period,mktsize,entries,exits,surviv,entryrate,exitrate,survivrate,firms,totresinv,totinninv,totimiinv,costshareinn,firmsres,firmsinn,firmsimi,hindex,div,gini,pcm,cs,totprofits,ts,maxage,minage,avgage,actfirms,inactfirms,profitablefirms,wmc,avgproxopt,price,totoutput,avgoutput,magtechshock
1,4,40,22,18,1.0,0.55,0.44999999999999996,40,0,0,0,0,0,0,0,388.69905842221976,0.498303952991453,-0.10522345663426314,0.16455827053780894,117784.9283478711,2556.5781490292297,120341.50649690033,0,0,0.0,33,7,18,47.88944472499264,0.5003156565656566,57.32230392156863,970.7107843137262,29.415478312537157,0
2,4,28,25,21,0.6086956521739131,0.5434782608695652,0.4565217391304348,46,300,300,0,1.0,3,3,0,281.0541136483249,0.4965579710144927,0.06884640789524799,0.1340577805509273,123013.27665233127,-2285.322512700576,120727.9541396307,1,0,0.391304347826087,46,0,16,45.024389335716435,0.5339673913043479,51.994680851063826,992.0212765957439,21.56567992599443,0
3,4,13,11,23,0.38235294117647056,0.3235294117647059,0.6764705882352942,34,400,300,100,0.75,5,3,2,328.2703749425642,0.48947192513368987,0.03757876579716313,0.15899704247218094,123664.30165816314,1319.065334467109,124983.36699263025,2,0,0.9411764705882353,34,0,17,43.17649112307999,0.5597426470588236,51.33928571428571,994.6428571428562,29.254201680672242,0
4,4,11,11,23,0.3235294117647059,0.3235294117647059,0.6764705882352942,34,700,500,200,0.7142857142857143,9,5,4,316.4263156022256,0.489861853832442,-0.00688240912410798,0.15553913259884058,124286.73469387769,1065.5187074830094,125352.2534013607,3,0,1.4411764705882353,34,0,14,42.82622970391596,0.5661764705882353,50.71428571428572,997.1428571428582,29.327731092437006,0
5,4,10,8,25,0.30303030303030304,0.24242424242424243,0.7575757575757576,33,600,400,200,0.6666666666666666,8,4,4,329.79126409070085,0.4881234217171717,0.011626135016298278,0.1640505293551852,124785.63120254237,1630.6422109284983,126416.27341347087,4,0,2.090909090909091,33,0,19,41.97675191136189,0.5735479797979798,50.21446078431373,999.1421568627458,30.27703505644684,0
6,4,6,6,25,0.1935483870967742,0.1935483870967742,0.8064516129032258,31,650,500,150,0.7692307692307693,8,5,3,340.0135000838858,0.48655913978494625,0.025272107843342884,0.16987401868211804,124967.45003594266,2298.124016655778,127265.57405259844,5,0,2.774193548387097,31,0,21,41.53332139601512,0.5803091397849462,50.032552083333314,999.8697916666645,32.25386424731176,0
7,4,7,9,23,0.21875,0.28125,0.71875,32,500,200,300,0.4,8,2,6,330.1065114044275,0.4848790322580645,0.016369047619047894,0.1673298523325889,125568.82747933856,1890.217516069757,127459.04499540832,6,0,3.1875,32,0,20,41.16039934492315,0.583984375,49.431818181818166,1002.272727272725,31.321022727272656,0
8,4,6,3,26,0.20689655172413793,0.10344827586206896,0.896551724137931,29,650,500,150,0.7692307692307693,8,5,3,356.8139731380524,0.4806034482758621,0.004875577182298585,0.1805088360601621,125486.58371913595,3155.0733024691594,128641.6570216051,7,0,3.5517241379310347,29,0,23,40.57619443674337,0.5912356321839081,49.5138888888889,1001.9444444444457,34.54980842911882,0
9,4,2,0,28,0.07142857142857142,0.0,1.0,28,650,300,350,0.46153846153846156,10,3,7,366.4555530069529,0.4800485008818342,0.025543856774140394,0.1854616129659283,125503.37932685962,3598.282055093152,129101.66138195277,8,0,4.607142857142857,28,0,25,40.3173095306376,0.5944940476190477,49.49712643678161,1002.0114942528742,35.786124794745504,0
10,4,3,3,28,0.0967741935483871,0.0967741935483871,0.9032258064516129,31,1150,700,450,0.6086956521739131,16,7,9,417.31088359841743,0.48288530465949825,0.04764684483473358,0.2001517483221088,123248.36730957023,4086.577012803806,127334.94432237404,9,0,5.064516129032258,31,0,16,41.39839583879707,0.5625,51.75781249999999,992.9687499999993,32.03124999999998,16
11,4,5,5,28,0.15151515151515152,0.15151515151515152,0.8484848484848485,33,700,300,400,0.42857142857142855,11,3,8,373.36055133336725,0.4854403409090909,0.027579329642198225,0.18450535983367344,124510.28450595902,2697.4456939638353,127207.73019992285,10,0,5.121212121212121,33,0,18,41.17448428290767,0.5707070707070707,50.49019607843136,998.0392156862727,30.243612596553717,0
12,4,7,9,26,0.2,0.2571428571428571,0.7428571428571429,35,1000,800,200,0.8,12,8,4,340.8959735394469,0.48816526610644256,0.038620315046170584,0.1724146943093738,125476.64399092951,1555.8577107313265,127032.50170166085,11,0,5.371428571428571,34,1,18,40.98517704372621,0.5784313725490196,49.52380952380951,1001.9047619047603,29.46778711484589,0
13,4,4,1,29,0.13333333333333333,0.03333333333333333,0.9666666666666667,30,600,300,300,0.5,9,3,6,378.630272424713,0.4880986590038314,0.020702792344583054,0.18885803729192394,124899.21387226829,3458.124674817872,128357.33854708615,12,0,6.1,30,0,23,40.63886647841871,0.5822916666666667,50.10080645161289,999.5967741935469,33.31989247311823,0
14,4,2,1,30,0.06451612903225806,0.03225806451612903,0.967741935483871,31,900,300,600,0.3333333333333333,15,3,12,371.0610929976655,0.48812724014336917,0.0359606345106358,0.18743092504471676,125423.53524102081,3107.9588148328644,128531.49405585368,13,0,6.838709677419355,31,0,20,40.28459313661769,0.585013440860215,49.57682291666665,1001.6927083333314,32.312668010752624,0
15,4,5,5,30,0.14285714285714285,0.14285714285714285,0.8571428571428572,35,1100,600,500,0.5454545454545454,16,6,10,329.2124854859642,0.48462885154061625,0.013223140495867591,0.1731943945382681,127092.01388888895,1368.0555555555648,128460.06944444451,14,0,6.542857142857143,35,0,21,39.61776859504131,0.5928571428571429,47.91666666666667,1008.3333333333339,28.809523809523828,0
16,4,2,2,30,0.0625,0.0625,0.9375,32,750,500,250,0.6666666666666666,10,5,5,354.3381090511109,0.48233786962365593,0.027794753666791516,0.1851051143353448,126805.716970845,2586.4195936639303,129392.13656450892,15,0,7.78125,32,0,23,39.278550833646726,0.5966796875,48.200757575757585,1007.1969696969712,31.47490530303035,0
17,4,2,2,30,0.0625,0.0625,0.9375,32,1050,700,350,0.6666666666666666,14,7,7,392.568086569757,0.48135080645161293,0.052355593308938575,0.19206719938822137,124090.20317925351,3639.8107271220765,127730.01390637559,16,0,8.34375,31,1,22,41.133037114479876,0.571236559139785,50.911458333333336,996.3541666666671,32.140456989247326,16
18,4,6,5,31,0.16666666666666666,0.1388888888888889,0.8611111111111112,36,1050,800,250,0.7619047619047619,13,8,5,345.01658231519167,0.4800595238095238,0.06622781989619897,0.17481695230319938,125552.07882785471,1470.1558782980183,127022.23470615273,17,0,8.166666666666666,33,3,16,40.8040882041249,0.5814393939393939,49.44852941176471,1002.2058823529414,30.369875222816408,0
19,4,3,1,33,0.08823529411764706,0.029411764705882353,0.9705882352941176,34,700,200,500,0.2857142857142857,12,2,10,394.5608176393764,0.48015077243018417,0.1376566702580364,0.18403946189706363,122055.31014336472,2944.886290518323,125000.19643388304,18,0,9.147058823529411,31,3,18,43.21509750955331,0.5500672043010753,52.96223958333333,988.151041666666,31.87584005376342,16
20,4,6,8,31,0.15384615384615385,0.20512820512820512,0.7948717948717949,39,1150,700,450,0.6086956521739131,16,7,9,400.4111165676634,0.482146873594242,0.22672863511334596,0.1930638617933265,123472.83046184167,2399.546300645347,125872.37676248702,19,0,8.794871794871796,33,6,15,41.58292231812579,0.5599747474747474,51.531862745098046,993.8725490196084,30.117349970291166,15
21,4,4,1,34,0.11428571428571428,0.02857142857142857,0.9714285714285714,35,750,300,450,0.4,12,3,9,377.76820602334664,0.48084733893557424,0.15804963606068578,0.18681979587493394,124540.86356509531,2409.5157211168967,126950.3792862122,20,0,8.142857142857142,33,2,16,41.03271434417844,0.5710227272727273,50.45955882352942,998.1617647058836,30.247326203208594,0
22,4,0,3,31,0.0,0.08823529411764706,0.9117647058823529,34,900,400,500,0.4444444444444444,14,4,10,393.2226839573188,0.4808749257278669,0.1636720232822979,0.19410611313645784,124463.95975219362,2988.4104619426544,127452.37021413627,21,1,9.382352941176471,32,2,16,40.727150027415746,0.5725911458333333,50.53661616161616,997.8535353535351,31.182922979797972,0
23,4,5,6,30,0.1388888888888889,0.16666666666666666,0.8333333333333334,36,950,500,450,0.5263157894736842,14,5,9,363.180147481987,0.48110119047619043,0.14435210834102818,0.18465920174788342,125695.40895061729,1930.015432098769,127625.42438271605,22,0,8.666666666666666,35,1,16,40.200831024930764,0.5785714285714285,49.30555555555556,1002.7777777777778,28.650793650793652,0
24,4,1,1,30,0.03225806451612903,0.03225806451612903,0.967741935483871,31,1400,1200,200,0.8571428571428571,16,12,4,401.9169750652625,0.4807795698924731,0.13811513060962732,0.20160848803138917,125134.44473349523,3858.731500751536,128993.17623424677,23,0,9.903225806451612,30,1,21,39.812264911338,0.5847222222222221,49.865591397849464,1000.5376344086023,33.35125448028675,0
25,4,5,2,33,0.14285714285714285,0.05714285714285714,0.9428571428571428,35,1100,800,300,0.7272727272727273,14,8,6,360.100515153056,0.4811624649859944,0.11973884509996258,0.1861327387382323,126372.79620181429,2101.381802721115,128474.1780045354,24,0,9.0,34,1,18,39.579140026837145,0.5876225490196079,48.630952380952394,1005.4761904761924,29.572829131652718,0
26,4,1,5,29,0.029411764705882353,0.14705882352941177,0.8529411764705882,34,600,400,200,0.6666666666666666,8,4,4,366.9851490061274,0.4812277183600713,0.12524205000215227,0.1893089429024062,126290.07623269911,2469.316488850466,128759.39272154958,25,0,10.235294117647058,33,1,19,39.491384215232074,0.5890151515151515,48.71323529411766,1005.1470588235306,30.45900178253123,0
27,4,4,6,27,0.12121212121212122,0.18181818181818182,0.8181818181818181,33,1000,900,100,0.9,11,9,2,377.61299727691176,0.4815340909090909,0.10865328729187329,0.1972638427817894,126805.71697084483,2976.697371441695,129782.41434228653,26,0,10.181818181818182,32,1,20,38.69249091137018,0.5966796875,48.20075757575758,1007.1969696969699,31.474905303030308,0
28,4,2,2,27,0.06896551724137931,0.06896551724137931,0.9310344827586207,29,1100,800,300,0.7272727272727273,14,8,6,403.1371816845809,0.4792179802955665,0.06313744536182608,0.20883544132759174,126462.58680555542,4396.354166666649,130858.94097222206,25,0,10.793103448275861,29,0,20,38.404446285556475,0.6012931034482758,48.54166666666666,1005.8333333333322,34.68390804597697,0
29,4,4,1,30,0.12903225806451613,0.03225806451612903,0.967741935483871,31,750,400,350,0.5333333333333333,11,4,7,409.4815524312523,0.4812275985663082,0.11955634304375762,0.20277526476395621,124597.09937565042,4005.6052361544753,128602.70461180489,26,0,10.96774193548387,30,1,17,40.18269834859092,0.5791666666666666,50.403225806451616,998.387096774194,33.279569892473134,16
30,4,7,8,29,0.1891891891891892,0.21621621621621623,0.7837837837837838,37,1200,800,400,0.6666666666666666,16,8,8,355.30297486921444,0.48301426426426425,0.11263234348353302,0.18378715423884004,126402.72285997754,1598.954406814781,128001.67726679232,27,0,9.864864864864865,34,3,15,39.66891598595163,0.5879289215686274,48.60119047619049,1005.5952380952399,29.57633053221294,0
31,4,2,2,29,0.06451612903225806,0.06451612903225806,0.935483870967742,31,800,500,300,0.625,11,5,6,410.71198035519177,0.4810035842293907,0.14371822331840534,0.20786543201275992,125504.5403550988,4109.243662562139,129613.78401766093,28,0,12.193548387096774,30,1,19,39.20746702436844,0.5885416666666667,49.49596774193548,1002.0161290322576,33.400537634408586,0
32,4,1,0,30,0.03333333333333333,0.0,1.0,30,1050,800,250,0.7619047619047619,13,8,5,420.45512802824874,0.4806992337164751,0.1447648091673599,0.2127042982886246,125486.58371913584,4552.295524691367,130038.8792438272,29,0,13.3,29,1,20,38.982071897236864,0.5912356321839081,49.51388888888889,1001.9444444444448,34.549808429118784,0
33,4,1,3,28,0.03225806451612903,0.0967741935483871,0.9032258064516129,31,950,500,450,0.5263157894736842,14,5,9,413.38970175788273,0.4807795698924731,0.020001858280752405,0.20009319024250366,123636.55090332031,4022.015380859374,127658.56628417969,30,0,13.838709677419354,31,0,19,41.08896307934014,0.5665322580645161,51.3671875,994.53125,32.08165322580645,16
34,4,5,1,32,0.15151515151515152,0.030303030303030304,0.9696969696969697,33,1200,1000,200,0.8333333333333334,14,10,4,402.2155508268629,0.4817708333333333,0.09909312099093137,0.1998573643745915,124739.71896701392,3480.87158203126,128220.59054904518,31,0,12.272727272727273,31,2,20,40.21550225929789,0.5779569892473118,50.26041666666667,998.9583333333337,32.22446236559141,15
35,4,6,4,34,0.15789473684210525,0.10526315789473684,0.8947368421052632,38,750,300,450,0.4,12,3,9,352.5007161569446,0.4834637268847795,0.1250957532275847,0.18287191849246998,126522.46492346923,1326.9048504818384,127849.36977395107,32,0,11.157894736842104,34,4,15,39.61612038023113,0.5891544117647058,48.48214285714285,1006.0714285714272,29.59033613445374,0
36,4,3,1,36,0.08108108108108109,0.02702702702702703,0.972972972972973,37,1250,900,350,0.72,16,9,7,352.34266119284666,0.4816378878878879,0.13731684645288245,0.18413658161535995,126822.0680980727,1536.964994331082,128359.03309240378,33,0,11.972972972972974,34,3,18,39.31199030847416,0.592218137254902,48.18452380952382,1007.261904761906,29.625350140056057,0
37,4,3,3,36,0.07692307692307693,0.07692307692307693,0.9230769230769231,39,650,400,250,0.6153846153846154,9,4,5,340.5367262818871,0.48155645524066576,0.16554226629793334,0.1820225071815181,127734.70320001733,899.9585218604104,128634.66172187774,34,0,11.487179487179487,35,4,17,38.67405159911457,0.5994047619047619,47.2800925925926,1010.8796296296312,28.882275132275176,0
38,4,1,4,33,0.02702702702702703,0.10810810810810811,0.8918918918918919,37,900,500,400,0.5555555555555556,13,5,8,343.62629757785464,0.47841591591591587,0.1634022257551675,0.1848622486969471,127993.90589569163,1396.4143990929733,129390.3202947846,35,0,12.18918918918919,34,3,19,38.330882352941174,0.6041666666666667,47.023809523809526,1011.904761904762,29.761904761904766,0
39,4,0,1,32,0.0,0.030303030303030304,0.9696969696969697,33,1050,500,550,0.47619047619047616,16,5,11,362.8405263574725,0.4760495580808081,0.1507542634338388,0.19376507094673573,127697.47865332625,2666.7640738190075,130364.24272714526,36,1,13.636363636363637,32,1,20,38.148552987716,0.6057942708333333,47.3169191919192,1010.7323232323238,31.585385101010118,0
40,4,0,0,32,0.0,0.0,1.0,32,1500,1300,200,0.8666666666666667,17,13,4,367.061881216312,0.4734543010752688,0.13241443643849715,0.19756266903138314,128012.72922091995,2997.7186414930306,131010.44786241298,37,2,13.9375,31,1,20,37.718733916623776,0.6115591397849462,47.00520833333332,1011.9791666666652,32.64448924731178,0
41,4,0,1,31,0.0,0.03125,0.96875,32,1500,1100,400,0.7333333333333333,19,11,8,363.80615140326086,0.47271925403225806,0.13006311833483264,0.19759269200080784,128375.34798516151,2940.7482571071846,131316.0962422687,38,3,14.9375,31,1,18,37.43000235556128,0.615255376344086,46.64713541666666,1013.411458333332,32.69069220430103,0
42,4,1,1,31,0.03125,0.03125,0.96875,32,1400,1100,300,0.7857142857142857,17,11,6,367.344019984975,0.4710181451612903,0.14516775724916586,0.20134172234619507,128738.4796142578,3058.262125651041,131796.74173990884,39,0,15.6875,31,1,19,36.96914293045934,0.6189516129032258,46.2890625,1014.8437499999999,32.73689516129032,0
43,4,1,1,31,0.03125,0.03125,0.96875,32,1400,1000,400,0.7142857142857143,18,10,8,356.4706680417245,0.46948504704301075,0.11873913178487117,0.19751860622188083,129169.29913082869,2809.013270329586,131978.31240115827,40,0,15.9375,32,0,20,36.80572806690679,0.6207682291666667,45.864898989899004,1016.5404040404057,31.76688762626268,0
44,4,1,2,30,0.03125,0.0625,0.9375,32,1350,1100,250,0.8148148148148148,16,11,5,354.6856918010127,0.46704889112903225,0.11173901576269096,0.19749154242161443,129361.89746263137,2776.5628188450187,132138.46028147638,41,0,16.65625,32,0,21,36.65497910719458,0.6227213541666667,45.67550505050505,1017.2979797979799,31.790561868686872,0
45,4,0,0,30,0.0,0.0,1.0,30,900,500,400,0.5555555555555556,13,5,8,417.47122770365206,0.4654932950191571,0.09202627075528391,0.20995918618703557,125243.17370756167,4724.439829162837,129967.6135367245,42,1,17.8,29,1,16,39.31001688173535,0.5887212643678161,49.75694444444444,1000.9722222222218,34.5162835249042,16
46,4,0,1,29,0.0,0.03333333333333333,0.9666666666666667,30,900,600,300,0.6666666666666666,12,6,6,422.809910304949,0.4647749042145594,0.09948227245412067,0.21335775109929916,125382.23620756165,4602.570408950607,129984.80661651226,43,2,18.8,29,1,16,39.03165880830214,0.5901580459770115,49.61805555555555,1001.5277777777771,34.5354406130268,0
47,4,1,1,29,0.03333333333333333,0.03333333333333333,0.9666666666666667,30,1150,700,450,0.6086956521739131,16,7,9,421.4632263708072,0.4661159003831417,0.10686885472926178,0.2144739927853134,125730.23003472216,4598.133680555545,130328.36371527771,44,0,19.7,29,1,18,38.70352098047362,0.59375,49.27083333333333,1002.9166666666661,34.583333333333314,0
48,4,1,1,29,0.03333333333333333,0.03333333333333333,0.9666666666666667,30,1350,1100,250,0.8148148148148148,16,11,5,419.1288321350073,0.4657088122605364,0.10804279653200521,0.2145512180362486,125974.1126543209,4559.8765432098635,130533.98919753075,45,0,20.533333333333335,29,1,20,38.508808337945034,0.5962643678160919,49.02777777777777,1003.8888888888881,34.616858237547866,0
49,4,5,3,31,0.14705882352941177,0.08823529411764706,0.9117647058823529,34,900,700,200,0.7777777777777778,11,7,4,371.3436864750214,0.4694927213309566,0.0781529958395335,0.19599256694880568,127223.34120008686,2653.674467110344,129877.01566719719,46,0,18.0,31,3,18,38.42066769919119,0.603494623655914,47.786458333333336,1008.8541666666671,32.543682795698935,0
50,4,1,1,31,0.03125,0.03125,0.96875,32,850,500,350,0.5882352941176471,12,5,7,392.9544784878515,0.46690188172043007,0.09581749366413206,0.20586860413860408,126922.65950182114,3574.9654945658635,130497.624996387,47,0,20.0625,30,2,20,38.18555199857721,0.603125,48.08467741935485,1007.6612903225816,33.58870967741939,0
51,4,0,1,30,0.0,0.03225806451612903,0.967741935483871,31,950,500,450,0.5263157894736842,14,5,9,392.9364544043997,0.4659498207885305,0.08569180023308731,0.20654634509372127,127058.13397863918,3785.1545337611337,130843.28851240031,48,1,21.096774193548388,30,1,21,38.046316046749325,0.6045138888888889,47.950268817204304,1008.198924731183,33.606630824372765,0
52,4,1,2,29,0.03225806451612903,0.06451612903225806,0.935483870967742,31,850,500,350,0.5882352941176471,12,5,7,390.3368212361276,0.4668906810035842,0.0748678293833811,0.2065970633592817,127337.21305941354,3740.885110553878,131078.09816996742,49,0,21.35483870967742,29,2,18,37.82438305582313,0.6102729885057472,47.67361111111111,1009.3055555555552,34.80363984674328,0
53,4,0,1,28,0.0,0.034482758620689655,0.9655172413793104,29,900,600,300,0.6666666666666666,12,6,6,413.28182626329703,0.46479885057471265,0.08874998157184799,0.21722835766962953,127055.79759958375,4701.970413859157,131757.7680134429,50,3,23.20689655172414,28,1,21,37.5359246591611,0.6104910714285714,47.95258620689655,1008.1896551724132,36.006773399014754,0
54,4,1,0,29,0.034482758620689655,0.0,1.0,29,1050,900,150,0.8571428571428571,12,9,3,403.6331109292016,0.46459359605911327,0.07786714299033748,0.21406263173581136,127418.19273104107,4486.040304201341,131904.23303524242,51,0,23.20689655172414,28,1,20,37.40542431573454,0.6142113095238095,47.593390804597696,1009.6264367816091,36.05808702791461,0
55,4,1,0,30,0.03333333333333333,0.0,1.0,30,900,700,200,0.7777777777777778,11,7,4,391.88673949226893,0.4653735632183908,0.06817807089859862,0.2094090814996132,127723.00347222218,4010.590277777774,131733.59374999994,52,0,23.4,29,1,21,37.388362187414124,0.6142241379310345,47.291666666666664,1010.8333333333329,34.856321839080444,0
56,4,2,2,30,0.0625,0.0625,0.9375,32,1200,800,400,0.6666666666666666,16,8,8,427.14532088765526,0.4680989583333333,0.1318184188569047,0.21198081452747608,124687.69531249991,4805.425347222208,129493.12065972212,53,0,22.875,29,3,20,39.647215269086345,0.5829741379310345,50.31249999999999,998.7499999999993,34.43965517241377,16
57,4,3,0,33,0.09090909090909091,0.0,1.0,33,1250,700,550,0.56,18,7,11,422.55060407989197,0.47056502525252525,0.19560461921961636,0.20243912318787322,123200.96450617284,4222.622492283953,127423.58699845678,54,0,22.333333333333332,29,4,15,41.31808431262825,0.5675287356321839,51.80555555555556,992.7777777777777,34.23371647509578,16
58,4,6,1,38,0.15384615384615385,0.02564102564102564,0.9743589743589743,39,1100,700,400,0.6363636363636364,15,7,8,365.06797102022324,0.4756803868645974,0.19001486995467776,0.18240729911183973,124971.06648930468,1324.5867358967716,126295.65322520144,55,0,19.743589743589745,35,4,20,40.903292240614256,0.5711309523809525,50.02893518518518,999.8842592592591,28.56812169312169,0
59,4,6,7,37,0.13636363636363635,0.1590909090909091,0.8409090909090909,44,1000,500,500,0.5,15,5,10,334.11577680256266,0.47874823819591267,0.21140925019548829,0.1733536236997095,126527.07151955934,-335.8923359363104,126191.17918362303,56,0,18.15909090909091,38,6,13,40.07380269724966,0.5814144736842105,48.477564102564095,1006.0897435897423,26.476045883940586,0
60,4,2,1,38,0.05128205128205128,0.02564102564102564,0.9743589743589743,39,1250,1000,250,0.8,15,10,5,375.5820404717422,0.47315002249212773,0.24660085677034926,0.19217835026616004,125956.68463059382,1661.4137249228047,127618.09835551663,57,0,21.333333333333332,35,4,21,39.619725008647535,0.58125,49.04513888888887,1003.8194444444418,28.680555555555483,0
61,4,1,1,38,0.02564102564102564,0.02564102564102564,0.9743589743589743,39,1100,500,600,0.45454545454545453,17,5,12,371.7590141385077,0.4730656770130454,0.24785178655713858,0.1919156194448193,126320.87305663683,1592.2449281659779,127913.11798480281,58,0,22.025641025641026,33,6,17,39.339647080336455,0.5893308080808081,48.682598039215684,1005.269607843137,30.46271538918597,0
62,4,1,0,39,0.02564102564102564,0.0,1.0,39,900,600,300,0.6666666666666666,12,6,6,369.6332504103019,0.47227845254161044,0.25310133418241487,0.1924060531603434,126659.88592128018,1563.5410659361603,128223.42698721634,59,0,22.641025641025642,33,6,18,39.04360441522602,0.5928030303030303,48.34558823529411,1006.6176470588227,30.503565062388567,0
63,4,2,1,40,0.04878048780487805,0.024390243902439025,0.975609756097561,41,1450,1200,250,0.8275862068965517,17,12,5,356.6467277977684,0.471239837398374,0.24825054491224052,0.18830342375609616,127237.93730977795,875.7987986539795,128113.73610843193,60,0,22.48780487804878,35,6,20,38.776361324614726,0.5943452380952381,47.77199074074074,1008.912037037037,28.8260582010582,0
64,4,1,5,36,0.024390243902439025,0.12195121951219512,0.8780487804878049,41,1400,1000,400,0.7142857142857143,18,10,8,355.3687736553891,0.4708333333333334,0.2388538681948429,0.18871531041651043,127471.58893014817,859.8844468021127,128331.47337695028,61,0,23.317073170731707,35,6,17,38.568887297039176,0.5967261904761905,47.54050925925925,1009.8379629629617,28.852513227513192,0
65,4,1,2,35,0.02702702702702703,0.05405405405405406,0.9459459459459459,37,1350,1000,350,0.7407407407407407,17,10,7,338.25856409393106,0.46943818818818817,0.09479295809570987,0.17898147323416752,127325.53155006863,1213.7902949245508,128539.32184499317,62,0,24.783783783783782,35,2,15,39.15042048929662,0.5952380952380952,47.68518518518518,1009.2592592592596,28.835978835978846,16
66,4,0,0,35,0.0,0.0,1.0,35,1450,1000,450,0.6896551724137931,19,10,9,368.93092965553467,0.46901260504201686,0.04376107980973454,0.18165328714255263,124357.44552876294,2375.2464570992342,126732.69198586217,63,4,27.17142857142857,33,2,17,41.44384547651226,0.5691287878787878,50.643382352941174,997.4264705882349,30.225044563279845,14
67,4,4,2,37,0.10256410256410256,0.05128205128205128,0.9487179487179487,39,1100,800,300,0.7272727272727273,14,8,6,341.167500864739,0.47407782276203325,0.0727445186239104,0.17250954374106897,125466.44310028074,761.014566982139,126227.45766726288,64,0,25.28205128205128,37,2,16,40.98890500164167,0.5723536036036037,49.53399122807017,1001.8640350877183,27.077406353722118,0
68,4,2,2,37,0.05128205128205128,0.05128205128205128,0.9487179487179487,39,1050,700,350,0.6666666666666666,14,7,7,343.0972709545699,0.47264394961763384,0.09941500806885406,0.17522467766608382,125878.73191751301,837.7298784241232,126716.46179593714,65,0,25.76923076923077,37,2,18,40.515278991841484,0.5765765765765766,49.122807017543856,1003.508771929824,27.121858700806055,0
69,4,4,4,37,0.0975609756097561,0.0975609756097561,0.9024390243902439,41,1300,900,400,0.6923076923076923,17,9,8,329.2039790068357,0.4749745934959349,0.1011844382875855,0.171633530802593,126724.65820312503,143.65234375000114,126868.31054687503,66,0,24.24390243902439,39,2,15,39.9945685909373,0.5817307692307692,48.28125,1006.8750000000002,25.817307692307697,0
70,4,2,1,38,0.05128205128205128,0.02564102564102564,0.9743589743589743,39,1300,800,500,0.6153846153846154,18,8,10,338.61341033504254,0.4742183985605038,0.12114002312216199,0.1764556375537096,126705.33842143748,780.8253501077376,127486.16377154522,67,0,26.153846153846153,37,2,17,39.777553909823574,0.5850225225225225,48.30043859649123,1006.7982456140361,27.21076339497395,0
71,4,3,2,39,0.07317073170731707,0.04878048780487805,0.9512195121951219,41,900,300,600,0.3333333333333333,15,3,12,339.58658011745564,0.4753810975609756,0.08060478184342568,0.1749694365455066,126241.80768606447,690.2318563322629,126932.03954239673,68,0,25.121951219512194,36,5,20,40.22953085313013,0.5821759259259259,48.76126126126126,1004.9549549549552,27.91541541541542,15
72,4,2,1,40,0.04878048780487805,0.024390243902439025,0.975609756097561,41,1150,700,450,0.6086956521739131,16,7,9,340.6400470745143,0.47568597560975606,0.09410589574173667,0.1770971553638705,126609.88004474062,425.67909970780914,127035.55914444843,69,0,25.75609756097561,36,5,16,39.82460557233972,0.5859375,48.39527027027027,1006.4189189189184,27.956081081081066,0
73,4,1,1,40,0.024390243902439025,0.024390243902439025,0.975609756097561,41,1450,900,550,0.6206896551724138,20,9,11,339.82270105804037,0.4760670731707317,0.09640434174166157,0.17716354344955892,126723.24087178384,412.686799975639,127135.92767175948,70,0,26.73170731707317,36,5,17,39.72873093986505,0.5870949074074074,48.28265765765765,1006.8693693693684,27.968593593593567,0
74,4,3,4,39,0.06976744186046512,0.09302325581395349,0.9069767441860466,43,1250,800,450,0.64,17,8,9,365.2543369126756,0.4780823181985973,0.06629555637449758,0.1817178215594601,124791.75347222244,764.7305667153837,125556.48403893782,71,0,26.348837209302324,39,4,14,41.084584375868765,0.561965811965812,50.20833333333334,999.1666666666684,25.619658119658165,16
75,4,1,3,37,0.025,0.075,0.925,40,1350,1000,350,0.7407407407407407,17,10,7,404.7582262246729,0.47733707264957265,0.015344504335599085,0.18834278640138277,121951.68493870035,2104.481202846374,124056.16614154672,72,0,28.675,35,5,17,43.07231856886181,0.5398809523809525,53.06712962962963,987.731481481482,28.220899470899486,15
76,4,11,6,42,0.22916666666666666,0.125,0.875,48,1400,1000,400,0.7142857142857143,18,10,8,357.64432109469163,0.4873762559101655,0.21143460148934645,0.1700220794604731,122870.98554362869,-138.82338470005516,122732.16215892864,71,0,23.020833333333332,37,11,16,43.273519870235184,0.5456081081081081,52.138157894736835,991.4473684210516,26.795874822190584,16
77,4,8,9,41,0.16,0.18,0.8200000000000001,50,1600,900,700,0.5625,23,9,14,325.45526493431953,0.4874829931972789,0.22952646239554353,0.16005265768687743,124306.5200617282,-1908.7336701891375,122397.78639153906,72,0,21.62,38,12,16,42.58066388115136,0.5586622807017544,50.694444444444436,997.2222222222206,26.24269005847949,0
78,4,4,3,42,0.08888888888888889,0.06666666666666667,0.9333333333333333,45,1450,1100,350,0.7586206896551724,18,11,7,350.54763533980434,0.48621632996632996,0.27538854094177734,0.17310548178120222,124479.70920138879,-272.78645833334343,124206.92274305545,73,0,24.555555555555557,35,10,19,41.77540013917884,0.5660714285714286,50.52083333333333,997.9166666666658,28.511904761904738,0
79,4,4,4,42,0.08695652173913043,0.08695652173913043,0.9130434782608696,46,1050,700,350,0.6666666666666666,14,7,7,327.4301670245736,0.48793276972624794,0.26436554959101377,0.1648763081777152,125293.97605970131,-994.9944983198084,124298.9815613815,74,0,23.304347826086957,38,8,16,41.51082239533313,0.5688048245614035,49.706196581196586,1001.1752136752144,26.34671614934775,0
80,4,5,1,46,0.10638297872340426,0.02127659574468085,0.9787234042553191,47,1250,600,650,0.48,19,6,13,321.13207937308715,0.48620104841196427,0.2774593862329928,0.16446157657474006,125992.81724048217,-1307.9329226981022,124684.88431778406,75,0,23.148936170212767,40,7,21,40.94902486756418,0.57265625,49.00914634146343,1003.9634146341489,25.09908536585372,0
81,4,2,5,43,0.041666666666666664,0.10416666666666667,0.8958333333333334,48,1500,1000,500,0.6666666666666666,20,10,10,321.1967157260117,0.4855200945626477,0.2849361016709149,0.16654120458568963,126500.20089122647,-1473.6792034699342,125026.52168775654,76,0,23.541666666666668,38,10,16,40.42631336731802,0.581140350877193,48.5042735042735,1005.9829059829054,26.473234367971195,0
82,4,2,2,43,0.044444444444444446,0.044444444444444446,0.9555555555555556,45,1100,900,200,0.8181818181818182,13,9,4,347.03690345324867,0.4843855218855219,0.2923925422600999,0.17883213250353439,126247.30909475716,-237.5049564900802,126009.80413826708,77,0,24.466666666666665,35,10,24,40.03668566931552,0.5842261904761905,48.755787037037024,1004.97685185185,28.713624338624285,0
83,4,1,6,38,0.022727272727272728,0.13636363636363635,0.8636363636363636,44,1050,800,250,0.7619047619047619,13,8,5,347.972384856692,0.48415477448907684,0.2814347293861623,0.18007933603453188,126421.84452428385,-1.7378525806219614,126420.10667170322,78,0,25.295454545454547,35,9,19,39.83352994207234,0.5860119047619048,48.58217592592591,1005.6712962962941,28.733465608465547,0
84,4,2,4,36,0.05,0.1,0.9,40,850,600,250,0.7058823529411765,11,6,5,342.71483504391216,0.483079594017094,0.13753426910845512,0.17124474415153057,124972.58922216437,565.9920600569235,125538.58128222129,79,0,26.65,37,3,18,41.46048086412983,0.5672860360360361,50.027412280701746,999.8903508771918,27.0240635372214,15
85,4,4,1,39,0.1,0.025,0.975,40,1500,1200,300,0.8,18,12,6,334.53982463652653,0.48481570512820515,0.21476356797420748,0.161540896120544,123535.2989284281,265.4984537199895,123800.7973821481,80,0,25.35,38,2,16,43.15466595020598,0.5507127192982456,51.469017094017104,994.123931623933,26.161156095366657,16
86,4,8,0,47,0.1702127659574468,0.0,1.0,47,1500,900,600,0.6,21,9,12,319.9610943625195,0.48340656799259946,0.3111743233911015,0.16300380161618158,125776.39564930029,-1325.3932259451312,124451.00242335517,81,0,22.361702127659573,42,5,20,41.20097565687794,0.5674603174603174,49.22480620155041,1003.1007751938014,23.883351790328604,0
87,4,4,3,48,0.0784313725490196,0.058823529411764705,0.9411764705882353,51,2050,1600,450,0.7804878048780488,25,16,9,304.67541162467666,0.4834640522875817,0.32560066280033007,0.15905848695111857,126779.33705548062,-2474.6906594235334,124304.64639605708,82,0,21.529411764705884,46,5,19,40.55604460093896,0.572463768115942,48.22695035460995,1007.0921985815644,21.89330866481662,0
88,4,0,4,44,0.0,0.08333333333333333,0.9166666666666666,48,2200,1500,700,0.6818181818181818,29,15,14,333.0675643894082,0.48297133569739953,0.2219567987028026,0.16584229244164647,124826.44917052465,-1229.5857378310743,123596.86343269357,83,1,23.479166666666668,41,7,21,41.85270442436877,0.5591971544715447,50.17361111111111,999.3055555555552,24.373306233062323,16
89,4,3,2,45,0.06382978723404255,0.0425531914893617,0.9574468085106383,47,1050,700,350,0.6666666666666666,14,7,7,343.552266083533,0.483695652173913,0.2984121943474123,0.1740021736427398,125534.75874789976,-774.2087054386725,124760.55004246108,84,0,24.76595744680851,38,9,19,40.85865316275767,0.5712719298245614,49.465811965811966,1002.136752136752,26.372019793072422,0
90,4,4,7,42,0.08163265306122448,0.14285714285714285,0.8571428571428572,49,1400,1000,400,0.7142857142857143,18,10,8,357.3638325673485,0.4851544784580499,0.2943994073975431,0.1752512234910278,124188.31383435796,-295.18517394065367,123893.12866041731,85,0,24.285714285714285,40,9,15,41.90796628602503,0.5541666666666667,50.81300813008131,996.7479674796757,24.918699186991894,16
91,4,3,3,42,0.06666666666666667,0.06666666666666667,0.9333333333333333,45,1550,1100,450,0.7096774193548387,20,11,9,367.15753017943916,0.48533249158249153,0.3162491168328758,0.18277852553250462,124817.77479383702,165.55718315974477,124983.33197699676,86,0,24.711111111111112,39,6,18,41.01004638799125,0.562232905982906,50.18229166666668,999.2708333333351,25.622329059829106,0
92,4,3,1,44,0.06666666666666667,0.022222222222222223,0.9777777777777777,45,1450,1100,350,0.7586206896551724,18,11,7,363.42417231424383,0.4850378787878788,0.28409753645047764,0.17690912352741855,123876.41019397798,324.311260294314,124200.7214542723,87,0,25.22222222222222,36,9,18,42.0814479638009,0.5578703703703703,51.12612612612614,995.4954954954973,27.6526526526527,16
93,4,6,3,47,0.12,0.06,0.94,50,1500,1000,500,0.6666666666666666,20,10,10,324.25421236259865,0.48826530612244895,0.2806539398862711,0.1629211981299425,125203.3346552978,-1880.4297336339423,123322.90492166387,88,0,23.46,40,10,19,41.68380212564311,0.5645833333333333,49.796747967479675,1000.8130081300816,25.02032520325204,0
94,4,5,8,44,0.09615384615384616,0.15384615384615385,0.8461538461538461,52,1650,1300,350,0.7878787878787878,20,13,7,321.01601049477443,0.48852281297134237,0.30372735372735327,0.1643145192058237,125970.87014001593,-2312.266765819334,123658.6033741966,89,0,23.403846153846153,42,10,16,40.97450128700128,0.5694444444444444,49.031007751938,1003.8759689922506,23.901808785529777,0
95,4,0,2,42,0.0,0.045454545454545456,0.9545454545454546,44,1200,800,400,0.6666666666666666,16,8,8,374.209538281103,0.4860597251585624,0.32544875506658943,0.18645697420988594,124855.36593632112,544.4137677897759,125399.7797041109,90,1,28.15909090909091,35,9,21,40.79485138004246,0.5699404761904762,50.144675925925924,999.421296296296,28.55489417989417,0
96,4,4,5,41,0.08695652173913043,0.10869565217391304,0.8913043478260869,46,1450,1100,350,0.7586206896551724,18,11,7,350.38688612673275,0.48561795491143317,0.30361163093349597,0.17918667908402833,125933.75485726357,-374.809030969069,125558.9458262945,91,0,25.108695652173914,37,9,19,40.2756536304712,0.5771396396396397,49.06798245614034,1003.7280701754369,27.12778568041721,0
97,4,2,3,40,0.046511627906976744,0.06976744186046512,0.9302325581395349,43,1300,800,500,0.6153846153846154,18,8,10,360.30170127359224,0.4868724621631599,0.20565850148645692,0.1764980223289532,124142.10205078124,345.72211371527766,124487.82416449652,92,0,26.441860465116278,39,4,18,41.88279589561341,0.5552884615384616,50.859375,996.5624999999999,25.552884615384613,16
98,4,5,2,43,0.1111111111111111,0.044444444444444446,0.9555555555555556,45,1450,1000,450,0.6896551724137931,19,10,9,343.0555555555555,0.48558501683501687,0.22944444444444412,0.17152777777777764,124999.9999999999,-411.7947048611255,124588.20529513877,93,0,25.77777777777778,37,8,19,41.4236111111111,0.5675675675675675,49.99999999999999,999.9999999999992,27.027027027027007,0
99,4,5,7,41,0.10416666666666667,0.14583333333333334,0.8541666666666666,48,1350,700,650,0.5185185185185185,20,7,13,327.3593891745446,0.4867113622931442,0.24670792568435607,0.16755435807067368,125969.13309594672,-1352.5643069727903,124616.56878897392,94,0,24.916666666666668,41,7,15,40.817089139243,0.5708841463414633,49.032738095238095,1003.8690476190477,24.48461091753775,0
100,4,2,2,41,0.046511627906976744,0.046511627906976744,0.9534883720930233,43,950,800,150,0.8421052631578947,11,8,3,349.21952448449474,0.4855574012550757,0.2571435288340227,0.1773588948365918,125648.36109335686,175.77218265563016,125824.1332760125,95,0,28.162790697674417,36,7,18,40.59937661462429,0.576099537037037,49.35247747747748,1002.5900900900899,27.84972472472472,0
101,4,3,4,40,0.06818181818181818,0.09090909090909091,0.9090909090909091,44,1650,1200,450,0.7272727272727273,21,12,9,336.746849483979,0.4842428646934461,0.2521484092116062,0.17448935541506116,126473.33311646206,-282.1007058587248,126191.23241060333,96,0,27.113636363636363,38,6,17,40.062842981058594,0.5808662280701755,48.5309829059829,1005.8760683760679,26.470422852001786,0
102,4,2,4,38,0.047619047619047616,0.09523809523809523,0.9047619047619048,42,900,600,300,0.6666666666666666,12,6,6,329.2062977096982,0.48298974061169186,0.24253588268822313,0.1724860818672817,126926.22369382865,-43.01756309635388,126883.2061307323,97,0,27.261904761904763,37,5,20,39.787812840043564,0.5872747747747749,48.081140350877185,1007.6754385964895,27.234471313418634,0
103,4,2,1,39,0.05,0.025,0.975,40,1050,800,250,0.7619047619047619,13,8,5,334.67659312888435,0.48341346153846154,0.23450413223140476,0.17606899029823933,127092.01388888898,506.94444444445395,127598.95833333343,98,0,28.15,36,4,22,39.480027548209364,0.5908564814814814,47.91666666666667,1008.3333333333342,28.00925925925928,0
104,4,2,1,40,0.04878048780487805,0.024390243902439025,0.975609756097561,41,950,600,350,0.631578947368421,13,6,7,323.66170011960446,0.48343495934959346,0.22801940775875185,0.17195486532420715,127489.7532667805,52.710058031030826,127542.46332481154,99,0,28.29268292682927,36,5,17,39.350793562295586,0.5949074074074074,47.522522522522536,1009.9099099099117,28.0530530530531,0
105,4,1,1,40,0.024390243902439025,0.024390243902439025,0.975609756097561,41,950,600,350,0.631578947368421,13,6,7,324.90787450799087,0.4830284552845528,0.2329118742692442,0.1728602392845006,127546.62390430983,88.18049468388932,127634.80439899373,100,0,29.26829268292683,36,5,18,39.261194723151256,0.5954861111111112,47.466216216216225,1010.1351351351361,28.059309309309338,0
106,4,1,2,39,0.024390243902439025,0.04878048780487805,0.9512195121951219,41,1800,1200,600,0.6666666666666666,24,12,12,318.2701844872048,0.482494918699187,0.22319583542530963,0.1713905369204728,128033.53555901835,-50.14860341641469,127983.38695560193,101,0,28.609756097560975,37,4,19,38.931924882629104,0.5985360360360361,46.98464912280703,1012.0614035087734,27.353010905642524,0
107,4,2,2,39,0.04878048780487805,0.04878048780487805,0.9512195121951219,41,1450,1200,250,0.8275862068965517,17,12,5,317.50810517044266,0.4813262195121952,0.21966001478196584,0.17216988801495856,128311.11495844886,-52.0362034472021,128259.07875500165,102,0,29.26829268292683,37,4,21,38.66838023088023,0.6013513513513513,46.71052631578948,1013.157894736843,27.38264580369846,0
108,4,1,3,37,0.025,0.075,0.925,40,1000,900,100,0.9,11,9,2,355.47536221303744,0.48091613247863246,0.18326483504109925,0.17785784179233724,125028.15473835326,891.9635886026496,125920.11832695591,103,0,30.65,36,4,17,41.083962016289455,0.5697337962962963,49.97184684684685,1000.112612612613,27.780905905905918,16
109,4,3,4,36,0.075,0.1,0.9,40,1250,800,450,0.64,17,8,9,346.635525618463,0.481517094017094,0.18044798162126674,0.1757401741363491,125576.32065876051,705.8427833564306,126282.16344211694,104,0,29.275,37,3,16,40.73849961710973,0.5734797297297297,49.424342105263165,1002.3026315789484,27.089260312944553,0
110,4,6,5,37,0.14285714285714285,0.11904761904761904,0.8809523809523809,42,1100,700,400,0.6363636363636364,15,7,8,332.7846316593883,0.4824574138598529,0.2141508308302078,0.17306686311623365,126622.55603887726,29.345447637723765,126651.90148651498,105,0,28.166666666666668,37,5,15,40.00923757126774,0.584177927927928,48.382675438596486,1006.4692982456133,27.20187292555712,0
111,4,2,2,37,0.05128205128205128,0.05128205128205128,0.9487179487179487,39,1250,700,550,0.56,18,7,11,379.0053957841181,0.48183760683760685,0.17981430357727013,0.18775654190439442,124613.39462868476,1646.69844695149,126260.09307563625,106,0,27.846153846153847,34,5,17,40.926433766543454,0.569546568627451,50.38690476190476,998.4523809523806,29.36624649859943,16
112,4,3,2,38,0.075,0.05,0.95,40,950,500,450,0.5263157894736842,14,5,9,365.08827467442217,0.48370726495726496,0.1900416171224737,0.18385583173723902,125297.79620181411,1149.5500283446786,126447.34623015879,107,0,27.925,34,6,16,40.56430836305985,0.576593137254902,49.702380952380956,1001.1904761904766,29.446778711484605,0
113,4,3,3,38,0.07317073170731707,0.07317073170731707,0.926829268292683,41,1450,1000,450,0.6896551724137931,19,10,9,343.04697582194024,0.4832571138211382,0.17377193630569754,0.17542040708553952,125930.78033692474,440.0346714958161,126370.81500842056,108,0,26.317073170731707,36,5,19,40.4629006320356,0.5789930555555556,49.070945945945944,1003.716216216216,27.881006006006,0
114,4,3,3,38,0.07317073170731707,0.07317073170731707,0.926829268292683,41,1000,800,200,0.8,12,8,4,332.2688977714689,0.4833587398373984,0.1626271121645384,0.17214766791732936,126468.25034493944,204.29322903984007,126672.54357397929,109,0,24.21951219512195,36,5,15,40.18067062248097,0.5844907407407407,48.53603603603603,1005.8558558558551,27.94044044044042,0
115,4,1,3,36,0.02564102564102564,0.07692307692307693,0.9230769230769231,39,750,400,350,0.5333333333333333,11,4,7,339.62167097462816,0.4807411156095367,0.14545840632797158,0.17638415815133893,126567.38281249977,797.0052083333046,127364.38802083307,95,0,23.333333333333332,35,4,17,39.89389233954451,0.5875,48.437499999999986,1006.2499999999982,28.749999999999947,0
116,4,2,2,36,0.05263157894736842,0.05263157894736842,0.9473684210526316,38,1000,700,300,0.7,13,7,6,347.66020369698845,0.480174253200569,0.1588225770294165,0.18049287725104105,126552.40929705223,1199.447278911573,127751.8565759638,96,0,24.657894736842106,34,4,18,39.70707130462218,0.5894607843137255,48.452380952380956,1006.1904761904768,29.593837535014025,0
117,4,2,2,36,0.05263157894736842,0.05263157894736842,0.9473684210526316,38,1100,600,500,0.5454545454545454,16,6,10,340.77093117825166,0.480174253200569,0.1674360988579371,0.17901778109545077,127033.66796339177,1057.8762645747765,128091.54422796654,97,0,25.105263157894736,35,3,21,39.38624186758516,0.5922619047619048,47.974537037037045,1008.1018518518529,28.802910052910082,0
118,4,1,1,36,0.02702702702702703,0.02702702702702703,0.972972972972973,37,1250,900,350,0.72,16,9,7,345.65656105398693,0.4789476976976977,0.1608863997346408,0.1823844145934925,127212.0819161,1394.3381519274585,128606.42006802745,98,0,26.135135135135137,34,3,22,39.08007827865625,0.5962009803921569,47.79761904761906,1008.8095238095257,29.670868347338992,0
119,4,1,2,35,0.02702702702702703,0.05405405405405406,0.9459459459459459,37,950,600,350,0.631578947368421,13,6,7,344.9314255613181,0.4794794794794795,0.14857059110271442,0.1832218711982884,127482.44224773263,1394.5401077097792,128876.98235544241,99,0,25.37837837837838,34,3,19,38.821269990962335,0.5989583333333333,47.52976190476192,1009.8809523809541,29.702380952381002,0
120,4,1,2,34,0.027777777777777776,0.05555555555555555,0.9444444444444444,36,1450,1100,350,0.7586206896551724,18,11,7,356.8787238503551,0.47622354497354497,0.16435998976306854,0.19079018749459364,127741.58564314211,1917.6508133890823,129659.2364565312,100,0,25.88888888888889,33,3,21,38.254005536024565,0.6038510101010102,47.27328431372549,1010.9068627450985,30.633541295306014,0
121,4,1,3,32,0.02857142857142857,0.08571428571428572,0.9142857142857143,35,1050,700,350,0.6666666666666666,14,7,7,358.8155255368991,0.4756652661064426,0.15563402889245603,0.19237699863122917,127857.05061983477,2175.418962350791,130032.46958218556,87,0,24.0,32,3,22,38.08676654182271,0.607421875,47.159090909090914,1011.3636363636368,31.60511363636365,0
122,4,2,0,34,0.058823529411764705,0.0,1.0,34,1100,700,400,0.6363636363636364,15,7,8,358.77517164759007,0.4702168746286393,0.13120572737512903,0.1945386488215954,128309.3791537812,2407.166736557208,130716.54589033841,88,0,22.470588235294116,31,3,24,37.62490361136099,0.6145833333333333,46.712239583333314,1013.1510416666646,32.6822916666666,0
123,4,1,0,35,0.02857142857142857,0.0,1.0,35,1750,1300,450,0.7428571428571429,22,13,9,353.60603697928315,0.46883753501400566,0.1339232409381672,0.194193479324688,128816.57483930195,2110.063705234144,130926.6385445361,89,0,22.8,32,3,22,37.2380286069652,0.6171875,46.212121212121204,1015.1515151515138,31.723484848484805,0
124,4,0,0,35,0.0,0.0,1.0,35,1150,900,250,0.782608695652174,14,9,5,356.0135723715022,0.4681022408963585,0.12581907174741036,0.1963404192539838,128983.44574502573,2183.9714592944715,131167.4172043202,90,1,23.8,33,2,23,37.00675091486709,0.6164772727272727,46.047794117647044,1015.80882352941,30.782085561497272,0
125,4,0,1,34,0.0,0.02857142857142857,0.9714285714285714,35,1300,1000,300,0.7692307692307693,16,10,6,354.16364292346805,0.46782212885154056,0.12158450643555052,0.1956276324769135,129045.69644187314,2140.6587910899466,131186.35523296308,91,2,24.8,33,2,23,36.99028565110764,0.6171085858585859,45.98651960784313,1016.0539215686259,30.789512774806845,0
126,4,0,1,33,0.0,0.029411764705882353,0.9705882352941176,34,950,400,550,0.42105263157894735,15,4,11,354.82736005555387,0.46769162210338683,0.10753379612714697,0.1964484352439619,129137.21335833067,2364.283300173447,131501.49665850413,92,3,25.38235294117647,32,2,23,36.88017598343688,0.6204427083333333,45.89646464646464,1016.4141414141405,31.762941919191892,0
127,4,0,1,32,0.0,0.030303030303030304,0.9696969696969697,33,850,500,350,0.5882352941176471,12,5,7,364.0623054235597,0.46681660353535354,0.096631185024729,0.20155108908768124,129135.2081298828,2802.652316623264,131937.86044650606,93,4,25.939393939393938,31,2,24,36.64755743445214,0.622983870967742,45.8984375,1016.4062499999999,32.78729838709677,0
128,4,1,0,33,0.030303030303030304,0.0,1.0,33,950,700,250,0.7368421052631579,12,7,5,362.85008385782015,0.46756628787878785,0.09139797462460675,0.2015547051870255,129267.58660210513,2780.9509277343855,132048.53752983952,94,0,26.545454545454547,31,2,25,36.543427230046966,0.6243279569892473,45.76822916666667,1016.9270833333342,32.80409946236562,0
129,4,0,2,31,0.0,0.06060606060606061,0.9393939393939394,33,1300,1000,300,0.7692307692307693,16,10,6,366.0758342596189,0.46586963383838387,0.08690797431841402,0.20437490861237023,129466.28146701399,2878.895399305566,132345.17686631955,95,1,27.545454545454547,31,2,16,36.2589559877175,0.6263440860215054,45.57291666666667,1017.7083333333342,32.829301075268845,0
130,4,1,3,29,0.03125,0.09375,0.90625,32,700,500,200,0.7142857142857143,9,5,4,361.6408897583168,0.4646967405913978,0.05347789984670426,0.20395712428156387,129864.12896050364,2992.83582899308,132856.96478949673,75,0,25.0,31,1,17,35.96704138988247,0.6303763440860215,45.18229166666668,1019.2708333333347,32.879704301075314,0
131,4,1,0,30,0.03333333333333333,0.0,1.0,30,800,400,400,0.5,12,4,8,381.012587022964,0.46333812260536394,0.051336606655755235,0.21357678043213857,129625.3472222223,3877.7777777777887,133503.1250000001,76,0,26.0,29,1,18,35.71672122204037,0.6336206896551724,45.41666666666667,1018.333333333334,35.114942528735654,0
132,4,0,1,29,0.0,0.03333333333333333,0.9666666666666667,30,1000,600,400,0.6,14,6,8,379.89491490500114,0.4610632183908046,0.05349956851523774,0.21430044431113018,129872.97694830246,3867.6167052469045,133740.59365354935,77,1,27.0,29,1,20,35.49288617886178,0.6361350574712643,45.17361111111111,1019.3055555555554,35.148467432950184,0
133,4,2,2,29,0.06451612903225806,0.06451612903225806,0.935483870967742,31,850,600,250,0.7058823529411765,11,6,5,368.52790089213255,0.4582885304659498,0.05318737871910373,0.2103460903889955,130331.20022907265,3406.136728234469,133737.33695730712,78,0,26.70967741935484,30,1,23,35.31684656223949,0.6378472222222222,44.72446236559139,1021.1021505376339,34.03673835125446,0
134,4,1,0,30,0.03333333333333333,0.0,1.0,30,1000,800,200,0.8,12,8,4,379.67513536026655,0.4584530651340996,0.0651700680272107,0.21632653061224483,130262.58680555543,3891.4930555555366,134154.07986111098,79,0,27.833333333333332,29,1,24,35.10204081632652,0.6400862068965517,44.79166666666666,1020.8333333333323,35.20114942528732,0
135,4,1,0,31,0.03225806451612903,0.0,1.0,31,800,600,200,0.75,10,6,4,368.47975303565437,0.4595878136200717,0.05987510817736008,0.21162538082198726,130571.48947855226,3422.59003931088,133994.07951786314,80,0,27.903225806451612,30,1,20,35.07419340697878,0.6402777777777777,44.489247311827945,1022.0430107526868,34.06810035842289,0
136,4,0,2,29,0.0,0.06451612903225806,0.935483870967742,31,1250,900,350,0.72,16,9,7,370.21235627313075,0.45788530465949817,0.07206886467379547,0.2139473229760663,130812.00003251794,3485.6437521678454,134297.6437846858,81,1,28.903225806451612,30,1,22,34.786000525555124,0.6427083333333333,44.2540322580645,1022.9838709677398,34.09946236559133,0
137,4,0,0,29,0.0,0.0,1.0,29,900,600,300,0.6666666666666666,12,6,6,381.6000887395728,0.4566399835796387,0.04665149088047671,0.21982314971054234,130688.28124999978,4174.131944444416,134862.4131944442,80,2,29.0,29,0,23,34.62034773159468,0.6443965517241379,44.374999999999986,1022.4999999999983,35.25862068965511,0
138,4,1,0,30,0.03333333333333333,0.0,1.0,30,850,500,350,0.5882352941176471,12,5,7,371.4854943791295,0.4560584291187739,0.05815295815295762,0.21699876809594654,131224.818710978,3749.623330731851,134974.44204170984,81,0,29.0,30,0,24,34.335235471599105,0.646875,43.85080645161289,1024.5967741935472,34.15322580645157,0
139,4,0,0,30,0.0,0.0,1.0,30,950,500,450,0.5263157894736842,14,5,9,371.2252172379194,0.4552442528735632,0.050535378698484124,0.21762757354908582,131362.56946250988,3753.0196771302813,135115.58913964016,82,1,30.0,30,0,24,34.202504261177424,0.6482638888888889,43.71639784946235,1025.1344086021486,34.17114695340495,0
140,4,0,0,30,0.0,0.0,1.0,30,1150,900,250,0.782608695652174,14,9,5,373.06074352979994,0.45469348659003833,0.04740061162079523,0.21929533691312555,131465.92994854876,3808.955515088425,135274.88546363718,83,2,31.0,30,0,24,34.050895587592834,0.6493055555555556,43.61559139784945,1025.5376344086005,34.18458781362002,0
141,4,0,0,30,0.0,0.0,1.0,30,950,600,350,0.631578947368421,13,6,7,373.15104187936885,0.4538793103448276,0.048187931185049715,0.22014181249668469,131603.80715978716,3821.6195513932153,135425.42671118036,84,3,32.0,30,0,20,33.90915640555411,0.6506944444444445,43.48118279569892,1026.0752688172036,34.202508960573454,0
142,4,0,1,29,0.0,0.03333333333333333,0.9666666666666667,30,800,600,200,0.75,10,6,4,373.14610745931463,0.45352011494252875,0.04994106090373274,0.22033801472945602,131638.28775364198,3824.0629335761314,135462.3506872181,85,4,33.0,30,0,20,33.87442698100851,0.6510416666666667,43.44758064516129,1026.2096774193544,34.20698924731182,0
143,4,0,0,29,0.0,0.0,1.0,29,650,400,250,0.6153846153846154,9,4,5,383.1364275575262,0.4536124794745484,0.03697582565337987,0.22566552264273418,131541.75347222213,4279.6874999999945,135821.44097222213,67,5,32.206896551724135,29,0,24,33.715813701597625,0.6530172413793103,43.541666666666664,1025.8333333333328,35.373563218390785,0
144,4,0,2,27,0.0,0.06896551724137931,0.9310344827586207,29,950,700,250,0.7368421052631579,12,7,5,412.9332786319913,0.4533559113300492,0.05827433475718191,0.21360827916816752,126404.78689803806,4975.459728828115,131380.24662686617,68,6,33.206896551724135,28,1,16,38.2179597085298,0.6037946428571428,48.599137931034484,1005.6034482758621,35.914408866995075,16
145,4,0,1,26,0.0,0.037037037037037035,0.962962962962963,27,900,800,100,0.8888888888888888,10,8,2,426.9848227777852,0.45251661918328584,0.03439388455675085,0.22014164069016498,126268.08080002839,5382.910820578236,131650.99162060663,69,7,33.03703703703704,27,0,16,38.00648998124569,0.6057098765432098,48.73511904761905,1005.0595238095241,37.22442680776015,0
146,4,3,1,28,0.10344827586206896,0.034482758620689655,0.9655172413793104,29,1050,800,250,0.7619047619047619,13,8,5,404.2925494864552,0.45535714285714285,0.06556878144557587,0.21402827129934793,127345.6724179217,4499.6607707812445,131845.33318870293,70,0,31.310344827586206,28,1,17,37.46352313167259,0.6134672619047619,47.665229885057464,1009.3390804597694,36.04782430213462,0
147,4,1,0,29,0.034482758620689655,0.0,1.0,29,1250,900,350,0.72,16,9,7,407.7711491032933,0.45243226600985226,0.09049702802428539,0.2182118308927662,127781.10394784651,4621.089518100149,132402.19346594665,71,0,32.275862068965516,28,1,18,36.92713514281654,0.6179315476190477,47.23419540229885,1011.0632183908048,36.10940065681446,0
148,4,2,0,31,0.06451612903225806,0.0,1.0,31,850,300,550,0.35294117647058826,14,3,11,386.88043861137913,0.4530913978494624,0.08649452677201364,0.21142553730630553,128621.28434284315,3752.211780263619,132373.49612310677,72,0,31.129032258064516,30,1,18,36.59345876948898,0.6204861111111111,46.40456989247312,1014.3817204301079,33.81272401433693,0
149,4,1,0,32,0.03125,0.0,1.0,32,1050,600,450,0.5714285714285714,15,6,9,376.80000605714116,0.4539440524193548,0.09017765602973249,0.20808000334493096,129035.96878051768,3324.1507636176366,132360.11954413532,73,0,31.125,31,1,20,36.42522640864625,0.6219758064516129,45.99609375000001,1016.0156250000008,32.77469758064519,0
150,4,0,0,32,0.0,0.0,1.0,32,900,600,300,0.6666666666666666,12,6,6,378.0560118140255,0.45369203629032256,0.09318960548225941,0.20947361846927604,129168.29639010968,3366.5701972113816,132534.86658732107,74,1,32.125,31,1,20,36.25819243414029,0.6233198924731183,45.86588541666667,1016.536458333334,32.791498655914005,0
151,4,0,1,31,0.0,0.03125,0.96875,32,950,700,250,0.7368421052631579,12,7,5,378.630764917757,0.45438508064516125,0.09307778489116525,0.21032050312999184,129267.58660210519,3388.9370388455104,132656.5236409507,75,2,33.125,31,1,20,36.142232180964605,0.6243279569892473,45.76822916666668,1016.9270833333346,32.804099462365635,0
152,4,2,2,31,0.06060606060606061,0.06060606060606061,0.9393939393939394,33,750,300,450,0.4,12,3,9,367.62537027236755,0.4568339646464647,0.09039076936945034,0.20654606457921057,129715.36705438235,2937.3319686766854,132652.69902305905,76,0,32.515151515151516,32,1,18,35.96590439596761,0.6263020833333333,45.32828282828284,1018.68686868687,31.833964646464686,0
153,4,0,1,30,0.0,0.03225806451612903,0.967741935483871,31,850,300,550,0.35294117647058826,14,3,11,388.27608119241154,0.4531810035842294,0.10498898016429536,0.21587693654540618,129303.89577191009,3841.1219866458587,133145.01775855594,77,4,35.61290322580645,30,1,20,35.859929078014176,0.6274305555555555,45.73252688172043,1017.0698924731187,33.902329749103956,0
154,4,1,1,30,0.03225806451612903,0.03225806451612903,0.967741935483871,31,950,800,150,0.8421052631578947,11,8,3,451.0129497536291,0.4543458781362007,0.008258922586008133,0.22893188968507017,125625.7812500002,5554.119153948463,131179.90040394868,78,0,35.0,29,2,15,38.07148794679967,0.5926724137931034,49.375000000000014,1002.5000000000016,34.56896551724144,16
155,4,5,3,32,0.14285714285714285,0.08571428571428572,0.9142857142857143,35,1400,1000,400,0.7142857142857143,18,10,8,407.07601939758246,0.46197478991596636,0.022904368358914073,0.21415738411785834,127092.01388888873,3347.2222222222013,130439.23611111093,79,0,30.8,33,2,16,37.65495867768595,0.5972222222222222,47.91666666666666,1008.333333333332,30.555555555555515,0
156,4,3,1,34,0.08571428571428572,0.02857142857142857,0.9714285714285714,35,1100,800,300,0.7272727272727273,14,8,6,406.61390971336294,0.4603641456582633,0.05194237869884044,0.2160480483525351,127493.93449935106,3368.1614343040937,130862.09593365516,80,0,31.514285714285716,33,2,16,37.252128584718676,0.6013257575757576,47.51838235294117,1009.926470588234,30.6038324420677,0
157,4,0,3,31,0.0,0.08823529411764706,0.9117647058823529,34,900,600,300,0.6666666666666666,12,6,6,412.5518749999997,0.46059863339275103,0.05446323529411767,0.2194424867021276,127538.00632588525,3723.2087287011645,131261.2150545864,81,1,32.794117647058826,32,2,16,37.05677083333332,0.6041666666666667,47.47474747474748,1010.1010101010112,31.5656565656566,0
158,4,2,0,33,0.06060606060606061,0.0,1.0,33,700,400,300,0.5714285714285714,10,4,6,432.68108980042706,0.46046401515151514,0.09085167705857344,0.21584979130119591,124905.32096533506,4264.329054433205,129169.65001976828,82,0,32.303030303030305,32,1,15,39.28176708349121,0.5771484375,50.09469696969696,999.6212121212113,31.238162878787854,15
159,4,5,6,32,0.13157894736842105,0.15789473684210525,0.8421052631578947,38,1050,400,650,0.38095238095238093,17,4,13,394.152604116376,0.4690908013276434,0.11111569517298281,0.20392715844491538,126411.62065782008,2370.259183826456,128781.87984164653,83,0,28.92105263157895,36,2,16,38.68304404628593,0.583912037037037,48.59234234234235,1005.6306306306315,27.934184184184208,0
160,4,6,5,33,0.15789473684210525,0.13157894736842105,0.868421052631579,38,800,500,300,0.625,11,5,6,382.59219644024694,0.47149122807017546,0.12321604980459666,0.2014256367958565,127122.02558106571,2130.8312975482313,129252.85687861394,84,0,28.07894736842105,34,4,19,38.241254476055566,0.595281862745098,47.88690476190476,1008.4523809523805,29.66036414565825,0
161,4,0,0,33,0.0,0.0,1.0,33,1350,1000,350,0.7407407407407407,17,10,7,418.6535714942087,0.46417297979797983,0.12823670726330016,0.21785288981408824,126646.80262218144,4004.2272472196773,130651.02986940111,82,1,30.636363636363637,32,1,19,37.82352818197024,0.5950520833333333,48.35858585858586,1006.5656565656568,31.455176767676775,0
162,4,3,2,34,0.08333333333333333,0.05555555555555555,0.9444444444444444,36,1100,600,500,0.5454545454545454,16,6,10,390.1695855197078,0.4666832010582011,0.12786136051120245,0.2074695305711893,127524.87775134572,2752.8280797162934,130277.705831062,83,0,29.0,33,3,20,37.635484914664715,0.6016414141414141,47.48774509803922,1010.0490196078438,30.60754604872254,0
163,4,1,1,34,0.02857142857142857,0.02857142857142857,0.9714285714285714,35,850,500,350,0.5882352941176471,12,5,7,390.351809708917,0.4643557422969187,0.12326451434113905,0.20852472321756124,127710.61610918868,2970.4140234525057,130681.03013264119,84,0,29.428571428571427,33,2,21,37.439884416424164,0.6035353535353536,47.303921568627445,1010.7843137254895,30.629827688651197,0
164,4,1,1,34,0.02857142857142857,0.02857142857142857,0.9714285714285714,35,1000,600,400,0.6,14,6,8,372.8908465619676,0.4632002801120448,0.11503645419764652,0.18588186028869882,124873.76925823904,2322.2435202969964,127196.01277853604,85,0,30.142857142857142,32,3,20,40.80869967997303,0.5768229166666667,50.12626262626263,999.4949494949503,31.234217171717198,16
165,4,3,2,35,0.08108108108108109,0.05405405405405406,0.9459459459459459,37,1150,900,250,0.782608695652174,14,9,5,358.45540262919616,0.46549674674674674,0.13662077131149908,0.18221302693697758,125685.46095521543,1610.5265022675737,127295.987457483,86,0,29.324324324324323,34,3,20,40.32955399897105,0.5805759803921569,49.31547619047619,1002.7380952380954,29.49229691876751,0
166,4,3,2,36,0.07894736842105263,0.05263157894736842,0.9473684210526316,38,1200,800,400,0.6666666666666666,16,8,8,350.02408151343684,0.46734234234234234,0.14086026870922197,0.17987230205909743,126133.5104875283,1230.4634353741399,127363.97392290244,87,0,29.263157894736842,34,4,23,40.07885952437384,0.585171568627451,48.86904761904761,1004.5238095238092,29.544817927170858,0
167,4,1,2,35,0.02702702702702703,0.05405405405405406,0.9459459459459459,37,750,500,250,0.6666666666666666,10,5,5,347.133582023174,0.466529029029029,0.14613102196872152,0.17974292161919173,126444.09789804397,1378.5985258073733,127822.69642385135,88,0,29.45945945945946,33,4,15,39.83172393485235,0.5905934343434344,48.56004901960784,1005.7598039215682,30.477569815805097,0
168,4,2,3,34,0.05405405405405406,0.08108108108108109,0.9189189189189189,37,1050,700,350,0.6666666666666666,14,7,7,352.22406542957435,0.46646646646646645,0.1451513625426668,0.18292927269084347,126567.38281250003,1516.0156250000014,128083.39843750003,89,0,30.35135135135135,33,4,15,39.576863354037265,0.5918560606060606,48.4375,1006.2500000000002,30.49242424242425,0
169,4,0,4,30,0.0,0.11764705882352941,0.8823529411764706,34,1000,900,100,0.9,11,9,2,448.15320118006275,0.46258541295306,0.12645789250952122,0.22215868389453916,124641.06264037537,4930.469008042692,129571.53164841807,90,2,31.91176470588235,28,6,19,39.1714628297362,0.5855654761904762,50.35919540229886,998.5632183908059,35.662972085385924,16
170,4,4,2,32,0.11764705882352941,0.058823529411764705,0.9411764705882353,34,1350,900,450,0.6666666666666666,18,9,9,420.6202705442528,0.4638294711824124,0.1908601053190191,0.21118948078545927,125173.67139274692,3731.148875943181,128904.8202686901,91,0,30.676470588235293,29,5,22,39.30357969003009,0.5880028735632183,49.82638888888889,1000.6944444444446,34.50670498084292,16
171,4,1,3,30,0.030303030303030304,0.09090909090909091,0.9090909090909091,33,1000,700,300,0.7,13,7,6,420.90193755192956,0.46366003787878785,0.1937277430625548,0.21328850992799997,125556.17283950596,3969.367283950586,129525.54012345655,92,0,32.03030303030303,29,4,17,38.89851256467111,0.5919540229885057,49.44444444444443,1002.2222222222205,34.55938697318002,0
172,4,1,0,31,0.03225806451612903,0.0,1.0,31,1100,600,500,0.5454545454545454,16,6,10,430.49806208284656,0.462679211469534,0.18905500235764072,0.21863285860364645,125647.38778240191,4618.191389219187,130265.5791716211,93,0,33.064516129032256,28,3,18,38.563162797363155,0.5959821428571428,49.35344827586207,1002.5862068965517,35.806650246305416,0
173,4,3,2,32,0.08823529411764706,0.058823529411764705,0.9411764705882353,34,1150,1100,50,0.9565217391304348,12,11,1,396.3557271234878,0.4651663695781343,0.1686986095666363,0.20620171963129336,126637.27092978396,3239.9304466042067,129877.20137638817,94,0,31.058823529411764,29,5,19,38.394479324778075,0.6030890804597702,48.36805555555556,1006.5277777777778,34.70785440613027,0
174,4,2,0,34,0.058823529411764705,0.0,1.0,34,900,700,200,0.7777777777777778,11,7,4,385.42130302281555,0.46446078431372545,0.16430358305167192,0.20259601919930878,127058.13397863905,2994.1823115388966,130052.31629017794,95,0,31.205882352941178,30,4,21,38.23573523530197,0.6045138888888889,47.9502688172043,1008.1989247311819,33.60663082437273,0
175,4,1,2,33,0.02857142857142857,0.05714285714285714,0.9428571428571428,35,1200,1000,200,0.8333333333333334,14,10,4,373.8354193197511,0.46558123249299715,0.09782559018439452,0.1824720992679648,123991.01494917805,2270.4511294995705,126261.46607867762,96,0,31.285714285714285,33,2,17,41.7029397891801,0.5653409090909092,51.011029411764696,995.9558823529399,30.18048128342242,15
176,4,6,5,34,0.15384615384615385,0.1282051282051282,0.8717948717948718,39,1000,700,300,0.7,13,7,6,341.27516677730085,0.4723065677013045,0.10412833844376301,0.17243062279378504,125434.40453800152,773.795631321017,126208.20016932253,97,0,26.692307692307693,35,4,14,41.01928076256499,0.5758928571428572,49.56597222222222,1001.736111111111,28.621031746031743,0
177,4,1,1,34,0.02857142857142857,0.02857142857142857,0.9714285714285714,35,1100,600,500,0.5454545454545454,16,6,10,378.39607787405487,0.4663865546218487,0.13241160321503043,0.18893556766913766,124942.13632758897,2455.5228695130095,127397.65919710198,98,0,30.6,35,0,18,40.600158215636355,0.5708333333333333,50.05787037037036,999.7685185185169,28.564814814814767,0
178,4,6,10,30,0.15,0.25,0.75,40,1300,900,400,0.6923076923076923,17,9,8,334.6985748742831,0.4731436965811966,0.10800257876443542,0.17185818015565552,126100.38406227196,441.177351024721,126541.56141329667,99,0,27.525,36,4,16,40.49781365623949,0.5807291666666667,48.90202702702704,1004.3918918918937,27.899774774774826,0
179,4,2,0,32,0.0625,0.0,1.0,32,700,400,300,0.5714285714285714,10,4,6,391.0933439144821,0.4671538978494623,0.13055682114032763,0.19585261199159412,125065.11264377178,3382.4266221788243,128447.5392659506,100,0,33.25,31,1,20,40.15501605484681,0.5813172043010753,49.934895833333336,1000.2604166666673,32.26646505376346,0
180,4,6,1,37,0.15789473684210525,0.02631578947368421,0.9736842105263158,38,1050,800,250,0.7619047619047619,13,8,5,361.69998050077777,0.47278034613560926,0.16605450978755343,0.17456127544452538,123512.33570986541,1402.1731433384034,124914.5088532038,101,0,28.842105263157894,36,2,17,42.50358747781429,0.5541087962962963,51.492117117117125,994.0315315315327,27.61198698698702,16
181,4,3,1,39,0.075,0.025,0.975,40,1300,900,400,0.6923076923076923,17,9,8,360.5160741083465,0.46988514957264954,0.205736224028906,0.177373908461307,124325.23739956216,965.8725448421858,125291.10994440435,102,0,28.3,36,4,16,41.68713301716349,0.5625,50.6756756756757,997.2972972973009,27.702702702702805,0
182,4,5,4,40,0.11363636363636363,0.09090909090909091,0.9090909090909091,44,1350,800,550,0.5925925925925926,19,8,11,333.685962601724,0.47460799859055675,0.21078069657615028,0.168484059805461,125406.83455615076,-430.69993885911515,124976.13461729164,103,0,26.613636363636363,40,4,15,41.237782399891756,0.5666666666666667,49.593495934959364,1001.6260162601652,25.04065040650413,0
183,4,2,2,40,0.047619047619047616,0.047619047619047616,0.9523809523809523,42,900,400,500,0.4444444444444444,14,4,10,356.23014399999977,0.47080671699574134,0.2384990476190474,0.1798415508885299,125400.96205210398,534.3205539119083,125935.28260601588,104,0,28.761904761904763,38,4,17,40.679333333333325,0.5699013157894737,49.59935897435898,1001.6025641025649,26.35796221322539,0
184,4,7,4,43,0.14893617021276595,0.0851063829787234,0.9148936170212766,47,1400,900,500,0.6428571428571429,19,9,10,328.53038421548223,0.47475331483194577,0.22672057234415188,0.1660096012274691,125438.98122499211,-850.9439977890561,124588.03722720305,105,0,26.02127659574468,37,10,19,41.333734676007,0.572072072072072,49.56140350877192,1001.7543859649106,27.074442863916502,16
185,4,3,3,43,0.06521739130434782,0.06521739130434782,0.9347826086956522,46,1000,600,400,0.6,14,6,8,324.16687149122436,0.47423510466988733,0.23495734171531213,0.1651989983549099,125789.53108513913,-1044.6402483564702,124744.89083678265,106,0,27.195652173913043,36,10,22,41.08198622960635,0.5775462962962963,49.21171171171171,1003.1531531531525,27.86536536536535,0
186,4,6,5,44,0.12244897959183673,0.10204081632653061,0.8979591836734694,49,1050,500,550,0.47619047619047616,16,5,11,297.5434514420621,0.47590702947845803,0.2594746171627309,0.1579620053822205,127459.90125868034,-2214.7714093950617,125245.12984928528,97,0,23.632653061224488,39,10,15,40.04066088989753,0.5892094017094017,47.55208333333332,1009.7916666666649,25.89209401709397,0
187,4,1,3,42,0.022222222222222223,0.06666666666666667,0.9333333333333333,45,1350,900,450,0.6666666666666666,18,9,9,357.3945456418499,0.473063973063973,0.20779462159493534,0.17485825212605108,124090.20317925364,-130.1676432291473,123960.0355360245,98,0,26.31111111111111,39,6,18,42.009169715978395,0.5547542735042735,50.91145833333334,996.3541666666681,25.54754273504277,16
188,4,10,9,43,0.19230769230769232,0.17307692307692307,0.8269230769230769,52,1050,700,350,0.6666666666666666,14,7,7,317.40728727500556,0.4772184514831574,0.23525709107924042,0.16217993459828461,125897.92460076,-2394.5241550894816,123503.40044567052,99,0,23.423076923076923,42,10,13,41.140050207589056,0.5687003968253967,49.103682170542626,1003.5852713178281,23.89488741232924,0
189,4,5,6,42,0.10416666666666667,0.125,0.875,48,1400,900,500,0.6428571428571429,19,9,10,357.31906662776385,0.47588837174940896,0.2918973103399336,0.18262542502182877,125909.76902074656,-602.0077708379022,125307.76124990867,100,0,26.145833333333332,38,10,17,40.1264548293237,0.575109649122807,49.09188034188034,1003.6324786324784,26.411381016644167,0
190,4,0,1,41,0.0,0.023809523809523808,0.9761904761904762,42,1150,700,450,0.6086956521739131,16,7,9,375.72183004566693,0.47368612078977934,0.2856775382597536,0.19099004070456563,125685.4609552154,1044.5542800453504,126730.01523526075,101,1,29.428571428571427,34,8,18,39.89671138549209,0.5805759803921569,49.31547619047619,1002.7380952380952,29.492296918767504,0
191,4,7,6,42,0.14583333333333334,0.125,0.875,48,1650,1300,350,0.7878787878787878,20,13,7,325.26283888658895,0.4759068410165485,0.26509441447159654,0.17283359280466112,127496.31461620632,-1297.1902715721521,126199.12434463417,102,0,24.708333333333332,38,10,16,39.30366021368879,0.591282894736842,47.516025641025635,1009.9358974358964,26.57726045883938,0
192,4,0,4,38,0.0,0.09523809523809523,0.9047619047619048,42,1650,1200,450,0.7272727272727273,21,12,9,369.2456225653756,0.470201800232288,0.2965777327479462,0.19282826956191793,126792.09183673444,963.4849773242356,127755.57681405867,103,1,28.928571428571427,34,8,17,38.91720843183611,0.5919117647058824,48.2142857142857,1007.1428571428551,29.621848739495736,0
193,4,5,4,39,0.11627906976744186,0.09302325581395349,0.9069767441860466,43,1800,1200,600,0.6666666666666666,24,12,12,351.7908385588268,0.4722914359542267,0.2745624550467516,0.18749291945168214,127617.73003472204,378.9496527777528,127996.6796874998,104,0,28.441860465116278,35,8,18,38.50945017182131,0.5982142857142857,47.39583333333332,1010.4166666666652,28.869047619047574,0
194,4,1,0,40,0.025,0.0,1.0,40,1900,1500,400,0.7894736842105263,23,15,8,374.87910634103395,0.4702724358974359,0.2797320981472211,0.19752864785304602,127155.67926742163,1533.6014819916245,128689.28074941326,105,0,31.375,32,8,20,38.40109122016358,0.6002604166666667,47.85353535353535,1008.585858585858,31.518308080808062,0
195,4,1,4,37,0.024390243902439025,0.0975609756097561,0.9024390243902439,41,1200,800,400,0.6666666666666666,16,8,8,377.0975604937529,0.47080792682926825,0.30620283409429616,0.2014443444917406,127710.61610918876,1431.872356785855,129142.48846597462,106,0,31.585365853658537,33,8,19,37.77481409634659,0.6035353535353536,47.30392156862745,1010.7843137254902,30.62982768865122,0
196,4,1,0,38,0.02631578947368421,0.0,1.0,38,1750,1300,450,0.7428571428571429,22,13,9,381.0005196649224,0.46673482693219537,0.2888105288663865,0.20447193038454314,127896.48963139197,2145.725802575956,130042.21543396793,107,0,32.71052631578947,33,5,20,37.485360633228346,0.6054292929292929,47.1200980392157,1011.5196078431388,30.652109328579964,0
197,4,1,1,38,0.02564102564102564,0.02564102564102564,0.9743589743589743,39,1550,1200,350,0.7741935483870968,19,12,7,374.26010712144085,0.4660368870895187,0.2928750835727578,0.2034770467453353,128415.88010204097,1812.188208616803,130228.06831065778,108,0,32.84615384615385,34,5,19,37.1236590713335,0.6084558823529411,46.60714285714287,1013.5714285714298,29.810924369747937,0
198,4,2,1,39,0.05,0.025,0.975,40,1350,900,450,0.6666666666666666,18,9,9,357.5125124169851,0.46434294871794873,0.27196434673653,0.19752060078720682,129054.34355977809,1227.7085208762146,130282.0520806543,109,0,32.55,35,5,21,36.89640524737062,0.612797619047619,45.97800925925927,1016.0879629629641,29.031084656084687,0
199,4,0,1,38,0.0,0.02564102564102564,0.9743589743589743,39,1200,700,500,0.5833333333333334,17,7,10,362.9706749882718,0.46404071075123704,0.17076662761942019,0.18507234181166693,125811.49798525368,1333.1768689986175,127144.6748542523,110,1,32.84615384615385,35,4,17,40.086140593754806,0.5797619047619047,49.18981481481481,1003.24074074074,28.664021164021143,16
200,4,2,1,39,0.05,0.025,0.975,40,1300,900,400,0.6923076923076923,17,9,8,362.3561539412458,0.4641693376068376,0.20371761504791208,0.18826039147297777,126582.35721371876,1174.0078927661518,127756.36510648491,111,0,32.1,34,6,18,39.306557829567396,0.5897671568627452,48.422619047619044,1006.3095238095233,29.597338935574214,0
201,4,0,0,39,0.0,0.0,1.0,39,1050,700,350,0.6666666666666666,14,7,7,365.53228364821666,0.4637876743139901,0.20238184405662474,0.1905592158917351,126721.57343329476,1464.1652249134738,128185.73865820824,112,1,33.15384615384615,33,6,18,39.083292762090224,0.5934343434343434,48.284313725490186,1006.8627450980382,30.51099227569813,0
202,4,2,1,40,0.04878048780487805,0.024390243902439025,0.975609756097561,41,1300,800,500,0.6153846153846154,18,8,10,350.22602752997045,0.4653201219512195,0.19680244938362512,0.18506956417356774,127272.13718820845,715.3436619745688,127987.48085018301,113,0,32.48780487804878,34,7,20,38.903226757904655,0.5968137254901961,47.73809523809523,1009.0476190476178,29.677871148459346,0
203,4,2,3,39,0.047619047619047616,0.07142857142857142,0.9285714285714286,42,1150,800,350,0.6956521739130435,15,8,7,345.5376220332785,0.46593108788230736,0.20908853187768717,0.18563886626876952,127939.5351750039,441.58454968274265,128381.11972468664,114,0,32.45238095238095,35,7,20,38.33812397513634,0.6014880952380952,47.077546296296276,1011.6898148148117,28.905423280423193,0
204,4,1,1,39,0.025,0.025,0.975,40,1150,700,450,0.6086956521739131,16,7,9,345.07139450847774,0.4656784188034188,0.19338762789603692,0.18605846972134346,128084.27047902496,839.6435657596386,128923.9140447846,115,0,33.45,34,6,21,38.20195813242386,0.6050857843137255,46.93452380952381,1012.2619047619048,29.772408963585434,0
205,4,0,0,39,0.0,0.0,1.0,39,1250,600,650,0.48,19,6,13,349.2803498877288,0.4659244264507422,0.1881045508164152,0.18831956201518535,128082.49831795464,1147.3399653979259,129229.83828335257,116,1,34.76923076923077,33,6,21,38.097255851493124,0.6073232323232323,46.93627450980392,1012.2549019607844,30.674390968508618,0
206,4,1,2,38,0.025,0.05,0.95,40,1200,700,500,0.5833333333333334,17,7,10,344.93333099842863,0.4655715811965812,0.09744735162731377,0.17721656710640568,126124.31171926354,700.895792241939,126825.20751150548,117,0,34.875,38,2,21,40.21617740906191,0.5773026315789473,48.878205128205124,1004.4871794871788,26.433873144399442,16
207,4,3,2,39,0.07317073170731707,0.04878048780487805,0.9512195121951219,41,1500,900,600,0.6,21,9,12,331.65813318260615,0.4662855691056911,0.12688577858058325,0.17313557406098454,126777.10503472215,209.33159722221856,126986.43663194437,118,0,34.26829268292683,39,2,17,39.87898220935044,0.5822649572649572,48.229166666666664,1007.0833333333327,25.822649572649556,0
208,4,1,2,38,0.025,0.05,0.95,40,1100,600,500,0.5454545454545454,16,6,10,341.7991057068475,0.46569177350427354,0.13406342808655047,0.17862982087606186,126822.836766747,669.5864380159212,127492.42320476292,119,0,35.625,38,2,18,39.57670414368548,0.5844298245614035,48.18376068376068,1007.264957264957,26.506972559604133,0
209,4,3,2,39,0.07317073170731707,0.04878048780487805,0.9512195121951219,41,1100,600,500,0.5454545454545454,16,6,10,324.4598368277369,0.46697154471544716,0.13879786473190858,0.1725003127746278,127518.18700034487,75.76209990775277,127593.94910025262,120,0,34.853658536585364,36,5,13,39.30157579811944,0.5951967592592593,47.494369369369366,1010.022522522522,28.056181181181167,0
210,4,1,1,39,0.025,0.025,0.975,40,1050,700,350,0.6666666666666666,14,7,7,341.7846504573159,0.4668269230769231,0.07182591623036672,0.17643477901985727,126319.25207756205,634.7962834718038,126954.04836103386,121,0,36.7,37,3,16,40.09462260034903,0.5810810810810811,48.68421052631577,1005.2631578947346,27.16927453769553,16
211,4,3,4,38,0.07142857142857142,0.09523809523809523,0.9047619047619048,42,1400,1100,300,0.7857142857142857,17,11,6,352.9217709024514,0.46818137824235384,0.08063427800269918,0.17790138247531734,125338.06610664718,940.9166265773478,126278.98273322453,122,0,35.833333333333336,36,6,16,40.82719485680012,0.5729166666666667,49.66216216216216,1001.3513513513512,27.815315315315313,16
212,4,6,2,42,0.13636363636363635,0.045454545454545456,0.9545454545454546,44,1500,1000,500,0.6666666666666666,20,10,10,329.56097568881546,0.4718551797040169,0.1501938545223076,0.17200674179638853,126769.03558514136,-444.37458908612325,126324.66099605525,123,0,34.02272727272727,38,6,17,39.940059410142176,0.5838815789473684,48.23717948717949,1007.0512820512822,26.501349527665322,0
213,4,3,2,43,0.06666666666666667,0.044444444444444446,0.9555555555555556,45,1350,1000,350,0.7407407407407407,17,10,7,327.808707408424,0.47127525252525254,0.1885807043545773,0.17337519877827362,127307.56104353837,-653.0836803272947,126654.47736321107,124,0,34.13333333333333,38,7,21,39.43247582751076,0.5893640350877193,47.70299145299144,1009.1880341880324,26.557579847053482,0
214,4,2,0,45,0.044444444444444446,0.0,1.0,45,1050,700,350,0.6666666666666666,14,7,7,326.6870584313552,0.4707070707070707,0.21470136028074083,0.1752264239189599,127874.24123612027,-645.0280562860689,127229.2131798342,125,0,34.577777777777776,38,7,16,38.88155346642724,0.5951206140350878,47.14209401709402,1011.4316239316242,26.616621682411164,0
215,4,1,5,41,0.021739130434782608,0.10869565217391304,0.8913043478260869,46,1650,1100,550,0.6666666666666666,22,11,11,321.5151816035746,0.47208132045088563,0.21501809543833872,0.17350394503082434,128118.16541883691,-961.612955729157,127156.55246310776,126,0,34.80434782608695,39,7,17,38.76352591144493,0.5958867521367521,46.90104166666667,1012.3958333333343,25.958867521367544,0
216,4,1,2,40,0.023809523809523808,0.047619047619047616,0.9523809523809523,42,1700,1400,300,0.8235294117647058,20,14,6,347.6961845643828,0.4708914053426248,0.22261209533624537,0.18571442078292097,127705.4548852239,480.5398823302633,128185.99476755416,127,0,38.61904761904762,35,7,18,38.52305908622467,0.5991071428571428,47.309027777777786,1010.7638888888899,28.878968253968285,0
217,4,0,2,38,0.0,0.05,0.95,40,1200,800,400,0.6666666666666666,16,8,8,398.1492422540379,0.4699652777777778,0.021570177572367122,0.20850847578424814,126906.72607891183,2701.025363508681,129607.75144242051,128,1,38.6,33,7,18,38.07113030081894,0.5953282828282829,48.100490196078425,1007.5980392156853,30.533273915626825,16
218,4,0,4,34,0.0,0.10526315789473684,0.8947368421052632,38,1350,900,450,0.6666666666666666,18,9,9,398.8586204712341,0.4670756282598388,0.053635476431719065,0.2093698660588927,127002.00007086176,2531.1685090703054,129533.16857993207,129,2,40.94736842105263,34,4,18,37.95495256092279,0.5940563725490196,48.00595238095239,1007.9761904761912,29.64635854341739,0
219,4,2,1,35,0.05555555555555555,0.027777777777777776,0.9722222222222222,36,1100,700,400,0.6363636363636364,15,7,8,397.08186583574616,0.46241732804232805,0.09107241569928148,0.21098334341408012,127493.9344993512,2925.137766503654,130419.07226585486,130,0,42.47222222222222,33,3,18,37.49279517048902,0.6013257575757576,47.518382352941174,1009.9264705882351,30.60383244206773,0
220,4,1,1,35,0.027777777777777776,0.027777777777777776,0.9722222222222222,36,1100,600,500,0.5454545454545454,16,6,10,396.6199077459693,0.4619543650793651,0.09171932441095287,0.21225537974080147,127783.17920918384,2936.270549886645,130719.44975907049,131,0,43.25,34,2,20,37.20686643902823,0.6020220588235294,47.23214285714287,1011.0714285714299,29.737394957983234,0
221,4,1,1,35,0.027777777777777776,0.027777777777777776,0.9722222222222222,36,1250,900,350,0.72,16,9,7,381.6893830268128,0.4619543650793651,-0.060469933243621155,0.19388347309118306,125655.61933106564,2416.1068594104163,128071.72619047605,132,0,43.611111111111114,34,2,16,39.778011952821956,0.5802696078431373,49.34523809523809,1002.6190476190466,29.48879551820725,16
222,4,0,2,33,0.0,0.05714285714285714,0.9428571428571428,35,1200,1000,200,0.8333333333333334,14,10,4,385.52734620189983,0.45997899159663863,-0.04866224240307382,0.19563360371783742,125613.49601114952,2685.487552864274,128298.98356401379,133,1,45.82857142857143,33,2,16,39.72544824775875,0.5820707070707071,49.38725490196078,1002.4509803921565,30.37730243612595,0
223,4,1,2,32,0.029411764705882353,0.058823529411764705,0.9411764705882353,34,900,500,400,0.5555555555555556,13,5,8,374.19860270946367,0.4600972964943553,0.014865887007622147,0.17761257621561907,122803.84948096915,2390.605776624413,125194.45525759357,134,0,47.088235294117645,33,1,16,42.933461094625805,0.553030303030303,52.205882352941195,991.1764705882376,30.03565062388599,16
224,4,10,5,37,0.23809523809523808,0.11904761904761904,0.8809523809523809,42,700,400,300,0.5714285714285714,10,4,6,311.2430353634207,0.4727787456445993,0.055922497980241515,0.15552893175150811,124975.19964293596,-620.4679035966208,124354.73173933933,135,0,38.38095238095238,41,1,15,42.24449763534741,0.5607215447154472,50.02480158730159,999.9007936507943,24.387824235385228,0
225,4,4,0,41,0.0975609756097561,0.0,1.0,41,950,800,150,0.8421052631578947,11,8,3,318.745223385017,0.47210365853658537,0.09292323700281169,0.1598597414276871,125127.06479484781,-223.2691560909329,124903.79563875688,136,0,40.21951219512195,40,1,19,41.900287794142535,0.5638020833333333,49.872967479674806,1000.5081300813022,25.012703252032555,0
226,4,5,5,41,0.10869565217391304,0.10869565217391304,0.8913043478260869,46,1100,1000,100,0.9090909090909091,12,10,2,293.5745681521262,0.4741445249597423,0.13274174960712348,0.15160956419006047,126335.91473056033,-1772.1590107145198,124563.75571984581,137,0,36.73913043478261,42,4,15,41.289156626506,0.5731646825396826,48.66763565891474,1005.3294573643433,23.936415651531984,0
227,4,2,0,43,0.046511627906976744,0.0,1.0,43,1750,1300,450,0.7428571428571429,22,13,9,317.8383773782323,0.4706533776301218,0.15845658296372522,0.1643328257542621,126384.01828342005,-566.0617404513944,125817.95654296866,138,0,39.627906976744185,39,4,19,40.629963914499825,0.5782585470085471,48.619791666666664,1005.5208333333326,25.78258547008545,0
228,4,0,1,42,0.0,0.023255813953488372,0.9767441860465116,43,1550,1000,550,0.6451612903225806,21,10,11,320.0442930368105,0.4706533776301218,0.1590969289226427,0.16600364028729914,126514.97938368034,-501.9205729166905,126013.05881076366,139,1,40.627906976744185,39,4,19,40.440135983985634,0.579594017094017,48.48958333333332,1006.0416666666649,25.795940170940128,0
229,4,2,1,43,0.045454545454545456,0.022727272727272728,0.9772727272727273,44,850,600,250,0.7058823529411765,11,6,5,315.969577141939,0.4699392177589852,0.1755173524438367,0.16592076864802266,127017.00015943863,-773.298433956928,126243.7017254817,140,0,40.29545454545455,41,3,21,40.02835596890073,0.5815548780487805,47.99107142857142,1008.0357142857131,24.58623693379788,0
230,4,5,4,44,0.10416666666666667,0.08333333333333333,0.9166666666666666,48,950,700,250,0.7368421052631579,12,7,5,300.0240123649743,0.4710309544917258,0.20254053363972924,0.16151808170823687,128021.9225106666,-1918.0033947112552,126103.91911595534,141,0,37.729166666666664,42,6,21,39.40540022979701,0.5902777777777778,46.99612403100776,1012.0155038759704,24.09560723514215,0
231,4,1,7,38,0.022222222222222223,0.15555555555555556,0.8444444444444444,45,900,600,300,0.6666666666666666,12,6,6,335.37866171745065,0.47135942760942756,-0.0186157627546919,0.1757558598837824,126934.5106336808,-246.47966266485406,126688.03097101593,142,0,40.17777777777778,39,6,16,39.62381986079524,0.5838675213675213,48.07291666666668,1007.7083333333353,25.838675213675263,16
232,4,1,1,38,0.02564102564102564,0.02564102564102564,0.9743589743589743,39,850,600,250,0.7058823529411765,11,6,5,358.1808903057132,0.4676394511920828,0.0508879470809005,0.18677521394609886,126732.14994331068,1278.6068594104343,128010.75680272111,143,0,46.23076923076923,34,5,18,39.25745842200677,0.5912990196078431,48.273809523809526,1006.904761904762,29.614845938375353,0
233,4,2,0,40,0.05,0.0,1.0,40,1500,1000,500,0.6666666666666666,20,10,10,342.90642293710494,0.4667601495726496,0.09303391384051363,0.1824931255728691,127559.26354595344,748.1781550068708,128307.4417009603,144,0,45.85,35,5,14,38.793728994805996,0.5976190476190476,47.45370370370371,1010.1851851851858,28.86243386243388,0
234,4,2,4,38,0.047619047619047616,0.09523809523809523,0.9047619047619048,42,1250,1000,250,0.8,15,10,5,368.7256659512691,0.46766114982578394,0.06600856072766192,0.1868825983465997,125563.69714308891,1420.1432397737967,126983.8403828627,145,0,44.61904761904762,36,6,18,40.198033707865164,0.5752314814814814,49.43693693693693,1002.2522522522513,27.840340340340315,16
235,4,3,0,41,0.07317073170731707,0.0,1.0,41,1250,900,350,0.72,16,9,7,350.9146042032602,0.46735264227642276,0.17012221853915133,0.17592004663464553,125109.67316866737,666.8764319318657,125776.54960059925,146,0,46.19512195121951,37,4,17,41.113638024258364,0.5686936936936937,49.890350877192986,1000.4385964912289,27.038880986249428,16
236,4,1,2,40,0.023809523809523808,0.047619047619047616,0.9523809523809523,42,1250,1000,250,0.8,15,10,5,344.8426893669135,0.4675401664730933,0.17065777046583164,0.17443013704870103,125481.23150887585,254.2570677186168,125735.48857659446,147,0,46.07142857142857,38,4,17,40.88158455960759,0.5707236842105263,49.519230769230774,1001.9230769230778,26.366396761133625,0
237,4,5,5,40,0.1111111111111111,0.1111111111111111,0.8888888888888888,45,900,600,300,0.6666666666666666,12,6,6,328.7973186133167,0.4698021885521886,0.19185731774430792,0.16985858344864446,126350.17108078854,-690.0220847261951,125660.14899606234,148,0,43.4,40,5,16,40.38924829003671,0.5763020833333333,48.65345528455284,1005.3861788617885,25.134654471544714,0
238,4,3,4,39,0.06976744186046512,0.09302325581395349,0.9069767441860466,43,1100,800,300,0.7272727272727273,14,8,6,333.77274525005345,0.46698504983388706,0.20966535039302991,0.17317564418841594,126527.07151955937,-153.74239809337337,126373.329121466,149,0,45.69767441860465,38,5,18,40.08243071041732,0.5814144736842105,48.477564102564095,1006.0897435897425,26.476045883940593,0
239,4,2,3,38,0.04878048780487805,0.07317073170731707,0.926829268292683,41,1350,700,650,0.5185185185185185,20,7,13,364.9732224357497,0.4683180894308943,0.13327989794593642,0.182740358533589,125057.87706832973,1073.5565096620348,126131.43357799177,150,0,45.926829268292686,35,6,19,40.81568695518013,0.5720238095238095,49.94212962962962,1000.23148148148,28.578042328042287,15
240,4,6,2,42,0.13636363636363635,0.045454545454545456,0.9545454545454546,44,1250,900,350,0.72,16,9,7,369.26375303341746,0.4739252995066949,0.15004899559039675,0.18517624568579985,125122.57905613234,1256.6858281151435,126379.26488424747,151,0,43.5,33,11,20,40.64133186346562,0.577020202020202,49.87745098039216,1000.4901960784321,30.317884729649457,15
241,4,4,5,41,0.08695652173913043,0.10869565217391304,0.8913043478260869,46,1350,900,450,0.6666666666666666,18,9,9,342.47913525451787,0.47605676328502416,0.1810659186535759,0.17610893921855553,126160.0865912209,-555.1814191241689,125604.90517209673,152,0,42.369565217391305,35,11,20,40.24097542242704,0.5833333333333333,48.842592592592595,1004.62962962963,28.703703703703713,0
242,4,6,4,43,0.1276595744680851,0.0851063829787234,0.9148936170212766,47,1600,1200,400,0.75,20,12,8,333.0031944393771,0.4765456367560901,0.21895153915040888,0.17555677531450875,127177.19144397798,-923.0590873029946,126254.13235667498,153,0,40.765957446808514,36,11,20,39.43493915373453,0.591724537037037,47.83220720720722,1008.6711711711729,28.018643643643692,0
243,4,3,4,42,0.06521739130434782,0.08695652173913043,0.9130434782608696,46,1350,800,550,0.5925925925925926,19,8,11,349.2931617470507,0.4736714975845411,0.23986057564863983,0.17342229257425237,124706.36922209414,-414.22450665458234,124292.14471543956,154,0,42.56521739130435,38,8,15,41.57173672763576,0.5627741228070176,50.29380341880341,998.8247863247843,26.28486279802064,16
244,4,0,2,40,0.0,0.047619047619047616,0.9523809523809523,42,1400,1200,200,0.8571428571428571,16,12,4,369.03145960641996,0.47131484707704224,0.24658543449828718,0.18311515037054574,124681.91557623852,802.3098583247184,125484.22543456324,155,1,45.976190476190474,35,7,15,41.10424633986169,0.5681547619047619,50.31828703703702,998.726851851849,28.53505291005283,0
245,4,3,2,41,0.06976744186046512,0.046511627906976744,0.9534883720930233,43,1100,600,500,0.5454545454545454,16,6,10,353.90422937936273,0.47171465485418973,0.26423180093603227,0.17956441304362356,125608.37733892718,291.47765024859024,125899.85498917577,156,0,44.51162790697674,35,8,15,40.523250779355735,0.5776785714285715,49.39236111111109,1002.4305555555532,28.64087301587295,0
246,4,1,1,41,0.023809523809523808,0.023809523809523808,0.9761904761904762,42,1300,800,500,0.6153846153846154,18,8,10,374.43113099995537,0.4712543554006969,0.23559237922627152,0.1808248372247047,123540.32241701144,927.483672087046,124467.80608909849,157,0,46.11904761904762,36,6,16,42.15800105724211,0.5543981481481481,51.463963963963955,994.1441441441427,27.615115115115074,15
247,4,5,5,41,0.10869565217391304,0.10869565217391304,0.8913043478260869,46,1450,800,650,0.5517241379310345,21,8,13,353.19685085095875,0.47377214170692433,0.22708314885327163,0.1744664524827171,124492.38631105835,-363.67797667173284,124128.70833438661,158,0,42.869565217391305,40,6,21,41.696155804480654,0.5572916666666667,50.50813008130082,997.9674796747977,24.949186991869944,16
248,4,5,3,43,0.10869565217391304,0.06521739130434782,0.9347826086956522,46,1150,800,350,0.6956521739130435,15,8,7,355.78270422358406,0.47401368760064416,0.2716988411331789,0.18069215149472745,125648.36109335705,-254.133338198343,125394.2277551587,159,0,39.67391304347826,36,10,18,40.43487214047698,0.576099537037037,49.352477477477485,1002.5900900900915,27.849724724724766,0
249,4,1,0,44,0.022727272727272728,0.0,1.0,44,1150,800,350,0.6956521739130435,15,8,7,368.84087842157874,0.4728792283298097,0.30918083811698294,0.18995642799002704,126223.21605725614,511.8777759764594,126735.0938332326,160,0,42.09090909090909,34,10,20,39.51373257512932,0.5860906862745099,48.7797619047619,1004.8809523809516,29.555322128851518,0
250,4,0,1,43,0.0,0.022727272727272728,0.9772727272727273,44,1350,800,550,0.5925925925925926,19,8,11,370.0431973543856,0.47261495771670187,0.3125437321707305,0.19113240377111826,126342.87308673459,550.4641439909144,126893.3372307255,161,1,43.09090909090909,34,10,13,39.36007499506611,0.5873161764705883,48.66071428571428,1005.357142857142,29.56932773109241,0
251,4,3,5,41,0.06521739130434782,0.10869565217391304,0.8913043478260869,46,1300,800,500,0.6153846153846154,18,8,10,354.80106427050646,0.4741847826086956,0.3076900053873932,0.18719407240809524,127208.74592764057,-171.02588463369278,127037.72004300688,162,0,41.0,35,11,16,38.85287593697414,0.594047619047619,47.800925925925924,1008.7962962962961,28.822751322751316,0
252,4,0,0,41,0.0,0.0,1.0,41,1100,800,300,0.7272727272727273,14,8,6,398.2844740158225,0.4708333333333334,0.32274361156867903,0.20628960468205743,126456.23692735439,1873.1111621263158,128329.3480894807,163,1,46.46341463414634,32,9,17,38.53303623734204,0.5930989583333333,48.5479797979798,1005.8080808080811,31.431502525252533,0
253,4,5,4,42,0.10869565217391304,0.08695652173913043,0.9130434782608696,46,1150,800,350,0.6956521739130435,15,8,7,393.3516853663561,0.47263486312399355,0.274498185319606,0.20078038200874018,125856.16188180297,1252.6887719086205,127108.85065371159,164,0,42.30434782608695,38,8,17,39.277887208972174,0.5745614035087719,49.14529914529915,1003.4188034188038,26.405757984705364,16
254,4,3,2,43,0.06666666666666667,0.044444444444444446,0.9555555555555556,45,1500,1000,500,0.6666666666666666,20,10,10,389.7978460326278,0.4713804713804714,0.29530864197530904,0.2028539810986123,126650.14716066472,873.8705623072337,127524.01772297196,165,0,42.333333333333336,37,8,19,38.54620551924473,0.5844594594594594,48.35526315789473,1006.5789473684204,27.204836415362713,0
255,4,3,3,43,0.06521739130434782,0.06521739130434782,0.9347826086956522,46,1250,900,350,0.72,16,9,7,380.5089219323823,0.4712157809983897,0.3144847796184438,0.20191969798893564,127442.3707561728,500.9002235730619,127943.27097974585,166,0,41.73913043478261,35,11,18,37.964236588720766,0.5964285714285714,47.56944444444444,1009.722222222222,28.84920634920634,0
256,4,0,2,41,0.0,0.046511627906976744,0.9534883720930233,43,1900,1400,500,0.7368421052631579,24,14,10,370.25128255399795,0.46813861203396084,0.20343336659247324,0.18153096863084375,124178.98415858734,734.8567721692247,124913.84093075656,167,1,43.674418604651166,37,6,16,41.59653465346536,0.5591216216216216,50.82236842105264,996.71052631579,26.93812233285919,16
257,4,2,4,39,0.046511627906976744,0.09302325581395349,0.9069767441860466,43,1250,800,450,0.64,17,8,9,366.6118634160044,0.46693890734588406,0.10333699304654487,0.1793969845374921,124097.0313582063,623.7425217374488,124720.77387994375,168,0,44.18604651162791,37,6,17,41.772472579876,0.558277027027027,50.90460526315789,996.3815789473678,26.92923186344237,16
258,4,5,4,40,0.11363636363636363,0.09090909090909091,0.9090909090909091,44,1550,1100,450,0.7096774193548387,20,11,9,344.278346648302,0.47198731501057084,0.15770394653889785,0.17358369785554262,125347.46334876557,-159.29678416006715,125188.1665646055,169,0,39.84090909090909,38,6,15,41.033865002311614,0.5693530701754386,49.652777777777786,1001.3888888888899,26.352339181286577,0
259,4,4,3,41,0.09090909090909091,0.06818181818181818,0.9318181818181819,44,1550,1100,450,0.7096774193548387,20,11,9,343.7880903924764,0.47381518675123324,0.1623138120263634,0.1755955156637591,125882.9640244905,-144.58723701511872,125738.37678747538,170,0,39.93181818181818,38,6,19,40.493585648887475,0.5748355263157895,49.118589743589745,1003.5256410256413,26.408569500674773,0
260,4,2,4,39,0.046511627906976744,0.09302325581395349,0.9069767441860466,43,1300,800,500,0.6153846153846154,18,8,10,365.86948442527955,0.47395256552233295,0.18274690810107086,0.18127421505185942,124619.1929097264,524.753176674684,125143.94608640108,171,0,41.674418604651166,40,3,15,41.24830364715861,0.55859375,50.38109756097561,998.4756097560978,24.961890243902445,15
261,4,3,3,39,0.07142857142857142,0.07142857142857142,0.9285714285714286,42,1450,1000,450,0.6896551724137931,19,10,9,362.8105833678378,0.4736377274487031,0.24439020212401474,0.183384258502289,125450.85626166716,705.3034344737576,126156.15969614091,172,0,43.19047619047619,36,6,11,40.46294214628297,0.5740740740740741,49.54954954954955,1001.8018018018025,27.827827827827846,0
262,4,3,2,40,0.07142857142857142,0.047619047619047616,0.9523809523809523,42,1200,1000,200,0.8333333333333334,14,10,4,349.139794359508,0.47470238095238093,0.21946363106354827,0.17879964601684042,125991.54188368049,397.73220486110563,126389.2740885416,173,0,39.38095238095238,39,3,14,40.24737151552881,0.5742521367521367,49.010416666666664,1003.9583333333328,25.742521367521356,0
263,4,2,2,40,0.047619047619047616,0.047619047619047616,0.9523809523809523,42,1050,700,350,0.6666666666666666,14,7,7,346.40781810204146,0.47470238095238093,0.21380807010985836,0.17930318891828034,126429.50234687609,359.2553117305517,126788.75765860664,174,0,38.976190476190474,37,5,11,39.86498764355286,0.5822072072072072,48.57456140350878,1005.701754385966,27.181128496918,0
264,4,1,5,36,0.024390243902439025,0.12195121951219512,0.8780487804878049,41,1050,700,350,0.6666666666666666,14,7,7,354.78968746706494,0.47238313008130084,0.2263154733629269,0.18407032914232058,126524.89271365968,777.9454285366527,127302.83814219633,175,0,40.78048780487805,36,5,12,39.556049921647634,0.5850694444444444,48.47972972972973,1006.0810810810817,27.946696696696716,0
265,4,2,2,36,0.05263157894736842,0.05263157894736842,0.9473684210526316,38,1150,700,450,0.6086956521739131,16,7,9,366.29078318112465,0.4704243717401612,0.2254459696061515,0.18947080499271018,126402.72285997715,1660.0304705215242,128062.75333049867,176,0,44.28947368421053,34,4,14,39.39268379306263,0.5879289215686274,48.60119047619047,1005.5952380952367,29.576330532212843,0
266,4,3,4,35,0.07692307692307693,0.10256410256410256,0.8974358974358975,39,1050,600,450,0.5714285714285714,15,6,9,367.80274571409086,0.47070400359874043,0.24708624708624782,0.19349622709306508,127092.0138888888,1548.9583333333285,128640.97222222213,177,0,43.58974358974359,35,4,17,38.64497245179065,0.5928571428571429,47.916666666666664,1008.3333333333326,28.80952380952379,0
267,4,3,1,37,0.07894736842105263,0.02631578947368421,0.9736842105263158,38,1350,800,550,0.5925925925925926,19,8,11,366.75610128620525,0.4696983167377904,0.22978919639035733,0.19561072207268523,127646.96830257626,1763.0608871313373,129410.0291897076,178,0,41.73684210526316,35,3,17,38.101424999045534,0.5985119047619047,47.366898148148145,1010.5324074074072,28.87235449735449,0
268,4,0,4,33,0.0,0.10810810810810811,0.8918918918918919,37,1300,700,600,0.5384615384615384,19,7,12,374.5607027145331,0.4690315315315315,0.08256553192822014,0.18598727643420127,124710.8155971363,1943.3220003857782,126654.13759752207,179,1,43.5945945945946,35,2,19,40.93617226728465,0.5684523809523809,50.28935185185184,998.8425925925911,28.538359788359745,15
269,4,4,0,37,0.10810810810810811,0.0,1.0,37,1050,800,250,0.7619047619047619,13,8,5,350.61555863954925,0.4683746246246246,0.15149729168420745,0.1786469751163414,125782.47070312477,1420.5931445044291,127203.0638476292,180,0,43.4054054054054,35,2,20,40.425969193492534,0.5794642857142858,49.218749999999986,1003.1249999999982,28.660714285714235,0
270,4,3,4,36,0.075,0.1,0.9,40,950,400,550,0.42105263157894735,15,4,11,339.7457163228394,0.4690705128205128,0.17862218922358952,0.1775566858920024,126822.83676674672,617.5031046825575,127440.33987142929,181,0,41.075,38,2,16,39.62841182293875,0.5844298245614035,48.18376068376067,1007.2649572649549,26.506972559604076,0
271,4,1,2,35,0.02702702702702703,0.05405405405405406,0.9459459459459459,37,1450,1100,350,0.7586206896551724,18,11,7,368.42714401450564,0.46418293293293295,0.20155559285994062,0.19134441995592052,126567.38281249991,1926.171874999985,128493.5546874999,182,0,45.2972972972973,35,2,18,39.16925465838507,0.5875,48.43749999999999,1006.2499999999993,28.749999999999982,0
272,4,2,1,36,0.05405405405405406,0.02702702702702703,0.972972972972973,37,800,400,400,0.5,12,4,8,382.900149503995,0.4658408408408408,0.13757961783439487,0.19078723548568918,124855.365936321,2249.3182816786502,127104.68421799966,183,0,44.513513513513516,35,2,17,40.577711831692724,0.5699404761904762,50.14467592592592,999.421296296295,28.554894179894145,15
273,4,6,3,39,0.14285714285714285,0.07142857142857142,0.9285714285714286,42,1300,1000,300,0.7692307692307693,16,10,6,343.79473078616275,0.4687741966705381,0.16258171173767244,0.17861018032404147,126580.82133693129,303.7313278326877,126884.55266476398,184,0,39.785714285714285,38,4,16,39.77509997522739,0.5819627192982456,48.42414529914531,1006.3034188034203,26.48166891587948,0
274,4,2,3,38,0.04878048780487805,0.07317073170731707,0.926829268292683,41,1050,700,350,0.6666666666666666,14,7,7,381.3623849748597,0.46862296747967475,0.13356841592267776,0.1858971462506212,123934.57166883674,1305.5763705547015,125240.14803939144,185,0,41.5609756097561,39,2,18,41.5743670886076,0.5531517094017093,51.06770833333333,995.7291666666661,25.53151709401708,16
275,4,4,3,39,0.09523809523809523,0.07142857142857142,0.9285714285714286,42,1300,700,600,0.5384615384615384,19,7,12,393.26624945546644,0.47291182733255904,0.21026678300415114,0.1826386063097716,121867.46312567315,1277.9478120671574,123145.41093774031,186,0,39.73809523809524,37,5,16,43.44472977975197,0.5351914414414414,53.152412280701746,987.390350877192,26.686225699383566,16
276,4,10,9,40,0.20408163265306123,0.1836734693877551,0.8163265306122449,49,1750,1300,450,0.7428571428571429,22,13,9,350.96375385867884,0.4783871882086168,0.2687908693077914,0.1733660721731316,124493.03643664617,-1029.9491633836617,123463.08727326251,187,0,34.204081632653065,38,11,16,41.75119544659744,0.5605811403508771,50.50747863247863,997.9700854700852,26.2623706702654,0
277,4,0,1,39,0.0,0.025,0.975,40,1600,1200,400,0.75,20,12,8,423.0667173501424,0.4745726495726496,0.26734687538824686,0.1953679866868215,121622.39470696377,2327.326088187941,123949.7207951517,188,1,38.4,33,7,16,42.96794115210999,0.540719696969697,53.40073529411765,986.3970588235302,29.8908199643494,16
278,4,6,4,41,0.13333333333333333,0.08888888888888889,0.9111111111111111,45,1100,700,400,0.6363636363636364,15,7,8,383.9104171968335,0.479229797979798,0.2795759058604219,0.18459961405044362,123356.13486207552,486.0336627672458,123842.16852484277,189,0,34.75555555555555,35,10,14,42.114863684026574,0.5544642857142856,51.64930555555555,993.4027777777769,28.382936507936485,0
279,4,6,2,45,0.1276595744680851,0.0425531914893617,0.9574468085106383,47,1000,700,300,0.7,13,7,6,387.86002633404536,0.4784921369102683,0.29228993009299775,0.19187057939887733,124553.9700255102,852.3899823239427,125406.36000783416,190,0,34.148936170212764,34,13,17,40.76724309282448,0.5689338235294117,50.44642857142857,998.2142857142857,29.35924369747899,16
280,4,5,6,44,0.1,0.12,0.88,50,1700,1200,500,0.7058823529411765,22,12,10,370.5602922045219,0.4808673469387755,0.3253622519612367,0.18894215369581166,125811.4979852539,-674.2565210240297,125137.24146422987,191,0,33.0,35,15,17,39.89578526380557,0.5797619047619047,49.189814814814824,1003.2407407407418,28.664021164021193,0
281,4,4,4,44,0.08333333333333333,0.08333333333333333,0.9166666666666666,48,1750,1200,550,0.6857142857142857,23,12,11,356.46703022001543,0.480219414893617,0.30369253213468994,0.1853365481845025,126612.30867346942,-572.7342634584617,126039.57441001096,192,0,33.979166666666664,34,14,15,39.42389204321426,0.5900735294117647,48.392857142857146,1006.4285714285717,29.60084033613446,0
282,4,4,6,42,0.08333333333333333,0.125,0.875,48,1350,1000,350,0.7407407407407407,17,10,7,361.0082573517027,0.48034869976359335,0.19821292148487735,0.18039137232269606,124973.95968967005,-188.489904425316,124785.46978524474,193,0,34.75,39,9,19,41.00177535854431,0.5638354700854701,50.026041666666664,999.8958333333326,25.63835470085468,16
283,4,4,4,42,0.08695652173913043,0.08695652173913043,0.9130434782608696,46,1200,700,500,0.5833333333333334,17,7,10,339.3348419235369,0.48151167471819645,0.19982953011072113,0.16810126015289067,124612.70356348783,-742.9135869238545,123869.78997656397,194,0,36.391304347826086,42,4,17,41.917378364389236,0.5555555555555556,50.38759689922481,998.4496124031012,23.77260981912146,16
284,4,1,2,41,0.023255813953488372,0.046511627906976744,0.9534883720930233,43,1400,900,500,0.6428571428571429,19,9,10,354.26614739720526,0.4805970837947582,0.2249088708719047,0.17592222099387897,124713.7057834202,236.368815104171,124950.07459852437,195,0,38.69767441860465,39,4,18,41.439952897417186,0.5611645299145299,50.286458333333336,998.8541666666672,25.611645299145312,0
285,4,3,3,41,0.06818181818181818,0.06818181818181818,0.9318181818181819,44,1250,900,350,0.72,16,9,7,391.9990160211655,0.4843639887244538,0.21791070805720247,0.19080834956412268,123874.07467689055,1400.1063970872049,125274.18107397776,196,0,37.77272727272727,35,9,18,41.3727328217649,0.5598214285714286,51.12847222222223,995.4861111111121,28.442460317460345,16
286,4,8,4,45,0.16326530612244897,0.08163265306122448,0.9183673469387755,49,1500,1100,400,0.7333333333333333,19,11,8,347.3203775594648,0.4836486678004535,0.246900376218824,0.17647134491481797,125666.3950644077,-1055.3583676268718,124611.03669678082,197,0,34.326530612244895,35,14,17,40.62836680903458,0.5782738095238096,49.33449074074075,1002.6620370370381,28.647486772486804,0
287,4,7,8,44,0.1346153846153846,0.15384615384615385,0.8461538461538461,52,1000,500,500,0.5,15,5,10,321.67887424051816,0.4838486676721971,0.2637284811505778,0.16717829602375256,126594.96792282215,-2254.8486692338392,124340.11925358832,198,0,33.21153846153846,37,15,14,40.31697174402558,0.5838963963963963,48.41008771929823,1006.359649122805,27.198909435751485,0
288,4,2,2,44,0.043478260869565216,0.043478260869565216,0.9565217391304348,46,1350,1100,250,0.8148148148148148,16,11,5,366.137324964264,0.48043478260869565,0.2702334790858838,0.1873343400545309,125954.1950113376,23.306405895655672,125977.50141723324,199,0,37.93478260869565,34,12,22,39.859315702087265,0.5833333333333333,49.04761904761903,1003.8095238095216,29.523809523809458,0
289,4,1,4,41,0.022222222222222223,0.08888888888888889,0.9111111111111111,45,2150,1800,350,0.8372093023255814,25,18,7,381.1539669122084,0.48005050505050506,0.1714090354090354,0.1880965888775,124452.3555324717,652.9641871753491,125105.31971964706,200,0,39.28888888888889,37,8,14,41.04029304029304,0.5619369369369369,50.548245614035096,997.8070175438611,26.967757230915165,16
290,4,3,7,37,0.06818181818181818,0.1590909090909091,0.8409090909090909,44,1050,600,450,0.5714285714285714,15,6,9,381.1502061043942,0.47965116279069764,0.21184808881969763,0.19006119266194418,124887.4127505886,720.1726219462907,125607.58537253489,201,0,40.86363636363637,36,8,17,40.58814969205348,0.568287037037037,50.11261261261262,999.549549549551,27.765265265265306,0
291,4,3,4,36,0.075,0.1,0.9,40,1050,800,250,0.7619047619047619,13,8,5,401.20513876586085,0.479420405982906,0.24804038004750595,0.2035028474944912,125595.94671201835,2077.998572207096,127673.94528422545,202,0,40.275,34,6,15,39.35075217735552,0.579656862745098,49.40476190476192,1002.3809523809542,29.48179271708689,0
292,4,5,4,37,0.12195121951219512,0.0975609756097561,0.9024390243902439,41,1450,1000,450,0.6896551724137931,19,10,9,400.59854315666166,0.47863313008130076,0.2654588854546007,0.20813366290473234,126583.26478165494,1944.2058735416383,128527.47065519658,203,0,39.829268292682926,32,9,16,38.34352781263068,0.5944010416666667,48.42171717171717,1006.3131313131314,31.447285353535356,0
293,4,4,2,39,0.0975609756097561,0.04878048780487805,0.9512195121951219,41,1150,700,450,0.6086956521739131,16,7,9,396.33754557475413,0.4795477642276423,0.25023957087886184,0.20740235277976138,126875.85791822849,1857.1332240003744,128732.99114222886,204,0,40.048780487804876,33,8,19,38.1486183757045,0.5950126262626263,48.13112745098039,1007.4754901960778,30.529560308972055,0
294,4,1,0,40,0.025,0.0,1.0,40,1250,800,450,0.64,17,8,9,409.865436326618,0.4762419871794872,0.2662136689772594,0.2148071053482332,126937.59799416088,2405.4667976259134,129343.06479178679,205,0,42.025,33,7,20,37.74410697636711,0.5956439393939394,48.06985294117647,1007.7205882352939,30.536987522281635,0
295,4,1,3,38,0.024390243902439025,0.07317073170731707,0.926829268292683,41,1000,800,200,0.8,12,8,4,402.2111833527619,0.4770579268292683,0.2597512176231873,0.21211232385526527,127190.50301445849,2031.7701381520505,129222.27315261053,206,0,41.97560975609756,31,10,21,37.67600899272838,0.6031586021505376,47.819010416666664,1008.7239583333328,32.539482526881706,0
296,4,3,3,38,0.07317073170731707,0.07317073170731707,0.926829268292683,41,1400,1000,400,0.7142857142857143,18,10,8,392.2660307934424,0.47586382113821135,0.26390131681919815,0.21133236453509732,128051.4874837803,1846.0497464917376,129897.53723027205,207,0,33.78048780487805,33,8,17,37.0412832465593,0.6070075757575757,46.966911764705884,1012.1323529411767,30.67067736185384,0
297,4,1,3,36,0.02564102564102564,0.07692307692307693,0.9230769230769231,39,1150,700,450,0.6086956521739131,16,7,9,388.876189156935,0.47461201079622134,0.23402670553898575,0.21032878713606065,128208.45967567104,2171.4772343610857,130379.93691003212,208,0,33.53846153846154,32,7,18,36.96598512238708,0.6110026041666667,46.8118686868687,1012.7525252525268,31.64851641414146,0
298,4,2,3,35,0.05263157894736842,0.07894736842105263,0.9210526315789473,38,950,600,350,0.631578947368421,13,6,7,386.10825660744655,0.47347676623992413,0.21300485526474855,0.20996064368180112,128423.86529519911,2317.102947183794,130740.9682423829,209,0,32.55263157894737,33,5,14,36.815253093136654,0.6107954545454546,46.59926470588236,1013.6029411764719,30.71524064171127,0
299,4,2,2,35,0.05405405405405406,0.05405405405405406,0.9459459459459459,37,1000,700,300,0.7,13,7,6,393.1183906477883,0.47240990990990994,0.21605457937379202,0.2134755212002129,128368.35048719512,2692.7918707274703,131061.14235792258,210,0,33.972972972972975,32,5,16,36.694544812692094,0.6126302083333333,46.6540404040404,1013.3838383838379,31.668244949494934,0
300,4,0,1,34,0.0,0.02857142857142857,0.9714285714285714,35,950,600,350,0.631578947368421,13,6,7,399.55120439655536,0.4716036414565827,0.09838195165071673,0.19881282821177987,124798.46839229962,3074.865498166361,127873.33389046598,211,1,35.25714285714286,30,5,17,40.22088826114249,0.58125,50.2016129032258,999.1935483870961,33.3064516129032,15
301,4,4,3,35,0.10526315789473684,0.07894736842105263,0.9210526315789473,38,550,300,250,0.5454545454545454,8,3,5,374.4979940002185,0.4745880749170223,0.13238642380599352,0.1918819618743388,126012.14161820222,1838.4214421886272,127850.56306039085,212,0,33.28947368421053,32,6,18,39.58962105969149,0.5885416666666667,48.98989898989899,1004.040404040404,31.376262626262626,0
302,4,2,3,34,0.05405405405405406,0.08108108108108109,0.9189189189189189,37,1100,600,500,0.5454545454545454,16,6,10,385.77064678654096,0.47344219219219225,0.15215085568666753,0.19923312132701546,126338.19792005743,2347.5136650933073,128685.71158515074,213,0,34.62162162162162,31,6,14,38.96961209687864,0.5944220430107527,48.66536458333333,1005.338541666666,32.43027553763439,0
303,4,1,1,34,0.02857142857142857,0.02857142857142857,0.9714285714285714,35,1150,800,350,0.6956521739130435,15,8,7,389.7461251343138,0.4726540616246499,0.1879141874556467,0.18511172585780392,122831.45732897158,2893.2289004435356,125724.6862294151,214,0,37.05714285714286,32,3,17,42.51926506177556,0.5556640625,52.178030303030305,991.2878787878792,30.977746212121225,16
304,4,8,5,37,0.19047619047619047,0.11904761904761904,0.8809523809523809,42,1350,1000,350,0.7407407407407407,17,10,7,350.97286717964283,0.47706155632984903,0.21848476726525523,0.17483040953901807,124843.79882812477,363.35720486108175,125207.15603298585,215,0,31.642857142857142,39,3,17,41.3874122715586,0.5625,50.156249999999986,999.3749999999982,25.624999999999954,0
305,4,5,4,38,0.11904761904761904,0.09523809523809523,0.9047619047619048,42,1100,800,300,0.7272727272727273,14,8,6,355.29515503475466,0.47870692992644215,0.2713931591884349,0.18048993875765515,125658.76038781143,529.385063192495,126188.14545100393,216,0,32.523809523809526,37,5,16,40.436351706036746,0.5743243243243243,49.34210526315788,1002.6315789473667,27.098150782361262,0
306,4,4,4,38,0.09523809523809523,0.09523809523809523,0.9047619047619048,42,1200,800,400,0.6666666666666666,16,8,8,350.30766957996144,0.47686798296554395,0.2569298765353023,0.18012073315981736,126156.94400058816,439.3381344116141,126596.28213499978,217,0,32.30952380952381,36,6,20,40.04759369278481,0.5813078703703703,48.845720720720706,1004.617117117115,27.90603103103097,0
307,4,2,1,39,0.05,0.025,0.975,40,1200,700,500,0.5833333333333334,17,7,10,364.6543525375281,0.4767361111111111,0.19921346504885573,0.17696852450140707,123747.80988613129,1028.488064134289,124776.29795026558,218,0,30.075,38,2,19,42.18475965496258,0.5529057017543859,51.25534188034188,994.9786324786332,26.183648223121928,16
308,4,7,4,42,0.15217391304347827,0.08695652173913043,0.9130434782608696,46,1400,1200,200,0.8571428571428571,16,12,4,347.46564892094983,0.48217592592592595,0.25784145349362664,0.17592734434839716,125521.37586805594,-457.85088049707605,125063.52498755886,219,0,26.76086956521739,39,7,16,40.77442827442828,0.5694444444444444,49.479166666666686,1002.0833333333364,25.694444444444525,0
309,4,2,2,42,0.045454545454545456,0.045454545454545456,0.9545454545454546,44,1400,1100,300,0.7857142857142857,17,11,6,335.8394979495864,0.48173229386892175,0.23633530775173828,0.16186693442955186,123456.37180677276,182.40935191945795,123638.78115869222,220,0,27.886363636363637,36,8,16,43.20443814919733,0.5535300925925926,51.54842342342341,993.8063063063044,27.605730730730677,16
310,4,1,1,42,0.023255813953488372,0.023255813953488372,0.9767441860465116,43,1200,800,400,0.6666666666666666,16,8,8,340.5498752775422,0.48223514211886304,0.260952149032023,0.16508889892896034,123701.30750868021,-174.7070312500391,123526.60047743017,221,0,29.41860465116279,35,8,18,42.83267888307155,0.5580357142857143,51.302083333333314,994.7916666666638,28.422619047618966,0
311,4,5,4,43,0.10638297872340426,0.0851063829787234,0.9148936170212766,47,1400,1000,400,0.7142857142857143,18,10,8,314.55142072551877,0.484736355226642,0.2686832618806647,0.15677296435200966,124866.48866105964,-1544.3424507702725,123322.14621028937,222,0,27.72340425531915,38,9,15,42.27396223053626,0.5644188596491229,50.13354700854699,999.4658119658093,26.301731893837086,0
312,4,4,3,44,0.0851063829787234,0.06382978723404255,0.9361702127659575,47,950,600,350,0.631578947368421,13,6,7,308.82176254939856,0.48585414739438787,0.2680560350309791,0.15520613044864617,125213.76652786907,-1666.1814458689491,123547.58508200012,223,0,28.27659574468085,38,9,19,42.05918196697979,0.5679824561403508,49.78632478632478,1000.8547008547006,26.33828160143949,0
313,4,5,7,42,0.10204081632653061,0.14285714285714285,0.8571428571428572,49,750,300,450,0.4,12,3,9,299.08496717560524,0.48561507936507936,0.26495700010948764,0.1531705749470093,125992.81724048212,-2263.48847825366,123729.32876222847,224,0,26.46938775510204,40,9,17,41.50238721867933,0.57265625,49.00914634146343,1003.9634146341485,25.099085365853714,0
314,4,8,8,42,0.16,0.16,0.84,50,900,500,400,0.5555555555555556,13,5,8,301.7234191526474,0.4858078231292517,0.30258971972282556,0.15761014261409767,126803.33251953126,-2348.0723347570256,124455.26018477423,225,0,26.58,39,11,16,40.60582359430483,0.5825320512820513,48.203125,1007.1875000000001,25.825320512820515,0
315,4,2,0,44,0.045454545454545456,0.0,1.0,44,1200,500,700,0.4166666666666667,19,5,14,370.2575928620157,0.48233791402396053,0.31040875586330197,0.1824392739646976,124388.00581507097,628.5740648127934,125016.57987988376,226,0,29.818181818181817,33,11,17,41.37899262899265,0.5694444444444444,50.612745098039206,997.5490196078417,30.228758169934597,14
316,4,2,5,41,0.043478260869565216,0.10869565217391304,0.8913043478260869,46,1400,1000,400,0.7142857142857143,18,10,8,350.8290209979906,0.48256843800322063,0.3028806094512557,0.17553988120334235,125029.76367630386,-425.68425654575253,124604.07941975811,227,0,29.47826086956522,34,12,19,41.19846843629726,0.5738357843137255,49.970238095238095,1000.1190476190477,29.41526610644258,0
317,4,1,2,40,0.023809523809523808,0.047619047619047616,0.9523809523809523,42,1250,500,750,0.4,20,5,15,368.458598853275,0.4818041037553233,0.28155796731648164,0.18396642765575513,124940.48327664388,807.0790816326396,125747.56235827651,228,0,31.261904761904763,34,8,21,40.8502520441375,0.5729166666666667,50.0595238095238,999.7619047619038,29.404761904761877,0
318,4,4,2,42,0.09090909090909091,0.045454545454545456,0.9545454545454546,44,1200,900,300,0.75,15,9,6,340.1828102550476,0.4838354474982382,0.2694917474456382,0.1743110383321047,126014.78273158842,-226.3590706666178,125788.4236609218,229,0,29.272727272727273,35,9,22,40.448246878001925,0.5818452380952381,48.987268518518505,1004.050925925924,28.68716931216926,0
319,4,2,3,41,0.045454545454545456,0.06818181818181818,0.9318181818181819,44,1350,800,550,0.5925925925925926,19,8,11,340.3437013522178,0.4815340909090909,0.2769337016574587,0.1760063141278608,126392.74691357996,-196.60493827164254,126196.14197530832,230,0,30.15909090909091,35,9,19,40.05524861878452,0.5857142857142856,48.61111111111109,1005.5555555555532,28.73015873015866,0
320,4,0,4,37,0.0,0.0975609756097561,0.9024390243902439,41,1050,600,450,0.5714285714285714,15,6,9,378.6839076322494,0.48122459349593494,0.1159541456983455,0.18712165728929053,124507.06587603872,1229.7644467528394,125736.83032279156,231,1,32.5609756097561,37,4,17,41.04500842305719,0.5625,50.493421052631575,998.0263157894731,26.9736842105263,16
321,4,6,5,38,0.13953488372093023,0.11627906976744186,0.8837209302325582,43,1700,1300,400,0.7647058823529411,21,13,8,353.12348767246385,0.48431155407899595,0.1364027208187235,0.17942955775885622,125668.6267829097,276.28261345877934,125944.90939636849,232,0,30.11627906976744,38,5,19,40.48059847274018,0.5726425438596492,49.33226495726496,1002.6709401709408,26.386077372919495,0
322,4,1,0,39,0.02564102564102564,0.0,1.0,39,1500,1100,400,0.7333333333333333,19,11,8,363.7853731119265,0.4809098065677013,0.15226023303567748,0.18522702957626036,125753.44676997585,1349.4529106652776,127102.89968064113,233,0,33.43589743589744,35,4,21,40.12568274482653,0.5791666666666666,49.247685185185176,1003.009259259258,28.657407407407373,0
323,4,3,4,38,0.07142857142857142,0.09523809523809523,0.9047619047619048,42,1200,600,600,0.5,18,6,12,343.44874797221973,0.48123548199767713,0.1634700423019957,0.17868131020813136,126638.21549590111,299.4171074540245,126937.63260335513,234,0,31.976190476190474,36,6,18,39.724817259640474,0.5862268518518519,48.367117117117104,1006.5315315315299,27.959209209209163,0
324,4,0,1,37,0.0,0.02631578947368421,0.9736842105263158,38,950,700,250,0.7368421052631579,12,7,5,364.1538619897632,0.48020388809862496,0.16977597577561654,0.18813087429244452,126351.6736351404,1602.2899846213081,127953.96361976171,235,1,34.86842105263158,33,5,19,39.49902486591906,0.5896464646464646,48.65196078431373,1005.3921568627457,30.466428995840776,0
325,4,1,3,35,0.02631578947368421,0.07894736842105263,0.9210526315789473,38,1350,1100,250,0.8148148148148148,16,11,5,362.9802419797389,0.47974454717875775,0.17775453538032449,0.18872293761972397,126612.30867346932,1591.5532879818513,128203.86196145117,236,0,35.68421052631579,34,4,20,39.2600149830455,0.5900735294117647,48.39285714285714,1006.4285714285709,29.60084033613444,0
326,4,4,6,33,0.10256410256410256,0.15384615384615385,0.8461538461538461,39,1100,600,500,0.5454545454545454,16,6,10,340.1666578591697,0.48071300044984255,0.14211555845797075,0.18042235305213383,127422.33737244901,870.780187074831,128293.11755952385,237,0,33.41025641025641,34,5,15,39.003114805643975,0.5983455882352942,47.589285714285715,1009.6428571428575,29.695378151260513,0
327,4,3,0,36,0.08333333333333333,0.0,1.0,36,1000,800,200,0.8,12,8,4,413.22169969621854,0.4765873015873016,0.10107863604732104,0.2040548393345242,124479.70920138879,3146.503861961441,127626.21306335022,238,0,30.833333333333332,33,3,16,40.21181280445372,0.5703914141414141,50.52083333333333,997.9166666666658,30.239898989898965,15
328,4,3,3,36,0.07692307692307693,0.07692307692307693,0.9230769230769231,39,1350,1000,350,0.7407407407407407,17,10,7,390.14761424184206,0.47911043634727846,0.12621908085373446,0.19823160012768762,125666.39506440744,2006.7739143947028,127673.16897880213,239,0,29.384615384615383,35,4,15,39.554835699719106,0.5782738095238096,49.33449074074073,1002.6620370370358,28.647486772486737,0
329,4,3,4,35,0.07692307692307693,0.10256410256410256,0.8974358974358975,39,1150,700,450,0.6086956521739131,16,7,9,397.03423006779985,0.47781713900134953,0.156022887907856,0.20516441103373698,126361.00788503712,2235.6270279871383,128596.63491302426,240,0,29.564102564102566,32,7,14,38.66293063753193,0.5921223958333333,48.64267676767676,1005.4292929292919,31.419665404040373,0
330,4,7,6,36,0.16666666666666666,0.14285714285714285,0.8571428571428572,42,1150,900,250,0.782608695652174,14,9,5,364.09089859900524,0.4764929345722029,0.1807203320586983,0.19574923957887475,127968.81028163577,920.5641882843512,128889.37446992012,241,0,28.0,35,7,18,37.83888126286891,0.6017857142857144,47.04861111111111,1011.8055555555553,28.90873015873015,0
331,4,1,2,35,0.02702702702702703,0.05405405405405406,0.9459459459459459,37,1300,1000,300,0.7692307692307693,16,10,6,388.1668171298035,0.4737862862862863,0.18427794598645142,0.2076186843525944,127761.29548324166,2518.539084022061,130279.83456726372,242,0,30.756756756756758,32,5,19,37.44301860871738,0.6064453125,47.25378787878789,1010.9848484848496,31.59327651515155,0
332,4,1,4,32,0.027777777777777776,0.1111111111111111,0.8888888888888888,36,1150,700,450,0.6086956521739131,16,7,9,392.1516170191692,0.47351190476190474,0.1835506376165157,0.21106664594688224,128012.72922092004,2840.079752604159,130852.8089735242,243,0,31.75,31,5,20,37.083976668382235,0.6115591397849462,47.00520833333333,1011.9791666666658,32.6444892473118,0
333,4,1,0,33,0.030303030303030304,0.0,1.0,33,1200,900,300,0.75,15,9,6,406.2727565242426,0.46938131313131315,0.17458535977054468,0.21938728852309097,128144.53125000001,3812.32638888889,131956.8576388889,244,0,33.18181818181818,29,4,21,36.59122085048011,0.6185344827586207,46.875,1012.5000000000001,34.91379310344828,0
334,4,0,1,32,0.0,0.030303030303030304,0.9696969696969697,33,650,300,350,0.46153846153846156,10,3,7,407.6514844001299,0.46863162878787884,0.17957412855931776,0.22051888903900213,128214.85339506177,3853.395061728399,132068.24845679017,245,1,34.18181818181818,29,4,21,36.484046443591154,0.6192528735632183,46.80555555555556,1012.777777777778,34.92337164750959,0
335,4,1,0,33,0.030303030303030304,0.0,1.0,33,1200,900,300,0.75,15,9,6,396.56579974876854,0.46752683080808083,0.16114808885893228,0.21783719894563272,128825.87808200372,3617.587473985433,132443.46555598915,246,0,34.39393939393939,30,3,21,36.13823425570415,0.6225694444444445,46.20295698924731,1015.1881720430108,33.83960573476703,0
336,4,1,1,33,0.029411764705882353,0.029411764705882353,0.9705882352941176,34,1500,800,700,0.5333333333333333,22,8,14,384.64122547702186,0.4669117647058823,0.14802314368370273,0.2133010432190759,129201.38888888898,3139.782597699161,132341.17148658814,247,0,34.35294117647059,30,4,22,36.057035519125655,0.6263888888888889,45.833333333333336,1016.6666666666674,33.888888888888914,0
337,4,0,2,31,0.0,0.06060606060606061,0.9393939393939394,33,1250,1100,150,0.88,14,11,3,382.3050850582623,0.4651594065656566,0.1215724902299955,0.21274153556771558,129338.07376575333,3289.3206584576346,132627.39442421097,248,1,30.636363636363637,30,3,23,35.97686531007753,0.6277777777777778,45.6989247311828,1017.2043010752693,33.90681003584231,0
338,4,0,0,31,0.0,0.0,1.0,31,900,500,400,0.5555555555555556,13,5,8,396.4759205384011,0.4632616487455197,0.13019035677647328,0.21966069990674905,129164.87327008176,4042.152406196302,133207.02567627808,249,2,32.774193548387096,28,3,23,35.79358068315666,0.6320684523809523,45.869252873563205,1016.5229885057458,36.30439244663378,0
339,4,1,1,31,0.03125,0.03125,0.96875,32,1100,800,300,0.7272727272727273,14,8,6,384.695744412985,0.46169354838709675,0.12382364975450044,0.2156413759966364,129625.34722222212,3573.2638888888714,133198.61111111098,250,0,32.71875,29,3,21,35.62295417348609,0.6336206896551724,45.41666666666666,1018.3333333333325,35.114942528735604,0
340,4,1,0,32,0.03125,0.0,1.0,32,1100,800,300,0.7272727272727273,14,8,6,403.5639283051623,0.4610845094086022,0.08265905051103561,0.20749886367008002,126155.93389048327,4027.7093519699542,130183.64324245322,251,0,32.34375,27,5,24,38.71108601194884,0.6045524691358024,48.84672619047619,1004.6130952380952,37.20789241622575,16
341,4,1,2,31,0.030303030303030304,0.06060606060606061,0.9393939393939394,33,850,400,450,0.47058823529411764,13,4,9,404.8082053285574,0.4623974116161616,0.05505145109105514,0.20808366758085522,126145.08360793143,3612.912981269499,129757.99658920093,252,0,32.333333333333336,30,3,18,38.69107349924183,0.5951388888888889,48.857526881720425,1004.5698924731173,33.48566308243724,16
342,4,3,2,32,0.08823529411764706,0.058823529411764705,0.9411764705882353,34,1500,1200,300,0.8,18,12,6,381.0897173327922,0.4646464646464647,0.06019514122662417,0.20000105097445045,126993.56291029182,2879.1881985134496,129872.75110880527,253,0,31.823529411764707,31,3,18,38.411407871506704,0.6011424731182795,48.014322916666664,1007.9427083333328,32.514280913978475,0
343,4,4,3,33,0.1111111111111111,0.08333333333333333,0.9166666666666666,36,800,500,300,0.625,11,5,6,357.53183276000175,0.4656415343915344,0.07451285366083571,0.1914338190851898,127803.5359747453,1938.7664900519007,129742.3024647972,254,0,30.944444444444443,33,3,21,38.17403446046945,0.6044823232323233,47.21200980392157,1011.1519607843138,30.640968508615572,0
344,4,2,1,34,0.05714285714285714,0.02857142857142857,0.9714285714285714,35,850,500,350,0.5882352941176471,12,5,7,363.3506887623758,0.4663165266106442,0.09110774440780678,0.1955846722921722,128016.72222541075,2302.9928387409523,130319.7150641517,255,0,31.514285714285716,32,3,23,37.80853607818673,0.6090494791666667,47.00126262626263,1011.9949494949501,31.62484217171719,0
345,4,0,1,33,0.0,0.029411764705882353,0.9705882352941176,34,750,200,550,0.26666666666666666,13,2,11,369.1737960249711,0.46598336304218657,0.09404119388071797,0.1985363023467163,127979.78931003154,2649.356926812076,130629.14623684362,256,1,33.029411764705884,31,3,23,37.69905739287092,0.6112231182795699,47.03776041666667,1011.8489583333339,32.640288978494645,0
346,4,4,1,36,0.10810810810810811,0.02702702702702703,0.972972972972973,37,1150,900,250,0.782608695652174,14,9,5,338.95458210158597,0.46621621621621623,0.09592379264510464,0.18796572280178836,129201.38888888876,1358.680555555547,130560.0694444443,257,0,30.756756756756758,34,3,21,37.21823770491806,0.616421568627451,45.83333333333333,1016.6666666666656,29.901960784313694,0
347,4,0,2,34,0.0,0.05555555555555555,0.9444444444444444,36,1100,800,300,0.7272727272727273,14,8,6,348.2908583396683,0.46555886243386246,0.10616108029901206,0.19283874359607528,129139.10064638591,1795.5936418685055,130934.69428825441,258,1,32.611111111111114,33,3,21,37.0443493288321,0.6180555555555556,45.89460784313725,1016.4215686274501,30.800653594771216,0
348,4,1,0,35,0.02857142857142857,0.0,1.0,35,1000,800,200,0.8,12,8,4,360.16682927173946,0.4612394957983193,0.11478254697730517,0.19956663058959195,129169.2991308284,2304.4993814406544,131473.79851226904,259,0,34.25714285714286,32,3,22,36.71179563615284,0.6207682291666667,45.86489898989898,1016.5404040404034,31.766887626262605,0
349,4,1,1,35,0.027777777777777776,0.027777777777777776,0.9722222222222222,36,900,500,400,0.5555555555555556,13,5,8,355.287147295095,0.46124338624338623,0.13713752857658523,0.19937822290138635,129669.02941476816,2013.9479106593346,131682.9773254275,260,0,34.27777777777778,33,3,18,36.32723198171099,0.6234217171717171,45.37377450980391,1018.5049019607827,30.863784907902506,0
350,4,0,1,34,0.0,0.02857142857142857,0.9714285714285714,35,900,400,500,0.4444444444444444,14,4,10,354.51516932998396,0.45920868347338933,0.12291623720195122,0.1997390344273811,129825.097318339,2204.9932718185128,132030.09059015752,261,1,35.08571428571429,33,2,18,36.188271604938265,0.625,45.22058823529411,1019.1176470588227,30.882352941176446,0
351,4,0,1,33,0.0,0.029411764705882353,0.9705882352941176,34,800,600,200,0.75,10,6,4,361.2679679344315,0.45653223410576355,0.12232056927877744,0.20297423156650368,129715.36705438212,2572.4014131210997,132287.76846750322,262,2,36.85294117647059,32,2,19,36.12780945298297,0.6263020833333333,45.32828282828282,1018.686868686868,31.833964646464626,0
352,4,0,1,32,0.0,0.030303030303030304,0.9696969696969697,33,1350,800,550,0.5925925925925926,19,8,11,370.5240453916122,0.4549794823232323,0.12320365139697675,0.20773251319052313,129631.97708129874,3006.352912055106,132638.32999335384,263,3,38.81818181818182,31,2,20,35.97699036781316,0.6280241935483871,45.41015624999999,1018.3593749999993,32.85030241935482,0
353,4,1,0,33,0.030303030303030304,0.0,1.0,33,1250,1000,250,0.8,15,10,5,372.31234027908516,0.4551373106060606,0.13267687734413958,0.21015380764563515,129897.31046888571,3072.4743313259596,132969.78480021167,264,0,39.03030303030303,31,2,21,35.66134989568697,0.6307123655913979,45.149739583333336,1019.4010416666673,32.88390456989249,0
354,4,0,0,33,0.0,0.0,1.0,33,1150,700,450,0.6086956521739131,16,7,9,372.4446075583715,0.453677398989899,0.13406373191895993,0.21094422349998007,130030.07888793945,3085.800340440538,133115.87922837998,265,1,40.03030303030303,31,2,22,35.52292118813567,0.6320564516129032,45.01953125,1019.921875,32.90070564516129,0
355,4,1,1,33,0.029411764705882353,0.029411764705882353,0.9705882352941176,34,1300,700,600,0.5384615384615384,19,7,12,364.0156951424786,0.4548054070112894,0.1316705162432128,0.20811509567766787,130395.54172092018,2693.412441677521,133088.9541625977,266,0,39.8235294117647,31,3,23,35.366734659187486,0.635752688172043,44.661458333333336,1021.3541666666671,32.94690860215055,0
356,4,0,0,33,0.0,0.0,1.0,33,1400,900,500,0.6428571428571429,19,9,10,374.6558932638802,0.45379577020202017,0.13307173591421528,0.21422198140799284,130399.83171826221,3171.013086773036,133570.84480503525,267,1,41.333333333333336,30,3,23,35.09069175768741,0.6385416666666667,44.65725806451613,1021.3709677419354,34.04569892473118,0
357,4,0,1,32,0.0,0.030303030303030304,0.9696969696969697,33,1400,1100,300,0.7857142857142857,17,11,6,374.70602493074796,0.453716856060606,0.1344896331738441,0.21444019499048825,130434.15423748402,3174.8926899063354,133609.04692739036,268,2,42.333333333333336,30,3,23,35.05455043859649,0.6388888888888888,44.62365591397849,1021.5053763440853,34.05017921146951,0
358,4,2,1,33,0.058823529411764705,0.029411764705882353,0.9705882352941176,34,750,600,150,0.8,9,6,3,380.4296797506762,0.4553624480095068,0.14184738587562862,0.19292145419767512,125586.62414550793,2938.3133553813714,128524.9375008893,269,0,40.73529411764706,31,3,17,39.88102970468521,0.5866935483870968,49.41406250000001,1002.3437500000009,32.33366935483874,16
359,4,0,1,32,0.0,0.030303030303030304,0.9696969696969697,33,1400,1200,200,0.8571428571428571,16,12,4,392.7716265940169,0.45284880050505055,0.17175372543285672,0.19975931193033122,125706.64103147757,3274.800374320722,128981.4414057983,270,1,42.878787878787875,30,3,19,39.44734843407944,0.590625,49.29435483870967,1002.8225806451608,33.42741935483869,0
360,4,2,1,33,0.058823529411764705,0.029411764705882353,0.9705882352941176,34,1100,900,200,0.8181818181818182,13,9,4,378.34229235420634,0.45625371360665473,0.16963755199049313,0.19555282339753552,126370.92590332033,2762.2931586371533,129133.21906195748,271,0,41.61764705882353,31,3,16,39.12252870586203,0.594758064516129,48.6328125,1005.4687500000001,32.434475806451616,0
361,4,1,1,33,0.029411764705882353,0.029411764705882353,0.9705882352941176,34,1200,900,300,0.75,15,9,6,391.3391600984283,0.45647653000594174,0.20836913951100788,0.20438949381237975,126796.77539401593,3124.108717176659,129920.88411119259,272,0,42.588235294117645,31,3,18,38.35609243697478,0.5991263440860215,48.20963541666667,1007.1614583333342,32.48907930107529,0
362,4,3,1,35,0.08333333333333333,0.027777777777777776,0.9722222222222222,36,1150,900,250,0.782608695652174,14,9,5,368.0814945270248,0.45823412698412697,0.20440766339274852,0.19647689872908586,127679.65032980118,2199.3033028162426,129878.95363261743,273,0,40.361111111111114,33,3,20,38.03441150317286,0.603219696969697,47.33455882352942,1010.6617647058836,30.626114081996473,0
363,4,1,0,36,0.027777777777777776,0.0,1.0,36,900,500,400,0.5555555555555556,13,5,8,362.6293135471299,0.4551421957671958,0.19090206358808892,0.19627578758788664,128237.60880730968,2101.387987793153,130338.99679510282,274,0,38.916666666666664,33,3,21,37.60070074611815,0.6089015151515151,46.783088235294116,1012.8676470588234,30.692959001782526,0
364,4,1,0,37,0.02702702702702703,0.0,1.0,37,650,400,250,0.6153846153846154,9,4,5,354.30212809568457,0.4574574574574575,0.19370109719957118,0.19321034104475301,128536.5717120182,1708.1561791383278,130244.72789115652,275,0,38.83783783783784,34,3,16,37.5061145026219,0.6096813725490196,46.48809523809524,1014.0476190476195,29.82492997198881,0
365,4,1,0,38,0.02631578947368421,0.0,1.0,38,1300,800,500,0.6153846153846154,18,8,10,343.9519602650871,0.4577850877192982,0.19062082116536683,0.1897464711028705,128995.54887099194,1273.6543799297062,130269.20325092165,276,0,38.78947368421053,35,3,18,37.30073392579091,0.6122023809523809,46.03587962962963,1015.8564814814815,29.024470899470902,0
366,4,0,2,36,0.0,0.05263157894736842,0.9473684210526316,38,1100,800,300,0.7272727272727273,14,8,6,349.3764430565031,0.45830369843527735,0.09160276096221054,0.180635915463319,126383.31056986057,1231.0703017206583,127614.38087158122,277,1,39.78947368421053,36,2,16,39.83788778138648,0.5836226851851851,48.620495495495504,1005.5180180180193,27.931056056056093,16
367,4,2,0,38,0.05263157894736842,0.0,1.0,38,1200,900,300,0.75,15,9,6,345.3304105820551,0.45980026078710284,0.11552814041365989,0.1801601243538354,126751.5890045452,1154.2356545735033,127905.8246591187,278,0,40.526315789473685,36,2,19,39.56096697234025,0.5873842592592593,48.25450450450451,1006.9819819819828,27.971721721721746,0
368,4,2,2,38,0.05,0.05,0.95,40,650,500,150,0.7692307692307693,8,5,3,329.80876446534324,0.46279380341880344,0.12600031756113061,0.174549209966616,127334.51727892821,399.20796351083345,127733.72524243905,279,0,39.45,38,2,13,39.35442468508521,0.5896381578947368,47.676282051282044,1009.2948717948707,26.560391363022912,0
369,4,2,2,38,0.05,0.05,0.95,40,1250,800,450,0.64,17,8,9,324.3256350316679,0.4630608974358974,0.11420190274841469,0.17314449816024702,127685.20801373366,282.31723464095444,127967.52524837462,280,0,38.375,38,2,14,39.134293516560966,0.5932017543859649,47.32905982905983,1010.6837606837606,26.59694107062528,0
370,4,0,1,37,0.0,0.02631578947368421,0.9736842105263158,38,850,500,350,0.5882352941176471,12,5,7,333.64970242703987,0.4614894499762921,0.1235395602396554,0.17738613995661678,127518.18700034515,909.2810293401733,128427.46802968532,281,1,40.86842105263158,36,2,15,39.069526517263164,0.5951967592592593,47.49436936936938,1010.0225225225242,28.05618118118123,0
371,4,2,3,36,0.05128205128205128,0.07692307692307693,0.9230769230769231,39,800,600,200,0.75,10,6,4,321.28797329879546,0.46201641925326137,0.1396329220438397,0.1733753277304373,128116.77781865597,432.47597818562343,128549.2537968416,282,0,40.333333333333336,37,2,18,38.770691180187015,0.5993806306306306,46.90241228070177,1012.3903508771948,27.36190137505932,0
372,4,1,0,37,0.02702702702702703,0.0,1.0,37,1300,1000,300,0.7692307692307693,16,10,6,327.78504357208135,0.45999124124124124,0.12623034603012306,0.17687800370426282,128116.02776763283,998.903548819125,129114.93131645196,283,0,42.13513513513514,36,1,19,38.607017055988116,0.6012731481481481,46.90315315315317,1012.38738738739,28.121871871871946,0
373,4,2,3,36,0.05128205128205128,0.07692307692307693,0.9230769230769231,39,1000,700,300,0.7,13,7,6,314.7286426592798,0.4609199280251912,0.14917139001349544,0.17262829707062127,128767.2812111916,305.35032690483115,129072.63153809644,284,0,40.92307692307692,38,1,17,38.2747807017544,0.6041666666666667,46.26068376068377,1014.957264957266,26.70940170940174,0
374,4,1,0,37,0.02702702702702703,0.0,1.0,37,700,500,200,0.7142857142857143,9,5,4,327.22600735894633,0.4613363363363363,0.15877853436122025,0.1791194608933237,128686.6997910073,1021.9269945621373,129708.62678556943,285,0,42.91891891891892,36,1,18,38.039678135405104,0.6070601851851851,46.340090090090094,1014.6396396396402,28.18443443443445,0
375,4,0,0,37,0.0,0.0,1.0,37,1150,700,450,0.6086956521739131,16,7,9,327.7127140920218,0.4607732732732733,0.1597872142640806,0.17977326184488104,128772.40997331799,1040.0711945053233,129812.48116782331,286,1,43.91891891891892,36,1,18,37.94010503347017,0.6079282407407407,46.255630630630634,1014.9774774774781,28.193818818818837,0
376,4,0,1,36,0.0,0.02702702702702703,0.972972972972973,37,1350,1100,250,0.8148148148148148,16,11,5,327.107168794778,0.4600538038038038,0.15891304412985652,0.17995883715817662,128886.73460200077,1031.9549701728922,129918.68957217367,287,2,44.91891891891892,36,1,18,37.839174152526724,0.6090856481481481,46.143018018018026,1015.427927927929,28.20633133133136,0
377,4,1,1,36,0.02702702702702703,0.02702702702702703,0.972972972972973,37,700,500,200,0.7142857142857143,9,5,4,325.6369157173914,0.45752002002002,0.1597057043742922,0.17979781233796258,129029.71172185714,1003.3674722019525,130033.07919405909,288,0,45.67567567567568,36,1,19,37.73114793467819,0.6105324074074074,46.00225225225226,1015.9909909909923,28.221971971972007,0
378,4,1,0,37,0.02702702702702703,0.0,1.0,37,1250,900,350,0.72,16,9,7,323.53969244398985,0.4578953953953954,0.15166012907626958,0.18006987318832815,129344.54038075259,969.6185628195999,130314.15894357218,289,0,45.4054054054054,36,1,21,37.46471272002656,0.6137152777777778,45.69256756756758,1017.2297297297315,28.25638138138143,0
379,4,0,1,36,0.0,0.02702702702702703,0.972972972972973,37,950,600,350,0.631578947368421,13,6,7,324.72705748568296,0.45811436436436437,0.14956111746016565,0.180862160131052,129373.1801903256,1002.194424153902,130375.3746144795,290,1,46.4054054054054,36,1,21,37.4054497823039,0.6140046296296297,45.66441441441442,1017.3423423423434,28.259509509509538,0
380,4,0,0,36,0.0,0.0,1.0,36,1300,900,400,0.6923076923076923,17,9,8,327.9837490531983,0.45729166666666665,0.1322927328556811,0.18310864161427107,129466.2814670138,1292.5672743055507,130758.84874131935,291,2,45.77777777777778,35,1,18,37.22812180143296,0.6169642857142856,45.572916666666664,1017.7083333333326,29.07738095238093,0
381,4,1,0,37,0.02702702702702703,0.0,1.0,37,1050,700,350,0.6666666666666666,14,7,7,374.57795933287457,0.4578953953953954,0.09782592259933609,0.19474131603012823,126609.88004474092,2117.877450402282,128727.7574951432,292,0,45.513513513513516,36,1,14,38.97071164820409,0.5859375,48.39527027027028,1006.4189189189208,27.956081081081134,16
382,4,1,2,36,0.02631578947368421,0.05263157894736842,0.9473684210526316,38,1400,1200,200,0.8571428571428571,16,12,4,342.1657331739864,0.4592223802750119,0.009060955518945146,0.16940831976884993,124589.1539343838,926.0278402970284,125515.18177468082,293,0,45.28947368421053,37,1,16,41.87111019586306,0.5633445945945945,50.41118421052632,998.3552631578959,26.982574679943134,16
383,4,3,3,36,0.07692307692307693,0.07692307692307693,0.9230769230769231,39,1250,1100,150,0.88,14,11,3,411.94585153981274,0.46361898335582546,0.12581005149088642,0.19666284941675868,123050.5895444342,2749.8423756322472,125800.43192006645,294,0,44.43589743589744,32,7,19,41.739045134470175,0.5579427083333333,51.957070707070706,992.1717171717169,31.005366161616152,16
384,4,7,2,41,0.16279069767441862,0.046511627906976744,0.9534883720930233,43,1600,1100,500,0.6875,21,11,10,350.1914362058776,0.47238372093023256,0.1278705571197858,0.1643397114967167,122316.90505378405,240.8899083250801,122557.79496210914,295,0,38.44186046511628,38,5,17,44.03733304532528,0.5381030701754386,52.697649572649574,989.2094017094016,26.031826360773728,16
385,4,7,3,45,0.14583333333333334,0.0625,0.9375,48,850,600,250,0.7058823529411765,11,6,5,320.6261938879304,0.4796283983451537,0.19628665498897124,0.15629766453474242,123936.3807763955,-1649.5309139487179,122286.84986244678,296,0,34.416666666666664,42,6,19,43.08441189827429,0.5486111111111112,51.06589147286821,995.7364341085258,23.708010335917283,0
386,4,6,9,42,0.11764705882352941,0.17647058823529413,0.8235294117647058,51,1300,1000,300,0.7692307692307693,16,10,6,304.59405448656145,0.4817320261437909,0.23858347622213705,0.15284256883340588,125148.85381235821,-2562.4424502764873,122586.41136208172,297,0,32.549019607843135,41,10,19,42.2318064644061,0.5625,49.851190476190474,1000.5952380952376,24.404761904761894,0
387,4,7,4,45,0.14285714285714285,0.08163265306122448,0.9183673469387755,49,1250,1000,250,0.8,15,10,5,336.8419721355852,0.4807610544217687,0.29283062764082923,0.1626933088088072,123545.92013888908,-816.6560374149474,122729.26410147414,298,0,34.285714285714285,39,10,14,43.08640681754681,0.5491452991452992,51.45833333333334,994.1666666666682,25.49145299145303,16
388,4,11,9,47,0.19642857142857142,0.16071428571428573,0.8392857142857143,56,1300,800,500,0.6153846153846154,18,8,10,330.2412813574476,0.4839623917748918,0.3952382075789642,0.16865382450818645,125877.48153588432,-2859.796562930458,123017.68497295387,299,0,30.660714285714285,43,13,16,40.83909361139943,0.5671027131782946,49.124053030303024,1003.5037878787871,23.337297392529933,0
389,4,5,3,49,0.09615384615384616,0.057692307692307696,0.9423076923076923,52,1650,1100,550,0.6666666666666666,22,11,11,343.68126014194615,0.480784942182001,0.3940633758953591,0.1761188200312463,126018.32573203783,-1737.9726022869938,124280.35312975085,300,0,33.38461538461539,40,12,20,40.356781376518214,0.5729166666666667,48.983739837398375,1004.0650406504068,25.10162601626017,0
390,4,2,1,50,0.0392156862745098,0.0196078431372549,0.9803921568627451,51,1750,1300,450,0.7428571428571429,22,13,9,349.2891095543878,0.47936274509803917,0.3937020681354251,0.1795599239095155,126148.45920138873,-1387.5434027777942,124760.91579861093,301,0,34.88235294117647,39,12,22,40.08191621733721,0.5758547008547008,48.85416666666666,1004.583333333332,25.758547008546973,0
391,4,2,5,47,0.038461538461538464,0.09615384615384616,0.9038461538461539,52,1950,1600,350,0.8205128205128205,23,16,7,336.1176105940616,0.4791666666666667,0.3860690162306404,0.1749915543713666,126667.2288851881,-1884.982737307911,124782.24614788019,302,0,35.03846153846154,41,11,18,39.879500509181696,0.5779979674796748,48.33829365079364,1006.6468253968235,24.552361595044474,0
392,4,3,3,47,0.06,0.06,0.94,50,1650,1000,650,0.6060606060606061,23,10,13,352.77554834581076,0.4775085034013606,0.2255405549059213,0.18183888127611172,126258.49364681481,-802.1021319441819,125456.39151487063,303,0,37.16,38,12,17,39.88098401899294,0.5786732456140351,48.74465811965811,1005.0213675213663,26.447930724246483,16
393,4,2,3,46,0.04081632653061224,0.061224489795918366,0.9387755102040817,49,1500,1000,500,0.6666666666666666,20,10,10,347.06410888669785,0.47558815192743764,0.2550978190200375,0.18117795921795854,126777.10503472212,-1000.0434027777856,125777.06163194434,304,0,37.816326530612244,39,10,19,39.491104675217244,0.5822649572649572,48.229166666666664,1007.0833333333325,25.82264957264955,0
394,4,1,2,45,0.02127659574468085,0.0425531914893617,0.9574468085106383,47,1200,800,400,0.6666666666666666,16,8,8,355.08371947720156,0.47421369102682703,0.26563900423586473,0.18566614290478373,126843.36917368801,-391.9969365574137,126451.3722371306,305,0,38.787234042553195,37,10,20,39.22106872029316,0.5864301801801801,48.16337719298245,1007.3464912280699,27.22558084400189,0
395,4,0,3,42,0.0,0.06666666666666667,0.9333333333333333,45,1200,900,300,0.75,15,9,6,361.73328468038494,0.47382154882154887,0.21951543136162188,0.17755888194100466,124227.38803854855,16.035769542093988,124243.42380809065,306,1,40.577777777777776,34,11,16,41.75846867287637,0.5655637254901961,50.77380952380951,996.9047619047603,29.32072829131648,16
396,4,3,2,43,0.06666666666666667,0.044444444444444446,0.9555555555555556,45,1300,900,400,0.6923076923076923,17,9,8,348.9894682397768,0.4757996632996633,0.2410054745932606,0.17522432882700983,125173.6713927469,-260.74627188839077,124912.9251208585,307,0,39.48888888888889,35,10,19,41.09559333795975,0.5732142857142857,49.826388888888886,1000.6944444444442,28.591269841269835,0
397,4,4,2,45,0.0851063829787234,0.0425531914893617,0.9574468085106383,47,1450,1200,250,0.8275862068965517,17,12,5,324.8698691283131,0.4773743447425223,0.24664496960320426,0.16669373284852748,126071.36480695962,-1205.6283610769333,124865.73644588269,308,0,38.319148936170215,37,10,22,40.77444317065182,0.5785472972972974,48.93092105263157,1004.2763157894719,27.142603129445188,0
398,4,2,5,42,0.0425531914893617,0.10638297872340426,0.8936170212765957,47,1250,1000,250,0.8,15,10,5,326.70094811009074,0.4760831020659883,0.265949330395965,0.16944495188864217,126512.22160905263,-1133.6674505617298,125378.55415849091,309,0,38.8936170212766,37,10,18,40.27554495912806,0.5830518018018018,48.4923245614035,1006.0307017543847,27.190018966334723,0
399,4,2,2,42,0.045454545454545456,0.045454545454545456,0.9545454545454546,44,750,100,650,0.13333333333333333,14,1,13,336.53537029178415,0.4748282241014799,0.2633634481460574,0.17478127295799104,126567.38281249999,-281.1197916666657,126286.26302083331,310,0,41.0,35,9,19,39.97153209109731,0.5875,48.4375,1006.2499999999999,28.749999999999996,0
400,4,3,3,42,0.06666666666666667,0.06666666666666667,0.9333333333333333,45,1450,1000,450,0.6896551724137931,19,10,9,362.43209406245154,0.47615740740740736,0.16584913778836952,0.18024956144705917,124776.88536352038,288.77019557822894,125065.65555909861,311,0,40.22222222222222,41,4,17,41.17050193625261,0.5586890243902439,50.223214285714285,999.1071428571427,24.3684668989547,16
401,4,3,4,41,0.06666666666666667,0.08888888888888889,0.9111111111111111,45,1750,1300,450,0.7428571428571429,22,13,9,360.92756933195153,0.4765151515151515,0.21112799558752338,0.18392958373132157,125788.8422586591,80.33151556902374,125869.17377422813,312,0,40.86666666666667,40,5,17,40.16078242663695,0.5705729166666667,49.21239837398375,1003.150406504067,25.078760162601675,0
402,4,2,1,42,0.046511627906976744,0.023255813953488372,0.9767441860465116,43,1600,1400,200,0.875,18,14,4,375.1834938915397,0.47674418604651164,0.25206751100082014,0.19265339408229487,126101.95500042876,863.0490012614891,126965.00400169025,313,0,43.25581395348837,35,8,19,39.47962280095261,0.5827380952380952,48.90046296296297,1004.3981481481488,28.697089947089967,0
403,4,1,1,42,0.023255813953488372,0.023255813953488372,0.9767441860465116,43,850,600,250,0.7058823529411765,11,6,5,366.9311987331657,0.47632890365448505,0.25269998646101244,0.19010611758031565,126468.25034493982,681.0293401509941,127149.27968509082,314,0,43.372093023255815,36,7,18,39.30903866248694,0.5844907407407407,48.53603603603605,1005.8558558558582,27.940440440440504,0
404,4,0,1,41,0.0,0.023809523809523808,0.9761904761904762,42,1500,1100,400,0.7333333333333333,19,11,8,372.37300167941714,0.47507742934572206,0.251021930876435,0.19332671528213807,126553.21865362002,1025.0003804480325,127578.21903406805,315,1,45.142857142857146,36,6,18,39.08459242678605,0.5853587962962963,48.451576576576585,1006.1936936936952,27.949824824824866,0
405,4,1,2,40,0.023809523809523808,0.047619047619047616,0.9523809523809523,42,1300,900,400,0.6923076923076923,17,9,8,363.71998656770455,0.4759243128145567,0.24184399427443326,0.19068132160482668,126950.11470507688,834.8588030598366,127784.97350813671,316,0,45.642857142857146,36,6,19,38.893777703281565,0.5894097222222222,48.05743243243244,1007.7702702702718,27.99361861861866,0
406,4,3,0,43,0.06976744186046512,0.0,1.0,43,1400,800,600,0.5714285714285714,20,8,12,354.8078414995916,0.47759782207456625,0.2517400588983978,0.18965065407940201,127734.70320001696,464.41338540427495,128199.11658542123,317,0,44.906976744186046,35,8,19,38.31339210747271,0.5994047619047619,47.28009259259258,1010.8796296296281,28.882275132275087,0
407,4,2,3,42,0.044444444444444446,0.06666666666666667,0.9333333333333333,45,1700,1100,600,0.6470588235294118,23,11,12,344.7567994868268,0.4774410774410774,0.26294860246217344,0.18701243597402026,128325.39859693851,-149.8200572667671,128175.57853967174,318,0,43.86666666666667,34,11,21,37.96361571299885,0.6075367647058824,46.696428571428555,1013.2142857142835,29.800420168067163,0
408,4,1,2,41,0.023255813953488372,0.046511627906976744,0.9534883720930233,43,1400,1100,300,0.7857142857142857,17,11,6,340.79632638925864,0.4765826873385013,0.22835681548124231,0.18675638686131396,128731.13854595354,174.2198216735436,128905.35836762708,319,0,41.51162790697674,35,8,20,37.65016727493918,0.6095238095238096,46.296296296296305,1014.8148148148163,28.994708994709036,0
409,4,0,2,39,0.0,0.04878048780487805,0.9512195121951219,41,1300,900,400,0.6923076923076923,17,9,8,350.18404637527834,0.4747205284552845,0.22626817817473976,0.19125436378957508,128596.93877551022,806.5192743764222,129403.45804988664,320,1,44.02439024390244,34,7,20,37.54890453834116,0.6102941176470589,46.42857142857143,1014.2857142857144,29.831932773109248,0
410,4,0,2,37,0.0,0.05128205128205128,0.9487179487179487,39,1200,700,500,0.5833333333333334,17,7,10,357.9865895972489,0.4741059379217274,0.21650548848576778,0.19536756930038207,128566.7534722223,1405.0347222222279,129971.78819444454,321,2,46.38461538461539,34,5,20,37.38188167625307,0.6099877450980392,46.458333333333336,1014.1666666666673,29.828431372549037,0
411,4,1,1,37,0.02631578947368421,0.02631578947368421,0.9736842105263158,38,1550,1200,350,0.7741935483870968,19,12,7,361.30354304314636,0.4741880037932669,0.20831081811304464,0.19770205108091282,128672.41753472229,1697.9600694444553,130370.37760416674,322,0,47.8421052631579,33,5,21,37.189852840520196,0.6133207070707071,46.35416666666667,1014.5833333333339,30.744949494949513,0
412,4,0,0,37,0.0,0.0,1.0,37,1250,900,350,0.72,16,9,7,367.8187717138677,0.47362987987987987,0.2027329794320083,0.20102421849994687,128624.38303489468,2062.092516069827,130686.4755509645,323,1,49.729729729729726,32,5,22,37.07368683096838,0.615234375,46.40151515151517,1014.3939393939418,31.69981060606068,0
413,4,1,0,38,0.02631578947368421,0.0,1.0,38,1500,1200,300,0.8,18,12,6,360.00210586136524,0.4731211474632527,0.20178315986780415,0.1990270709606616,129080.3854875284,1693.842120181414,130774.22760770982,324,0,49.39473684210526,34,4,23,36.80661316776006,0.6151960784313726,45.952380952380956,1016.1904761904767,29.887955182072844,0
414,4,0,1,37,0.0,0.02631578947368421,0.9736842105263158,38,1100,600,500,0.5454545454545454,16,6,10,373.6490576087523,0.47252844950213374,0.12354616662710649,0.19034866743720333,125775.00708616765,1818.6011904761722,127593.60827664382,325,1,50.39473684210526,34,4,16,39.85605071603765,0.5814950980392157,49.22619047619047,1003.0952380952369,29.502801120448144,15
415,4,3,2,38,0.075,0.05,0.95,40,1100,900,200,0.8181818181818182,13,9,4,357.96616964835914,0.4730101495726496,0.13580576307363934,0.18013657409264894,125267.23669552182,968.2865804660538,126235.52327598787,326,0,48.6,38,2,15,40.7741906794735,0.5685307017543859,49.732905982905976,1001.068376068375,26.343904633378287,16
416,4,1,0,39,0.02564102564102564,0.0,1.0,39,1350,1000,350,0.7407407407407407,17,10,7,387.921055124945,0.47309379217273956,0.19789985655370268,0.1981168245816682,125878.73191751304,1966.2021006463442,127844.93401815939,327,0,50.48717948717949,37,2,16,39.390752476689954,0.5765765765765766,49.122807017543856,1003.5087719298242,27.121858700806058,0
417,4,2,2,39,0.04878048780487805,0.04878048780487805,0.9512195121951219,41,1700,1600,100,0.9411764705882353,18,16,2,374.62068965517255,0.4727642276422764,0.20730025231286797,0.19539568345323738,126742.13927469129,1296.1537310625417,128038.29300575383,328,0,48.97560975609756,38,3,18,38.83333333333335,0.5836074561403508,48.263888888888886,1006.9444444444439,26.498538011695892,0
418,4,0,3,36,0.0,0.07692307692307693,0.9230769230769231,39,950,800,150,0.8421052631578947,11,8,3,382.1197176125103,0.4721378767431399,0.19679637806525996,0.1986622406226302,126609.880044741,1876.026321930073,128485.90636667107,329,1,51.64102564102564,36,3,18,38.78095744284063,0.5859375,48.39527027027029,1006.4189189189215,27.95608108108115,0
419,4,0,2,34,0.0,0.05555555555555555,0.9444444444444444,36,1400,1000,400,0.7142857142857143,18,10,8,363.40700085595154,0.47154431216931214,0.13948654607272837,0.17737823624042537,123990.14314058961,1812.6934565218917,125802.83659711151,330,2,54.27777777777778,34,2,18,41.963503067973576,0.5631127450980392,51.011904761904766,995.9523809523813,29.292717086834745,16
420,4,6,4,36,0.15,0.1,0.9,40,1350,1000,350,0.7407407407407407,17,10,7,335.11353190908807,0.47650908119658114,0.1547220398336615,0.16956076714204035,125493.907981302,415.037152326312,125908.94513362832,331,0,45.9,37,3,16,41.11220544247466,0.5726351351351351,49.506578947368425,1001.9736842105269,27.080369843527755,0
421,4,2,3,35,0.05263157894736842,0.07894736842105263,0.9210526315789473,38,1350,900,450,0.6666666666666666,18,9,9,345.70851400161,0.476543978188715,0.17040523123130313,0.17545594023046326,125620.13660620057,1085.5901509617515,126705.72675716232,332,0,48.421052631578945,36,2,21,40.71650565416012,0.5758101851851851,49.38063063063062,1002.4774774774755,27.84659659659654,0
422,4,2,1,36,0.05405405405405406,0.02702702702702703,0.972972972972973,37,1450,1100,350,0.7586206896551724,18,11,7,349.3588438835748,0.47688313313313313,0.16545403535022962,0.1783828725836621,125869.5625964501,1394.7289737653712,127264.29157021547,333,0,47.67567567567568,35,2,23,40.36764705882354,0.5803571428571428,49.131944444444414,1003.4722222222179,28.670634920634797,0
423,4,1,0,37,0.02702702702702703,0.0,1.0,37,1050,700,350,0.6666666666666666,14,7,7,344.19928221028306,0.4758508508508508,0.16400548013451277,0.17699346976215916,126160.08659122032,1284.8422496569974,127444.92884087731,334,0,48.108108108108105,35,2,24,40.197772657450045,0.5833333333333333,48.84259259259256,1004.6296296296252,28.703703703703578,0
424,4,0,2,35,0.0,0.05405405405405406,0.9459459459459459,37,1000,700,300,0.7,13,7,6,387.632225940242,0.4757257257257257,0.03141031468758526,0.18375003694342673,122748.32766439905,2200.7965377508963,124949.12420214995,335,1,49.108108108108105,34,3,18,42.65877783117091,0.5502450980392157,52.26190476190476,990.9523809523806,29.14565826330531,16
425,4,8,3,40,0.18604651162790697,0.06976744186046512,0.9302325581395349,43,1300,600,700,0.46153846153846156,20,6,14,334.63665397920767,0.4838270579549649,0.08632304749838626,0.16172692973324232,123571.81125217005,-39.73086956137098,123532.08038260868,336,0,42.81395348837209,39,4,17,43.114305046272044,0.5494123931623931,51.432291666666664,994.2708333333326,25.49412393162391,14
426,4,5,4,41,0.1111111111111111,0.08888888888888889,0.9111111111111111,45,1150,1000,150,0.8695652173913043,13,10,3,325.71126589489467,0.48545875420875423,0.1316117070586682,0.16169926158924056,124702.55810657587,-875.9840361926088,123826.57407038327,337,0,41.644444444444446,41,4,13,42.16453118792214,0.5579268292682926,50.297619047619044,998.8095238095231,24.361207897793246,0
427,4,6,7,40,0.1276595744680851,0.14893617021276595,0.851063829787234,47,1100,600,500,0.5454545454545454,16,6,10,314.08417975383037,0.4879355534998458,0.19230935220750123,0.16010406267806027,125800.696744862,-1497.243961695914,124303.45278316608,338,0,40.42553191489362,42,5,15,41.32336842783092,0.5677083333333333,49.200581395348834,1003.1976744186039,23.885658914728666,0
428,4,4,3,41,0.09090909090909091,0.06818181818181818,0.9318181818181819,44,1150,900,250,0.782608695652174,14,9,5,322.16030384214844,0.48544309372797745,0.19668053420711074,0.1647839109812999,125941.8080032554,-685.3097734483397,125256.49822980705,339,0,43.65909090909091,40,4,18,40.97566737538389,0.5721354166666667,49.0599593495935,1003.7601626016265,25.09400406504066,0
429,4,6,5,42,0.1276595744680851,0.10638297872340426,0.8936170212765957,47,950,600,350,0.631578947368421,13,6,7,320.33331056621853,0.48296330558125194,0.24916476173729674,0.16852317642831485,127092.01388888877,-1252.3277934761109,125839.68609541266,340,0,41.61702127659574,40,7,20,39.84159779614328,0.5838541666666667,47.916666666666664,1008.3333333333323,25.208333333333307,0
430,4,0,3,39,0.0,0.07142857142857142,0.9285714285714286,42,1050,800,250,0.7619047619047619,13,8,5,334.7004878313491,0.48208236546651184,0.22462191274072518,0.17548386672321312,126953.84787867403,98.30296341180377,127052.15084208583,341,1,43.833333333333336,37,5,20,39.621074057955255,0.5875563063063063,48.05372807017543,1007.7850877192968,27.23743480322424,0
431,4,0,3,36,0.0,0.07692307692307693,0.9230769230769231,39,1100,900,200,0.8181818181818182,13,9,4,346.88241560357744,0.4801225820962663,0.07431089216372677,0.17332716426789158,124972.5892221644,870.1587267235907,125842.74794888799,342,2,46.82051282051282,37,2,16,41.356302774427014,0.5672860360360361,50.027412280701746,999.8903508771921,27.02406353722141,15
432,4,2,5,33,0.05263157894736842,0.13157894736842105,0.868421052631579,38,1150,800,350,0.6956521739130435,15,8,7,355.9745798958552,0.47972972972972977,0.09537762199463229,0.1791055347015269,125260.55230034704,1317.9175022602863,126578.46980260733,343,0,48.71052631578947,35,3,16,40.83094866458548,0.5741071428571429,49.73958333333332,1001.0416666666652,28.601190476190432,0
433,4,2,1,34,0.05714285714285714,0.02857142857142857,0.9714285714285714,35,900,500,400,0.5555555555555556,13,5,8,378.4172251020286,0.4782563025210084,0.11246799148844122,0.18949565469394866,125063.13928425664,2465.2092260993736,127528.34851035601,344,0,52.628571428571426,32,3,19,40.474049061684774,0.5787760416666667,49.936868686868685,1000.2525252525247,31.257891414141397,0
434,4,3,2,35,0.08108108108108109,0.05405405405405406,0.9459459459459459,37,1150,800,350,0.6956521739130435,15,8,7,360.4307635429464,0.4782282282282282,0.13496527477317266,0.18454842920204398,125984.07206632636,1681.707057823106,127665.77912414947,345,0,50.5945945945946,34,3,21,39.97168860429265,0.5836397058823529,49.01785714285713,1003.9285714285701,29.527310924369708,0
435,4,2,1,36,0.05405405405405406,0.02702702702702703,0.972972972972973,37,1150,800,350,0.6956521739130435,15,8,7,350.138599151116,0.47766516516516516,0.12833886518097093,0.18143545592376017,126474.91349480979,1456.7639801018627,127931.67747491166,346,0,50.432432432432435,33,4,20,39.7244558154646,0.5909090909090908,48.52941176470589,1005.8823529411773,30.481283422459917,0
436,4,0,1,35,0.0,0.027777777777777776,0.9722222222222222,36,900,600,300,0.6666666666666666,12,6,6,349.35509533172234,0.47647156084656084,0.1098392596200688,0.18157620524456358,126598.21342752792,1645.5461841599513,128243.75961168787,347,1,49.916666666666664,33,3,20,39.617328300048726,0.5921717171717171,48.406862745098046,1006.3725490196082,30.496137849079037,0
437,4,0,0,35,0.0,0.0,1.0,35,1000,600,400,0.6,14,6,8,358.2070623431342,0.47640056022408966,0.10998602601311402,0.1866890924917749,126710.35640495892,2077.7089072543936,128788.06531221331,348,2,49.457142857142856,32,3,21,39.27921996488589,0.595703125,48.29545454545456,1006.8181818181838,31.463068181818244,0
438,4,5,3,37,0.125,0.075,0.925,40,1000,700,300,0.7,13,7,6,321.4285674505993,0.477323717948718,0.12809266881744374,0.1733246186450776,128087.52745566546,234.77201270125954,128322.29946836672,349,0,44.15,36,4,19,38.79695553825044,0.6009837962962963,46.931306306306325,1012.2747747747776,28.11874374374382,0
439,4,2,0,39,0.05128205128205128,0.0,1.0,39,1400,900,500,0.6428571428571429,19,9,10,403.66163844677027,0.4771142600089968,0.2864537474318949,0.2030988662551552,125260.55230034729,3125.339732151925,128385.89203249922,350,0,46.1025641025641,31,8,14,39.63753035032951,0.5833333333333333,49.739583333333336,1001.0416666666673,32.291666666666686,16
440,4,4,3,40,0.09302325581395349,0.06976744186046512,0.9302325581395349,43,1500,1100,400,0.7333333333333333,19,11,8,363.13508146056824,0.4806432262827612,0.27906426375852034,0.18838886270247174,126522.46492346945,591.3905275652005,127113.85545103466,351,0,42.72093023255814,34,9,16,39.34864710290696,0.5891544117647058,48.48214285714286,1006.0714285714291,29.590336134453796,0
441,4,1,5,36,0.024390243902439025,0.12195121951219512,0.8780487804878049,41,1500,900,600,0.6,21,9,12,414.7283723190968,0.48003048780487806,0.2097808155874028,0.2017633528356247,123851.33526662036,2162.505241016062,126013.84050763641,352,0,43.78048780487805,37,4,17,40.83085481383565,0.5557432432432432,51.15131578947368,995.3947368421041,26.902560455192003,16
442,4,4,3,37,0.1,0.075,0.925,40,1000,800,200,0.8,12,8,4,411.57292942037026,0.47888621794871794,0.2360067526089633,0.20353743230898078,124540.86356509505,2251.673885167344,126792.53745026239,353,0,44.8,33,7,18,40.18914978514427,0.5710227272727273,50.459558823529406,998.1617647058814,30.247326203208527,0
443,4,5,2,40,0.11904761904761904,0.047619047619047616,0.9523809523809523,42,1300,700,600,0.5384615384615384,19,7,12,386.8159535713286,0.48060636856368566,0.2765272733810362,0.1972811018663529,125822.05419089894,1336.5299061785963,127158.58409707753,354,0,43.285714285714285,32,10,22,39.47714783119391,0.5865885416666667,49.179292929292934,1003.2828282828286,31.352588383838395,0
444,4,4,3,41,0.09090909090909091,0.06818181818181818,0.9318181818181819,44,1750,1300,450,0.7428571428571429,22,13,9,368.2000361499916,0.480366895701198,0.2740142593562782,0.19309938820954237,126964.73095857573,550.0742908886875,127514.80524946442,355,0,41.90909090909091,32,12,21,38.765869038670324,0.5983072916666667,48.042929292929294,1007.8282828282835,31.49463383838386,0
445,4,2,2,41,0.046511627906976744,0.046511627906976744,0.9534883720930233,43,1400,1000,400,0.7142857142857143,18,10,8,367.3079962981393,0.4804817275747508,0.2776899632343306,0.19369132557266225,127187.51793503213,743.3984733700613,127930.91640840219,356,0,43.46511627906977,32,11,23,38.55926899486792,0.6005859375,47.821969696969695,1008.7121212121211,31.522253787878785,0
446,4,2,3,40,0.046511627906976744,0.06976744186046512,0.9302325581395349,43,1050,700,350,0.6666666666666666,14,7,7,360.63686639844934,0.4814968623108158,0.26086274099458495,0.19197974504683926,127569.89282024796,601.2812786960544,128171.17409894401,357,0,44.116279069767444,32,11,18,38.33505186851644,0.6044921875,47.44318181818182,1010.2272727272729,31.569602272727277,0
447,4,0,1,39,0.0,0.025,0.975,40,1200,800,400,0.6666666666666666,16,8,8,379.865216983532,0.47923344017094016,0.26255662136957114,0.20051113352168698,127227.57869406856,1665.8663573823412,128893.44505145091,358,2,45.85,30,10,24,38.2013833377742,0.60625,47.78225806451612,1008.8709677419346,33.629032258064484,0
448,4,1,1,39,0.025,0.025,0.975,40,1150,500,650,0.43478260869565216,18,5,13,367.94558401530486,0.4784855769230769,0.25716494845360893,0.19610286620595896,127617.73003472213,1391.2760416666583,129009.00607638879,359,0,46.5,31,9,19,38.101374570446744,0.6075268817204301,47.39583333333333,1010.4166666666658,32.59408602150535,0
449,4,0,2,37,0.0,0.05128205128205128,0.9487179487179487,39,1200,800,400,0.6666666666666666,16,8,8,367.7118710478317,0.47663630229419707,0.24402727557911086,0.19678033622924962,127782.23885430218,1597.4092271592704,129379.64808146145,360,1,47.87179487179487,31,8,19,37.938532946984324,0.6092069892473118,47.23307291666666,1011.0677083333323,32.615087365591364,0
450,4,0,0,37,0.0,0.0,1.0,37,1000,800,200,0.8,12,8,4,378.6498415572657,0.47581956956956956,0.23535796434732603,0.20223343810444858,127702.62458087632,2270.9157127991552,129973.54029367547,361,2,50.16216216216216,30,7,20,37.74379432624114,0.6111111111111112,47.31182795698924,1010.7526881720423,33.69175627240141,0
451,4,1,1,37,0.02631578947368421,0.02631578947368421,0.9736842105263158,38,1200,900,300,0.75,15,9,6,389.3641187508324,0.4769292318634424,0.21519081452556632,0.1919935366899164,124418.56985594453,2182.337798048551,126600.90765399308,362,0,49.81578947368421,33,5,16,40.87067006510257,0.569760101010101,50.58210784313724,997.6715686274486,30.23247177658935,16
452,4,3,0,40,0.075,0.0,1.0,40,1600,1200,400,0.75,20,12,8,375.19450512622984,0.4788595085470086,0.2068560380725759,0.18826924272154977,125148.85381235812,1392.3878528126768,126541.2416651708,363,0,48.025,34,6,19,40.46574459647035,0.5750612745098039,49.85119047619047,1000.5952380952369,29.42927170868344,0
453,4,3,2,41,0.06976744186046512,0.046511627906976744,0.9534883720930233,43,750,500,250,0.6666666666666666,10,5,5,355.2121582267066,0.48008951642672576,0.22472069912203407,0.18201889943379668,126016.31180988357,352.5052179516513,126368.81702783522,364,0,45.604651162790695,37,6,21,40.06941410942448,0.5779842342342343,48.985745614035075,1004.0570175438577,27.136676149833992,0
454,4,0,0,41,0.0,0.0,1.0,41,1000,600,400,0.6,14,6,8,369.15261910921714,0.4800813008130081,0.22353973539735406,0.18875539580867481,125927.64060356632,1097.3036694101265,127024.94427297646,365,1,48.34146341463415,35,6,21,39.811077798277985,0.5809523809523809,49.07407407407406,1003.7037037037021,28.67724867724863,0
455,4,2,0,43,0.046511627906976744,0.0,1.0,43,1150,500,650,0.43478260869565216,18,5,13,337.83535932142377,0.4814737910668143,0.16515020495828137,0.1685848369421687,124917.77668369122,-46.234963025176796,124871.54172066605,366,0,47.04651162790697,37,6,20,41.63913111037988,0.566722972972973,50.08223684210527,999.6710526315796,27.018136557610262,15
456,4,5,3,45,0.10416666666666667,0.0625,0.9375,48,1500,1100,400,0.7333333333333333,19,11,8,311.74649295779085,0.48516917848699764,0.1975045532732973,0.16005145921568073,126094.86669847672,-1732.993817373012,124361.8728811037,367,0,43.041666666666664,40,8,19,41.07980033053389,0.5736979166666667,48.907520325203265,1004.3699186991894,25.109247967479735,0
457,4,1,5,41,0.021739130434782608,0.10869565217391304,0.8913043478260869,46,1150,800,350,0.6956521739130435,15,8,7,336.89231914874085,0.4828099838969404,0.14700728162673338,0.16774672915399252,124826.44917052478,-705.1000487244786,124121.3491218003,368,0,45.80434782608695,41,5,15,41.7571519573778,0.5591971544715447,50.173611111111114,999.3055555555562,24.373306233062348,16
458,4,2,3,40,0.046511627906976744,0.06976744186046512,0.9302325581395349,43,1350,1100,250,0.8148148148148148,16,11,5,341.55402948798434,0.48188907345884086,0.18850146176491545,0.17213418307308362,125329.16378116353,-38.42269309359074,125290.74108806995,369,0,47.372093023255815,37,6,15,41.120966564461966,0.5709459459459459,49.67105263157895,1001.3157894736851,27.06258890469419,0
459,4,3,2,41,0.06976744186046512,0.046511627906976744,0.9534883720930233,43,1200,600,600,0.5,18,6,12,328.47041744950104,0.4799510889627168,0.19963613024027893,0.1682145527831188,125991.5418836808,-323.10112847219807,125668.44075520859,370,0,46.76744186046512,39,4,18,40.76615134536902,0.5742521367521367,49.01041666666668,1003.9583333333353,25.74252136752142,0
460,4,1,3,39,0.023809523809523808,0.07142857142857142,0.9285714285714286,42,850,600,250,0.7058823529411765,11,6,5,325.30142924320853,0.4805337785520712,0.20076850642447042,0.1675676475061127,126231.65155416752,-187.3218160452846,126044.32973812224,371,0,47.904761904761905,38,4,19,40.598864200155916,0.5783991228070176,48.771367521367516,1004.9145299145295,26.44511920827709,0
461,4,1,2,38,0.025,0.05,0.95,40,1150,800,350,0.6956521739130435,15,8,7,329.4342245416184,0.47960737179487184,0.19032214106617285,0.17063241906946727,126457.07242853566,331.8575186595806,126788.92994719524,372,0,50.05,37,3,14,40.2634316290563,0.5824887387387387,48.547149122807014,1005.8114035087715,27.184091986723555,0
462,4,1,3,36,0.02564102564102564,0.07692307692307693,0.9230769230769231,39,1100,800,300,0.7272727272727273,14,8,6,337.33767323118207,0.47823886639676116,0.20675748162044183,0.17562384746729967,126666.55411746203,745.8801284392478,127412.43424590128,373,0,51.87179487179487,36,3,16,39.849489130029454,0.5865162037037037,48.33896396396396,1006.644144144144,27.96233733733733,0
463,4,0,0,36,0.0,0.0,1.0,36,1250,900,350,0.72,16,9,7,362.55681142177264,0.4760912698412698,0.2241327913279132,0.1867440862850841,126228.49384852001,1953.0000480584658,128181.49389657848,374,1,56.94444444444444,33,3,19,39.66615853658538,0.5883838383838385,48.77450980392158,1004.9019607843154,30.45157456922168,0
464,4,0,0,36,0.0,0.0,1.0,36,1000,800,200,0.8,12,8,4,362.82563523669893,0.4758928571428571,0.2216905739092747,0.1873038820545402,126320.87305663704,1966.4902020857594,128287.36325872279,375,2,57.94444444444444,33,3,16,39.56415843796985,0.5893308080808081,48.6825980392157,1005.2696078431386,30.46271538918602,0
465,4,1,0,37,0.02702702702702703,0.0,1.0,37,900,600,300,0.6666666666666666,12,6,6,354.5260969434803,0.47622622622622623,0.22420292633058558,0.1851414061815954,126792.09183673482,1590.2210884353894,128382.3129251702,376,0,57.351351351351354,34,3,17,39.28782505910167,0.5919117647058824,48.21428571428572,1007.1428571428581,29.621848739495828,0
466,4,2,3,36,0.05128205128205128,0.07692307692307693,0.9230769230769231,39,850,400,450,0.47058823529411764,13,4,9,344.9849554255548,0.4769174538911381,0.24340393905611357,0.18354181792213659,127546.62390430958,1000.3332724616394,128546.95717677122,377,0,55.35897435897436,36,3,18,38.75418060200669,0.5954861111111112,47.46621621621621,1010.1351351351341,28.05930930930928,0
467,4,0,2,34,0.0,0.05555555555555555,0.9444444444444444,36,1000,600,400,0.6,14,6,8,361.22746349139754,0.4742559523809524,0.23682865455689273,0.19116644416230105,127332.20663265284,1999.1780045351213,129331.38463718796,378,1,54.52777777777778,34,2,18,38.56402846583315,0.5974264705882353,47.678571428571416,1009.2857142857125,29.68487394957978,0
468,4,1,1,34,0.02857142857142857,0.02857142857142857,0.9714285714285714,35,1300,800,500,0.6153846153846154,18,8,10,366.334493701905,0.4754901960784314,0.2117989803350333,0.19419971422884721,127401.12727076089,2334.285491157202,129735.4127619181,379,0,54.857142857142854,33,2,18,38.36438860564862,0.6003787878787878,47.61029411764704,1009.5588235294089,30.5926916221033,0
469,4,1,0,35,0.02857142857142857,0.0,1.0,35,1250,900,350,0.72,16,9,7,365.77849628071175,0.47517507002801124,0.22065571497885927,0.19479831546112286,127586.77551903084,2333.6997789311426,129920.47529796198,380,0,55.82857142857143,33,2,19,38.18787400938055,0.6022727272727273,47.426470588235276,1010.2941176470564,30.614973262032013,0
470,4,1,1,35,0.027777777777777776,0.027777777777777776,0.9722222222222222,36,900,400,500,0.4444444444444444,14,4,10,359.23560655613136,0.4748677248677249,0.22391543108182344,0.19296992316776232,127933.68055555537,1991.6666666666426,129925.34722222202,381,0,55.25,34,2,20,37.99766611751784,0.6035539215686274,47.08333333333332,1011.6666666666652,29.75490196078427,0
471,4,1,1,35,0.027777777777777776,0.027777777777777776,0.9722222222222222,36,1000,600,400,0.6,14,6,8,358.7451846024094,0.47400793650793654,0.23089134524929444,0.19357671636160445,128114.39909297033,1992.0847505668653,130106.4838435372,382,0,55.94444444444444,34,2,22,37.82509211351519,0.6053921568627452,46.90476190476189,1012.3809523809508,29.775910364145613,0
472,4,3,2,36,0.07894736842105263,0.05263157894736842,0.9473684210526316,38,700,300,400,0.42857142857142855,11,3,8,334.7500015776444,0.47266180654338547,0.19911494363947457,0.1839436358817452,128839.34389667958,1025.7941145352195,129865.1380112148,383,0,49.921052631578945,37,1,22,37.69339291500162,0.6067004504504505,46.18969298245613,1015.2412280701741,27.438952110004706,0
473,4,3,4,35,0.07692307692307693,0.10256410256410256,0.8974358974358975,39,1150,700,450,0.6086956521739131,16,7,9,383.4605340921917,0.4741059379217274,0.10295069292119408,0.19596952923203964,125906.24188452214,1880.3313279085814,127786.57321243073,384,0,48.82051282051282,37,2,16,39.47419334280198,0.5768581081081081,49.0953947368421,1003.6184210526314,27.12482219061166,16
474,4,4,1,38,0.10256410256410256,0.02564102564102564,0.9743589743589743,39,1500,1300,200,0.8666666666666667,17,13,4,376.4002079400546,0.4770017993702204,0.15427068363638452,0.19596048100035818,126666.55411746216,1735.5386050859215,128402.09272254808,385,0,49.48717948717949,36,3,20,38.8664373345266,0.5865162037037037,48.33896396396397,1006.644144144145,27.96233733733736,0
475,4,1,0,39,0.02564102564102564,0.0,1.0,39,1150,1000,150,0.8695652173913043,13,10,3,410.4183532868322,0.47745164192532613,0.2004431300205951,0.19929186951654476,123771.9704143709,2469.5025094057573,126241.47292377666,386,0,50.38461538461539,32,7,14,41.021126760563384,0.5654296875,51.2310606060606,995.0757575757568,31.0961174242424,16
476,4,8,3,44,0.1702127659574468,0.06382978723404255,0.9361702127659575,47,900,600,300,0.6666666666666666,12,6,6,362.46263650113434,0.48223095898859086,0.2863355001885828,0.18010449140134097,124739.71896701398,277.49001018710743,125017.20897720108,387,0,42.638297872340424,39,8,17,41.208289885297184,0.5614316239316239,50.26041666666667,998.9583333333342,25.61431623931626,16
477,4,8,9,43,0.15384615384615385,0.17307692307692307,0.8269230769230769,52,1050,600,450,0.5714285714285714,15,6,9,333.29133345916256,0.4834794494720965,0.3041853104878314,0.17147380620361038,126181.50686990202,-1967.5293419610166,124213.97752794101,388,0,39.38461538461539,37,15,19,40.449702608316066,0.5796734234234234,48.82127192982455,1004.7149122806997,27.15445708866756,0
478,4,3,1,45,0.06521739130434782,0.021739130434782608,0.9782608695652174,46,1500,1100,400,0.7333333333333333,19,11,8,387.29555629471344,0.48399758454106284,0.31198842945069405,0.18642164174513123,123400.42058528119,494.85999827431147,123895.2805835555,389,0,43.47826086956522,36,10,15,41.98449129169972,0.5529513888888888,51.604729729729726,993.5810810810808,27.599474474474466,16
479,4,4,5,44,0.08163265306122448,0.10204081632653061,0.8979591836734694,49,1600,1200,400,0.75,20,12,8,343.87870185506824,0.48478245464852604,0.2480985684975332,0.16558601398260941,123416.5052625867,-1102.07383996645,122314.43142262024,390,0,41.714285714285715,39,10,18,43.04620068490761,0.547809829059829,51.588541666666664,993.6458333333325,25.47809829059827,16
480,4,8,7,45,0.15384615384615385,0.1346153846153846,0.8653846153846154,52,1550,1100,450,0.7096774193548387,20,11,9,320.3617930182917,0.4853255404725993,0.3022526558300267,0.16179616605377609,125417.01388888907,-2350.5533854166483,123066.46050347242,391,0,38.67307692307692,39,13,13,41.56094009983362,0.5683760683760684,49.58333333333334,1001.6666666666681,25.68376068376072,0
481,4,3,3,45,0.0625,0.0625,0.9375,48,1700,1400,300,0.8235294117647058,20,14,6,333.8136598914275,0.48378398345153667,0.32029026217228385,0.16918801668756883,125563.69714308922,-1217.0245414333085,124346.67260165591,392,0,42.541666666666664,36,12,18,41.07279962546817,0.5752314814814814,49.436936936936945,1002.2522522522537,27.84034034034038,0
482,4,3,0,48,0.0625,0.0,1.0,48,1600,1000,600,0.625,22,10,12,339.4555598077761,0.4835346483451537,0.350186996547756,0.1757967112472931,126450.94548396797,-1013.2722112283412,125437.67327273963,393,0,42.041666666666664,35,13,17,40.01774069812045,0.5863095238095238,48.553240740740755,1005.7870370370388,28.736772486772537,0
483,4,0,3,45,0.0,0.0625,0.9375,48,1150,700,450,0.6086956521739131,16,7,9,342.3814060350095,0.4830729166666667,0.35125790684301306,0.17794419160038333,126596.50051708265,-931.1424307698701,125665.35808631277,394,1,43.041666666666664,35,13,17,39.79454188230783,0.5877976190476191,48.408564814814824,1006.3657407407422,28.753306878306923,0
484,4,0,3,42,0.0,0.06666666666666667,0.9333333333333333,45,1750,1200,550,0.6857142857142857,23,12,11,358.11779490441745,0.4826388888888889,0.3462031057498338,0.18543045695776353,126444.09789804397,56.376303585150254,126500.47420162911,395,2,46.48888888888889,33,12,17,39.55553694001055,0.5905934343434344,48.56004901960784,1005.7598039215682,30.477569815805097,0
485,4,0,2,40,0.0,0.047619047619047616,0.9523809523809523,42,950,500,450,0.5263157894736842,14,5,9,433.6662568849125,0.482663085559427,0.27391477219571536,0.21430691723730144,124510.28450595925,2430.577482218381,126940.86198817764,396,3,48.61904761904762,33,9,12,39.66979780615588,0.5707070707070707,50.490196078431374,998.0392156862746,30.243612596553774,14
486,4,7,2,45,0.14893617021276595,0.0425531914893617,0.9574468085106383,47,1300,900,400,0.6923076923076923,17,9,8,395.18263863895965,0.48196114708603144,0.320063853613209,0.20446007897137394,126411.62065782021,601.4831438974554,127013.10380171766,397,0,44.1063829787234,36,11,16,38.657148189623,0.583912037037037,48.592342342342356,1005.6306306306325,27.934184184184236,0
487,4,2,1,46,0.0425531914893617,0.02127659574468085,0.9787234042553191,47,1800,1500,300,0.8333333333333334,21,15,6,392.9273374410525,0.4814986123959297,0.31766894930450085,0.20499161326708867,126751.58900454544,560.8328767957555,127312.4218813412,398,0,44.87234042553192,36,11,18,38.36273577872214,0.5873842592592593,48.254504504504524,1006.9819819819849,27.971721721721803,0
488,4,3,2,47,0.061224489795918366,0.04081632653061224,0.9591836734693877,49,1150,800,350,0.6956521739130435,15,8,7,379.95229167730446,0.48191255668934235,0.3325705996382047,0.20202862573212838,127523.29082657634,-109.4466816421664,127413.84414493418,399,0,43.857142857142854,38,11,17,37.895114942528735,0.5915570175438596,47.48931623931625,1010.0427350427371,26.580071974808874,0
489,4,2,2,47,0.04081632653061224,0.04081632653061224,0.9591836734693877,49,1750,1200,550,0.6857142857142857,23,12,11,371.5179015770049,0.481062216553288,0.32590355149992445,0.20010528836156877,128041.65556423152,-286.04656206617335,127755.60900216535,400,0,43.02040816326531,40,9,19,37.576354721022874,0.5934895833333333,46.97662601626019,1012.0934959349639,25.3023373983741,0
490,4,0,2,45,0.0,0.0425531914893617,0.9574468085106383,47,1150,700,450,0.6086956521739131,16,7,9,385.6420940777107,0.4807662658032686,0.3340825620024179,0.2067094033148141,127847.22792935967,460.65454014175293,128307.88246950142,401,1,45.61702127659574,38,9,19,37.418568209028805,0.5948464912280702,47.168803418803435,1011.324786324789,26.613810166441816,0
491,4,0,4,41,0.0,0.08888888888888889,0.9111111111111111,45,1550,1000,550,0.6451612903225806,21,10,11,356.81448365558924,0.4813341750841751,0.21893997585866343,0.17758877059275724,124808.18767553479,-70.37779336379663,124737.809882171,402,2,46.77777777777778,37,8,20,41.278370642671625,0.5655968468468469,50.19188596491228,999.2324561403509,27.006282598387862,16
492,4,1,2,40,0.023809523809523808,0.047619047619047616,0.9523809523809523,42,1200,700,500,0.5833333333333334,17,7,10,367.7083333333333,0.4815500387146729,0.24126984126984108,0.18385416666666668,125000.0,793.0028951215756,125793.00289512158,403,0,50.07142857142857,34,8,21,40.80729166666665,0.5735294117647058,50.0,1000.0,29.41176470588235,0
493,4,3,3,40,0.06976744186046512,0.06976744186046512,0.9302325581395349,43,1100,800,300,0.7272727272727273,14,8,6,326.99674110378544,0.48385012919896636,0.1474504510032515,0.16095034399783725,124342.97091412745,517.1923091720486,124860.1632232995,404,0,45.04651162790697,37,6,13,42.50448915274111,0.5608108108108107,50.6578947368421,997.3684210526318,26.95590327169275,16
494,4,2,3,39,0.047619047619047616,0.07142857142857142,0.9285714285714286,42,1450,900,550,0.6206896551724138,20,9,11,322.1383137209709,0.4843568524970964,0.17703680484810524,0.16054077252961452,124862.9761681479,-355.37028220221123,124507.60588594568,405,0,45.523809523809526,37,5,16,42.088018833424776,0.5661599099099099,50.137061403508774,999.4517543859649,27.01220957799905,0
495,4,2,0,41,0.04878048780487805,0.0,1.0,41,950,400,550,0.42105263157894735,15,4,11,318.6018837459444,0.48452743902439027,0.19034482002117104,0.16081981577959323,125394.45484335699,-209.74295180880523,125184.71189154818,406,0,46.09756097560975,36,5,15,41.6282512555281,0.5734953703703703,49.605855855855864,1001.5765765765775,27.821571571571596,0
496,4,0,4,37,0.0,0.0975609756097561,0.9024390243902439,41,1550,1200,350,0.7741935483870968,19,12,7,375.5951064800101,0.4837906504065041,0.027654365762987965,0.18370015207840476,124075.78875171454,1696.8749467685716,125772.66369848311,407,1,47.09756097560975,35,6,18,41.570825588599746,0.5619047619047619,50.92592592592592,996.2962962962952,28.465608465608433,16
497,4,2,2,37,0.05128205128205128,0.05128205128205128,0.9487179487179487,39,1250,800,450,0.64,17,8,9,363.25544078605697,0.4811347278452542,-0.05837488823681203,0.17038315021721398,122294.88838520218,1172.7875300068388,123467.67591520902,408,0,45.205128205128204,35,4,15,43.737323504173496,0.543452380952381,52.7199074074074,989.1203703703691,28.260582010581974,16
498,4,7,5,39,0.1590909090909091,0.11363636363636363,0.8863636363636364,44,1250,800,450,0.64,17,8,9,333.6066834564854,0.4858835447498238,0.04195913941676621,0.16251848524348053,123908.642578125,-531.0288333761998,123377.6137447488,409,0,40.59090909090909,39,5,19,42.79007114459091,0.5528846153846154,51.09375,995.625,25.528846153846153,0
499,4,7,7,39,0.15217391304347827,0.15217391304347827,0.8478260869565217,46,750,600,150,0.8,9,6,3,314.2188665153662,0.48617149758454103,0.08047191329101588,0.15672701678727866,124898.39463943394,-1350.9027506672085,123547.49188876673,410,0,37.41304347826087,40,6,19,42.24934763453976,0.5614583333333334,50.10162601626015,999.5934959349573,24.989837398373933,0
500,4,3,1,41,0.07142857142857142,0.023809523809523808,0.9761904761904762,42,800,600,200,0.75,10,6,4,320.4249560271141,0.48496176926054974,0.09183748036099226,0.16052920778887209,125082.25036790158,-384.10508521853876,124698.14528268304,411,0,40.285714285714285,37,5,22,41.904504183565344,0.5684121621621622,49.91776315789473,1000.3289473684204,27.035917496443794,0
501,4,2,5,38,0.046511627906976744,0.11627906976744186,0.8837209302325582,43,1200,700,500,0.5833333333333334,17,7,10,315.75705020722154,0.48564968623108157,0.09553996717768043,0.15161557534743464,123296.44239900666,-719.8889773068138,122576.55342169985,412,0,40.13953488372093,38,5,15,43.86945101835913,0.5482456140350878,51.70940170940172,993.1623931623946,26.135852451641963,16
502,4,8,5,41,0.17391304347826086,0.10869565217391304,0.8913043478260869,46,1350,800,550,0.5925925925925926,19,8,11,287.08963352590564,0.48772141706924316,0.13189474750202534,0.14221978768514099,124612.70356348771,-2044.9969202572022,122567.70664323051,413,0,37.56521739130435,42,4,17,43.221483566252594,0.5555555555555556,50.3875968992248,998.4496124031002,23.772609819121435,0
503,4,3,5,39,0.06818181818181818,0.11363636363636363,0.8863636363636364,44,1450,1000,450,0.6896551724137931,19,10,9,294.4479343136473,0.4873590556730092,0.1315499861278091,0.14633079849864292,124746.06405743954,-1453.7558249057881,123292.30823253375,414,0,40.11363636363637,40,4,18,42.90034757544933,0.5598958333333333,50.25406504065042,998.9837398373999,24.974593495934997,0
504,4,2,1,40,0.04878048780487805,0.024390243902439025,0.975609756097561,41,1100,700,400,0.6363636363636364,15,7,8,316.41937509166263,0.486229674796748,0.15310435517705545,0.15700044152637316,124679.69263642379,-309.7859138724155,124369.90672255137,415,0,42.24390243902439,38,3,20,42.42017008985878,0.5625,50.32051282051284,998.7179487179519,26.282051282051366,0
505,4,2,1,41,0.047619047619047616,0.023809523809523808,0.9761904761904762,42,1350,900,450,0.6666666666666666,18,9,9,308.4944891105711,0.4870789779326365,0.1610231536560811,0.15484241077221914,125160.30777449049,-677.3360453648888,124482.9717291256,416,0,42.04761904761905,38,4,22,42.12243754003844,0.5674342105263157,49.83974358974359,1000.6410256410259,26.33265856950068,0
506,4,3,3,41,0.06818181818181818,0.06818181818181818,0.9318181818181819,44,1250,800,450,0.64,17,8,9,337.9643591643899,0.4882289464411558,0.1824890892826485,0.16708891486746583,124529.21395699494,-332.7610839358067,124196.45287305913,417,0,40.36363636363637,41,3,17,42.03804707948183,0.5561483739837398,50.471230158730165,998.1150793650803,24.344270228416594,16
507,4,3,3,41,0.06818181818181818,0.06818181818181818,0.9318181818181819,44,1550,1300,250,0.8387096774193549,18,13,5,345.5866411078673,0.48733703312191684,0.2281098052156021,0.17357158537573159,125187.0357243956,-144.74186840113782,125042.29385599446,418,0,41.02272727272727,38,6,20,41.16690687164158,0.5677083333333333,49.813034188034194,1000.747863247864,26.335470085470103,0
508,4,3,2,42,0.06818181818181818,0.045454545454545456,0.9545454545454546,44,1500,900,600,0.6,21,9,12,343.34826704940554,0.4879426532769556,0.2565453770853703,0.1749157286666778,125775.77257515166,-163.02128990429793,125612.75128524736,419,0,41.70454545454545,38,6,16,40.61512585649872,0.5737390350877193,49.22542735042735,1003.0982905982912,26.397323436797137,0
509,4,6,5,43,0.125,0.10416666666666667,0.8958333333333334,48,1150,1000,150,0.8695652173913043,13,10,3,328.97135856148736,0.4879395685579196,0.22627912364310365,0.16370551005095302,124801.66603678462,-1139.9569248585303,123661.70911192609,420,0,38.666666666666664,41,7,20,41.980655943870765,0.5589430894308943,50.198412698412675,999.2063492063454,24.370886566008423,14
510,4,3,3,43,0.06521739130434782,0.06521739130434782,0.9347826086956522,46,1000,600,400,0.6,14,6,8,332.85177583145617,0.4869363929146538,0.24811554001085434,0.16782246879334256,125347.46334876544,-855.1024344923154,124492.36091427311,421,0,37.67391304347826,38,8,15,41.319926028663915,0.5693530701754386,49.65277777777778,1001.3888888888889,26.35233918128655,0
511,4,2,2,43,0.044444444444444446,0.044444444444444446,0.9555555555555556,45,1000,600,400,0.6,14,6,8,325.05899579211496,0.4880260942760943,0.24279002615353606,0.1655984216761894,125775.77257515168,-823.0907343487445,124952.68184080294,422,0,38.577777777777776,38,7,17,41.07377427486062,0.5737390350877193,49.22542735042735,1003.0982905982914,26.397323436797144,0
512,4,2,2,43,0.044444444444444446,0.044444444444444446,0.9555555555555556,45,1200,700,500,0.5833333333333334,17,7,10,324.5467536715965,0.48813131313131314,0.2425080682342089,0.1664165268826697,126043.83680555562,-818.0056751771463,125225.83113037847,423,0,39.111111111111114,36,9,19,40.81085753803594,0.580150462962963,48.958333333333336,1004.1666666666672,27.893518518518533,0
513,4,1,2,42,0.022727272727272728,0.045454545454545456,0.9545454545454546,44,1550,1200,350,0.7741935483870968,19,12,7,330.25264107957395,0.48851523960535587,0.23368204343772025,0.1694619850175905,126072.8942285019,-472.8187424983196,125600.07548600358,424,0,40.61363636363637,35,9,23,40.63772521224697,0.5824404761904762,48.92939814814813,1004.2824074074047,28.69378306878299,0
514,4,2,4,40,0.045454545454545456,0.09090909090909091,0.9090909090909091,44,1050,800,250,0.7619047619047619,13,8,5,386.8055555555555,0.48782152924594785,0.17821969696969697,0.19340277777777784,125000.00000000012,985.1696459190814,125985.1696459192,425,0,41.09090909090909,34,10,20,40.329861111111114,0.5735294117647058,50.00000000000001,1000.0000000000009,29.41176470588238,15
515,4,4,4,40,0.09090909090909091,0.09090909090909091,0.9090909090909091,44,1400,1100,300,0.7857142857142857,17,11,6,370.0467665628944,0.48724894291754756,0.2512812690665043,0.18988937081921828,126074.60359296894,535.0401588331308,126609.64375180207,426,0,41.70454545454545,33,11,20,39.636846654464115,0.5868055555555556,48.92769607843137,1004.2892156862737,30.433006535947687,0
516,4,1,1,40,0.024390243902439025,0.024390243902439025,0.975609756097561,41,1300,800,500,0.6153846153846154,18,8,10,390.6613178147759,0.48666158536585363,0.2522011942111122,0.20031782466672549,126043.83680555559,1648.0902777777821,127691.92708333337,427,0,44.609756097560975,30,11,21,39.15110650069156,0.5940972222222223,48.958333333333336,1004.166666666667,33.472222222222236,0
517,4,2,4,38,0.047619047619047616,0.09523809523809523,0.9047619047619048,42,1350,800,550,0.5925925925925926,19,8,11,370.8665250041228,0.4852037359659311,0.2540985563294125,0.19404222970543578,126869.31060924905,1010.3160710641772,127879.62668031323,428,0,43.214285714285715,32,10,17,38.796893929899326,0.5973307291666667,48.13762626262626,1007.4494949494949,31.482796717171716,0
518,4,3,4,37,0.07317073170731707,0.0975609756097561,0.9024390243902439,41,1300,900,400,0.6923076923076923,17,9,8,353.40076981885835,0.48373983739837395,0.14922189789849227,0.17598644396030017,124831.13814828343,790.5773361636908,125621.71548444712,429,0,44.09756097560975,36,5,18,41.33986928104576,0.5677083333333333,50.16891891891892,999.3243243243244,27.75900900900901,16
519,4,6,6,37,0.13953488372093023,0.13953488372093023,0.8604651162790697,43,1750,1500,250,0.8571428571428571,20,15,5,323.8918513567698,0.48396548541897383,0.19830963629032872,0.16753593732616667,126401.93527094876,-405.9124297579814,125996.02284119077,430,0,41.83720930232558,37,6,17,40.45939646712464,0.5819256756756757,48.60197368421053,1005.5921052631579,27.178165007112376,0
520,4,2,3,36,0.05128205128205128,0.07692307692307693,0.9230769230769231,39,1250,700,550,0.56,18,7,11,340.4194092241643,0.48256860098965365,0.20619645823927102,0.17617059242101044,126421.84452428418,807.2899251971978,127229.13444948138,431,0,45.333333333333336,35,4,19,40.02342521195382,0.5860119047619048,48.58217592592593,1005.6712962962968,28.73346560846562,0
521,4,3,3,36,0.07692307692307693,0.07692307692307693,0.9230769230769231,39,1250,900,350,0.72,16,9,7,334.50294680005857,0.4831309041835357,0.19014514288746764,0.17409767374746327,126654.74597318684,673.2771508487768,127328.02312403562,432,0,44.76923076923077,35,4,19,39.93295101759227,0.5883928571428572,48.35069444444445,1006.5972222222232,28.75992063492066,0
522,4,2,1,37,0.05263157894736842,0.02631578947368421,0.9736842105263158,38,1100,700,400,0.6363636363636364,15,7,8,342.7550054627028,0.4833303698435278,0.1971225081867196,0.1782073072682466,126612.30867346944,1079.4005102040894,127691.70918367352,433,0,46.89473684210526,34,4,21,39.76889638041164,0.5900735294117647,48.392857142857146,1006.4285714285718,29.600840336134464,0
523,4,0,2,35,0.0,0.05405405405405406,0.9459459459459459,37,1050,800,250,0.7619047619047619,13,8,5,354.1610223981442,0.482982982982983,0.20281628930672624,0.18365810694038956,126505.73284614096,1560.6799368031557,128066.41278294411,434,1,49.16216216216216,33,4,21,39.591581394404514,0.5912247474747474,48.49877450980392,1006.0049019607848,30.48499702911469,0
524,4,3,0,38,0.07894736842105263,0.0,1.0,38,700,500,200,0.7142857142857143,9,5,4,344.822883545479,0.4833748221906116,0.2164153157460118,0.18234956854741288,127302.17013888899,1179.340277777784,128481.51041666677,435,0,47.78947368421053,34,4,24,39.00873933388384,0.5971200980392157,47.708333333333336,1009.1666666666675,29.681372549019635,0
525,4,0,2,36,0.0,0.05263157894736842,0.9473684210526316,38,1100,700,400,0.6363636363636364,15,7,8,344.9353577701815,0.48288584637268844,0.21589745499227364,0.18295164285484117,127422.337372449,1190.4939058956943,128612.83127834469,436,1,48.78947368421053,34,4,21,38.88274771056872,0.5983455882352942,47.589285714285715,1009.6428571428573,29.69537815126051,0
526,4,1,0,37,0.02702702702702703,0.0,1.0,37,1150,600,550,0.5217391304347826,17,6,11,349.7209073323504,0.4812625125125125,0.20854474641894294,0.18725160327055312,127803.53597474532,1539.1137122741234,129342.64968701944,437,0,48.86486486486486,33,4,22,38.37148527451219,0.6044823232323233,47.21200980392157,1011.1519607843139,30.640968508615572,0
527,4,1,0,38,0.02631578947368421,0.0,1.0,38,1250,800,450,0.64,17,8,9,369.0631519448935,0.48023352299668093,0.12167268147358756,0.19140196400387927,126509.1574502744,1785.91572722802,128295.07317750242,438,0,48.55263157894737,35,3,17,39.213261236385954,0.5869047619047619,48.495370370370374,1006.018518518519,28.743386243386258,15
528,4,2,2,38,0.05,0.05,0.95,40,1250,1000,250,0.8,15,10,5,348.91835536639655,0.4790865384615384,0.11647131056039317,0.1840760086791627,127205.59030314101,878.2126643034476,128083.80296744446,439,0,47.075,36,4,20,39.004474585100844,0.5920138888888888,47.804054054054056,1008.7837837837841,28.021771771771782,0
529,4,1,5,34,0.02564102564102564,0.1282051282051282,0.8717948717948718,39,1450,1100,350,0.7586206896551724,18,11,7,344.6468507273033,0.4780701754385965,0.09741130584221924,0.182975033183643,127461.32270361582,985.8286918675469,128447.15139548336,440,0,48.53846153846154,36,3,18,38.85008921601427,0.5946180555555556,47.55067567567568,1009.7972972972976,28.049924924924934,0
530,4,3,2,35,0.08108108108108109,0.05405405405405406,0.9459459459459459,37,1050,600,450,0.5714285714285714,15,6,9,346.6765857269617,0.4772897897897898,0.10415293342122656,0.18516982404608895,127705.45488522366,1454.4982156635676,129159.95310088723,441,0,50.351351351351354,35,2,20,38.54882342837514,0.5991071428571428,47.30902777777777,1010.763888888888,28.878968253968228,0
531,4,2,2,35,0.05405405405405406,0.05405405405405406,0.9459459459459459,37,1400,800,600,0.5714285714285714,20,8,12,404.51388888888886,0.4767267267267267,0.01554054054054066,0.2022569444444446,125000.00000000012,2746.9063464506316,127746.90634645075,442,0,51.13513513513514,33,4,19,39.887152777777786,0.5757575757575757,50.00000000000001,1000.0000000000009,30.30303030303033,16
532,4,3,6,32,0.07894736842105263,0.15789473684210525,0.8421052631578947,38,1150,900,250,0.782608695652174,14,9,5,380.0073863218312,0.4764550734945472,0.036644029428409386,0.19340674438170843,125736.37543252623,1956.1502787389777,127692.5257112652,443,0,50.3421052631579,33,5,17,39.73657950472465,0.5833333333333333,49.264705882352956,1002.9411764705904,30.392156862745164,0
533,4,2,1,33,0.058823529411764705,0.029411764705882353,0.9705882352941176,34,1350,900,450,0.6666666666666666,18,9,9,412.60225939927875,0.47530451574569227,0.07817992024204679,0.20855641885402929,125451.7963927469,3552.3389274691294,129004.13532021602,444,0,56.64705882352941,29,5,19,39.2149302185868,0.5908764367816092,49.54861111111111,1001.8055555555554,34.54501915708812,0
534,4,4,4,33,0.10810810810810811,0.10810810810810811,0.8918918918918919,37,1150,700,450,0.6086956521739131,16,7,9,380.6522278046692,0.47594469469469475,0.08254625436667107,0.19785212297930674,126600.14046563052,2239.5188131450245,128839.65927877555,445,0,52.945945945945944,31,6,16,38.82792620865139,0.5971102150537635,48.40494791666667,1006.3802083333342,32.46387768817207,0
535,4,0,1,32,0.0,0.030303030303030304,0.9696969696969697,33,1100,600,500,0.5454545454545454,16,6,10,408.43959807653437,0.473208648989899,0.0790886984564565,0.2098017068444566,126115.98553722432,3702.152488769995,129818.13802599431,446,1,57.15151515151515,28,5,23,38.630024316978954,0.6008184523809523,48.88649425287357,1004.4540229885067,35.87335796387524,0
536,4,2,1,33,0.058823529411764705,0.029411764705882353,0.9705882352941176,34,1100,800,300,0.7272727272727273,14,8,6,422.7867159188387,0.47381907308377896,0.12712281565345784,0.20621637776449497,123960.5034722223,3748.841285176388,127709.34475739869,447,0,55.88235294117647,29,5,18,40.516039051603904,0.5754310344827587,51.04166666666667,995.833333333334,34.33908045977014,15
537,4,11,7,37,0.25,0.1590909090909091,0.8409090909090909,44,1400,900,500,0.6428571428571429,19,9,10,332.8649628701924,0.47875924947145876,0.1327908637376849,0.17315962535616153,126634.58256857707,-365.2165972678684,126269.3659713092,448,0,43.86363636363637,38,6,18,39.99486961752114,0.5825109649122807,48.3707264957265,1006.5170940170949,26.48729194781829,0
538,4,2,0,39,0.05128205128205128,0.0,1.0,39,1800,1400,400,0.7777777777777778,22,14,8,366.6829268292683,0.47413405308142154,0.17049405878674184,0.18886934673366854,126228.49384851998,1457.1667147251328,127685.66056324511,449,0,50.35897435897436,33,6,21,39.562500000000014,0.5883838383838385,48.77450980392158,1004.9019607843152,30.451574569221673,0
539,4,2,3,38,0.04878048780487805,0.07317073170731707,0.926829268292683,41,1250,1000,250,0.8,15,10,5,401.1639661915808,0.47553353658536585,0.2585338153211174,0.19082921244283427,122897.43026387847,1989.394163785233,124886.8244276637,450,0,48.853658536585364,36,5,17,42.16709256104484,0.5477430555555556,52.11148648648647,991.5540540540518,27.543168168168105,16
540,4,5,4,39,0.11627906976744186,0.09302325581395349,0.9069767441860466,43,1000,800,200,0.8,12,8,4,371.0475946988019,0.48092008121077884,0.26404858649606644,0.18147600540723205,124075.78875171453,616.7638813112201,124692.55263302574,451,0,46.46511627906977,35,8,19,41.68409231722427,0.5619047619047619,50.92592592592592,996.296296296295,28.46560846560843,0
541,4,7,8,38,0.15217391304347827,0.17391304347826086,0.8260869565217391,46,1300,800,500,0.6153846153846154,18,8,10,335.20099195332966,0.48359500805152983,0.23567035556256388,0.16911593641391362,125374.2112736505,-788.0292925787835,124586.18198107171,452,0,36.608695652173914,38,8,13,41.23350935210865,0.5696271929824561,49.62606837606838,1001.4957264957275,26.355150697255986,0
542,4,3,3,38,0.07317073170731707,0.07317073170731707,0.926829268292683,41,1600,1300,300,0.8125,19,13,6,361.684956264271,0.47784552845528455,0.22896245200611687,0.17938602864382308,124662.39043097154,1103.167537639993,125765.55796861154,453,0,37.75609756097561,36,5,16,41.30793301759134,0.5659722222222222,50.33783783783784,998.6486486486489,27.740240240240247,16
543,4,7,5,40,0.15555555555555556,0.1111111111111111,0.8888888888888888,45,1250,700,550,0.56,18,7,11,346.0152584505294,0.4776304713804714,0.33060463729217826,0.180517411964098,126751.58900454537,-197.4981738495003,126554.09083069587,454,0,35.13333333333333,36,9,19,39.54372623574144,0.5873842592592593,48.25450450450452,1006.9819819819843,27.971721721721785,0
544,4,5,6,39,0.1111111111111111,0.13333333333333333,0.8666666666666667,45,1350,800,550,0.5925925925925926,19,8,11,319.31505094672764,0.4797138047138047,0.28055643599225233,0.17104227262087027,127820.21747616708,-837.016148915179,126983.2013272519,455,0,32.333333333333336,38,7,19,39.12308505018489,0.5945723684210527,47.195512820512825,1011.2179487179493,26.61099865047235,0
545,4,0,0,39,0.0,0.0,1.0,39,1000,500,500,0.5,15,5,10,355.223034355486,0.47795771479982,0.2760699329005345,0.1878780788643177,127308.35383326124,1244.571949490583,128552.92578275182,456,1,36.87179487179487,33,6,22,38.74000708358634,0.5994318181818181,47.70220588235294,1009.1911764705881,30.58155080213903,0
546,4,2,0,41,0.04878048780487805,0.0,1.0,41,950,500,450,0.5263157894736842,14,5,9,338.50310783425607,0.47677845528455287,0.272233074733494,0.18172709843190402,127910.26341735249,459.6043381344299,128369.86775548692,457,0,36.02439024390244,35,6,23,38.54595728451564,0.6011904761904762,47.10648148148148,1011.5740740740736,28.902116402116388,0
547,4,1,4,38,0.023809523809523808,0.09523809523809523,0.9047619047619048,42,1550,1300,250,0.8387096774193549,18,13,5,329.4825691399449,0.47632355787843594,0.2575633932311645,0.17857343205460904,128291.057487247,54.14777842077223,128345.20526566777,458,0,36.142857142857146,35,7,24,38.38552972314253,0.6050595238095238,46.73032407407407,1013.078703703703,28.945105820105802,0
548,4,1,2,37,0.02564102564102564,0.05128205128205128,0.9487179487179487,39,1350,1000,350,0.7407407407407407,17,10,7,339.7274281509695,0.47506185335132706,0.23612516869095823,0.1844234609962405,128355.5555555554,921.1805555555363,129276.73611111093,459,0,37.76923076923077,34,5,26,38.060238486842096,0.607843137254902,46.66666666666666,1013.3333333333321,29.803921568627416,0
549,4,3,2,38,0.075,0.05,0.95,40,1300,900,400,0.6923076923076923,17,9,8,327.45503509759544,0.4769364316239317,0.21040408070215433,0.1801105343517994,128877.99968117685,440.34998178151454,129318.34966295837,460,0,36.9,35,5,22,37.83922736426155,0.6110119047619047,46.15162037037035,1015.3935185185163,29.011243386243322,0
550,4,2,4,36,0.05,0.1,0.9,40,1150,900,250,0.782608695652174,14,9,5,361.66280329755574,0.4773504273504274,0.21368800390911247,0.18434444008678663,125797.83767060761,1145.8271939233798,126943.66486453099,461,0,37.8,33,7,19,40.133052365827815,0.5839646464646464,49.203431372549026,1003.1862745098052,30.399584076054705,16
551,4,2,2,36,0.05263157894736842,0.05263157894736842,0.9473684210526316,38,1450,1000,450,0.6896551724137931,19,10,9,380.29711250062434,0.4767069701280227,0.23568236859160163,0.19546916875032105,126141.91903008363,1994.2815144856822,128136.20054456932,462,0,39.63157894736842,31,7,22,39.30992114927629,0.5924059139784946,48.860677083333336,1004.5572916666674,32.405073924731205,0
552,4,2,2,36,0.05263157894736842,0.05263157894736842,0.9473684210526316,38,1150,800,350,0.6956521739130435,15,8,7,363.0915576694411,0.47892958748221903,0.20555353901996343,0.18938228727362932,126742.1392746913,1603.8001543209814,128345.93942901229,463,0,35.921052631578945,32,6,22,39.12356321839081,0.5960286458333333,48.263888888888886,1006.944444444444,31.467013888888875,0
553,4,1,0,37,0.02702702702702703,0.0,1.0,37,1050,700,350,0.6666666666666666,14,7,7,357.899050611297,0.47766516516516516,0.2005807460352913,0.18828602227811717,127092.01388888896,1697.2222222222317,128789.2361111112,464,0,37.2972972972973,32,5,24,38.89462809917354,0.599609375,47.91666666666667,1008.333333333334,31.51041666666669,0
554,4,5,6,36,0.11904761904761904,0.14285714285714285,0.8571428571428572,42,950,700,250,0.7368421052631579,12,7,5,315.016766112583,0.47748499806426636,0.19232692506291427,0.17174000547058718,128525.67361379007,-302.4515871485156,128223.22202664155,465,0,33.73809523809524,35,7,17,38.51313111136478,0.6074404761904761,46.49884259259258,1014.0046296296279,28.971560846560795,0
555,4,2,0,38,0.05263157894736842,0.0,1.0,38,850,400,450,0.47058823529411764,13,4,9,340.52058133966875,0.4751659554291133,0.21227195169969915,0.18402796916065617,128176.49347005383,1129.3468141005771,129305.8402841544,466,0,37.55263157894737,32,6,25,38.22293225270159,0.6106770833333333,46.84343434343433,1012.6262626262607,31.644570707070645,0
556,4,0,5,33,0.0,0.13157894736842105,0.868421052631579,38,1400,800,600,0.5714285714285714,20,8,12,383.3026278509428,0.474765884305358,0.16258359095083463,0.18859230867297266,124326.88899702014,1930.9646530180376,126257.85365003817,467,1,38.55263157894737,33,5,17,41.1172892602605,0.5688131313131313,50.67401960784312,997.3039215686255,30.221330956625014,16
557,4,3,1,35,0.08333333333333333,0.027777777777777776,0.9722222222222222,36,750,500,250,0.6666666666666666,10,5,5,393.0981146467806,0.4731812169312169,0.18813344899877138,0.19731933449121536,125162.81339857307,2643.8876136272243,127806.7010122003,213,0,26.083333333333332,31,5,20,40.003388635870756,0.5823252688172043,49.83723958333333,1000.6510416666661,32.279065860215034,0
558,4,5,3,37,0.125,0.075,0.925,40,1000,800,200,0.8,12,8,4,361.5153891555764,0.47350427350427354,0.1948573400828355,0.18748757533056476,126509.15745027416,1147.0014574759734,127656.15890775013,214,0,24.225,35,5,16,39.40309096487193,0.5869047619047619,48.49537037037036,1006.0185185185169,28.743386243386198,0
559,4,4,5,36,0.0975609756097561,0.12195121951219512,0.8780487804878049,41,1000,700,300,0.7,13,7,6,350.83956887721877,0.47400914634146346,0.17749509805332986,0.18470863815779487,127122.02558106581,722.5665137454247,127844.59209481123,215,0,23.48780487804878,34,7,18,39.04177979774132,0.595281862745098,47.886904761904766,1008.4523809523814,29.660364145658278,0
560,4,2,1,37,0.05263157894736842,0.02631578947368421,0.9736842105263158,38,1250,1000,250,0.8,15,10,5,372.4897561665485,0.4737286628733997,0.19866642068365747,0.19626966835477486,127155.67926742161,1872.8375931027367,129028.51686052435,216,0,25.736842105263158,32,6,21,38.46133784009348,0.6002604166666667,47.85353535353535,1008.5858585858579,31.51830808080806,0
561,4,4,2,39,0.0975609756097561,0.04878048780487805,0.9512195121951219,41,1200,1000,200,0.8333333333333334,14,10,4,382.82980719583065,0.4760670731707317,0.18662954824482503,0.19104738698300747,124919.88463593043,1402.1112294422446,126321.99586537268,217,0,24.341463414634145,38,3,17,40.51245057176445,0.564967105263158,50.08012820512821,999.6794871794881,26.307354925776004,16
562,4,2,3,38,0.04878048780487805,0.07317073170731707,0.926829268292683,41,1250,800,450,0.64,17,8,9,378.97140800999455,0.47718495934959354,0.22571381003912472,0.19144590094297995,125427.71568412593,1306.7036032580925,126734.41928738402,218,0,25.195121951219512,38,3,17,40.082169013083046,0.5701754385964912,49.572649572649574,1001.7094017094016,26.36077372919478,0
563,4,1,0,39,0.02564102564102564,0.0,1.0,39,1200,700,500,0.5833333333333334,17,7,10,377.5847736745106,0.47787336932073776,0.2457668118045475,0.19189582333321029,125676.58875091317,1690.7132639396273,127367.3020148528,219,0,27.05128205128205,36,3,18,39.85919249775383,0.5763888888888888,49.32432432432433,1002.7027027027035,27.852852852852877,0
564,4,1,3,37,0.025,0.075,0.925,40,1250,900,350,0.72,16,9,7,388.204559717268,0.47751068376068373,0.24442049808429167,0.18763220386334606,123575.51020408153,1675.7219350486632,125251.2321391302,220,0,27.35,34,6,15,41.778915229885065,0.5588235294117647,51.42857142857142,994.2857142857134,29.24369747899157,15
565,4,4,0,41,0.0975609756097561,0.0,1.0,41,1200,600,600,0.5,18,6,12,367.32949163374366,0.4753810975609756,0.26989817238118285,0.1826764153461083,124774.87622757888,966.6983706679603,125741.57459824684,221,0,26.75609756097561,36,5,17,41.05026112113015,0.5671296296296297,50.22522522522522,999.0990990990987,27.75275275275274,0
566,4,6,6,41,0.1276595744680851,0.1276595744680851,0.8723404255319149,47,1150,900,250,0.782608695652174,14,9,5,332.62121925905876,0.4791666666666667,0.2904480165063352,0.1718661674672611,126357.83420138895,-981.0975988657538,125376.73660252319,222,0,24.21276595744681,39,8,14,40.285260395082176,0.5779914529914529,48.645833333333336,1005.4166666666672,25.779914529914542,0
567,4,3,4,40,0.06818181818181818,0.09090909090909091,0.9090909090909091,44,1750,1300,450,0.7428571428571429,22,13,9,353.1878606265935,0.47904554263565896,0.29457875495178065,0.18235442636284543,126326.69990514153,123.41137590291498,126450.11128104445,223,0,26.181818181818183,36,8,14,39.80037153205631,0.5830439814814814,48.676801801801794,1005.2927927927919,27.924799799799775,0
568,4,3,5,38,0.06976744186046512,0.11627906976744186,0.8837209302325582,43,1150,800,350,0.6956521739130435,15,8,7,365.88489077163695,0.47584440753045404,0.310348703401397,0.18948389158554974,126450.94548396775,653.2980752743499,127104.2435592421,224,0,27.6046511627907,35,8,15,39.35318373609515,0.5863095238095238,48.55324074074074,1005.7870370370368,28.73677248677248,0
569,4,3,4,37,0.07317073170731707,0.0975609756097561,0.9024390243902439,41,1600,1100,500,0.6875,21,11,10,373.1311913637243,0.4779979674796748,0.29225502781343593,0.19334979916120268,126474.91349480973,1238.3470299884702,127713.2605247982,225,0,28.951219512195124,33,8,17,39.14625974658869,0.5909090909090908,48.529411764705884,1005.8823529411768,30.481283422459903,0
570,4,6,4,39,0.13953488372093023,0.09302325581395349,0.9069767441860466,43,1500,1000,500,0.6666666666666666,20,10,10,343.6284408545013,0.47625968992248063,0.24866938384080606,0.18314263056531085,127617.73003472202,172.11814566510546,127789.84818038713,226,0,26.3953488372093,35,8,15,38.715635738831615,0.5982142857142857,47.39583333333332,1010.4166666666649,28.86904761904757,0
571,4,3,0,42,0.07142857142857142,0.0,1.0,42,1400,800,600,0.5714285714285714,20,8,12,352.39463579563505,0.4756944444444444,0.27401259301659997,0.18849768179270482,127763.95486379015,604.6664684070449,128368.62133219719,227,0,27.952380952380953,35,7,18,38.344423774088916,0.5997023809523809,47.2511574074074,1010.9953703703691,28.885582010581974,0
572,4,1,4,39,0.023255813953488372,0.09302325581395349,0.9069767441860466,43,1450,1200,250,0.8275862068965517,17,12,5,341.6749051287984,0.4746677740863787,0.2623949090720954,0.1843731931037153,128116.02776763242,154.8063265968566,128270.83409422927,228,0,28.27906976744186,36,7,19,38.2554690396737,0.6012731481481481,46.90315315315315,1012.3873873873868,28.121871871871853,0
573,4,1,0,40,0.025,0.0,1.0,40,1700,1400,300,0.8235294117647058,20,14,6,354.82067783603867,0.4733840811965812,0.24824716916390255,0.1909044422351066,127998.08873724694,1083.2737214934668,129081.3624587404,229,0,29.4,35,5,20,38.04341091921156,0.6020833333333333,47.01967592592592,1011.9212962962952,28.912037037037006,0
574,4,3,3,40,0.06976744186046512,0.06976744186046512,0.9302325581395349,43,1100,600,500,0.5454545454545454,16,6,10,329.5312730822903,0.4738141380583241,0.23715554037045483,0.18082222850757326,128783.68975309702,-112.26562819128219,128671.42412490574,230,0,28.27906976744186,37,6,19,37.88248082532138,0.6061373873873874,46.244517543859644,1015.0219298245606,27.43302513039353,0
575,4,2,2,40,0.047619047619047616,0.047619047619047616,0.9523809523809523,42,1500,1100,400,0.7333333333333333,19,11,8,340.68916498876644,0.47289972899729,0.24641045017812835,0.18773371417554668,128950.68825263533,386.42046110340334,129337.10871373874,231,0,29.333333333333332,37,5,22,37.42926607650507,0.6078265765765766,46.080043859649116,1015.6798245614027,27.4508060692271,0
576,4,0,3,37,0.0,0.075,0.925,40,1150,700,450,0.6086956521739131,16,7,9,350.95661804940113,0.4732772435897436,0.23425461591064578,0.1931802614031016,128907.38195516092,1048.1797625171153,129955.56171767804,232,1,30.9,35,5,23,37.21269280449814,0.6113095238095239,46.12268518518517,1015.5092592592571,29.014550264550202,0
577,4,0,2,35,0.0,0.05405405405405406,0.9459459459459459,37,1400,1000,400,0.7142857142857143,18,10,8,429.7435965408928,0.47194069069069067,0.1748716559288097,0.2150397762234914,125032.55420260946,3765.0237723142327,128797.5779749237,233,2,32.7027027027027,31,6,17,39.222459098207686,0.580981182795699,49.96744791666666,1000.1302083333322,32.262264784946204,16
578,4,2,4,33,0.05405405405405406,0.10810810810810811,0.8918918918918919,37,950,400,550,0.42105263157894735,15,4,11,424.6957309759034,0.47250375375375375,0.21220025064680215,0.2155393825170387,125619.25464206259,3269.99223497177,128889.24687703435,234,0,33.37837837837838,31,6,18,38.73785015369961,0.5870295698924731,49.38151041666666,1002.4739583333322,32.33786962365588,0
579,4,1,2,32,0.029411764705882353,0.058823529411764705,0.9411764705882353,34,1100,800,300,0.7272727272727273,14,8,6,435.27144982376376,0.47328060011883544,0.2216940785454189,0.2215007145297674,125730.23003472226,4145.355902777784,129875.58593750004,235,0,33.970588235294116,29,5,20,38.35730854452292,0.59375,49.270833333333336,1002.9166666666671,34.58333333333335,0
580,4,2,1,33,0.058823529411764705,0.029411764705882353,0.9705882352941176,34,1450,1100,350,0.7586206896551724,18,11,7,411.4005971509963,0.47012403446226975,0.1760973923428064,0.21375130262800182,126584.2894590414,3615.76107967683,130200.05053871823,236,0,31.852941176470587,30,4,19,38.0707114554116,0.5996527777777778,48.42069892473118,1006.3172043010744,33.543906810035814,0
581,4,0,0,33,0.0,0.0,1.0,33,1500,1200,300,0.8,18,12,6,408.58836724883815,0.4691051136363636,0.1368111494693771,0.18987341772151903,121894.53125000012,3414.4931856284097,125309.02443562853,237,1,33.515151515151516,29,4,18,43.0379746835443,0.5538793103448276,53.12500000000001,987.5000000000009,34.05172413793107,16
582,4,8,4,37,0.1951219512195122,0.0975609756097561,0.9024390243902439,41,1250,900,350,0.72,16,9,7,339.56966997402594,0.4791920731707317,0.17186088527551968,0.16706827762722062,124325.23739956162,247.75624442008484,124572.99364398171,238,0,27.78048780487805,36,5,14,42.209377822944894,0.5625,50.67567567567567,997.2972972972965,27.70270270270268,0
583,4,3,2,38,0.075,0.05,0.95,40,1900,1600,300,0.8421052631578947,22,16,6,346.4466584155691,0.4764823717948718,0.18988523069789065,0.171552748306125,124595.23560742443,633.120606138537,125228.35621356296,239,0,29.35,35,5,16,41.75796042970864,0.5672619047619047,50.40509259259259,998.3796296296287,28.525132275132247,0
584,4,1,2,37,0.02564102564102564,0.05128205128205128,0.9487179487179487,39,1100,700,400,0.6363636363636364,15,7,8,377.00012224591467,0.4786043634727845,0.16360385039759517,0.17429541271749147,121672.22279289445,1432.30723763681,123104.53003053126,240,0,30.58974358974359,36,3,18,44.0515257010235,0.5350115740740741,53.35022522522524,986.5990990991008,27.40553053053058,16
585,4,7,3,41,0.1590909090909091,0.06818181818181818,0.9318181818181819,44,1300,800,500,0.6153846153846154,18,8,10,368.8009864639865,0.48325184989429176,0.29657527392805316,0.18023437127624062,124042.4111866149,371.3192090970948,124413.730395712,241,0,27.886363636363637,37,7,19,41.774789029535846,0.5577139639639639,50.95942982456139,996.1622807017527,26.923304883831154,0
586,4,4,6,39,0.08888888888888889,0.13333333333333333,0.8666666666666667,45,1350,1000,350,0.7407407407407407,17,10,7,360.4166666666665,0.4823653198653199,0.2987037037037039,0.18020833333333347,125000.00000000012,21.462733725775593,125021.46273372589,242,0,27.133333333333333,36,9,16,40.989583333333336,0.5694444444444444,50.00000000000001,1000.0000000000009,27.777777777777803,0
587,4,5,4,40,0.11363636363636363,0.09090909090909091,0.9090909090909091,44,850,500,350,0.5882352941176471,12,5,7,362.8745502981058,0.48046599718111344,0.3096804165923006,0.1838578543611058,125550.3730093664,311.80702910665093,125862.18003847306,243,0,28.15909090909091,35,9,15,40.35841802363631,0.5770833333333334,49.45023148148148,1002.1990740740738,28.634259259259252,0
588,4,4,1,43,0.09090909090909091,0.022727272727272728,0.9772727272727273,44,1900,1300,600,0.6842105263157895,25,13,12,339.00533463902957,0.48454016913319237,0.17583327352696898,0.16802461164026156,124634.27690782017,129.22766085970426,124763.50456867987,244,0,28.954545454545453,36,8,18,41.90326491485281,0.5656828703703703,50.365990990991,998.5360360360376,27.737112112112154,16
589,4,7,7,43,0.14,0.14,0.86,50,1250,900,350,0.72,16,9,7,321.16681356550794,0.48494047619047614,0.26776519255392484,0.1678232968672465,126817.07180846862,-1853.0414330693018,124964.03037539932,245,0,26.04,41,9,14,40.10216602646179,0.5795223577235773,48.18948412698412,1007.2420634920625,24.56687959736738,0
590,4,4,4,43,0.0851063829787234,0.0851063829787234,0.9148936170212766,47,1900,1600,300,0.8421052631578947,22,16,6,331.321542616846,0.48084335491828556,0.2735210921165905,0.17520977646681263,127302.17013888898,-964.4097222222179,126337.76041666676,132,0,21.51063829787234,39,8,20,39.349366914395816,0.5876068376068376,47.708333333333336,1009.1666666666674,25.876068376068396,0
591,4,2,2,43,0.044444444444444446,0.044444444444444446,0.9555555555555556,45,1200,800,400,0.6666666666666666,16,8,8,323.3892862589304,0.48061868686868686,0.24089406931046797,0.17340356556297826,127861.72251966437,-730.177762905661,127131.54475675871,133,0,20.711111111111112,40,5,19,38.97771804662381,0.5916666666666667,47.154471544715456,1011.3821138211393,25.284552845528484,0
592,4,1,1,43,0.022727272727272728,0.022727272727272728,0.9772727272727273,44,1550,1100,450,0.7096774193548387,20,11,9,323.25029605726434,0.47897947498238197,0.23139900445375905,0.1740964454818397,128039.08420138925,-522.2656249999616,127516.8185763893,134,0,21.795454545454547,39,5,20,38.800260738301084,0.5950854700854701,46.979166666666686,1012.0833333333363,25.950854700854777,0
593,4,0,2,41,0.0,0.046511627906976744,0.9534883720930233,43,1150,800,350,0.6956521739130435,15,8,7,325.8930845433712,0.47870524178663715,0.22450181893161636,0.17562634146552356,128063.41428336647,-253.00378040759878,127810.41050295887,135,1,23.0,38,5,21,38.708570825416935,0.5970394736842105,46.95512820512822,1012.1794871794893,26.636302294197087,0
594,4,1,4,38,0.023809523809523808,0.09523809523809523,0.9047619047619048,42,1300,900,400,0.6923076923076923,17,9,8,318.5555276155483,0.4792876500193573,0.19414177009113676,0.17309869146093562,128394.44739006237,-219.82213163335194,128174.62525842902,136,0,22.88095238095238,37,5,17,38.556993580727756,0.6021959459459459,46.62828947368421,1013.4868421052636,27.391536273115232,0
595,4,0,1,37,0.0,0.02631578947368421,0.9736842105263158,38,1300,900,400,0.6923076923076923,17,9,8,336.3607831850877,0.4773293029871977,0.17966318759164257,0.18190853035953863,128204.80619331067,1024.6138038548743,129229.41999716553,137,1,25.236842105263158,34,4,22,38.29934171858468,0.6063112745098039,46.81547619047619,1012.7380952380954,29.786414565826334,0
596,4,2,3,36,0.05128205128205128,0.07692307692307693,0.9230769230769231,39,750,300,450,0.4,12,3,9,369.01896421070677,0.4790823211875843,0.09673751270248387,0.187927496525144,125761.29074598257,1519.24882687432,127280.53957285688,138,0,25.28205128205128,36,3,15,39.98634033157441,0.5772569444444444,49.23986486486487,1003.0405405405413,27.86223723723726,16
597,4,2,3,35,0.05263157894736842,0.07894736842105263,0.9210526315789473,38,1500,1200,300,0.8,18,12,6,368.56752454497996,0.47912221431958274,0.12412250391008595,0.18979260071764628,126218.23157793209,1703.98823302469,127922.21981095678,139,0,26.394736842105264,35,3,18,39.52574291637872,0.5839285714285714,48.78472222222222,1004.8611111111111,28.71031746031746,0
598,4,3,4,34,0.07894736842105263,0.10526315789473684,0.8947368421052632,38,1400,1000,400,0.7142857142857143,18,10,8,359.0441681213778,0.47941856330014226,0.14517078050072052,0.18770602477181306,126836.65242522916,1507.992071463337,128344.64449669249,140,0,26.55263157894737,36,2,15,39.12823737656045,0.5882523148148149,48.170045045045036,1007.3198198198188,27.98110610610608,0
599,4,1,0,35,0.02857142857142857,0.0,1.0,35,1050,700,350,0.6666666666666666,14,7,7,384.80168374848364,0.4771008403361345,0.1697722567287785,0.199848616398406,126567.3828125,2740.6684027777774,129308.05121527778,141,0,29.428571428571427,33,2,19,38.757332643202204,0.5918560606060606,48.4375,1006.25,30.492424242424242,0
600,4,1,2,34,0.027777777777777776,0.05555555555555555,0.9444444444444444,36,1100,800,300,0.7272727272727273,14,8,6,379.5952992056201,0.4767857142857143,0.16520295106070138,0.19881773592056745,126912.01814058959,2435.041099773243,129347.05924036283,142,0,29.583333333333332,34,2,20,38.53305174858222,0.5931372549019608,48.095238095238095,1007.6190476190478,29.6358543417367,0
601,4,3,3,34,0.08108108108108109,0.08108108108108109,0.9189189189189189,37,900,400,500,0.4444444444444444,14,4,10,361.8136528637175,0.47700825825825827,0.1439190008885507,0.1925390536188265,127555.82475790558,1830.542881981216,129386.3676398868,143,0,28.513513513513512,33,4,15,38.31976121153301,0.6019570707070707,47.45710784313725,1010.1715686274506,30.611259655377292,0
602,4,0,3,31,0.0,0.08823529411764706,0.9117647058823529,34,1400,1100,300,0.7857142857142857,17,11,6,392.0347739213865,0.47716131907308373,0.12774283234641337,0.19284485121797693,124317.34085083017,2975.7624296535355,127293.1032804837,144,1,30.764705882352942,31,3,17,40.90952365408887,0.5735887096774194,50.68359375000001,997.2656250000007,32.169858870967765,16
603,4,6,4,33,0.16216216216216217,0.10810810810810811,0.8918918918918919,37,1000,600,400,0.6,14,6,8,354.8981330504793,0.4801051051051051,0.1171278166527574,0.1800145951978938,125595.94671201814,1514.7534013605461,127110.70011337868,145,0,26.783783783783782,34,3,18,40.51118368962788,0.579656862745098,49.404761904761905,1002.3809523809523,29.481792717086833,0
604,4,2,1,34,0.05714285714285714,0.02857142857142857,0.9714285714285714,35,650,300,350,0.46153846153846156,10,3,7,372.8431907404774,0.47853641456582635,0.13797698582773577,0.18827275825233675,125410.69031540159,2351.704386032051,127762.39470143364,146,0,29.257142857142856,32,3,20,40.253266943989246,0.5823567708333333,49.58964646464647,1001.641414141415,31.30129419191922,0
605,4,3,4,33,0.08108108108108109,0.10810810810810811,0.8918918918918919,37,1000,700,300,0.7,13,7,6,352.57328146357406,0.4789164164164164,0.13712236806981326,0.18173811950237403,126259.2831633266,1504.724181105601,127764.0073444322,147,0,28.18918918918919,33,4,23,39.88525281469739,0.588699494949495,48.743872549019606,1005.0245098039215,30.45528817587641,0
606,4,6,9,30,0.15384615384615385,0.23076923076923078,0.7692307692307692,39,1200,900,300,0.75,15,9,6,313.5838892029824,0.47950404858299595,0.0690480964156035,0.16632951911181204,127423.91889812227,191.61761311170426,127615.53651123398,148,0,23.923076923076923,37,2,13,39.67247683174054,0.5923423423423424,47.5877192982456,1009.6491228070156,27.28781412991934,0
607,4,2,1,31,0.0625,0.03125,0.96875,32,650,500,150,0.7692307692307693,8,5,3,376.8863362333983,0.47744455645161293,0.10190835228032658,0.1942094511383266,126246.3710580703,3116.1064501676515,129362.47750823795,149,0,29.6875,30,2,23,39.28770451607152,0.5961805555555555,48.75672043010753,1004.9731182795699,33.49910394265233,0
608,4,0,1,30,0.0,0.03225806451612903,0.967741935483871,31,950,700,250,0.7368421052631579,12,7,5,384.54796528702315,0.4778673835125448,0.10150228375677961,0.19751781853378933,126113.58024691374,3499.344135802492,129612.92438271623,150,1,31.06451612903226,29,2,23,39.23246220501474,0.5977011494252873,48.8888888888889,1004.4444444444458,34.63601532567055,0
609,4,4,3,31,0.11764705882352941,0.08823529411764706,0.9117647058823529,34,700,400,300,0.5714285714285714,10,4,6,343.3759072485624,0.47530451574569227,0.08161050828098193,0.18230782704433993,127462.99500192242,1953.5443098808246,129416.53931180324,100,0,24.794117647058822,33,1,18,38.880461165048544,0.601010101010101,47.54901960784314,1009.8039215686282,30.600118835412975,0
610,4,1,1,31,0.03125,0.03125,0.96875,32,1050,800,250,0.7619047619047619,13,8,5,361.26210924821737,0.4723412298387097,0.08837695236865883,0.1905171926716094,127190.50301445872,2789.8218790690325,129980.32489352775,101,0,26.8125,31,1,23,38.7086667957489,0.6031586021505376,47.81901041666668,1008.7239583333347,32.53948252688176,0
611,4,1,1,31,0.03125,0.03125,0.96875,32,850,500,350,0.5882352941176471,12,5,7,357.1136898963019,0.47129116263440857,0.0791911195666195,0.1892482869286416,127387.59570651579,2698.3708699544213,130085.96657647021,102,0,27.125,31,1,19,38.610994668730406,0.6051747311827957,47.623697916666664,1009.5052083333328,32.56468413978493,0
612,4,0,2,29,0.0,0.06451612903225806,0.935483870967742,31,850,500,350,0.5882352941176471,12,5,7,408.05214766102466,0.4707885304659498,0.08392663153263968,0.20166868865833043,124514.36149691363,4157.597614806382,128671.95911172,103,2,29.0,29,2,16,40.30464328787456,0.5811781609195402,50.486111111111114,998.0555555555559,34.41570881226055,15
613,4,2,2,29,0.06451612903225806,0.06451612903225806,0.935483870967742,31,900,600,300,0.6666666666666666,12,6,6,394.7916666666666,0.4723118279569893,0.11344086021505362,0.19739583333333333,125000.00000000012,3669.7916666666806,128669.7916666668,104,0,29.451612903225808,30,1,19,40.13020833333333,0.5833333333333333,50.00000000000001,1000.0000000000009,33.333333333333364,0
614,4,6,5,30,0.17142857142857143,0.14285714285714285,0.8571428571428572,35,900,500,400,0.5555555555555556,13,5,8,354.26185964808604,0.477906162464986,0.09857582625756933,0.18311478987685037,126372.79620181413,1953.8123582766561,128326.60856009078,96,0,23.82857142857143,34,1,15,39.72590575420318,0.5876225490196079,48.63095238095239,1005.476190476191,29.57282913165268,0
615,4,4,1,33,0.11764705882352941,0.029411764705882353,0.9705882352941176,34,750,500,250,0.6666666666666666,10,5,5,364.11061541055244,0.4752302436125966,0.1285425608908446,0.1888176905815051,126505.73284614093,2412.4160479142674,128918.14889405521,97,0,25.38235294117647,33,1,18,39.341347910829576,0.5912247474747474,48.49877450980392,1006.0049019607845,30.484997029114684,0
616,4,1,1,33,0.029411764705882353,0.029411764705882353,0.9705882352941176,34,1000,700,300,0.7,13,7,6,367.57721929380057,0.47536021984551396,0.13853678798034919,0.19133582251452982,126659.88592128048,2511.457732602871,129171.34365388335,98,0,26.352941176470587,33,1,20,39.09534534534534,0.5928030303030303,48.34558823529413,1006.6176470588252,30.503565062388645,0
617,4,1,0,34,0.029411764705882353,0.0,1.0,34,950,600,350,0.631578947368421,13,6,7,366.68475113579206,0.4750631313131313,0.1494913217050382,0.1920307021553174,126906.72607891208,2506.9522539408094,129413.67833285288,99,0,27.11764705882353,33,1,21,38.863719289710545,0.5953282828282829,48.10049019607844,1007.5980392156873,30.53327391562689,0
618,4,4,3,35,0.10526315789473684,0.07894736842105263,0.9210526315789473,38,1250,900,350,0.72,16,9,7,335.2009737811966,0.47455844001896635,0.16125832345161006,0.18075790829135568,128089.02739304409,987.1133425669555,129076.14073561104,100,0,25.157894736842106,37,1,17,38.446887637203936,0.5990990990990991,46.929824561403514,1012.2807017543865,27.35893788525369,0
619,4,1,2,34,0.027777777777777776,0.05555555555555555,0.9444444444444444,36,1150,700,450,0.6086956521739131,16,7,9,342.2581246083761,0.4732638888888889,0.14483310470964805,0.18481938728852326,128144.53125000012,1571.7013888889041,129716.23263888902,101,0,26.25,35,1,18,38.211591220850494,0.6035714285714286,46.87500000000001,1012.5000000000009,28.928571428571455,0
620,4,1,1,34,0.02857142857142857,0.02857142857142857,0.9714285714285714,35,950,700,250,0.7368421052631579,12,7,5,352.6916451763423,0.47202380952380957,0.1670696487339649,0.19088425681681417,128234.94897959183,2045.4790249433104,130280.42800453515,102,0,27.771428571428572,34,1,19,37.855057984641896,0.6066176470588236,46.785714285714285,1012.8571428571428,29.789915966386552,0
621,4,1,0,35,0.02857142857142857,0.0,1.0,35,1150,1000,150,0.8695652173913043,13,10,3,350.94374856638046,0.472233893557423,0.1678659487747196,0.19123403112859003,128506.39349489799,2019.7030895691682,130526.09658446716,103,0,28.314285714285713,34,1,18,37.6220598019647,0.609375,46.517857142857146,1013.9285714285717,29.82142857142858,0
622,4,0,2,33,0.0,0.05714285714285714,0.9428571428571428,35,1200,900,300,0.75,15,9,6,351.60538637075535,0.4712885154061625,0.03386369437590431,0.17517668953011806,124851.23476473914,1779.6733276643886,126630.90809240354,104,1,29.314285714285713,34,1,20,41.36390708755211,0.5719975490196079,50.14880952380952,999.4047619047612,29.394257703081212,16
623,4,3,0,36,0.08333333333333333,0.0,1.0,36,900,800,100,0.8888888888888888,10,8,2,363.3316535699622,0.4732969576719577,0.12061783386950387,0.1717220131083297,122621.71550605554,1980.4531248774178,124602.16863093295,105,0,29.305555555555557,33,3,18,43.39324012208198,0.5511363636363636,52.38970588235295,990.4411764705897,30.013368983957264,16
624,4,6,3,39,0.14285714285714285,0.07142857142857142,0.9285714285714286,42,1000,700,300,0.7,13,7,6,319.34543304321096,0.47847706155632985,0.15062350376960776,0.15655142116973791,124173.3796867009,-461.89081939418395,123711.4888673067,106,0,25.976190476190474,38,4,20,42.87079715582236,0.5572916666666667,50.82799145299145,996.6880341880334,26.22863247863246,0
625,4,9,10,38,0.1875,0.20833333333333334,0.7916666666666666,48,1000,400,600,0.4,16,4,12,342.69587899913495,0.482565011820331,0.1306499903418974,0.17479177985995273,125825.00018778908,-441.58480107196516,125383.41538671711,107,0,23.104166666666668,42,6,15,40.58073369390254,0.5679563492063492,49.17635658914728,1003.2945736434099,23.887966039128806,16
626,4,4,2,40,0.09523809523809523,0.047619047619047616,0.9523809523809523,42,900,500,400,0.5555555555555556,13,5,8,392.00451057168044,0.47886420828494,0.22277339473357505,0.20144543606600732,126133.51048752837,1489.5514187512067,127623.06190627957,108,0,26.642857142857142,34,8,19,39.02460101129809,0.585171568627451,48.86904761904762,1004.5238095238097,29.544817927170875,0
627,4,3,5,38,0.06976744186046512,0.11627906976744186,0.8837209302325582,43,1800,1300,500,0.7222222222222222,23,13,10,383.0717147176955,0.4789128829826504,0.2476562642850988,0.1945514818101335,125648.36109335675,1581.6855896850943,127230.04668304184,109,0,26.627906976744185,36,7,19,39.750879853232995,0.576099537037037,49.35247747747747,1002.5900900900891,27.849724724724698,16
628,4,3,2,39,0.07317073170731707,0.04878048780487805,0.9512195121951219,41,850,500,350,0.5882352941176471,12,5,7,368.18335754239297,0.4802591463414634,0.17221032266979908,0.17745593284061242,123456.37180677285,916.089273395,124372.46108016785,110,0,26.585365853658537,36,5,15,42.40084985835693,0.5535300925925926,51.548423423423415,993.806306306305,27.605730730730695,16
629,4,7,9,37,0.15217391304347827,0.1956521739130435,0.8043478260869565,46,1050,700,350,0.6666666666666666,14,7,7,323.3656798565659,0.48259863123993557,0.20498544082817505,0.161783944361797,125026.04302300335,-1112.1193003339154,123913.92372266944,111,0,24.5,39,7,16,41.888974238794596,0.5643696581196581,49.97395833333333,1000.1041666666656,25.643696581196554,0
630,4,3,4,36,0.075,0.1,0.9,40,900,500,400,0.5555555555555556,13,5,8,355.7245716996578,0.48334668803418807,0.22917014178482042,0.17697666450949787,124791.75347222228,878.2986111111165,125670.05208333339,112,0,27.95,34,6,18,41.322629969418955,0.5713848039215687,50.208333333333336,999.1666666666672,29.3872549019608,0
631,4,3,2,37,0.07692307692307693,0.05128205128205128,0.9487179487179487,39,1650,1200,450,0.7272727272727273,21,12,9,351.9888474133882,0.4835807467386415,0.2046012058245974,0.17782180709252368,125429.2895160515,1030.1158208381376,126459.40533688964,113,0,26.256410256410255,33,6,17,40.75625968518066,0.5801767676767677,49.57107843137255,1001.7156862745096,30.355020796197262,0
632,4,1,0,38,0.02631578947368421,0.0,1.0,38,1250,1000,250,0.8,15,10,5,389.63498489885046,0.4822042437174016,0.15957916827746188,0.18659404050683637,123183.7293836805,1999.3381076388846,125183.0674913194,101,0,24.94736842105263,35,3,17,42.15306925498427,0.5526785714285714,51.822916666666664,992.7083333333329,28.363095238095227,16
633,4,9,7,40,0.19148936170212766,0.14893617021276595,0.851063829787234,47,1350,900,450,0.6666666666666666,18,9,9,333.3842536327177,0.4856421523280913,0.20990672571399283,0.16868578680486035,125493.90798130212,-982.8195033567805,124511.08847794535,102,0,20.97872340425532,37,10,13,41.15552272561464,0.5726351351351351,49.50657894736843,1001.9736842105278,27.08036984352778,0
634,4,3,3,40,0.06976744186046512,0.06976744186046512,0.9302325581395349,43,850,500,350,0.5882352941176471,12,5,7,347.25757748998853,0.482765780730897,0.21367303244316305,0.1756989391192771,125492.3820757245,115.6361186128313,125608.01819433733,103,0,22.023255813953487,35,8,15,40.80958087867237,0.5764880952380953,49.508101851851855,1001.967592592593,28.627645502645514,0
635,4,3,2,41,0.06976744186046512,0.046511627906976744,0.9534883720930233,43,900,600,300,0.6666666666666666,12,6,6,343.83024771795823,0.48394241417497236,0.2417965240302722,0.17668938064824224,126133.51048752859,76.12119468418285,126209.63168221277,104,0,22.651162790697676,34,9,18,40.23440586236865,0.585171568627451,48.869047619047635,1004.5238095238116,29.54481792717093,0
636,4,1,3,39,0.023809523809523808,0.07142857142857142,0.9285714285714286,42,1050,700,350,0.6666666666666666,14,7,7,348.6690306578103,0.48429636082075106,0.2328528000090242,0.17982972668563807,126283.03748582778,406.19685374151,126689.23433956929,105,0,23.785714285714285,34,8,15,39.95889099451222,0.586703431372549,48.7202380952381,1005.1190476190486,29.562324929972018,0
637,4,2,2,39,0.04878048780487805,0.04878048780487805,0.9512195121951219,41,1550,1000,550,0.6451612903225806,21,10,11,347.21141350882937,0.48343495934959346,0.2246764412285711,0.18052431056602974,126612.30867346932,592.2477324262957,127204.55640589562,106,0,23.341463414634145,34,7,17,39.656769970822495,0.5900735294117647,48.39285714285714,1006.4285714285709,29.60084033613444,0
638,4,3,4,38,0.07142857142857142,0.09523809523809523,0.9047619047619048,42,1500,1200,300,0.8,18,12,6,339.4306048820748,0.4816468253968254,0.23737305615034865,0.1789667402094475,127182.05959467127,234.80371315193605,127416.86330782321,107,0,23.571428571428573,34,8,20,39.26787049057792,0.5958946078431373,47.827380952380956,1008.6904761904768,29.66736694677873,0
639,4,0,4,34,0.0,0.10526315789473684,0.8947368421052632,38,650,400,250,0.6153846153846154,9,4,5,399.803335689077,0.4816856330014225,0.1773116325285673,0.19555547144254148,124079.08340419497,2321.4462868480655,126400.52969104303,108,1,25.710526315789473,34,4,17,40.964422272672955,0.564031862745098,50.922619047619044,996.3095238095234,29.303221288515395,16
640,4,4,1,37,0.10526315789473684,0.02631578947368421,0.9736842105263158,38,1200,700,500,0.5833333333333334,17,7,10,380.9762391529096,0.4841305120910384,0.2040658937759965,0.18084425126494438,122807.3200113378,1788.2015306122385,124595.52154195003,109,0,25.55263157894737,34,4,20,42.76188045480022,0.5508578431372548,52.20238095238095,991.1904761904757,29.152661064425757,16
641,4,2,4,35,0.05128205128205128,0.10256410256410256,0.8974358974358975,39,1600,1000,600,0.625,22,10,12,371.86134282149425,0.48599865047233465,0.20540020811391257,0.17891275408034757,123381.49877751358,1376.2753416317678,124757.77411914535,110,0,25.666666666666668,33,6,18,42.387622836232076,0.5590277777777778,51.62377450980393,993.5049019607853,30.10620915032683,0
642,4,7,5,37,0.16666666666666666,0.11904761904761904,0.8809523809523809,42,750,500,250,0.6666666666666666,10,5,5,333.84728578344976,0.4865345528455285,0.21554575523704567,0.167292534920215,125091.92866025094,-23.875883073805483,125068.05277717713,111,0,23.142857142857142,33,9,19,41.558837641390014,0.5767045454545454,49.90808823529412,1000.3676470588241,30.31417112299467,0
643,4,1,0,38,0.02631578947368421,0.0,1.0,38,1700,1300,400,0.7647058823529411,21,13,8,370.33741423434253,0.4839230678046467,0.23691530634653346,0.18363627643758101,124653.01890432111,1632.7353395061868,126285.7542438273,112,0,26.236842105263158,32,6,21,41.10164580435791,0.5745442708333333,50.34722222222223,998.6111111111121,31.206597222222253,0
644,4,4,3,39,0.09523809523809523,0.07142857142857142,0.9285714285714286,42,850,500,350,0.5882352941176471,12,5,7,333.0617211754282,0.48355836236933797,0.22493366848205532,0.16951350286689723,125736.37543252614,-22.958517557332016,125713.41691496881,113,0,24.642857142857142,33,9,20,40.91367302052784,0.5833333333333333,49.26470588235295,1002.9411764705898,30.392156862745143,0
645,4,6,3,42,0.13333333333333333,0.06666666666666667,0.9333333333333333,45,1300,700,600,0.5384615384615384,19,7,12,311.66182006502896,0.4858585858585858,0.24802691195272986,0.16361788571273184,127006.86486740132,-1083.3618669344912,125923.50300046684,114,0,23.622222222222224,36,9,20,40.14728335753917,0.5899884259259259,48.00112612612613,1007.9954954954967,27.99987487487491,0
646,4,0,2,40,0.0,0.047619047619047616,0.9523809523809523,42,1050,500,550,0.47619047619047616,16,5,11,338.85009580391716,0.48478029423151375,0.26851030267179365,0.17598343685300222,126567.38281250009,177.4739583333489,126744.85677083343,115,1,26.214285714285715,33,9,20,39.913302277432706,0.5918560606060606,48.43750000000001,1006.2500000000007,30.492424242424264,0
647,4,2,2,40,0.047619047619047616,0.047619047619047616,0.9523809523809523,42,1600,900,700,0.5625,23,9,14,325.2600853902231,0.48326800232288036,0.2428210636797481,0.1709921909374915,127062.83925165041,-134.30601101679758,126928.53324063361,116,0,26.095238095238095,35,7,24,39.74727834538705,0.5925595238095238,47.945601851851855,1008.2175925925928,28.806216931216937,0
648,4,2,1,41,0.047619047619047616,0.023809523809523808,0.9761904761904762,42,1350,900,450,0.6666666666666666,18,9,9,322.4543439039837,0.4820581687959737,0.2450210835424842,0.17102784807064977,127422.33737244911,-182.41941179119044,127239.91796065791,117,0,26.61904761904762,34,8,18,39.45019258735213,0.5983455882352942,47.58928571428572,1009.6428571428582,29.695378151260538,0
649,4,1,1,41,0.023809523809523808,0.023809523809523808,0.9761904761904762,42,1500,900,600,0.6,21,9,12,375.6944444444445,0.48186459543166865,0.21944444444444433,0.18784722222222225,125000.0,1186.366213151928,126186.36621315192,118,0,27.285714285714285,37,5,17,40.60763888888888,0.5675675675675675,50.0,1000.0,27.027027027027028,16
650,4,3,4,40,0.06818181818181818,0.09090909090909091,0.9090909090909091,44,1650,1100,550,0.6666666666666666,22,11,11,359.34348111181714,0.48206263213530653,0.21851984741473718,0.18286252833745134,125730.2300347224,236.06770833335193,125966.29774305575,119,0,26.954545454545453,39,5,18,40.26104417670683,0.5715811965811965,49.27083333333334,1002.9166666666681,25.715811965812,0
651,4,3,3,40,0.06976744186046512,0.06976744186046512,0.9302325581395349,43,1250,900,350,0.72,16,9,7,363.11348632325473,0.4813353636028055,0.23553450841697332,0.18696258733193302,126213.51662050553,566.7472582379557,126780.26387874348,120,0,26.6046511627907,36,7,21,39.667619261085584,0.5818865740740741,48.78941441441441,1004.8423423423415,27.912287287287263,0
652,4,4,5,39,0.09090909090909091,0.11363636363636363,0.8863636363636364,44,1600,1100,500,0.6875,21,11,10,343.92692364423215,0.4819745419309373,0.2293730148288764,0.18023559368008107,126934.51063368036,-68.76085069446358,126865.74978298589,92,0,23.84090909090909,39,5,19,39.408465991316945,0.5838675213675213,48.07291666666666,1007.7083333333318,25.838675213675174,0
653,4,1,0,40,0.025,0.0,1.0,40,1300,900,400,0.6923076923076923,17,9,8,367.6508699499764,0.48094284188034186,0.24091301346220217,0.19053391238731315,126480.04979263108,1300.1000675154214,127780.1498601465,93,0,26.9,35,5,20,39.27877977217811,0.5866071428571429,48.52430555555555,1005.9027777777769,28.74007936507934,0
654,4,3,2,41,0.06976744186046512,0.046511627906976744,0.9534883720930233,43,1200,700,500,0.5833333333333334,17,7,10,345.2728555796279,0.4814045773348099,0.2462097982647462,0.1829568557937735,127383.94445516108,200.8743516375058,127584.81880679859,94,0,25.953488372093023,35,8,18,38.91357104639608,0.5958333333333333,47.62731481481481,1009.49074074074,28.84259259259257,0
655,4,0,1,40,0.0,0.024390243902439025,0.975609756097561,41,1300,900,400,0.6923076923076923,17,9,8,345.1906951983526,0.4813262195121952,0.22938210998890618,0.1837696511576673,127572.62613378666,607.3767006802561,128180.00283446691,95,1,27.048780487804876,34,7,18,38.72235643019877,0.5998774509803921,47.44047619047618,1010.2380952380937,29.71288515406158,0
656,4,1,2,39,0.024390243902439025,0.04878048780487805,0.9512195121951219,41,1200,1000,200,0.8333333333333334,14,10,4,347.5914437920392,0.48099593495934956,0.22817254073176518,0.1861564768959379,127813.27239228993,685.3599773242267,128498.63236961416,96,0,27.609756097560975,34,7,19,38.41535201318579,0.602328431372549,47.202380952380935,1011.1904761904736,29.740896358543342,0
657,4,1,6,34,0.025,0.15,0.85,40,1400,1100,300,0.7857142857142857,17,11,6,337.1968383500148,0.47983440170940167,0.19407979786108864,0.1826357668695271,128265.09530895663,650.5456349206029,128915.64094387724,97,0,27.35,34,6,21,38.216643162142056,0.6069240196078431,46.755952380952365,1012.9761904761881,29.79341736694671,0
658,4,0,1,33,0.0,0.029411764705882353,0.9705882352941176,34,900,700,200,0.7777777777777778,11,7,4,373.67462430410023,0.4763814616755793,0.1866409406912657,0.1989939196963288,127584.8409864636,2735.043504503019,130319.88449096662,98,1,29.941176470588236,31,3,21,37.99042509773595,0.6071908602150538,47.42838541666666,1010.2864583333321,32.58988575268813,0
659,4,0,0,33,0.0,0.0,1.0,33,900,600,300,0.6666666666666666,12,6,6,370.4209378544655,0.4741161616161616,0.16442409409045977,0.19790624504915427,127716.42261081256,2861.7674085828744,130578.19001939544,99,2,30.272727272727273,31,2,22,37.937572459100856,0.6085349462365591,47.29817708333332,1010.8072916666654,32.60668682795695,0
660,4,1,1,33,0.029411764705882353,0.029411764705882353,0.9705882352941176,34,1150,800,350,0.6956521739130435,15,8,7,363.80424904850173,0.4741161616161616,0.1654917592599594,0.1966160976268381,128177.49235365134,2527.019585503482,130704.51193915482,100,0,30.352941176470587,31,3,23,37.632468604003236,0.613239247311828,46.84244791666667,1012.630208333334,32.66549059139787,0
661,4,1,1,33,0.029411764705882353,0.029411764705882353,0.9705882352941176,34,1450,1200,250,0.8275862068965517,17,12,5,359.5365425567854,0.47456179441473556,0.1610111875750686,0.19592099768297339,128507.33651055243,2440.6166924370855,130947.95320298952,101,0,30.735294117647058,31,3,23,37.40328432002055,0.6165994623655914,46.51692708333334,1013.9322916666678,32.70749327956993,0
662,4,0,0,33,0.0,0.0,1.0,33,1400,900,500,0.6428571428571429,19,9,10,392.3233860605634,0.4730508207070707,-0.02741702741702734,0.19886737155483739,125568.82747933893,3657.418748979955,129226.24622831888,102,1,30.303030303030305,32,1,19,39.60144242882339,0.583984375,49.43181818181819,1002.2727272727279,31.321022727272748,16
663,4,5,2,36,0.13157894736842105,0.05263157894736842,0.9473684210526316,38,1100,800,300,0.7272727272727273,14,8,6,358.8228356358846,0.47436581318160265,0.04163799036476257,0.1895889382468873,127267.13204089495,1543.3501284945296,128810.48216938948,103,0,27.18421052631579,35,3,21,38.69150034411561,0.5946428571428571,47.74305555555555,1009.0277777777769,28.829365079365054,0
664,4,4,2,38,0.1,0.05,0.95,40,700,500,200,0.7142857142857143,9,5,4,335.7811391129004,0.4714610042735043,0.08939631835408823,0.18144756112976207,128172.28768707678,610.5814342447259,128782.8691213215,104,0,26.5,37,3,22,38.347207182819005,0.5999436936936937,46.84758771929825,1012.6096491228069,27.367828354670458,0
665,4,0,3,35,0.0,0.07894736842105263,0.9210526315789473,38,1100,600,500,0.5454545454545454,16,6,10,344.7048569028253,0.4699057610241821,0.09455268004264772,0.18575426351838786,128061.27997316503,1228.6690375885105,129289.94901075354,105,1,28.42105263157895,37,1,22,38.2347298956415,0.5988175675675675,46.957236842105274,1012.1710526315806,27.355974395448122,0
666,4,1,0,36,0.027777777777777776,0.0,1.0,36,1000,600,400,0.6,14,6,8,347.87122876245047,0.47070105820105823,0.07433420842965899,0.18813353738602465,128204.80619331067,1719.7797443365596,129924.58593764722,106,0,28.63888888888889,34,2,23,38.007915050350704,0.6063112745098039,46.81547619047619,1012.7380952380953,29.786414565826334,0
667,4,1,2,35,0.02702702702702703,0.05405405405405406,0.9459459459459459,37,1300,900,400,0.6923076923076923,17,9,8,346.88344598155766,0.470970970970971,0.08590931794217238,0.18981150358766116,128672.41753472213,1526.8663194444387,130199.28385416657,107,0,28.83783783783784,35,2,15,37.55561259411363,0.6089285714285715,46.354166666666664,1014.5833333333326,28.988095238095216,0
668,4,0,1,34,0.0,0.02857142857142857,0.9714285714285714,35,750,500,250,0.6666666666666666,10,5,5,364.2497307442477,0.4706932773109244,0.09092855416278178,0.1985376990894538,128517.04422577868,2362.4597510572994,130879.50397683597,108,1,30.857142857142858,33,2,15,37.27389009749416,0.6117424242424243,46.50735294117648,1013.9705882352952,30.72638146167561,0
669,4,0,1,33,0.0,0.029411764705882353,0.9705882352941176,34,500,400,100,0.8,6,4,2,369.2249953086882,0.47019830659536543,0.08130539887187749,0.20114496013085256,128496.33487654323,2688.811728395062,131185.1466049383,109,2,32.0,32,2,15,37.1689497716895,0.6139322916666667,46.52777777777778,1013.888888888889,31.684027777777782,0
670,4,1,3,31,0.029411764705882353,0.08823529411764706,0.9117647058823529,34,950,700,250,0.7368421052631579,12,7,5,361.28041129802125,0.4689542483660131,0.09846639923320022,0.19862031901818863,128858.98940611769,2510.845738417903,131369.83514453558,110,0,32.529411764705884,33,1,17,36.999974854154104,0.6152146464646464,46.170343137254896,1015.3186274509792,30.76723113487816,0
671,4,0,2,29,0.0,0.06451612903225806,0.935483870967742,31,1000,700,300,0.7,13,7,6,395.02812653779176,0.46792114695340503,-0.03670730730139693,0.19282515251356522,123992.92204115118,3596.1383395724743,127589.06038072365,111,1,35.16129032258065,31,0,18,41.173274284220156,0.570228494623656,51.00911458333333,995.963541666666,32.127856182795675,16
672,4,5,4,30,0.14705882352941177,0.11764705882352941,0.8823529411764706,34,800,600,200,0.75,10,6,4,362.2245593332014,0.4736148247177659,0.019851411375956474,0.18258709897048667,125337.2369551374,2284.1183337923176,127621.35528892971,112,0,32.64705882352941,33,1,18,40.595168889976726,0.579229797979798,49.662990196078425,1001.3480392156858,30.343879976232905,0
673,4,4,1,33,0.11764705882352941,0.029411764705882353,0.9705882352941176,34,1000,800,200,0.8,12,8,4,362.3589141756337,0.47448752228164,0.0661851929383852,0.1851324634242783,125894.45153061222,2323.7953514739174,128218.24688208614,113,0,32.8235294117647,34,0,21,40.01581652827203,0.5827205882352942,49.107142857142854,1003.5714285714284,29.516806722689072,0
674,4,3,4,32,0.08333333333333333,0.1111111111111111,0.8888888888888888,36,1050,600,450,0.5714285714285714,15,6,9,346.4548980088181,0.4708664021164021,0.07191290565844799,0.17980492109794963,126538.26845689733,1568.049155586872,128106.31761248421,114,0,31.916666666666668,35,1,17,39.75193163081404,0.587202380952381,48.46643518518518,1006.1342592592596,28.74669312169313,0
675,4,5,2,35,0.13513513513513514,0.05405405405405406,0.9459459459459459,37,850,500,350,0.5882352941176471,12,5,7,358.5563062373755,0.4771021021021021,0.047252423201190163,0.18345550814281228,125954.1950113377,2221.4163756744765,128175.61138701218,115,0,28.72972972972973,34,3,20,40.049563172043,0.5833333333333333,49.04761904761904,1003.8095238095224,29.523809523809483,16
676,4,3,3,35,0.07894736842105263,0.07894736842105263,0.9210526315789473,38,950,600,350,0.631578947368421,13,6,7,377.9193321235046,0.47688477951635844,0.0766708955312363,0.18870460239552744,124943.70003449415,1916.1804566908575,126859.880491185,116,0,26.789473684210527,36,2,17,40.610450927386054,0.5688657407407407,50.05630630630632,999.7747747747763,27.771521521521564,16
677,4,1,3,33,0.027777777777777776,0.08333333333333333,0.9166666666666666,36,1300,1100,200,0.8461538461538461,15,11,4,379.3434776703878,0.47539682539682543,0.07818965850640058,0.18693890417616188,124393.09956114965,2278.0250364032327,126671.12459755287,117,0,29.083333333333332,35,1,15,41.147102332057074,0.5651785714285714,50.607638888888886,997.5694444444441,28.501984126984116,16
678,4,5,5,33,0.13157894736842105,0.13157894736842105,0.868421052631579,38,900,500,400,0.5555555555555556,13,5,8,346.8391038501503,0.4796111901375059,0.11554762178970424,0.17572668565356833,125548.84676054165,1110.5268000463789,126659.37356058804,118,0,27.842105263157894,37,1,16,40.76176148796501,0.5731981981981982,49.45175438596491,1002.1929824561399,27.086296823138916,0
679,4,6,6,33,0.15384615384615385,0.15384615384615385,0.8461538461538461,39,1700,1400,300,0.8235294117647058,20,14,6,340.3736665193907,0.47911043634727846,0.13547162320469508,0.17606130263109562,126401.9352709484,805.7518900045751,127207.68716095296,119,0,27.76923076923077,37,2,15,40.045046886926166,0.5819256756756757,48.601973684210506,1005.592105263155,27.178165007112295,0
680,4,3,2,34,0.08333333333333333,0.05555555555555555,0.9444444444444444,36,750,500,250,0.6666666666666666,10,5,5,363.8872001128943,0.47800925925925924,0.1669067255962018,0.18822750639030109,126402.72285997728,1999.26658163265,128401.98944160993,120,0,30.666666666666668,34,2,17,39.4531095852571,0.5879289215686274,48.601190476190474,1005.5952380952377,29.576330532212875,0
681,4,0,1,33,0.0,0.029411764705882353,0.9705882352941176,34,1250,800,450,0.64,17,8,9,373.5386587710997,0.47558303624480097,0.1459213519662006,0.1931728492501974,126392.7469135803,2642.515432098772,129035.26234567908,121,1,29.970588235294116,32,2,18,39.220764272559855,0.5924479166666667,48.611111111111114,1005.555555555556,31.423611111111125,0
682,4,1,0,34,0.029411764705882353,0.0,1.0,34,900,600,300,0.6666666666666666,12,6,6,367.93289810875956,0.4757315805109923,0.1327292582863553,0.19145959945972782,126646.80262218136,2519.505024997442,129166.30764717881,122,0,29.529411764705884,32,2,20,39.09987037966216,0.5950520833333333,48.358585858585855,1006.5656565656561,31.455176767676754,0
683,4,3,2,35,0.08108108108108109,0.05405405405405406,0.9459459459459459,37,750,500,250,0.6666666666666666,10,5,5,342.8886605963937,0.4763513513513513,0.1330291744060459,0.18213678821785909,127482.44224773254,1343.237944665179,128825.68019239772,123,0,28.054054054054053,34,3,16,38.87284372666903,0.5989583333333333,47.52976190476191,1009.8809523809534,29.702380952380985,0
684,4,0,2,33,0.0,0.05714285714285714,0.9428571428571428,35,1050,800,250,0.7619047619047619,13,8,5,359.6489111193654,0.4760854341736695,0.14223858984214388,0.18995072364539659,127251.2072269412,2153.151623558829,129404.35885050004,124,1,30.457142857142856,32,3,22,38.687012472364756,0.6012369791666667,47.75883838383839,1008.9646464646471,31.530145202020222,0
685,4,2,1,34,0.05714285714285714,0.02857142857142857,0.9714285714285714,35,900,700,200,0.7777777777777778,11,7,4,352.45845770682,0.4728291316526611,0.13683281717676765,0.1895928003443134,127989.47707912818,2022.194738802375,130011.67181793055,125,0,28.97142857142857,33,2,18,38.11198074361146,0.6063762626262627,47.0281862745098,1011.8872549019604,30.663250148544254,0
686,4,0,1,33,0.0,0.029411764705882353,0.9705882352941176,34,1050,800,250,0.7619047619047619,13,8,5,363.3336748786594,0.4719065656565657,0.1498777721496689,0.19526443573458752,127952.84162649234,2497.9152318641213,130450.75685835647,126,1,30.735294117647058,32,2,19,37.87439161362787,0.6083984375,47.06439393939395,1011.7424242424254,31.616950757575793,0
687,4,2,2,33,0.05714285714285714,0.05714285714285714,0.9428571428571428,35,950,700,250,0.7368421052631579,12,7,5,355.1123465023238,0.47062324929971994,0.1520308207936698,0.19280525234587786,128361.76478097384,2116.569498510209,130478.33427948406,127,0,30.571428571428573,33,2,21,37.66414217761116,0.6101641414141414,46.660539215686285,1013.3578431372564,30.70781342840171,0
688,4,2,1,34,0.05714285714285714,0.02857142857142857,0.9714285714285714,35,850,600,250,0.7058823529411765,11,6,5,361.0787530566718,0.47328431372549024,0.16095620385635434,0.1878929386010306,126646.80262218144,2248.3860443169483,128895.18866649839,128,0,29.914285714285715,32,3,18,39.272349055025934,0.5950520833333333,48.35858585858586,1006.5656565656568,31.455176767676775,16
689,4,2,1,35,0.05555555555555555,0.027777777777777776,0.9722222222222222,36,1350,1100,250,0.8148148148148148,16,11,5,391.0937474047043,0.47519841269841273,0.13803670525354184,0.19397583369451807,124663.21734729416,2635.9572216399,127299.17456893406,129,0,29.444444444444443,33,3,16,40.57284636151676,0.5722853535353536,50.33700980392156,998.6519607843125,30.26218062982765,16
690,4,3,2,36,0.07894736842105263,0.05263157894736842,0.9473684210526316,38,1100,600,500,0.5454545454545454,16,6,10,372.7629614722659,0.47639580369843526,0.15122685396333102,0.1883399551396649,125434.40453800143,1751.4600212191199,127185.86455922054,130,0,28.763157894736842,35,3,16,40.230719237435,0.5758928571428572,49.565972222222214,1001.7361111111102,28.62103174603172,0
691,4,1,0,37,0.02702702702702703,0.0,1.0,37,1550,1100,450,0.7096774193548387,20,11,9,399.3447686526963,0.4772897897897898,0.15482088046157227,0.20076934183343864,125227.96842787007,2634.4693219220285,127862.43774979211,131,0,29.16216216216216,31,6,16,39.77941654741773,0.582997311827957,49.77213541666667,1000.9114583333339,32.287466397849485,16
692,4,3,2,38,0.075,0.05,0.95,40,1500,1100,400,0.7333333333333333,19,11,8,373.45574896625385,0.47763087606837606,0.16716664506932766,0.19225870678936482,126207.32837253132,1434.5177544487656,127641.84612698009,132,0,27.9,31,9,20,39.41419917066217,0.5930779569892473,48.79557291666666,1004.8177083333321,32.41347446236555,0
693,4,5,5,38,0.11627906976744186,0.11627906976744186,0.8837209302325582,43,1500,1100,400,0.7333333333333333,19,11,8,342.1650533073545,0.4778516057585825,0.16346219731126022,0.1820232274177369,127542.5612953515,128.121456916099,127670.68275226759,133,0,26.162790697674417,34,9,18,38.82955215085442,0.5995710784313726,47.470238095238095,1010.1190476190478,29.709383753501406,0
694,4,3,2,39,0.07317073170731707,0.04878048780487805,0.9512195121951219,41,900,700,200,0.7777777777777778,11,7,4,348.1701915433434,0.4789888211382114,0.17635749483859153,0.1857057826304274,127648.68830497874,688.6936514801884,128337.38195645894,134,0,27.926829268292682,33,8,20,38.56920527124263,0.6029040404040404,47.36519607843137,1010.5392156862737,30.622400475341628,0
695,4,3,1,41,0.07142857142857142,0.023809523809523808,0.9761904761904762,42,1250,900,350,0.72,16,9,7,335.6406610800426,0.47673490127758417,0.17877421918807546,0.18111344000414117,128115.23604948973,200.13650441527602,128315.372553905,135,0,27.976190476190474,35,7,24,38.40900213406502,0.6032738095238095,46.903935185185176,1012.384259259258,28.925264550264515,0
696,4,0,2,39,0.0,0.04878048780487805,0.9512195121951219,41,1000,500,500,0.5,15,5,10,342.82245796123624,0.4764735772357724,0.1748961751141498,0.1849849100572556,128114.3990929703,584.0986394557531,128698.49773242605,136,1,29.365853658536587,34,7,25,38.22808874255251,0.6053921568627452,46.90476190476189,1012.3809523809506,29.775910364145606,0
697,4,0,0,39,0.0,0.0,1.0,39,1300,800,500,0.6153846153846154,18,8,10,352.1168167333156,0.47492127755285646,0.17056494681837675,0.1899914291095371,128112.57301550846,1222.1182787470461,129334.6912942555,137,2,31.128205128205128,32,7,25,37.994720212854425,0.6100260416666667,46.90656565656565,1012.373737373736,31.63667929292925,0
698,4,2,2,39,0.04878048780487805,0.04878048780487805,0.9512195121951219,41,1000,500,500,0.5,15,5,10,337.5106789354148,0.47540650406504065,0.16470494011847614,0.18531574753910338,128808.33510487503,494.8377267573394,129303.17283163237,138,0,30.5609756097561,34,7,19,37.65490012118369,0.6124387254901961,46.22023809523808,1015.1190476190455,29.85644257703075,0
699,4,0,4,35,0.0,0.10256410256410256,0.8974358974358975,39,1600,1200,400,0.75,20,12,8,348.36082662341784,0.47340305892937473,0.1504281760258579,0.19106783881424796,128765.68657487487,1171.3842031910576,129937.07077806593,139,1,31.743589743589745,33,6,19,37.423025839169284,0.6142676767676767,46.26225490196077,1014.9509803921554,30.756090314913802,0
700,4,1,0,36,0.027777777777777776,0.0,1.0,36,1250,1000,250,0.8,15,10,5,381.5323762481121,0.4720734126984127,0.17795380558869933,0.20779052086927835,128484.97884509758,2604.235858191684,131089.21470328927,140,0,34.80555555555556,30,6,20,36.868619912501664,0.6190972222222222,46.53897849462365,1013.8440860215044,33.79480286738348,0
701,4,0,0,36,0.0,0.0,1.0,36,1300,1000,300,0.7692307692307693,16,10,6,381.10307071309603,0.47144510582010585,0.18193193193193147,0.20844680998133677,128655.37200832463,2606.1914672216353,131261.56347554625,141,1,35.80555555555556,30,6,20,36.70508744038153,0.6208333333333333,46.37096774193548,1014.5161290322578,33.81720430107526,0
702,4,0,1,35,0.0,0.027777777777777776,0.9722222222222222,36,1050,600,450,0.5714285714285714,15,6,9,378.9647822463926,0.471412037037037,0.17950699043414264,0.20763309912628913,128723.56088854205,2556.3392444213205,131279.90013296338,142,2,36.80555555555556,30,6,20,36.689569536423825,0.6215277777777778,46.303763440860216,1014.7849462365593,33.82616487455198,0
703,4,0,0,35,0.0,0.0,1.0,35,1050,600,450,0.5714285714285714,15,6,9,390.4810493782916,0.4702380952380953,0.1863303021413909,0.2136677202777842,128672.41753472216,3048.8281249999945,131721.24565972216,143,3,38.628571428571426,29,6,20,36.449777549623555,0.6239224137931034,46.354166666666664,1014.5833333333328,34.98563218390803,0
704,4,0,1,34,0.0,0.02857142857142857,0.9714285714285714,35,950,500,450,0.5263157894736842,14,5,9,400.3207796339799,0.46985294117647064,0.1394572025052192,0.19768417880894468,124479.70920138885,2966.3628472222113,127446.07204861105,144,4,39.628571428571426,33,2,17,40.533663883089744,0.5703914141414141,50.52083333333333,997.9166666666663,30.23989898989898,15
705,4,2,0,36,0.05555555555555555,0.0,1.0,36,1300,800,500,0.6153846153846154,18,8,10,389.23611111111086,0.4720072751322751,0.1458333333333337,0.1946180555555557,125000.00000000023,2530.9027777778065,127530.90277777804,145,0,39.0,34,2,19,40.26909722222223,0.5735294117647058,50.000000000000014,1000.0000000000018,29.411764705882405,0
706,4,4,6,34,0.1,0.15,0.85,40,1300,800,500,0.6153846153846154,18,8,10,365.4815556411876,0.4722489316239316,0.18882782828864086,0.18914051441133295,126421.84452428421,1240.970480752754,127662.81500503697,146,0,36.0,35,5,12,39.39331818007442,0.5860119047619048,48.58217592592593,1005.671296296297,28.73346560846563,0
707,4,1,2,33,0.02857142857142857,0.05714285714285714,0.9428571428571428,35,1100,600,500,0.5454545454545454,16,6,10,404.48843004627963,0.4686274509803921,0.22542318059299205,0.20692940919356015,125948.76320018369,3188.9634986225933,129137.72669880628,147,0,40.542857142857144,32,3,16,38.902515723270426,0.587890625,49.053030303030305,1003.7878787878791,31.36837121212122,0
708,4,1,2,32,0.029411764705882353,0.058823529411764705,0.9411764705882353,34,750,500,250,0.6666666666666666,10,5,5,431.6898479866127,0.46732026143790845,0.2330501385666175,0.204755178924794,122773.48443206938,3800.013366253361,126573.49779832274,148,0,41.411764705882355,33,1,15,41.54082168913071,0.5527146464646464,52.236519607843135,991.0539215686274,30.031937017231133,15
709,4,10,6,36,0.23809523809523808,0.14285714285714285,0.8571428571428572,42,1250,800,450,0.64,17,8,9,362.9198923820971,0.4780536198219125,0.19457980197595148,0.18182839278229945,125084.47372626008,744.9575464992604,125829.43127275935,149,0,32.11904761904762,36,6,16,40.83947802919434,0.5703125,49.91554054054054,1000.3378378378382,27.787162162162172,0
710,4,10,2,44,0.21739130434782608,0.043478260869565216,0.9565217391304348,46,1100,800,300,0.7272727272727273,14,8,6,359.0416038466434,0.47690217391304346,0.2555699525059427,0.1803507274798193,125191.95960535946,681.7467208156393,125873.7063261751,150,0,28.847826086956523,37,9,21,40.82518443446185,0.5695382882882882,49.808114035087726,1000.7675438596501,27.04777145566622,16
711,4,1,6,39,0.022222222222222223,0.13333333333333333,0.8666666666666667,45,1350,900,450,0.6666666666666666,18,9,9,354.6588240544809,0.476746632996633,0.28219814429730117,0.17933136001028183,125466.44310028093,-100.44376635118039,125365.99933392975,151,0,30.42222222222222,37,8,14,40.650993214402966,0.5723536036036037,49.53399122807018,1001.8640350877199,27.07740635372216,0
712,4,3,4,38,0.07142857142857142,0.09523809523809523,0.9047619047619048,42,1150,600,550,0.5217391304347826,17,6,11,368.61072480919336,0.4759969028261711,0.2668729883634562,0.18624202120394476,125434.40453800176,847.2933545524969,126281.69789255426,152,0,31.19047619047619,35,7,16,40.33470537261701,0.5758928571428572,49.565972222222236,1001.7361111111129,28.621031746031797,0
713,4,3,0,41,0.07317073170731707,0.0,1.0,41,1050,700,350,0.6666666666666666,14,7,7,408.6518282709279,0.478760162601626,0.31555127423206897,0.19321780919019912,122638.57408479092,1864.618564600491,124503.1926493914,153,0,29.097560975609756,35,6,16,42.25334969229569,0.5470238095238096,52.37268518518519,990.5092592592601,28.300264550264576,16
714,4,6,6,41,0.1276595744680851,0.1276595744680851,0.8723404255319149,47,2000,1600,400,0.8,24,16,8,365.7832436960508,0.48292476102374343,0.29662688116242864,0.1791464009228098,124133.45148533954,-296.54867541151924,123836.90280992801,154,0,26.25531914893617,35,12,16,41.75522648083624,0.5625,50.86805555555556,996.5277777777779,28.47222222222223,0
715,4,6,6,41,0.1276595744680851,0.1276595744680851,0.8723404255319149,47,1250,1000,250,0.8,15,10,5,370.4601298824843,0.4836763798951588,0.32463116090785227,0.18423331122855408,124774.87622757902,-155.17662933202237,124619.699598247,155,0,26.893617021276597,36,11,19,40.97206567478209,0.5671296296296297,50.22522522522523,999.0990990990999,27.752752752752777,0
716,4,5,2,44,0.10869565217391304,0.043478260869565216,0.9565217391304348,46,1350,900,450,0.6666666666666666,18,9,9,356.34094855638267,0.48296095008051526,0.3252968182733669,0.18061616170356326,125566.11571712012,-250.7244325475635,125315.39128457256,156,0,27.82608695652174,34,12,20,40.50584986340419,0.5793504901960784,49.4345238095238,1002.2619047619042,29.478291316526594,0
717,4,1,1,44,0.022222222222222223,0.022222222222222223,0.9777777777777777,45,1450,1100,350,0.7586206896551724,18,11,7,358.3334568999449,0.48282828282828283,0.3222129926295114,0.1826785263941825,125804.86288265302,16.018282312921514,125820.88116496593,157,0,28.91111111111111,34,11,21,40.20929749614335,0.5818014705882353,49.19642857142857,1003.2142857142853,29.506302521008394,0
718,4,1,3,42,0.022222222222222223,0.06666666666666667,0.9333333333333333,45,1200,1000,200,0.8333333333333334,14,10,4,371.80717305265796,0.48406986531986534,0.2992969382057682,0.17625142170327995,122749.04699790145,127.79523183952176,122876.84222974097,158,0,29.644444444444446,40,5,16,43.05007178750899,0.5393229166666667,52.26117886178862,990.955284552846,24.773882113821152,16
719,4,6,4,44,0.125,0.08333333333333333,0.9166666666666666,48,1250,1000,250,0.8,15,10,5,337.9455935318384,0.48575096040189125,0.33734423676012404,0.16623121542304328,124315.63227387272,-1191.03455256803,123124.59772130469,159,0,28.291666666666668,37,11,16,42.25982682792742,0.5605292792792793,50.685307017543856,997.2587719298244,26.952939781887146,0
720,4,5,1,48,0.10204081632653061,0.02040816326530612,0.9795918367346939,49,1800,1400,400,0.7777777777777778,22,14,8,328.1249999999998,0.48602253401360546,0.33826530612244876,0.16406250000000017,125000.00000000026,-1594.9964171667923,123405.00358283347,160,0,26.775510204081634,40,9,20,41.79687500000002,0.5625,50.000000000000014,1000.000000000002,25.00000000000005,0
721,4,4,5,47,0.07692307692307693,0.09615384615384616,0.9038461538461539,52,1400,600,800,0.42857142857142855,22,6,16,312.47887583119683,0.48699095022624433,0.33462907740993164,0.15926342703654559,125794.91055681536,-2538.349552784074,123256.56100403129,161,0,26.153846153846153,41,11,17,41.36957739978904,0.5691056910569106,49.20634920634921,1003.1746031746036,24.467673248161063,0
722,4,3,3,47,0.06,0.06,0.94,50,1750,1400,350,0.8,21,14,7,328.29157718479314,0.48560374149659863,0.3589080340460864,0.16769676853649512,125886.98459201395,-1734.472656249994,124152.51193576395,162,0,28.0,39,11,19,40.87822642031692,0.5731837606837606,49.114583333333336,1003.5416666666672,25.73183760683762,0
723,4,2,3,46,0.04081632653061224,0.061224489795918366,0.9387755102040817,49,1300,800,500,0.6153846153846154,18,8,10,327.64587386580837,0.4856505102040816,0.34549919552883446,0.16800565021629715,126043.83680555533,-1540.4513888889146,124503.38541666641,163,0,28.367346938775512,38,11,21,40.73305670816042,0.5764802631578947,48.95833333333332,1004.1666666666648,26.42543859649118,0
724,4,3,2,47,0.061224489795918366,0.04081632653061224,0.9591836734693877,49,1500,800,700,0.5333333333333333,22,8,14,322.52117833788054,0.48614654195011336,0.3379867616865091,0.16689894731690277,126419.6061276386,-1645.3999333406791,124774.20619429792,164,0,28.857142857142858,38,11,17,40.47571620808101,0.5803179824561404,48.58440170940169,1005.66239316239,26.464799820062893,0
725,4,1,5,43,0.020833333333333332,0.10416666666666667,0.8958333333333334,48,1150,600,550,0.5217391304347826,17,6,11,331.7893877888589,0.48579713356973997,0.33896930541925663,0.17162100820144519,126401.93527094866,-1212.2358562250042,125189.69941472365,165,0,30.4375,37,11,18,40.26085395994618,0.5819256756756757,48.60197368421052,1005.5921052631571,27.178165007112355,0
726,4,1,2,42,0.022727272727272728,0.045454545454545456,0.9545454545454546,44,1300,1000,300,0.7692307692307693,16,10,6,391.1193812851658,0.4855532064834391,0.28035944739458807,0.18947463149744764,123672.52470207502,1234.7690522772734,124907.2937543523,166,0,31.931818181818183,35,9,16,41.605092700333586,0.5577380952380953,51.33101851851853,994.6759259259281,28.41931216931223,16
727,4,8,6,44,0.16,0.12,0.88,50,1300,1000,300,0.7692307692307693,16,10,6,339.5124879080655,0.48527210884353744,0.2765767592780368,0.1720592063591645,125559.56792418529,-1466.770403516392,124092.7975206689,167,0,27.9,40,10,14,40.9342678969783,0.5682291666666667,49.4410569105691,1002.2357723577231,25.055894308943078,0
728,4,1,5,40,0.022222222222222223,0.1111111111111111,0.8888888888888888,45,1500,1300,200,0.8666666666666667,17,13,4,354.2307837242858,0.48606902356902354,0.11173343133651858,0.171444674940196,123633.14313057864,-241.06696291166514,123392.07616766698,168,0,31.844444444444445,37,8,18,42.56339581036384,0.553490990990991,51.37061403508772,994.5175438596491,26.878852536747274,16
729,4,4,2,42,0.09090909090909091,0.045454545454545456,0.9545454545454546,44,1550,1300,250,0.8387096774193549,18,13,5,364.7206684085309,0.4862359055673009,0.19952067263677442,0.18223376832743154,124971.06648930442,316.7718313107184,125287.83832061513,169,0,32.36363636363637,35,9,19,40.91197380098004,0.5711309523809525,50.02893518518517,999.8842592592569,28.568121693121626,0
730,4,2,3,41,0.045454545454545456,0.06818181818181818,0.9318181818181819,44,1100,600,500,0.5454545454545454,16,6,10,358.7605459350972,0.48429792107117686,0.21405316977831568,0.1818425669011185,125566.11571711994,209.63699410445474,125775.7527112244,170,0,32.29545454545455,34,10,18,40.445223106465534,0.5793504901960784,49.434523809523796,1002.2619047619028,29.47829131652655,0
731,4,3,3,41,0.06818181818181818,0.06818181818181818,0.9318181818181819,44,1500,1200,300,0.8,18,12,6,345.44170349023125,0.4833839852008457,0.2165005653029608,0.17813632738177923,126276.3899605621,-74.86671880690332,126201.52324175519,171,0,32.47727272727273,35,9,16,40.0468294180869,0.5845238095238094,48.72685185185183,1005.09259259259,28.716931216931144,0
732,4,1,1,41,0.023809523809523808,0.023809523809523808,0.9761904761904762,42,1150,600,550,0.5217391304347826,17,6,11,356.50847289266494,0.48353416569879987,0.129330196650155,0.17617034737842116,124508.58577942812,1018.9218696416241,125527.50764906974,172,0,34.5,35,7,15,41.59672291159301,0.5663690476190476,50.491898148148145,998.0324074074072,28.515211640211632,16
733,4,3,5,39,0.06818181818181818,0.11363636363636363,0.8863636363636364,44,1200,900,300,0.75,15,9,6,340.6379574436044,0.4853660147991543,0.15119221684849848,0.17159275238703045,125309.87649389257,-261.9720695694086,125047.90442432316,173,0,33.59090909090909,36,8,17,41.163817343380956,0.5726273148148149,49.69031531531532,1001.238738738739,27.812187187187195,0
734,4,4,4,39,0.09302325581395349,0.09302325581395349,0.9069767441860466,43,700,500,200,0.7142857142857143,9,5,4,336.25555249577957,0.48747231450719825,0.16644403315361722,0.1716923227407779,125869.56259645057,-135.13213734568117,125734.4304591049,174,0,33.53488372093023,35,8,19,40.69636678200692,0.5803571428571428,49.13194444444444,1003.472222222222,28.670634920634914,0
735,4,2,1,40,0.04878048780487805,0.024390243902439025,0.975609756097561,41,750,300,450,0.4,12,3,9,349.71919953604936,0.4880589430894309,0.197528217040412,0.17878902897629478,125920.80720155708,607.3847798923454,126528.19198144943,175,0,35.8780487804878,33,8,23,40.30575905575906,0.5852272727272727,49.080882352941174,1003.6764705882351,30.414438502673793,0
736,4,5,4,41,0.1111111111111111,0.08888888888888889,0.9111111111111111,45,1150,900,250,0.782608695652174,14,9,5,310.7438594558984,0.48644781144781146,0.19145856740724665,0.16358965514687435,127119.65610812927,-1094.247896994009,126025.40821113526,176,0,31.977777777777778,37,8,20,40.05506777572397,0.5892454954954955,47.889254385964904,1008.4429824561391,27.255215742057814,0
737,4,4,3,42,0.08888888888888889,0.06666666666666667,0.9333333333333333,45,1500,1200,300,0.8,18,12,6,310.67812400395553,0.4839646464646465,0.21405400455570422,0.1663404605464092,127801.98703342024,-1058.943684895824,126743.04334852441,177,0,32.333333333333336,39,6,18,39.360019401806234,0.5926816239316239,47.21354166666667,1011.1458333333343,25.926816239316263,0
738,4,1,1,42,0.023255813953488372,0.023255813953488372,0.9767441860465116,43,1400,1000,400,0.7142857142857143,18,10,8,325.38571392458465,0.4821889996308601,0.22446477316877456,0.1737778395687618,127700.83703639616,-289.594394429015,127411.24264196714,178,0,34.69767441860465,37,6,20,39.09154191075433,0.5951576576576576,47.31359649122809,1010.7456140350905,27.31744902797542,0
739,4,1,1,42,0.023255813953488372,0.023255813953488372,0.9767441860465116,43,900,500,400,0.5555555555555556,13,5,8,325.7280829740501,0.481266149870801,0.23031066542366796,0.175406663118465,128033.53555901852,-259.1763811941769,127774.35917782434,179,0,34.58139534883721,37,6,22,38.743228602383496,0.5985360360360361,46.984649122807035,1012.0614035087749,27.353010905642567,0
740,4,1,4,39,0.023255813953488372,0.09302325581395349,0.9069767441860466,43,1400,1100,300,0.7857142857142857,17,11,6,321.55700869876,0.47992801771871535,0.22685724770452498,0.17463437062644196,128372.67324334486,-344.077255200266,128028.5959881446,180,0,34.86046511627907,36,7,15,38.50312071711671,0.6038773148148149,46.649774774774784,1013.4009009009022,28.150025025025062,0
741,4,0,1,38,0.0,0.02564102564102564,0.9743589743589743,39,1150,700,450,0.6086956521739131,16,7,9,345.6652676923324,0.4771142600089968,0.2285256776850051,0.1859785498728653,127998.08873724705,1048.89872149348,129046.98745874052,181,2,38.333333333333336,35,4,22,38.275024781730146,0.6020833333333333,47.019675925925924,1011.921296296296,28.912037037037027,0
742,4,2,2,38,0.05,0.05,0.95,40,1100,800,300,0.7272727272727273,14,8,6,333.7019769477267,0.4749599358974359,0.20452989502510266,0.18232943428739867,128613.70991941007,583.8973015260514,129197.60722093613,182,0,34.725,35,5,17,37.949756579948264,0.6083333333333334,46.41203703703703,1014.3518518518513,28.981481481481467,0
743,4,2,1,39,0.05,0.025,0.975,40,1300,1100,200,0.8461538461538461,15,11,4,331.01380670611434,0.47581463675213675,0.19930769230769219,0.1823381138635375,128936.76757812491,535.9700520833186,129472.73763020823,183,0,34.875,35,5,19,37.689102564102555,0.6116071428571428,46.09374999999999,1015.6249999999993,29.017857142857125,0
744,4,0,4,35,0.0,0.10256410256410256,0.8974358974358975,39,1200,700,500,0.5833333333333334,17,7,10,381.6357335121006,0.4763270355375619,0.11641434569898701,0.19255358612712536,125376.4403961974,2063.408511231099,127439.8489074285,184,1,36.58974358974359,35,4,17,40.068593743980884,0.5752976190476191,49.623842592592574,1001.5046296296272,28.61441798941792,16
745,4,1,3,33,0.027777777777777776,0.08333333333333333,0.9166666666666666,36,1550,1200,350,0.7741935483870968,19,12,7,396.2312558944853,0.47366071428571427,0.15106712284131607,0.201663967552268,125736.3754325261,2764.1363898500736,128500.51182237617,149,0,35.02777777777778,33,3,18,39.32978983382209,0.5833333333333333,49.26470588235295,1002.9411764705894,30.392156862745136,0
746,4,1,0,34,0.029411764705882353,0.0,1.0,34,1050,700,350,0.6666666666666666,14,7,7,402.41648700173,0.47192513368983957,0.151225089356412,0.20571116753548252,125917.07996951851,3334.221794969914,129251.30176448842,150,0,36.0,32,2,20,38.987346416740046,0.5875651041666667,49.084595959595966,1003.661616161617,31.36442550505053,0
747,4,6,9,31,0.15,0.225,0.775,40,850,500,350,0.5882352941176471,12,5,7,352.8775362296181,0.47508012820512824,0.13328217434981604,0.18629521785982014,127233.9923327043,985.1235521408535,128219.11588484516,151,0,31.45,36,4,17,38.875479034118385,0.5923032407407407,47.7759009009009,1008.8963963963962,28.024899899899893,0
748,4,2,0,33,0.06060606060606061,0.0,1.0,33,1000,700,300,0.7,13,7,6,400.60869977136315,0.46898674242424243,0.16874382730564874,0.20872685085122483,126698.43885633665,3551.2993706597035,130249.73822699636,152,0,36.878787878787875,31,2,19,38.224262803931715,0.5981182795698925,48.30729166666666,1006.7708333333321,32.47647849462361,0
749,4,1,1,33,0.029411764705882353,0.029411764705882353,0.9705882352941176,34,950,600,350,0.631578947368421,13,6,7,394.17194345461957,0.469845513963161,0.1753694506462542,0.20770448122445465,127157.66906738281,3225.0074598524316,130382.67652723525,153,0,36.76470588235294,31,3,20,37.91257853515792,0.6028225806451613,47.8515625,1008.59375,32.53528225806452,0
750,4,1,1,33,0.029411764705882353,0.029411764705882353,0.9705882352941176,34,1200,700,500,0.5833333333333334,17,7,10,385.609358720055,0.4700311942959002,0.15178558301601086,0.20543582479879374,127601.78330017351,3040.888365983072,130642.67166615659,154,0,35.705882352941174,32,2,20,37.67157169041073,0.6048177083333333,47.411616161616166,1010.3535353535359,31.573547979797997,0
751,4,0,0,33,0.0,0.0,1.0,33,1200,900,300,0.75,15,9,6,395.38857875322446,0.46898674242424243,0.15667893162092672,0.21038577462054328,127551.95617675805,3486.5173339844036,131038.47351074245,155,1,37.42424242424242,31,2,20,37.475831399845326,0.6068548387096775,47.460937500000014,1010.1562500000018,32.585685483871025,0
752,4,3,1,35,0.08333333333333333,0.027777777777777776,0.9722222222222222,36,1100,800,300,0.7272727272727273,14,8,6,365.93246019629515,0.47124669312169315,0.14818733959500707,0.19867994178353018,128361.76478097368,2195.720567303598,130557.48534827727,156,0,35.22222222222222,33,3,23,37.39002600072561,0.6101641414141414,46.66053921568628,1013.357843137255,30.707813428401668,0
753,4,1,2,34,0.027777777777777776,0.05555555555555555,0.9444444444444444,36,1100,800,300,0.7272727272727273,14,8,6,357.500114592012,0.46919642857142857,0.12689290275497167,0.19614195476264445,128778.125,2007.6388888888882,130785.76388888889,157,0,34.47222222222222,34,2,17,37.17843459222768,0.6121323529411764,46.25,1015.0,29.852941176470587,0
754,4,1,0,35,0.02857142857142857,0.0,1.0,35,850,700,150,0.8235294117647058,10,7,3,364.5289271628276,0.4666666666666666,0.1293029675638373,0.1996229839225008,128703.50346020758,2383.230007689344,131086.7334678969,158,0,36.371428571428574,33,2,19,37.076288244766495,0.6136363636363636,46.3235294117647,1014.7058823529409,30.74866310160427,0
755,4,0,2,33,0.0,0.05714285714285714,0.9428571428571428,35,1450,1000,450,0.6896551724137931,19,10,9,364.510388219651,0.4656862745098039,0.12906118507277387,0.2002389957567366,128827.88470780461,2391.8204536716544,131219.70516147627,159,1,37.371428571428574,33,2,20,36.94974247545467,0.6148989898989898,46.20098039215686,1015.1960784313719,30.763517528223392,0
756,4,0,1,32,0.0,0.030303030303030304,0.9696969696969697,33,1150,700,450,0.6086956521739131,16,7,9,430.14510391024123,0.465435606060606,0.21880203411187638,0.20947302989238376,123893.58822190425,4107.238409814764,128000.82663171901,160,2,39.09090909090909,30,3,17,40.40294091175015,0.571875,51.108870967741936,995.5645161290322,33.18548387096774,16
757,4,6,5,33,0.15789473684210525,0.13157894736842105,0.868421052631579,38,750,400,350,0.5333333333333333,11,4,7,388.63558660719616,0.47163940256045517,0.21456508800272078,0.19787990561327656,125753.4467699762,2174.452910665321,127927.89968064152,161,0,31.94736842105263,35,3,15,39.50255788906841,0.5791666666666666,49.2476851851852,1003.009259259261,28.657407407407455,0
758,4,3,0,36,0.08333333333333333,0.0,1.0,36,1150,1000,150,0.8695652173913043,13,10,3,393.1849795441919,0.46939484126984127,0.21325931194352266,0.2017584238099029,126073.72448979595,2714.058956916106,128787.78344671206,162,0,33.25,34,2,18,39.05681997787261,0.5845588235294117,48.92857142857143,1004.2857142857146,29.53781512605043,0
759,4,1,2,35,0.02702702702702703,0.05405405405405406,0.9459459459459459,37,1100,800,300,0.7272727272727273,14,8,6,379.38301309588337,0.4715027527527527,0.2063418531841399,0.19689412136373238,126538.26845689741,2201.293911822715,128739.56236872013,163,0,33.32432432432432,35,2,14,38.92367901376587,0.587202380952381,48.46643518518519,1006.1342592592603,28.746693121693152,0
760,4,3,2,36,0.07894736842105263,0.05263157894736842,0.9473684210526316,38,1100,700,400,0.6363636363636364,15,7,8,385.08574732991485,0.47054291133238507,0.24257646796159804,0.20315654443942163,127205.59030314106,2197.011961285615,129402.60226442668,164,0,33.21052631578947,36,2,18,38.0923476222371,0.5920138888888888,47.804054054054056,1008.7837837837844,28.02177177177179,0
761,4,2,1,37,0.05263157894736842,0.02631578947368421,0.9736842105263158,38,1500,1100,400,0.7333333333333333,19,11,8,405.64411524058914,0.47015765765765766,0.22193409948263,0.20472009247265005,125387.20415249429,2591.5038245636606,127978.70797705796,165,0,34.0,34,4,17,39.45629779309797,0.5775122549019608,49.613095238095234,1001.5476190476187,29.457282913165255,16
762,4,1,3,35,0.02631578947368421,0.07894736842105263,0.9210526315789473,38,1400,1100,300,0.7857142857142857,17,11,6,402.63600356722554,0.4696983167377904,0.25014054243132144,0.20511553603733004,125775.00708616765,2528.3092403627934,128303.31632653045,166,0,34.94736842105263,34,4,18,39.129134029590944,0.5814950980392157,49.22619047619047,1003.0952380952369,29.502801120448144,0
763,4,1,1,35,0.027777777777777776,0.027777777777777776,0.9722222222222222,36,900,500,400,0.5555555555555556,13,5,8,411.40721756278714,0.46841931216931215,0.24284395198522635,0.20918028949319178,125695.40895061732,3142.399691358027,128837.80864197535,167,0,35.0,32,4,19,38.9918051708218,0.5852864583333333,49.30555555555556,1002.777777777778,31.336805555555564,0
764,4,2,2,35,0.05405405405405406,0.05405405405405406,0.9459459459459459,37,1450,1100,350,0.7586206896551724,18,11,7,397.4041059569204,0.4714401901901902,0.2301643351894609,0.20487931887416358,126265.81471278438,2636.1928948576656,128902.00760764205,168,0,34.270270270270274,32,5,18,38.75209380234507,0.5911458333333333,48.73737373737374,1005.0505050505049,31.407828282828277,0
765,4,1,1,35,0.027777777777777776,0.027777777777777776,0.9722222222222222,36,1000,800,200,0.8,12,8,4,409.9401897899696,0.47134589947089944,0.22397047397047398,0.2118847486986711,126370.92590332043,3160.904269748278,129531.83017306871,169,0,34.94444444444444,31,5,18,38.3282612449279,0.594758064516129,48.63281250000001,1005.4687500000009,32.434475806451644,0
766,4,1,0,36,0.027777777777777776,0.0,1.0,36,1900,1500,400,0.7894736842105263,23,15,8,404.7076010667248,0.471792328042328,0.2237348912746664,0.2106932298886769,126665.66848754894,3052.511766221802,129718.18025377074,170,0,35.916666666666664,31,5,20,38.15496593799853,0.5977822580645161,48.33984375000001,1006.6406250000009,32.472278225806484,0
767,4,0,0,36,0.0,0.0,1.0,36,1350,1100,250,0.8148148148148148,16,11,5,402.6558262646761,0.4710152116402116,0.21691377180128124,0.21013091500209213,126763.99230957034,3008.4520128038203,129772.44432237415,171,1,36.916666666666664,31,5,20,38.10501249892249,0.5987903225806452,48.2421875,1007.0312500000002,32.48487903225807,0
768,4,1,5,32,0.02702702702702703,0.13513513513513514,0.8648648648648649,37,900,500,400,0.5555555555555556,13,5,8,394.0516585977817,0.4702202202202202,0.2199249456041743,0.20746806837313678,127123.84458537406,2618.672361238665,129742.51694661273,172,0,36.891891891891895,32,5,21,37.95047159968283,0.5999348958333333,47.88510101010102,1008.4595959595969,31.514362373737402,0
769,4,3,3,32,0.08571428571428572,0.08571428571428572,0.9142857142857143,35,1050,900,150,0.8571428571428571,12,9,3,384.98934830224067,0.47027310924369753,0.16355771531650976,0.20535411217688598,127650.62332153329,2828.8260565863866,130479.44937811968,173,0,33.34285714285714,31,4,19,37.63703667912212,0.6078629032258065,47.36328125000001,1010.5468750000007,32.598286290322605,0
770,4,0,0,32,0.0,0.0,1.0,32,900,500,400,0.5555555555555556,13,5,8,405.4109199337531,0.46509576612903225,0.1593359063082247,0.21543547753763936,127498.92509249615,3937.891302462704,131436.81639495885,174,1,34.84375,30,2,21,37.27736003903826,0.6090277777777777,47.51344086021505,1009.946236559139,33.6648745519713,0
771,4,3,4,31,0.08571428571428572,0.11428571428571428,0.8857142857142857,35,900,400,500,0.4444444444444444,14,4,10,378.0071307937701,0.4656862745098039,0.14489236790606652,0.20592925782048674,128496.33487654322,2716.1365997674784,131212.4714763107,175,0,32.77142857142857,32,3,19,36.94634703196347,0.6139322916666667,46.52777777777778,1013.8888888888889,31.68402777777778,0
772,4,1,0,32,0.03125,0.0,1.0,32,1450,1200,250,0.8275862068965517,17,12,5,415.38741777702774,0.4646967405913978,0.12306818181818158,0.210981735942158,125651.88937717023,4069.7069709683706,129721.5963481386,176,0,35.59375,31,1,20,38.93722943722942,0.5873655913978495,49.348958333333336,1002.6041666666674,32.34206989247314,16
773,4,5,3,34,0.13513513513513514,0.08108108108108109,0.9189189189189189,37,1350,1000,350,0.7407407407407407,17,10,7,369.75907025285045,0.4697822822822823,0.09971037637537394,0.19483083464246517,127155.67926742186,2021.0255271305434,129176.70479455241,177,0,31.64864864864865,32,5,20,38.530191120013356,0.6002604166666667,47.853535353535364,1008.5858585858599,31.518308080808122,0
774,4,3,1,36,0.08108108108108109,0.02702702702702703,0.972972972972973,37,1450,1100,350,0.7586206896551724,18,11,7,346.31814508375436,0.47047047047047047,0.09678938239127088,0.1751672846395769,125479.06172642214,1291.1351807888714,126770.19690721101,178,0,32.432432432432435,36,1,19,40.84686785807951,0.5743634259259259,49.52139639639638,1001.9144144144125,27.8309559559559,16
775,4,5,3,38,0.12195121951219512,0.07317073170731707,0.926829268292683,41,1500,1300,200,0.8666666666666667,17,13,4,316.2020755651614,0.47296747967479674,0.07771621111591243,0.16224914326180145,126072.10884871359,-80.72257223439749,125991.38627647918,179,0,30.121951219512194,36,5,21,40.991300366300365,0.5804398148148149,48.93018018018018,1004.2792792792793,27.896646646646648,15
776,4,1,1,38,0.02564102564102564,0.02564102564102564,0.9743589743589743,39,1150,700,450,0.6086956521739131,16,7,9,322.52543056764864,0.47281264057579847,0.09535625664657932,0.16584838491274792,126160.08659122055,337.96724965702725,126498.05384087758,180,0,32.07692307692308,35,4,22,40.74212749615973,0.5833333333333333,48.842592592592574,1004.6296296296272,28.703703703703635,0
777,4,1,3,36,0.02564102564102564,0.07692307692307693,0.9230769230769231,39,1000,500,500,0.5,15,5,10,320.87243774668644,0.474527665317139,0.08944637324075133,0.16589866801622216,126383.31056986006,310.5841906094886,126693.89476046954,181,0,32.87179487179487,36,3,17,40.55442005450407,0.5836226851851851,48.620495495495476,1005.5180180180151,27.931056056055976,0
778,4,3,5,34,0.07692307692307693,0.1282051282051282,0.8717948717948718,39,1350,800,550,0.5925925925925926,19,8,11,338.14331953396106,0.4726158344579397,0.14109298919849955,0.17702564539908383,126893.37722435237,781.6295603035036,127675.00678465588,182,0,33.69230769230769,36,3,19,39.596373085950596,0.5888310185185186,48.11373873873872,1007.5450450450421,27.98736236236228,0
779,4,0,0,34,0.0,0.0,1.0,34,1750,1300,450,0.7428571428571429,22,13,9,367.1984201385414,0.46676322043969104,0.11939191561628948,0.19041894067702367,126505.7328461408,2490.5410479142515,128996.27389405505,183,1,36.529411764705884,33,1,19,39.26368924351321,0.5912247474747474,48.498774509803916,1006.0049019607835,30.484997029114652,0
780,4,0,0,34,0.0,0.0,1.0,34,950,600,350,0.631578947368421,13,6,7,367.31264654570094,0.46654040404040403,0.12379734502496675,0.19076560030276707,126567.38281249988,2497.960069444429,129065.3428819443,184,2,37.529411764705884,33,1,19,39.1972912353347,0.5918560606060606,48.43749999999999,1006.2499999999991,30.492424242424214,0
781,4,1,1,34,0.02857142857142857,0.02857142857142857,0.9714285714285714,35,1400,1200,200,0.8571428571428571,16,12,4,360.2632859016435,0.4675070028011204,0.12260427744298719,0.18855338210176908,126882.03124999988,2142.1874999999845,129024.21874999987,185,0,37.42857142857143,34,1,20,39.05086848635236,0.5928308823529411,48.12499999999999,1007.4999999999991,29.632352941176443,0
782,4,0,0,34,0.0,0.0,1.0,34,1300,1000,300,0.7692307692307693,16,10,6,366.78324408085365,0.46707887700534756,0.12197137154752502,0.192228082605281,126937.59799416088,2511.716797625914,129449.31479178679,186,1,39.0,33,1,20,38.8294772791763,0.5956439393939394,48.06985294117647,1007.7205882352939,30.536987522281635,0
783,4,1,0,35,0.02857142857142857,0.0,1.0,35,550,400,150,0.7272727272727273,7,4,3,359.0926360992401,0.46754201680672264,0.13015573383671564,0.18975493663199228,127272.13718820845,2140.4974489795695,129412.63463718802,187,0,38.857142857142854,34,1,21,38.67955600125843,0.5968137254901961,47.73809523809523,1009.0476190476178,29.677871148459346,0
784,4,1,1,35,0.027777777777777776,0.027777777777777776,0.9722222222222222,36,1400,1200,200,0.8571428571428571,16,12,4,351.44976727467014,0.46798941798941796,0.13329006973074775,0.18758309094391304,127676.20991941003,1774.3548525377073,129450.56477194774,188,0,38.75,35,1,19,38.45816155138188,0.5988095238095238,47.337962962962955,1010.6481481481472,28.87566137566135,0
785,4,0,1,34,0.0,0.02857142857142857,0.9714285714285714,35,550,300,250,0.5454545454545454,8,3,5,360.0492484372237,0.46736694677871143,0.12507068803016042,0.19196595607632877,127632.76643990932,2190.8163265306107,129823.58276643993,189,1,39.42857142857143,34,1,19,38.28542255733585,0.6004901960784313,47.38095238095238,1010.4761904761906,29.719887955182077,0
786,4,1,1,34,0.02857142857142857,0.02857142857142857,0.9714285714285714,35,1050,500,550,0.47619047619047616,16,5,11,410.01836230459486,0.4655462184873949,0.2384032889997718,0.20071398578559052,124113.09840265755,3196.890867253753,127309.9892699113,190,0,39.65714285714286,33,2,19,40.67445066207518,0.5666035353535354,50.88848039215686,996.4460784313718,30.19533571004157,15
787,4,1,1,34,0.02857142857142857,0.02857142857142857,0.9714285714285714,35,1550,1300,250,0.8387096774193549,18,13,5,408.66573826640075,0.4649159663865546,0.24423488168273466,0.2028395716730307,124693.81517925786,3191.6180074971003,127885.43318675496,191,0,39.91428571428571,33,2,15,40.10224948875254,0.5726010101010102,50.3063725490196,998.7745098039206,30.265894236482442,0
788,4,3,1,36,0.08108108108108109,0.02702702702702703,0.972972972972973,37,950,400,550,0.42105263157894735,15,4,11,384.8256850973704,0.4693756256256256,0.23640299044291457,0.19463299073193924,125476.6439909297,2257.702554060844,127734.34654499055,192,0,38.351351351351354,34,3,14,39.88484236375159,0.5784313725490196,49.523809523809526,1001.9047619047619,29.46778711484594,0
789,4,3,1,38,0.07692307692307693,0.02564102564102564,0.9743589743589743,39,1200,900,300,0.75,15,9,6,368.969398373293,0.46851102114260007,0.24984048209854648,0.18973070959005833,126160.0865912209,1511.1213029450512,127671.20789416594,193,0,37.30769230769231,35,4,17,39.57565284178188,0.5833333333333333,48.842592592592595,1004.62962962963,28.703703703703713,0
790,4,2,2,38,0.05,0.05,0.95,40,1050,700,350,0.6666666666666666,14,7,7,389.966031518296,0.46940438034188037,0.2975182863113899,0.1913833293143638,124219.97070312501,1959.5543713563115,126179.52507448132,194,0,36.425,35,5,15,41.06256530825496,0.5633928571428571,50.78125,996.8750000000001,28.48214285714286,15
791,4,5,3,40,0.11627906976744186,0.06976744186046512,0.9302325581395349,43,900,600,300,0.6666666666666666,12,6,6,366.727169556449,0.4752445551864157,0.3004661351537221,0.18457657431369262,125274.27309364441,590.7373242247845,125865.0104178692,195,0,31.767441860465116,37,6,17,40.54764512595837,0.5703828828828829,49.725877192982466,1001.096491228072,27.056661925083027,0
792,4,3,2,41,0.06976744186046512,0.046511627906976744,0.9534883720930233,43,1050,800,250,0.7619047619047619,13,8,5,367.7296243481376,0.47632890365448505,0.32145109768255664,0.1868066491688537,125658.76038781148,641.6897506924972,126300.45013850398,196,0,32.651162790697676,37,6,20,40.124671916010485,0.5743243243243243,49.34210526315788,1002.6315789473672,27.098150782361277,0
793,4,1,0,42,0.023809523809523808,0.0,1.0,42,1450,1000,450,0.6896551724137931,19,10,9,373.31137059656055,0.4754887727448703,0.3056253871097021,0.1902744139046201,125796.22005088096,992.2318646121762,126788.45191549313,197,0,33.333333333333336,37,5,21,39.842582978103216,0.5757319819819819,49.205043859649116,1003.1798245614029,27.112968231389267,0
794,4,4,1,45,0.08695652173913043,0.021739130434782608,0.9782608695652174,46,1600,1200,400,0.75,20,12,8,379.02861070557503,0.47718397745571656,0.2214162524094545,0.1914959003446883,125432.2836625856,956.3885247536481,126388.67218733925,198,0,31.347826086956523,40,6,18,40.07600351695918,0.5669270833333333,49.56808943089433,1001.7276422764269,25.043191056910672,16
795,4,2,1,46,0.0425531914893617,0.02127659574468085,0.9787234042553191,47,1450,1000,450,0.6896551724137931,19,10,9,373.1940803406454,0.4778946962688868,0.2439867746901887,0.19066824831949392,125894.45153061264,-3.3871882085795164,125891.06434240406,199,0,31.617021276595743,41,6,20,39.74396994859629,0.5701219512195121,49.107142857142875,1003.5714285714319,24.477351916376385,0
796,4,4,4,46,0.08,0.08,0.92,50,1450,1100,350,0.7586206896551724,18,11,7,346.5237123624646,0.4789030612244898,0.1841135371179039,0.17792361015920252,126098.8958140966,-565.5068612163243,125533.38895288027,200,0,30.2,37,13,20,40.20241994177583,0.5788288288288288,48.90350877192982,1004.3859649122803,27.14556661925082,16
797,4,2,6,42,0.041666666666666664,0.125,0.875,48,1400,800,600,0.5714285714285714,20,8,12,330.9012652763752,0.4771073433806146,0.22126955475330945,0.17179868337226586,126553.945001461,-1224.6278946599498,125329.31710680106,201,0,32.083333333333336,38,10,14,40.127061654986896,0.5816885964912281,48.4508547008547,1006.1965811965811,26.478857399910027,0
798,4,2,2,42,0.045454545454545456,0.045454545454545456,0.9545454545454546,44,1150,600,550,0.5217391304347826,17,6,11,372.84500851362736,0.4754668780831572,0.12461337140138018,0.1872243214794234,125178.63520408147,958.6002922426733,126137.23549632414,202,0,33.88636363636363,34,10,18,40.4936454120073,0.5753676470588236,49.82142857142856,1000.7142857142843,29.432773109243655,16
799,4,2,2,42,0.045454545454545456,0.045454545454545456,0.9545454545454546,44,1700,1200,500,0.7058823529411765,22,12,10,360.3807692166822,0.47378215292459475,0.14663746524681298,0.1833646133448356,125724.42618580669,261.7330836333946,125986.15926944009,203,0,34.59090909090909,35,9,17,40.24103192921716,0.5788690476190477,49.27662037037037,1002.893518518518,28.654100529100514,0
800,4,2,1,43,0.045454545454545456,0.022727272727272728,0.9772727272727273,44,1450,1000,450,0.6896551724137931,19,10,9,361.4159744973701,0.4740133897110641,0.16106036162500792,0.1855838950703062,126101.95500042854,315.05219050066944,126417.00719092922,204,0,35.34090909090909,35,9,20,39.825324575555044,0.5827380952380952,48.900462962962955,1004.3981481481471,28.697089947089918,0
801,4,0,3,40,0.0,0.06976744186046512,0.9302325581395349,43,2050,1700,350,0.8292682926829268,24,17,7,367.891755483369,0.47196843853820597,0.16209181829136066,0.18984788451414475,126305.47417534703,693.3485243055354,126998.82269965256,205,1,36.97674418604651,35,8,17,39.45272020725388,0.5848214285714286,48.69791666666666,1005.2083333333318,28.720238095238052,0
802,4,2,1,41,0.047619047619047616,0.023809523809523808,0.9761904761904762,42,1100,600,500,0.5454545454545454,16,6,10,359.00783982932194,0.47118176538908246,0.15685757928967936,0.18794869180532153,126893.37722435276,711.1434491924363,127604.5206735452,206,0,36.333333333333336,36,6,19,39.07082448492978,0.5888310185185186,48.11373873873874,1007.5450450450453,27.98736236236237,0
803,4,1,3,39,0.023809523809523808,0.07142857142857142,0.9285714285714286,42,1800,1500,300,0.8333333333333334,21,15,6,350.43058035496745,0.47011711188540456,0.05740548040235893,0.17631611922571933,125260.55230034726,420.7829477492738,125681.33524809654,207,0,37.023809523809526,35,7,14,40.96969302809573,0.5741071428571429,49.739583333333336,1001.0416666666671,28.60119047619049,16
804,4,2,7,34,0.04878048780487805,0.17073170731707318,0.8292682926829268,41,1400,900,500,0.6428571428571429,19,9,10,353.861409041926,0.47017276422764226,0.08582932622675399,0.17948873880319385,125595.94671201812,688.7117346938777,126284.658446712,208,0,38.51219512195122,34,7,14,40.53716349960412,0.579656862745098,49.404761904761905,1002.3809523809522,29.48179271708683,0
805,4,6,3,37,0.15,0.075,0.925,40,1050,600,450,0.5714285714285714,15,6,9,349.3989212177492,0.472409188034188,0.11434746565608744,0.18033768280945403,126312.95351473897,826.7219387754797,127139.67545351444,209,0,37.5,34,6,16,39.909748539396816,0.5870098039215687,48.690476190476176,1005.2380952380931,29.56582633053215,0
806,4,2,0,39,0.05128205128205128,0.0,1.0,39,1250,800,450,0.64,17,8,9,350.9822203170905,0.47236279802069275,0.1420174337136726,0.18248485181800014,126612.3086734694,1087.7338435374213,127700.04251700682,210,0,38.94871794871795,34,5,18,39.56189377809322,0.5900735294117647,48.392857142857146,1006.4285714285714,29.600840336134453,0
807,4,2,4,37,0.04878048780487805,0.0975609756097561,0.9024390243902439,41,1000,600,400,0.6,14,6,8,338.25793307036014,0.47271341463414634,0.15912858157707777,0.17882768957188816,127290.8059030317,411.4249807239996,127702.23088375569,211,0,38.0,36,5,20,39.1860097459361,0.5928819444444444,47.71959459459461,1009.121621621624,28.03115615615622,0
808,4,4,1,40,0.0975609756097561,0.024390243902439025,0.975609756097561,41,1400,1200,200,0.8571428571428571,16,12,4,336.1935169424712,0.47271341463414634,0.18411838469597686,0.18090029600269752,128002.04554216389,406.69157333009684,128408.73711549399,212,0,37.73170731707317,36,5,22,38.51059982194526,0.6001157407407407,47.01576576576577,1011.9369369369377,28.10935935935938,0
809,4,0,2,38,0.0,0.05,0.95,40,1500,1300,200,0.8666666666666667,17,13,4,342.0450536048488,0.4720352564102564,0.18347632120796153,0.1838965472702084,127968.81028163576,754.2197145061656,128723.02999614192,213,1,39.65,35,5,22,38.396533973919006,0.6017857142857144,47.04861111111111,1011.8055555555552,28.908730158730148,0
810,4,3,0,41,0.07317073170731707,0.0,1.0,41,1050,800,250,0.7619047619047619,13,8,5,322.5857443856915,0.47197662601626017,0.18900791925261262,0.17676323648842943,128728.04763244456,105.16661376577312,128833.21424621034,214,0,38.707317073170735,37,4,19,38.11532054745183,0.6055743243243243,46.29934210526316,1014.8026315789471,27.427098150782353,0
811,4,1,2,40,0.023809523809523808,0.047619047619047616,0.9523809523809523,42,1100,700,400,0.6363636363636364,15,7,8,359.2116483690027,0.4723432055749129,0.08811940888133418,0.18456185702234645,126126.42982696612,868.5008848876686,126994.9307118538,215,0,38.76190476190476,37,5,17,39.855433358803595,0.5791103603603603,48.876096491228076,1004.4956140350888,27.148530109056455,14
812,4,0,2,38,0.0,0.05,0.95,40,1350,900,450,0.6666666666666666,18,9,9,362.62663632543575,0.4717280982905983,-0.04202103596471407,0.17675549715487884,123932.46920907385,1137.720972761368,125070.19018183522,216,1,37.4,36,4,17,42.04294842795747,0.5584490740740741,51.06981981981981,995.72072072072,27.658908908908888,15
813,4,6,8,36,0.13636363636363635,0.18181818181818182,0.8181818181818181,44,1200,900,300,0.75,15,9,6,332.8517758314563,0.4760174418604651,0.0328142731055352,0.16782246879334248,125347.4633487653,-450.9936174913784,124896.46973127393,217,0,34.61363636363637,38,6,15,41.3199260286639,0.5693530701754386,49.65277777777777,1001.3888888888879,26.352339181286524,0
814,4,3,2,37,0.07692307692307693,0.05128205128205128,0.9487179487179487,39,1150,900,250,0.782608695652174,14,9,5,366.83557862447947,0.476102114260009,0.06742547016922318,0.1839585788630374,125122.57905613212,1379.88273740867,126502.46179354079,218,0,39.07692307692308,33,6,19,40.7020659807284,0.577020202020202,49.87745098039215,1000.4901960784302,30.3178847296494,0
815,4,1,2,36,0.02631578947368421,0.05263157894736842,0.9473684210526316,38,1650,1100,550,0.6666666666666666,22,11,11,376.6381739170389,0.4752104077761972,0.07173491663822484,0.19013365011883604,125398.60157451448,1845.980061755079,127244.58163626956,219,0,38.81578947368421,33,5,20,40.1707604306864,0.5798611111111112,49.6017156862745,1001.593137254901,30.351307189542453,0
816,4,6,4,38,0.14285714285714285,0.09523809523809523,0.9047619047619048,42,1350,1100,250,0.8148148148148148,16,11,5,328.26142075460274,0.4755613627564847,0.098996430969293,0.17212284502379996,126957.38965821065,-63.301615691730206,126894.08804251892,220,0,34.595238095238095,38,4,21,39.779674193434424,0.5858004385964912,48.05021367521366,1007.7991452991427,26.521030139451124,0
817,4,2,3,37,0.05,0.075,0.925,40,1700,1300,400,0.7647058823529411,21,13,8,333.19116812707915,0.47541399572649573,0.10670595464193955,0.17492047776571748,127006.86486740103,463.5131330654782,127470.37800046652,221,0,37.075,36,4,23,39.604746210851665,0.5899884259259259,48.00112612612612,1007.9954954954942,27.999874874874838,0
818,4,2,2,37,0.05128205128205128,0.05128205128205128,0.9487179487179487,39,1200,900,300,0.75,15,9,6,330.55080215047894,0.4738529014844804,0.09914949352825775,0.1753679581113133,127432.89531085137,624.6091530719826,128057.50446392335,222,0,36.56410256410256,36,3,18,39.235026767789435,0.5943287037037037,47.578828828828826,1009.6846846846845,28.04679679679679,0
819,4,1,1,37,0.02631578947368421,0.02631578947368421,0.9736842105263158,38,1050,800,250,0.7619047619047619,13,8,5,331.0537910216641,0.47288406827880514,0.09456021797708125,0.1765687629450305,127646.96830257631,851.6025537980172,128498.57085637432,223,0,37.89473684210526,35,3,21,39.003383537586394,0.5985119047619047,47.36689814814815,1010.5324074074075,28.8723544973545,0
820,4,0,0,37,0.0,0.0,1.0,37,1650,1300,350,0.7878787878787878,20,13,7,341.9597938312997,0.4713463463463463,0.10402651443999078,0.18245736579722835,127662.8419075963,1331.1118197278875,128993.95372732419,224,1,39.86486486486486,34,3,22,38.711616994541956,0.600796568627451,47.351190476190474,1010.5952380952376,29.723389355742285,0
821,4,2,2,37,0.05128205128205128,0.05128205128205128,0.9487179487179487,39,1400,900,500,0.6428571428571429,19,9,10,339.11618058875735,0.47205353126405764,0.07395634668361906,0.17840459935321598,127092.01388888898,1190.9403344671296,128282.95422335611,225,0,38.76923076923077,36,3,19,39.36811294765838,0.5908564814814814,47.91666666666667,1008.3333333333342,28.00925925925928,16
822,4,0,2,35,0.0,0.05405405405405406,0.9459459459459459,37,950,500,450,0.5263157894736842,14,5,9,342.53124786558277,0.46962587587587584,0.09247263792718319,0.180201221703198,127092.01388888898,1306.5972222222317,128398.61111111121,226,1,41.486486486486484,36,1,20,39.28202479338841,0.5908564814814814,47.91666666666667,1008.3333333333342,28.00925925925928,0
823,4,2,3,34,0.05405405405405406,0.08108108108108109,0.9189189189189189,37,950,600,350,0.631578947368421,13,6,7,335.87240131302065,0.47128378378378377,0.08943714356558385,0.17771889195688972,127325.53155006868,1153.0264060356765,128478.55795610436,227,0,40.62162162162162,35,2,15,39.21062691131499,0.5952380952380952,47.68518518518519,1009.25925925926,28.835978835978857,0
824,4,1,0,35,0.02857142857142857,0.0,1.0,35,1150,900,250,0.782608695652174,14,9,5,353.20554536300335,0.46960784313725495,0.1049204227918843,0.18624182215777596,127184.70848051237,1984.4688641387988,129169.17734465118,228,0,43.65714285714286,33,2,21,38.91778540477058,0.5981691919191919,47.82475490196079,1008.7009803921574,30.56669637551992,0
825,4,1,1,35,0.027777777777777776,0.027777777777777776,0.9722222222222222,36,950,600,350,0.631578947368421,13,6,7,345.2277564241239,0.4701388888888889,0.11476134354743683,0.1836525086682566,127542.56129535158,1606.246456916114,129148.80775226769,229,0,43.416666666666664,34,2,18,38.752209781968176,0.5995710784313726,47.4702380952381,1010.1190476190485,29.709383753501427,0
826,4,3,3,35,0.07894736842105263,0.07894736842105263,0.9210526315789473,38,1350,900,450,0.6666666666666666,18,9,9,327.6944788993871,0.46845365101944053,0.1226697526225613,0.17786516818128537,128349.69142500429,813.3142832428731,129163.00570824716,230,0,41.8421052631579,35,3,22,38.371049876261175,0.6056547619047619,46.6724537037037,1013.3101851851852,28.95171957671958,0
827,4,1,2,34,0.027777777777777776,0.05555555555555555,0.9444444444444444,36,1150,700,450,0.6086956521739131,16,7,9,339.78552866731565,0.46625330687830685,0.10949286143084569,0.18473397133291988,128415.8801020408,1526.7715419501083,129942.6516439909,231,0,42.361111111111114,34,2,17,37.99722026466211,0.6084558823529411,46.607142857142854,1013.5714285714284,29.810924369747895,0
828,4,1,1,34,0.02857142857142857,0.02857142857142857,0.9714285714285714,35,1050,800,250,0.7619047619047619,13,8,5,414.41319632233655,0.465266106442577,0.07778832463217866,0.21142096964919196,125834.72222222219,3626.849489795914,129461.5717120181,232,0,43.885714285714286,34,1,18,38.771802325581405,0.5821078431372548,49.166666666666664,1003.333333333333,29.50980392156862,16
829,4,0,3,31,0.0,0.08823529411764706,0.9117647058823529,34,1500,1000,500,0.6666666666666666,20,10,10,419.6898746349295,0.46468360071301246,0.08799109387344695,0.21456055388639655,125920.80720155708,3769.5375576701217,129690.3447592272,233,1,46.14705882352941,33,1,18,38.55006105006104,0.5852272727272727,49.080882352941174,1003.6764705882351,30.414438502673793,0
830,4,3,2,32,0.08823529411764706,0.058823529411764705,0.9411764705882353,34,850,600,250,0.7058823529411765,11,6,5,412.50954737205393,0.46893568033273914,0.06958118367990629,0.1933684790284441,122268.87124081735,3380.4684992819116,125649.33974009925,234,0,42.64705882352941,32,2,16,42.54675730882164,0.5498046875,52.746212121212125,989.0151515151522,30.906723484848506,16
831,4,4,4,32,0.1111111111111111,0.1111111111111111,0.8888888888888888,36,1450,1100,350,0.7586206896551724,18,11,7,385.14239437471605,0.4704861111111111,0.10929029078363728,0.18650451508026217,123655.59520376773,2328.5176692213035,125984.11287298903,235,0,40.44444444444444,33,3,15,41.77139806144242,0.5618686868686869,51.34803921568627,994.6078431372545,30.139631610219833,0
832,4,5,5,32,0.13513513513513514,0.13513513513513514,0.8648648648648649,37,850,600,250,0.7058823529411765,11,6,5,362.9836207275368,0.47184684684684686,0.1180075986323752,0.17981946999656534,124613.39462868475,1646.5242346938726,126259.91886337863,236,0,39.054054054054056,34,3,14,41.326358252851634,0.569546568627451,50.38690476190476,998.4523809523805,29.366246498599427,0
833,4,5,5,32,0.13513513513513514,0.13513513513513514,0.8648648648648649,37,800,500,300,0.625,11,5,6,361.24320794874217,0.4773836336336336,0.12365966728542599,0.1807506962464196,125029.76367630396,1633.2305839002404,126662.9942602042,237,0,39.0,34,3,17,40.93808276792446,0.5738357843137255,49.9702380952381,1000.1190476190485,29.4152661064426,0
834,4,2,1,33,0.058823529411764705,0.029411764705882353,0.9705882352941176,34,1200,1000,200,0.8333333333333334,14,10,4,403.6477853065025,0.4772727272727273,0.06897166086115525,0.19172677248058093,122834.21828443368,3116.352034073413,125950.57031850709,238,0,40.88235294117647,33,1,19,42.17185375200891,0.5533459595959596,52.175245098039206,991.2990196078415,30.039364230540652,16
835,4,7,6,34,0.175,0.15,0.85,40,800,600,200,0.75,10,6,4,348.10692073343495,0.4797542735042735,0.07218162839248454,0.17190022168176805,124479.70920138858,676.7972354382554,125156.50643682684,239,0,35.55,35,5,13,41.836290883785644,0.5660714285714286,50.520833333333314,997.9166666666641,28.511904761904688,0
836,4,4,4,34,0.10526315789473684,0.10526315789473684,0.8947368421052632,38,900,700,200,0.7777777777777778,11,7,4,367.5296330550801,0.4781294452347084,0.09688319743626184,0.1818892096516819,124571.44637879662,1556.739595347945,126128.18597414457,240,0,38.23684210526316,33,5,16,41.25644488092315,0.5713383838383839,50.42892156862745,998.2843137254903,30.251039809863343,0
837,4,5,3,36,0.1282051282051282,0.07692307692307693,0.9230769230769231,39,1050,700,350,0.6666666666666666,14,7,7,342.7152770422405,0.47922289698605486,0.1073036636807434,0.17327940642976836,125463.39163237314,799.644204389577,126263.03583676272,241,0,37.48717948717949,35,4,16,40.953288662969804,0.5761904761904761,49.53703703703704,1001.8518518518521,28.62433862433863,0
838,4,3,5,34,0.07692307692307693,0.1282051282051282,0.8717948717948718,39,1050,800,250,0.7619047619047619,13,8,5,393.3754661157888,0.4771704903283851,0.2025533741014911,0.19187089061566062,123960.50347222242,2248.868312757226,126209.37178497965,242,0,37.82051282051282,34,5,18,41.248256624825665,0.5628063725490196,51.04166666666668,995.8333333333351,29.28921568627456,16
839,4,7,1,40,0.17073170731707318,0.024390243902439025,0.975609756097561,41,1100,1000,100,0.9090909090909091,12,10,2,349.23604099397613,0.4791920731707317,0.20762715108578322,0.17002795943858523,123882.71620008674,561.3688151041621,124444.0850151909,243,0,35.78048780487805,39,2,21,42.42799780265776,0.5526175213675213,51.119791666666664,995.5208333333328,25.5261752136752,16
840,4,6,5,41,0.13043478260869565,0.10869565217391304,0.8913043478260869,46,1400,1000,400,0.7142857142857143,18,10,8,356.1855372536364,0.48239734299516907,0.25138335573166026,0.17474812299907228,124206.30777017937,398.0763912934862,124604.38416147286,244,0,32.69565217391305,37,9,16,41.918632897004365,0.5594031531531531,50.794956140350884,996.8201754385972,26.94108582266479,16
841,4,6,1,46,0.1276595744680851,0.02127659574468085,0.9787234042553191,47,1400,1000,400,0.7142857142857143,18,10,8,322.88570468692086,0.4830596669750231,0.23701988196338997,0.16039152247126784,124727.33139841554,-1246.9947380242488,123480.33666039129,245,0,30.95744680851064,41,6,14,42.209483728937016,0.558180894308943,50.27281746031745,998.9087301587276,24.363627564847015,16
842,4,2,3,45,0.041666666666666664,0.0625,0.9375,48,1050,800,250,0.7619047619047619,13,8,5,355.7072963980226,0.48383939125295505,0.2996016093404861,0.16799350555668163,122589.85595703125,-619.7670188590505,121970.0889381722,246,0,31.270833333333332,39,9,15,43.61534045089585,0.5392628205128205,52.421875,990.3125,25.392628205128204,16
843,4,3,3,45,0.0625,0.0625,0.9375,48,1450,1000,450,0.6896551724137931,19,10,9,355.03221815242813,0.48530769799054374,0.32439075343633794,0.1705026962163973,123303.55944089184,-844.6527571220697,122458.90668376978,247,0,31.979166666666668,40,8,14,42.88686517275487,0.5450520833333333,51.70223577235773,993.1910569105705,24.82977642276426,0
844,4,3,5,43,0.0625,0.10416666666666667,0.8958333333333334,48,1250,700,550,0.56,18,7,11,353.4601985259364,0.48716385933806144,0.3234832635983267,0.17240201519938528,123960.50347222216,-829.9975419723766,123130.50593024978,248,0,32.1875,36,12,18,42.24198047419807,0.5587384259259259,51.041666666666664,995.8333333333328,27.662037037037024,0
845,4,4,6,41,0.0851063829787234,0.1276595744680851,0.8723404255319149,47,1450,1000,450,0.6896551724137931,19,10,9,343.59107021976536,0.48886062288004933,0.3330212160464334,0.17169083493612308,124974.59478691554,-811.9690453764609,124162.62574153907,249,0,31.638297872340427,40,7,19,41.43650269336314,0.5622395833333333,50.025406504065025,999.8983739837372,24.99745934959343,0
846,4,4,3,42,0.08888888888888889,0.06666666666666667,0.9333333333333333,45,800,500,300,0.625,11,5,6,340.80413561398507,0.48731060606060606,0.3189364046781127,0.17227603124810476,125454.47216971681,-448.91682869637,125005.55534102044,250,0,32.86666666666667,38,7,16,41.01036223383457,0.5704495614035088,49.545940170940185,1001.8162393162414,26.36358524516425,0
847,4,1,2,41,0.023255813953488372,0.046511627906976744,0.9534883720930233,43,1400,1100,300,0.7857142857142857,17,11,6,329.92737728037895,0.4862264673311185,0.20449876362441066,0.1627676585536956,124439.73177596966,-358.8683203667281,124080.86345560293,251,0,35.116279069767444,38,5,17,42.331218545882855,0.560032894736842,50.56089743589743,997.7564102564095,26.256747638326566,16
848,4,5,3,43,0.10869565217391304,0.06521739130434782,0.9347826086956522,46,1650,1200,450,0.7272727272727273,21,12,9,311.78159218411724,0.48533615136876,0.24475034380619887,0.15820028936749692,125610.49970255829,-1366.1332578043514,124244.36644475393,252,0,33.608695652173914,40,6,16,41.57669302514192,0.56875,49.39024390243904,1002.4390243902462,25.060975609756156,0
849,4,1,2,42,0.022727272727272728,0.045454545454545456,0.9545454545454546,44,1900,1300,600,0.6842105263157895,25,13,12,325.9577765558076,0.4852118569415081,0.24372022310880448,0.16594856867168783,125748.98184673833,-602.2282946161056,125146.75355212223,253,0,35.72727272727273,38,6,20,41.078815154097434,0.5734649122807017,49.25213675213676,1002.9914529914536,26.394511920827725,0
850,4,4,2,44,0.08695652173913043,0.043478260869565216,0.9565217391304348,46,1750,1300,450,0.7428571428571429,22,13,9,317.1067838533601,0.48403784219001605,0.25929216741916594,0.16546662038983367,126759.19514054118,-1160.4145792329102,125598.78056130827,254,0,33.17391304347826,40,6,17,40.2636912571063,0.58046875,48.246951219512184,1007.01219512195,25.17530487804875,0
851,4,1,3,42,0.022222222222222223,0.06666666666666667,0.9333333333333333,45,1500,900,600,0.6,21,9,12,320.8730939539548,0.4833543771043771,0.2731222072894779,0.16804577356884676,126908.26958550324,-855.7101779514123,126052.55940755183,255,0,34.75555555555555,39,6,19,40.01613167235261,0.5836004273504274,48.09895833333332,1007.6041666666647,25.836004273504223,0
852,4,0,3,39,0.0,0.07142857142857142,0.9285714285714286,42,1250,600,650,0.48,19,6,13,354.94279550363325,0.48233643050716224,0.22812122543098723,0.1759642917066732,124643.89433527614,448.423380571414,125092.31771584756,256,1,35.642857142857146,37,5,17,41.4954384905384,0.5639076576576576,50.3563596491228,998.5745614035079,26.988501659554267,16
853,4,6,4,41,0.13333333333333333,0.08888888888888889,0.9111111111111111,45,1350,1200,150,0.8888888888888888,15,12,3,346.47916414677536,0.48177609427609425,0.32319615762471354,0.17801994519061165,126126.42982696585,-243.82021391199322,125882.60961305385,257,0,33.977777777777774,37,8,18,40.1751764727286,0.5791103603603603,48.87609649122806,1004.4956140350865,27.14853010905639,0
854,4,3,4,40,0.06818181818181818,0.09090909090909091,0.9090909090909091,44,1700,1200,500,0.7058823529411765,22,12,10,349.814495090393,0.4813689217758985,0.35304878652553184,0.18216942027367547,126677.7412881848,62.74202158355695,126740.48330976836,258,0,35.11363636363637,37,7,17,39.52399429982209,0.584740990990991,48.32785087719298,1006.6885964912278,27.20779990516832,0
855,4,1,1,40,0.024390243902439025,0.024390243902439025,0.975609756097561,41,1500,1200,300,0.8,18,12,6,363.7626001894913,0.48074186991869916,0.3426516351009552,0.18954653788062412,126702.18431122456,1017.9032029478506,127720.08751417241,259,0,36.19512195121951,34,7,18,39.14779669701627,0.5909926470588236,48.30357142857143,1006.7857142857149,29.611344537815143,0
856,4,1,1,40,0.024390243902439025,0.024390243902439025,0.975609756097561,41,1200,800,400,0.6666666666666666,16,8,8,335.08515721885203,0.48041158536585366,0.19355286331856747,0.16977152644014978,125548.84676054143,522.9777627809809,126071.82452332242,260,0,36.78048780487805,37,4,16,41.056254558716276,0.5731981981981982,49.4517543859649,1002.1929824561381,27.086296823138866,16
857,4,2,1,41,0.047619047619047616,0.023809523809523808,0.9761904761904762,42,1150,800,350,0.6956521739130435,15,8,7,329.7119539952823,0.48034020518776616,0.21389053546729864,0.16906506577204908,126043.83680555562,-87.39419821483105,125956.4426073408,261,0,36.80952380952381,37,5,18,40.68118948824342,0.5782657657657657,48.958333333333336,1004.1666666666672,27.139639639639654,0
858,4,5,5,41,0.10869565217391304,0.10869565217391304,0.8913043478260869,46,1500,800,700,0.5333333333333333,22,8,14,296.42783962844106,0.48079710144927534,0.2028386633129724,0.1559468199784406,127092.01388888877,-1660.937500000005,125431.07638888877,262,0,34.23913043478261,40,6,18,40.44421487603309,0.5838541666666667,47.916666666666664,1008.3333333333323,25.208333333333307,0
859,4,2,1,42,0.046511627906976744,0.023255813953488372,0.9767441860465116,43,1250,700,550,0.56,18,7,11,317.9831987964541,0.4790743816906608,0.2290572643160791,0.16642497287658595,126882.03125000026,-530.7291666666383,126351.30208333362,263,0,37.44186046511628,39,4,20,40.115798180314314,0.5833333333333333,48.125000000000014,1007.500000000002,25.833333333333385,0
860,4,2,5,39,0.045454545454545456,0.11363636363636363,0.8863636363636364,44,1100,700,400,0.6363636363636364,15,7,8,349.53984709127036,0.4806752114164905,0.18150082004429113,0.17172435852841536,124264.29709704871,-47.48392986979064,124216.81316717892,264,0,37.22727272727273,40,4,16,42.024046138687844,0.5549479166666667,50.73678861788618,997.0528455284552,24.92632113821138,16
861,4,4,2,41,0.09302325581395349,0.046511627906976744,0.9534883720930233,43,1250,700,550,0.56,18,7,11,355.2244198098093,0.48258121077888516,0.22930005579882118,0.17717988809580573,124898.39463943435,273.39195419394787,125171.7865936283,265,0,37.651162790697676,40,3,20,41.22462552528129,0.5614583333333334,50.10162601626017,999.5934959349606,24.989837398374014,0
862,4,3,2,42,0.06818181818181818,0.045454545454545456,0.9545454545454546,44,1400,800,600,0.5714285714285714,20,8,12,342.620815660217,0.4834830866807611,0.2436676773199462,0.1741671683831397,125686.2463089604,-187.28990891571834,125498.95640004468,266,0,36.81818181818182,37,7,19,40.72569254601785,0.5746058558558558,49.31469298245614,1002.741228070175,27.101114272166893,0
863,4,4,4,42,0.08695652173913043,0.08695652173913043,0.9130434782608696,46,1650,1100,550,0.6666666666666666,22,11,11,317.91341294879714,0.4855776972624799,0.2316523358935243,0.16542796496091688,126646.00830078126,-1146.9990841532976,125499.00921662796,267,0,32.93478260869565,39,7,17,40.35938200696816,0.5809294871794872,48.359375,1006.5625000000001,25.809294871794876,0
864,4,4,4,42,0.08695652173913043,0.08695652173913043,0.9130434782608696,46,1050,400,650,0.38095238095238093,17,4,13,346.6083431875657,0.4837157809983897,0.23773595983912132,0.1740091377155202,125168.97598612124,-190.76706761132135,124978.20891850992,268,0,32.23913043478261,36,10,20,41.160017630729975,0.5711805555555556,49.83108108108108,1000.6756756756756,27.796546546546544,15
865,4,3,4,41,0.06666666666666667,0.08888888888888889,0.9111111111111111,45,1300,600,700,0.46153846153846156,20,6,14,346.03018699979316,0.4823232323232323,0.2543551862111426,0.17593929226327487,125695.40895061701,-301.1188271605215,125394.29012345649,269,0,32.82222222222222,38,7,18,40.63077100646354,0.5729166666666667,49.30555555555554,1002.7777777777756,26.38888888888883,0
866,4,4,5,40,0.08888888888888889,0.1111111111111111,0.8888888888888888,45,1150,900,250,0.782608695652174,14,9,5,332.99180266827653,0.48398569023569027,0.26006980401181345,0.17257195927191343,126480.04979263108,-574.2247781635931,125905.82501446748,270,0,32.82222222222222,35,10,18,40.15037107352434,0.5866071428571429,48.52430555555555,1005.9027777777769,28.74007936507934,0
867,4,6,2,44,0.13043478260869565,0.043478260869565216,0.9565217391304348,46,1450,900,550,0.6206896551724138,20,9,11,326.05783403096507,0.48299114331723025,0.27007678344350916,0.17201567003824422,127205.590303141,-904.7241498254973,126300.8661533155,271,0,32.5,36,10,24,39.58100766540149,0.5920138888888888,47.804054054054056,1008.783783783784,28.02177177177178,0
868,4,0,2,42,0.0,0.045454545454545456,0.9545454545454546,44,1450,1100,350,0.7586206896551724,18,11,7,328.4800966174313,0.4818424066243834,0.24235387935078334,0.17393290361873842,127354.7363281251,-433.30078124998664,126921.43554687512,272,1,33.75,35,9,16,39.36726006191952,0.5955357142857143,47.65625000000001,1009.3750000000008,28.839285714285737,0
869,4,0,4,38,0.0,0.09523809523809523,0.9047619047619048,42,1450,800,650,0.5517241379310345,21,8,13,335.7233446066217,0.4817194154084398,0.22037848158131212,0.1779333726415095,127392.2902494331,153.71315192743924,127546.00340136055,273,2,35.38095238095238,34,8,17,39.146029874213845,0.5980392156862745,47.61904761904762,1009.5238095238095,29.69187675070028,0
870,4,1,1,38,0.02564102564102564,0.02564102564102564,0.9743589743589743,39,850,700,150,0.8235294117647058,10,7,3,360.6793561634952,0.4817251461988304,0.2353372010099648,0.18915523133357537,126964.73095857557,1358.7114835220766,128323.44244209764,274,0,38.717948717948715,32,7,25,38.955357888582654,0.5983072916666667,48.04292929292929,1007.8282828282821,31.494633838383816,0
871,4,1,2,37,0.02564102564102564,0.05128205128205128,0.9487179487179487,39,1000,700,300,0.7,13,7,6,355.03906249999983,0.479251012145749,0.2413141025641028,0.1888505651595747,127538.00632588532,1256.2586088154535,128794.26493470077,275,0,39.256410256410255,32,7,21,38.50911458333333,0.6041666666666667,47.47474747474749,1010.1010101010118,31.565656565656617,0
872,4,0,0,37,0.0,0.0,1.0,37,1250,1100,150,0.88,14,11,3,371.7028467042058,0.47919794794794796,0.23943363035603182,0.1973571369108622,127464.99098522961,2075.820000867165,129540.81098609678,276,1,41.486486486486484,30,7,22,38.16329473357292,0.6086805555555556,47.547043010752695,1009.8118279569901,33.660394265233,0
873,4,0,1,36,0.0,0.02702702702702703,0.972972972972973,37,1700,1300,400,0.7647058823529411,21,13,8,372.7099413392639,0.4792917917917918,0.23963292723271468,0.19839149568738731,127566.80685628403,2109.083420048572,129675.8902763326,277,2,42.486486486486484,30,7,22,38.033306723434464,0.6097222222222223,47.44623655913979,1010.2150537634413,33.67383512544804,0
874,4,1,2,35,0.02702702702702703,0.05405405405405406,0.9459459459459459,37,750,400,350,0.5333333333333333,11,4,7,390.59513954233734,0.4782907907907908,0.2134992134992133,0.19799132935421954,125568.82747933903,2409.314738292035,127978.14221763106,278,0,42.83783783783784,32,5,14,39.64474678760394,0.583984375,49.431818181818194,1002.2727272727287,31.321022727272773,16
875,4,0,1,34,0.0,0.02857142857142857,0.9714285714285714,35,1500,1100,400,0.7333333333333333,19,11,8,390.16831487789636,0.47657563025210087,0.20252188102655388,0.19880004615207117,125782.4707031251,2815.2669270833476,128597.73763020844,279,1,45.17142857142857,31,4,15,39.43406022845275,0.5887096774193548,49.21875000000001,1003.1250000000008,32.358870967741964,0
876,4,5,4,35,0.1282051282051282,0.10256410256410256,0.8974358974358975,39,1150,700,450,0.6086956521739131,16,7,9,351.58453370266244,0.4789417453891138,0.18299533130090295,0.18403748441862158,126887.8617567944,1122.361941658091,128010.2236984525,280,0,41.17948717948718,35,4,17,39.26347405705534,0.5907738095238095,48.11921296296296,1007.523148148148,28.786375661375658,0
877,4,0,1,34,0.0,0.02857142857142857,0.9714285714285714,35,1000,600,400,0.6,14,6,8,386.35213375664193,0.47647058823529415,0.2134823973642317,0.19905645983536477,126240.03940158426,2754.6217176649343,128994.6611192492,281,1,46.57142857142857,31,4,17,39.05642653537184,0.5934139784946236,48.763020833333336,1004.9479166666672,32.417674731182814,0
878,4,2,2,34,0.05555555555555555,0.05555555555555555,0.9444444444444444,36,1300,1000,300,0.7692307692307693,16,10,6,367.1377692351178,0.47615740740740736,0.20309106098579766,0.19224143034752236,126901.11340679527,2118.038337924706,129019.15174471997,282,0,45.416666666666664,32,4,19,38.858082706766915,0.59765625,48.10606060606061,1007.575757575758,31.486742424242436,0
879,4,1,0,35,0.02857142857142857,0.0,1.0,35,1100,900,200,0.8181818181818182,13,9,4,365.3217056430914,0.4747198879551821,0.17600686744402294,0.19249272985996146,127155.67926742176,2290.5459264360834,129446.22519385784,283,0,42.25714285714286,32,3,20,38.64207769988314,0.6002604166666667,47.85353535353536,1008.5858585858591,31.518308080808097,0
880,4,2,0,37,0.05405405405405406,0.0,1.0,37,1150,900,250,0.782608695652174,14,9,5,346.2331254588828,0.4756318818818819,0.1662731721596804,0.1854290143535785,127813.27239229041,1450.6377551020619,129263.91014739247,284,0,40.91891891891892,34,3,20,38.449689977238855,0.602328431372549,47.20238095238096,1011.1904761904775,29.740896358543456,0
881,4,0,0,37,0.0,0.0,1.0,37,1200,700,500,0.5833333333333334,17,7,10,346.33910034602025,0.47528778778778774,0.1600635930047687,0.1863216679076695,127993.90589569192,1465.8588435374475,129459.76473922936,285,1,41.91891891891892,34,3,20,38.26225490196078,0.6041666666666667,47.02380952380954,1011.9047619047644,29.761904761904837,0
882,4,0,1,36,0.0,0.02702702702702703,0.972972972972973,37,900,700,200,0.7777777777777778,11,7,4,345.95565569389305,0.4751313813813814,0.15814402970366293,0.18639511943659606,128054.14540816362,1460.2111678004987,129514.35657596412,286,2,42.91891891891892,34,3,20,38.21037206931703,0.6047794117647058,46.96428571428574,1012.14285714286,29.768907563025294,0
883,4,4,3,37,0.1,0.075,0.925,40,950,600,350,0.631578947368421,13,6,7,369.12322995675834,0.47538728632478633,0.12113011777902472,0.1890139916751578,125987.30223043976,1414.7470398556175,127402.04927029538,287,0,39.425,36,4,17,39.750186950831946,0.5795717592592593,49.01463963963963,1003.9414414414402,27.88726226226223,16
884,4,4,3,38,0.0975609756097561,0.07317073170731707,0.926829268292683,41,750,700,50,0.9333333333333333,8,7,1,367.70833333333337,0.47553353658536585,0.1630081300813011,0.18385416666666657,124999.99999999987,1549.9695641587373,126549.9695641586,288,0,38.146341463414636,34,7,19,40.80729166666667,0.5735294117647058,49.99999999999999,999.999999999999,29.411764705882323,15
885,4,3,4,37,0.07317073170731707,0.0975609756097561,0.9024390243902439,41,1050,800,250,0.7619047619047619,13,8,5,356.18539825623895,0.4754573170731707,0.1850668903514434,0.1726129237703312,123687.67313019391,611.1486226531279,124298.82175284704,289,0,38.36585365853659,37,4,14,42.4580210170488,0.5540540540540541,51.31578947368421,994.7368421052632,26.884779516358467,16
886,4,2,1,38,0.05128205128205128,0.02564102564102564,0.9743589743589743,39,950,500,450,0.5263157894736842,14,5,9,381.10685611852483,0.4769174538911381,0.17919436815938838,0.18003565792447493,122600.90880102017,1652.8474322554198,124253.75623327559,290,0,40.02564102564103,34,5,17,42.974916856994014,0.5487132352941176,52.41071428571427,990.3571428571408,29.128151260504143,14
887,4,4,6,36,0.09523809523809523,0.14285714285714285,0.8571428571428572,42,1050,600,450,0.5714285714285714,15,6,9,353.49299528401696,0.4810540069686411,0.20397993852127483,0.17093883616417693,123596.3053425047,338.51434946391714,123934.81969196862,291,0,37.88095238095238,36,6,17,42.62009248773124,0.5549768518518519,51.40765765765766,994.3693693693697,27.62137137137138,0
888,4,4,5,35,0.1,0.125,0.875,40,1850,1700,150,0.918918918918919,20,17,3,355.1290526520143,0.48125,0.20551555457843262,0.17491115278697233,124370.31256011488,833.5022555017201,125203.8148156166,292,0,38.325,37,3,16,41.77464640357627,0.5610923423423424,50.63048245614036,997.4780701754404,26.95886676149839,0
889,4,3,1,37,0.07894736842105263,0.02631578947368421,0.9736842105263158,38,1350,1000,350,0.7407407407407407,17,10,7,359.99439938569134,0.4797889995258416,0.20276555356848558,0.17789293443569165,124508.58577942826,1364.478711205428,125873.0644906337,293,0,37.1578947368421,35,3,18,41.50974622134601,0.5663690476190476,50.49189814814815,998.0324074074083,28.515211640211664,0
890,4,7,6,38,0.1590909090909091,0.13636363636363635,0.8636363636363636,44,1050,900,150,0.8571428571428571,12,9,3,314.53574747636554,0.48020172656800564,0.20150287686996515,0.16068497187424305,125890.8090938764,-879.600197097996,125011.20889677841,294,0,32.93181818181818,40,4,19,41.21940928270043,0.5716145833333333,49.1107723577236,1003.5569105691089,25.088922764227725,0
891,4,3,3,38,0.07317073170731707,0.07317073170731707,0.926829268292683,41,950,700,250,0.7368421052631579,12,7,5,350.32966437500147,0.47886178861788614,0.13579490909479852,0.1752801354231701,125027.41378356816,781.8212198528892,125809.23500342105,295,0,35.926829268292686,37,4,18,41.2133857764134,0.5678490990990991,49.972587719298254,1000.1096491228082,27.02999051683265,16
892,4,1,3,36,0.02564102564102564,0.07692307692307693,0.9230769230769231,39,1050,600,450,0.5714285714285714,15,6,9,350.83281617990747,0.4791947818263608,0.171669089985921,0.17636889537370024,125225.32667802945,986.6308031004025,126211.95748112985,296,0,38.61538461538461,36,3,16,40.99605273027302,0.5717592592592593,49.77477477477478,1000.9009009009015,27.80280280280282,0
893,4,7,5,38,0.16279069767441862,0.11627906976744186,0.8837209302325582,43,1100,800,300,0.7272727272727273,14,8,6,322.7888077489311,0.47895902547065333,0.19909750682648908,0.16742719147364038,126514.97938368075,-429.8098219629911,126085.16956171776,297,0,35.48837209302326,39,4,17,40.371108580106295,0.579594017094017,48.48958333333334,1006.0416666666682,25.79594017094021,0
894,4,3,0,41,0.07317073170731707,0.0,1.0,41,1150,400,750,0.34782608695652173,19,4,15,406.44366506454435,0.4786839430894309,0.2457230607473404,0.19461167341357735,123176.74251531942,2028.625693366514,125205.36820868593,298,0,37.97560975609756,36,5,13,41.743240688220844,0.5506365740740741,51.82995495495496,992.6801801801805,27.57444944944946,14
895,4,10,8,43,0.19607843137254902,0.1568627450980392,0.8431372549019608,51,1650,1200,450,0.7272727272727273,21,12,9,362.0408784623174,0.4809150326797385,0.30800203786720903,0.1845499367169065,125800.69674486203,-1081.058673056475,124719.63807180556,299,0,31.333333333333332,42,9,17,40.1206172124022,0.5677083333333333,49.200581395348834,1003.1976744186042,23.88565891472867,0
896,4,5,5,43,0.10416666666666667,0.10416666666666667,0.8958333333333334,48,850,600,250,0.7058823529411765,11,6,5,366.61522615068804,0.4818816489361702,0.3048752483785102,0.18467852553573783,125309.87649389269,-359.2468624060336,124950.62963148666,300,0,33.208333333333336,36,12,18,40.51358114947701,0.5726273148148149,49.690315315315324,1001.23873873874,27.812187187187224,16
897,4,4,5,42,0.0851063829787234,0.10638297872340426,0.8936170212765957,47,2250,1700,550,0.7555555555555555,28,17,11,362.79233326957234,0.4815371569534382,0.30933484956352686,0.1846302011485035,125733.05357722587,-277.00242472201666,125456.05115250386,301,0,34.53191489361702,36,11,20,40.171653941163264,0.5769675925925926,49.26801801801802,1002.9279279279278,27.859109109109106,0
898,4,8,6,44,0.16,0.12,0.88,50,1250,700,550,0.56,18,7,11,349.17285564386947,0.4848299319727891,0.24289093298291697,0.17597386963244013,125329.1637811634,-820.5118839173126,124508.65189724609,302,0,33.0,37,13,13,40.9302452912834,0.5709459459459459,49.671052631578945,1001.3157894736839,27.06258890469416,14
899,4,4,5,43,0.08333333333333333,0.10416666666666667,0.8958333333333334,48,1550,1100,450,0.7096774193548387,20,11,9,350.15901177093104,0.48265735815602834,0.12302592919053956,0.17013079180047994,123796.76919821464,-346.503731917531,123450.2654662971,303,0,35.25,37,11,17,42.49439914793599,0.5551801801801801,51.206140350877185,995.1754385964896,26.8966334755808,16
900,4,7,8,42,0.14,0.16,0.84,50,1250,700,550,0.56,18,7,11,319.38950090871924,0.48417517006802724,0.19356496411110036,0.16100111548167334,125338.77088758642,-1987.8034061562614,123350.96748143015,304,0,34.0,39,11,11,41.665908145220016,0.5675747863247863,49.661458333333314,1001.3541666666634,25.675747863247782,0
901,4,3,1,44,0.06666666666666667,0.022222222222222223,0.9777777777777777,45,800,500,300,0.625,11,5,6,335.63602196388615,0.48074494949494945,0.19895204151816426,0.1683865643788328,125140.8053957674,-599.6475783215603,124541.15781744584,305,0,38.355555555555554,36,9,18,41.46360907897207,0.5708912037037037,49.859234234234236,1000.5630630630632,27.793418418418423,0
902,4,0,2,42,0.0,0.045454545454545456,0.9545454545454546,44,1050,700,350,0.6666666666666666,14,7,7,333.99216440053664,0.4798163319238901,0.19356414374418196,0.1677890539868609,125197.1497468753,-437.02659585260153,124760.1231510227,306,1,40.0,36,8,18,41.446541765125104,0.5714699074074074,49.80292792792793,1000.7882882882886,27.799674674674684,0
903,4,2,5,39,0.045454545454545456,0.11363636363636363,0.8863636363636364,44,1450,1300,150,0.896551724137931,16,13,3,331.83796401362895,0.4816001585623679,0.21816989307151124,0.16902303423144097,125768.72210680218,-453.0326638965704,125315.68944290561,307,0,40.15909090909091,37,7,14,40.91103702084247,0.5754504504504505,49.232456140350884,1003.0701754385972,27.110004741583708,0
904,4,2,1,40,0.04878048780487805,0.024390243902439025,0.975609756097561,41,1100,700,400,0.6363636363636364,15,7,8,360.3588092491518,0.481859756097561,0.24208076105657272,0.18477972984903349,126043.83680555582,884.2013888889228,126928.03819444474,308,0,41.78048780487805,34,7,16,39.91182572614109,0.5842524509803921,48.95833333333335,1004.1666666666688,29.534313725490257,0
905,4,2,5,37,0.047619047619047616,0.11904761904761904,0.8809523809523809,42,1500,1100,400,0.7333333333333333,19,11,8,349.46449744144405,0.48211866047231905,0.23824431382570888,0.18257070473810072,126808.29478126812,462.9994014284989,127271.29418269663,309,0,40.73809523809524,36,6,17,39.39861918604654,0.587962962962963,48.19819819819822,1007.2072072072102,27.97797797797806,0
906,4,2,5,34,0.05128205128205128,0.1282051282051282,0.8717948717948718,39,1050,600,450,0.5714285714285714,15,6,9,439.28929991435547,0.48096603688708955,0.3278894430171446,0.21214255565123985,123539.44778442371,3224.2158895807747,126763.66367400449,310,0,40.53846153846154,31,8,15,40.54696027068325,0.5655241935483871,51.46484374999999,994.1406249999991,32.06905241935481,16
907,4,6,3,37,0.15,0.075,0.925,40,1300,900,400,0.6923076923076923,17,9,8,399.7693801128033,0.48012820512820514,0.289397292371778,0.20019741708126174,125065.11264377173,2010.1725260416702,127075.2851698134,311,0,37.475,31,9,17,39.93805866527813,0.5813172043010753,49.934895833333336,1000.260416666667,32.26646505376345,0
908,4,6,4,39,0.13953488372093023,0.09302325581395349,0.9069767441860466,43,950,500,450,0.5263157894736842,14,5,9,328.81535747135206,0.48038944259874494,0.19013005678604133,0.16227317409675837,124453.72314453125,-348.2496473524304,124105.47349717881,312,0,35.72093023255814,39,4,17,42.34447315307792,0.5584935897435898,50.546875,997.8125,25.584935897435898,16
909,4,4,2,41,0.09302325581395349,0.046511627906976744,0.9534883720930233,43,1250,600,650,0.48,19,6,13,386.25589913582974,0.48417312661498707,0.19605766815150205,0.1890436063479452,124104.61844403714,2243.8661091285144,126348.48455316566,313,0,36.02325581395349,35,8,17,41.27524005885316,0.562202380952381,50.89699074074074,996.4120370370365,28.468915343915327,16
910,4,5,3,43,0.10869565217391304,0.06521739130434782,0.9347826086956522,46,1250,800,450,0.64,17,8,9,359.3402342065817,0.4856481481481481,0.27360264992703454,0.18258841895120567,125668.62678290959,-165.22287432605708,125503.40390858352,314,0,34.52173913043478,38,8,17,40.32476469543598,0.5726425438596492,49.332264957264954,1002.6709401709397,26.386077372919466,0
911,4,4,2,45,0.0851063829787234,0.0425531914893617,0.9574468085106383,47,2100,1800,300,0.8571428571428571,24,18,6,345.55847607141635,0.4851988899167437,0.26844945519540797,0.17974848461193846,126631.30411791925,-648.2959052151487,125983.00821270411,315,0,32.8936170212766,40,7,16,39.67883346795906,0.5791666666666666,48.3739837398374,1006.5040650406506,25.162601626016265,0
912,4,2,6,41,0.0425531914893617,0.1276595744680851,0.8723404255319149,47,1100,900,200,0.8181818181818182,13,9,4,351.6348874663077,0.4844858156028369,0.28120299138421245,0.1841764347188823,126912.74957242713,-474.609917211978,126438.13965521516,316,0,33.808510638297875,40,7,19,39.23663640948059,0.58203125,48.09451219512195,1007.6219512195122,25.190548780487806,0
913,4,1,1,41,0.023809523809523808,0.023809523809523808,0.9761904761904762,42,1200,900,300,0.75,15,9,6,375.80260846773376,0.4831712156407278,0.2561489061209259,0.19510728103772265,126553.21865362013,1111.805936003602,127665.02458962373,317,0,34.904761904761905,36,6,21,38.99832120872973,0.5853587962962963,48.45157657657659,1006.1936936936961,27.94982482482489,0
914,4,1,1,41,0.023809523809523808,0.023809523809523808,0.9761904761904762,42,1200,700,500,0.5833333333333334,17,7,10,373.6601619065996,0.48274777390631046,0.2673040053888798,0.19577747365573844,126926.22369382888,1085.454659125882,128011.67835295477,318,0,35.714285714285715,37,5,22,38.66793616249545,0.5872747747747749,48.08114035087719,1007.6754385964914,27.234471313418688,0
915,4,0,1,40,0.0,0.024390243902439025,0.975609756097561,41,1600,1100,500,0.6875,21,11,10,374.12571147001063,0.4822154471544715,0.2619226661435514,0.1965477329272028,127035.24470416365,1305.430261342428,128340.67496550607,319,1,37.390243902439025,36,5,22,38.54399389335717,0.5902777777777778,47.972972972972975,1008.1081081081082,28.003003003003005,0
916,4,1,2,39,0.024390243902439025,0.04878048780487805,0.9512195121951219,41,800,400,400,0.5,12,4,8,371.7105021401236,0.4817835365853658,0.2568745036199769,0.19642258205359633,127272.13718820843,1261.703367736162,128533.8405559446,320,0,38.1219512195122,34,7,23,38.361255309108046,0.5968137254901961,47.73809523809523,1009.0476190476177,29.677871148459342,0
917,4,1,1,39,0.025,0.025,0.975,40,1250,900,350,0.72,16,9,7,361.56055372179145,0.4810763888888889,0.2449264460046805,0.19276784602172525,127631.95363860486,1229.3359660336025,128861.28960463846,321,0,39.225,36,4,19,38.24807756603143,0.5963541666666667,47.38175675675676,1010.4729729729734,28.068693693693703,0
918,4,0,3,36,0.0,0.07692307692307693,0.9230769230769231,39,900,500,400,0.5555555555555556,13,5,8,366.75523435009063,0.4801225820962663,0.2379064234734345,0.19546844907669636,127617.73003472202,1560.8940972221967,129178.6241319442,322,1,36.56410256410256,35,4,19,38.13144329896907,0.5982142857142857,47.39583333333332,1010.4166666666649,28.86904761904757,0
919,4,1,1,36,0.02702702702702703,0.02702702702702703,0.972972972972973,37,600,200,400,0.3333333333333333,10,2,8,370.2247691645098,0.4767267267267267,0.22398594520361526,0.19846773208340415,127851.7299489884,2066.7754415294985,129918.50539051791,323,0,37.13513513513514,35,2,20,37.80374990463111,0.6005952380952381,47.164351851851855,1011.3425925925931,28.89550264550266,0
920,4,0,2,34,0.0,0.05555555555555555,0.9444444444444444,36,1350,1100,250,0.8148148148148148,16,11,5,379.9109739467517,0.4756117724867725,0.23068372044360785,0.2037704314805305,127873.4693877551,2516.1068594104363,130389.57624716553,324,1,38.97222222222222,34,2,20,37.53653680163215,0.6029411764705883,47.142857142857146,1011.4285714285714,29.747899159663866,0
921,4,1,1,34,0.02857142857142857,0.02857142857142857,0.9714285714285714,35,1350,1000,350,0.7407407407407407,17,10,7,388.3533959481359,0.4749649859943978,0.2335012376451857,0.20825734741780177,127865.50132461089,2931.400332804714,130796.9016574156,325,0,40.542857142857144,33,2,21,37.3312482329658,0.6051136363636364,47.15073529411766,1011.3970588235306,30.64839572192517,0
922,4,3,1,36,0.08108108108108109,0.02702702702702703,0.972972972972973,37,1250,900,350,0.72,16,9,7,370.9835121622922,0.4748811311311311,0.22710775492356028,0.20291712186684957,128656.40503838909,2146.793360092278,130803.19839848137,326,0,39.0,32,5,21,36.960692802323166,0.6155598958333333,46.3699494949495,1014.5202020202032,31.70375631313135,0
923,4,1,3,34,0.02702702702702703,0.08108108108108109,0.9189189189189189,37,850,700,150,0.8235294117647058,10,7,3,363.6479776158629,0.4736611611611612,0.21379121523839295,0.20102460202604916,129076.82742214545,1987.705449826999,131064.53287197245,327,0,38.486486486486484,33,4,22,36.71761939218521,0.6174242424242424,45.95588235294118,1016.1764705882363,30.793226381461704,0
924,4,1,2,33,0.02857142857142857,0.05714285714285714,0.9428571428571428,35,1200,800,400,0.6666666666666666,16,8,8,482.06612462523566,0.4744397759103642,0.2087196377109921,0.236936183066511,124282.64136609859,5258.721153079105,129541.3625191777,328,0,39.97142857142857,28,7,17,38.7013688760807,0.5818452380952381,50.7183908045977,997.1264367816094,35.61165845648605,16
925,4,1,1,33,0.029411764705882353,0.029411764705882353,0.9705882352941176,34,1250,1000,250,0.8,15,10,5,475.3562826565542,0.47482174688057044,0.21981447221905603,0.23536275279282828,124591.10874167377,5045.033260700112,129636.14200237389,329,0,41.588235294117645,27,7,18,38.54477194812937,0.5883487654320987,50.40922619047619,998.3630952380954,36.97641093474427,0
926,4,4,4,33,0.10810810810810811,0.10810810810810811,0.8918918918918919,37,1000,500,500,0.5,15,5,10,435.64314752432665,0.4745683183183183,0.20380152974695132,0.221316529343991,125660.59268904311,3549.305088065307,129209.89777710842,330,0,39.027027027027025,29,8,17,38.42045874313155,0.5930316091954023,49.34027777777777,1002.6388888888881,34.573754789272,0
927,4,2,2,33,0.05714285714285714,0.05714285714285714,0.9428571428571428,35,1150,800,350,0.6956521739130435,15,8,7,448.92048675695105,0.4764355742296919,0.2109968404758369,0.22791087560524328,125633.24043810235,4279.867090065196,129913.10752816754,331,0,41.77142857142857,27,8,18,38.116155806244116,0.5991512345679013,49.367559523809526,1002.5297619047622,37.130731922398596,0
928,4,2,5,30,0.05714285714285714,0.14285714285714285,0.8571428571428572,35,1250,900,350,0.72,16,9,7,433.35117594745503,0.4757352941176471,0.21598579040852584,0.22383184592515337,126342.87308673469,3950.836389243195,130293.70947597788,332,0,42.2,27,8,18,37.768896783106385,0.6064814814814814,48.660714285714285,1005.3571428571428,37.235449735449734,0
929,4,2,1,31,0.0625,0.03125,0.96875,32,1150,700,450,0.6086956521739131,16,7,9,450.1923767631238,0.47488239247311825,0.20294082510353628,0.23357915217511502,126527.0715195595,4992.304610453646,131519.37613001314,333,0,44.59375,25,7,20,37.15421577997239,0.6158333333333333,48.4775641025641,1006.0897435897435,40.243589743589745,0
930,4,0,1,30,0.0,0.03225806451612903,0.967741935483871,31,1100,800,300,0.7272727272727273,14,8,6,450.8821868011583,0.47352150537634413,0.17699314991116455,0.23486251222926013,126688.35521449707,5224.304528270876,131912.65974276795,334,1,45.25806451612903,25,6,20,36.96938342353815,0.6174999999999999,48.31730769230769,1006.7307692307694,40.269230769230774,0
931,4,1,1,30,0.03225806451612903,0.03225806451612903,0.967741935483871,31,700,500,200,0.7142857142857143,9,5,4,449.628840624563,0.47383512544802864,0.17793517591808494,0.23490584067542644,126809.38540125747,5203.431387656167,132012.81678891365,335,0,46.12903225806452,25,6,21,36.8753314770618,0.61875,48.197115384615394,1007.2115384615391,40.28846153846157,0
932,4,1,0,31,0.03225806451612903,0.0,1.0,31,1000,700,300,0.7,13,7,6,432.7794686818096,0.4719534050179211,0.15399414924843025,0.22877485413988316,127286.59705551754,4817.405168800504,132104.00222431804,336,0,46.225806451612904,26,5,22,36.80576795636438,0.6197916666666667,47.72376543209877,1009.1049382716058,38.81172839506176,0
933,4,2,1,32,0.06060606060606061,0.030303030303030304,0.9696969696969697,33,1450,1000,450,0.6896551724137931,19,10,9,402.49553665183197,0.47238005050505055,0.1351452405203648,0.21813958715849865,128290.04667475895,3727.2342366891376,132017.2809114481,337,0,44.36363636363637,28,5,22,36.53737058573251,0.6231398809523809,46.731321839080465,1013.0747126436787,36.18123973727424,0
934,4,1,2,31,0.030303030303030304,0.06060606060606061,0.9393939393939394,33,1100,900,200,0.8181818181818182,13,9,4,404.2570552436938,0.4724984217171717,0.1357513888351829,0.21949384223508656,128362.83535225932,3778.316364447103,132141.15171670643,338,0,45.27272727272727,28,5,23,36.418013611229256,0.6238839285714286,46.6594827586207,1013.3620689655181,36.19150246305422,0
935,4,2,2,31,0.06060606060606061,0.06060606060606061,0.9393939393939394,33,750,300,450,0.4,12,3,9,398.82536911330743,0.47222222222222227,0.11262275880709982,0.2185340249842738,128727.08839096974,3667.925708481967,132395.0140994517,339,0,42.78787878787879,28,5,21,36.18209920241635,0.6276041666666667,46.30028735632184,1014.7988505747126,36.24281609195402,0
936,4,1,0,32,0.03125,0.0,1.0,32,1050,600,450,0.5714285714285714,15,6,9,412.634435571305,0.469695060483871,0.12985316761988575,0.22600435471170516,128710.16521843108,4222.049275439342,132932.21449387042,340,0,45.0625,27,5,22,35.84912866011635,0.630787037037037,46.316964285714285,1014.7321428571425,37.58267195767195,0
937,4,0,2,30,0.0,0.0625,0.9375,32,1100,600,500,0.5454545454545454,16,6,10,416.68662196062877,0.4688760080645162,0.06632156753752128,0.2076507570379975,124861.14969135805,4005.5941358024775,128866.74382716052,341,1,46.0625,29,3,19,39.72751065406709,0.5847701149425287,50.13888888888889,999.4444444444446,34.463601532567054,16
938,4,2,4,28,0.0625,0.125,0.875,32,700,500,200,0.7142857142857143,9,5,4,400.62916084861047,0.47124915994623656,0.04663590604026835,0.20194095049540908,125336.2473262804,3642.6711180483167,128978.91844432871,342,0,44.15625,30,2,19,39.63478747203579,0.5868055555555556,49.66397849462365,1001.3440860215046,33.37813620071682,0
939,4,4,1,31,0.125,0.03125,0.96875,32,900,700,200,0.7777777777777778,11,7,4,382.6690130591725,0.4684559811827957,0.04483222935902598,0.19654196114028843,126111.33015738812,3253.771389756041,129365.10154714416,200,0,34.03125,30,2,22,39.28197064989518,0.5947916666666666,48.891129032258064,1004.4354838709676,33.48118279569892,0
940,4,1,1,31,0.03125,0.03125,0.96875,32,950,600,350,0.631578947368421,13,6,7,428.4435924936608,0.46702788978494625,0.07734502170374391,0.20298754266473432,122725.49572204874,4430.68671233668,127156.18243438542,201,0,35.0,30,2,19,41.67175348164225,0.5597222222222222,52.284946236559136,990.860215053763,33.02867383512543,15
941,4,9,7,33,0.225,0.175,0.825,40,850,500,350,0.5882352941176471,12,5,7,360.1143610578538,0.4769364316239317,0.13082041194168004,0.18030754972549123,125057.87706833011,1069.8418418412612,126127.71891017137,202,0,28.75,35,5,16,40.937186608038246,0.5720238095238095,49.94212962962964,1000.2314814814832,28.57804232804238,0
942,4,4,3,34,0.10810810810810811,0.08108108108108109,0.9189189189189189,37,1100,800,300,0.7272727272727273,14,8,6,377.0616035216212,0.4732232232232232,0.13751334973402907,0.1886737183509008,125031.56764934692,2028.9206777369573,127060.48832708388,203,0,31.486486486486488,32,5,17,40.54070403568572,0.5784505208333333,49.96843434343434,1000.126262626262,31.253945707070688,0
943,4,2,0,36,0.05555555555555555,0.0,1.0,36,1300,1000,300,0.7692307692307693,16,10,6,389.95177342306073,0.472255291005291,0.1751528157107558,0.19635489101833112,125293.14041137707,2571.6564602322183,127864.79687160929,204,0,33.30555555555556,31,5,16,39.94681254606147,0.5836693548387097,49.70703125000001,1001.1718750000009,32.2958669354839,0
944,4,1,2,35,0.02702702702702703,0.05405405405405406,0.9459459459459459,37,900,700,200,0.7777777777777778,11,7,4,383.30262785094243,0.4724724724724725,0.0800648276686613,0.18859230867297275,124326.88899702036,2227.607888966417,126554.49688598678,205,0,33.37837837837838,33,4,17,41.117289260260485,0.5688131313131313,50.674019607843135,997.3039215686274,30.221330956625074,15
945,4,7,4,38,0.16666666666666666,0.09523809523809523,0.9047619047619048,42,1250,900,350,0.72,16,9,7,331.9739776937355,0.4779205381339528,0.11225352189971294,0.17034525159364516,126072.89422850206,-4.050119853168667,126068.84410864889,206,0,30.047619047619047,35,7,21,40.59450751027619,0.5824404761904762,48.92939814814814,1004.282407407406,28.69378306878303,0
946,4,5,5,38,0.11627906976744186,0.11627906976744186,0.8837209302325582,43,1350,900,450,0.6666666666666666,18,9,9,322.40923919918265,0.4775516795865633,0.15509947983079364,0.16915443645655726,126981.47506925183,-411.9998461065218,126569.4752231453,207,0,30.093023255813954,37,6,21,39.90245140702061,0.5878378378378378,48.02631578947367,1007.8947368421033,27.24039829302982,0
947,4,2,2,38,0.05,0.05,0.95,40,1100,900,200,0.8181818181818182,13,9,4,375.532385827447,0.4752537393162393,0.19450267379679098,0.1865689589525308,124733.04866133396,1368.2598710643588,126101.30853239833,208,0,33.15,38,2,16,40.888814616755774,0.5630482456140351,50.26709401709402,998.9316239316242,26.287674313990113,16
948,4,4,4,38,0.09523809523809523,0.09523809523809523,0.9047619047619048,42,1450,800,650,0.5517241379310345,21,8,13,356.75623524178985,0.47725512969415407,0.21177383997077182,0.1811580363370644,125641.84746877024,565.2732120680536,126207.1206808383,209,0,32.07142857142857,38,4,18,40.41719948849106,0.5723684210526316,49.35897435897434,1002.5641025641,26.38326585695,0
949,4,3,0,41,0.07317073170731707,0.0,1.0,41,900,600,300,0.6666666666666666,12,6,6,355.5100111863664,0.47820121951219513,0.22626002046733795,0.1815640414273226,125878.73191751288,750.2298784241086,126628.961795937,210,0,33.53658536585366,37,4,21,40.203871649184165,0.5765765765765766,49.12280701754385,1003.5087719298228,27.121858700806023,0
950,4,3,1,43,0.06818181818181818,0.022727272727272728,0.9772727272727273,44,1350,1000,350,0.7407407407407407,17,10,7,337.6770755668613,0.48059813248766736,0.22478928356411831,0.17582496003653786,126672.22222222202,-245.03068251772154,126427.19153970429,211,0,32.18181818181818,39,5,17,39.83512693156733,0.5811965811965811,48.33333333333332,1006.6666666666649,25.811965811965766,0
951,4,0,2,41,0.0,0.046511627906976744,0.9534883720930233,43,1300,1000,300,0.7692307692307693,16,10,6,341.9030710928487,0.4800664451827243,0.2213814863215957,0.17791111340711868,126646.00830078112,60.13183593748559,126706.1401367186,212,1,33.93023255813954,39,4,18,39.75570475007761,0.5809294871794872,48.35937499999999,1006.562499999999,25.809294871794844,0
952,4,3,2,42,0.06818181818181818,0.045454545454545456,0.9545454545454546,44,750,400,350,0.5333333333333333,11,4,7,337.60986564548404,0.4794309372797745,0.23757914799644486,0.17750013127020875,127066.39695493718,-220.22615919760523,126846.17079573958,213,0,34.0,40,4,21,39.43234888956086,0.58359375,47.94207317073169,1008.2317073170703,25.20579268292676,0
953,4,1,1,42,0.023255813953488372,0.023255813953488372,0.9767441860465116,43,1200,700,500,0.5833333333333334,17,7,10,348.23831275086457,0.4787513842746401,0.24825270739501581,0.18285737555192288,127015.17083292006,246.30975692377203,127261.48058984384,214,0,35.58139534883721,40,3,22,39.217032967032964,0.5830729166666666,47.99288617886178,1008.0284552845517,25.20071138211379,0
954,4,1,1,42,0.023255813953488372,0.023255813953488372,0.9767441860465116,43,1900,1300,600,0.6842105263157895,25,13,12,341.3644081623005,0.4774132521225545,0.23153460815478955,0.18126833628932945,127469.3412594054,102.74572288336236,127572.08698228876,215,0,35.18604651162791,38,5,20,38.92474255889406,0.5910087719298245,47.542735042735046,1009.8290598290602,26.574448942870003,0
955,4,0,3,39,0.0,0.07142857142857142,0.9285714285714286,42,1800,1600,200,0.8888888888888888,20,16,4,361.7756282384228,0.47606949283778555,0.13017333722855162,0.17446576154693205,123480.25728732924,546.1177478495642,124026.3750351788,216,1,36.92857142857143,40,2,15,42.53514826175871,0.546875,51.52439024390245,993.9024390243924,24.84756097560981,16
956,4,3,2,40,0.07142857142857142,0.047619047619047616,0.9523809523809523,42,1350,1000,350,0.7407407407407407,17,10,7,361.5026499896262,0.47628726287262874,0.181833671484668,0.17643893443609773,123987.80303795416,567.1801375466966,124554.98317550085,217,0,37.642857142857146,37,5,18,42.01335370105327,0.5571509009009009,51.014254385964925,995.9429824561419,26.91737790422005,0
957,4,6,4,42,0.13043478260869565,0.08695652173913043,0.9130434782608696,46,1300,800,500,0.6153846153846154,18,8,10,335.96063439493815,0.479176731078905,0.22791891353033011,0.1698276479095063,125454.47216971683,-758.102644922553,124696.36952479428,218,0,34.41304347826087,38,8,14,41.13166968824428,0.5704495614035088,49.545940170940185,1001.8162393162415,26.363585245164252,0
958,4,3,3,42,0.06666666666666667,0.06666666666666667,0.9333333333333333,45,1250,600,650,0.48,19,6,13,329.61423581663564,0.48034511784511785,0.2309214553630068,0.1557282970259094,122605.82133605727,-860.4038075549915,121745.41752850228,219,0,34.84444444444444,41,4,14,44.244695148418984,0.5363313008130082,52.405753968253954,990.3769841269816,24.155536198219064,16
959,4,8,6,44,0.16,0.12,0.88,50,1150,1000,150,0.8695652173913043,13,10,3,329.88632346340876,0.4846853741496599,0.3312879743763948,0.16332622732549268,124588.51748880789,-1757.2457737125944,122831.2717150953,220,0,31.16,42,8,13,42.17824905367369,0.5553075396825398,50.41182170542636,998.3527131782955,23.770302694721323,0
960,4,10,9,45,0.18518518518518517,0.16666666666666666,0.8333333333333334,54,1850,1600,250,0.8648648648648649,21,16,5,307.6356094467469,0.4882366643372933,0.3355234801784197,0.157657916353083,126021.09854973984,-3044.9277319639796,122976.17081777586,221,0,29.11111111111111,45,9,13,41.25873928732523,0.5659722222222222,48.980978260869556,1004.0760869565198,22.31280193236711,0
961,4,4,3,46,0.08163265306122448,0.061224489795918366,0.9387755102040817,49,950,300,650,0.3157894736842105,16,3,13,296.19171123610215,0.4844458616780045,0.21103510656340152,0.15059888416370779,125695.40895061684,-2314.3816713196766,123381.02727929717,222,0,31.918367346938776,44,5,14,41.88019390581716,0.5639204545454546,49.305555555555536,1002.7777777777742,22.79040404040396,16
962,4,1,1,46,0.02127659574468085,0.02127659574468085,0.9787234042553191,47,1650,1200,450,0.7272727272727273,21,12,9,307.18002146870714,0.48377274128893005,0.23191469268590725,0.15615598883015522,125687.49574042956,-1678.2624720213835,124009.23326840818,223,0,34.1063829787234,43,4,15,41.6128568955205,0.5651647286821706,49.313446969696955,1002.7462121212095,23.319679351656035,0
963,4,3,7,42,0.061224489795918366,0.14285714285714285,0.8571428571428572,49,1300,800,500,0.6153846153846154,18,8,10,305.2054463464708,0.4855796485260771,0.06968008222460553,0.15142943461655617,124677.78727521106,-1783.7586805148785,122894.02859469618,224,0,33.10204081632653,41,8,13,42.702124929638124,0.5576727642276422,50.32242063492064,998.7103174603178,24.35878823073946,16
964,4,3,2,43,0.06666666666666667,0.044444444444444446,0.9555555555555556,45,1650,1400,250,0.8484848484848485,19,14,5,308.1477116173742,0.4860479797979798,0.11894084988255393,0.15466835300151802,125160.30777449039,-1286.0116945296193,123874.29607996077,225,0,35.577777777777776,38,7,16,42.13111253469996,0.5674342105263157,49.839743589743584,1000.641025641025,26.332658569500655,0
965,4,3,5,41,0.06521739130434782,0.10869565217391304,0.8913043478260869,46,1050,700,350,0.6666666666666666,14,7,7,305.4460664620628,0.4857487922705314,0.16988627652570631,0.15682167054458032,126096.14257812544,-1493.7783145339795,124602.36426359146,226,0,34.45652173913044,39,7,16,41.23669017492911,0.5753205128205128,48.90625000000002,1004.3750000000036,25.75320512820522,0
966,4,1,2,40,0.023809523809523808,0.047619047619047616,0.9523809523809523,42,700,400,300,0.5714285714285714,10,4,6,318.9880055681622,0.48519163763066203,0.16865252651278873,0.16378532124463938,126098.89581409673,-355.1929439827553,125743.70287011398,227,0,36.404761904761905,37,5,17,40.89383187772924,0.5788288288288288,48.90350877192983,1004.3859649122815,27.14556661925085,0
967,4,2,2,40,0.047619047619047616,0.047619047619047616,0.9523809523809523,42,1200,800,400,0.6666666666666666,16,8,8,315.6509437754593,0.4860506194347658,0.1686086058019325,0.163273254673702,126401.93527094866,-420.2219673361154,125981.71330361255,228,0,37.095238095238095,37,5,12,40.666571257223836,0.5819256756756757,48.60197368421052,1005.5921052631571,27.178165007112355,0
968,4,1,1,40,0.024390243902439025,0.024390243902439025,0.975609756097561,41,1350,1000,350,0.7407407407407407,17,10,7,322.4058211824334,0.4864837398373984,0.1582707806153909,0.16733008004355246,126539.80070791012,-40.56632810095553,126499.23437980916,229,0,38.78048780487805,37,4,15,40.355274629468155,0.5833333333333333,48.46491228070175,1006.140350877193,27.19298245614035,0
969,4,3,1,42,0.06976744186046512,0.023255813953488372,0.9767441860465116,43,1450,900,550,0.6206896551724138,20,9,11,313.83063827959717,0.4852574750830565,0.17774965655451536,0.16598231854362097,127307.5610435384,-608.1950789642902,126699.36596457411,230,0,37.83720930232558,38,5,18,39.78513833015738,0.5893640350877193,47.70299145299144,1009.1880341880326,26.55757984705349,0
970,4,2,4,40,0.045454545454545456,0.09090909090909091,0.9090909090909091,44,1400,700,700,0.5,21,7,14,319.02515906711767,0.48288847780126853,0.2144228068532914,0.17114554113490113,127880.99500868046,-640.5490451388941,127240.44596354157,231,0,37.79545454545455,39,5,16,39.068400274630974,0.593482905982906,47.135416666666664,1011.4583333333326,25.934829059829042,0
971,4,1,2,39,0.024390243902439025,0.04878048780487805,0.9512195121951219,41,900,700,200,0.7777777777777778,11,7,4,333.8899234635108,0.4811991869918699,0.20324025898162512,0.1785187518125038,127745.77100326687,330.60514061359777,128076.37614388046,232,0,40.21951219512195,36,5,18,38.83071553228623,0.5975115740740741,47.26914414414415,1010.9234234234242,28.08120620620623,0
972,4,2,1,40,0.04878048780487805,0.024390243902439025,0.975609756097561,41,1100,600,500,0.5454545454545454,16,6,10,340.6074819797935,0.4770579268292683,0.24515822659578657,0.18533938616263623,128450.017373134,550.2073955447768,129000.22476867877,233,0,40.80487804878049,37,4,15,37.94156751397151,0.602759009009009,46.5734649122807,1013.7061403508769,27.397463252726403,0
973,4,2,4,38,0.047619047619047616,0.09523809523809523,0.9047619047619048,42,1600,1300,300,0.8125,19,13,6,337.16032017632915,0.4754161827332559,0.2497546958228205,0.18645749799518826,129092.79348381895,304.9935166922132,129397.78700051116,234,0,40.26190476190476,38,4,19,37.37428160919539,0.6074561403508771,45.94017094017093,1016.2393162393148,26.7431399010346,0
974,4,0,0,38,0.0,0.0,1.0,38,1450,1100,350,0.7586206896551724,18,11,7,350.0062584334649,0.4737879326695116,0.22748550982646765,0.19255682930412182,128886.73460200078,1422.2327479506698,130308.96734995145,191,1,36.36842105263158,36,2,19,37.25786477394551,0.6090856481481481,46.143018018018026,1015.4279279279291,28.206331331331363,0
975,4,0,0,38,0.0,0.0,1.0,38,1350,900,450,0.6666666666666666,18,9,9,347.8861188800605,0.4738323850165955,0.2255526578334759,0.19194377238024637,129001.10995708557,1375.5390948380932,130376.64905192367,192,2,37.36842105263158,36,2,19,37.1951557476998,0.6102430555555556,46.03040540540541,1015.8783783783792,28.218843843843867,0
976,4,0,2,36,0.0,0.05263157894736842,0.9473684210526316,38,1350,1200,150,0.8888888888888888,15,12,3,347.8257263131702,0.4731211474632527,0.04097291421324378,0.1833818030743663,127179.55789448284,1303.684860078243,128483.24275456108,193,3,38.36842105263158,35,3,20,39.05873493975905,0.59375,47.8298611111111,1008.6805555555541,28.8194444444444,16
977,4,1,1,36,0.02702702702702703,0.02702702702702703,0.972972972972973,37,1050,800,250,0.7619047619047619,13,8,5,351.9183283053795,0.4715027527527527,0.08607179882826688,0.18696703603333165,127489.75326678013,1573.1961691420986,129062.94943592223,194,0,40.108108108108105,36,1,18,38.637377341659246,0.5949074074074074,47.522522522522515,1009.9099099099085,28.053053053053013,0
978,4,0,1,35,0.0,0.027777777777777776,0.9722222222222222,36,1000,700,300,0.7,13,7,6,386.6252383306269,0.4704199735449735,0.15616246498599495,0.1840336134453781,122925.34722222199,2397.9140035305327,125323.26122575252,195,1,41.94444444444444,34,2,18,42.498249299719895,0.5520833333333333,52.08333333333332,991.6666666666647,29.166666666666607,16
979,4,6,4,37,0.14634146341463414,0.0975609756097561,0.9024390243902439,41,850,300,550,0.35294117647058826,14,3,11,347.21266592061704,0.4778963414634146,0.16763718858791665,0.1705362420195365,124253.25535101155,432.80108572574136,124686.0564367373,196,0,37.19512195121951,38,3,13,42.093513359051286,0.5581140350877193,50.747863247863236,997.0085470085453,26.237067026540664,0
980,4,2,1,38,0.05128205128205128,0.02564102564102564,0.9743589743589743,39,1500,900,600,0.6,21,9,12,360.66297557750727,0.4757647323436797,0.1779141282022314,0.17685473666684298,124184.89171181312,1157.7785133106058,125342.67022512373,197,0,40.05128205128205,36,3,16,41.82931307196928,0.5610532407407407,50.81644144144144,996.7342342342339,27.687062062062054,0
981,4,5,2,41,0.11627906976744186,0.046511627906976744,0.9534883720930233,43,850,300,550,0.35294117647058826,14,3,11,331.3699463201591,0.4781746031746032,0.18376111829331476,0.16630823951679435,125156.29882812485,-302.72648862969277,124853.57233949516,198,0,37.2093023255814,39,4,21,41.55432368658477,0.5657051282051282,49.84374999999999,1000.6249999999989,25.657051282051253,0
982,4,3,8,36,0.06818181818181818,0.18181818181818182,0.8181818181818181,44,950,600,350,0.631578947368421,13,6,7,325.1405854464419,0.47964015151515155,0.18996369533568003,0.1651821326475075,125661.44180877789,-628.4730484499894,125032.9687603279,199,0,36.43181818181818,40,4,14,41.18943847557267,0.5692708333333334,49.33943089430895,1002.6422764227647,25.066056910569117,0
983,4,4,1,39,0.1,0.025,0.975,40,1250,900,350,0.72,16,9,7,343.6130784754569,0.48059561965811964,0.19508310249307503,0.17471031173188714,125695.40895061729,638.1172839506204,126333.52623456791,200,0,36.675,38,2,17,40.69136657433058,0.5729166666666667,49.30555555555556,1002.7777777777778,26.38888888888889,0
984,4,1,2,38,0.025,0.05,0.95,40,1150,600,550,0.5217391304347826,17,6,11,348.5604988126819,0.47919337606837603,0.21495956156220086,0.1784971666126848,125990.20113092614,783.0414703411341,126773.24260126728,201,0,37.65,38,2,20,40.26329324961868,0.5759320175438596,49.01175213675213,1003.9529914529903,26.419815564552376,0
985,4,2,2,38,0.05,0.05,0.95,40,1500,1000,500,0.6666666666666666,20,10,10,344.3676021914886,0.47821848290598296,0.19963605823068398,0.1781693329994197,126411.62065781959,706.4361675631152,127118.0568253827,202,0,36.65,36,4,15,39.93467711832775,0.583912037037037,48.59234234234232,1005.6306306306274,27.934184184184094,0
986,4,3,6,35,0.07317073170731707,0.14634146341463414,0.8536585365853658,41,1600,1000,600,0.625,22,10,12,334.80157235145555,0.4758130081300813,0.20158540457242813,0.17742793365950113,127388.43831041353,329.969889144576,127718.40819955811,203,0,34.24390243902439,38,3,15,39.17323702684588,0.5901864035087719,47.62286324786325,1009.5085470085476,26.56601439496178,0
987,4,1,2,34,0.027777777777777776,0.05555555555555555,0.9444444444444444,36,1050,700,350,0.6666666666666666,14,7,7,354.8327809135207,0.4725033068783069,0.17614694106546258,0.18694152677632547,127150.37321030538,1823.4241040809504,128973.79731438633,204,0,36.361111111111114,35,1,21,38.9119998469895,0.593452380952381,47.858796296296305,1008.5648148148161,28.816137566137606,0
988,4,2,1,35,0.05555555555555555,0.027777777777777776,0.9722222222222222,36,1650,1400,250,0.8484848484848485,19,14,5,347.35631828524237,0.4711640211640212,0.1699206076567812,0.18553288853731023,127705.45488522381,1671.8593267746937,129377.3142119985,205,0,35.111111111111114,35,1,17,38.5316472002748,0.5991071428571428,47.30902777777778,1010.7638888888891,28.87896825396826,0
989,4,3,2,36,0.07894736842105263,0.05263157894736842,0.9473684210526316,38,1500,1200,300,0.8,18,12,6,332.8579470820042,0.4703799193930773,0.17591925018024512,0.1813330607237783,128496.3348765431,955.7122878086287,129452.04716435172,206,0,34.1578947368421,35,3,17,38.09075342465753,0.6071428571428572,46.52777777777777,1013.888888888888,28.968253968253943,0
990,4,2,3,35,0.05263157894736842,0.07894736842105263,0.9210526315789473,38,1400,1100,300,0.7857142857142857,17,11,6,369.80345323024017,0.4702465623518255,0.14179584407705148,0.18948877476505227,126014.78273158868,1732.1966896004824,127746.97942118917,207,0,34.8421052631579,35,3,21,39.70473102785782,0.5818452380952381,48.98726851851852,1004.0509259259262,28.68716931216932,16
991,4,2,4,33,0.05405405405405406,0.10810810810810811,0.8918918918918919,37,850,600,250,0.7058823529411765,11,6,5,369.4554414648059,0.47225350350350354,0.15055829601740944,0.19061793710313157,126297.54178463937,1932.2695091522744,128229.81129379164,208,0,36.0,32,5,19,39.4216074195034,0.5914713541666667,48.70580808080808,1005.176767676768,31.411773989899,0
992,4,1,0,34,0.029411764705882353,0.0,1.0,34,800,600,200,0.75,10,6,4,388.3568116870637,0.46726455733808675,0.14504489384912356,0.19897803155607627,126011.15120781786,2987.457784016923,128998.60899183479,209,0,38.705882352941174,31,3,22,39.24277547226907,0.5910618279569892,48.990885416666664,1004.0364583333328,32.388272849462346,0
993,4,4,2,36,0.10526315789473684,0.05263157894736842,0.9473684210526316,38,1050,900,150,0.8571428571428571,12,9,3,357.5313874719304,0.47006875296348977,0.15290122234078596,0.18938816968529196,127370.19903702902,1512.3888191009028,128882.58785612992,210,0,35.526315789473685,33,5,18,38.61830257779937,0.6000631313131313,47.64093137254902,1009.4362745098038,30.5889780154486,0
994,4,0,1,35,0.0,0.027777777777777776,0.9722222222222222,36,1400,1000,400,0.7142857142857143,18,10,8,370.92993625629504,0.46848544973544975,0.16578406026742232,0.19637178214786916,127346.77105652496,2247.345934088369,129594.11699061333,211,1,38.361111111111114,32,4,18,38.30424902009838,0.6022135416666667,47.66414141414142,1009.3434343434353,31.541982323232354,0
995,4,2,3,34,0.05405405405405406,0.08108108108108109,0.9189189189189189,37,1200,800,400,0.6666666666666666,16,8,8,362.1359779614327,0.46753003003003,0.16782309582309596,0.19374979365640838,127772.55893166077,1854.2081170703427,129626.76704873111,212,0,38.108108108108105,33,4,21,38.08939393939394,0.6041666666666667,47.24264705882352,1011.0294117647048,30.637254901960752,0
996,4,2,1,35,0.05555555555555555,0.027777777777777776,0.9722222222222222,36,1150,800,350,0.6956521739130435,15,8,7,359.9632569174142,0.46473214285714287,0.1450585546986578,0.19502187596222015,128276.40109592008,2035.4988822658308,130311.89997818592,213,0,36.166666666666664,31,5,23,37.62853470437018,0.614247311827957,46.744791666666664,1013.0208333333328,32.67809139784944,0
997,4,2,3,34,0.05405405405405406,0.08108108108108109,0.9189189189189189,37,1150,800,350,0.6956521739130435,15,8,7,342.3333079661387,0.46593468468468463,0.13734286319142774,0.18845905516575304,128912.72454660224,1426.2238865931906,130338.94843319543,214,0,35.78378378378378,32,5,20,37.426178043018794,0.6181640625,46.117424242424235,1015.5303030303019,31.735321969696933,0
998,4,0,0,34,0.0,0.0,1.0,34,850,600,250,0.7058823529411765,11,6,5,374.9992208153673,0.4627710932857992,0.15779504457304983,0.20393027671464592,128425.93557098754,2831.9251543209716,131257.8607253085,215,1,39.64705882352941,29,5,21,37.09463780031057,0.6214080459770115,46.597222222222214,1013.6111111111102,34.95210727969346,0
999,4,0,2,32,0.0,0.058823529411764705,0.9411764705882353,34,1150,700,450,0.6086956521739131,16,7,9,420.3382448621169,0.46217691622103385,0.09821364568249913,0.21748396200116846,126413.28605584396,3827.267757593239,130240.55381343719,216,2,40.64705882352941,33,1,14,38.02299130717361,0.5902777777777778,48.59068627450981,1005.6372549019612,30.47385620915034,16
1000,4,0,1,31,0.0,0.03125,0.96875,32,900,600,300,0.6666666666666666,12,6,6,437.7651638719174,0.46005544354838707,0.11790122456913332,0.2253658285256561,126207.32837253142,4649.8343573676175,130857.16272989905,217,3,43.9375,31,1,16,37.79871819791802,0.5930779569892473,48.795572916666664,1004.8177083333329,32.41347446236558,0
1001,4,2,0,33,0.06060606060606061,0.0,1.0,33,850,400,450,0.47058823529411764,13,4,9,430.48202368759394,0.46121369949494945,0.12449551952937976,0.2243571017571814,126710.3564049587,4309.306129476586,131019.66253443528,218,0,43.45454545454545,32,1,16,37.46002633559067,0.595703125,48.29545454545455,1006.8181818181821,31.46306818181819,0
1002,4,2,1,34,0.05714285714285714,0.02857142857142857,0.9714285714285714,35,1000,800,200,0.8,12,8,4,412.0531240865176,0.46249999999999997,0.12949929759447798,0.21826891209650437,127370.1990370289,3497.231606774318,130867.43064380322,219,0,41.91428571428571,33,2,15,37.242397110598525,0.6000631313131313,47.64093137254901,1009.4362745098028,30.58897801544857,0
1003,4,1,2,33,0.02857142857142857,0.05714285714285714,0.9428571428571428,35,1150,800,350,0.6956521739130435,15,8,7,414.312650099042,0.46169467787114843,0.1245335966325416,0.22115446118878962,127679.65032980106,3579.858858371783,131259.50918817284,220,0,42.17142857142857,33,2,16,36.8663099713027,0.603219696969697,47.33455882352941,1010.6617647058825,30.62611408199644,0
1004,4,0,2,31,0.0,0.06060606060606061,0.9393939393939394,33,1200,1000,200,0.8333333333333334,14,10,4,428.4833669890528,0.45995107323232326,0.14358013120899704,0.22836750877988005,127617.73003472236,4336.414930555575,131954.14496527793,221,1,44.878787878787875,31,2,18,36.57216494845361,0.6075268817204301,47.39583333333334,1010.4166666666679,32.59408602150542,0
1005,4,2,2,31,0.06060606060606061,0.06060606060606061,0.9393939393939394,33,1350,1200,150,0.8888888888888888,15,12,3,426.62276515457836,0.4583727904040404,0.09136994275734933,0.22332152567030147,126888.8021736616,4360.193871762617,131248.99604542422,222,0,42.57575757575758,30,3,19,37.372431963713964,0.6027777777777779,48.118279569892465,1007.5268817204294,33.58422939068098,16
1006,4,3,1,33,0.08823529411764706,0.029411764705882353,0.9705882352941176,34,1150,1000,150,0.8695652173913043,13,10,3,407.60984970096854,0.4584818775995247,0.11384883784608424,0.21751727891423592,127668.66337510124,3607.9635290207075,131276.62690412195,223,0,41.911764705882355,30,4,18,37.046980981513514,0.6107638888888889,47.34543010752689,1010.618279569893,33.6872759856631,0
1007,4,1,1,33,0.029411764705882353,0.029411764705882353,0.9705882352941176,34,1500,1200,300,0.8,18,12,6,407.0162580986968,0.4589275103980986,0.12217705686925973,0.21830344563027015,127872.49835602364,3609.2371589200866,131481.73551494372,224,0,42.88235294117647,30,4,22,36.852159468438536,0.6128472222222222,47.143817204301065,1011.4247311827943,33.71415770609314,0
1008,4,3,1,35,0.08333333333333333,0.027777777777777776,0.9722222222222222,36,1150,700,450,0.6086956521739131,16,7,9,355.71256555443864,0.46249999999999997,0.11163336838415683,0.17853211412406114,125157.87810236192,1704.3350345854797,126862.21313694741,225,0,40.361111111111114,32,4,19,40.94374342797057,0.5797526041666667,49.84217171717171,1000.6313131313125,31.269728535353515,16
1009,4,2,2,35,0.05405405405405406,0.05405405405405406,0.9459459459459459,37,1050,800,250,0.7619047619047619,13,8,5,348.2070208717441,0.4620558058058058,0.1413487760910188,0.17748584513425228,125797.83767060726,1360.7380574778663,127158.57572808512,226,0,40.054054054054056,33,4,21,40.47051877188695,0.5839646464646464,49.203431372549005,1003.1862745098023,30.399584076054616,0
1010,4,3,2,36,0.07894736842105263,0.05263157894736842,0.9473684210526316,38,950,600,350,0.631578947368421,13,6,7,338.990509035805,0.46246740161213845,0.1483809025050189,0.17471049311845321,126253.12499999988,959.7222222222099,127212.84722222209,227,0,39.421052631578945,34,4,24,40.2328634604754,0.5863970588235294,48.74999999999999,1004.9999999999991,29.55882352941174,0
1011,4,1,2,35,0.02702702702702703,0.05405405405405406,0.9459459459459459,37,1150,900,250,0.782608695652174,14,9,5,338.11841322082563,0.46277527527527523,0.14940028786182635,0.17528224489055066,126492.5240929705,1153.890306122445,127646.41439909294,228,0,37.7027027027027,34,3,17,40.008629191321475,0.5888480392156863,48.51190476190476,1005.9523809523808,29.586834733893554,0
1012,4,4,0,39,0.10256410256410256,0.0,1.0,39,1250,1000,250,0.8,15,10,5,323.25510385049466,0.4656151596941071,0.1618523573662507,0.1708961053453858,127290.80590303171,429.4805362795563,127720.28643931127,229,0,36.48717948717949,36,3,22,39.564501729717676,0.5928819444444444,47.71959459459461,1009.1216216216241,28.031156156156225,0
1013,4,2,1,40,0.04878048780487805,0.024390243902439025,0.975609756097561,41,650,100,550,0.15384615384615385,12,1,11,309.256980703208,0.4661585365853658,0.17117488521177116,0.16576594446979467,127847.2279293596,-292.4704598582605,127554.75746950133,230,0,35.65853658536585,38,3,17,39.34982217057536,0.5948464912280702,47.16880341880343,1011.3247863247884,26.6138101664418,0
1014,4,1,3,38,0.024390243902439025,0.07317073170731707,0.926829268292683,41,1350,1100,250,0.8148148148148148,16,11,5,316.11130526799417,0.46592987804878044,0.1817002381105599,0.1704698131709873,128090.45041867571,-101.83210515741729,127988.6183135183,231,0,36.609756097560975,38,3,19,38.92854001759011,0.5973135964912281,46.92841880341881,1012.2863247863258,26.63911381016647,0
1015,4,0,0,38,0.0,0.0,1.0,38,1350,1000,350,0.7407407407407407,17,10,7,339.5393938650124,0.463356448553817,0.18571118624455352,0.1813576468882663,127705.45488522378,1072.2065489969154,128777.66143422069,232,1,39.55263157894737,35,3,19,38.72917382342838,0.5991071428571428,47.30902777777778,1010.7638888888889,28.878968253968253,0
1016,4,0,1,37,0.0,0.02631578947368421,0.9736842105263158,38,950,600,350,0.631578947368421,13,6,7,341.21630319701575,0.46341571834992884,0.18494570522941123,0.18238575227189338,127734.70320001725,1117.0326431755877,128851.73584319283,233,2,40.55263157894737,35,3,19,38.65687733760781,0.5994047619047619,47.280092592592595,1010.8796296296305,28.882275132275158,0
1017,4,2,0,39,0.05128205128205128,0.0,1.0,39,1150,900,250,0.782608695652174,14,9,5,324.9951577433408,0.46440620782726044,0.16884190600001148,0.1758728308509993,128230.06071950337,535.4861622289332,128765.5468817323,234,0,39.282051282051285,36,3,22,38.56135571862725,0.6024305555555556,46.79054054054055,1012.8378378378385,28.134384384384404,0
1018,4,0,2,37,0.0,0.05128205128205128,0.9487179487179487,39,1200,800,400,0.6666666666666666,16,8,8,362.8116702211037,0.46381578947368424,0.10594913244217286,0.18489281226141838,125789.53108513923,1535.3573167762427,127324.88840191546,235,1,40.282051282051285,36,3,18,40.112819937135164,0.5775462962962963,49.211711711711715,1003.1531531531534,27.865365365365374,16
1019,4,3,1,39,0.075,0.025,0.975,40,1650,1200,450,0.7272727272727273,21,12,9,356.01843615219724,0.4672275641025641,0.04556512192303308,0.17962842729008538,125376.44039619772,1382.9432883012898,126759.38368449901,236,0,39.975,35,5,16,40.70998979159443,0.5752976190476191,49.623842592592595,1001.5046296296299,28.614417989417998,16
1020,4,2,1,40,0.04878048780487805,0.024390243902439025,0.975609756097561,41,1600,1100,500,0.6875,21,11,10,354.86027625068607,0.4684959349593496,0.11334370207985422,0.18271311280928298,126213.51662050576,759.4042852012932,126972.92090570705,237,0,39.90243902439025,36,5,19,39.87494863461468,0.5818865740740741,48.78941441441442,1004.8423423423433,27.912287287287313,0
1021,4,1,3,38,0.024390243902439025,0.07317073170731707,0.926829268292683,41,1350,900,450,0.6666666666666666,18,9,9,349.5616495881537,0.4695121951219512,0.0007692655776279089,0.1728566322275364,124537.46570644707,985.1811771731539,125522.64688362023,238,0,40.46341463414634,35,6,12,41.74010513296227,0.5666666666666667,50.462962962962955,998.1481481481471,28.51851851851849,16
1022,4,1,2,37,0.02564102564102564,0.05128205128205128,0.9487179487179487,39,1200,900,300,0.75,15,9,6,355.8447712089299,0.4660931174089069,0.0380351559276344,0.17653351778070447,124672.83340419496,1072.8351757369542,125745.66857993191,239,0,43.23076923076923,34,5,14,41.4429113521675,0.5701593137254901,50.32738095238095,998.6904761904758,29.373249299719877,0
1023,4,3,3,37,0.075,0.075,0.925,40,1400,900,500,0.6428571428571429,19,9,10,345.1082142909097,0.46968482905982906,0.050277520814061116,0.1735171998364995,125231.58864883415,643.6899862825942,125875.27863511675,240,0,42.45,35,5,13,41.13282454517422,0.5738095238095238,49.768518518518526,1000.925925925927,28.59788359788363,0
1024,4,2,0,39,0.05128205128205128,0.0,1.0,39,1000,600,400,0.6,14,6,8,357.0288049712066,0.4688765182186235,0.07061650686769605,0.1795393655620758,125238.20861678013,1142.7295918367447,126380.93820861688,241,0,44.205128205128204,34,5,15,40.82768395179193,0.5759803921568627,49.761904761904766,1000.9523809523816,29.439775910364165,0
1025,4,2,2,39,0.04878048780487805,0.04878048780487805,0.9512195121951219,41,850,500,350,0.5882352941176471,12,5,7,347.13377383336757,0.4700711382113821,0.11106672430870601,0.17763205855055347,125959.03969848243,544.9273597922452,126503.96705827468,242,0,43.0,36,5,17,40.33122055194076,0.5792824074074074,49.0427927927928,1003.8288288288302,27.88413413413417,0
1026,4,3,1,41,0.07142857142857142,0.023809523809523808,0.9761904761904762,42,950,600,350,0.631578947368421,13,6,7,348.99714188902374,0.46934281842818426,0.03054353054353065,0.17809647962378017,125846.02127465299,507.58790885479743,126353.60918350778,243,0,42.45238095238095,36,6,18,40.40100074822297,0.578125,49.1554054054054,1003.3783783783781,27.871621621621614,16
1027,4,3,5,39,0.06818181818181818,0.11363636363636363,0.8863636363636364,44,1550,1300,250,0.8387096774193549,18,13,5,341.25006522375566,0.47080910852713176,0.0834569846028761,0.17840338009506126,126836.65242522949,-143.0861182127809,126693.5663070167,244,0,41.40909090909091,36,8,16,39.576346189677665,0.5882523148148149,48.17004504504506,1007.3198198198215,27.981106106106154,0
1028,4,3,4,38,0.07142857142857142,0.09523809523809523,0.9047619047619048,42,1750,1300,450,0.7428571428571429,22,13,9,350.8344980026938,0.470189701897019,0.07906495143554948,0.18348340680462277,126852.04790249432,500.81490929705365,127352.86281179138,245,0,43.23809523809524,34,8,18,39.31916213661073,0.5925245098039216,48.154761904761905,1007.3809523809523,29.628851540616242,0
1029,4,0,2,36,0.0,0.05263157894736842,0.9473684210526316,38,1350,900,450,0.6666666666666666,18,9,9,368.22650753222274,0.46572724039829305,0.07816803270568218,0.19116593084848754,126551.50183973576,1719.923509080712,128271.42534881647,246,1,47.39473684210526,32,6,18,39.19066591374912,0.5940755208333333,48.45328282828283,1006.1868686868688,31.44333964646465,0
1030,4,2,2,36,0.05263157894736842,0.05263157894736842,0.9473684210526316,38,1250,1000,250,0.8,15,10,5,351.6243253340892,0.4666311047889995,0.08325878435465373,0.1852587863327366,127152.04081632654,1341.9501133786798,128493.99092970522,247,0,47.31578947368421,34,4,20,38.99118665407616,0.5955882352941176,47.857142857142854,1008.5714285714287,29.66386554621849,0
1031,4,1,2,35,0.02702702702702703,0.05405405405405406,0.9459459459459459,37,950,600,350,0.631578947368421,13,6,7,353.55460853703397,0.4654341841841842,0.05238124960988677,0.17926129449243067,125579.37349965711,1547.3077373953724,127126.68123705249,248,0,48.83783783783784,35,2,19,40.56197074672826,0.5773809523809523,49.4212962962963,1002.3148148148152,28.63756613756615,16
1032,4,1,2,34,0.027777777777777776,0.05555555555555555,0.9444444444444444,36,1200,700,500,0.5833333333333334,17,7,10,383.5457591808258,0.4663359788359788,0.05018576570300737,0.1882324571979745,124219.97070312497,3205.7054558899167,127425.67615901488,249,0,47.361111111111114,31,5,15,41.22257053291537,0.5725806451612903,50.78125,996.8749999999998,32.15725806451612,16
1033,4,1,0,35,0.02857142857142857,0.0,1.0,35,1350,900,450,0.6666666666666666,18,9,9,382.93549733648393,0.4640756302521008,-0.03674867207156818,0.19374261300885465,125490.67666282196,2610.96693579392,128101.64359861589,250,0,49.6,33,2,16,39.91764514024787,0.5808080808080809,49.509803921568626,1001.9607843137252,30.362448009506824,16
1034,4,0,1,34,0.0,0.02857142857142857,0.9714285714285714,35,1400,1000,400,0.7142857142857143,18,10,8,379.6787350785998,0.46369047619047615,-0.035087474246603745,0.19295226151634165,125674.92821270657,2543.219554978843,128218.14776768541,251,1,50.6,33,2,17,39.80842092397946,0.5827020202020202,49.32598039215686,1002.6960784313718,30.38472964943551,0
1035,4,2,3,33,0.05555555555555555,0.08333333333333333,0.9166666666666666,36,1350,1000,350,0.7407407407407407,17,10,7,375.63013025737774,0.46507936507936504,-0.03166036508517289,0.19333279585563357,126197.70828827865,2281.2729779411884,128478.98126621984,252,0,49.888888888888886,33,3,20,39.36951152579584,0.5880681818181819,48.805147058823536,1004.7794117647068,30.44786096256687,0
1036,4,3,2,34,0.08333333333333333,0.05555555555555555,0.9444444444444444,36,900,600,300,0.6666666666666666,12,6,6,362.60967034086394,0.46279761904761907,-0.006346110914128289,0.18950218781680353,126822.06809807254,1997.3816609977343,128819.44975907028,253,0,49.77777777777778,34,2,19,39.053451128708204,0.592218137254902,48.18452380952381,1007.2619047619046,29.625350140056018,0
1037,4,3,1,36,0.08108108108108109,0.02702702702702703,0.972972972972973,37,900,500,400,0.5555555555555556,13,5,8,356.98610349718524,0.46305680680680683,0.01639161285179025,0.18850200792141086,127242.10778061225,1685.0198412698478,128927.1276218821,254,0,49.32432432432432,34,3,22,38.76352015732547,0.5965073529411764,47.767857142857146,1008.9285714285714,29.67436974789916,0
1038,4,0,0,36,0.0,0.0,1.0,36,700,200,500,0.2857142857142857,12,2,10,366.85586112325024,0.4621527777777778,0.015820478561885398,0.1937347212718228,127246.52364775569,2136.226601547485,129382.75024930318,255,1,51.27777777777778,33,3,22,38.51003583141018,0.598800505050505,47.763480392156865,1008.9460784313726,30.574123588829472,0
1039,4,2,2,36,0.05263157894736842,0.05263157894736842,0.9473684210526316,38,1000,700,300,0.7,13,7,6,347.2989758549202,0.46396396396396394,0.018844334648871364,0.18577198739085923,127763.9548637904,1274.45813507374,129038.41299886414,256,0,49.526315789473685,35,3,18,38.47321598931501,0.5997023809523809,47.25115740740741,1010.9953703703712,28.885582010582034,0
1040,4,2,3,35,0.05263157894736842,0.07894736842105263,0.9210526315789473,38,750,600,150,0.8,9,6,3,347.18116308819407,0.46294155998103365,0.021053803513459313,0.18628322621613877,127888.11404309727,1280.0688357276342,129168.18287882491,257,0,50.31578947368421,36,2,20,38.34915200771914,0.5989583333333333,47.128378378378386,1011.4864864864875,28.096846846846873,0
1041,4,0,0,35,0.0,0.0,1.0,35,1050,800,250,0.7619047619047619,13,8,5,367.2527445096582,0.459453781512605,0.026561632075948305,0.1956606429788745,127602.69451530621,2372.48795351475,129975.18246882096,258,1,55.02857142857143,34,1,20,38.13430344448372,0.6001838235294117,47.41071428571429,1010.3571428571436,29.71638655462187,0
1042,4,2,1,36,0.05405405405405406,0.02702702702702703,0.972972972972973,37,1300,1000,300,0.7692307692307693,16,10,6,348.524262217986,0.46258758758758756,0.031459966081065494,0.18834087524059046,128173.82979948979,1535.485852487846,129709.31565197764,259,0,53.0,35,2,22,38.02303596601517,0.6038690476190476,46.84606481481481,1012.61574074074,28.931878306878286,0
1043,4,1,3,34,0.02702702702702703,0.08108108108108109,0.9189189189189189,37,700,400,300,0.5714285714285714,10,4,6,353.8942855739083,0.4636511511511512,0.04802062962300324,0.1930773181941833,128555.0157000171,1698.9770876200205,130253.99278763712,260,0,53.108108108108105,35,2,17,37.49762230845317,0.6077380952380953,46.469907407407405,1014.12037037037,28.974867724867714,0
1044,4,3,1,36,0.08108108108108109,0.02702702702702703,0.972972972972973,37,950,600,350,0.631578947368421,13,6,7,338.37609757467726,0.46405780780780775,0.044560893875962515,0.18778884011600513,129231.6485969388,1347.4010932819663,130579.04969022077,261,0,49.270270270270274,34,3,20,37.20217187682942,0.6167279411764706,45.80357142857143,1016.7857142857146,29.905462184873958,0
1045,4,0,3,33,0.0,0.08333333333333333,0.9166666666666666,36,700,400,300,0.5714285714285714,10,4,6,343.5555724215757,0.4624669312169312,0.043737231786183495,0.1903712545689705,129171.13272392294,1675.492488662136,130846.62521258507,262,1,51.583333333333336,34,2,20,37.13208025920288,0.6161151960784313,45.86309523809524,1016.5476190476194,29.89845938375351,0
1046,4,0,3,30,0.0,0.09090909090909091,0.9090909090909091,33,800,300,500,0.375,13,3,10,407.7935017580015,0.460976957070707,-0.004357398403815882,0.20513876154425367,125252.65279053168,3633.304263127059,128885.95705365874,263,2,56.78787878787879,32,1,14,39.54233938782376,0.5807291666666667,49.747474747474755,1001.0101010101018,31.281565656565682,16
1047,4,2,2,30,0.0625,0.0625,0.9375,32,700,600,100,0.8571428571428571,8,6,2,405.61318398686996,0.45919438844086025,0.040628654021046984,0.2055302618266583,125553.99788750548,3785.2713690863775,129339.26925659186,264,0,59.25,31,1,17,39.28383894157896,0.5863575268817205,49.446614583333336,1002.2135416666672,32.329469086021525,0
1048,4,1,1,30,0.03225806451612903,0.03225806451612903,0.967741935483871,31,800,500,300,0.625,11,5,6,403.25442779596744,0.4602598566308244,0.038804681089951165,0.2066056636238599,126010.09690426638,3962.825904728871,129972.92280899525,265,0,58.54838709677419,30,1,18,38.86992414100848,0.59375,48.99193548387097,1004.0322580645161,33.46774193548387,0
1049,4,3,0,33,0.09090909090909091,0.0,1.0,33,1150,900,250,0.782608695652174,14,9,5,378.7664650347672,0.460976957070707,0.044064707222601696,0.19833047184891373,126901.11340679538,3013.177226813611,129914.290633609,266,0,55.63636363636363,32,1,18,38.565162907268174,0.59765625,48.106060606060616,1007.5757575757589,31.486742424242465,0
1050,4,2,2,33,0.05714285714285714,0.05714285714285714,0.9428571428571428,35,1050,700,350,0.6666666666666666,14,7,7,418.0411036814861,0.465126050420168,0.10388549461110719,0.19816481475197548,122748.32766439907,3338.6703303911054,126086.99799479017,267,0,53.4,34,1,16,41.905434086176506,0.5502450980392157,52.26190476190476,990.9523809523807,29.145658263305315,16
1051,4,6,3,36,0.15384615384615385,0.07692307692307693,0.9230769230769231,39,1400,1100,300,0.7857142857142857,17,11,6,355.7129271613377,0.47368421052631576,0.09868341489764809,0.17149353400941542,123468.2630750871,983.8514539930898,124452.1145290802,268,0,47.97435897435897,39,0,12,42.69828896342104,0.548344017094017,51.53645833333335,993.8541666666691,25.483440170940234,16
1052,4,9,8,37,0.2,0.17777777777777778,0.8222222222222222,45,950,700,250,0.7368421052631579,12,7,5,334.4197156938171,0.47239057239057236,0.19027643325804044,0.16818674114494342,125242.36543026284,-594.9683014772158,124647.39712878563,269,0,42.31111111111111,42,3,15,41.3891577928364,0.5620039682539683,49.75775193798451,1000.968992248064,23.83259505352533,0
1053,4,3,1,39,0.075,0.025,0.975,40,1050,700,350,0.6666666666666666,14,7,7,360.85202195625516,0.4711939102564102,0.193840115347645,0.18077354101532478,125080.14104618685,1027.084360618032,126107.22540680488,270,0,47.6,38,2,20,40.895679803481805,0.5666118421052632,49.9198717948718,1000.3205128205138,26.32422402159247,0
1054,4,4,5,38,0.09302325581395349,0.11627906976744186,0.8837209302325582,43,1450,1000,450,0.6896551724137931,19,10,9,350.54531306791995,0.4762827611664821,0.12452521608877398,0.17631560126705453,125246.83225848331,733.25761377305,125980.08987225636,271,0,45.093023255813954,37,6,17,40.98100832511773,0.5701013513513513,49.753289473684205,1000.9868421052627,27.05369843527737,16
1055,4,2,3,37,0.05,0.075,0.925,40,1100,900,200,0.8181818181818182,13,9,4,372.1992998191519,0.47381143162393163,0.1260983874737085,0.1759824092736078,122638.57408479079,1193.1903266650866,123831.76441145588,272,0,48.95,35,5,15,43.1560138661681,0.5470238095238096,52.37268518518518,990.5092592592591,28.300264550264547,16
1056,4,11,7,41,0.22916666666666666,0.14583333333333334,0.8541666666666666,48,1100,700,400,0.6363636363636364,15,7,8,313.30145502736883,0.4817154255319149,0.1819644492877226,0.15602974303463032,124834.3352290659,-1777.8442270718856,123056.49100199401,273,0,41.458333333333336,43,5,14,42.338375343504204,0.5564437984496124,50.16571969696968,999.3371212121185,23.240398167723686,0
1057,4,6,6,41,0.1276595744680851,0.1276595744680851,0.8723404255319149,47,1500,800,700,0.5333333333333333,22,8,14,321.5277777777778,0.48055427073697193,0.19875886524822706,0.16076388888888887,125000.0,-1361.8055555555557,123638.19444444444,274,0,43.212765957446805,42,5,16,41.96180555555556,0.5595238095238095,50.0,1000.0,23.80952380952381,0
1058,4,1,0,42,0.023809523809523808,0.0,1.0,42,1150,700,450,0.6086956521739131,16,7,9,359.4695805027717,0.4757428377855207,0.21623084283675098,0.17820846323564168,124643.89433527613,561.1376817866915,125205.03201706283,275,0,49.142857142857146,37,5,17,41.38243018191135,0.5639076576576576,50.3563596491228,998.5745614035078,26.988501659554267,0
1059,4,7,3,46,0.14285714285714285,0.061224489795918366,0.9387755102040817,49,1450,1000,450,0.6896551724137931,19,10,9,332.1287946597358,0.48074333900226757,0.2890639783236233,0.17196740144333034,126442.63058232583,-1377.498571261474,125065.13201106436,276,0,42.97959183673469,41,8,15,40.21051160649701,0.5757113821138211,48.56150793650795,1005.7539682539708,24.530584591560263,0
1060,4,0,4,42,0.0,0.08695652173913043,0.9130434782608696,46,1100,700,400,0.6363636363636364,15,7,8,346.64143321912104,0.47938808373590985,0.27419041675334554,0.1784434964108286,126204.81231508897,-450.4365959894592,125754.37571909951,277,1,46.47826086956522,38,8,17,40.0903774587985,0.578125,48.798076923076934,1004.8076923076941,26.44230769230774,0
1061,4,5,4,43,0.10638297872340426,0.0851063829787234,0.9148936170212766,47,1100,600,500,0.5454545454545454,16,6,10,344.1723811999182,0.4784921369102683,0.29202084728590294,0.17992809295641302,126835.9607376562,-669.3130742283017,126166.64766342791,278,0,45.851063829787236,40,7,19,39.50346381490449,0.58125,48.170731707317074,1007.3170731707321,25.182926829268304,0
1062,4,2,0,45,0.044444444444444446,0.0,1.0,45,1600,1200,400,0.75,20,12,8,353.7159943388255,0.4773148148148148,0.2941763956331571,0.18596507926156966,127065.75656467034,-10.961914062479337,127054.79465060786,279,0,47.68888888888889,39,6,23,39.02703877811068,0.5852029914529915,47.94270833333334,1008.2291666666683,25.852029914529957,0
1063,4,1,4,42,0.021739130434782608,0.08695652173913043,0.9130434782608696,46,1500,1100,400,0.7333333333333333,19,11,8,341.81847184864307,0.4770028180354267,0.2816488678394662,0.1817290974517178,127518.1870003449,-482.3747866320756,127035.81221371282,280,0,47.630434782608695,36,10,16,38.863260489835355,0.5951967592592593,47.494369369369366,1010.0225225225222,28.056181181181174,0
1064,4,1,1,42,0.023255813953488372,0.023255813953488372,0.9767441860465116,43,1200,700,500,0.5833333333333334,17,7,10,355.1452503859401,0.4741602067183463,0.27338397725683916,0.18864728610043377,127482.44224773235,454.95677437640484,127937.39902210876,281,0,49.674418604651166,34,9,17,38.56340131242877,0.5989583333333333,47.5297619047619,1009.8809523809517,29.702380952380935,0
1065,4,1,3,40,0.023255813953488372,0.06976744186046512,0.9302325581395349,43,1250,1100,150,0.88,14,11,3,358.10867294336106,0.4731912144702843,0.2872371019383042,0.19135939219396328,127723.00347222207,547.7430555555369,128270.7465277776,282,0,50.604651162790695,34,9,18,38.24196207749381,0.6014093137254901,47.29166666666666,1010.8333333333321,29.73039215686271,0
1066,4,1,2,39,0.024390243902439025,0.04878048780487805,0.9512195121951219,41,1500,1200,300,0.8,18,12,6,368.25035812672166,0.4707063008130081,0.29761419068736106,0.19702110600165065,127772.55893166082,1210.458117070342,128983.01704873117,283,0,53.073170731707314,33,8,20,37.934848484848466,0.6041666666666667,47.24264705882352,1011.0294117647053,30.637254901960766,0
1067,4,3,2,40,0.07142857142857142,0.047619047619047616,0.9523809523809523,42,1350,1000,350,0.7407407407407407,17,10,7,352.9227480590297,0.47230691056910573,0.27880815432171246,0.19260402887347014,128566.75347222204,675.3670463283112,129242.12051855035,284,0,51.976190476190474,34,8,21,37.510271158586676,0.6099877450980392,46.45833333333332,1014.1666666666652,29.828431372548977,0
1068,4,1,1,40,0.024390243902439025,0.024390243902439025,0.975609756097561,41,850,500,350,0.5882352941176471,12,5,7,368.55325001556275,0.4694359756097561,0.3063207358292799,0.2024598888016526,128827.88470780464,1295.9871203383204,130123.87182814296,285,0,54.02439024390244,33,8,22,36.847135039433425,0.6148989898989898,46.20098039215686,1015.1960784313721,30.7635175282234,0
1069,4,0,0,40,0.0,0.0,1.0,40,1050,800,250,0.7619047619047619,13,8,5,375.8437291156157,0.4700721153846154,0.3093656716417905,0.20640598238316601,128816.57483930213,1682.9803719008235,130499.55521120295,286,1,53.325,32,8,22,36.673662935323364,0.6171875,46.21212121212121,1015.1515151515154,31.723484848484855,0
1070,4,0,1,39,0.0,0.025,0.975,40,1600,1000,600,0.625,22,10,12,375.3282837311925,0.4698717948717949,0.31174002237970955,0.2066232297091021,128912.72454660236,1676.9183310376488,130589.64287764001,287,2,54.325,32,8,22,36.588493099589705,0.6181640625,46.11742424242424,1015.5303030303029,31.735321969696965,0
1071,4,0,2,37,0.0,0.05128205128205128,0.9487179487179487,39,1300,1000,300,0.7692307692307693,16,10,6,384.5389394674514,0.4699730094466936,0.31366512741576913,0.21111729380903163,128804.55864800341,2106.0736762152683,130910.63232421868,288,3,56.333333333333336,31,8,22,36.46528134085855,0.6196236559139785,46.22395833333333,1015.1041666666661,32.745295698924714,0
1072,4,1,1,37,0.02631578947368421,0.02631578947368421,0.9736842105263158,38,1000,700,300,0.7,13,7,6,375.6968997243729,0.4686166429587482,0.2785079545677467,0.2078339756619571,129105.13157139579,2100.879533976128,131206.01110537193,289,0,52.81578947368421,32,6,23,36.382625170828675,0.6201171875,45.928030303030305,1016.2878787878789,31.758996212121215,0
1073,4,0,0,37,0.0,0.0,1.0,37,1400,1000,400,0.7142857142857143,18,10,8,411.6047539161406,0.4684997497497498,0.27159378577956095,0.21223627892309196,126272.75466918937,3060.4995699515443,129333.25423914091,290,1,52.54054054054054,31,6,17,38.388095392321986,0.59375,48.73046874999999,1005.0781249999993,32.42187499999998,16
1074,4,5,2,40,0.11904761904761904,0.047619047619047616,0.9523809523809523,42,1400,1200,200,0.8571428571428571,16,12,4,371.07872224492155,0.47055265195509094,0.266876550276665,0.19849189459947264,127763.95486379022,1084.7461192859662,128848.70098307618,291,0,47.166666666666664,35,7,18,37.87218565159322,0.5997023809523809,47.251157407407405,1010.9953703703698,28.88558201058199,0
1075,4,0,0,40,0.0,0.0,1.0,40,800,500,300,0.625,11,5,6,390.85028058945653,0.4702857905982906,0.293539189517108,0.20783148468505136,127524.87775134544,1968.6268502498829,129493.50460159533,292,1,50.525,33,7,18,37.618296529968454,0.6016414141414141,47.487745098039206,1010.0490196078415,30.60754604872247,0
1076,4,3,2,41,0.06976744186046512,0.046511627906976744,0.9534883720930233,43,1250,800,450,0.64,17,8,9,368.54238278219407,0.4706764488741233,0.3064596360570502,0.20103416068046537,128548.1113784363,879.5909325740242,129427.70231101032,293,0,47.93023255813954,33,10,18,37.1333081570997,0.6120580808080809,46.47671568627452,1014.093137254903,30.730095068330396,0
1077,4,0,0,41,0.0,0.0,1.0,41,1700,1100,600,0.6470588235294118,23,11,12,370.85571533826635,0.4686737804878049,0.2955427239111823,0.2026840011583424,128624.38303489446,1340.2175160697973,129964.60055096426,294,1,49.80487804878049,32,9,18,36.99667040079662,0.615234375,46.401515151515156,1014.39393939394,31.699810606060623,0
1078,4,0,1,40,0.0,0.024390243902439025,0.975609756097561,41,1200,800,400,0.6666666666666666,16,8,8,375.570073414789,0.4671747967479675,0.29335023856394526,0.20642234862121095,128848.62075617274,1478.337191358014,130326.95794753075,295,2,50.80487804878049,32,9,19,36.64785681714546,0.6175130208333333,46.18055555555555,1015.2777777777769,31.72743055555553,0
1079,4,0,0,40,0.0,0.0,1.0,40,1550,1200,350,0.7741935483870968,19,12,7,380.4182140651088,0.46650641025641026,0.284629439671753,0.20937767477020336,128903.70898776574,1807.4637518988613,130711.1727396646,296,3,50.6,31,9,19,36.468484207377024,0.6206317204301075,46.12630208333333,1015.4947916666658,32.757896505376316,0
1080,4,0,1,39,0.0,0.025,0.975,40,1250,600,650,0.48,19,6,13,385.45334556185765,0.4654513888888889,0.2810994361865713,0.2130366790909869,129069.04432508664,1950.0189887152574,131019.06331380189,297,4,51.6,31,9,19,36.17162139073979,0.6223118279569892,45.96354166666666,1016.145833333332,32.778897849462325,0
1081,4,0,0,39,0.0,0.0,1.0,39,1200,800,400,0.6666666666666666,16,8,8,394.37992760080544,0.46353463787674315,0.2910098676734476,0.21775879274904952,129030.63441221527,2377.4184515550905,131408.05286377037,298,5,53.76923076923077,30,9,20,35.98414693301582,0.6246527777777777,46.001344086021504,1015.9946236559139,33.86648745519713,0
1082,4,1,3,37,0.025,0.075,0.925,40,1650,1100,550,0.6666666666666666,22,11,11,388.08891967110515,0.4635416666666667,0.27887715930902135,0.2164821489814195,129433.15505981445,2046.314663357205,131479.46972317167,299,0,53.4,31,9,16,35.73269886969502,0.626008064516129,45.60546875,1017.578125,32.825100806451616,0
1083,4,1,0,38,0.02631578947368421,0.0,1.0,38,1150,700,450,0.6086956521739131,16,7,9,395.4963000163261,0.46131164058795643,0.2706146718253992,0.22181165545697298,129645.87894915609,2654.8930873511563,132300.77203650726,300,0,51.78947368421053,30,8,18,35.32703136685584,0.6309027777777778,45.396505376344095,1018.4139784946246,33.94713261648749,0
1084,4,0,0,38,0.0,0.0,1.0,38,1150,900,250,0.782608695652174,14,9,5,395.49792400763675,0.46061522048364156,0.2693706701467462,0.22278345169583255,129817.03990345723,2668.4739565267914,132485.51385998403,301,1,52.78947368421053,30,8,18,35.152334476391445,0.6326388888888889,45.228494623655926,1019.0860215053779,33.96953405017926,0
1085,4,0,0,38,0.0,0.0,1.0,38,1000,700,300,0.7,13,7,6,394.83072312951555,0.46027441915599815,0.27391666377545687,0.22299263104522551,129919.79067305487,2659.264980055521,132579.05565311038,302,2,53.78947368421053,30,8,18,35.06454625357064,0.6336805555555556,45.12768817204302,1019.4892473118293,33.98297491039431,0
1086,4,0,0,38,0.0,0.0,1.0,38,950,700,250,0.7368421052631579,12,7,5,394.39822442504874,0.45987434803224275,0.266847931637211,0.22333535275651284,130022.5820904152,2656.135102323989,132678.7171927392,303,3,54.78947368421053,30,8,19,34.970787207872085,0.6347222222222222,45.02688172043012,1019.8924731182806,33.99641577060935,0
1087,4,0,0,38,0.0,0.0,1.0,38,1600,1200,400,0.75,20,12,8,394.2319577782832,0.4594298245614035,0.26599787781484263,0.22343736576395756,130056.85492903812,2654.5137082321776,132711.3686372703,304,4,55.78947368421053,30,8,19,34.94009970571442,0.6350694444444445,44.99327956989248,1020.0268817204308,34.000896057347695,0
1088,4,0,0,38,0.0,0.0,1.0,38,1650,1200,450,0.7272727272727273,21,12,9,395.8161313177277,0.45802216690374586,0.2625301293800901,0.2253306211619222,130229.35867309582,2709.3761867947183,132938.73485989054,305,5,56.78947368421053,31,7,21,34.723949695964635,0.6340725806451613,44.82421875000001,1020.7031250000009,32.92590725806455,0
1089,4,0,2,36,0.0,0.05263157894736842,0.9473684210526316,38,1300,800,500,0.6153846153846154,18,8,10,394.37426002095583,0.4580666192508298,0.18785057178529918,0.20793609864079393,127182.05959467117,2431.470366670423,129613.5299613416,306,6,57.78947368421053,34,4,18,37.88234194893582,0.5958946078431373,47.82738095238095,1008.6904761904759,29.667366946778703,15
1090,4,1,0,37,0.02702702702702703,0.0,1.0,37,1050,600,450,0.5714285714285714,15,6,9,405.43599744029035,0.45980355355355357,0.20785781533445147,0.21509254236384706,127432.05925905873,2933.108810313309,130365.16806937204,307,0,58.75675675675676,33,4,16,37.345627503337795,0.6006944444444444,47.57965686274508,1009.6813725490173,30.5964052287581,0
1091,4,0,2,35,0.0,0.05405405405405406,0.9459459459459459,37,850,500,350,0.5882352941176471,12,5,7,409.3218457615277,0.45949074074074076,0.2092135803926205,0.21798768064974344,127586.77551903091,3044.8108900422676,130631.58640907318,308,1,59.75675675675676,33,4,16,37.0880842633026,0.6022727272727273,47.42647058823528,1010.294117647057,30.61497326203203,0
1092,4,1,1,35,0.027777777777777776,0.027777777777777776,0.9722222222222222,36,1200,900,300,0.75,15,9,6,406.68320325128025,0.45858134920634924,0.18417881713047146,0.21808684057393177,127865.50132461046,3200.1503328046574,131065.65165741512,309,0,57.72222222222222,33,3,17,36.867780403085746,0.6051136363636364,47.15073529411763,1011.3970588235272,30.648395721925066,0
1093,4,2,3,34,0.05405405405405406,0.08108108108108109,0.9189189189189189,37,1450,900,550,0.6206896551724138,20,9,11,389.6569638374124,0.45830205205205204,0.18689739421902285,0.2124463731553468,128528.34093778691,2617.000858994943,131145.34179678187,310,0,56.21621621621622,32,5,17,36.61826049059892,0.6142578125,46.49621212121212,1014.0151515151512,31.687973484848474,0
1094,4,0,2,32,0.0,0.058823529411764705,0.9411764705882353,34,1000,700,300,0.7,13,7,6,409.90793708101495,0.45580808080808083,0.189794199530535,0.2232444454441943,128484.9788450975,3733.402524858336,132218.38136995584,311,1,57.38235294117647,30,4,18,36.14941004905209,0.6190972222222222,46.53897849462364,1013.8440860215038,33.79480286738346,0
1095,4,0,0,32,0.0,0.0,1.0,32,1600,1200,400,0.75,20,12,8,420.2068793438085,0.45415406586021506,0.16105374023838914,0.228716630300556,128461.13281249988,4396.050347222208,132857.1831597221,312,2,57.46875,29,3,18,35.91288190163036,0.6217672413793103,46.56249999999999,1013.7499999999991,34.95689655172411,0
1096,4,1,2,31,0.030303030303030304,0.06060606060606061,0.9393939393939394,33,750,500,250,0.6666666666666666,10,5,5,420.49191058620744,0.45565025252525254,0.03049662350677007,0.22069605011240606,126996.54571280998,4408.719653925627,131405.2653667356,313,0,56.696969696969695,32,1,16,37.41544532130777,0.5986328125,48.01136363636364,1007.954545454546,31.49857954545456,16
1097,4,0,2,29,0.0,0.06451612903225806,0.935483870967742,31,1150,700,450,0.6086956521739131,16,7,9,421.4137164505154,0.4542562724014337,0.022710758884063598,0.20366551511494524,123571.8112521701,4214.971245659717,127786.78249782982,314,1,59.58064516129032,31,0,17,40.9573074908329,0.5658602150537635,51.432291666666664,994.2708333333329,32.073252688172026,15
1098,4,5,4,30,0.14705882352941177,0.11764705882352941,0.8823529411764706,34,650,500,150,0.7692307692307693,8,5,3,381.46189380780925,0.4651478015448604,0.044522396114409446,0.18978124924297218,124791.75347222213,2720.659722222212,127512.41319444435,315,0,54.088235294117645,34,0,17,40.67973311092578,0.5713848039215687,50.20833333333333,999.1666666666658,29.38725490196076,0
1099,4,1,0,31,0.03225806451612903,0.0,1.0,31,1400,1100,300,0.7857142857142857,17,11,6,408.14172452322094,0.458915770609319,0.054903049188187,0.20264434749628626,124707.20291137672,3979.642571343287,128686.84548272,316,0,56.67741935483871,31,0,18,40.10138291400512,0.5776209677419355,50.292968749999986,998.8281249999982,32.220262096774135,0
1100,4,6,5,32,0.16216216216216217,0.13513513513513514,0.8648648648648649,37,1350,800,550,0.5925925925925926,19,8,11,356.3908043395253,0.46943818818818817,0.03852312027667448,0.18341087735521885,126193.31065759614,1616.202117850692,127809.51277544684,317,0,48.32432432432432,34,3,18,39.85732622432859,0.5857843137254901,48.809523809523796,1004.7619047619029,29.55182072829126,0
1101,4,2,1,33,0.058823529411764705,0.029411764705882353,0.9705882352941176,34,1300,1100,200,0.8461538461538461,15,11,4,375.6116437256834,0.46633615567439096,0.12284651873007313,0.177684166426459,122659.8657171203,2414.494756235839,125074.36047335614,318,0,52.3235294117647,34,0,16,43.04921283499579,0.5493259803921569,52.35119047619048,990.595238095239,29.135154061624675,16
1102,4,4,1,36,0.10810810810810811,0.02702702702702703,0.972972972972973,37,700,500,200,0.7142857142857143,9,5,4,413.4104214006102,0.46815565565565564,0.1959355669033087,0.19087247115730285,121614.15289256188,2833.209881748824,124447.3627743107,319,0,48.891891891891895,32,5,16,43.214765745007675,0.54296875,53.4090909090909,986.3636363636355,30.82386363636361,16
1103,4,8,7,37,0.18181818181818182,0.1590909090909091,0.8409090909090909,44,1350,1000,350,0.7407407407407407,17,10,7,344.17590724698914,0.47619362226920364,0.19349151896321803,0.1658302098553669,123442.38281249955,-302.82118055559874,123139.56163194394,320,0,41.72727272727273,39,5,17,43.01187980433265,0.5480769230769231,51.56249999999998,993.7499999999962,25.480769230769134,0
1104,4,11,3,45,0.22916666666666666,0.0625,0.9375,48,1050,700,350,0.6666666666666666,14,7,7,343.92140421246427,0.4776152482269504,0.3034909909909911,0.17413283729073217,125521.37586805577,-932.4652777777543,124588.91059027801,321,0,38.75,37,11,16,40.863218988218996,0.5729166666666667,49.47916666666668,1002.0833333333351,27.083333333333382,0
1105,4,2,0,47,0.0425531914893617,0.0,1.0,47,1200,800,400,0.6666666666666666,16,8,8,354.18559907604134,0.4778946962688868,0.3156904145448991,0.18049687165728706,125789.53108513923,-489.4319150231228,125300.09917011611,322,0,40.53191489361702,36,11,20,40.32915169884749,0.5775462962962963,49.211711711711715,1003.1531531531534,27.865365365365374,0
1106,4,0,2,45,0.0,0.0425531914893617,0.9574468085106383,47,1550,1300,250,0.8387096774193549,18,13,5,347.64246579028935,0.477586339808819,0.30711171839417073,0.17802094053556403,125988.78981994445,-640.1892890120174,125348.60053093242,323,1,41.53191489361702,37,10,21,40.28778942769769,0.5777027027027026,49.013157894736835,1003.9473684210514,27.133712660028415,0
1107,4,0,3,42,0.0,0.06666666666666667,0.9333333333333333,45,950,700,250,0.7368421052631579,12,7,5,367.33031538952105,0.475273569023569,0.2199169530355103,0.1781552029639175,123721.23602892821,89.31213017750554,123810.54815910572,324,2,44.111111111111114,38,7,16,42.14588702749142,0.5526315789473684,51.28205128205128,994.8717948717938,26.18083670715247,16
1108,4,7,4,45,0.14285714285714285,0.08163265306122448,0.9183673469387755,49,1800,1300,500,0.7222222222222222,23,13,10,337.75734754755774,0.47813917233560094,0.22668759811617,0.16207819026610956,123269.91705246881,-1176.7441011031133,122093.17295136569,325,0,41.12244897959184,41,8,15,43.35081585081584,0.5431910569105691,51.73611111111109,993.0555555555528,24.22086720867202,16
1109,4,2,2,45,0.0425531914893617,0.0425531914893617,0.9574468085106383,47,1150,900,250,0.782608695652174,14,9,5,336.7339302919777,0.4778946962688868,0.24172202588842473,0.16312287845432508,123671.18604838946,-1071.1430916110899,122600.04295677837,326,0,43.319148936170215,42,5,17,42.958881311901266,0.5458829365079365,51.33236434108527,994.6705426356584,23.682631967515675,0
1110,4,6,5,46,0.11764705882352941,0.09803921568627451,0.9019607843137255,51,1450,900,550,0.6206896551724138,20,9,11,328.4623479044932,0.48081699346405227,0.2879073466763995,0.16404886367588875,124953.70799039771,-1990.8062977170139,122962.9016926807,327,0,40.549019607843135,44,7,15,41.836258257702035,0.556344696969697,50.04629629629629,999.8148148148141,22.723063973063958,0
1111,4,3,5,44,0.061224489795918366,0.10204081632653061,0.8979591836734694,49,1700,1300,400,0.7647058823529411,21,13,8,341.7553726802731,0.4797689909297052,0.19926099936377417,0.1638068855260619,123220.6632653061,-906.7326030206357,122313.93066228546,328,0,43.02040816326531,41,8,12,43.30285771382895,0.5426829268292683,51.785714285714285,992.8571428571427,24.216027874564457,16
1112,4,10,7,47,0.18518518518518517,0.12962962962962962,0.8703703703703703,54,1250,900,350,0.72,16,9,7,314.3310159854377,0.48258793384579546,0.2767814228930079,0.15689799223443338,124928.98736118281,-2939.545613032576,121989.44174815023,329,0,39.5,43,11,15,42.21497979223897,0.5574127906976745,50.07102272727273,999.7159090909087,23.249207188160668,0
1113,4,6,5,48,0.11320754716981132,0.09433962264150944,0.9056603773584906,53,1400,1000,400,0.7142857142857143,18,10,8,336.1135883790089,0.48092041606192554,0.21719248357222432,0.16602793953128142,124492.38631105855,-1816.251125361888,122676.13518569666,330,0,40.132075471698116,40,13,19,42.1223693143245,0.5572916666666667,50.50813008130083,997.9674796747994,24.949186991869986,15
1114,4,6,6,48,0.1111111111111111,0.1111111111111111,0.8888888888888888,54,1350,800,550,0.5925925925925926,19,8,11,314.3219530358842,0.48083362450500816,0.2759430424296967,0.16005320390177338,125756.34901258704,-2890.272615467889,122866.07639711916,331,0,40.0,39,15,18,41.363004984941334,0.5718482905982907,49.24479166666668,1003.0208333333353,25.718482905982956,0
1115,4,1,1,48,0.02040816326530612,0.02040816326530612,0.9795918367346939,49,1450,1200,250,0.8275862068965517,17,12,5,343.87724079812665,0.4789363662131519,0.308545034642032,0.17435461974893313,125579.37349965711,-1163.2223079561022,124416.151191701,332,0,43.734693877551024,35,14,19,40.8044649730562,0.5773809523809523,49.4212962962963,1002.3148148148152,28.63756613756615,0
1116,4,2,0,50,0.04,0.0,1.0,50,1500,1200,300,0.8,18,12,6,339.4524440404942,0.48072278911564625,0.32789430027254385,0.17456667734660147,126163.40880102034,-1432.9898291621303,124730.4189718582,333,0,42.06,34,16,22,40.31357388316149,0.5854779411764706,48.83928571428571,1004.6428571428567,29.54831932773108,0
1117,4,3,4,49,0.05660377358490566,0.07547169811320754,0.9245283018867925,53,1450,1100,350,0.7586206896551724,18,11,7,305.09391689764703,0.4809506531204644,0.21031016893374233,0.14993186773255804,124276.41251837857,-2866.4501969659927,121409.96232141257,334,0,40.62264150943396,45,8,11,43.11939801356587,0.5481481481481482,50.72463768115942,997.1014492753629,22.157809983896954,16
1118,4,6,6,49,0.10909090909090909,0.10909090909090909,0.8909090909090909,55,1250,600,650,0.48,19,6,13,301.4833374237166,0.4828984287317621,0.2674714642210434,0.15173408269040986,125272.96631905045,-3433.855210577838,121839.11110847261,335,0,37.32727272727273,41,14,12,42.181874112245225,0.563770325203252,49.727182539682524,1001.0912698412673,24.41686024003091,0
1119,4,2,5,46,0.0392156862745098,0.09803921568627451,0.9019607843137255,51,1800,1200,600,0.6666666666666666,24,12,12,315.0832614813102,0.4808986928104575,0.27331650148848774,0.1581495084155386,125160.3077744904,-2312.816403681799,122847.4913708086,336,0,40.78431372549019,38,13,16,41.957612641469126,0.5674342105263157,49.839743589743584,1000.6410256410251,26.33265856950066,0
1120,4,1,5,42,0.02127659574468085,0.10638297872340426,0.8936170212765957,47,1400,800,600,0.5714285714285714,20,8,12,331.94444444444434,0.4796677459142769,0.2650709219858154,0.16597222222222205,124999.9999999999,-1101.388888888904,123898.611111111,337,0,44.234042553191486,37,10,17,41.70138888888887,0.5675675675675675,49.99999999999999,999.9999999999992,27.027027027027007,0
1121,4,3,4,41,0.06666666666666667,0.08888888888888889,0.9111111111111111,45,1350,1100,250,0.8148148148148148,16,11,5,339.3951006261741,0.4798611111111111,0.2645064506450645,0.1706189849754206,125225.3266780294,-499.82753023293253,124725.49914779648,338,0,45.955555555555556,36,9,14,41.28225322532252,0.5717592592592593,49.77477477477478,1000.9009009009011,27.80280280280281,0
1122,4,2,3,40,0.046511627906976744,0.06976744186046512,0.9302325581395349,43,1950,1600,350,0.8205128205128205,23,16,7,344.38934427460504,0.4805970837947582,0.249324896215388,0.17400407324557526,125434.40453800144,39.65446566356317,125474.05900366501,339,0,47.27906976744186,35,8,15,40.941291161178505,0.5758928571428572,49.565972222222214,1001.7361111111103,28.621031746031722,0
1123,4,5,6,39,0.1111111111111111,0.13333333333333333,0.8666666666666667,45,1150,800,350,0.6956521739130435,15,8,7,354.63418047921806,0.48135521885521887,0.28881670533642745,0.17488253064821863,124421.96609224973,125.90288494514016,124547.86897719487,340,0,44.355555555555554,35,10,18,41.733372003093585,0.5654761904761905,50.57870370370371,997.6851851851857,28.50529100529102,14
1124,4,6,5,40,0.13333333333333333,0.1111111111111111,0.8888888888888888,45,1350,900,450,0.6666666666666666,18,9,9,339.9172710013946,0.4850589225589226,0.2789909666779107,0.17146252359701672,125366.25888980206,-477.1686805048215,124889.09020929724,341,0,43.266666666666666,36,9,15,41.123636568087264,0.5732060185185186,49.63400900900901,1001.4639639639648,27.818443443443467,0
1125,4,3,2,41,0.06976744186046512,0.046511627906976744,0.9534883720930233,43,1050,600,450,0.5714285714285714,15,6,9,346.94697896361106,0.48265042451088963,0.29695885509839015,0.17566473355947027,125521.3758680554,109.85243055553633,125631.22829861093,342,0,45.674418604651166,35,8,19,40.78742203742201,0.5767857142857142,49.47916666666666,1002.0833333333321,28.630952380952348,0
1126,4,3,1,43,0.06818181818181818,0.022727272727272728,0.9772727272727273,44,1450,800,650,0.5517241379310345,21,8,13,334.4613708080218,0.4828994890768146,0.295001324017681,0.17256660091516743,126298.3993283822,-350.5277765096429,125947.87155187257,343,0,41.38636363636363,36,8,16,40.300106430652036,0.5827546296296297,48.70495495495494,1005.1801801801782,27.921671671671618,0
1127,4,0,1,42,0.0,0.023255813953488372,0.9767441860465116,43,950,500,450,0.5263157894736842,14,5,9,344.15269014509016,0.4820967146548542,0.3025988010478786,0.1772202642846777,126218.23157793179,87.66878858021573,126305.900366512,344,1,43.348837209302324,35,8,22,40.139080856945405,0.5839285714285714,48.78472222222221,1004.8611111111086,28.710317460317388,0
1128,4,4,3,43,0.08695652173913043,0.06521739130434782,0.9347826086956522,46,1550,1200,350,0.7741935483870968,19,12,7,321.1013781389031,0.48253824476650564,0.30836974234229975,0.169967693258689,127340.90206842478,-1019.1180886854222,126321.78397973935,345,0,40.84782608695652,37,9,17,39.56760365743254,0.5914977477477478,47.66995614035087,1009.3201754385956,27.278923660502585,0
1129,4,2,3,42,0.044444444444444446,0.06666666666666667,0.9333333333333333,45,1650,1100,550,0.6666666666666666,22,11,11,332.4907474748546,0.4824074074074074,0.3198751532716526,0.17701925789892745,127575.06397867498,-516.4943237155654,127058.56965495941,346,0,42.355555555555554,36,9,18,39.04061234347714,0.595775462962963,47.43806306306308,1010.2477477477507,28.06243743743752,0
1130,4,1,2,41,0.023255813953488372,0.046511627906976744,0.9534883720930233,43,1250,1000,250,0.8,15,10,5,344.3086406631945,0.4814968623108158,0.3298010069527688,0.18350515463917527,127617.73003472228,187.97743055556003,127805.70746527784,347,0,43.46511627906977,35,8,20,38.698453608247426,0.5982142857142857,47.395833333333336,1010.4166666666672,28.869047619047635,0
1131,4,0,0,41,0.0,0.0,1.0,41,1550,900,650,0.5806451612903226,22,9,13,352.0805326296713,0.4803099593495935,0.3201470883966784,0.18799771836640963,127692.92091836748,791.6383219954754,128484.55924036296,348,1,45.09756097560975,34,7,21,38.42510797016096,0.6011029411764706,47.32142857142858,1010.7142857142868,29.726890756302552,0
1132,4,1,1,41,0.023809523809523808,0.023809523809523808,0.9761904761904762,42,1900,1400,500,0.7368421052631579,24,14,10,345.2756084006968,0.4805337785520712,0.3168958870994094,0.18617635456673792,128085.94419795931,444.99046210560357,128530.93466006492,349,0,45.0,35,7,22,38.195079655461555,0.6029761904761906,46.93287037037036,1012.2685185185167,28.921957671957617,0
1133,4,1,0,42,0.023809523809523808,0.0,1.0,42,1000,800,200,0.8,12,8,4,346.8556012115068,0.48011033681765386,0.3143265769926167,0.18758427206015837,128204.80619331075,493.7244219961781,128698.53061530693,350,0,45.61904761904762,34,8,23,38.03362916813606,0.6063112745098039,46.8154761904762,1012.7380952380961,29.786414565826355,0
1134,4,0,0,42,0.0,0.0,1.0,42,1700,1300,400,0.7647058823529411,21,13,8,344.9069975679298,0.47989256678281067,0.31182976246445926,0.1866710391417268,128234.94897959182,445.82624716553255,128680.77522675735,351,1,46.61904761904762,34,8,23,38.05217638301205,0.6066176470588236,46.785714285714285,1012.8571428571427,29.78991596638655,0
1135,4,1,1,42,0.023255813953488372,0.023255813953488372,0.9767441860465116,43,1650,1200,450,0.7272727272727273,21,12,9,343.5103238618875,0.47856681432262826,0.3177498686786684,0.18796576148397642,128672.41753472209,240.06076388887038,128912.47829861096,352,0,46.51162790697674,35,8,19,37.641170431211506,0.6089285714285715,46.35416666666666,1014.5833333333322,28.988095238095205,0
1136,4,1,2,41,0.023255813953488372,0.046511627906976744,0.9534883720930233,43,1250,700,550,0.56,18,7,11,339.1383474647789,0.47780546327057954,0.30399868008239217,0.18711724969295235,129001.10995708554,149.84465039364852,129150.95460747919,353,0,46.93023255813954,36,7,20,37.41732254369433,0.6102430555555556,46.03040540540541,1015.878378378379,28.21884384384386,0
1137,4,2,1,42,0.046511627906976744,0.023255813953488372,0.9767441860465116,43,1050,700,350,0.6666666666666666,14,7,7,337.43591371565543,0.47752860834256183,0.3102804727932127,0.18726307656298366,129230.80800165031,121.57850525622155,129352.38650690654,354,0,47.72093023255814,35,8,23,37.2269256308101,0.6145833333333333,45.804398148148145,1016.7824074074069,29.050925925925913,0
1138,4,0,0,42,0.0,0.0,1.0,42,1100,800,300,0.7272727272727273,14,8,6,345.35982258500565,0.4771825396825397,0.30844203816278304,0.19096366660582684,129086.92476260054,516.287486811146,129603.21224941168,355,1,49.404761904761905,36,6,23,37.17193964243499,0.6111111111111112,45.94594594594595,1016.2162162162169,28.228228228228247,0
1139,4,1,1,42,0.023255813953488372,0.023255813953488372,0.9767441860465116,43,2050,1400,650,0.6829268292682927,27,14,13,342.5903005645005,0.4766519010705057,0.3045781909324532,0.19169365672807548,129554.63927469133,276.9340145325435,129831.57328922387,356,0,49.23255813953488,35,8,17,36.76671214188266,0.6178571428571429,45.48611111111111,1018.0555555555554,29.087301587301585,0
1140,4,0,3,39,0.0,0.07142857142857142,0.9285714285714286,42,600,400,200,0.6666666666666666,8,4,4,345.1148140337305,0.4760090011614402,0.2928415519622256,0.19315588282830243,129564.73922902482,542.9421768707309,130107.68140589555,357,1,49.714285714285715,34,8,17,36.692196757093846,0.6200980392156863,45.47619047619047,1018.0952380952372,29.943977591036386,0
1141,4,0,1,38,0.0,0.02564102564102564,0.9743589743589743,39,1400,900,500,0.6428571428571429,19,9,10,362.8396532120245,0.47466824111560957,0.27465434267817646,0.20186714407983897,129329.78777675744,1585.1950693806732,130914.98284613811,358,2,48.666666666666664,32,7,25,36.48031487917908,0.6223958333333333,45.707070707070706,1017.1717171717169,31.786616161616152,0
1142,4,0,0,38,0.0,0.0,1.0,38,1000,700,300,0.7,13,7,6,363.144281928788,0.4737138454243717,0.2605781795158477,0.2023972481449039,129400.03289116766,1798.176405164937,131198.2092963326,359,3,49.0,31,7,25,36.401011005886865,0.6256720430107527,45.638020833333336,1017.4479166666677,32.820900537634444,0
1143,4,0,0,38,0.0,0.0,1.0,38,1200,700,500,0.5833333333333334,17,7,10,362.40489034155337,0.4730915125651968,0.251233552631579,0.20294673859126972,129586.776859504,1792.5763314967694,131379.35319100076,360,4,50.0,32,6,21,36.22969370039684,0.625,45.454545454545446,1018.181818181817,31.81818181818178,0
1144,4,2,3,37,0.05,0.075,0.925,40,1100,900,200,0.8181818181818182,13,9,4,343.5987709246669,0.4720886752136752,0.24906111499883377,0.19561858312802755,130232.20663265305,949.5252267573669,131181.7318594104,361,0,48.45,34,6,23,36.05352422051163,0.6268382352941176,44.82142857142857,1020.7142857142856,30.02100840336134,0
1145,4,1,2,36,0.02631578947368421,0.05263157894736842,0.9473684210526316,38,1000,600,400,0.6,14,6,8,373.5598221884231,0.47165422000948315,0.12885091985092578,0.19099350278172209,125924.32149943318,2031.650368480733,127955.97186791392,362,0,50.026315789473685,34,4,20,39.70392005693275,0.5830269607843137,49.077380952380956,1003.6904761904768,29.52030812324932,16
1146,4,2,2,36,0.05263157894736842,0.05263157894736842,0.9473684210526316,38,600,300,300,0.5,9,3,6,375.6238841838989,0.47119487908961594,0.17775262452463525,0.19449496640361244,126444.09789804397,1899.1413262608871,128343.23922430485,363,0,50.55263157894737,33,5,19,39.11536391698144,0.5905934343434344,48.56004901960784,1005.7598039215682,30.477569815805097,0
1147,4,1,1,36,0.02702702702702703,0.02702702702702703,0.972972972972973,37,1350,1000,350,0.7407407407407407,17,10,7,381.1569315852138,0.4731293793793794,0.2028958981554918,0.19865002434382326,126710.35640495871,2259.3061294765866,128969.66253443531,364,0,52.5945945945946,32,5,20,38.70156132430398,0.595703125,48.29545454545455,1006.8181818181822,31.463068181818194,0
1148,4,1,0,37,0.02702702702702703,0.0,1.0,37,1600,1100,500,0.6875,21,11,10,378.68725787037516,0.4729416916916917,0.1932200828517836,0.1990709310223369,127061.12320081204,2223.2856653690706,129284.40886618111,365,0,52.91891891891892,33,4,21,38.40238948989102,0.5969065656565656,47.94730392156862,1008.2107843137243,30.551841948900737,0
1149,4,2,2,37,0.05128205128205128,0.05128205128205128,0.9487179487179487,39,1200,700,500,0.5833333333333334,17,7,10,359.2298600268825,0.47351551956815113,0.20075888237323203,0.1923429964361978,127803.53597474529,1382.176776960781,129185.71275170607,366,0,51.15384615384615,33,6,22,38.131110370460156,0.6044823232323233,47.21200980392157,1011.1519607843137,30.64096850861557,0
1150,4,0,0,37,0.0,0.0,1.0,37,1250,1000,250,0.8,15,10,5,367.59895146732555,0.47128378378378377,0.19095497746340984,0.1963061778849861,127697.47865332624,1988.291851596785,129685.77050492303,367,1,54.189189189189186,32,5,22,38.02831563606079,0.6057942708333333,47.3169191919192,1010.7323232323237,31.585385101010115,0
1151,4,2,0,39,0.05128205128205128,0.0,1.0,39,1000,700,300,0.7,13,7,6,346.997261231846,0.47199730094466935,0.19243327720773618,0.1883992352676384,128361.76478097356,1109.0173354655917,129470.78211643915,368,0,52.35897435897436,33,6,24,37.86972931027533,0.6101641414141414,46.66053921568627,1013.3578431372541,30.70781342840164,0
1152,4,1,1,39,0.025,0.025,0.975,40,1050,700,350,0.6666666666666666,14,7,7,337.1737226527139,0.4720886752136752,0.186094171455377,0.1851307361918667,128808.3351048752,686.1571712017974,129494.49227607698,369,0,52.025,34,6,20,37.66345138970329,0.6124387254901961,46.22023809523809,1015.1190476190468,29.856442577030787,0
1153,4,0,1,38,0.0,0.02564102564102564,0.9743589743589743,39,800,400,400,0.5,12,4,8,347.85072644809856,0.471631803868646,0.18837685278936456,0.19063877337635354,128734.59314025844,1156.08434856785,129890.67748882629,370,1,53.97435897435897,33,6,21,37.46767198003464,0.6139520202020202,46.29289215686274,1014.828431372548,30.752376708259032,0
1154,4,0,1,37,0.0,0.02631578947368421,0.9736842105263158,38,1300,900,400,0.6923076923076923,17,9,8,347.430590972451,0.47055772878141294,0.1829149417912379,0.19134476252975974,128929.21095521528,1358.790391156443,130288.00134637173,371,2,55.60526315789474,34,4,21,37.27996913218459,0.6136642156862745,46.10119047619047,1015.595238095237,29.870448179271676,0
1155,4,0,0,37,0.0,0.0,1.0,37,1150,500,650,0.43478260869565216,18,5,13,353.1112167918134,0.4691253753753754,0.19503683724752863,0.19443406335905375,128921.21006644091,1704.7050713667966,130625.91513780771,372,3,57.972972972972975,33,4,21,37.14389505651423,0.6158459595959596,46.10906862745099,1015.563725490197,30.77465834818779,0
1156,4,0,0,37,0.0,0.0,1.0,37,1150,800,350,0.6956521739130435,15,8,7,352.884945066412,0.4693756256256256,0.19359803819263233,0.19446212930255488,128952.32602845074,1701.0668973471877,130653.39292579793,373,4,58.972972972972975,33,4,22,37.117921492921475,0.6161616161616161,46.078431372549026,1015.6862745098051,30.77837195484258,0
1157,4,2,2,37,0.05128205128205128,0.05128205128205128,0.9487179487179487,39,950,500,450,0.5263157894736842,14,5,9,336.43951318142416,0.4699167791273054,0.18638582250135616,0.1879700812526966,129495.73072059326,913.4961205418365,130409.2268411351,374,0,56.8974358974359,35,4,20,36.9830755818361,0.6172619047619048,45.54398148148148,1017.8240740740739,29.080687830687825,0
1158,4,0,1,36,0.0,0.02702702702702703,0.972972972972973,37,1250,900,350,0.72,16,9,7,341.77007858291046,0.4658408408408408,0.17125548571500882,0.19069521094821942,129443.56575963728,1447.987528344685,130891.55328798197,375,1,58.189189189189186,34,3,20,36.90044454843239,0.6188725490196079,45.5952380952381,1017.6190476190484,29.92997198879554,0
1159,4,0,1,35,0.0,0.027777777777777776,0.9722222222222222,36,1050,700,350,0.6666666666666666,14,7,7,406.1009841964101,0.4645171957671958,0.09821652851042462,0.20968716187884678,126329.27284205689,3467.1919215344506,129796.46476359134,376,2,58.416666666666664,32,4,19,38.467878673700085,0.591796875,48.67424242424242,1005.30303030303,31.41571969696969,16
1160,4,0,0,35,0.0,0.0,1.0,35,1100,700,400,0.6363636363636364,15,7,8,401.01349769547795,0.46362044817927167,0.07378492662299907,0.19707537265525082,124277.66692654772,2967.4043799297215,127245.07130647745,377,8,61.02857142857143,35,0,15,40.727050686786605,0.5639880952380952,50.72337962962964,997.1064814814833,28.488756613756667,16
1161,4,3,0,38,0.07894736842105263,0.0,1.0,38,1150,800,350,0.6956521739130435,15,8,7,382.2950522776323,0.4646603840682788,0.08871831488754034,0.19155786072086745,125089.30165816336,1972.5766727730324,127061.8783309364,378,0,57.13157894736842,34,4,18,40.34992463009243,0.5744485294117647,49.91071428571429,1000.3571428571436,29.422268907563048,0
1162,4,2,1,39,0.05,0.025,0.975,40,1000,700,300,0.7,13,7,6,366.53348001120446,0.46786858974358975,0.10363319856244413,0.18627934395089996,125676.58875091319,1212.93548616185,126889.52423707503,379,0,55.225,36,4,18,40.13622154836778,0.5763888888888888,49.32432432432433,1002.7027027027036,27.852852852852877,0
1163,4,6,4,41,0.13333333333333333,0.08888888888888889,0.9111111111111111,45,700,300,400,0.42857142857142855,11,3,8,366.66229859396884,0.47148569023569026,0.053476765033677376,0.18978705432866141,126429.50234687589,1113.1624969985623,127542.66484387445,380,0,48.977777777777774,37,8,15,39.355738479430144,0.5822072072072072,48.57456140350877,1005.7017543859643,27.181128496917953,15
1164,4,2,1,42,0.046511627906976744,0.023255813953488372,0.9767441860465116,43,1250,1100,150,0.88,14,11,3,365.16816373796087,0.47090716131413807,0.0868207185469192,0.1905910914393143,126769.03558514123,658.4031886916398,127427.43877383287,381,0,51.86046511627907,38,5,17,39.04360280076385,0.5838815789473684,48.23717948717948,1007.0512820512811,26.50134952766529,0
1165,4,4,2,44,0.08695652173913043,0.043478260869565216,0.9565217391304348,46,1350,900,450,0.6666666666666666,18,9,9,353.3309714179114,0.4715780998389694,0.12548260728141813,0.18935337300333543,127839.4088205027,-164.4318437022289,127674.97697680046,382,0,49.32608695652174,37,9,17,38.243499042249425,0.5965653153153153,47.17653508771931,1011.2938596491247,27.33226647700337,0
1166,4,0,4,40,0.0,0.09090909090909091,0.9090909090909091,44,1250,1000,250,0.8,15,10,5,351.6516939033234,0.4709742776603241,0.023712761629220758,0.17324143959813368,124380.72921587579,-52.261176461365494,124328.46803941442,383,1,52.27272727272727,41,3,15,41.85055113542183,0.5546239837398375,50.62003968253966,997.5198412698383,24.329752226093618,16
1167,4,2,1,41,0.047619047619047616,0.023809523809523808,0.9761904761904762,42,1700,1200,500,0.7058823529411765,22,12,10,354.9875865294962,0.47052845528455284,0.07306108608244943,0.17641698562107905,124746.06405743913,456.6608417608347,125202.72489919997,384,0,55.07142857142857,40,2,19,41.38839437097322,0.5598958333333333,50.254065040650396,998.9837398373966,24.974593495934915,0
1168,4,4,5,40,0.08888888888888889,0.1111111111111111,0.8888888888888888,45,1200,500,700,0.4166666666666667,19,5,14,329.2926259583456,0.47131734006734005,0.09717160954241422,0.16732058985484982,125668.6267829098,-722.3585963176472,124946.26818659216,385,0,52.266666666666666,38,7,17,41.07796128573966,0.5726425438596492,49.33226495726497,1002.6709401709415,26.386077372919516,0
1169,4,3,2,41,0.06976744186046512,0.046511627906976744,0.9534883720930233,43,1350,1000,350,0.7407407407407407,17,10,7,360.36593907956535,0.47282207456626063,0.162986037135334,0.18631774580436805,126383.31056986029,509.40737893591114,126892.7179487962,386,0,54.04651162790697,36,7,14,39.56163437488333,0.5836226851851851,48.62049549549549,1005.5180180180172,27.931056056056033,0
1170,4,3,3,41,0.06818181818181818,0.06818181818181818,0.9318181818181819,44,1350,1000,350,0.7407407407407407,17,10,7,353.8268994187517,0.4739032769556026,0.18608665545553515,0.18538592962704237,126926.2236938287,181.98243690364578,127108.20613073235,387,0,53.56818181818182,37,7,17,39.16757344940152,0.5872747747747749,48.081140350877185,1007.6754385964898,27.234471313418645,0
1171,4,0,0,41,0.0,0.0,1.0,41,1300,700,600,0.5384615384615384,19,7,12,367.2227438468401,0.47299288617886176,0.17848715563545348,0.1914483121128041,126723.24087178371,1107.1312444200685,127830.37211620378,388,1,57.292682926829265,36,5,17,39.03902434477874,0.5870949074074074,48.282657657657644,1006.8693693693674,27.96859359359354,0
1172,4,2,1,42,0.046511627906976744,0.023255813953488372,0.9767441860465116,43,750,500,250,0.6666666666666666,10,5,5,372.333789868287,0.4755214101144334,0.17520407250166525,0.18569056172748918,124893.18522171103,833.1447611019413,125726.32998281297,389,0,55.58139534883721,38,5,19,40.802470785235855,0.5646929824561404,50.106837606837615,999.5726495726509,26.3045434098066,16
1173,4,3,1,44,0.06666666666666667,0.022222222222222223,0.9777777777777777,45,1400,800,600,0.5714285714285714,20,8,12,352.80542769283136,0.47502104377104376,0.1856907648555608,0.17979352116062586,125789.53108513913,-123.97150885760561,125665.55957628152,390,0,53.06666666666667,36,9,18,40.36376478072143,0.5775462962962963,49.21171171171171,1003.1531531531525,27.86536536536535,0
1174,4,2,3,43,0.043478260869565216,0.06521739130434782,0.9347826086956522,46,1000,700,300,0.7,13,7,6,352.7178766585995,0.47676127214170694,0.19137637094642024,0.1697388046200666,123390.63042534716,40.21385458514868,123430.84427993231,391,0,52.869565217391305,39,7,15,42.85358565737051,0.5475427350427351,51.61458333333333,993.5416666666661,25.475427350427335,16
1175,4,7,7,43,0.14,0.14,0.86,50,1200,700,500,0.5833333333333334,17,7,10,321.87762645827536,0.4795068027210884,0.251713039263209,0.1604720984493529,124878.90531105404,-1958.2290046984813,122920.67630635556,392,0,47.24,42,8,19,42.07808208111165,0.5582837301587302,50.12112403100775,999.5155038759691,23.797988187523075,0
1176,4,5,4,44,0.10416666666666667,0.08333333333333333,0.9166666666666666,48,1300,1100,200,0.8461538461538461,15,11,4,336.35523268674626,0.480007018321513,0.2899851978809598,0.17105609218570056,125704.1137695315,-1143.6353444264814,124560.47842510502,393,0,44.041666666666664,39,9,15,40.86434420553307,0.5713141025641026,49.296875000000014,1002.8125000000019,25.713141025641075,0
1177,4,2,0,46,0.043478260869565216,0.0,1.0,46,1900,1600,300,0.8421052631578947,22,16,6,350.98755560237316,0.4774557165861513,0.2942631528874513,0.17782850655242177,125548.84676054165,-386.78343336411524,125162.06332717753,394,0,46.869565217391305,37,9,17,40.65782275711162,0.5731981981981982,49.45175438596491,1002.1929824561399,27.086296823138916,0
1178,4,6,2,50,0.11538461538461539,0.038461538461538464,0.9615384615384616,52,1200,600,600,0.5,18,6,12,321.2134885294742,0.4800229386626445,0.3087408552597517,0.16827703109410583,126921.08464222391,-2245.273269484601,124675.8113727393,395,0,42.34615384615385,42,10,18,39.99443055421993,0.5791170634920635,48.086240310077514,1007.6550387596891,23.991786637135455,0
1179,4,3,7,46,0.05660377358490566,0.1320754716981132,0.8679245283018868,53,1100,600,500,0.5454545454545454,16,6,10,346.1127623464175,0.48082970488630866,0.3060924204939224,0.1752962480481778,125534.10590794162,-1742.1796898239168,123791.9262181177,396,0,41.9811320754717,40,13,14,40.7951779738363,0.56796875,49.46646341463414,1002.1341463414627,25.05335365853657,15
1180,4,3,4,45,0.061224489795918366,0.08163265306122448,0.9183673469387755,49,1400,1100,300,0.7857142857142857,17,11,6,362.29290396978985,0.48074333900226757,0.3340684734913957,0.18387294362252396,125620.13660620085,-697.7431823715528,124922.39342382929,397,0,45.87755102040816,36,13,16,40.30086871864001,0.5758101851851851,49.380630630630634,1002.4774774774779,27.84659659659661,0
1181,4,1,1,45,0.021739130434782608,0.021739130434782608,0.9782608695652174,46,1450,800,650,0.5517241379310345,21,8,13,387.1785001293547,0.47920692431562,0.2857254694732305,0.1943767317598558,125168.97598612128,807.7643099180264,125976.74029603931,398,0,48.15217391304348,36,10,18,40.145078400480145,0.5711805555555556,49.83108108108108,1000.675675675676,27.796546546546555,16
1182,4,2,3,44,0.0425531914893617,0.06382978723404255,0.9361702127659575,47,1450,1100,350,0.7586206896551724,18,11,7,380.15195486207574,0.4805157261794635,0.29702574216896616,0.19363196453665182,125768.72210680199,162.2451138811789,125930.96722068316,399,0,47.297872340425535,37,10,17,39.699478938930184,0.5754504504504505,49.23245614035087,1003.0701754385956,27.110004741583666,0
1183,4,3,4,43,0.06382978723404255,0.0851063829787234,0.9148936170212766,47,1750,1500,250,0.8571428571428571,20,15,5,353.38489420171373,0.4797641073080481,0.19237339395268793,0.17702426390292414,125078.13720703125,-559.8551432291664,124518.28206380208,400,0,47.723404255319146,39,8,15,41.08449182547122,0.5649038461538461,49.921875,1000.3125,25.64903846153846,16
1184,4,4,6,41,0.0851063829787234,0.1276595744680851,0.8723404255319149,47,1100,700,400,0.6363636363636364,15,7,8,343.15358826961,0.4801302806043786,0.23441815249331643,0.17484492354689665,125782.47070312512,-767.4587673610963,125015.01193576402,214,0,39.97872340425532,39,8,16,40.613101419176196,0.5721153846153846,49.21875000000001,1003.1250000000009,25.721153846153868,0
1185,4,3,1,43,0.06818181818181818,0.022727272727272728,0.9772727272727273,44,1100,1000,100,0.9090909090909091,12,10,2,342.75516323129096,0.47748194150810425,0.2310501267194185,0.175638659980789,126017.01754145657,-161.40331653152748,125855.61422492504,215,0,40.68181818181818,38,6,19,40.381375469958165,0.5762061403508771,48.98504273504273,1004.0598290598284,26.4226270805218,0
1186,4,2,4,41,0.044444444444444446,0.08888888888888889,0.9111111111111111,45,1400,1000,400,0.7142857142857143,18,10,8,329.5914641567612,0.47861952861952867,0.23062986553432463,0.17134390686295184,126607.70052596962,-654.2336684564387,125953.46685751318,216,0,40.48888888888889,38,7,16,40.104830148619975,0.5822368421052632,48.39743589743589,1006.4102564102552,26.484480431848823,0
1187,4,2,3,40,0.046511627906976744,0.06976744186046512,0.9302325581395349,43,1050,900,150,0.8571428571428571,12,9,3,332.54506131446647,0.4794435215946844,0.22395781892222444,0.17341063589158104,126732.93856042232,-171.11743517237733,126561.82112524995,217,0,41.55813953488372,37,6,19,39.90197012595736,0.5853040540540541,48.273026315789465,1006.9078947368412,27.21372688477949,0
1188,4,1,0,41,0.024390243902439025,0.0,1.0,41,1250,1000,250,0.8,15,10,5,341.6638209647373,0.47784552845528455,0.2252403556338125,0.17807870452799568,126713.00482520986,458.64987890086843,127171.65470411073,218,0,44.048780487804876,35,6,20,39.69290052496454,0.5889880952380953,48.29282407407406,1006.8287037037022,28.76653439153435,0
1189,4,3,2,42,0.06818181818181818,0.045454545454545456,0.9545454545454546,44,1350,900,450,0.6666666666666666,18,9,9,321.824371880662,0.47890239605355883,0.22851616468637803,0.17116894421273965,127534.65008464114,-590.6822911175024,126943.96779352364,219,0,41.97727272727273,37,7,14,39.35129903025041,0.5934684684684685,47.47807017543858,1010.0877192982432,27.299668089141708,0
1190,4,0,4,38,0.0,0.09523809523809523,0.9047619047619048,42,1300,900,400,0.6923076923076923,17,9,8,359.1116457972348,0.47824719318621756,0.2496198026209353,0.17365585062374478,123596.30534250455,505.84158044863227,124102.14692295318,220,1,43.404761904761905,36,6,18,42.480417138542855,0.5549768518518519,51.40765765765765,994.3693693693683,27.621371371371342,16
1191,4,5,2,41,0.11627906976744186,0.046511627906976744,0.9534883720930233,43,1400,1100,300,0.7857142857142857,17,11,6,337.046452944911,0.48082779623477295,0.23979295016185076,0.16787713103550023,124839.79495397749,-184.6379848783873,124655.1569690991,221,0,39.2093023255814,38,5,17,41.73949647209751,0.5641447368421053,50.1602564102564,999.3589743589731,26.298920377867713,0
1192,4,2,4,39,0.046511627906976744,0.09302325581395349,0.9069767441860466,43,1100,700,400,0.6363636363636364,15,7,8,345.38214942459456,0.4827427094868955,0.1836909996568934,0.16815166592210168,123882.71620008702,-36.84576412000456,123845.87043596701,222,0,38.44186046511628,39,4,15,42.52391353632589,0.5526175213675213,51.11979166666668,995.5208333333351,25.52617521367526,15
1193,4,3,4,38,0.07142857142857142,0.09523809523809523,0.9047619047619048,42,1200,800,400,0.6666666666666666,16,8,8,355.24530950310975,0.4819250871080139,0.2450895040331904,0.1753665006967717,124465.66234731344,443.2173767411758,124908.87972405461,223,0,40.023809523809526,36,6,15,41.6727795959824,0.5639467592592593,50.534909909909906,997.8603603603597,27.718343343343324,0
1194,4,6,5,39,0.13636363636363635,0.11363636363636363,0.8863636363636364,44,1400,1100,300,0.7857142857142857,17,11,6,342.3653958521288,0.48418780831571534,0.24605240887685276,0.17242903637759477,125301.71693453776,-219.06110170422198,125082.65583283354,224,0,38.20454545454545,37,7,14,41.12900649801043,0.5706644144144144,49.69846491228071,1001.206140350879,27.05962541488862,0
1195,4,7,5,41,0.15217391304347827,0.10869565217391304,0.8913043478260869,46,950,400,550,0.42105263157894735,15,4,11,332.6335573978005,0.4839774557165861,0.27655195354187656,0.1719063376535259,126365.89055309036,-791.1016793002492,125574.78887379011,225,0,37.04347826086956,38,8,12,40.27667091701201,0.5797697368421053,48.637820512820525,1005.4487179487203,26.459176788124218,0
1196,4,2,3,40,0.046511627906976744,0.06976744186046512,0.9302325581395349,43,1000,800,200,0.8,12,8,4,358.3729785661136,0.4823966408268734,0.2946205932371384,0.1836352572928431,126015.56793279776,432.1148851554371,126447.68281795319,226,0,40.53488372093023,36,7,21,39.990840436668165,0.5798611111111112,48.98648648648649,1004.0540540540547,27.890390390390408,0
1197,4,7,6,41,0.14893617021276595,0.1276595744680851,0.8723404255319149,47,1300,800,500,0.6153846153846154,18,8,10,316.8487091783346,0.4845821769966081,0.26212171689431973,0.16825022467155157,127469.34125940531,-1313.1446368539291,126156.19662255138,227,0,35.48936170212766,38,9,13,39.54365919029482,0.5910087719298245,47.54273504273504,1009.8290598290594,26.57444894286998,0
1198,4,1,4,38,0.023809523809523808,0.09523809523809523,0.9047619047619048,42,1050,700,350,0.6666666666666666,14,7,7,355.0481471175462,0.4810540069686411,0.3015088307109457,0.18492268165439638,126683.87372470857,595.7749271262004,127279.64865183477,228,0,40.666666666666664,35,7,16,39.38596995477887,0.5886904761904762,48.32175925925926,1006.7129629629635,28.76322751322753,0
1199,4,0,0,38,0.0,0.0,1.0,38,850,500,350,0.5882352941176471,12,5,7,378.61549216351136,0.48124110953058324,0.2863007178836312,0.19549523661516716,126329.27284205692,1966.0439623507773,128295.31680440769,229,1,42.10526315789474,32,6,16,39.15865988445114,0.591796875,48.67424242424242,1005.3030303030303,31.415719696969695,0
1200,4,5,4,39,0.11627906976744186,0.09302325581395349,0.9069767441860466,43,1650,1200,450,0.7272727272727273,21,12,9,333.2811118817328,0.4816122185308232,0.2755881828417497,0.17853323571494176,127822.46823827585,-75.24576418826118,127747.22247408758,230,0,38.093023255813954,35,8,21,38.76771679829078,0.600297619047619,47.19328703703703,1011.2268518518515,28.89219576719576,0
1201,4,0,2,37,0.0,0.05128205128205128,0.9487179487179487,39,1000,700,300,0.7,13,7,6,356.06050800021865,0.479251012145749,0.2587377613634181,0.18909508253557417,127474.24529384756,1277.708907254364,128751.95420110192,231,1,40.0,32,7,21,38.54869967491873,0.603515625,47.53787878787879,1009.8484848484848,31.55776515151515,0
1202,4,1,1,37,0.02631578947368421,0.02631578947368421,0.9736842105263158,38,900,800,100,0.8888888888888888,10,8,2,366.0030556465486,0.47941856330014226,0.2582391506267925,0.1955458858213458,127716.42261081262,1748.9201863606668,129465.34279717329,232,0,40.8421052631579,31,7,23,38.04921314783804,0.6085349462365591,47.29817708333333,1010.8072916666658,32.60668682795696,0
1203,4,0,0,37,0.0,0.0,1.0,37,1050,800,250,0.7619047619047619,13,8,5,378.80507079611635,0.47869744744744747,0.2648770894081527,0.20180564969343764,127600.75451280494,2267.162569372185,129867.91708217713,233,1,42.67567567567568,30,7,23,37.84449691809677,0.6100694444444444,47.41263440860215,1010.3494623655913,33.67831541218638,0
1204,4,1,1,37,0.02631578947368421,0.02631578947368421,0.9736842105263158,38,650,600,50,0.9230769230769231,7,6,1,366.70219334004497,0.47879623044096725,0.2570223611950495,0.19691809470780422,127920.90730537691,1781.7754565860546,129702.68276196296,234,0,42.526315789473685,32,6,24,37.82191296388752,0.6080729166666667,47.09595959595959,1011.6161616161609,31.613005050505027,0
1205,4,0,0,37,0.0,0.0,1.0,37,1350,1000,350,0.7407407407407407,17,10,7,372.9043112737422,0.4781031031031031,0.2444222629526973,0.2005425192324047,127979.78931003141,2144.8430379231713,130124.63234795458,235,1,40.67567567567568,31,6,25,37.604689443658046,0.6112231182795699,47.037760416666664,1011.8489583333328,32.64028897849461,0
1206,4,1,0,38,0.02631578947368421,0.0,1.0,38,750,400,350,0.5333333333333333,11,4,7,362.49610427702305,0.477759009009009,0.24213164320646174,0.19655624999160373,128309.37915378135,1702.4359809027683,130011.81513468412,236,0,40.578947368421055,31,7,26,37.53065694212399,0.6145833333333333,46.71223958333333,1013.1510416666657,32.682291666666636,0
1207,4,1,1,38,0.02564102564102564,0.02564102564102564,0.9743589743589743,39,1350,1000,350,0.7407407407407407,17,10,7,354.5937124193187,0.4768049932523617,0.23265491904545144,0.19433425099565702,128734.59314025841,1329.6954596789487,130064.28859993735,237,0,40.51282051282051,33,6,21,37.29659763313608,0.6139520202020202,46.292892156862735,1014.8284313725478,30.752376708259025,0
1208,4,0,0,38,0.0,0.0,1.0,38,1000,600,400,0.6,14,6,8,356.30151481398957,0.47612908961593176,0.21948153967007045,0.1956737827257156,128816.57483930212,1579.5081496786033,130396.08298898072,238,1,40.44736842105263,32,6,22,37.16962064676615,0.6171875,46.21212121212121,1015.1515151515152,31.72348484848485,0
1209,4,1,0,39,0.02564102564102564,0.0,1.0,39,750,500,250,0.6666666666666666,10,5,5,347.9044774707897,0.47511808367071523,0.2157271965544001,0.19247310418047098,129107.96215698286,1183.447622308722,130291.40977929159,239,0,40.38461538461539,33,6,23,37.08587061377063,0.617739898989899,45.92524509803921,1016.299019607843,30.796939988116453,0
1210,4,1,5,35,0.025,0.125,0.875,40,700,500,200,0.7142857142857143,9,5,4,412.8080877163758,0.47562767094017094,0.1214556661925088,0.21182779975519117,126073.7244897958,2432.917388769223,128506.64187856502,240,0,40.35,34,6,16,38.56413979769245,0.5845588235294117,48.92857142857142,1004.2857142857133,29.53781512605039,16
1211,4,2,1,36,0.05405405405405406,0.02702702702702703,0.972972972972973,37,1150,800,350,0.6956521739130435,15,8,7,385.97354233235853,0.47519394394394393,0.11337619670953014,0.19634306283863454,125715.30612244896,2459.3218537414955,128174.62797619046,241,0,43.4054054054054,34,3,18,39.6088061886673,0.5808823529411764,49.285714285714285,1002.8571428571427,29.495798319327726,15
1212,4,4,1,39,0.1,0.025,0.975,40,1900,1300,600,0.6842105263157895,25,13,12,370.15852302156924,0.4774706196581197,0.18237806948059299,0.1798290746531946,123792.34544933458,1243.406139695967,125035.75158903055,242,0,40.925,36,4,17,42.00143336728149,0.5570023148148149,51.21058558558559,995.1576576576585,27.643268268268294,16
1213,4,6,3,42,0.13333333333333333,0.06666666666666667,0.9333333333333333,45,1500,1200,300,0.8,18,12,6,335.34569369337027,0.4840909090909091,0.19444870717478424,0.16800432529185164,125082.25036790171,-587.3929169691917,124494.85745093251,243,0,37.22222222222222,37,8,18,41.53136303847418,0.5684121621621622,49.91776315789474,1000.3289473684215,27.035917496443822,0
1214,4,5,8,39,0.10638297872340426,0.1702127659574468,0.8297872340425532,47,1450,900,550,0.6206896551724138,20,9,11,323.08104889967433,0.48300185013876046,0.21374865041344182,0.16484647006648515,125839.82051234404,-1268.7077591050113,124571.11275323902,244,0,36.255319148936174,40,7,17,41.05747155542049,0.57109375,49.16158536585367,1003.3536585365871,25.08384146341468,0
1215,4,8,2,45,0.1702127659574468,0.0425531914893617,0.9574468085106383,47,1050,800,250,0.7619047619047619,13,8,5,332.11043883207304,0.48028445883441256,0.25185733783340636,0.16361442736190546,124380.729215876,-944.5160140249554,123436.21320185105,245,0,34.787234042553195,41,6,16,42.337870876844065,0.5546239837398375,50.62003968253968,997.5198412698398,24.329752226093653,16
1216,4,9,7,47,0.16666666666666666,0.12962962962962962,0.8703703703703703,54,1250,900,350,0.72,16,9,7,299.9723927031795,0.48528855112974606,0.2928998122546518,0.15425120667438358,126160.0865912207,-3215.432929859198,122944.6536613615,246,0,31.074074074074073,44,10,19,41.3085637480799,0.568655303030303,48.84259259259259,1004.6296296296283,22.832491582491553,0
1217,4,5,4,48,0.09615384615384616,0.07692307692307693,0.9230769230769231,52,1350,900,450,0.6666666666666666,18,9,9,336.8049563188295,0.4821911136249371,0.3385352605483696,0.16730582659962,124727.33139841605,-1972.469571033128,122754.86182738292,247,0,32.59615384615385,41,11,17,41.861882179627216,0.558180894308943,50.27281746031747,998.9087301587318,24.363627564847118,16
1218,4,4,4,48,0.07692307692307693,0.07692307692307693,0.9230769230769231,52,1650,1200,450,0.7272727272727273,21,12,9,345.40541139524794,0.48294526143790845,0.3741081325818487,0.1741875600761914,125355.94408916683,-1739.9779947416916,123615.96609442514,248,0,33.40384615384615,40,12,19,40.99688789662406,0.5661458333333333,49.64430894308945,1001.422764227645,25.035569105691124,0
1219,4,6,4,50,0.1111111111111111,0.07407407407407407,0.9259259259259259,54,1450,800,650,0.5517241379310345,21,8,13,325.7207604872265,0.4860601560680177,0.3735335667342299,0.16787146886649376,126253.12500000003,-2569.7004717760587,123683.42452822397,249,0,32.888888888888886,39,15,24,40.56626589275842,0.5769230769230769,48.75,1005.0000000000002,25.769230769230774,0
1220,4,4,9,45,0.07407407407407407,0.16666666666666666,0.8333333333333334,54,1550,900,650,0.5806451612903226,22,9,13,349.5754493714865,0.48606743535988817,0.3356931134708907,0.17237685951766413,124419.28069226617,-1827.7773083047844,122591.50338396139,250,0,31.12962962962963,42,12,15,41.86233326858325,0.5535714285714286,50.58139534883721,997.6744186046518,23.754152823920283,16
1221,4,11,10,46,0.19642857142857142,0.17857142857142858,0.8214285714285714,56,1600,1200,400,0.75,20,12,8,337.1137325576966,0.48824404761904766,0.39741852735024286,0.17329013241460353,126145.90691924439,-2689.4881654891706,123456.41875375522,170,0,22.714285714285715,40,16,20,40.39032203675603,0.57421875,48.856707317073166,1004.5731707317063,25.114329268292657,0
1222,4,1,2,45,0.02127659574468085,0.0425531914893617,0.9574468085106383,47,1550,1000,550,0.6451612903225806,21,10,11,358.6168271679275,0.4849290780141844,0.2683571280060988,0.17757317087186086,124593.82642606915,-463.71145647432104,124130.11496959483,171,0,26.638297872340427,40,7,18,41.45566130564604,0.5583333333333333,50.40650406504065,998.3739837398375,24.959349593495936,14
1223,4,2,5,42,0.0425531914893617,0.10638297872340426,0.8936170212765957,47,1300,700,600,0.5384615384615384,19,7,12,355.7463184509135,0.4856806968855998,0.28199977077760496,0.17776475506544148,124974.59478691606,-508.1496009319594,124466.4451859841,172,0,27.425531914893618,40,7,20,41.132652369820796,0.5622395833333333,50.02540650406505,999.8983739837415,24.997459349593537,0
1224,4,5,4,43,0.10638297872340426,0.0851063829787234,0.9148936170212766,47,1400,1200,200,0.8571428571428571,16,12,4,330.6906809557411,0.4847748997841505,0.29642293040973766,0.16979409403332854,126098.89581409634,-1050.9423119185515,125047.95350217778,173,0,27.72340425531915,37,10,23,40.599981804949046,0.5788288288288288,48.90350877192981,1004.3859649122782,27.14556661925076,0
1225,4,1,3,41,0.022727272727272728,0.06818181818181818,0.9318181818181819,44,650,300,350,0.46153846153846156,10,3,7,354.99750757514505,0.48538803735024666,0.17924071082391024,0.16929388073113594,123004.82053336599,362.75202907219045,123367.57256243817,174,0,28.818181818181817,38,6,21,43.199380721593975,0.5452302631578947,52.00320512820512,991.9871794871776,26.10492577597836,15
1226,4,6,2,45,0.1276595744680851,0.0425531914893617,0.9574468085106383,47,1700,1100,600,0.6470588235294118,23,11,12,326.7883075120253,0.4862588652482269,0.2552644708873566,0.1612190176362811,124439.73177596965,-1255.8154585798932,123183.91631738975,175,0,27.78723404255319,38,9,17,42.40951922047329,0.560032894736842,50.56089743589743,997.7564102564094,26.256747638326562,0
1227,4,6,2,49,0.11764705882352941,0.0392156862745098,0.9607843137254902,51,1750,1100,650,0.6285714285714286,24,11,13,314.8028389345828,0.48704248366013075,0.24741576532873277,0.15568950070571375,124543.10120464025,-2090.2404649159166,122452.86073972433,176,0,26.49019607843137,40,11,14,42.60164257109886,0.5578125,50.457317073170735,998.1707317073183,24.954268292682958,16
1228,4,3,7,45,0.057692307692307696,0.1346153846153846,0.8653846153846154,52,1250,1000,250,0.8,15,10,5,341.6121970253026,0.48878990698843644,0.16285103785103838,0.16956387234165016,124695.30785246873,-1553.8787262872625,123141.42912618147,177,0,26.134615384615383,40,12,18,41.7749881291548,0.559375,50.30487804878049,998.7804878048778,24.969512195121943,16
1229,4,7,10,42,0.1346153846153846,0.19230769230769232,0.8076923076923077,52,1550,1200,350,0.7741935483870968,19,12,7,348.8108920587107,0.4880593262946204,0.2838572243282229,0.18054703735679983,126429.50234687589,-1571.6343625911445,124857.86798428475,178,0,26.73076923076923,37,15,14,39.80456825119929,0.5822072072072072,48.57456140350877,1005.7017543859644,27.181128496917957,0
1230,4,2,3,41,0.045454545454545456,0.06818181818181818,0.9318181818181819,44,1350,700,650,0.5185185185185185,20,7,13,362.68010320970023,0.48604871388301624,0.15141245615698185,0.18021254869331693,124739.7189670136,248.1228298610771,124987.84179687468,179,0,30.636363636363637,35,9,18,41.20285888077859,0.56875,50.26041666666665,998.958333333331,28.5416666666666,16
1231,4,1,3,39,0.023809523809523808,0.07142857142857142,0.9285714285714286,42,1200,900,300,0.75,15,9,6,358.16352716398603,0.48524003097173823,0.144921957023868,0.1796097687817433,125122.5790561322,563.4113832420163,125685.99043937422,180,0,31.571428571428573,33,9,20,40.91897354238119,0.577020202020202,49.877450980392155,1000.4901960784309,30.31788472964942,0
1232,4,2,1,40,0.04878048780487805,0.024390243902439025,0.975609756097561,41,1200,800,400,0.6666666666666666,16,8,8,344.34161454838494,0.48422256097560973,0.16534041667135635,0.17557371264149388,125811.49798525355,464.42686899860223,126275.92485425215,181,0,32.048780487804876,35,6,18,40.55337640363021,0.5797619047619047,49.1898148148148,1003.2407407407389,28.66402116402111,0
1233,4,4,1,43,0.09090909090909091,0.022727272727272728,0.9772727272727273,44,1100,600,500,0.5454545454545454,16,6,10,320.2356085590999,0.4825471282593376,0.1804230814896901,0.1675583582825176,126870.98434133574,-674.06428948699,126196.92005184875,182,0,30.568181818181817,37,7,18,40.070381657234066,0.5867117117117118,48.1359649122807,1007.4561403508768,27.22854433380748,0
1234,4,2,3,42,0.044444444444444446,0.06666666666666667,0.9333333333333333,45,1450,1000,450,0.6896551724137931,19,10,9,328.2904795402703,0.4812920875420876,0.22412312442707627,0.17460807722430519,127534.65008464128,-626.1253462604038,126908.52473838087,183,0,30.755555555555556,37,8,15,39.18801563178463,0.5934684684684685,47.47807017543859,1010.0877192982443,27.29966808914174,0
1235,4,2,7,37,0.045454545454545456,0.1590909090909091,0.8409090909090909,44,1650,1300,350,0.7878787878787878,20,13,7,322.96791230574723,0.4805210535588442,0.21099392100259173,0.1735599840911549,127950.32035097336,-535.2304314789175,127415.08991949444,184,0,29.931818181818183,37,7,17,38.897957985621915,0.5976914414414414,47.06688596491228,1011.7324561403507,27.344120436225694,0
1236,4,1,1,37,0.02631578947368421,0.02631578947368421,0.9736842105263158,38,1150,800,350,0.6956521739130435,15,8,7,376.21639734250306,0.47878141299193927,0.21298290917739737,0.19808266467829294,127124.83935885967,1965.2898152669322,129090.1291741266,185,0,34.71052631578947,31,7,21,38.39910157090594,0.602486559139785,47.884114583333336,1008.4635416666673,32.53108198924733,0
1237,4,2,3,36,0.05128205128205128,0.07692307692307693,0.9230769230769231,39,1200,800,400,0.6666666666666666,16,8,8,363.75084571657203,0.47812640575798465,0.2078768308153618,0.19409745127436273,127665.57621671249,1487.6922635445271,129153.26848025701,186,0,33.666666666666664,32,7,19,38.15826461769115,0.60546875,47.348484848484844,1010.6060606060599,31.581439393939373,0
1238,4,0,2,34,0.0,0.05555555555555555,0.9444444444444444,36,1050,700,350,0.6666666666666666,14,7,7,380.556040145792,0.4755952380952381,0.20436058979250804,0.20205777594454646,127464.9909852294,2501.514445311583,129966.50543054097,187,1,36.25,30,6,19,37.939793247260305,0.6086805555555556,47.54704301075268,1009.8118279569883,33.660394265232945,0
1239,4,0,1,33,0.0,0.029411764705882353,0.9705882352941176,34,650,300,350,0.46153846153846156,10,3,7,386.33021787455164,0.47524881164587046,0.18698374687517716,0.20518677970532234,127477.43296682088,3049.6768904320834,130527.10985725296,188,2,35.411764705882355,29,5,20,37.78122564525741,0.6117097701149425,47.534722222222214,1009.8611111111103,34.82279693486587,0
1240,4,1,2,32,0.029411764705882353,0.058823529411764705,0.9411764705882353,34,750,600,150,0.8,9,6,3,382.34553659209644,0.47554590017825316,0.17543575979044812,0.20395499444604764,127652.81635802449,2961.4969135802257,130614.31327160471,189,0,36.029411764705884,29,5,21,37.70157595748581,0.6135057471264368,47.3611111111111,1010.5555555555538,34.846743295019095,0
1241,4,3,2,33,0.08571428571428572,0.05714285714285714,0.9428571428571428,35,900,700,200,0.7777777777777778,11,7,4,362.0656913657084,0.47535014005602244,0.15487042165691545,0.19762646601594258,128573.35620456262,2310.4002210828817,130883.7564256455,190,0,33.714285714285715,31,4,20,37.271713313647446,0.617271505376344,46.45182291666666,1014.1927083333325,32.715893817204275,0
1242,4,0,1,32,0.0,0.030303030303030304,0.9696969696969697,33,1100,800,300,0.7272727272727273,14,8,6,372.7494645617368,0.472103851010101,0.13990896637058614,0.20300716326275658,128484.97884509753,2978.541413747227,131463.52025884477,191,1,34.57575757575758,30,3,20,37.09123248928364,0.6190972222222222,46.53897849462364,1013.844086021504,33.79480286738347,0
1243,4,1,1,32,0.030303030303030304,0.030303030303030304,0.9696969696969697,33,1050,700,350,0.6666666666666666,14,7,7,362.60473072287397,0.46993371212121215,0.10953857632493236,0.19940703033688076,128870.65463595914,2745.8218044704813,131616.47644042963,192,0,34.121212121212125,31,2,22,36.954454133538526,0.6202956989247312,46.158854166666664,1015.3645833333328,32.75369623655912,0
1244,4,1,0,33,0.030303030303030304,0.0,1.0,33,1250,900,350,0.72,16,9,7,361.48102306337034,0.469302398989899,0.11517869275716763,0.19995459851237476,129102.12410820865,2733.5935804579044,131835.71768866654,193,0,35.0,31,2,23,36.74687700192183,0.6226478494623655,45.930989583333336,1016.2760416666674,32.7830981182796,0
1245,4,0,2,31,0.0,0.06060606060606061,0.9393939393939394,33,1100,500,600,0.45454545454545453,17,5,12,361.50704717186807,0.468710542929293,0.11877546269351646,0.20080867983017725,129267.58660210513,2746.2287055121624,132013.8153076173,194,1,36.0,31,2,23,36.57757148954333,0.6243279569892473,45.76822916666667,1016.9270833333342,32.80409946236562,0
1246,4,1,0,32,0.03125,0.0,1.0,32,950,500,450,0.5263157894736842,14,5,9,370.19618382155306,0.46748991935483875,0.11065573770491777,0.20529061102831597,129201.38888888895,3165.972222222227,132367.36111111118,195,0,36.96875,30,2,25,36.424180327868854,0.6263888888888889,45.833333333333336,1016.6666666666672,33.88888888888891,0
1247,4,1,4,29,0.030303030303030304,0.12121212121212122,0.8787878787878788,33,1150,700,450,0.6086956521739131,16,7,9,361.2815269256989,0.46606691919191917,0.11092520294974317,0.20306513409961682,129731.44531249987,2773.9149305555406,132505.36024305542,196,0,36.81818181818182,31,2,20,36.1111111111111,0.6290322580645161,45.31249999999999,1018.749999999999,32.86290322580642,0
1248,4,0,0,29,0.0,0.0,1.0,29,850,500,350,0.5882352941176471,12,5,7,421.1700483111674,0.465311986863711,-0.010834611388710336,0.2124135482437654,125359.4534449729,4942.906148847269,130302.35959382016,197,1,38.06896551724138,28,1,19,39.09642515542802,0.5930059523809523,49.64080459770115,1001.4367816091954,35.76559934318555,16
1249,4,1,1,29,0.03333333333333333,0.03333333333333333,0.9666666666666667,30,1000,600,400,0.6,14,6,8,410.5650900073705,0.4673611111111111,-0.014741992061294784,0.20910444852138435,125765.055941358,4326.948302469127,130092.00424382713,198,0,37.766666666666666,29,1,20,38.940621249884586,0.5941091954022988,49.23611111111111,1003.0555555555554,34.58812260536398,0
1250,4,2,1,30,0.06451612903225806,0.03225806451612903,0.967741935483871,31,800,600,200,0.75,10,6,4,387.4446678915819,0.46814516129032263,-0.0018250043399490323,0.20156579384137074,126637.27092978396,3613.295717592596,130250.56664737656,199,0,37.096774193548384,29,2,19,38.618710040936485,0.6030890804597702,48.36805555555556,1006.5277777777778,34.70785440613027,0
1251,4,0,1,29,0.0,0.03333333333333333,0.9666666666666667,30,800,600,200,0.75,10,6,4,400.13063086383744,0.4658045977011494,-0.0036984149650149956,0.20771792497697972,126549.3114389286,4127.251164288558,130676.56260321717,200,1,37.733333333333334,28,2,19,38.39039221286116,0.6052827380952381,48.45545977011495,1006.1781609195409,35.93493431855503,0
1252,4,1,0,30,0.03333333333333333,0.0,1.0,30,1050,700,350,0.6666666666666666,14,7,7,396.5791685405604,0.4615181992337165,-0.005886828340466277,0.20715499042245367,126802.42807834593,4057.44029924693,130859.86837759285,201,0,38.63333333333333,28,2,22,38.218319067998095,0.6078869047619048,48.20402298850575,1007.1839080459773,35.970853858784906,0
1253,4,1,1,30,0.03225806451612903,0.03225806451612903,0.967741935483871,31,1050,700,350,0.6666666666666666,14,7,7,383.54849191291044,0.46330645161290324,-0.006193050810561207,0.2019539956330417,127127.02787422849,3551.8759645061814,130678.90383873467,202,0,38.354838709677416,29,2,24,38.21199444520956,0.608117816091954,47.88194444444445,1008.472222222223,34.77490421455941,0
1254,4,1,0,31,0.03225806451612903,0.0,1.0,31,700,400,300,0.5714285714285714,10,4,6,383.6064242262075,0.4635752688172043,0.015820692898434352,0.20374012494877664,127477.4329668209,3580.2324459876368,131057.66541280854,203,0,38.74193548387097,29,2,18,37.849991977261254,0.6117097701149425,47.534722222222214,1009.8611111111104,34.82279693486588,0
1255,4,0,1,30,0.0,0.03225806451612903,0.967741935483871,31,900,500,400,0.5555555555555556,13,5,8,383.1732183119303,0.4632168458781362,0.012562546577238765,0.20368681605002603,127512.49999999999,3571.875,131084.375,204,1,39.74193548387097,29,2,19,37.82487623762377,0.6120689655172413,47.5,1009.9999999999999,34.82758620689655,0
1256,4,1,1,30,0.03225806451612903,0.03225806451612903,0.967741935483871,31,1300,900,400,0.6923076923076923,17,9,8,375.22917979142267,0.4632616487455197,0.014328342851263276,0.20108435532412164,127838.5145681583,3393.748193432785,131232.2627615911,205,0,40.03225806451613,30,1,20,37.69077839801524,0.6125,47.17741935483872,1011.2903225806461,33.70967741935487,0
1257,4,0,1,29,0.0,0.03333333333333333,0.9666666666666667,30,950,700,250,0.7368421052631579,12,7,5,379.58985341824496,0.46319444444444446,0.003771799378126328,0.18339818064890645,123559.28295539948,3380.370021100707,126939.65297650019,206,1,41.666666666666664,30,0,19,42.00999278986978,0.5684027777777778,51.44489247311828,994.2204301075269,33.14068100358423,16
1258,4,3,0,32,0.09375,0.0,1.0,32,950,700,250,0.7368421052631579,12,7,5,386.01965893039045,0.4698630712365592,0.05473500202675363,0.18709440050712645,123692.95086498448,3503.705450052047,127196.65631503653,207,0,39.75,30,2,21,41.71057965139848,0.5697916666666667,51.31048387096775,994.7580645161297,33.158602150537654,16
1259,4,4,4,32,0.1111111111111111,0.1111111111111111,0.8888888888888888,36,1050,700,350,0.6666666666666666,14,7,7,364.0782919243063,0.4719080687830688,0.10567180543996613,0.18347888037000254,125327.59530895698,1925.8113662131575,127253.40667517013,208,0,36.22222222222222,34,2,14,40.55874251971625,0.5768995098039216,49.67261904761905,1001.3095238095243,29.450280112044833,0
1260,4,1,2,31,0.030303030303030304,0.06060606060606061,0.9393939393939394,33,700,600,100,0.8571428571428571,8,6,2,417.67825180490564,0.4678030303030303,0.05307338207419443,0.20006300699293322,123192.06880853264,3831.239252768381,127023.30806130102,209,0,39.03030303030303,30,3,16,41.448348226374215,0.5645833333333333,51.81451612903225,992.7419354838698,33.091397849462325,16
1261,4,5,1,35,0.1388888888888889,0.027777777777777776,0.9722222222222222,36,1250,800,450,0.64,17,8,9,387.65554240205176,0.4738260582010582,0.1896029686290579,0.17660399663506038,121033.3225842583,2342.5139466990413,123375.83653095734,210,0,36.388888888888886,30,6,19,44.46227746664846,0.5420138888888889,53.998655913978496,984.0053763440861,32.80017921146954,16
1262,4,9,7,37,0.20454545454545456,0.1590909090909091,0.8409090909090909,44,900,700,200,0.7777777777777778,11,7,4,312.940892534979,0.4839675828047921,0.19026756376154008,0.15026335418415107,123296.4423990065,-1080.0471552293393,122216.39524377715,196,0,25.795454545454547,38,6,16,43.93937356569135,0.5482456140350878,51.70940170940171,993.1623931623931,26.135852451641924,0
1263,4,9,6,40,0.1956521739130435,0.13043478260869565,0.8695652173913043,46,550,200,350,0.36363636363636365,9,2,7,329.76881361566797,0.48424919484702095,0.2054893471370851,0.1591252474580589,123505.51016466744,-989.0087283114625,122516.50143635599,197,0,25.02173913043478,40,6,13,43.30419520839725,0.5471354166666667,51.49898373983741,994.0040650406524,24.85010162601631,16
1264,4,6,3,43,0.13043478260869565,0.06521739130434782,0.9347826086956522,46,1650,1300,350,0.7878787878787878,20,13,7,368.8885581185333,0.48614130434782604,0.19853121750625746,0.17450379147835776,122659.86571712005,449.91162945942494,123109.77734657947,198,0,25.608695652173914,34,12,18,43.215709249689525,0.5493259803921569,52.35119047619047,990.595238095237,29.13515406162462,16
1265,4,8,10,41,0.1568627450980392,0.19607843137254902,0.803921568627451,51,1000,700,300,0.7,13,7,6,318.8555420645503,0.4877450980392157,0.2312627516531065,0.156677887507283,124271.8967013888,-2267.8970025510243,122003.99969883778,199,0,23.764705882352942,39,12,14,42.78102799832849,0.5566239316239316,50.729166666666664,997.0833333333326,25.566239316239297,0
1266,4,8,6,43,0.16326530612244897,0.12244897959183673,0.8775510204081632,49,1200,800,400,0.6666666666666666,16,8,8,325.1222313587908,0.4865185657596372,0.26618375206308476,0.16131861033662323,124679.69263642358,-1692.7720249835397,122986.92061144004,200,0,25.367346938775512,38,11,18,42.20287762088149,0.5625,50.32051282051283,998.7179487179501,26.282051282051317,0
1267,4,6,7,42,0.12244897959183673,0.14285714285714285,0.8571428571428572,49,850,700,150,0.8235294117647058,10,7,3,321.10745852957194,0.48623511904761907,0.2764166203198559,0.16196889330027864,125364.84917534758,-1748.8823784721837,123615.9667968754,201,0,25.979591836734695,39,10,15,41.59602316066845,0.5678418803418803,49.635416666666686,1001.4583333333363,25.67841880341888,0
1268,4,1,2,41,0.023255813953488372,0.046511627906976744,0.9534883720930233,43,1250,900,350,0.72,16,9,7,357.862833495504,0.4856266149870801,0.279374489244705,0.17829427223707783,124851.23476473954,335.92332766443127,125187.15809240397,202,0,27.069767441860463,34,9,22,41.207564026206065,0.5719975490196079,50.14880952380954,999.4047619047644,29.39425770308131,0
1269,4,4,5,40,0.08888888888888889,0.1111111111111111,0.8888888888888888,45,1300,900,400,0.6923076923076923,17,9,8,337.610919731502,0.48541666666666666,0.26943866943866923,0.1709377393587921,125521.37586805563,-524.433992346928,124996.94187570871,203,0,26.533333333333335,35,10,19,41.02130977130976,0.5767857142857142,49.47916666666667,1002.083333333334,28.6309523809524,0
1270,4,4,5,39,0.09090909090909091,0.11363636363636363,0.8863636363636364,44,1100,800,300,0.7272727272727273,14,8,6,406.1170220086316,0.49010086328400276,0.2551539097875304,0.19628989397083874,123575.51020408176,1726.5899589002465,125302.10016298201,204,0,25.727272727272727,34,10,18,41.33366259578545,0.5588235294117647,51.42857142857144,994.2857142857154,29.243697478991628,16
1271,4,6,6,39,0.13333333333333333,0.13333333333333333,0.8666666666666667,45,1350,1000,350,0.7407407407407407,17,10,7,330.54233727235567,0.49053030303030304,0.15557748297579477,0.1653799593121862,125027.4137835679,-247.13637114011152,124780.2774124278,205,0,24.57777777777778,37,8,21,41.708123195556034,0.5678490990990991,49.97258771929824,1000.1096491228061,27.029990516832598,16
1272,4,3,3,39,0.07142857142857142,0.07142857142857142,0.9285714285714286,42,1150,800,350,0.6956521739130435,15,8,7,330.8516646551146,0.4901398567557104,0.2176022509655402,0.16791570802507566,125620.13660620071,-87.67373792712448,125532.4628682736,206,0,26.833333333333332,36,6,17,41.08884707556355,0.5758101851851851,49.38063063063063,1002.4774774774769,27.84659659659658,0
1273,4,1,1,39,0.025,0.025,0.975,40,1150,800,350,0.6956521739130435,15,8,7,338.8584736485017,0.48993055555555554,0.2195262407979104,0.1721270244311023,125655.61933106554,515.8942743763872,126171.51360544193,207,0,28.675,34,6,20,40.85158909206047,0.5802696078431373,49.34523809523808,1002.6190476190458,29.48879551820723,0
1274,4,0,2,37,0.0,0.05128205128205128,0.9487179487179487,39,1250,1000,250,0.8,15,10,5,349.03844309710354,0.4896255060728745,0.224213981397011,0.1769860772530195,125582.78554221908,966.6439890906987,126549.42953130978,208,1,30.102564102564102,33,6,20,40.67161327790683,0.5817550505050505,49.41789215686273,1002.3284313725469,30.373588829471117,0
1275,4,9,3,43,0.1956521739130435,0.06521739130434782,0.9347826086956522,46,1200,900,300,0.75,15,9,6,331.64589916690636,0.4866847826086957,0.19738393515106867,0.17470632188256652,127145.88355613982,169.41276706872114,127315.29632320853,209,0,25.869565217391305,38,8,18,39.501235875706215,0.5877192982456141,47.86324786324786,1008.5470085470073,26.540710751237032,15
1276,4,0,1,42,0.0,0.023255813953488372,0.9767441860465116,43,1250,800,450,0.64,17,8,9,352.54493473203155,0.48606496862310816,0.19385738652910023,0.18418001730393052,126808.29478126779,341.12440142845605,127149.41918269625,210,1,28.674418604651162,36,7,19,39.32105322003578,0.587962962962963,48.1981981981982,1007.2072072072075,27.977977977977986,0
1277,4,2,3,41,0.045454545454545456,0.06818181818181818,0.9318181818181819,44,1150,700,450,0.6086956521739131,16,7,9,392.2469242880203,0.485619274136716,0.23574176756817922,0.19055998185449335,123792.34544933443,987.224936084729,124779.57038541917,211,0,28.75,36,8,14,41.451897325638406,0.5570023148148149,51.210585585585584,995.1576576576574,27.643268268268262,15
1278,4,2,5,38,0.046511627906976744,0.11627906976744186,0.8837209302325582,43,1700,1300,400,0.7647058823529411,21,13,8,381.14566566717474,0.4855112587670727,0.2398100685264124,0.1879562721997164,124421.96609224952,884.6927523744815,125306.658844624,212,0,29.906976744186046,35,8,10,41.072119102861556,0.5654761904761905,50.578703703703695,997.6851851851841,28.505291005290974,0
1279,4,8,9,37,0.17391304347826086,0.1956521739130435,0.8043478260869565,46,950,700,250,0.7368421052631579,12,7,5,355.5752382023969,0.4853160225442834,0.25461187084385006,0.18099313877781442,125741.22716845563,-256.56704763621826,125484.66012081942,213,0,28.26086956521739,37,9,14,40.344170219744186,0.5751689189189189,49.25986842105263,1002.9605263157891,27.107041251778085,0
1280,4,3,0,40,0.075,0.0,1.0,40,1300,1000,300,0.7692307692307693,16,10,6,396.3327248139336,0.4827590811965812,0.2745145631067962,0.1998292969166756,125347.46334876542,1935.8603395061753,127283.3236882716,214,0,32.25,32,8,17,39.730698104484524,0.5817057291666667,49.65277777777778,1001.3888888888888,31.293402777777775,0
1281,4,2,2,40,0.047619047619047616,0.047619047619047616,0.9523809523809523,42,1000,600,400,0.6,14,6,8,382.45498553633195,0.4817073170731707,0.28918738961398005,0.19668114704089615,126163.40880102046,1250.3649376417245,127413.77373866219,215,0,31.666666666666668,34,8,19,39.23351897934193,0.5854779411764706,48.839285714285715,1004.6428571428576,29.548319327731104,0
1282,4,3,4,39,0.06976744186046512,0.09302325581395349,0.9069767441860466,43,1150,700,450,0.6086956521739131,16,7,9,370.4649819264708,0.4828349944629014,0.2720874052632569,0.19226579629174936,126538.26845689699,775.5994673782251,127313.86792427521,216,0,31.53488372093023,35,8,16,39.14799743088309,0.587202380952381,48.46643518518517,1006.1342592592567,28.74669312169305,0
1283,4,2,1,40,0.04878048780487805,0.024390243902439025,0.975609756097561,41,1300,1000,300,0.7692307692307693,16,10,6,386.2607504647047,0.48071646341463414,0.2895761463818114,0.20215984732113773,126882.03124999999,1601.9097222222222,128483.9409722222,217,0,33.02439024390244,34,7,18,38.39605734767026,0.5928308823529411,48.125,1007.4999999999999,29.632352941176467,0
1284,4,2,5,37,0.047619047619047616,0.11904761904761904,0.8809523809523809,42,1050,600,450,0.5714285714285714,15,6,9,382.0774012826896,0.4801587301587302,0.30050934262266593,0.2038626687296511,127662.84190759622,1355.5909863945403,129018.43289399076,218,0,32.666666666666664,34,8,18,37.69805041818825,0.600796568627451,47.35119047619047,1010.5952380952369,29.723389355742263,0
1285,4,3,2,38,0.075,0.05,0.95,40,850,600,250,0.7058823529411765,11,6,5,399.9779331127438,0.47561431623931627,0.31589432925306093,0.21376657760351295,127729.38507550237,2217.7870880522273,129947.1721635546,219,0,34.425,32,8,20,37.177325339328846,0.6061197916666667,47.28535353535353,1010.8585858585848,31.589330808080774,0
1286,4,1,4,35,0.02564102564102564,0.10256410256410256,0.8974358974358975,39,1050,600,450,0.5714285714285714,15,6,9,409.7297423425585,0.4738529014844804,0.3283952573344959,0.21980529271526195,127880.99500868049,2679.3294270833285,130560.32443576382,220,0,35.717948717948715,31,8,21,36.774802608994165,0.6102150537634409,47.135416666666664,1011.4583333333328,32.627688172042994,0
1287,4,2,2,35,0.05405405405405406,0.05405405405405406,0.9459459459459459,37,850,400,450,0.47058823529411764,13,4,9,398.35404965642164,0.4732857857857858,0.2795702337687074,0.21674023851913263,128446.04768990913,2834.4857213718615,131280.53341128098,221,0,31.18918918918919,27,10,20,36.4821882951654,0.6280864197530864,46.57738095238094,1013.6904761904748,37.54409171075832,0
1288,4,0,1,34,0.0,0.02857142857142857,0.9714285714285714,35,1000,900,100,0.9,11,9,2,419.1434232586496,0.47149859943977596,0.27560258671369775,0.2263374485596708,128144.53125,3742.1875,131886.71875,222,1,32.91428571428571,26,9,23,36.26543209876544,0.6286057692307692,46.875,1012.5,38.94230769230769,0
1289,4,3,2,35,0.08108108108108109,0.05405405405405406,0.9459459459459459,37,1150,700,450,0.6086956521739131,16,7,9,391.53138152445064,0.47040790790790793,0.24365722396357015,0.21557812211647484,128919.13580246926,2695.1774691358237,131614.3132716051,223,0,31.81081081081081,29,8,23,36.170564369073674,0.6264367816091954,46.11111111111112,1015.5555555555566,35.01915708812264,0
1290,4,1,3,33,0.027777777777777776,0.08333333333333333,0.9166666666666666,36,1050,600,450,0.5714285714285714,15,6,9,398.4705774819348,0.4693452380952381,0.11807251804809216,0.2034087960362893,125859.31492695115,3059.4327368747036,128918.74766382585,224,0,32.0,33,3,17,39.14620990066765,0.5845959595959596,49.1421568627451,1003.4313725490193,30.40701128936422,15
1291,4,2,1,34,0.05714285714285714,0.02857142857142857,0.9714285714285714,35,1000,700,300,0.7,13,7,6,388.7580472417972,0.46642156862745093,0.1325716989741601,0.20197736775260666,126582.35721371876,2841.982001133779,129424.33921485253,116,0,25.714285714285715,34,1,15,38.64234591269371,0.5897671568627452,48.422619047619044,1006.3095238095233,29.597338935574214,0
1292,4,2,1,35,0.05555555555555555,0.027777777777777776,0.9722222222222222,36,900,500,400,0.5555555555555556,13,5,8,364.796885944391,0.4688492063492064,0.09844703272323896,0.18423775500216716,125417.01388888883,1977.164824263028,127394.17871315186,117,0,25.666666666666668,34,2,15,40.44821131447587,0.5778186274509804,49.58333333333333,1001.6666666666662,29.460784313725476,15
1293,4,3,2,36,0.07894736842105263,0.05263157894736842,0.9473684210526316,38,1450,1100,350,0.7586206896551724,18,11,7,339.60754133425837,0.4706614509246088,0.11777848519147294,0.1754638963560334,126355.0036523009,982.2224251278247,127337.22607742873,118,0,25.157894736842106,36,2,14,40.11256720430107,0.5833333333333333,48.648648648648646,1005.4054054054051,27.927927927927918,0
1294,4,4,3,37,0.1,0.075,0.925,40,1200,600,600,0.5,18,6,12,324.9151048339629,0.4709535256410256,0.12566779732881117,0.1704810399890769,126984.30879720926,251.82400102270316,127236.13279823196,119,0,24.8,38,2,16,39.83640732103739,0.5860745614035088,48.023504273504265,1007.9059829059815,26.52384165542057,0
1295,4,1,1,37,0.02631578947368421,0.02631578947368421,0.9736842105263158,38,1600,1200,400,0.75,20,12,8,340.81346050534734,0.4691648885727833,0.13712499485387974,0.17867250486598457,126950.11470507685,1053.261580837615,128003.37628591446,120,0,27.07894736842105,36,2,19,39.47089060230194,0.5894097222222222,48.05743243243244,1007.7702702702716,27.993618618618655,0
1296,4,0,0,37,0.0,0.0,1.0,37,1200,1100,100,0.9166666666666666,13,11,2,347.1736188814912,0.46918793793793795,0.14142944046480999,0.1821197513987968,126975.33543381355,1416.4973422496664,128391.83277606322,121,1,28.37837837837838,35,2,20,39.28475731128464,0.5916666666666667,48.03240740740741,1007.8703703703713,28.796296296296322,0
1297,4,0,1,36,0.0,0.02702702702702703,0.972972972972973,37,800,500,300,0.625,11,5,6,348.07732720697413,0.4691253753753754,0.14013462308329694,0.18272486091895968,127004.50002411276,1441.47738233026,128445.97740644301,122,2,29.37837837837838,35,2,20,39.23204443678953,0.5919642857142857,48.00347222222223,1007.986111111112,28.7996031746032,0
1298,4,1,0,37,0.02702702702702703,0.0,1.0,37,1100,600,500,0.5454545454545454,16,6,10,349.2349067884342,0.4706268768768769,0.1386251690784266,0.18399988372584666,127152.0408163265,1481.2163653076911,128633.25718163418,123,0,30.08108108108108,34,3,21,39.051434135977324,0.5955882352941176,47.857142857142854,1008.5714285714283,29.66386554621848,0
1299,4,1,3,35,0.02631578947368421,0.07894736842105263,0.9210526315789473,38,1050,600,450,0.5714285714285714,15,6,9,346.3547811350389,0.47046882408724516,0.15041684499876418,0.18472960257116816,127646.96830257624,1242.2275537980042,128889.19585637424,124,0,30.263157894736842,35,3,17,38.61682987821174,0.5985119047619047,47.366898148148145,1010.5324074074069,28.872354497354483,0
1300,4,1,0,36,0.027777777777777776,0.0,1.0,36,950,400,550,0.42105263157894735,15,4,11,363.3224049828465,0.4669312169312169,0.15541341632647532,0.19393656141705742,127679.65032980111,2077.77552503845,129757.42585483956,125,0,31.805555555555557,33,3,18,38.154657249100666,0.603219696969697,47.33455882352941,1010.6617647058829,30.62611408199645,0
1301,4,0,3,33,0.0,0.08333333333333333,0.9166666666666666,36,1150,900,250,0.782608695652174,14,9,5,368.2184889823071,0.46613756613756613,0.15131157401958872,0.19764703100964404,127903.57320011343,2219.292091836741,130122.86529195018,126,1,32.80555555555556,34,2,19,37.80133184261112,0.6032475490196079,47.11309523809524,1011.5476190476195,29.751400560224102,0
1302,4,1,0,34,0.029411764705882353,0.0,1.0,34,850,400,450,0.47058823529411764,13,4,9,380.60918463038763,0.4653149138443256,0.1350678167844701,0.2034150288485238,127729.38507550267,2922.9954213855885,130652.38049688825,127,0,33.73529411764706,32,2,20,37.66680198184693,0.6061197916666667,47.28535353535354,1010.8585858585873,31.589330808080852,0
1303,4,2,1,35,0.05555555555555555,0.027777777777777776,0.9722222222222222,36,1100,700,400,0.6363636363636364,15,7,8,359.20396752338036,0.46455026455026455,0.1352201257861636,0.19487522332567653,128330.72015570941,2020.0543271086044,130350.77448281801,128,0,32.80555555555556,33,3,22,37.592223028543785,0.6098484848484849,46.69117647058824,1013.2352941176475,30.704099821746894,0
1304,4,2,1,36,0.05405405405405406,0.02702702702702703,0.972972972972973,37,1700,1400,300,0.8235294117647058,20,14,6,351.75472793634844,0.4631819319319319,0.1409119284602931,0.19343108153250274,128868.76594387753,1666.039540816324,130534.80548469385,129,0,32.5945945945946,34,3,20,37.23179739711572,0.6130514705882353,46.160714285714285,1015.3571428571427,29.863445378151255,0
1305,4,0,2,34,0.0,0.05555555555555555,0.9444444444444444,36,1000,700,300,0.7,13,7,6,367.6404230741461,0.4607638888888889,-0.03852609919861405,0.19050458286569388,126474.91349480966,2222.46338486374,128697.37687967341,130,1,32.388888888888886,33,3,14,39.28433641975308,0.5909090909090908,48.52941176470588,1005.8823529411762,30.481283422459885,16
1306,4,0,2,32,0.0,0.058823529411764705,0.9411764705882353,34,1500,1200,300,0.8,18,12,6,377.430669523203,0.4578877005347594,-0.009280910344197535,0.1952375794191356,126403.65812513552,2741.723463270382,129145.3815884059,131,2,35.205882352941174,31,3,15,39.11166321377701,0.5950940860215054,48.60026041666666,1005.5989583333325,32.43867607526879,0
1307,4,0,2,30,0.0,0.0625,0.9375,32,650,500,150,0.7692307692307693,8,5,3,417.0893205087513,0.456065188172043,0.018531502739368655,0.20628430522710253,124544.6862114801,4019.875250922318,128564.56146240242,132,3,38.1875,31,1,16,40.04750413079398,0.5759408602150538,50.45572916666667,998.1770833333339,32.19926075268819,16
1308,4,5,5,30,0.14285714285714285,0.14285714285714285,0.8571428571428572,35,750,600,150,0.8,9,6,3,383.7337419738859,0.4583333333333333,0.048127436027792125,0.19605305726302177,125894.45153061229,2661.9897959183745,128556.44132653066,133,0,34.114285714285714,34,1,17,39.47953736654804,0.5827205882352942,49.10714285714286,1003.571428571429,29.51680672268909,0
1309,4,1,0,31,0.03225806451612903,0.0,1.0,31,650,400,250,0.6153846153846154,9,4,5,420.8252772606718,0.4550179211469534,0.08210671970941807,0.2138526272727936,125672.94629436919,4377.270493698679,130050.21678806788,134,0,34.935483870967744,30,1,18,38.77904378909741,0.5902777777777778,49.327956989247305,1002.6881720430099,33.42293906810033,0
1310,4,2,0,33,0.06060606060606061,0.0,1.0,33,1200,900,300,0.75,15,9,6,401.15601844263756,0.45770202020202017,0.07938229462780533,0.20729431374813248,126361.00788503722,3538.095761912051,129899.10364694927,135,0,33.75757575757576,32,1,20,38.559326468249,0.5921223958333333,48.64267676767677,1005.4292929292927,31.419665404040398,0
1311,4,0,0,33,0.0,0.0,1.0,33,1100,800,300,0.7272727272727273,14,8,6,405.74173224875574,0.4566366792929293,0.09217140032698379,0.21080584133132904,126583.26478165512,3672.0226252423463,130255.28740689746,136,1,34.75757575757576,32,1,20,38.21413634462569,0.5944010416666667,48.421717171717184,1006.3131313131328,31.4472853535354,0
1312,4,1,2,32,0.029411764705882353,0.058823529411764705,0.9411764705882353,34,1250,800,450,0.64,17,8,9,396.7915148159608,0.4589832144979204,0.08165724050651058,0.20858810175021797,127061.12320081223,3283.3551098135435,130344.47831062578,137,0,34.705882352941174,33,1,21,37.946066812527874,0.5969065656565656,47.94730392156863,1008.2107843137258,30.55184194890078,0
1313,4,2,2,32,0.058823529411764705,0.058823529411764705,0.9411764705882353,34,1100,800,300,0.7272727272727273,14,8,6,379.29934845258776,0.4631053178847297,0.06571016911675542,0.2024648366788669,127679.65032980118,2885.761636149575,130565.41196595076,138,0,33.76470588235294,33,1,22,37.75097510205731,0.603219696969697,47.33455882352942,1010.6617647058836,30.626114081996473,0
1314,4,1,1,32,0.030303030303030304,0.030303030303030304,0.9696969696969697,33,800,500,300,0.625,11,5,6,379.98244376848027,0.46026672979797983,0.05167742361830063,0.20392555857379924,127896.48963139163,3119.684135909246,131016.17376730088,139,0,33.27272727272727,33,0,23,37.511105726516426,0.6054292929292929,47.12009803921568,1011.5196078431361,30.652109328579883,0
1315,4,0,1,31,0.0,0.03125,0.96875,32,950,400,550,0.42105263157894735,15,4,11,420.3357784352514,0.46024445564516125,0.09793410041841,0.20502092050209209,123960.50347222229,4021.0069444444543,127981.51041666674,140,1,34.59375,32,0,17,40.577057182705715,0.5673828125,51.04166666666667,995.8333333333339,31.119791666666686,15
1316,4,4,3,32,0.11428571428571428,0.08571428571428572,0.9142857142857143,35,1200,1100,100,0.9166666666666666,13,11,2,395.88998968588487,0.467156862745098,0.0950329975686004,0.19753332414309552,124913.2095148532,2890.377845293185,127803.58736014638,141,0,32.08571428571429,35,0,17,40.19299235845778,0.5705357142857144,50.08680555555554,999.6527777777761,28.56150793650789,0
1317,4,8,7,33,0.2,0.175,0.825,40,1500,1200,300,0.8,18,12,6,351.7953609495176,0.4713007478632478,0.12303021824286509,0.18264332074863085,126553.21865361974,914.4149252010906,127467.63357882084,142,0,28.8,36,4,15,39.60221973512404,0.5853587962962963,48.45157657657657,1006.1936936936929,27.949824824824802,0
1318,4,5,1,37,0.13157894736842105,0.02631578947368421,0.9736842105263158,38,750,300,450,0.4,12,3,9,374.2456140419492,0.465134542437174,0.1808887838316977,0.19558320817843952,126822.06809807273,1892.5205498866376,128714.58864795938,143,0,31.07894736842105,34,4,20,38.76044005830672,0.592218137254902,48.18452380952382,1007.2619047619062,29.625350140056064,0
1319,4,2,0,39,0.05128205128205128,0.0,1.0,39,1400,1000,400,0.7142857142857143,18,10,8,363.6135011835022,0.46761133603238864,0.18825799505205,0.1924291674802583,127332.20663265335,1460.2288832199883,128792.43551587334,144,0,30.974358974358974,34,5,18,38.503823621923395,0.5974264705882353,47.678571428571445,1009.2857142857166,29.6848739495799,0
1320,4,2,6,35,0.04878048780487805,0.14634146341463414,0.8536585365853658,41,1300,900,400,0.6923076923076923,17,9,8,374.9765154970165,0.4691819105691057,0.15999676078935576,0.19203101255899255,125991.54188368034,1310.5085654053091,127302.05044908565,145,0,30.414634146341463,39,2,18,39.59889672822854,0.5742521367521367,49.01041666666666,1003.9583333333316,25.742521367521324,16
1321,4,1,2,34,0.027777777777777776,0.05555555555555555,0.9444444444444444,36,750,700,50,0.9333333333333333,8,7,1,395.42762459087817,0.46517857142857144,0.21925732658654873,0.20232073607708045,125954.19501133791,2761.1536281179206,128715.34863945583,146,0,34.72222222222222,34,2,19,39.124268659076535,0.5833333333333333,49.04761904761905,1003.8095238095241,29.523809523809533,0
1322,4,0,1,33,0.0,0.029411764705882353,0.9705882352941176,34,800,500,300,0.625,11,5,6,403.9142627621714,0.46600193107546045,0.2009989443219602,0.20664970182916598,125951.55897070846,3374.7262170799777,129326.28518778844,147,1,36.44117647058823,33,1,20,38.9140265738819,0.5855429292929293,49.05024509803922,1003.7990196078438,30.4181521093286,0
1323,4,2,1,34,0.05714285714285714,0.02857142857142857,0.9714285714285714,35,900,500,400,0.5555555555555556,13,5,8,382.6310514543898,0.4654411764705882,0.17800405141351328,0.19864409440000208,126551.50183973573,2684.574424593974,129236.0762643297,148,0,35.114285714285714,32,3,18,38.82832434015144,0.5940755208333333,48.45328282828283,1006.1868686868686,31.443339646464644,0
1324,4,1,0,35,0.02857142857142857,0.0,1.0,35,1600,1100,500,0.6875,21,11,10,380.44496483034123,0.4649159663865546,0.180980507974011,0.1994096982841384,126942.00857426289,2658.889597505653,129600.89817176854,149,0,36.08571428571429,34,1,19,38.480754085449895,0.5934436274509804,48.06547619047618,1007.7380952380939,29.639355742296882,0
1325,4,1,2,34,0.027777777777777776,0.05555555555555555,0.9444444444444444,36,1400,1100,300,0.7857142857142857,17,11,6,372.5248650409416,0.46474867724867724,0.1843409817490187,0.19733037384837523,127370.19903702893,2289.890395496418,129660.08943252535,150,0,36.05555555555556,33,3,18,38.23992857431914,0.6000631313131313,47.64093137254901,1009.4362745098031,30.58897801544858,0
1326,4,0,0,34,0.0,0.0,1.0,34,1150,800,350,0.6956521739130435,15,8,7,382.1163486756986,0.46187982768865127,0.18839813730251698,0.2022564426537953,127339.27455786237,2931.6837274125346,130270.9582852749,151,1,38.23529411764706,33,1,18,38.02968674113647,0.5997474747474747,47.67156862745098,1009.3137254901962,30.585264408793826,0
1327,4,2,1,35,0.05555555555555555,0.027777777777777776,0.9722222222222222,36,1150,1000,150,0.8695652173913043,13,10,3,369.2758291347503,0.46380621693121693,0.197646640235845,0.19882683805137039,128027.3705418381,2255.482681755829,130282.85322359393,152,0,37.05555555555556,35,1,21,37.64772034156757,0.6023809523809525,46.99074074074074,1012.0370370370367,28.915343915343907,0
1328,4,0,1,34,0.0,0.02857142857142857,0.9714285714285714,35,850,600,250,0.7058823529411765,11,6,5,375.4435075289964,0.46186974789915963,0.19929428369795343,0.20228268067246674,128054.14540816315,2615.4195011337742,130669.56490929693,153,1,38.628571428571426,34,1,22,37.46422410413236,0.6047794117647058,46.96428571428571,1012.1428571428563,29.768907563025184,0
1329,4,0,0,34,0.0,0.0,1.0,34,750,700,50,0.9333333333333333,8,7,1,383.31765697783453,0.46108140225787286,0.20128019719453705,0.20619243606944498,127989.47707912828,3012.1252943579443,131001.60237348622,154,2,40.61764705882353,33,1,22,37.33132998264099,0.6063762626262627,47.02818627450981,1011.8872549019612,30.66325014854428,0
1330,4,1,2,33,0.02857142857142857,0.05714285714285714,0.9428571428571428,35,1150,800,350,0.6956521739130435,15,8,7,382.52218867444225,0.4619047619047619,0.06807781720298567,0.19310400543769113,125398.6015745147,2815.2528474625296,128213.85442197723,155,0,40.42857142857143,33,2,16,40.023425710673365,0.5798611111111112,49.60171568627452,1001.5931372549028,30.35130718954251,16
1331,4,1,0,34,0.029411764705882353,0.0,1.0,34,950,400,550,0.42105263157894735,15,4,11,378.97182017889594,0.4617869875222816,0.0983554712207464,0.19287968758358776,125736.3754325263,2730.108612072326,128466.48404459862,156,0,42.14705882352941,33,1,19,39.76254480286738,0.5833333333333333,49.26470588235296,1002.941176470591,30.392156862745182,0
1332,4,6,3,37,0.15,0.075,0.925,40,1400,1100,300,0.7857142857142857,17,11,6,334.2187653678531,0.46594551282051283,0.12350689542838555,0.17739600059207847,127451.59718615361,520.0940042537936,127971.69119040741,157,0,36.675,37,3,16,39.12329876570022,0.5926238738738738,47.56030701754387,1009.758771929826,27.290777619725027,0
1333,4,1,1,37,0.02631578947368421,0.02631578947368421,0.9736842105263158,38,1200,800,400,0.6666666666666666,16,8,8,347.1332698867989,0.46593468468468463,0.14084558025048843,0.18420867679394373,127442.37075617292,1247.8973765432213,128690.26813271614,158,0,39.39473684210526,35,3,18,38.80674002751031,0.5964285714285714,47.56944444444445,1009.722222222223,28.84920634920637,0
1334,4,3,1,39,0.075,0.025,0.975,40,1450,1200,250,0.8275862068965517,17,12,5,324.61802271285086,0.4677751068376068,0.13014705882352962,0.17700869540379968,128533.39489073546,346.78031274578785,128880.17520348125,159,0,35.875,37,3,19,38.261876441753174,0.6036036036036037,46.49122807017543,1014.035087719297,27.406353722143162,0
1335,4,0,3,36,0.0,0.07692307692307693,0.9230769230769231,39,1250,900,350,0.72,16,9,7,361.88870459430314,0.46662730544309494,0.021145577174741526,0.18530946590799646,125987.30223044017,1504.8874617908236,127492.189692231,160,1,37.43589743589744,36,3,16,39.9317629463451,0.5795717592592593,49.014639639639654,1003.9414414414437,27.887262262262325,16
1336,4,5,5,36,0.12195121951219512,0.12195121951219512,0.8780487804878049,41,900,600,300,0.6666666666666666,12,6,6,347.6171376753825,0.46920731707317076,0.09317835365853644,0.18364678971529644,127262.3975326679,652.5529330005783,127914.95046566849,161,0,35.170731707317074,36,5,16,38.97902715773809,0.5925925925925926,47.74774774774775,1009.0090090090099,28.028028028028054,0
1337,4,1,1,36,0.02702702702702703,0.02702702702702703,0.972972972972973,37,1000,900,100,0.9,11,9,2,372.2391180947648,0.46405780780780775,0.11407863859133838,0.19510861514998012,126942.00857426287,2050.5562641723213,128992.5648384352,162,0,39.648648648648646,34,3,18,38.68748769442806,0.5934436274509804,48.06547619047618,1007.7380952380938,29.63935574229688,0
1338,4,3,2,37,0.07692307692307693,0.05128205128205128,0.9487179487179487,39,600,200,400,0.3333333333333333,10,2,8,355.1258591205654,0.467442645074224,0.11576542269611578,0.18877743037461642,127512.50000000001,1256.7743764172346,128769.27437641725,163,0,38.41025641025641,34,5,15,38.533072057205715,0.5992647058823529,47.5,1010.0000000000001,29.70588235294118,0
1339,4,0,0,37,0.0,0.0,1.0,37,1150,600,550,0.5217391304347826,17,6,11,371.38667358585326,0.465746996996997,0.12387866410135895,0.19645888034227177,127314.91246110095,2056.612367360478,129371.52482846142,164,1,40.810810810810814,32,5,16,38.32546186246298,0.6018880208333333,47.69570707070707,1009.217171717172,31.538036616161627,0
1340,4,1,2,36,0.02631578947368421,0.05263157894736842,0.9473684210526316,38,1250,900,350,0.72,16,9,7,364.35366716113157,0.4666014698909436,0.12712545699319255,0.19478635129048416,127741.58564314191,1708.6230356112906,129450.2086787532,165,0,40.71052631578947,33,5,17,38.06509374873724,0.6038510101010102,47.27328431372548,1010.9068627450968,30.633541295305964,0
1341,4,0,1,35,0.0,0.027777777777777776,0.9722222222222222,36,600,300,300,0.5,9,3,6,381.76174258101275,0.464566798941799,0.12464534433840568,0.20247472995712554,127420.45932345928,2528.85131835938,129949.31064181865,166,1,43.77777777777778,31,5,18,37.95514143237899,0.605510752688172,47.591145833333336,1009.6354166666673,32.56888440860217,0
1342,4,0,1,34,0.0,0.02857142857142857,0.9714285714285714,35,1400,1000,400,0.7142857142857143,18,10,8,380.56918883549145,0.4640756302521008,0.10874150974653496,0.20299639000359093,127650.62332153319,2715.978834364149,130366.60215589734,167,2,44.142857142857146,31,4,18,37.74870613752524,0.6078629032258065,47.36328125,1010.5468749999999,32.59828629032258,0
1343,4,0,0,34,0.0,0.0,1.0,34,1150,800,350,0.6956521739130435,15,8,7,391.39044134434926,0.4628453654188948,0.11558506600724638,0.20851041442845317,127600.75451280495,3188.34312492774,130789.09763773269,168,3,46.14705882352941,30,4,18,37.52660635891978,0.6100694444444444,47.41263440860215,1010.3494623655914,33.67831541218638,0
1344,4,1,1,34,0.02857142857142857,0.02857142857142857,0.9714285714285714,35,1200,800,400,0.6666666666666666,16,8,8,398.71475279234926,0.4624299719887955,0.10305151125052125,0.1933214484462105,123709.15794625547,2864.933265738187,126574.09121199365,169,0,45.8,32,3,18,41.37792444049582,0.5647786458333333,51.29419191919192,994.8232323232322,31.088226010101007,15
1345,4,5,3,36,0.1282051282051282,0.07692307692307693,0.9230769230769231,39,1000,600,400,0.6,14,6,8,352.61798351715925,0.4676394511920828,0.1118631665599561,0.17757588271732416,125297.79620181424,1036.9613991908582,126334.7576010051,170,0,40.43589743589744,34,5,16,40.87643678160921,0.576593137254902,49.70238095238096,1001.1904761904777,29.44677871148464,0
1346,4,4,2,38,0.1,0.05,0.95,40,1050,800,250,0.7619047619047619,13,8,5,343.15267685177366,0.4670673076923077,0.1142659279778393,0.1744762202020989,125695.40895061722,626.543209876532,126321.95216049375,171,0,40.2,35,5,18,40.70290858725762,0.5785714285714285,49.30555555555555,1002.7777777777771,28.650793650793634,0
1347,4,1,0,39,0.02564102564102564,0.0,1.0,39,1150,800,350,0.6956521739130435,15,8,7,350.94784323108917,0.4667116509221772,0.11574691436956908,0.17826795752064137,125655.61933106578,1019.7137188208611,126675.33304988664,172,0,42.205128205128204,34,5,20,40.54856328663024,0.5802696078431373,49.345238095238095,1002.6190476190478,29.48879551820729,0
1348,4,0,1,38,0.0,0.02564102564102564,0.9743589743589743,39,1550,900,650,0.5806451612903226,22,9,13,354.9474526946512,0.4665991902834008,0.11758802222566933,0.18147737863363278,125924.32149943315,1139.3034297052234,127063.62492913837,173,1,43.205128205128204,34,5,20,40.17094650693869,0.5830269607843137,49.077380952380956,1003.6904761904766,29.52030812324931,0
1349,4,3,1,40,0.07317073170731707,0.024390243902439025,0.975609756097561,41,850,500,350,0.5882352941176471,12,5,7,328.57356721534643,0.4684959349593496,0.12003938221200383,0.17153726862853716,126779.94030770629,131.30744765034524,126911.24775535663,174,0,41.292682926829265,36,5,17,39.95373476462035,0.5876736111111112,48.22635135135135,1007.0945945945941,27.974849849849836,0
1350,4,1,2,39,0.024390243902439025,0.04878048780487805,0.9512195121951219,41,1450,1200,250,0.8275862068965517,17,12,5,328.6119731535706,0.46811483739837395,0.11877201537568793,0.17275766269195064,127063.62771132632,150.9258836539394,127214.55359498026,175,0,42.26829268292683,36,5,19,39.66198480956105,0.5905671296296297,47.94481981981983,1008.2207207207218,28.006131131131163,0
1351,4,3,4,38,0.07142857142857142,0.09523809523809523,0.9047619047619048,42,1000,500,500,0.5,15,5,10,322.2871718567326,0.4679878048780488,0.13564064801178133,0.1717684377478191,127617.7300347223,-174.08854166666194,127443.64149305565,176,0,41.833333333333336,37,5,18,39.254725085910636,0.5943130630630631,47.395833333333336,1010.4166666666674,27.30855855855858,0
1352,4,1,1,38,0.02564102564102564,0.02564102564102564,0.9743589743589743,39,1100,1000,100,0.9090909090909091,12,10,2,340.469028322069,0.4670490328385066,0.143358705217415,0.1803146090657605,127362.24666950128,872.5800736961623,128234.82674319745,177,0,45.38461538461539,34,5,20,39.05703306207494,0.5977328431372548,47.64880952380953,1009.4047619047631,29.68837535014009,0
1353,4,1,1,38,0.02564102564102564,0.02564102564102564,0.9743589743589743,39,1300,1000,300,0.7692307692307693,16,10,6,344.9426402016645,0.46471547458389567,0.164537464890822,0.18418635316428492,127692.92091836722,1009.3466553287798,128702.267573696,178,0,46.35897435897436,34,5,21,38.60546721633295,0.6011029411764706,47.32142857142856,1010.7142857142846,29.72689075630249,0
1354,4,4,3,39,0.09523809523809523,0.07142857142857142,0.9285714285714286,42,1400,900,500,0.6428571428571429,19,9,10,316.17958199183306,0.4683386566008518,0.16694965398368966,0.17325293258344648,128728.04763244448,-258.9667479122453,128469.08088453223,179,0,42.54761904761905,37,5,19,38.27784530884206,0.6055743243243243,46.29934210526315,1014.8026315789464,27.427098150782335,0
1355,4,0,0,39,0.0,0.0,1.0,39,950,600,350,0.631578947368421,13,6,7,328.5246596119625,0.4678081421502474,0.15078480093889257,0.1791042030404728,128525.67361379002,644.7706350736937,129170.44424886371,180,1,44.23076923076923,35,4,20,38.17070444774187,0.6074404761904761,46.498842592592574,1014.0046296296274,28.971560846560784,0
1356,4,0,1,38,0.0,0.02564102564102564,0.9743589743589743,39,1300,700,600,0.5384615384615384,19,7,12,330.01783538320774,0.46710526315789475,0.16048017690728145,0.18058279306923813,128672.41753472209,692.8385416666479,129365.25607638873,181,2,45.23076923076923,35,4,20,37.98340177960301,0.6089285714285715,46.35416666666666,1014.5833333333322,28.988095238095205,0
1357,4,0,0,38,0.0,0.0,1.0,38,1350,700,650,0.5185185185185185,20,7,13,333.62541103852504,0.4673719772403983,0.14844073471787977,0.1832328415916657,128819.24518014822,995.4747245798901,129814.71990472812,182,3,45.60526315789474,35,3,21,37.74239444381104,0.6104166666666666,46.20949074074073,1015.1620370370363,29.00462962962961,0
1358,4,0,2,36,0.0,0.05263157894736842,0.9473684210526316,38,1150,900,250,0.782608695652174,14,9,5,332.84342137114396,0.46749051683262205,0.14718904293676194,0.1830743157171815,128877.99968117705,979.2388706704324,129857.23855184749,183,4,46.60526315789474,35,3,21,37.70244405182567,0.6110119047619047,46.15162037037037,1015.393518518518,29.011243386243372,0
1359,4,0,1,35,0.0,0.027777777777777776,0.9722222222222222,36,1100,800,300,0.7272727272727273,14,8,6,339.97427746366094,0.4656084656084656,0.1441798941798944,0.18652642790573815,128778.12499999988,1556.2499999999868,130334.37499999987,184,5,48.861111111111114,34,2,21,37.6231527093596,0.6121323529411764,46.24999999999999,1014.9999999999991,29.852941176470562,0
1360,4,0,1,34,0.0,0.02857142857142857,0.9714285714285714,35,1050,900,150,0.8571428571428571,12,9,3,343.054266112237,0.4650210084033613,0.13359009997153248,0.18893453480978006,128929.21095521539,1845.9431689342373,130775.15412414962,185,6,48.6,34,1,21,37.391083499394384,0.6136642156862745,46.101190476190474,1015.5952380952378,29.8704481792717,0
1361,4,1,1,34,0.02857142857142857,0.02857142857142857,0.9714285714285714,35,900,600,300,0.6666666666666666,12,6,6,373.9746583180064,0.46642156862745093,0.15430524659541067,0.1840514533366935,124338.00002869604,2328.824012387326,126666.82404108337,186,0,48.94285714285714,32,3,19,41.33830231674896,0.5712890625,50.66287878787879,997.3484848484848,31.16714015151515,16
1362,4,5,0,39,0.1282051282051282,0.0,1.0,39,1450,1200,250,0.8275862068965517,17,12,5,352.0321942245259,0.47025416104363477,0.18082900825632553,0.17543867962583687,124862.97616814796,1244.2566691292843,126107.23283727725,187,0,44.61538461538461,37,2,19,41.34108155055769,0.5661599099099099,50.137061403508774,999.4517543859654,27.012209577999066,16
1363,4,0,0,39,0.0,0.0,1.0,39,1500,1100,400,0.7333333333333333,19,11,8,353.86725357198907,0.46921390013495273,0.18547463490763683,0.17717965268650782,125057.87706832972,1050.9277857692932,126108.80485409901,188,1,45.61538461538461,35,4,19,41.09340044742731,0.5720238095238095,49.94212962962962,1000.2314814814799,28.578042328042283,0
1364,4,2,0,41,0.04878048780487805,0.0,1.0,41,750,500,250,0.6666666666666666,10,5,5,338.4250042069065,0.4716971544715447,0.18793122273580476,0.1716272102415783,125588.29740119806,300.4440152677394,125888.7414164658,189,0,44.34146341463415,38,3,17,40.9318819725716,0.5718201754385965,49.412393162393165,1002.3504273504275,26.37764282501125,0
1365,4,5,4,42,0.10869565217391304,0.08695652173913043,0.9130434782608696,46,1350,1000,350,0.7407407407407407,17,10,7,317.79382205718366,0.47508051529790657,0.22180853510161924,0.1664855393235594,126921.08464222401,-1132.2280010673992,125788.85664115661,190,0,40.41304347826087,42,4,16,40.080576658012,0.5791170634920635,48.08624031007752,1007.6550387596899,23.991786637135473,0
1366,4,2,2,42,0.045454545454545456,0.045454545454545456,0.9545454545454546,44,1250,1000,250,0.8,15,10,5,402.8140874294094,0.4758302501761804,0.3167496746292824,0.20018844647542247,124746.7500228269,1788.1135827461371,126534.86360557305,191,0,42.81818181818182,36,8,19,40.19323263066919,0.5668402777777778,50.25337837837838,998.9864864864867,27.74962462462463,16
1367,4,4,3,43,0.08695652173913043,0.06521739130434782,0.9347826086956522,46,1200,1000,200,0.8333333333333334,14,10,4,384.5208739328418,0.4776771336553945,0.32113975834839725,0.1948182254848211,125548.84676054162,455.4872579352931,126004.33401847692,192,0,41.80434782608695,37,9,18,39.817651349380036,0.5731981981981982,49.45175438596491,1002.1929824561397,27.086296823138913,0
1368,4,3,1,45,0.06521739130434782,0.021739130434782608,0.9782608695652174,46,1300,800,500,0.6153846153846154,18,8,10,385.52887210918703,0.4767210144927536,0.34392857651803443,0.197026564288966,125906.24188452185,508.0982850492124,126414.34016957106,193,0,42.69565217391305,37,9,22,39.42229778943149,0.5768581081081081,49.09539473684209,1003.618421052629,27.124822190611592,0
1369,4,4,2,47,0.08163265306122448,0.04081632653061224,0.9591836734693877,49,1050,700,350,0.6666666666666666,14,7,7,351.8691231730367,0.4786706349206349,0.28306077726927104,0.17408166274482256,124557.68364800354,-912.0390483730537,123645.64459963048,194,0,40.87755102040816,39,10,17,41.661557793314536,0.5595619658119658,50.442708333333336,998.2291666666673,25.595619658119674,16
1370,4,5,4,48,0.09615384615384616,0.07692307692307693,0.9230769230769231,52,1550,1100,450,0.7096774193548387,20,11,9,349.38853507728925,0.4799051030668678,0.28787726155457904,0.168856383155075,123571.81125217037,-1209.6842447916404,122362.12700737873,195,0,37.88461538461539,39,13,15,42.747620918456434,0.5494123931623931,51.43229166666668,994.2708333333353,25.49412393162398,16
1371,4,5,3,50,0.09433962264150944,0.05660377358490566,0.9433962264150944,53,1650,1100,550,0.6666666666666666,22,11,11,345.21482689669295,0.48309748427672955,0.24483575463415486,0.16590704128073128,123334.0762743374,-1825.1824107954444,121508.89386354196,196,0,37.24528301886792,42,11,18,43.09884401521804,0.5424107142857143,51.67151162790697,993.3139534883715,23.650332225913605,16
1372,4,5,5,50,0.09090909090909091,0.09090909090909091,0.9090909090909091,55,1500,1100,400,0.7333333333333333,19,11,8,343.54581472597476,0.48267396184062855,0.3408259868005403,0.17100500293411613,124813.1041004639,-2414.6751804608475,122398.42892000305,197,0,36.67272727272727,38,17,21,41.60474357603621,0.5638706140350878,50.18696581196581,999.252136752137,26.29610886189834,0
1373,4,3,4,49,0.05660377358490566,0.07547169811320754,0.9245283018867925,53,1500,1100,400,0.7333333333333333,19,11,8,332.66522703005535,0.48400459603289797,0.35560876924982443,0.16854546424915204,125548.84676054155,-2246.713052949196,123302.13370759235,198,0,37.39622641509434,37,16,18,41.11688548504743,0.5731981981981982,49.451754385964904,1002.192982456139,27.08629682313889,0
1374,4,2,2,49,0.0392156862745098,0.0392156862745098,0.9607843137254902,51,1550,900,650,0.5806451612903226,22,9,13,335.47004165866537,0.48277777777777775,0.3420691192005165,0.17121507814938328,125851.22495623621,-1756.1368642274929,124095.08809200872,199,0,37.666666666666664,37,14,21,40.73496066003713,0.576295045045045,49.150219298245595,1003.3991228070149,27.118895211000403,0
1375,4,1,2,48,0.02,0.04,0.96,50,1400,1000,400,0.7142857142857143,18,10,8,337.97627451317976,0.4830527210884354,0.3449792531120328,0.17330272799505583,126043.8368055554,-1479.7401604340052,124564.09664512139,200,0,38.88,34,16,22,40.47372060857536,0.5842524509803921,48.95833333333332,1004.1666666666654,29.534313725490158,0
1376,4,4,3,49,0.07692307692307693,0.057692307692307696,0.9423076923076923,52,1350,1000,350,0.7407407407407407,17,10,7,313.9495286335367,0.48182975113122173,0.3237366484157629,0.16396688124256742,126795.93474915955,-2438.495210570562,124357.439538589,201,0,37.25,38,14,20,40.305549662317496,0.5841557017543859,48.21047008547007,1007.1581196581168,26.504161043634653,0
1377,4,4,8,45,0.07547169811320754,0.1509433962264151,0.8490566037735849,53,1700,1400,300,0.8235294117647058,20,14,6,316.74002784524924,0.48140420899854863,0.34486567640206456,0.16903254951345476,127670.36132812497,-2511.991957787733,125158.36937033724,202,0,36.79245283018868,39,14,17,39.34111523397239,0.5913461538461539,47.34375,1010.6249999999998,25.913461538461533,0
1378,4,2,2,45,0.0425531914893617,0.0425531914893617,0.9574468085106383,47,1350,800,550,0.5925925925925926,19,8,11,337.30975532893456,0.48061208757323465,0.3423196594266338,0.17928217866906057,127506.96277941311,-798.1315164281048,126708.831262985,203,0,41.02127659574468,37,10,18,38.98859606267868,0.5931869369369369,47.50548245614036,1009.9780701754403,27.296704599336223,0
1379,4,0,4,41,0.0,0.08888888888888889,0.9111111111111111,45,1250,800,450,0.64,17,8,9,351.6546480631249,0.4784301346801347,0.34895080839353243,0.18620401856457292,127354.73632812513,-43.023003472207165,127311.71332465293,204,1,43.55555555555556,35,10,18,38.782464740282066,0.5955357142857143,47.65625000000001,1009.375000000001,28.839285714285744,0
1380,4,4,1,44,0.08888888888888889,0.022222222222222223,0.9777777777777777,45,1250,1000,250,0.8,15,10,5,383.52760419955627,0.4789141414141414,0.3047998590270149,0.19710192925540837,126136.14843149275,1047.5177816224545,127183.66621311521,205,0,44.022222222222226,33,12,20,39.23475560164288,0.5874368686868687,48.86642156862745,1004.5343137254906,30.44043374925729,15
1381,4,4,1,47,0.08333333333333333,0.020833333333333332,0.9791666666666666,48,1250,900,350,0.72,16,9,7,355.37912590583346,0.48043181146572106,0.30808840887629874,0.18723706185784966,127152.0408163266,-555.3475005198065,126596.69331580678,206,0,41.854166666666664,34,14,22,38.89651203966005,0.5955882352941176,47.85714285714286,1008.5714285714291,29.663865546218503,0
1382,4,0,3,44,0.0,0.06382978723404255,0.9361702127659575,47,1550,900,650,0.5806451612903226,22,9,13,353.9178072449548,0.48022664199814985,0.2985508873587681,0.18686259998511653,127237.93730977809,-393.64564579045367,126844.29166398763,207,1,42.787234042553195,35,12,22,38.845192344461,0.5943452380952381,47.77199074074075,1008.9120370370382,28.826058201058235,0
1383,4,3,5,42,0.06382978723404255,0.10638297872340426,0.8936170212765957,47,1500,1000,500,0.6666666666666666,20,10,10,341.02528369421333,0.47895467160037003,0.2816022811238892,0.1832399012385658,127945.07345183053,-673.4990057624823,127271.57444606804,208,0,41.361702127659576,36,11,16,38.44659023449093,0.599537037037037,47.07207207207209,1011.7117117117143,28.103103103103177,0
1384,4,2,1,43,0.045454545454545456,0.022727272727272728,0.9772727272727273,44,1500,1000,500,0.6666666666666666,20,10,10,358.6335538955366,0.4764358703312192,0.27911273974738826,0.19323785759805717,128056.65569540896,385.0827064043254,128441.73840181329,209,0,41.77272727272727,35,9,20,37.88700686106346,0.6026785714285714,46.96180555555556,1012.1527777777778,28.918650793650794,0
1385,4,1,5,39,0.022727272727272728,0.11363636363636363,0.8863636363636364,44,1050,700,350,0.6666666666666666,14,7,7,356.1910018751951,0.4757091261451727,0.2753784211915873,0.19264152090946432,128206.57920030765,333.266260105635,128539.84546041329,210,0,42.40909090909091,33,11,21,37.79545821232656,0.6085858585858586,46.813725490196084,1012.7450980392163,30.689245395127767,0
1386,4,1,1,39,0.025,0.025,0.975,40,1300,900,400,0.6923076923076923,17,9,8,367.30132384501485,0.4734909188034188,0.2599389332003985,0.19913687990083814,128304.3822058976,1425.2738878686123,129729.6560937662,211,0,45.25,32,8,22,37.41405990362245,0.6119791666666667,46.71717171717173,1013.1313131313151,31.660353535353597,0
1387,4,1,0,40,0.025,0.0,1.0,40,1150,900,250,0.782608695652174,14,9,5,363.65480848004586,0.47270299145299144,0.25873178931639873,0.19826963794319413,128528.34093778704,1347.9898415978043,129876.33077938485,212,0,45.9,32,8,20,37.27742497820944,0.6142578125,46.496212121212125,1014.0151515151522,31.687973484848506,0
1388,4,1,2,39,0.024390243902439025,0.04878048780487805,0.9512195121951219,41,1150,400,750,0.34782608695652173,19,4,15,361.9284648718274,0.47289126016260163,0.2708408320906823,0.2003985235457627,129140.88010204076,1147.9520975056603,130288.83219954642,213,0,45.75609756097561,34,7,21,36.69599633013196,0.6158088235294117,45.89285714285714,1016.4285714285709,29.89495798319326,0
1389,4,0,3,36,0.0,0.07692307692307693,0.9230769230769231,39,1100,800,300,0.7272727272727273,14,8,6,385.09727311058697,0.47185672514619886,0.21662202437092115,0.19198370168031453,124877.48101691648,1928.9967580169223,126806.4777749334,214,1,47.666666666666664,33,6,17,40.499836521170515,0.5744949494949495,50.12254901960784,999.5098039215679,30.28817587641115,16
1390,4,3,3,36,0.07692307692307693,0.07692307692307693,0.9230769230769231,39,900,600,300,0.6666666666666666,12,6,6,382.30926179087714,0.4725033738191633,0.21817622674311,0.1927112262858271,125337.23695513746,1783.5173070453698,127120.75426218283,215,0,46.87179487179487,33,6,16,40.09237445437116,0.579229797979798,49.66299019607843,1001.3480392156863,30.34387997623292,0
1391,4,1,2,35,0.02702702702702703,0.05405405405405406,0.9459459459459459,37,1450,1000,450,0.6896551724137931,19,10,9,392.83169181122173,0.47409909909909914,0.153823647734338,0.1920221781559486,124052.04916678698,2346.3152693675725,126398.36443615454,216,0,48.62162162162162,33,4,19,41.16627198917456,0.5659722222222222,50.949754901960794,996.2009803921583,30.187908496732067,16
1392,4,10,1,44,0.2222222222222222,0.022222222222222223,0.9777777777777777,45,750,300,450,0.4,12,3,9,331.24864972545583,0.48337542087542085,0.25505304299274134,0.16077678364723344,123753.12500000001,-794.1726138985019,122958.95238610152,217,0,40.71111111111111,39,6,17,43.010189838079285,0.5512820512820513,51.25,995.0000000000001,25.512820512820515,16
1393,4,3,0,47,0.06382978723404255,0.0,1.0,47,1350,800,550,0.5925925925925926,19,8,11,321.81942998411336,0.4827705827937095,0.27817307275642467,0.15896714298008002,124492.38631105809,-1387.0126288915485,123105.37368216654,218,0,39.8936170212766,40,7,14,42.47899694501019,0.5572916666666667,50.508130081300806,997.9674796747955,24.949186991869887,0
1394,4,2,5,44,0.04081632653061224,0.10204081632653061,0.8979591836734694,49,1300,800,500,0.6153846153846154,18,8,10,318.74522338501754,0.4834892290249433,0.30004249541360495,0.15985974142768694,125127.06479484752,-1821.203586654779,123305.86120819274,219,0,39.224489795918366,40,9,16,41.90028779414255,0.5638020833333333,49.87296747967479,1000.5081300812999,25.012703252032498,0
1395,4,4,2,46,0.08333333333333333,0.041666666666666664,0.9583333333333334,48,2150,1900,250,0.8837209302325582,24,19,5,325.2517996076937,0.4824357269503546,0.2203464944138911,0.16646052006475523,125965.39849175338,-625.8793403423367,125339.51915141105,220,0,40.270833333333336,39,9,19,40.87382397703296,0.5739850427350428,49.03645833333333,1003.8541666666658,25.739850427350405,16
1396,4,3,8,41,0.061224489795918366,0.16326530612244897,0.8367346938775511,49,1650,1300,350,0.7878787878787878,20,13,7,316.5765146370331,0.4827628968253968,0.22706584268763108,0.16408321724746522,126484.64551592767,-1791.5131113059174,124693.13240462175,221,0,40.36734693877551,37,12,17,40.55846232105224,0.5827702702702703,48.519736842105246,1005.9210526315765,27.187055476529093,0
1397,4,4,3,42,0.08888888888888889,0.06666666666666667,0.9333333333333333,45,1000,600,400,0.6,14,6,8,339.62167097462805,0.4801557239057239,0.2416379112031286,0.17638415815133915,126567.38281250012,-402.9947916666522,126164.38802083346,222,0,42.111111111111114,35,10,20,39.89389233954451,0.5875,48.43750000000001,1006.2500000000009,28.750000000000025,0
1398,4,2,1,43,0.045454545454545456,0.022727272727272728,0.9772727272727273,44,1400,1000,400,0.7142857142857143,18,10,8,338.48536085027774,0.48056509866102887,0.25054360527144626,0.17720471173361266,126893.37722435303,-209.68988414086905,126683.68734021216,223,0,43.59090909090909,36,8,23,39.587757535114164,0.5888310185185186,48.11373873873875,1007.5450450450475,27.98736236236243,0
1399,4,3,3,43,0.06521739130434782,0.06521739130434782,0.9347826086956522,46,800,500,300,0.625,11,5,6,320.05395877171145,0.4796799516908212,0.2714577140257939,0.17120806172169065,127766.20513048809,-1021.4287005433766,126744.77642994472,224,0,42.5,38,8,21,39.159533622177605,0.5940241228070176,47.24893162393163,1011.0042735042744,26.605375618533536,0
1400,4,1,1,43,0.022727272727272728,0.022727272727272728,0.9772727272727273,44,1300,800,500,0.6153846153846154,18,8,10,334.0832732293655,0.4798273431994362,0.2745405920132906,0.1782439532675586,127660.40322417059,-270.15892581765485,127390.24429835293,225,0,44.61363636363637,36,8,22,38.9131100958324,0.5966435185185186,47.35360360360363,1010.5855855855895,28.071821821821928,0
1401,4,1,3,41,0.022727272727272728,0.06818181818181818,0.9318181818181819,44,1400,900,500,0.6428571428571429,19,9,10,372.8799685803585,0.4792327343199436,0.21071538382699662,0.185187308023952,124718.62698847511,562.2042650759097,125280.83125355102,226,0,42.43181818181818,36,8,17,40.97003006388577,0.5665509259259259,50.28153153153154,998.873873873875,27.74649649649653,15
1402,4,1,2,40,0.023809523809523808,0.047619047619047616,0.9523809523809523,42,1550,1100,450,0.7096774193548387,20,11,9,390.7169774576743,0.4806910569105691,0.2518262664760995,0.19480164743079784,124880.98072562365,1358.623866213157,126239.6045918368,227,0,45.142857142857146,34,8,18,40.35577457519451,0.5723039215686274,50.11904761904762,999.5238095238101,29.397759103641473,0
1403,4,5,3,42,0.1111111111111111,0.06666666666666667,0.9333333333333333,45,1150,800,350,0.6956521739130435,15,8,7,360.2732703710898,0.48173400673400674,0.23796719993378557,0.18449525458730962,125990.2011309264,78.18035923005425,126068.38149015646,228,0,41.28888888888889,38,7,21,39.96931644851195,0.5759320175438596,49.01175213675214,1003.9529914529924,26.41981556455243,0
1404,4,6,7,41,0.125,0.14583333333333334,0.8541666666666666,48,1250,600,650,0.48,19,6,13,333.1182180889255,0.48139221335697396,0.2378277153558055,0.17478516515299894,126984.3087972093,-1139.8084228212585,125844.50037438805,229,0,39.458333333333336,38,10,17,39.629708147834066,0.5860745614035088,48.023504273504265,1007.9059829059819,26.523841655420576,0
1405,4,2,2,41,0.046511627906976744,0.046511627906976744,0.9534883720930233,43,1200,800,400,0.6666666666666666,16,8,8,364.8356018202441,0.4779208194905869,0.17925964471360634,0.18267870837268732,125059.53089569171,643.5142602954079,125703.04515598713,230,0,43.46511627906977,34,9,19,40.81741450448307,0.5741421568627452,49.9404761904762,1000.2380952380961,29.418767507002826,15
1406,4,5,6,40,0.10869565217391304,0.13043478260869565,0.8695652173913043,46,1100,800,300,0.7272727272727273,14,8,6,332.7143163389611,0.47940821256038646,0.20583238017493777,0.17094760807522308,126126.42982696624,-807.1862255693795,125319.24360139685,231,0,41.45652173913044,37,9,17,40.520844703998826,0.5791103603603603,48.87609649122808,1004.4956140350897,27.14853010905648,0
1407,4,2,4,38,0.047619047619047616,0.09523809523809523,0.9047619047619048,42,1150,500,650,0.43478260869565216,18,5,13,359.32576918441464,0.47975948509485095,0.22120134360798205,0.18425002207115737,126043.83680555565,658.1597222222275,126701.99652777788,232,0,42.166666666666664,33,9,19,39.93775933609957,0.586489898989899,48.958333333333336,1004.1666666666674,30.429292929292952,0
1408,4,5,4,39,0.11627906976744186,0.09302325581395349,0.9069767441860466,43,1350,1000,350,0.7407407407407407,17,10,7,316.2051505631702,0.4795127353266888,0.20685864535440723,0.16150706793038924,125882.96402449052,-639.0316814595632,125243.93234303096,233,0,39.2093023255814,38,5,18,41.18559033322688,0.5748355263157895,49.118589743589745,1003.5256410256414,26.408569500674776,15
1409,4,1,0,40,0.025,0.0,1.0,40,1350,1200,150,0.8888888888888888,15,12,3,340.66086888716126,0.47594818376068376,0.23673551811677895,0.17345282548625943,125753.44676997582,567.8556884430552,126321.30245841888,234,0,42.925,35,5,20,40.70553504115703,0.5791666666666666,49.247685185185176,1003.0092592592578,28.657407407407366,0
1410,4,3,2,41,0.06976744186046512,0.046511627906976744,0.9534883720930233,43,1600,1300,300,0.8125,19,13,6,334.581920114721,0.4782668881506091,0.2009527503926425,0.1664782104538433,124796.83059025742,-77.99486880673146,124718.83572145068,235,0,40.86046511627907,40,3,17,41.84550447518306,0.5604166666666667,50.20325203252034,999.1869918699211,24.97967479674803,16
1411,4,3,5,39,0.06818181818181818,0.11363636363636363,0.8863636363636364,44,1550,1200,350,0.7741935483870968,19,12,7,330.6611749883032,0.47933183579985905,0.21191764090036624,0.16725676909602538,125481.23150887594,-501.1499733944647,124980.08153548147,236,0,38.77272727272727,38,6,16,41.236804222648765,0.5707236842105263,49.51923076923078,1001.9230769230785,26.366396761133643,0
1412,4,3,3,39,0.07142857142857142,0.07142857142857142,0.9285714285714286,42,800,400,400,0.5,12,4,8,339.9487532869558,0.4766502129307007,0.23392408991914615,0.17218007714858394,125535.48216713338,135.1261311987747,125670.60829833215,237,0,41.30952380952381,36,6,19,40.94818706221674,0.5749421296296297,49.465090090090094,1002.1396396396399,27.83721221221222,0
1413,4,1,0,40,0.025,0.0,1.0,40,1450,1000,450,0.6896551724137931,19,10,9,375.2941603308715,0.47564102564102567,0.2561751635600542,0.1797905377197156,123198.93678212714,1397.9081512352134,124596.84493336236,238,0,43.725,33,7,15,42.493082129778216,0.5571338383838385,51.80759803921569,992.7696078431379,30.08392751039812,16
1414,4,5,5,40,0.1111111111111111,0.1111111111111111,0.8888888888888888,45,1250,700,550,0.56,18,7,11,352.91463867997345,0.4784301346801347,0.2772335115864528,0.1753321929679997,124733.04866133405,-195.9762400467369,124537.07242128732,239,0,39.75555555555555,38,7,15,41.45365418894829,0.5630482456140351,50.267094017094024,998.931623931625,26.287674313990134,0
1415,4,6,5,41,0.13043478260869565,0.10869565217391304,0.8913043478260869,46,850,400,450,0.47058823529411764,13,4,9,354.9507217056686,0.48179347826086955,0.3119291973101648,0.18070918521544557,125748.9818467382,-272.7762710935863,125476.2055756446,240,0,38.69565217391305,38,8,18,40.35182324953842,0.5734649122807017,49.25213675213675,1002.9914529914525,26.3945119208277,0
1416,4,5,4,42,0.10869565217391304,0.08695652173913043,0.9130434782608696,46,700,500,200,0.7142857142857143,9,5,4,352.3989224749818,0.4823268921095008,0.3042090361501524,0.18058042930315565,126017.01754145647,-318.347760975986,125698.66978048049,241,0,38.869565217391305,38,8,21,40.13930268851528,0.5762061403508771,48.985042735042725,1004.0598290598276,26.422627080521778,0
1417,4,1,2,41,0.023255813953488372,0.046511627906976744,0.9534883720930233,43,1000,700,300,0.7,13,7,6,367.28966367739883,0.47948966408268734,0.30517421742979023,0.18753836184234624,125869.56259645025,646.1178626542744,126515.68045910452,242,0,41.58139534883721,35,8,22,39.91782006920415,0.5803571428571428,49.13194444444442,1003.4722222222192,28.670634920634836,0
1418,4,2,2,41,0.046511627906976744,0.046511627906976744,0.9534883720930233,43,1300,600,700,0.46153846153846156,20,6,14,366.012697912811,0.47849760059062385,0.2971824959407878,0.18951837298236207,126444.09789804395,656.390771177741,127100.4886692217,239,0,36.69767441860465,33,10,17,39.357027537468014,0.5905934343434344,48.56004901960784,1005.759803921568,30.477569815805094,0
1419,4,1,0,42,0.023809523809523808,0.0,1.0,42,850,400,450,0.47058823529411764,13,4,9,370.47569041225125,0.477787456445993,0.29982429718875525,0.19218426440135555,126519.74288337934,974.4978191001051,127494.24070247944,240,0,37.976190476190474,32,10,18,39.16682354417672,0.59375,48.48484848484849,1006.0606060606068,31.439393939393963,0
1420,4,0,4,38,0.0,0.09523809523809523,0.9047619047619048,42,1000,500,500,0.5,15,5,10,371.7966842409349,0.47735191637630664,0.2966541196152239,0.19316946371579222,126583.26478165499,1012.6476252423313,127595.91240689732,241,1,38.976190476190474,32,10,18,39.068120033458804,0.5944010416666667,48.42171717171718,1006.3131313131317,31.447285353535367,0
1421,4,1,1,38,0.02564102564102564,0.02564102564102564,0.9743589743589743,39,1150,900,250,0.782608695652174,14,9,5,395.4512262999963,0.47627080521817367,0.30970874785238833,0.20377593515127984,126246.3710580702,2184.856450167637,128431.22750823783,242,0,42.23076923076923,30,9,22,38.82127412955285,0.5961805555555555,48.75672043010752,1004.9731182795691,33.499103942652305,0
1422,4,2,1,39,0.05,0.025,0.975,40,1050,600,450,0.5714285714285714,15,6,9,385.27332091420794,0.47773771367521367,0.31257105943152474,0.20203357072330397,126960.75439453113,1782.9182942708178,128743.67268880195,243,0,41.75,31,9,21,38.339793281653755,0.6008064516129032,48.04687499999999,1007.8124999999991,32.51008064516126,0
1423,4,3,2,40,0.07142857142857142,0.047619047619047616,0.9523809523809523,42,1300,1000,300,0.7692307692307693,16,10,6,368.77347596535105,0.47638404955478125,0.3218237132636934,0.19834568029438426,127984.77993317021,1039.5462501634242,129024.32618333363,244,0,40.523809523809526,32,10,21,37.704069960901755,0.6087239583333333,47.03282828282829,1011.8686868686879,31.620896464646496,0
1424,4,0,0,40,0.0,0.0,1.0,40,1050,800,250,0.7619047619047619,13,8,5,388.0012761997582,0.47657585470085473,0.32446157936718967,0.2075779231560869,127770.56054168117,1915.0281101861588,129685.58865186734,245,1,42.25,30,10,21,37.43768279712842,0.6118055555555555,47.24462365591398,1011.0215053763445,33.70071684587815,0
1425,4,0,2,38,0.0,0.05,0.95,40,1350,700,650,0.5185185185185185,20,7,13,391.40283219831986,0.4764957264957265,0.32245514950166076,0.20992917407643333,127872.4983560239,2009.9316033645591,129882.42995938846,246,2,43.25,30,10,21,37.24695459579179,0.6128472222222222,47.14381720430108,1011.4247311827964,33.71415770609322,0
1426,4,3,1,40,0.07317073170731707,0.024390243902439025,0.975609756097561,41,1150,900,250,0.782608695652174,14,9,5,376.7748137789535,0.474364837398374,0.32001676692411407,0.20702700655634265,128837.6045227052,1508.8419411110604,130346.44646381626,247,0,42.34146341463415,31,10,20,36.62853768543457,0.6199596774193548,46.19140625000001,1015.2343750000009,32.749495967741964,0
1427,4,0,1,39,0.0,0.025,0.975,40,1000,700,300,0.7,13,7,6,380.7454863531192,0.47232905982905987,0.30849564325986667,0.21043468665012355,129069.04432508688,1828.4912109375095,130897.5355360244,248,1,41.35,31,9,20,36.291218178711766,0.6223118279569892,45.96354166666667,1016.145833333334,32.77889784946239,0
1428,4,0,0,39,0.0,0.0,1.0,39,850,500,350,0.5882352941176471,12,5,7,390.6652784959315,0.4725033738191633,0.31730133040176756,0.21533606926285603,128962.36423647254,2276.2235879870686,131238.5878244596,249,2,43.1025641025641,30,9,20,36.148328260773695,0.6239583333333334,46.06854838709678,1015.7258064516137,33.85752688172046,0
1429,4,0,1,38,0.0,0.02564102564102564,0.9743589743589743,39,1200,900,300,0.75,15,9,6,390.83837238599125,0.47168803418803423,0.31492334825668133,0.21598962684489026,129064.77627471404,2288.6934183142866,131353.4696930283,250,3,44.1025641025641,30,9,20,36.03918650793653,0.625,45.967741935483886,1016.1290322580662,33.87096774193554,0
1430,4,1,3,36,0.02564102564102564,0.07692307692307693,0.9230769230769231,39,1250,1000,250,0.8,15,10,5,379.5899579496041,0.47050719748088166,0.29407307544700423,0.21209826313738792,129499.41211276597,2031.3352796766676,131530.74739244263,251,0,44.282051282051285,31,8,18,35.881332352564904,0.6266801075268817,45.54036458333334,1017.8385416666678,32.83350134408606,0
1431,4,1,0,37,0.02702702702702703,0.0,1.0,37,1050,700,350,0.6666666666666666,14,7,7,399.0862671324911,0.47131506506506504,0.2939743021710237,0.22131147540983623,129201.388888889,2912.5000000000177,132113.88888888902,252,0,45.891891891891895,30,7,21,35.68989071038252,0.6263888888888889,45.83333333333334,1016.6666666666677,33.88888888888892,0
1432,4,0,4,33,0.0,0.10810810810810811,0.8918918918918919,37,1200,900,300,0.75,15,9,6,399.3857233321035,0.47090840840840836,0.2900940263037477,0.22227211532555674,129342.63117283957,2931.520061728406,132274.15123456798,253,1,46.891891891891895,29,8,21,35.53784361915164,0.6307471264367817,45.69444444444445,1017.2222222222227,35.07662835249044,0
1433,4,1,1,33,0.029411764705882353,0.029411764705882353,0.9705882352941176,34,1300,1000,300,0.7692307692307693,16,10,6,419.79515784097805,0.4718137254901961,0.24685111332668663,0.2336595689869595,129347.50297265162,4059.891085348132,133407.39405799974,254,0,41.73529411764706,28,6,22,35.013830037664796,0.6339285714285714,45.689655172413794,1017.2413793103449,36.330049261083744,0
1434,4,0,1,32,0.0,0.030303030303030304,0.9696969696969697,33,700,400,300,0.5714285714285714,10,4,6,429.1162482737967,0.4704861111111111,0.23626873151240213,0.2381926339930829,129239.21407755796,4491.72933496313,133730.9434125211,255,1,42.09090909090909,27,6,22,34.88782989414118,0.6361882716049383,45.79613095238094,1016.815476190475,37.65983245149908,0
1435,4,0,0,32,0.0,0.0,1.0,32,1000,800,200,0.8,12,8,4,429.0072879970933,0.4688760080645162,0.21120610826627662,0.23858948848333025,129314.88106310213,4695.405284509608,134010.28634761175,256,2,42.375,27,5,22,34.81300292611557,0.6369598765432098,45.721726190476176,1017.1130952380937,37.67085537918866,0
1436,4,0,1,31,0.0,0.03125,0.96875,32,1150,800,350,0.6956521739130435,15,8,7,426.67487432030373,0.4684349798387097,0.20376461988304095,0.23843595917899324,129504.14540816325,4651.232993197277,134155.37840136053,257,3,43.375,27,5,20,34.678362573099406,0.6388888888888888,45.535714285714285,1017.8571428571428,37.698412698412696,0
1437,4,0,3,28,0.0,0.0967741935483871,0.9032258064516129,31,1050,700,350,0.6666666666666666,14,7,7,428.04824287791956,0.4674283154121864,0.18421189130055504,0.239434017132285,129542.01488538114,4890.046370110532,134432.06125549166,258,4,44.354838709677416,27,4,20,34.60462042586368,0.6392746913580247,45.4985119047619,1018.0059523809516,37.703924162257465,0
1438,4,0,0,28,0.0,0.0,1.0,28,800,700,100,0.875,9,7,2,432.37438324626044,0.46199845679012347,0.1020756187877605,0.24193162054924325,129554.63927469125,5603.221450617262,135157.8607253085,259,5,41.607142857142854,26,2,20,34.48158253751704,0.6430288461538461,45.4861111111111,1018.0555555555545,39.15598290598287,0
1439,4,1,2,27,0.034482758620689655,0.06896551724137931,0.9310344827586207,29,600,300,300,0.5,9,3,6,418.50462133960747,0.46233579638752054,0.09225610584983457,0.2359126050662528,129845.17000159435,5068.160740858839,134913.3307424532,260,0,41.13793103448276,27,2,21,34.537432471893695,0.6423611111111112,45.200892857142854,1019.1964285714283,37.748015873015866,0
1440,4,0,0,27,0.0,0.0,1.0,27,750,400,350,0.5333333333333333,11,4,7,450.77474635616665,0.46005460588793917,0.12297859188112725,0.25179159314934174,129486.6690551036,6273.864079963848,135760.53313506744,261,1,44.666666666666664,25,2,21,34.08305122552879,0.64625,45.55288461538462,1017.7884615384619,40.711538461538474,0
1441,4,0,0,27,0.0,0.0,1.0,27,750,400,350,0.5333333333333333,11,4,7,450.68918558686755,0.45999525166191835,0.12480542875631806,0.252266819033777,129568.23545878532,6279.00050336949,135847.2359621548,262,2,45.666666666666664,25,2,21,34.00148879794322,0.6470833333333333,45.47275641025641,1018.1089743589743,40.72435897435897,0
1442,4,1,0,28,0.03571428571428571,0.0,1.0,28,1050,900,150,0.8571428571428571,12,9,3,435.31861724281566,0.4594080687830688,0.12055393586005825,0.24803037494067393,130262.5868055555,5741.145833333328,136003.73263888882,263,0,45.0,26,2,23,33.68197278911565,0.6502403846153846,44.791666666666664,1020.8333333333329,39.2628205128205,0
1443,4,1,0,29,0.034482758620689655,0.0,1.0,29,850,400,450,0.47058823529411764,13,4,9,420.96218766982764,0.4595648604269294,0.11657500702500934,0.242688939066028,130718.71456916089,5205.527210884338,135924.24178004524,264,0,44.41379310344828,27,2,19,33.58313930927435,0.6512345679012346,44.34523809523809,1022.6190476190467,37.87477954144617,0
1444,4,0,0,29,0.0,0.0,1.0,29,1100,600,500,0.5454545454545454,16,6,10,418.41535965386686,0.4585899014778325,0.11267040898155556,0.24313324952859833,131023.24263038546,5164.427437641716,136187.67006802716,265,1,45.41379310344828,27,2,22,33.33817829457364,0.654320987654321,44.047619047619044,1023.8095238095235,37.918871252204575,0
1445,4,0,1,28,0.0,0.034482758620689655,0.9655172413793104,29,1300,1100,200,0.8461538461538461,15,11,4,421.0886029771166,0.4579741379310345,0.10012335213226575,0.22505545869579488,127730.5246642928,4957.173637684239,132687.69830197704,266,2,46.41379310344828,27,2,20,36.642652976102845,0.6207561728395061,47.28422619047619,1010.8630952380953,37.439373897707235,13
1446,4,2,1,29,0.06666666666666667,0.03333333333333333,0.9666666666666667,30,800,600,200,0.75,10,6,4,403.9647905034958,0.46046455938697317,0.06834042553191488,0.21873669531871295,128253.6600772888,4361.992584885696,132615.6526621745,267,0,44.13333333333333,28,2,22,36.537529550827415,0.6227678571428572,46.767241379310335,1012.9310344827576,36.1761083743842,0
1447,4,2,1,30,0.06451612903225806,0.03225806451612903,0.967741935483871,31,800,600,200,0.75,10,6,4,381.7004313830908,0.46344086021505376,0.05895709364234247,0.1872149734878969,124194.84911550465,3281.0454965891977,127475.89461209385,268,0,43.41935483870968,30,1,19,41.29472312117944,0.575,50.806451612903224,996.7741935483868,33.2258064516129,16
1448,4,3,0,33,0.09090909090909091,0.0,1.0,33,1250,800,450,0.64,17,8,9,361.3395439484846,0.46602746212121215,0.08524600507942504,0.18123583914491864,125130.24224175334,2445.502389975521,127575.74463172886,269,0,41.666666666666664,31,2,23,40.83159812597604,0.581989247311828,49.86979166666666,1000.5208333333322,32.27486559139781,0
1449,4,1,0,34,0.029411764705882353,0.0,1.0,34,1200,1000,200,0.8333333333333334,14,10,4,353.1797042047091,0.4663547237076649,0.096688398281227,0.17929967080469236,125632.11024385263,2074.1423069074503,127706.25255076008,270,0,41.411764705882355,32,2,19,40.51689756507136,0.5846354166666667,49.368686868686865,1002.5252525252522,31.32891414141413,0
1450,4,2,2,34,0.05555555555555555,0.05555555555555555,0.9444444444444444,36,1150,600,550,0.5217391304347826,17,6,11,339.0777970147394,0.4688492063492064,0.10631670187984188,0.17517596012020914,126351.67363514031,1369.282989161647,127720.95662430195,271,0,40.05555555555556,33,3,17,40.12930684219077,0.5896464646464646,48.65196078431372,1005.392156862745,30.466428995840758,0
1451,4,0,0,34,0.0,0.0,1.0,34,700,600,100,0.8571428571428571,8,6,2,356.117979365702,0.4674131016042781,0.10955910952479031,0.18275036426132155,126076.52664184592,2179.623582628067,128256.15022447398,272,1,42.26470588235294,31,3,22,39.98457690479279,0.591733870967742,48.925781250000014,1004.2968750000017,32.39667338709683,0
1452,4,1,1,34,0.02857142857142857,0.02857142857142857,0.9714285714285714,35,1250,800,450,0.64,17,8,9,347.4405543176341,0.4675070028011204,0.10513022888713563,0.17967640094711942,126392.74691358034,1782.793209876564,128175.5401234569,273,0,42.02857142857143,32,3,18,39.876841620626166,0.5924479166666667,48.61111111111112,1005.5555555555563,31.423611111111136,0
1453,4,0,1,33,0.0,0.029411764705882353,0.9705882352941176,34,1450,1000,450,0.6896551724137931,19,10,9,358.759376210974,0.46557486631016043,0.10721111745669143,0.18587633676926726,126469.13528442392,2274.3976169162474,128743.53290134016,274,1,43.5,31,3,22,39.51361920172602,0.595766129032258,48.53515625000001,1005.8593750000007,32.447076612903246,0
1454,4,1,1,33,0.029411764705882353,0.029411764705882353,0.9705882352941176,34,1150,900,250,0.782608695652174,14,9,5,384.6167203147547,0.4656491384432561,0.018172743398421343,0.19677673679563745,125951.55897070836,3138.897393566509,129090.45636427487,275,0,43.3235294117647,33,1,19,39.398297928620835,0.5855429292929293,49.05024509803921,1003.799019607843,30.418152109328574,16
1455,4,3,3,33,0.08333333333333333,0.08333333333333333,0.9166666666666666,36,1550,900,650,0.5806451612903226,22,9,13,363.1519972140669,0.46301256613756614,0.04860946978649672,0.18992535231306745,126852.04790249419,2013.3487003870018,128865.39660288118,276,0,41.72222222222222,34,2,21,39.008951784448136,0.5925245098039216,48.1547619047619,1007.3809523809513,29.628851540616214,0
1456,4,3,1,35,0.08333333333333333,0.027777777777777776,0.9722222222222222,36,1000,800,200,0.8,12,8,4,342.50535365366216,0.46428571428571425,0.04653637137432032,0.18220425866779458,127542.5612953515,1536.8020124716531,129079.36330782315,277,0,37.861111111111114,34,2,18,38.82095855431151,0.5995710784313726,47.470238095238095,1010.1190476190478,29.709383753501406,0
1457,4,0,3,32,0.0,0.08571428571428572,0.9142857142857143,35,1600,1100,500,0.6875,21,11,10,342.72038807853085,0.46327030812324926,0.04486239149451632,0.18327339644602533,127753.08956916092,1756.717687074823,129509.80725623574,278,1,39.57142857142857,34,1,19,38.60005495368189,0.6017156862745099,47.26190476190476,1010.9523809523803,29.73389355742295,0
1458,4,1,0,33,0.030303030303030304,0.0,1.0,33,450,100,350,0.2222222222222222,8,1,7,357.4212499999997,0.46247632575757575,0.0363257575757574,0.19011768617021277,127538.00632588525,2516.958728701163,130054.96505458641,279,0,41.24242424242424,32,1,21,38.44895833333331,0.6041666666666667,47.47474747474748,1010.1010101010112,31.5656565656566,0
1459,4,0,1,32,0.0,0.030303030303030304,0.9696969696969697,33,950,700,250,0.7368421052631579,12,7,5,358.9912315206713,0.46216066919191917,0.04068420335286893,0.19155772113943048,127665.57621671272,2566.164485766777,130231.7407024795,280,1,42.24242424242424,32,1,21,38.27851699150424,0.60546875,47.34848484848486,1010.6060606060619,31.581439393939434,0
1460,4,1,1,32,0.030303030303030304,0.030303030303030304,0.9696969696969697,33,750,500,250,0.6666666666666666,10,5,5,358.611374283171,0.46275252525252525,0.04782179229537786,0.19181037233703085,127761.29548324167,2563.3307506887254,130324.6262339304,281,0,43.0,32,1,23,38.19002123142251,0.6064453125,47.25378787878789,1010.9848484848497,31.593276515151555,0
1461,4,3,1,34,0.08571428571428572,0.02857142857142857,0.9714285714285714,35,650,300,350,0.46153846153846156,10,3,7,338.66876073111746,0.46428571428571425,0.04750155261258504,0.18370999506580868,128325.39859693874,1691.9607426303803,130017.35933956913,282,0,41.114285714285714,34,1,26,38.11782790898053,0.6075367647058824,46.69642857142857,1013.2142857142854,29.80042016806722,0
1462,4,2,3,33,0.05555555555555555,0.08333333333333333,0.9166666666666666,36,1700,1500,200,0.8823529411764706,19,15,4,328.6574621959237,0.4644510582010582,0.04897435897435898,0.18104012748080534,128936.76757812488,1275.2061631944289,130211.9737413193,283,0,39.861111111111114,35,1,18,37.748931623931625,0.6116071428571428,46.09374999999999,1015.6249999999991,29.017857142857117,0
1463,4,0,0,33,0.0,0.0,1.0,33,800,200,600,0.25,14,2,12,355.4663965886035,0.46101641414141414,0.05158348150748848,0.19318407348792957,128400.34060618811,2528.4012792062035,130928.74188539431,284,1,44.39393939393939,32,1,18,37.615755159669476,0.6129557291666667,46.62247474747475,1013.5101010101007,31.672190656565647,0
1464,4,0,1,32,0.0,0.030303030303030304,0.9696969696969697,33,950,800,150,0.8421052631578947,11,8,3,355.67218770178795,0.460976957070707,0.05478552339538845,0.19345097038414333,128432.33471074386,2535.9618916437144,130968.29660238758,285,2,45.39393939393939,32,1,18,37.57785251619331,0.61328125,46.59090909090909,1013.6363636363641,31.676136363636378,0
1465,4,0,0,32,0.0,0.0,1.0,32,950,800,150,0.8421052631578947,11,8,3,365.1585225074951,0.46085349462365593,0.056850668122832015,0.19832720032629678,128375.3479851616,2975.470479329423,131350.81846449102,286,3,47.3125,31,1,18,37.39573964623754,0.615255376344086,46.647135416666664,1013.4114583333327,32.69069220430105,0
1466,4,0,0,32,0.0,0.0,1.0,32,650,400,250,0.6153846153846154,9,4,5,365.7470829110375,0.46039146505376344,0.06320247270391777,0.19897561428808017,128441.33377075195,2995.408630371093,131436.74240112305,287,4,48.3125,31,1,18,37.31334296724469,0.6159274193548387,46.58203125,1013.671875,32.69909274193548,0
1467,4,0,1,31,0.0,0.03125,0.96875,32,850,500,350,0.5882352941176471,12,5,7,366.19370366394315,0.46003444220430106,0.06637715129720045,0.19938350886206016,128474.33302137579,3009.2983669704813,131483.63138834626,288,5,49.3125,31,1,18,37.268280674715314,0.616263440860215,46.549479166666664,1013.8020833333327,32.70329301075267,0
1468,4,0,1,30,0.0,0.03225806451612903,0.967741935483871,31,1200,1000,200,0.8333333333333334,14,10,4,366.9711063265054,0.45645161290322583,0.039537179909128195,0.2005453250866138,128621.28434284306,3240.0590024858257,131861.3433453289,206,6,42.61290322580645,30,1,19,37.0983503378826,0.6204861111111111,46.40456989247311,1014.3817204301072,33.81272401433691,0
1469,4,1,2,29,0.03225806451612903,0.06451612903225806,0.935483870967742,31,850,500,350,0.5882352941176471,12,5,7,368.9391471633908,0.455331541218638,0.039565564633578854,0.20266162752909747,128825.87808200369,3305.781918429878,132131.66000043356,207,0,43.16129032258065,30,1,21,36.83939052914958,0.6225694444444445,46.20295698924731,1015.1881720430106,33.83960573476702,0
1470,4,1,1,29,0.03333333333333333,0.03333333333333333,0.9666666666666667,30,700,300,400,0.42857142857142855,11,3,8,375.83483651090216,0.45179597701149427,0.03869731800766263,0.20620127516679243,128778.12500000012,3679.8611111111254,132457.98611111124,208,0,44.7,29,1,22,36.71319102353584,0.625,46.25000000000001,1015.0000000000009,35.00000000000003,0
1471,4,1,0,30,0.03333333333333333,0.0,1.0,30,950,600,350,0.631578947368421,13,6,7,380.61005106154255,0.45155651340996167,0.050273224043715814,0.21106557377049198,129201.388888889,3835.069444444462,133036.45833333346,209,0,45.166666666666664,29,1,23,36.15949453551913,0.6293103448275862,45.83333333333334,1016.6666666666677,35.05747126436785,0
1472,4,0,0,30,0.0,0.0,1.0,30,1300,1000,300,0.7692307692307693,16,10,6,381.9682291643738,0.4513649425287356,0.051561504142765724,0.2121981315585392,129272.00038580265,3875.5594135802694,133147.55979938293,210,1,46.166666666666664,29,1,23,36.052877173814075,0.6300287356321839,45.7638888888889,1016.9444444444459,35.06704980842917,0
1473,4,1,0,31,0.03225806451612903,0.0,1.0,31,550,300,250,0.5454545454545454,8,3,5,381.33819295663704,0.44959677419354843,0.08757218305367287,0.21556121697235833,129954.0499624235,3711.2885160134256,133665.33847843693,211,0,45.645161290322584,30,1,19,35.37354996045347,0.6340277777777779,45.09408602150538,1019.6236559139792,33.98745519713264,0
1474,4,0,1,30,0.0,0.03225806451612903,0.967741935483871,31,1100,600,500,0.5454545454545454,16,6,10,382.99632689726104,0.4486111111111111,0.09072368197423453,0.21764282288952136,130159.70054341538,3770.1374436350998,133929.83798705047,212,1,46.645161290322584,30,1,19,35.12194854232526,0.6361111111111111,44.89247311827957,1020.4301075268813,34.01433691756271,0
1475,4,0,1,29,0.0,0.03333333333333333,0.9666666666666667,30,700,500,200,0.7142857142857143,9,5,4,392.60131961130696,0.4471264367816092,0.09518750567511103,0.22207079264916932,129979.17631172847,4205.999228395073,134185.17554012354,213,2,49.06666666666667,29,1,19,35.06083719240896,0.6372126436781609,45.06944444444445,1019.7222222222229,35.16283524904217,0
1476,4,1,1,29,0.03333333333333333,0.03333333333333333,0.9666666666666667,30,650,400,250,0.6153846153846154,9,4,5,392.00333194502304,0.44602490421455937,0.10897959183673467,0.22335073564309452,130262.58680555549,4212.673611111106,134475.2604166666,214,0,49.833333333333336,29,1,21,34.78741496598639,0.6400862068965517,44.791666666666664,1020.8333333333328,35.20114942528734,0
1477,4,0,0,29,0.0,0.0,1.0,29,1300,1200,100,0.9230769230769231,14,12,2,402.9987505206164,0.44499178981937604,0.09767769176636176,0.22961556715709533,130262.58680555543,4699.131944444427,134961.71874999985,100,1,45.172413793103445,28,1,22,34.50680272108843,0.6432291666666667,44.79166666666666,1020.8333333333323,36.4583333333333,0
1478,4,0,1,28,0.0,0.034482758620689655,0.9655172413793104,29,1200,900,300,0.75,15,9,6,456.88978088550226,0.4443247126436782,0.10966681302523162,0.23555981527486125,126268.08080002839,5894.36915391157,132162.44995393997,101,2,46.172413793103445,27,2,18,37.25508340736356,0.6057098765432098,48.73511904761905,1005.0595238095241,37.22442680776015,16
1479,4,0,0,28,0.0,0.0,1.0,28,750,400,350,0.5333333333333333,11,4,7,471.28364508874324,0.44381062610229277,0.10535549804815947,0.2432600367756001,126315.16965782651,6306.054717268697,132621.22437509522,102,3,46.57142857142857,26,2,18,36.844360863780565,0.609775641025641,48.688271604938265,1005.2469135802467,38.66334283000948,0
1480,4,0,0,28,0.0,0.0,1.0,28,1150,900,250,0.782608695652174,14,9,5,466.9107093191262,0.44229497354497355,0.10150174162595604,0.24260754864302947,126586.794243446,6220.94597812832,132807.74022157432,103,4,47.57142857142857,26,2,18,36.671586668711356,0.6125801282051282,48.4182098765432,1006.3271604938261,38.704890788224084,0
1481,4,2,0,30,0.06666666666666667,0.0,1.0,30,950,700,250,0.7368421052631579,12,7,5,440.7111808885552,0.4469348659003831,0.09095353362760439,0.23289049084878252,127273.1727482163,5218.142051459884,132491.31479967618,104,0,45.333333333333336,28,2,20,36.61955954245573,0.6127232142857143,47.73706896551723,1009.0517241379301,36.03756157635465,0
1482,4,1,1,30,0.03225806451612903,0.03225806451612903,0.967741935483871,31,750,400,350,0.5333333333333333,11,4,7,424.84633976282964,0.448252688172043,0.08402347975668967,0.22662624399665315,127652.81635802466,4646.566358024685,132299.38271604935,105,0,44.83870967741935,29,2,17,36.62784038849185,0.6135057471264368,47.36111111111111,1010.5555555555553,34.84674329501915,0
1483,4,4,1,33,0.11764705882352941,0.029411764705882353,0.9705882352941176,34,950,600,350,0.631578947368421,13,6,7,393.80151161149865,0.45313428401663697,0.09036594473487702,0.21522458124399876,128624.38303489446,3330.4952938475762,131954.87832874205,106,0,41.73529411764706,32,2,19,36.414768483943256,0.615234375,46.401515151515156,1014.39393939394,31.699810606060623,0
1484,4,2,1,34,0.05714285714285714,0.02857142857142857,0.9714285714285714,35,1000,800,200,0.8,12,8,4,384.9561872497757,0.4521358543417367,0.11000774993541729,0.21330738632176952,129170.24289035461,2944.976841839669,132115.21973219427,107,0,41.48571428571429,33,2,21,36.08084689572031,0.6183712121212122,45.86397058823529,1016.5441176470583,30.80436720142601,0
1485,4,3,5,32,0.08108108108108109,0.13513513513513514,0.8648648648648649,37,1100,700,400,0.6363636363636364,15,7,8,364.1191828474534,0.4533283283283283,0.09687921359845642,0.20489783602835965,129776.92920918354,2050.857637785484,131827.78684696901,108,0,40.108108108108105,34,3,18,35.99257117264475,0.6222426470588236,45.26785714285713,1018.9285714285703,29.96848739495795,0
1486,4,0,0,32,0.0,0.0,1.0,32,750,600,150,0.8,9,6,3,393.18445924992943,0.4495337701612903,0.15037496544097317,0.20229703970227525,126183.34297839513,3522.6658950617402,129706.00887345687,109,2,45.21875,29,3,22,38.94341535342365,0.5984195402298851,48.81944444444445,1004.7222222222229,34.645593869731826,15
1487,4,3,0,35,0.08571428571428572,0.0,1.0,35,900,500,400,0.5555555555555556,13,5,8,362.7087263258559,0.4530812324929972,0.14762680025046948,0.19066683210743654,127060.18717796658,2217.167731609024,129277.3549095756,110,0,42.25714285714286,32,3,22,38.806094761010215,0.5992838541666667,47.948232323232325,1008.2070707070711,31.506470959595973,0
1488,4,2,4,33,0.05405405405405406,0.10810810810810811,0.8918918918918919,37,1000,800,200,0.8,12,8,4,342.30590945120923,0.45758258258258255,0.13611865140249435,0.18229779828913223,127586.77551903107,1334.7454311605366,128921.52095019161,111,0,40.91891891891892,33,4,16,38.7807294193757,0.6022727272727273,47.42647058823529,1010.2941176470583,30.61497326203207,0
1489,4,2,0,35,0.05714285714285714,0.0,1.0,35,900,500,400,0.5555555555555556,13,5,8,360.77019771071775,0.45339635854341737,0.15115207373271877,0.190720943537385,127289.03028700096,2184.417724609384,129473.44801161035,112,0,44.0,31,4,23,38.61989247311828,0.6041666666666667,47.72135416666667,1009.1145833333342,32.55208333333336,0
1490,4,1,1,35,0.027777777777777776,0.027777777777777776,0.9722222222222222,36,1000,600,400,0.6,14,6,8,351.7288101805005,0.45436507936507936,0.15158551654240782,0.18753402184374066,127633.67776566168,1778.488323895521,129412.1660895572,113,0,43.75,32,4,20,38.49467907867881,0.6051432291666667,47.380050505050505,1010.4797979797981,31.577493686868692,0
1491,4,2,0,37,0.05405405405405406,0.0,1.0,37,1000,700,300,0.7,13,7,6,369.7184831528862,0.45777027027027023,0.16701144006234836,0.18848261691042778,125804.862882653,2016.5753045555502,127821.43818720855,114,0,43.486486486486484,34,3,20,39.92375697163879,0.5818014705882353,49.19642857142857,1003.2142857142852,29.50630252100839,15
1492,4,2,2,37,0.05128205128205128,0.05128205128205128,0.9487179487179487,39,1200,700,500,0.5833333333333334,17,7,10,355.1820434150136,0.4591767881241566,0.1696987939363359,0.18381040948380323,126421.8445242842,1180.7805714557026,127602.6250957399,115,0,42.205128205128204,35,4,17,39.652266275367325,0.5860119047619048,48.58217592592593,1005.6712962962969,28.733465608465625,0
1493,4,1,2,36,0.02631578947368421,0.05263157894736842,0.9473684210526316,38,1050,1000,50,0.9523809523809523,11,10,1,367.84226164006174,0.4584815078236131,0.20379871363016555,0.19111067225835524,126582.35721371876,1712.4681122448915,128294.82532596365,116,0,44.18421052631579,34,4,18,39.16853976891832,0.5897671568627452,48.422619047619044,1006.3095238095233,29.597338935574214,0
1494,4,2,1,37,0.05263157894736842,0.02631578947368421,0.9736842105263158,38,1000,700,300,0.7,13,7,6,366.73423574631084,0.4600521574205785,0.19632567304644022,0.19250705356875455,127002.00007086156,1715.1962868480553,128717.19635770962,117,0,43.44736842105263,34,4,20,38.76446793433329,0.5940563725490196,48.00595238095237,1007.9761904761895,29.646358543417335,0
1495,4,2,1,38,0.05128205128205128,0.02564102564102564,0.9743589743589743,39,1200,700,500,0.5833333333333334,17,7,10,364.10154932678546,0.4614260008996851,0.19382731903600026,0.18024531243532632,124583.68055555574,1318.6649659864188,125902.34552154216,118,0,42.07692307692308,34,5,17,41.32929883138565,0.5692401960784313,50.41666666666668,998.3333333333348,29.36274509803926,16
1496,4,5,3,40,0.11627906976744186,0.06976744186046512,0.9302325581395349,43,1000,600,400,0.6,14,6,8,332.7167240633169,0.4668927648578811,0.19291400031215833,0.16927977716977577,125722.19397189385,-234.02469592369297,125488.16927597015,119,0,39.02325581395349,38,5,16,40.936934057739435,0.5731907894736843,49.278846153846175,1002.8846153846184,26.39170040485838,0
1497,4,2,0,42,0.047619047619047616,0.0,1.0,42,1300,900,400,0.6923076923076923,17,9,8,338.863778009629,0.46507210607820365,0.2151273626997643,0.17296785886230656,125856.16188180313,129.61890021187128,125985.780782015,120,0,40.904761904761905,38,4,18,40.64474197898921,0.5745614035087719,49.145299145299155,1003.4188034188053,26.405757984705403,0
1498,4,3,2,43,0.06666666666666667,0.044444444444444446,0.9555555555555556,45,1450,1300,150,0.896551724137931,16,13,3,316.9283562935232,0.4678661616161616,0.20801004901136055,0.1651661875749575,126708.03098560742,-968.3865772491304,125739.64440835829,121,0,39.111111111111114,40,5,16,40.32060664176845,0.5799479166666667,48.29776422764229,1006.8089430894333,25.170223577235834,0
1499,4,0,1,42,0.0,0.023255813953488372,0.9767441860465116,43,1000,700,300,0.7,13,7,6,332.62872180837036,0.4648624953857512,0.21417579567488798,0.17235549894473368,126473.33311646222,-186.26737252537725,126287.06574393684,122,1,41.93023255813954,38,5,16,40.16640113294387,0.5808662280701755,48.53098290598291,1005.8760683760692,26.47042285200182,0
1500,4,1,2,41,0.023255813953488372,0.046511627906976744,0.9534883720930233,43,1300,900,400,0.6923076923076923,17,9,8,335.4406667660958,0.4653931339977852,0.24835128531947492,0.17588726012254466,126957.38965821084,-82.66571243335284,126874.72394577748,123,0,42.674418604651166,38,5,18,39.59879324357752,0.5858004385964912,48.05021367521367,1007.7991452991444,26.521030139451167,0
1501,4,2,0,43,0.046511627906976744,0.0,1.0,43,1150,900,250,0.782608695652174,14,9,5,323.8556479148924,0.4657392026578073,0.041460021040282014,0.1613224862977921,124843.79882812497,-508.20161974258616,124335.59720838239,124,0,43.348837209302324,39,4,18,42.06491904662636,0.5625,50.15625,999.3749999999998,25.624999999999993,16
1502,4,3,4,42,0.06521739130434782,0.08695652173913043,0.9130434782608696,46,1350,1000,350,0.7407407407407407,17,10,7,317.6365870916776,0.4678442028985507,0.014842400458346061,0.160055220844548,125322.62854505204,-1212.7866453294514,124109.84189972258,125,0,41.45652173913044,41,5,12,41.726423428779015,0.5642784552845528,49.67757936507935,1001.2896825396805,24.421699574138547,16
1503,4,1,0,43,0.023255813953488372,0.0,1.0,43,1450,1100,350,0.7586206896551724,18,11,7,320.9071962598365,0.4653239202657807,0.05992500308256177,0.1623780284494145,125495.28130425356,-545.5322265624945,124949.74907769106,126,0,44.93023255813954,39,4,14,41.46665020618912,0.5691773504273504,49.505208333333336,1001.9791666666674,25.691773504273524,0
1504,4,3,3,43,0.06521739130434782,0.06521739130434782,0.9347826086956522,46,1850,1300,550,0.7027027027027027,24,13,11,311.040566527273,0.46677737520128826,0.09073985106894078,0.16085240726124725,126392.74691358057,-1336.1493899498098,125056.59752363076,127,0,42.93478260869565,41,5,12,40.79189686924494,0.5752032520325203,48.61111111111113,1005.5555555555583,24.52574525745264,0
1505,4,0,2,41,0.0,0.046511627906976744,0.9534883720930233,43,1450,1300,150,0.896551724137931,16,13,3,321.4912088788561,0.4652085640457733,0.10334050632598668,0.16636595652428102,126419.60612763897,-471.4416000073026,125948.16452763167,128,1,46.395348837209305,38,5,14,40.50161124685719,0.5803179824561404,48.58440170940171,1005.6623931623931,26.464799820062975,0
1506,4,1,1,41,0.023809523809523808,0.023809523809523808,0.9761904761904762,42,1300,800,500,0.6153846153846154,18,8,10,317.4235185713426,0.4647333526906698,0.08382223273089107,0.1655981194834956,126750.88026258702,-353.2579210069239,126397.62234158009,129,0,44.142857142857146,39,3,15,40.26423657804903,0.5819978632478633,48.25520833333334,1006.9791666666683,25.819978632478676,0
1507,4,2,3,40,0.046511627906976744,0.06976744186046512,0.9302325581395349,43,1600,1200,400,0.75,20,12,8,318.5728600881482,0.4634090070136582,0.1279116597514256,0.16866021569272346,127348.32523630129,-486.05596040714704,126862.26927589414,130,0,43.93023255813954,40,3,15,39.62381695529603,0.5864583333333333,47.66260162601627,1009.3495934959362,25.233739837398407,0
1508,4,2,2,40,0.047619047619047616,0.047619047619047616,0.9523809523809523,42,1350,900,450,0.6666666666666666,18,9,9,319.65162125441174,0.46055942702284164,0.15349857231167752,0.17103300087625822,127775.65646701408,-231.26085069442468,127544.39561631966,131,0,44.88095238095238,39,3,17,39.16005563568927,0.5924145299145299,47.23958333333334,1011.0416666666682,25.92414529914534,0
1509,4,0,1,39,0.0,0.025,0.975,40,650,500,150,0.7692307692307693,8,5,3,329.2310017650203,0.45746527777777773,0.1456801171493658,0.17595249885633174,127728.54538175203,410.4393900046154,128138.98477175664,132,1,46.825,37,3,17,38.966061937303415,0.5954391891891893,47.286184210526315,1010.8552631578943,27.320412517780927,0
1510,4,1,0,40,0.025,0.0,1.0,40,1600,1200,400,0.75,20,12,8,330.0914453366389,0.4541399572649573,0.14765633466999062,0.1773881051905163,127950.32035097326,447.06123518773666,128397.38158616099,133,0,47.725,37,3,19,38.71778024637838,0.5976914414414414,47.066885964912274,1011.7324561403499,27.344120436225673,0
1511,4,3,3,40,0.06976744186046512,0.06976744186046512,0.9302325581395349,43,1150,500,650,0.43478260869565216,18,5,13,315.63502413382804,0.45711055740125506,0.1614782928237699,0.17340354820790826,128830.99500868066,-467.1378753558692,128363.8571333248,134,0,45.325581395348834,39,4,17,38.187033996853415,0.6030982905982907,46.19791666666667,1015.2083333333343,26.03098290598293,0
1512,4,0,0,40,0.0,0.0,1.0,40,900,500,400,0.5555555555555556,13,5,8,326.95749275693487,0.453258547008547,0.06984148600065354,0.17003642073744515,126622.55603887739,455.0495404836146,127077.605579361,135,1,49.475,37,3,17,40.15585848131604,0.584177927927928,48.38267543859649,1006.4692982456144,27.201872925557144,16
1513,4,3,1,42,0.06976744186046512,0.023255813953488372,0.9767441860465116,43,1550,1300,250,0.8387096774193549,18,13,5,333.1980355531788,0.4582641196013289,0.0663161629519724,0.16799705149219718,125347.46334876544,175.57644606460326,125523.03979483004,136,0,46.95348837209303,38,5,14,41.311257512713844,0.5693530701754386,49.65277777777778,1001.3888888888889,26.35233918128655,16
1514,4,2,1,43,0.045454545454545456,0.022727272727272728,0.9772727272727273,44,1750,1300,450,0.7428571428571429,22,13,9,323.14764737696004,0.4599630021141649,0.08392479613409809,0.16486007094994107,125834.7222222226,-667.3611111110727,125167.36111111153,137,0,46.79545454545455,39,5,17,41.0610465116279,0.5726495726495726,49.166666666666686,1003.3333333333364,25.726495726495806,0
1515,4,3,4,42,0.06521739130434782,0.08695652173913043,0.9130434782608696,46,1750,1300,450,0.7428571428571429,22,13,9,314.71104835826185,0.462932769726248,0.11278710402472414,0.16370263775946578,126631.30411791937,-1229.3722941040203,125401.93182381535,138,0,43.23913043478261,40,6,13,40.45503500269252,0.5791666666666666,48.373983739837406,1006.5040650406515,25.16260162601629,0
1516,4,1,3,40,0.023255813953488372,0.06976744186046512,0.9302325581395349,43,1500,1100,400,0.7333333333333333,19,11,8,332.1631109910884,0.46158637873754155,0.10120853194665114,0.17251051893408123,126567.38281249988,-191.7968750000141,126375.58593749987,139,0,45.97674418604651,37,6,14,40.08152173913044,0.5836148648648649,48.43749999999999,1006.2499999999991,27.195945945945923,0
1517,4,2,1,41,0.047619047619047616,0.023809523809523808,0.9761904761904762,42,750,400,350,0.5333333333333333,11,4,7,328.4888515643384,0.46092237708091366,0.11080277142960782,0.17199339356266097,126898.60251471578,-63.0447589643295,126835.55775575145,140,0,46.26190476190476,37,5,16,39.83419940508578,0.5869932432432432,48.10855263157893,1007.5657894736819,27.231507823613025,0
1518,4,0,2,39,0.0,0.04878048780487805,0.9512195121951219,41,1450,1100,350,0.7586206896551724,18,11,7,337.8281223588285,0.4603404471544716,0.10785695783173588,0.17661440996491637,126836.65242522916,369.7976270188933,127206.45005224805,141,1,48.048780487804876,36,5,16,39.66252096143096,0.5882523148148149,48.170045045045036,1007.3198198198188,27.98110610610608,0
1519,4,6,5,40,0.13333333333333333,0.1111111111111111,0.8888888888888888,45,1100,600,500,0.5454545454545454,16,6,10,300.59551663653525,0.4670664983164983,0.11316101907220477,0.16181397705589923,128019.00397022207,-1303.6122724553065,126715.39169776675,142,0,41.977777777777774,41,4,15,39.39391154461982,0.5917174796747968,46.99900793650792,1012.0039682539659,24.68302361595039,0
1520,4,3,0,43,0.06976744186046512,0.0,1.0,43,800,500,300,0.625,11,5,6,322.27472099442826,0.46398578811369506,0.15293329505215802,0.17402834933699132,128144.53125,-340.38987701562166,127804.14137298438,143,0,44.604651162790695,38,5,19,38.71742112482853,0.5978618421052632,46.875,1012.5,26.644736842105264,0
1521,4,4,6,41,0.0851063829787234,0.1276595744680851,0.8723404255319149,47,1900,1100,800,0.5789473684210527,27,11,16,297.8555638551369,0.46667823003391923,0.16639043306555878,0.16477246965429526,129105.13157139582,-1709.0636478420547,127396.06792355377,144,0,41.723404255319146,43,4,18,38.3603553236427,0.5998062015503876,45.928030303030305,1016.2878787878791,23.634601832276257,0
1522,4,1,2,40,0.023809523809523808,0.047619047619047616,0.9523809523809523,42,1450,1200,250,0.8275862068965517,17,12,5,322.10148316048736,0.46503581107239644,0.16238686592296392,0.17691377416132642,128821.50472094365,-101.28045328367935,128720.22426765997,145,0,45.88095238095238,38,4,19,38.03256332000279,0.6047149122807017,46.20726495726495,1015.1709401709387,26.715024741340493,0
1523,4,0,3,37,0.0,0.075,0.925,40,950,400,550,0.42105263157894735,15,4,11,344.5457278741879,0.46388888888888885,0.014042182048842555,0.18381602030242192,127658.21468195255,796.8184993425277,128455.03318129508,146,1,47.325,38,2,16,38.651020192409355,0.5929276315789473,47.355769230769226,1010.5769230769222,26.594129554655847,16
1524,4,1,1,37,0.02631578947368421,0.02631578947368421,0.9736842105263158,38,850,500,350,0.5882352941176471,12,5,7,347.58046306198463,0.46286747273589374,0.03760254851251155,0.18575908921556147,127728.54538175203,1279.1893900046146,129007.73477175664,147,0,49.81578947368421,37,1,17,38.5023456990997,0.5954391891891893,47.286184210526315,1010.8552631578943,27.320412517780927,0
1525,4,1,2,36,0.02631578947368421,0.05263157894736842,0.9473684210526316,38,950,700,250,0.7368421052631579,12,7,5,349.05877032781723,0.4620821479374111,0.05318493502344657,0.18745146769758075,127922.58795975668,1330.5002500769294,129253.08820983362,148,0,50.5,37,1,18,38.266402919286065,0.5974099099099099,47.09429824561403,1011.6228070175425,27.341156946420067,0
1526,4,0,3,33,0.0,0.08333333333333333,0.9166666666666666,36,800,600,200,0.75,10,6,4,444.3615956589417,0.46025132275132274,0.021148735405655428,0.2225396362647271,125067.21333391142,4432.468186300973,129499.6815202124,149,1,53.916666666666664,30,6,16,38.82076950640507,0.5840277777777778,49.93279569892473,1000.268817204301,33.342293906810035,16
1527,4,4,1,36,0.10810810810810811,0.02702702702702703,0.972972972972973,37,1100,800,300,0.7272727272727273,14,8,6,428.5938574255071,0.46637262262262263,0.050772100590471325,0.2190717143922949,125913.11984592,3393.117947048592,129306.23779296859,150,0,52.054054054054056,31,6,19,38.334630686732396,0.5900537634408602,49.08854166666666,1003.6458333333321,32.37567204301072,0
1528,4,1,1,36,0.02702702702702703,0.02702702702702703,0.972972972972973,37,1100,800,300,0.7272727272727273,14,8,6,418.8700303696419,0.4657782782782783,0.0606620606620607,0.21650029280551358,126370.92590332023,3186.666531032972,129557.5924343532,151,0,52.108108108108105,31,6,16,38.10379435379435,0.594758064516129,48.63281249999999,1005.4687499999993,32.434475806451594,0
1529,4,2,2,36,0.05263157894736842,0.05263157894736842,0.9473684210526316,38,1050,800,250,0.7619047619047619,13,8,5,399.0041957486111,0.466364390706496,0.0818528568502972,0.20927362919876122,126968.47366397537,2532.190743944636,129500.66440792,152,0,51.473684210526315,33,5,19,37.9858746757458,0.595959595959596,48.03921568627451,1007.8431372549018,30.540701128936416,0
1530,4,2,4,34,0.05263157894736842,0.10526315789473684,0.8947368421052632,38,850,700,150,0.8235294117647058,10,7,3,402.646325841141,0.4633712660028449,0.10838883704281344,0.21279780789319347,127277.43686322558,2649.5584630911076,129926.99532631668,153,0,52.31578947368421,33,5,21,37.5753987531374,0.5991161616161615,47.732843137254896,1009.0686274509795,30.57783719548423,0
1531,4,2,3,33,0.05555555555555555,0.08333333333333333,0.9166666666666666,36,1100,800,300,0.7272727272727273,14,8,6,385.6978849175871,0.46092923280423276,0.12159070107999281,0.20718461605750024,127933.68055555547,2668.7499999999914,130602.43055555546,154,0,51.833333333333336,34,2,19,37.32839099395936,0.6035539215686274,47.08333333333333,1011.666666666666,29.75490196078429,0
1532,4,0,1,32,0.0,0.030303030303030304,0.9696969696969697,33,950,700,250,0.7368421052631579,12,7,5,408.39982265670193,0.4590830176767677,0.07054600676468592,0.20144665409695742,124432.46384297521,3563.8128443526202,127996.27668732783,155,1,54.75757575757576,32,1,15,40.381390787142514,0.572265625,50.56818181818182,997.7272727272727,31.178977272727273,16
1533,4,2,0,34,0.058823529411764705,0.0,1.0,34,850,500,350,0.5882352941176471,12,5,7,394.72996561281775,0.4613413547237077,0.0670821827934509,0.1972199503634402,124969.36462238072,3065.830600009598,128035.19522239032,156,0,53.794117647058826,33,1,18,40.16359745883891,0.5754419191919191,50.030637254901954,999.8774509803914,30.299316696375495,0
1534,4,6,7,33,0.15,0.175,0.825,40,1100,800,300,0.7272727272727273,14,8,6,347.437706940614,0.46838942307692305,0.07767117313563054,0.17983626682050274,126429.50234687587,794.4739626099911,127223.97630948586,157,0,46.575,37,3,15,39.83909361825846,0.5822072072072072,48.57456140350877,1005.7017543859641,27.18112849691795,0
1535,4,4,1,36,0.10810810810810811,0.02702702702702703,0.972972972972973,37,900,500,400,0.5555555555555556,13,5,8,371.8578597423094,0.46555930930930933,0.115226542301482,0.19216711645338735,126363.65265185607,1997.8634848679576,128361.51613672404,158,0,50.13513513513514,35,2,18,39.29302885537775,0.5854166666666667,48.64004629629629,1005.4398148148143,28.726851851851837,0
1536,4,1,0,37,0.02702702702702703,0.0,1.0,37,2000,1500,500,0.75,25,15,10,370.09366177330156,0.4640265265265265,0.11670804037742744,0.19289663054319645,126713.00482520998,1979.1359900119915,128692.14081522197,159,0,51.108108108108105,35,2,19,38.977301030769816,0.5889880952380953,48.29282407407407,1006.8287037037031,28.766534391534375,0
1537,4,3,1,39,0.075,0.025,0.975,40,1350,900,450,0.6666666666666666,18,9,9,357.3733273593143,0.4653311965811966,0.1659288339458742,0.1913449675825451,127802.69870799844,1135.7870917166401,128938.48579971508,160,0,48.2,36,4,18,38.17889891227678,0.5980902777777778,47.21283783783783,1011.1486486486478,28.08746246246244,0
1538,4,3,5,37,0.07142857142857142,0.11904761904761904,0.8809523809523809,42,1100,600,500,0.5454545454545454,16,6,10,336.3482829799212,0.46741918312040265,0.1566210045662102,0.18323451236965857,128496.33487654322,244.36085860635512,128740.69573514957,161,0,46.30952380952381,38,4,14,38.00228310502283,0.6014254385964912,46.52777777777778,1013.8888888888889,26.681286549707604,0
1539,4,0,2,35,0.0,0.05405405405405406,0.9459459459459459,37,650,500,150,0.7692307692307693,8,5,3,372.8624444630645,0.46458958958958957,0.16789601135636167,0.20002731136664934,127880.99500868039,2136.4040798610918,130017.39908854148,162,2,52.67567567567568,35,2,18,37.70704600068657,0.6008928571428571,47.13541666666666,1011.458333333332,28.898809523809486,0
1540,4,2,2,35,0.05405405405405406,0.05405405405405406,0.9459459459459459,37,1100,800,300,0.7272727272727273,14,8,6,362.63413057977004,0.46343218218218213,0.1601613364245562,0.19656155740342945,128295.24518140586,1905.389473497729,130200.63465490358,163,0,51.027027027027025,34,3,20,37.54161770466118,0.6072303921568627,46.726190476190474,1013.0952380952378,29.796918767506995,0
1541,4,0,1,34,0.0,0.02857142857142857,0.9714285714285714,35,1450,1100,350,0.7586206896551724,18,11,7,377.4831072499109,0.46015406162464983,0.1679012345679014,0.2038408779149521,128144.53125000012,2674.479166666681,130819.0104166668,164,1,53.91428571428571,33,2,20,37.31995884773663,0.6079545454545454,46.87500000000001,1012.5000000000009,30.68181818181821,0
1542,4,1,0,35,0.02857142857142857,0.0,1.0,35,950,500,450,0.5263157894736842,14,5,9,367.9280526307057,0.4598739495798319,0.16275830574266492,0.2002909765688222,128466.99948827577,2453.3225898062246,130920.322078082,165,0,54.42857142857143,35,0,19,37.23182345777675,0.606845238095238,46.556712962962955,1013.7731481481472,28.964947089947064,0
1543,4,1,2,34,0.027777777777777776,0.05555555555555555,0.9444444444444444,36,1100,800,300,0.7272727272727273,14,8,6,360.4065919600899,0.46122685185185186,0.16226869829998614,0.1977081322785326,128772.40997331789,2082.0850833941977,130854.49505671208,166,0,53.888888888888886,36,0,20,37.11051629128294,0.6079282407407407,46.25563063063063,1014.9774774774774,28.193818818818816,0
1544,4,0,1,33,0.0,0.029411764705882353,0.9705882352941176,34,1100,700,400,0.6363636363636364,15,7,8,375.3797410801569,0.45933600713012473,0.15558347253475446,0.2053264540105967,128657.3200113379,2859.070294784583,131516.39030612248,167,1,56.44117647058823,34,0,20,36.84825549558006,0.610906862745098,46.36904761904762,1014.5238095238097,29.838935574229698,0
1545,4,1,1,33,0.029411764705882353,0.029411764705882353,0.9705882352941176,34,1100,700,400,0.6363636363636364,15,7,8,372.1633132752493,0.4581476530005942,0.1577771957154086,0.2054360747406841,129019.90504535144,2803.295068027205,131823.20011337864,168,0,56.8235294117647,34,0,21,36.559399656276845,0.6145833333333333,46.01190476190476,1015.9523809523806,29.880952380952372,0
1546,4,0,0,33,0.0,0.0,1.0,33,500,100,400,0.2,9,1,8,377.687489199937,0.45533459595959597,0.15938801554826632,0.20796652644517466,128921.21006644082,3138.385626922338,132059.59569336317,169,1,59.303030303030305,33,0,21,36.519925787377815,0.6158459595959596,46.10906862745098,1015.5637254901964,30.774658348187767,0
1547,4,1,0,34,0.029411764705882353,0.0,1.0,34,1000,600,400,0.6,14,6,8,374.11680105828697,0.45642082590612,0.15218858232746446,0.2079427346415711,129292.17864229027,2874.0752551020432,132166.2538973923,170,0,58.529411764705884,34,0,23,36.23190526356861,0.6173406862745099,45.74404761904762,1017.0238095238096,29.9124649859944,0
1548,4,0,0,34,0.0,0.0,1.0,34,1400,900,500,0.6428571428571429,19,9,10,403.2579192483855,0.4558452168746286,0.1419189034837236,0.20332095089376653,125347.46334876554,3329.0044721592503,128676.4678209248,171,1,59.529411764705884,32,2,16,39.55732778548314,0.5817057291666667,49.652777777777786,1001.3888888888897,31.293402777777803,14
1549,4,3,2,35,0.08108108108108109,0.05405405405405406,0.9459459459459459,37,1300,900,400,0.6923076923076923,17,9,8,377.5847862122778,0.45892767767767767,0.1343204545917429,0.19496303941777923,126329.27284205689,2145.789332721147,128475.06217477804,172,0,55.62162162162162,32,5,16,39.18456417985431,0.591796875,48.67424242424242,1005.30303030303,31.41571969696969,0
1550,4,3,3,35,0.07894736842105263,0.07894736842105263,0.9210526315789473,38,1000,600,400,0.6,14,6,8,345.8055157592349,0.46184506875296344,0.06068643508445959,0.16959436797941535,124191.12761488352,1131.5636726411253,125322.69128752465,173,0,55.026315789473685,35,3,16,42.193063941786654,0.5630952380952381,50.81018518518519,996.7592592592601,28.478835978836003,16
1551,4,2,1,36,0.05405405405405406,0.02702702702702703,0.972972972972973,37,1400,1200,200,0.8571428571428571,16,12,4,334.63339047748786,0.4638388388388388,0.07633239009323778,0.16652843935539824,124803.00560273118,952.6505813245737,125755.65618405576,174,0,55.567567567567565,36,1,18,41.83783199969946,0.5674189814814814,50.197072072072075,999.2117117117123,27.755880880880895,0
1552,4,6,6,36,0.14285714285714285,0.14285714285714285,0.8571428571428572,42,900,600,300,0.6666666666666666,12,6,6,294.5885917942182,0.47133904374758034,0.10086939340051382,0.1510550013242695,126043.83680555575,-973.7847222222042,125070.05208333355,175,0,49.54761904761905,41,1,18,41.56293222683261,0.5716463414634146,48.95833333333334,1004.1666666666682,24.491869918699226,0
1553,4,5,2,39,0.12195121951219512,0.04878048780487805,0.9512195121951219,41,1050,700,350,0.6666666666666666,14,7,7,339.6869279346241,0.4679115853658537,0.13532733471815095,0.16910309806314722,124817.77479383674,492.4669053819399,125310.24169921868,176,0,51.58536585365854,39,2,16,41.696310677924885,0.562232905982906,50.182291666666664,999.2708333333328,25.622329059829045,16
1554,4,3,3,39,0.07142857142857142,0.07142857142857142,0.9285714285714286,42,1200,900,300,0.75,15,9,6,339.83343110773916,0.47171409214092136,0.16876459644539454,0.17249772895468785,125625.78124999999,138.50097656249977,125764.28222656249,177,0,50.857142857142854,39,3,15,40.85792463286227,0.5705128205128205,49.375,1002.4999999999999,25.7051282051282,0
1555,4,2,3,38,0.04878048780487805,0.07317073170731707,0.926829268292683,41,1300,1100,200,0.8461538461538461,15,11,4,346.5463843754074,0.4706808943089431,0.19077517507848385,0.177004360437096,125882.96402449021,524.8572074292948,126407.8212319195,178,0,52.829268292682926,38,3,18,40.42438518045352,0.5748355263157895,49.11858974358973,1003.525641025639,26.40856950067471,0
1556,4,4,1,41,0.09523809523809523,0.023809523809523808,0.9761904761904762,42,1050,600,450,0.5714285714285714,15,6,9,344.54068260956757,0.47054055361982194,0.21975087582717046,0.17869761237664078,126512.22160905249,317.92689526337097,126830.14850431586,179,0,52.30952380952381,37,5,18,39.82686194368755,0.5830518018018018,48.49232456140349,1006.0307017543836,27.19001896633469,0
1557,4,3,0,44,0.06818181818181818,0.0,1.0,44,1800,1400,400,0.7777777777777778,22,14,8,335.9167123297514,0.4708311310782241,0.23837818339938166,0.17708297058575234,127174.94956380787,-253.31075427057357,126921.6388095373,180,0,50.86363636363637,37,7,21,39.36376689495233,0.5898085585585586,47.83442982456139,1008.6622807017526,27.26114272166899,0
1558,4,1,3,42,0.022222222222222223,0.06666666666666667,0.9333333333333333,45,1200,800,400,0.6666666666666666,16,8,8,330.2228418812446,0.4703914141414141,0.2526617555485058,0.1759390093335735,127604.23657909637,-572.4332721528244,127031.80330694355,181,0,50.71111111111111,38,7,19,39.068062458143885,0.5923793859649122,47.409188034188034,1010.363247863248,26.588506522717054,0
1559,4,0,0,42,0.0,0.0,1.0,42,1350,800,550,0.5925925925925926,19,8,11,350.0044842155607,0.46812088656600853,0.24109268707482934,0.1849080293969005,127262.39753266814,508.4819616914589,127770.8794943596,182,1,54.88095238095238,36,6,21,38.918805803571416,0.5925925925925926,47.747747747747766,1009.0090090090118,28.028028028028107,0
1560,4,1,0,43,0.023255813953488372,0.0,1.0,43,1350,900,450,0.6666666666666666,18,9,9,344.4189137998746,0.4677233296419343,0.24444590210255956,0.1839428474743481,127700.83703639603,196.51671668208076,127897.3537530781,183,0,54.58139534883721,37,6,20,38.61059882837927,0.5951576576576576,47.31359649122808,1010.7456140350895,27.317449027975393,0
1561,4,0,1,42,0.0,0.023255813953488372,0.9767441860465116,43,1200,700,500,0.5833333333333334,17,7,10,346.64528021974,0.4671234772978959,0.2443410852713177,0.18602691739541022,127894.85857427292,266.8298178285737,128161.6883921015,184,1,55.58139534883721,37,6,20,38.355803974706426,0.5971283783783784,47.121710526315795,1011.5131578947373,27.338193456614523,0
1562,4,1,1,42,0.023255813953488372,0.023255813953488372,0.9767441860465116,43,1300,1100,200,0.8461538461538461,15,11,4,345.38270078798536,0.4674464747139166,0.24222727765139185,0.18611953946140644,128061.27997316477,246.03014869959415,128307.31012186436,185,0,56.44186046511628,37,6,21,38.21757754667244,0.5988175675675675,46.95723684210526,1012.1710526315785,27.35597439544807,0
1563,4,0,2,40,0.0,0.047619047619047616,0.9523809523809523,42,1150,500,650,0.43478260869565216,18,5,13,346.17800971417716,0.4670320363917925,0.17916993361559697,0.17195647047416357,124726.02747960936,427.5028133656741,125153.53029297503,186,1,55.166666666666664,37,5,16,41.62916209293814,0.5647522522522522,50.274122807017555,998.9035087719319,26.997392128971132,16
1564,4,7,2,45,0.14893617021276595,0.0425531914893617,0.9574468085106383,47,1300,900,400,0.6923076923076923,17,9,8,323.6643259310827,0.4744256860931237,0.09354253370346144,0.1604604271745116,124644.56197534544,-1230.2875310418954,123414.27444430355,187,0,49.51063829787234,40,7,19,42.27559535925097,0.5588541666666667,50.35569105691057,998.5772357723583,24.964430894308958,16
1565,4,4,5,44,0.08163265306122448,0.10204081632653061,0.8979591836734694,49,1400,900,500,0.6428571428571429,19,9,10,344.48676250606854,0.4761727607709751,0.22425254278245266,0.16479310111644593,123137.33312331079,-761.8062284612963,122375.52689484949,188,0,47.714285714285715,38,11,16,43.321896304269835,0.5466008771929824,51.869658119658126,992.5213675213685,26.118983355825485,16
1566,4,6,4,46,0.12,0.08,0.92,50,1250,1000,250,0.8,15,10,5,332.7209665733106,0.4767176870748299,0.24145403564990953,0.15746689915644937,122679.52117189475,-1489.1451766165546,121190.3759952782,189,0,47.18,41,9,19,44.09089391815209,0.5370934959349594,52.33134920634921,990.6746031746038,24.162795199380582,16
1567,4,9,11,44,0.16363636363636364,0.2,0.8,55,1100,700,400,0.6363636363636364,15,7,8,297.6078134874197,0.4818322109988777,0.2954553892367151,0.14668008154224416,124398.8725994512,-3575.3792849444417,120823.49331450676,190,0,43.43636363636364,44,11,15,43.179568096033655,0.5506628787878788,50.60185185185185,997.5925925925918,22.672558922558906,0
1568,4,5,4,45,0.10204081632653061,0.08163265306122448,0.9183673469387755,49,1200,900,300,0.75,15,9,6,329.4113737189817,0.4765093537414966,0.3161056076023132,0.16077091087938664,123986.43798828124,-1631.4914279513903,122354.94656032984,191,0,49.36734693877551,39,10,20,42.81379649966881,0.5536858974358974,51.015625,995.9374999999999,25.53685897435897,0
1569,4,5,3,47,0.1,0.06,0.94,50,1150,600,550,0.5217391304347826,17,6,11,321.9742470023554,0.47816326530612246,0.3421218149095393,0.16071310286543097,124928.98736118281,-1955.2166731232796,122973.77068805952,192,0,48.18,43,7,22,42.02395330112722,0.5574127906976745,50.07102272727273,999.7159090909087,23.249207188160668,0
1570,4,6,6,47,0.11320754716981132,0.11320754716981132,0.8867924528301887,53,1400,1000,400,0.7142857142857143,18,10,8,306.9499242478009,0.4809960087082728,0.3443565917646674,0.15703842042333238,125950.87555727044,-2867.8171270168477,123083.05843025359,193,0,43.22641509433962,44,9,19,41.34804599821667,0.5665246212121212,49.05092592592594,1003.7962962962979,22.813552188552226,0
1571,4,1,1,47,0.020833333333333332,0.020833333333333332,0.9791666666666666,48,1700,1400,300,0.8235294117647058,20,14,6,325.73300633382854,0.4789727393617021,0.34555980481545223,0.16599434721327955,125788.84225865899,-1405.284449567046,124383.55780909194,194,0,47.791666666666664,40,8,21,41.043418431094445,0.5705729166666667,49.212398373983746,1003.150406504066,25.07876016260165,0
1572,4,2,3,46,0.04081632653061224,0.061224489795918366,0.9387755102040817,49,1800,1300,500,0.7222222222222222,23,13,10,322.664901014744,0.4786352040816326,0.3445640612477501,0.16661524663955568,126331.65283203128,-1646.925556425675,124684.7272756056,195,0,47.6530612244898,39,10,17,40.56239854246537,0.577724358974359,48.671875,1005.3125000000002,25.777243589743595,0
1573,4,3,4,45,0.061224489795918366,0.08163265306122448,0.9183673469387755,49,1500,700,800,0.4666666666666667,23,7,16,322.9835561982176,0.47709396258503406,0.1777308019044983,0.16243525489423533,125242.36543026283,-1457.685315366106,123784.68011489672,196,0,48.06122448979592,42,7,15,41.675338818973856,0.5620039682539683,49.75775193798451,1000.9689922480638,23.83259505352533,16
1574,4,6,10,41,0.11764705882352941,0.19607843137254902,0.803921568627451,51,1850,1300,550,0.7027027027027027,24,13,11,302.36669296028043,0.4733986928104575,0.23006277992203317,0.15627161821277114,126367.80876991995,-2550.4478718548894,123817.36089806506,197,0,46.76470588235294,41,10,16,41.03549991777668,0.5749491869918699,48.635912698412696,1005.4563492063488,24.523325590398752,0
1575,4,2,0,43,0.046511627906976744,0.0,1.0,43,1400,1100,300,0.7857142857142857,17,11,6,346.59576153033925,0.4708379475821336,0.25507720605047535,0.17724791067311288,125933.7548572636,129.6211334256524,126063.37599068925,198,0,54.30232558139535,37,6,20,40.37078508484453,0.5771396396396397,49.06798245614034,1003.7280701754371,27.12778568041722,0
1576,4,1,2,42,0.022727272727272728,0.045454545454545456,0.9545454545454546,44,900,500,400,0.5555555555555556,13,5,8,337.6660885995012,0.4715578752642706,0.26030024553503206,0.17386004088709464,126213.51662050567,-276.2989194320796,125937.21770107359,199,0,54.04545454545455,36,8,21,40.30688482946691,0.5818865740740741,48.789414414414416,1004.8423423423426,27.912287287287295,0
1577,4,2,2,42,0.045454545454545456,0.045454545454545456,0.9545454545454546,44,1700,1400,300,0.8235294117647058,20,14,6,333.12356831438666,0.47110641296687805,0.2644557987081848,0.1743260404664076,126876.6493626268,-346.87956570970925,126529.7697969171,200,0,53.79545454545455,38,6,21,39.739969954047346,0.5849780701754386,48.130341880341874,1007.4786324786314,26.512595591542933,0
1578,4,2,3,41,0.045454545454545456,0.06818181818181818,0.9318181818181819,44,1500,1100,400,0.7333333333333333,19,11,8,361.0525055058898,0.4711284355179704,0.18971227010874525,0.17728218697968087,124241.02047571239,752.5300008148402,124993.55047652722,201,0,54.45454545454545,36,8,18,41.76126736699423,0.5616319444444444,50.760135135135144,996.9594594594611,27.69331831831836,16
1579,4,10,8,43,0.19607843137254902,0.1568627450980392,0.8431372549019608,51,1350,1100,250,0.8148148148148148,16,11,5,311.27719012957164,0.47986928104575166,0.23335537423525587,0.16014783229406285,126181.50686990203,-2296.3122554699626,123885.19461443207,202,0,47.588235294117645,37,14,21,41.00265106042418,0.5796734234234234,48.82127192982455,1004.7149122806998,27.154457088667563,0
1580,4,4,1,46,0.0851063829787234,0.02127659574468085,0.9787234042553191,47,1200,900,300,0.75,15,9,6,331.62720963140987,0.47793324082639527,0.2821921952203288,0.170666685932262,126193.31065759616,-1030.1729024943581,125163.1377551018,203,0,52.255319148936174,34,13,26,40.47936413902054,0.5857843137254901,48.809523809523796,1004.761904761903,29.551820728291265,0
1581,4,3,6,43,0.061224489795918366,0.12244897959183673,0.8775510204081632,49,1800,1300,500,0.7222222222222222,23,13,10,313.52181201157583,0.47907808956916104,0.2825315444285388,0.1648275049426204,127064.37467538047,-1832.5094019314101,125231.86527344906,204,0,50.42857142857143,37,12,18,40.04157603770164,0.5886824324324325,47.944078947368396,1008.2236842105228,27.249288762446565,0
1582,4,2,1,44,0.044444444444444446,0.022222222222222223,0.9777777777777777,45,1650,1500,150,0.9090909090909091,18,15,3,344.86788801847626,0.47367424242424244,0.32281564245810057,0.180924243714265,126978.48820103878,-241.83939006575793,126736.64881097303,205,0,55.48888888888889,36,9,22,39.339618249534446,0.5896990740740741,48.02927927927927,1007.8828828828821,27.996746746746723,0
1583,4,3,0,47,0.06382978723404255,0.0,1.0,47,1150,800,350,0.6956521739130435,15,8,7,329.3533989901143,0.47747070613629355,0.32676094774904785,0.1757893569670953,127676.2099194102,-989.7290793671436,126686.48084004306,206,0,53.8936170212766,35,12,19,39.01645289357156,0.5988095238095238,47.33796296296297,1010.6481481481486,28.875661375661387,0
1584,4,2,3,46,0.04081632653061224,0.061224489795918366,0.9387755102040817,49,950,600,350,0.631578947368421,13,6,7,315.0643098333354,0.4780683106575964,0.3268392766359216,0.17025590589070647,128173.03790276781,-1722.59271596419,126450.44518680363,207,0,52.6530612244898,36,13,21,38.87089449881378,0.6018518518518519,46.84684684684686,1012.612612612614,28.128128128128168,0
1585,4,1,0,47,0.02127659574468085,0.0,1.0,47,1350,800,550,0.5925925925925926,19,8,11,321.6103993228702,0.4772008942337342,0.31511788000511,0.1740411511137123,128230.06071950351,-1151.9757933609012,127078.0849261426,208,0,53.61702127659574,36,11,23,38.64706100363207,0.6024305555555556,46.790540540540555,1012.8378378378396,28.134384384384433,0
1586,4,0,0,47,0.0,0.0,1.0,47,1300,1200,100,0.9230769230769231,14,12,2,319.23161258121536,0.47617946345975953,0.3094003282530078,0.17346606673063947,128394.44739006246,-1202.486702639254,127191.9606874232,209,1,54.61702127659574,37,10,14,38.53986350030656,0.6021959459459459,46.62828947368422,1013.4868421052643,27.39153627311525,0
1587,4,0,1,46,0.0,0.02127659574468085,0.9787234042553191,47,1350,1100,250,0.8148148148148148,16,11,5,320.33370763609804,0.47619873573851373,0.31087074094104894,0.1743075413240569,128450.01737313412,-1170.6259377885428,127279.39143534558,210,2,55.61702127659574,37,10,15,38.455358752478816,0.602759009009009,46.573464912280706,1013.7061403508778,27.39746325272643,0
1588,4,0,2,44,0.0,0.043478260869565216,0.9565217391304348,46,1350,700,650,0.5185185185185185,20,7,13,320.1351097766935,0.47587560386473426,0.30089338892197737,0.17440196278879586,128496.33487654336,-972.7623456789963,127523.57253086436,211,3,56.73913043478261,38,8,15,38.41324200913244,0.6014254385964912,46.527777777777786,1013.88888888889,26.681286549707632,0
1589,4,1,1,44,0.022222222222222223,0.022222222222222223,0.9777777777777777,45,1000,700,300,0.7,13,7,6,328.7811136126378,0.47521043771043775,0.30207319271678346,0.17890414334013155,128450.017373134,-553.6120488996685,127896.40532423434,212,0,58.62222222222222,37,8,15,38.24127906976742,0.602759009009009,46.5734649122807,1013.7061403508769,27.397463252726403,0
1590,4,0,1,43,0.0,0.022727272727272728,0.9772727272727273,44,1300,700,600,0.5384615384615384,19,7,12,338.0970853625479,0.47412350246652574,0.3083773520113924,0.18387987101802392,128429.74044568224,-115.65581628925366,128314.084629393,213,6,60.95454545454545,36,8,15,38.025867496204135,0.6044560185185186,46.59346846846847,1013.6261261261267,28.156281281281295,0
1591,4,0,1,42,0.0,0.023255813953488372,0.9767441860465116,43,1200,1000,200,0.8333333333333334,14,10,4,347.41325945677283,0.4727990033222591,0.3157508787684751,0.18829153312849142,128291.05748724724,314.00288816016945,128605.06037540741,214,7,63.23255813953488,35,8,21,37.93139971057542,0.6050595238095238,46.73032407407408,1013.078703703705,28.945105820105855,0
1592,4,1,2,41,0.023255813953488372,0.046511627906976744,0.9534883720930233,43,850,500,350,0.5882352941176471,12,5,7,340.45130060925146,0.47298357327427093,0.3012535425047498,0.18601715701617705,128613.70991941018,157.34096364883686,128771.05088305901,215,0,62.72093023255814,35,8,17,37.778601856077906,0.6083333333333334,46.41203703703704,1014.3518518518521,28.981481481481488,0
1593,4,0,1,40,0.0,0.024390243902439025,0.975609756097561,41,1150,800,350,0.6956521739130435,15,8,7,339.4258074944207,0.47197662601626017,0.2714050883238901,0.18614289592986724,128760.50407503864,540.9276138117352,129301.43168885038,216,1,60.34146341463415,35,6,17,37.655020526855985,0.6098214285714285,46.267361111111114,1014.930555555556,28.998015873015884,0
1594,4,2,5,37,0.047619047619047616,0.11904761904761904,0.8809523809523809,42,800,600,200,0.75,10,6,4,328.2375241970749,0.47245209059233445,0.25910550204804594,0.18268450745977696,129344.54038075247,91.89986104489452,129436.44024179736,217,0,58.30952380952381,36,6,20,37.345243366913905,0.6137152777777778,45.69256756756757,1017.2297297297306,28.256381381381406,0
1595,4,3,3,37,0.075,0.075,0.925,40,1300,1000,300,0.7692307692307693,16,10,6,332.95866235899285,0.47023237179487176,0.2540406910661519,0.18658409626970815,129613.56122470846,631.1915937928674,130244.75281850134,218,0,57.275,35,5,16,36.952053497006894,0.618452380952381,45.42824074074074,1018.2870370370367,29.093915343915334,0
1596,4,1,1,37,0.02631578947368421,0.02631578947368421,0.9736842105263158,38,1350,900,450,0.6666666666666666,18,9,9,350.78022443834874,0.467534969179706,0.2589187271091278,0.1960686772668186,129513.05537533641,1486.1237264513584,130999.17910178777,219,0,60.13157894736842,33,5,17,36.600549803354994,0.6218434343434344,45.52696078431372,1017.8921568627451,30.84521687462864,0
1597,4,1,0,38,0.02631578947368421,0.0,1.0,38,1300,900,400,0.6923076923076923,17,9,8,352.20952458633906,0.46713489805595065,0.26240478547144663,0.19850334035442033,129837.58680555534,1546.0069444444205,131383.59374999977,220,0,60.5,34,4,19,36.23432815481056,0.6228553921568627,45.20833333333332,1019.1666666666649,29.97549019607838,0
1598,4,0,0,38,0.0,0.0,1.0,38,1100,900,200,0.8181818181818182,13,9,4,354.1682255713011,0.46703117591275484,0.26389537599252755,0.20007234061956586,129928.5997732424,1603.3163265305855,131531.916099773,221,1,61.5,34,4,20,36.091974155379106,0.6237745098039216,45.119047619047606,1019.5238095238076,29.985994397759047,0
1599,4,0,2,36,0.0,0.05263157894736842,0.9473684210526316,38,1400,1000,400,0.7142857142857143,18,10,8,358.5293049681746,0.4666162873399715,0.27326281389748885,0.2031666061486322,130049.99999999988,1725.3472222222067,131775.3472222221,222,2,62.5,34,4,20,35.85750272331155,0.625,44.99999999999999,1019.9999999999991,29.99999999999997,0
1600,4,0,1,35,0.0,0.027777777777777776,0.9722222222222222,36,1650,1100,550,0.6666666666666666,22,11,11,411.67019839338525,0.4655919312169312,0.2722961475158314,0.21322267882975998,126456.23692735449,3211.82643990411,129668.0633672586,223,3,65.13888888888889,32,4,15,38.196449493681484,0.5930989583333333,48.54797979797981,1005.8080808080819,31.431502525252558,16
1601,4,2,1,36,0.05405405405405406,0.02702702702702703,0.972972972972973,37,1350,1100,250,0.8148148148148148,16,11,5,408.4977476838953,0.4694069069069069,0.283805147723426,0.2140903109754411,126937.5979941609,2970.7445754036917,129908.34256956459,224,0,64.21621621621621,33,4,17,37.77856317645628,0.5956439393939394,48.06985294117647,1007.720588235294,30.53698752228164,0
1602,4,2,1,37,0.05263157894736842,0.02631578947368421,0.9736842105263158,38,1250,1000,250,0.8,15,10,5,399.0844364595046,0.4710615220483641,0.2809727100112933,0.21182942365766683,127452.38803854866,2572.8528911564504,130025.2409297051,225,0,60.10526315789474,34,4,14,37.48501729151929,0.5986519607843137,47.5595238095238,1009.7619047619039,29.698879551820703,0
1603,4,1,0,38,0.02631578947368421,0.0,1.0,38,1250,900,350,0.72,16,9,7,404.9951985164078,0.4722913703176861,0.26516235482166084,0.20339426759440263,125183.89111159176,2609.7437872207774,127793.63489881254,226,0,61.078947368421055,33,5,20,39.68385174299944,0.5776515151515151,49.81617647058824,1000.7352941176475,30.325311942959015,16
1604,4,2,2,38,0.05,0.05,0.95,40,1450,1000,450,0.6896551724137931,19,10,9,388.65925749577065,0.4744791666666666,0.27259820426487114,0.19833642521691403,125846.0212746531,1782.2442374807333,127628.26551213383,227,0,58.975,36,4,19,39.406098017209125,0.578125,49.15540540540541,1003.378378378379,27.87162162162164,0
1605,4,2,0,40,0.05,0.0,1.0,40,1250,900,350,0.72,16,9,7,401.4592279586245,0.4744791666666666,0.229848273456575,0.19541317598597244,123874.07467689054,2031.8247186868862,125905.89939557742,228,0,58.5,35,5,20,41.13729508196721,0.5598214285714286,51.12847222222223,995.486111111112,28.44246031746034,16
1606,4,3,1,42,0.06976744186046512,0.023255813953488372,0.9767441860465116,43,900,600,300,0.6666666666666666,12,6,6,372.82056583987776,0.4774132521225545,0.22951844566008206,0.1851232153738864,124710.81559713655,699.0417899091269,125409.85738704567,229,0,55.348837209302324,35,8,19,40.97962533796832,0.5684523809523809,50.289351851851855,998.8425925925931,28.538359788359802,0
1607,4,2,2,42,0.045454545454545456,0.045454545454545456,0.9545454545454546,44,1500,1200,300,0.8,18,12,6,365.8118531501602,0.47665609584214236,0.2336815565969479,0.1838514095186069,125214.55277116991,361.9982120480928,125576.55098321801,230,0,55.04545454545455,33,11,22,40.632397657238464,0.5779671717171717,49.785539215686285,1000.8578431372564,30.32902554961383,0
1608,4,3,2,43,0.06666666666666667,0.044444444444444446,0.9555555555555556,45,1350,1100,250,0.8148148148148148,16,11,5,343.0034641468033,0.4758417508417508,0.22779890156316007,0.17625382269568418,126131.01912133492,-344.58762271588904,125786.43149861903,231,0,53.08888888888889,35,10,16,40.25773418596612,0.5830357142857143,48.87152777777778,1004.5138888888891,28.700396825396833,0
1609,4,6,1,48,0.12244897959183673,0.02040816326530612,0.9795918367346939,49,1500,1000,500,0.6666666666666666,20,10,10,301.5655774750273,0.4805661848072562,0.18887857200648828,0.15374329777528556,125806.22004849618,-2107.314733110793,123698.90531538539,232,0,49.57142857142857,43,6,18,41.63166257630103,0.5663759689922481,49.19507575757575,1003.2196969696957,23.330690627202227,16
1610,4,3,6,45,0.058823529411764705,0.11764705882352941,0.8823529411764706,51,950,700,250,0.7368421052631579,12,7,5,284.55324214619566,0.48194444444444445,0.19157257930484328,0.1470976789244551,126376.87690111353,-3007.361613291998,123369.51528782153,233,0,48.450980392156865,43,8,14,41.473990707603434,0.5721899224806202,48.626893939393945,1005.4924242424252,23.38354474982384,0
1611,4,3,6,42,0.0625,0.125,0.875,48,850,400,450,0.47058823529411764,13,4,9,303.2322851069299,0.482278738179669,0.05709971577451478,0.15118643218250602,124881.65681136675,-2024.352276314253,122857.30453505249,234,0,51.916666666666664,43,5,17,42.541153481762215,0.5569282945736433,50.118371212121225,999.5265151515171,23.244802677942257,16
1612,4,4,5,41,0.08695652173913043,0.10869565217391304,0.8913043478260869,46,1450,1100,350,0.7586206896551724,18,11,7,303.89793583379964,0.4813506441223832,0.1183479208014564,0.15368378838184987,125471.67427445519,-1573.8834364764418,123897.79083797874,235,0,54.06521739130435,41,5,18,41.91700085817076,0.5658028455284553,49.52876984126984,1001.884920634921,24.436217576461488,0
1613,4,2,0,43,0.046511627906976744,0.0,1.0,43,1300,1000,300,0.7692307692307693,16,10,6,302.9600538056313,0.48002030269472135,0.13946891646424908,0.15438919417219346,125788.84225865887,-978.201116233726,124810.64114242514,236,0,56.69767441860465,40,3,20,41.6145358457434,0.5705729166666667,49.21239837398374,1003.1504065040651,25.07876016260163,0
1614,4,4,2,45,0.0851063829787234,0.0425531914893617,0.9574468085106383,47,950,800,150,0.8421052631578947,11,8,3,292.6644229784247,0.48103607770582796,0.19428751426689672,0.1535971406569914,126994.32594946197,-1966.1393825343105,125028.18656692766,237,0,52.787234042553195,42,5,20,40.63881945779658,0.5798611111111112,48.01356589147286,1007.945736434107,23.99870801033588,0
1615,4,2,0,47,0.0425531914893617,0.0,1.0,47,1500,1100,400,0.7333333333333333,19,11,8,317.78256329428064,0.48194187480727724,0.12173556325525059,0.16367583492258037,126226.95448133702,-954.7461855906314,125272.20829574639,238,0,53.319148936170215,39,8,18,40.79258232265644,0.576655982905983,48.77604166666668,1004.8958333333351,25.766559829059872,16
1616,4,1,6,42,0.020833333333333332,0.125,0.875,48,1700,1200,500,0.7058823529411765,22,12,10,332.28413331807474,0.4832299054373523,0.04250985489516457,0.16305027832501234,124213.63900662636,-1033.2932015784008,123180.34580504795,239,0,53.1875,40,8,15,42.50666904543448,0.5544270833333333,50.78760162601626,996.849593495935,24.921239837398375,16
1617,4,6,2,46,0.125,0.041666666666666664,0.9583333333333334,48,1300,800,500,0.6153846153846154,18,8,10,340.8397114482699,0.48545545212765956,0.1493205155823638,0.16244126699618788,122978.32657608308,-903.9358187758514,122074.39075730724,240,0,53.208333333333336,38,10,18,43.578109291971856,0.5449561403508771,52.029914529914535,991.8803418803427,26.102114260009017,16
1618,4,9,11,44,0.16363636363636364,0.2,0.8,55,1100,700,400,0.6363636363636364,15,7,8,308.37191612948396,0.48656004489337823,0.23914454709037614,0.15409839386707108,124976.3268785149,-3280.4425158589856,121695.88436265591,241,0,47.127272727272725,43,12,15,42.31510638633711,0.5578972868217054,50.02367424242423,999.9053030303,23.25361169837907,0
1619,4,6,7,43,0.12,0.14,0.86,50,1000,500,500,0.5,15,5,10,334.85480610428755,0.4862840136054422,0.2759163644122038,0.16894127838652256,125374.21127365025,-1603.5663168177643,123770.64495683248,242,0,51.52,38,12,15,41.242176943318405,0.5696271929824561,49.62606837606837,1001.4957264957254,26.355150697255933,0
1620,4,4,6,41,0.0851063829787234,0.1276595744680851,0.8723404255319149,47,1500,1200,300,0.8,18,12,6,345.15922484545047,0.48560360777058276,0.26020762899160177,0.17553643045395406,125704.81957886934,-722.3643829640539,124982.45519590529,243,0,53.93617021276596,36,11,20,40.64289724873667,0.5766782407407407,49.29617117117117,1002.8153153153148,27.855980980980966,0
1621,4,1,2,40,0.023809523809523808,0.047619047619047616,0.9523809523809523,42,950,500,450,0.5263157894736842,14,5,9,386.11179030759445,0.4836793457220287,0.2600399600399599,0.18528183226169795,123269.91705246909,1143.0984898186384,124413.01554228773,244,0,59.69047619047619,35,7,15,42.15034965034963,0.5535714285714286,51.73611111111111,993.0555555555552,28.373015873015863,16
1622,4,1,5,36,0.024390243902439025,0.12195121951219512,0.8780487804878049,41,1200,600,600,0.5,18,6,12,366.9960779988117,0.4826219512195122,0.16630904102114763,0.17643896242155915,123349.501652787,1006.6308943312227,124356.13254711822,245,0,56.90243902439025,38,3,15,42.54185487918547,0.5487938596491229,51.65598290598291,993.3760683760692,26.141475483580766,16
1623,4,3,0,39,0.07692307692307693,0.0,1.0,39,1200,700,500,0.5833333333333334,17,7,10,371.7729900111743,0.4807411156095367,0.21558860772331223,0.1820597226678962,124128.77562951483,1431.0547502097463,125559.83037972458,246,0,58.41025641025641,36,3,18,41.610869401438976,0.560474537037037,50.87274774774776,996.5090090090105,27.680805805805846,0
1624,4,0,2,37,0.0,0.05128205128205128,0.9487179487179487,39,1350,900,450,0.6666666666666666,18,9,9,436.67951971009745,0.4806848852901484,0.18927152050676832,0.209441384736428,123248.36730957043,3231.5608057183713,126479.9281152888,247,1,59.41025641025641,31,8,19,40.9175845790716,0.5625,51.75781250000001,992.9687500000009,32.03125000000003,16
1625,4,2,1,38,0.05128205128205128,0.02564102564102564,0.9743589743589743,39,1200,800,400,0.6666666666666666,16,8,8,431.9787700962875,0.47899797570850206,0.19889673418545994,0.20893108722136478,123604.17895846904,2878.8762410481827,126483.05519951723,248,0,60.0,31,8,21,40.66073610929247,0.5661962365591398,51.399739583333336,994.4010416666673,32.07745295698927,0
1626,4,3,2,39,0.07317073170731707,0.04878048780487805,0.9512195121951219,41,1050,900,150,0.8571428571428571,12,9,3,405.4539534728177,0.4794207317073171,0.24826697654061092,0.20165663946137052,124779.13805032644,1918.9518315416651,126698.0898818681,249,0,57.926829268292686,32,9,19,40.09356965331311,0.5758463541666667,50.22095959595959,999.1161616161611,31.222380050505034,0
1627,4,5,5,39,0.11363636363636363,0.11363636363636363,0.8863636363636364,44,1150,800,350,0.6956521739130435,15,8,7,372.14027826162885,0.4791446441155744,0.2645086564252628,0.19196821146552673,126290.0762326987,606.2923076444115,126896.36854034312,250,0,53.38636363636363,33,11,13,39.36184264000649,0.5890151515151515,48.71323529411763,1005.1470588235272,30.45900178253113,0
1628,4,2,1,40,0.04878048780487805,0.024390243902439025,0.975609756097561,41,1450,1100,350,0.7586206896551724,18,11,7,405.1238787210965,0.47835365853658535,0.2979455520696286,0.20773373355698768,126043.83680555549,2012.6736111111024,128056.5104166666,251,0,58.146341463414636,30,11,21,38.78803596127247,0.5940972222222223,48.95833333333333,1004.1666666666661,33.4722222222222,0
1629,4,3,2,41,0.06976744186046512,0.046511627906976744,0.9534883720930233,43,1200,700,500,0.5833333333333334,17,7,10,385.0486235515449,0.47902823920265786,0.2932761532433956,0.2014948907840387,126875.85791822847,1170.6748906670407,128046.53280889551,252,0,56.13953488372093,33,10,18,38.43295118193246,0.5950126262626263,48.13112745098039,1007.4754901960777,30.52956030897205,0
1630,4,2,1,42,0.046511627906976744,0.023255813953488372,0.9767441860465116,43,1450,900,550,0.6206896551724138,20,9,11,390.0374988950549,0.47969730527870064,0.32044543643650814,0.20652805269361135,127354.73632812523,1334.992513396318,128689.72884152154,253,0,57.093023255813954,31,12,19,37.81389748882009,0.6048387096774194,47.656250000000014,1009.3750000000018,32.5604838709678,0
1631,4,2,2,42,0.045454545454545456,0.045454545454545456,0.9545454545454546,44,1300,700,600,0.5384615384615384,19,7,12,370.4313979415867,0.4791666666666667,0.309993173835974,0.19926072005235718,127989.47707912826,682.264183246833,128671.7412623751,254,0,56.47727272727273,33,11,21,37.657316014694615,0.6063762626262627,47.02818627450981,1011.8872549019611,30.663250148544275,0
1632,4,0,2,40,0.0,0.047619047619047616,0.9523809523809523,42,950,500,450,0.5263157894736842,14,5,9,376.80708103634475,0.47944492837785524,0.29557695737471,0.20202307356767912,127857.05061983489,1235.488406795247,129092.53902663014,255,1,54.69047619047619,32,10,21,37.631866416978774,0.607421875,47.15909090909092,1011.3636363636379,31.605113636363683,0
1633,4,2,2,40,0.047619047619047616,0.047619047619047616,0.9523809523809523,42,1300,800,500,0.6153846153846154,18,8,10,371.24419247654765,0.4786222415795587,0.29749515121479675,0.20163248779099557,128375.34798516154,1132.0433099079198,129507.39129506946,256,0,54.04761904761905,31,11,17,37.24155745428069,0.615255376344086,46.64713541666666,1013.4114583333322,32.69069220430104,0
1634,4,0,0,40,0.0,0.0,1.0,40,1400,900,500,0.6428571428571429,19,9,10,382.2858313651418,0.4775641025641026,0.2912531511211365,0.20713790877060176,128280.65609102187,1807.9754523644099,130088.63154338628,257,1,56.775,30,10,23,37.05884304099776,0.6170138888888889,46.74059139784945,1013.0376344086004,33.76792114695335,0
1635,4,0,0,40,0.0,0.0,1.0,40,900,600,300,0.6666666666666666,12,6,6,383.0939969038573,0.47733707264957265,0.2892989786443829,0.2079298518832381,128348.74561004147,1833.9267906694242,130182.6724007109,258,2,57.775,30,10,23,36.968596630852915,0.6177083333333333,46.673387096774185,1013.3064516129019,33.77688172043006,0
1636,4,2,0,42,0.047619047619047616,0.0,1.0,42,1400,1300,100,0.9285714285714286,15,13,2,366.00176528257407,0.47834397986837013,0.2797188339880088,0.20232577584820724,129076.82742214554,1048.4693387159027,130125.29676086144,259,0,55.976190476190474,33,9,20,36.65782280109341,0.6174242424242424,45.95588235294119,1016.176470588237,30.793226381461725,0
1637,4,0,2,40,0.0,0.047619047619047616,0.9523809523809523,42,1250,900,350,0.72,16,9,7,365.02614059839107,0.4773882113821138,0.2803398488772222,0.20275314043996123,129265.58036169765,1037.1232553771492,130302.7036170748,260,1,56.976190476190474,32,10,20,36.490149822034624,0.6217447916666667,45.770202020202014,1016.9191919191909,31.778724747474715,0
1638,4,1,3,38,0.024390243902439025,0.07317073170731707,0.926829268292683,41,1700,1300,400,0.7647058823529411,21,13,8,373.06819070350235,0.4754573170731707,0.2844415030608769,0.20775351204322634,129366.91496107324,1452.536180284299,130819.45114135754,261,0,58.97560975609756,31,10,22,36.1823509962029,0.6253360215053764,45.67057291666667,1017.3177083333343,32.816700268817236,0
1639,4,1,1,38,0.02564102564102564,0.02564102564102564,0.9743589743589743,39,900,500,400,0.5555555555555556,13,5,8,389.3046688940269,0.47629892037786775,0.2773001807521056,0.2153279152529437,129098.92265363061,2251.76266764946,131350.68532128006,262,0,61.666666666666664,30,9,23,36.043237226116496,0.6253472222222223,45.93413978494625,1016.2634408602161,33.875448028673866,0
1640,4,0,0,38,0.0,0.0,1.0,38,1250,1000,250,0.8,15,10,5,389.0194236655714,0.4760253674727359,0.2592218491865508,0.2159220015660082,129236.69222608027,2455.1573530096666,131691.84957908993,263,1,62.3421052631579,29,9,23,35.90968333105678,0.6296695402298851,45.798611111111114,1016.8055555555558,35.062260536398476,0
1641,4,0,0,38,0.0,0.0,1.0,38,1200,800,400,0.6666666666666666,16,8,8,387.6409705893494,0.47556602655286867,0.26294230935065666,0.2157357498933433,129342.63117283967,2427.7006172839756,131770.33179012366,264,2,63.3421052631579,29,9,23,35.836519206262516,0.6307471264367817,45.69444444444446,1017.2222222222235,35.07662835249047,0
1642,4,0,0,38,0.0,0.0,1.0,38,1350,1000,350,0.7407407407407407,17,10,7,386.7620278026733,0.4750029634898056,0.2601413468168232,0.21602074235807867,129483.95061728409,2415.8950617284127,131899.8456790125,265,3,64.34210526315789,29,9,19,35.71461062590974,0.632183908045977,45.555555555555564,1017.777777777779,35.09578544061307,0
1643,4,1,1,38,0.02564102564102564,0.02564102564102564,0.9743589743589743,39,900,400,500,0.4444444444444444,14,4,10,374.10028792039003,0.4738529014844804,0.24845619517210116,0.2107301919028529,129817.03990345722,1912.9184009712362,131729.95830442847,266,0,63.666666666666664,30,9,20,35.697485272135765,0.6326388888888889,45.228494623655926,1019.0860215053777,33.969534050179256,0
1644,4,1,2,37,0.02564102564102564,0.05128205128205128,0.9487179487179487,39,1250,700,550,0.56,18,7,11,361.7416679540725,0.474021592442645,0.22981133990535252,0.20593800308033272,130230.36552392626,1621.9499285787351,131852.315452505,267,0,63.1025641025641,32,7,21,35.59242536698004,0.6315104166666667,44.82323232323233,1020.7070707070718,31.897095959595994,0
1645,4,2,3,36,0.05128205128205128,0.07692307692307693,0.9230769230769231,39,800,500,300,0.625,11,5,6,430.1004611623185,0.4734311740890688,0.279218915715266,0.22489985946273916,126844.99351211074,3147.004408600534,129991.99792071128,268,0,63.76923076923077,33,6,18,37.33019059205192,0.5946969696969697,48.161764705882355,1007.3529411764707,30.525846702317295,16
1646,4,0,1,35,0.0,0.027777777777777776,0.9722222222222222,36,1750,1500,250,0.8571428571428571,20,15,5,408.82963144748925,0.47291666666666665,0.16178173090498404,0.19690876373878463,123426.6991250893,2892.3386750133936,126319.0378001027,269,1,68.22222222222223,32,4,16,41.42206692079627,0.5618489583333333,51.57828282828283,993.6868686868689,31.052714646464654,16
1647,4,8,4,39,0.18604651162790697,0.09302325581395349,0.9069767441860466,43,1300,1000,300,0.7692307692307693,16,10,6,351.39729454321497,0.47812846068660025,0.19177439386713635,0.17558311939394944,124972.5892221645,716.5332994712851,125689.12252163579,270,0,57.395348837209305,37,6,17,41.24344317724897,0.5672860360360361,50.02741228070175,999.8903508771929,27.02406353722143,16
1648,4,4,2,41,0.09302325581395349,0.046511627906976744,0.9534883720930233,43,1200,900,300,0.75,15,9,6,351.50659371979907,0.47870524178663715,0.22815634222144365,0.17779159547044074,125479.06172642241,221.34651985476663,125700.40824627718,271,0,58.25581395348837,36,7,18,40.71690832115695,0.5743634259259259,49.5213963963964,1001.9144144144148,27.830955955955964,0
1649,4,1,1,41,0.023809523809523808,0.023809523809523808,0.9761904761904762,42,1450,1000,450,0.6896551724137931,19,10,9,349.61118658926716,0.4781987998451413,0.22761305780173724,0.17767910989673716,125676.58875091307,387.58826393961385,126064.17701485268,272,0,60.214285714285715,36,6,19,40.560422282120385,0.5763888888888888,49.32432432432432,1002.7027027027027,27.852852852852852,0
1650,4,3,3,41,0.06818181818181818,0.06818181818181818,0.9318181818181819,44,1250,900,350,0.72,16,9,7,337.88819370433373,0.47837385482734324,0.1920725963969503,0.1745406674971851,126346.81013629191,61.59356389663168,126408.40370018854,273,0,57.68181818181818,37,7,17,40.16420820154871,0.5813626126126126,48.656798245614034,1005.3728070175437,27.17223802750118,16
1651,4,0,1,40,0.0,0.024390243902439025,0.975609756097561,41,750,500,250,0.6666666666666666,10,5,5,373.96164467577375,0.47540650406504065,0.24334321680928794,0.18356124340650212,124227.38803854863,1195.599673820347,125422.98771236898,274,1,57.75609756097561,34,7,17,41.45370591513416,0.5655637254901961,50.77380952380952,996.9047619047609,29.3207282913165,16
1652,4,2,2,40,0.047619047619047616,0.047619047619047616,0.9523809523809523,42,1300,900,400,0.6923076923076923,17,9,8,369.0626494464402,0.4770373596593109,0.2641963581330202,0.18366196794942574,124803.00560273102,812.0255813245576,125615.03118405558,275,0,56.833333333333336,36,6,19,40.97777903001615,0.5674189814814814,50.19707207207207,999.211711711711,27.755880880880863,0
1653,4,4,3,41,0.09090909090909091,0.06818181818181818,0.9318181818181819,44,1350,1000,350,0.7407407407407407,17,10,7,353.74704306389697,0.4782857646229739,0.17924281984334178,0.17414539523582598,124349.80604383688,380.631040801157,124730.43708463805,276,0,50.43181818181818,39,5,15,41.8303959965187,0.5574252136752137,50.65104166666667,997.395833333334,25.574252136752154,16
1654,4,3,0,44,0.06818181818181818,0.0,1.0,44,1200,900,300,0.75,15,9,6,349.6643447868346,0.48088442565186756,0.2135337720433288,0.17440661740990354,124898.39463943394,-65.49693469498538,124832.89770473896,277,0,50.56818181818182,40,4,19,41.363570896028165,0.5614583333333334,50.10162601626015,999.5934959349572,24.98983739837393,0
1655,4,4,8,40,0.08333333333333333,0.16666666666666666,0.8333333333333334,48,1200,700,500,0.5833333333333334,17,7,10,342.036738266331,0.48242649231678486,0.2570048736888262,0.17560254983304674,126094.86669847652,-968.83220966355,125126.03448881296,278,0,47.270833333333336,40,8,15,40.319235050086014,0.5736979166666667,48.90752032520326,1004.3699186991876,25.10924796747969,0
1656,4,2,3,39,0.047619047619047616,0.07142857142857142,0.9285714285714286,42,1300,1000,300,0.7692307692307693,16,10,6,358.3835758501064,0.47994096012388693,0.1847696347576988,0.17641231483385358,124346.09552154182,686.8910680224756,125032.9865895643,279,0,53.19047619047619,34,8,16,41.71863809978515,0.5667892156862745,50.6547619047619,997.3809523809513,29.33473389355739,16
1657,4,7,6,40,0.15217391304347827,0.13043478260869565,0.8695652173913043,46,1150,800,350,0.6956521739130435,15,8,7,326.9746051676909,0.48102858293075684,0.2207727463444782,0.1673422342007986,125965.39849175351,-962.5027126736077,125002.8957790799,280,0,49.08695652173913,39,7,17,40.83058783853897,0.5739850427350428,49.036458333333336,1003.854166666667,25.739850427350436,0
1658,4,6,1,45,0.13043478260869565,0.021739130434782608,0.9782608695652174,46,1500,1000,500,0.6666666666666666,20,10,10,354.2590266903379,0.48055555555555557,0.27482133652814733,0.17747069378820945,125080.14104618673,-38.51079997225946,125041.63024621448,281,0,49.82608695652174,38,8,18,41.06055751361744,0.5666118421052632,49.919871794871796,1000.3205128205129,26.324224021592446,16
1659,4,3,1,47,0.0625,0.020833333333333332,0.9791666666666666,48,1750,1400,350,0.8,21,14,7,345.8962483428313,0.4816138445626477,0.30765905947441174,0.17736382095877118,126043.83680555574,-876.6837195923551,125167.15308596338,282,0,48.604166666666664,40,8,17,40.274896265560166,0.5731770833333334,48.95833333333334,1004.1666666666681,25.104166666666703,0
1660,4,4,3,48,0.0784313725490196,0.058823529411764705,0.9411764705882353,51,1100,700,400,0.6363636363636364,15,7,8,327.2607555677239,0.48073529411764704,0.31357873068471065,0.17111254953834523,126842.05424067756,-1897.9146982867417,124944.13954239083,283,0,46.64705882352941,41,10,19,39.92310091261243,0.5797764227642277,48.16468253968253,1007.3412698412683,24.56929926442118,0
1661,4,2,7,43,0.04,0.14,0.86,50,1700,1300,400,0.7647058823529411,21,13,8,325.50168887303016,0.48069727891156466,0.1415540296349842,0.1652592978186556,125634.86203003553,-1701.795011439093,123933.06701859643,284,0,47.76,45,5,11,41.207761113118906,0.5620370370370371,49.3659420289855,1002.5362318840565,22.278582930756812,16
1662,4,5,5,43,0.10416666666666667,0.10416666666666667,0.8958333333333334,48,1250,600,650,0.48,19,6,13,344.57482626404914,0.4821771572104019,0.22415390206715569,0.17691687284043317,126097.48389445928,-906.6733819711501,125190.81051248813,285,0,45.270833333333336,38,10,17,40.2528099847534,0.5770285087719298,48.90491452991454,1004.3803418803437,26.431061628430097,0
1663,4,2,3,42,0.044444444444444446,0.06666666666666667,0.9333333333333333,45,1400,1000,400,0.7142857142857143,18,10,8,361.4598359593242,0.4811026936026936,0.24327638434508714,0.18684254203759876,126374.37120075406,135.85189673745896,126510.22309749151,245,0,42.577777777777776,37,8,15,39.54334787350056,0.5816441441441442,48.62938596491228,1005.4824561403507,27.175201517306775,0
1664,4,0,1,41,0.0,0.023809523809523808,0.9761904761904762,42,1500,1100,400,0.7333333333333333,19,11,8,366.5873108980272,0.48037650019357336,0.23505203582497103,0.18927269660998805,126326.69990514178,861.9530425696105,127188.6529477114,246,1,45.642857142857146,36,6,15,39.46361226242484,0.5830439814814814,48.67680180180181,1005.2927927927941,27.924799799799835,0
1665,4,0,2,39,0.0,0.04878048780487805,0.9512195121951219,41,1450,1200,250,0.8275862068965517,17,12,5,377.3534625511153,0.4795731707317073,0.2480521777705409,0.19500711059973436,126363.6526518559,1336.7523737568329,127700.40502561272,247,2,47.53658536585366,35,6,15,39.154891408618255,0.5854166666666667,48.64004629629628,1005.4398148148128,28.726851851851794,0
1666,4,3,4,38,0.07142857142857142,0.09523809523809523,0.9047619047619048,42,1350,1000,350,0.7407407407407407,17,10,7,368.8924175022867,0.47898519163763065,0.24978180811886674,0.19325815877110417,126921.74437951451,964.0938235532644,127885.83820306777,248,0,47.023809523809526,36,6,18,38.79265385188496,0.5891203703703703,48.08558558558558,1007.6576576576565,27.99049049049046,0
1667,4,2,2,38,0.05,0.05,0.95,40,1600,1000,600,0.625,22,10,12,409.9447677069658,0.47860576923076925,0.24574708541517953,0.20585398550446543,125178.63520408151,2405.077303931048,127583.71250801256,249,0,47.25,34,6,17,39.56548893647393,0.5753676470588236,49.82142857142856,1000.7142857142846,29.432773109243666,16
1668,4,4,4,38,0.09523809523809523,0.09523809523809523,0.9047619047619048,42,1150,900,250,0.782608695652174,14,9,5,394.3515262154689,0.4786222415795587,0.2514927214409084,0.20350225818070997,126305.47417534728,1567.710769203525,127873.1849445508,250,0,44.714285714285715,35,7,15,38.78778065630397,0.5848214285714286,48.69791666666667,1005.2083333333338,28.72023809523811,0
1669,4,0,0,38,0.0,0.0,1.0,38,1450,1100,350,0.7586206896551724,18,11,7,414.32697515605724,0.4770329540066382,0.2582586258228854,0.21278057374864023,126107.23913695042,2849.9261873788546,128957.16532432927,251,1,49.18421052631579,32,6,16,38.49125288078777,0.5895182291666667,48.89520202020203,1004.4191919191928,31.388099747474776,0
1670,4,3,0,41,0.07317073170731707,0.0,1.0,41,800,400,400,0.5,12,4,8,387.2876125208338,0.47761686991869917,0.25565636843918593,0.20301705251167407,126946.17419249429,1632.936144333025,128579.11033682732,252,0,46.51219512195122,35,6,18,38.304070479690665,0.5913690476190476,48.06134259259261,1007.7546296296321,28.79298941798949,0
1671,4,0,1,40,0.0,0.024390243902439025,0.975609756097561,41,1150,700,450,0.6086956521739131,16,7,9,384.7348394667408,0.4771595528455284,0.24733411640065395,0.2027035795996413,127152.0408163267,1584.0477267617675,128736.08854308847,253,1,47.51219512195122,34,7,18,38.15632869058861,0.5955882352941176,47.85714285714287,1008.5714285714299,29.663865546218528,0
1672,4,3,2,41,0.06976744186046512,0.046511627906976744,0.9534883720930233,43,1350,1100,250,0.8148148148148148,16,11,5,361.3162405592068,0.4786129568106312,0.24107619882864006,0.1943022300629585,127978.05574792274,648.1099953832263,128626.16574330597,254,0,45.93023255813954,37,6,20,37.89959904638058,0.597972972972973,47.03947368421054,1011.8421052631604,27.347083926031363,0
1673,4,1,4,38,0.023809523809523808,0.09523809523809523,0.9047619047619048,42,950,600,350,0.631578947368421,13,6,7,358.4022753807874,0.47685588463027484,0.22358368683940122,0.17943112845534398,125053.42451055598,679.3545987396386,125732.77910929562,255,0,47.095238095238095,38,4,18,40.98460976999216,0.5663377192982456,49.9465811965812,1000.2136752136757,26.321412505623044,16
1674,4,1,3,36,0.02564102564102564,0.07692307692307693,0.9230769230769231,39,1550,1100,450,0.7096774193548387,20,11,9,376.5813073414062,0.47601776878092666,0.2271596150138664,0.18894633789706644,125144.7177881729,1625.4322863082907,126770.1500744812,256,0,42.48717948717949,35,4,20,40.43534316560632,0.5729166666666667,49.85532407407407,1000.5787037037028,28.587962962962937,0
1675,4,2,3,35,0.05263157894736842,0.07894736842105263,0.9210526315789473,38,1350,1100,250,0.8148148148148148,16,11,5,374.60547189743085,0.47695886676149835,0.24116174656889244,0.19033473331656547,125666.39506440748,1815.063844950261,127481.45890935774,257,0,43.421052631578945,35,3,21,39.94442360229326,0.5782738095238096,49.33449074074073,1002.6620370370362,28.647486772486747,0
1676,4,0,0,35,0.0,0.0,1.0,35,1400,900,500,0.6428571428571429,19,9,10,384.6316207409569,0.47580532212885157,0.232067328441951,0.19586625610039515,125758.72359963281,2674.156336088169,128432.87993572098,250,1,40.05714285714286,32,3,21,39.59749496475326,0.5859375,49.24242424242425,1003.030303030304,31.344696969697,0
1677,4,2,1,36,0.05405405405405406,0.02702702702702703,0.972972972972973,37,850,600,250,0.7058823529411765,11,6,5,375.54278169995155,0.47581956956956956,0.250573554921381,0.19503996081836192,126567.38281250001,2106.616233356291,128673.99904585631,251,0,38.83783783783784,33,4,19,38.99025189786058,0.5918560606060606,48.4375,1006.2500000000001,30.492424242424246,0
1678,4,3,2,37,0.07692307692307693,0.05128205128205128,0.9487179487179487,39,1100,800,300,0.7272727272727273,14,8,6,352.7143640428929,0.4771704903283851,0.24535001435413872,0.18763519616952645,127542.56129535151,1198.3037485827667,128740.86504393427,252,0,37.256410256410255,34,5,16,38.563150658023936,0.5995710784313726,47.470238095238095,1010.1190476190479,29.70938375350141,0
1679,4,1,0,38,0.02631578947368421,0.0,1.0,38,1450,1100,350,0.7586206896551724,18,11,7,364.66170676895854,0.47492887624466573,0.27082906487652614,0.19491770788984591,127734.70320001706,1715.990976508907,129450.69417652597,253,0,39.13157894736842,35,3,18,38.06436531562477,0.5994047619047619,47.28009259259259,1010.8796296296289,28.88227513227511,0
1680,4,4,3,39,0.09523809523809523,0.07142857142857142,0.9285714285714286,42,1450,1100,350,0.7586206896551724,18,11,7,344.0163486602566,0.4747749709639954,0.2781513814767971,0.1894339727283767,128922.8476550477,471.6262619029957,129394.47391695071,254,0,36.30952380952381,37,5,17,37.373137551284806,0.607545045045045,46.10745614035088,1015.5701754385965,27.447842579421525,0
1681,4,0,1,38,0.0,0.02564102564102564,0.9743589743589743,39,950,700,250,0.7368421052631579,12,7,5,366.0486149207004,0.47345928924876296,0.28897511983565427,0.1997084659984542,128555.01570001707,1611.477087620022,130166.4927876371,255,1,39.717948717948715,35,4,17,37.189473483983875,0.6077380952380953,46.469907407407405,1014.1203703703698,28.974867724867707,0
1682,4,0,1,37,0.0,0.02631578947368421,0.9736842105263158,38,1450,1000,450,0.6896551724137931,19,10,9,372.4065967288394,0.47300260787102894,0.2809560281410015,0.2035456453320359,128627.12762188201,1980.3181689342296,130607.44579081624,256,2,40.39473684210526,34,4,19,36.954533896647476,0.6106004901960784,46.39880952380952,1014.4047619047614,29.83543417366945,0
1683,4,0,0,37,0.0,0.0,1.0,37,1800,1400,400,0.7777777777777778,22,14,8,374.315053854176,0.4718155655655656,0.25969703100830843,0.20530313086227048,128765.68657487498,2239.78698096885,131005.47355584384,257,3,41.0,33,4,20,36.76446912983982,0.6142676767676767,46.26225490196078,1014.9509803921563,30.756090314913827,0
1684,4,0,1,36,0.0,0.02702702702702703,0.972972972972973,37,1300,900,400,0.6923076923076923,17,9,8,374.85105324425604,0.47159659659659664,0.25683596844206447,0.20628899897893574,128898.98667800454,2263.584183673467,131162.57086167802,258,4,42.0,34,3,21,36.61464439234074,0.6133578431372548,46.13095238095238,1015.4761904761905,29.866946778711483,0
1685,4,1,0,37,0.02702702702702703,0.0,1.0,37,950,700,250,0.7368421052631579,12,7,5,399.0165843312291,0.4710648148148148,0.22744424333527635,0.2008763490261788,125284.2523243802,2950.4585804707613,128234.71090485096,259,0,42.810810810810814,32,5,16,39.72915878420986,0.5810546875,49.71590909090909,1001.136363636364,31.285511363636374,15
1686,4,3,2,38,0.075,0.05,0.95,40,1450,1100,350,0.7586206896551724,18,11,7,377.3720832262196,0.4718616452991453,0.2426765349614104,0.19418891846394834,126189.15741008644,1524.0530424811186,127713.21045256755,260,0,40.525,35,5,19,39.33458606919324,0.5836309523809524,48.8136574074074,1004.7453703703691,28.707010582010543,0
1687,4,3,2,39,0.07317073170731707,0.04878048780487805,0.9512195121951219,41,1350,800,550,0.5925925925925926,19,8,11,363.63812363339133,0.47040142276422764,0.2561785343552798,0.1901390689709711,126843.36917368784,1025.0169523314635,127868.38612601931,261,0,39.853658536585364,37,4,17,39.00563749501107,0.5864301801801801,48.163377192982445,1007.3464912280683,27.225580844001847,0
1688,4,3,1,41,0.07142857142857142,0.023809523809523808,0.9761904761904762,42,1500,900,600,0.6,21,9,12,358.68423788554674,0.4721617305458769,0.28104134018112514,0.19012123075487777,127396.24361582405,739.2483744998337,128135.49199032388,262,0,39.80952380952381,37,5,17,38.56248416060242,0.5920608108108107,47.61513157894736,1009.5394736842101,27.284850640113785,0
1689,4,1,1,41,0.023809523809523808,0.023809523809523808,0.9761904761904762,42,1700,1300,400,0.7647058823529411,21,13,8,359.60005347100537,0.4708430120015486,0.2827781568554475,0.1912607212803061,127534.65008464143,772.2933979686027,128306.94348261003,263,0,40.785714285714285,37,5,19,38.39738022868722,0.5934684684684685,47.478070175438596,1010.0877192982456,27.299668089141772,0
1690,4,0,4,37,0.0,0.0975609756097561,0.9024390243902439,41,1000,700,300,0.7,13,7,6,374.4245171075054,0.4717733739837398,0.14457983875629266,0.1848342978322901,124465.6623473136,1371.3613579421378,125837.02370525573,264,1,42.5609756097561,36,5,14,41.19432532069367,0.5639467592592593,50.53490990990991,997.8603603603609,27.71834334334336,16
1691,4,4,2,39,0.0975609756097561,0.04878048780487805,0.9512195121951219,41,1100,600,500,0.5454545454545454,16,6,10,369.1100273898711,0.4753810975609756,0.18937487482693482,0.18495119619302858,125089.30165816336,1036.6321411386689,126125.93379930203,265,0,42.609756097560975,34,7,18,40.679667975722964,0.5744485294117647,49.91071428571429,1000.3571428571436,29.422268907563048,0
1692,4,5,6,38,0.11363636363636363,0.13636363636363635,0.8636363636363636,44,1250,900,350,0.72,16,9,7,339.9839819988175,0.47749295278365045,0.1753870583564905,0.17456576654199382,126098.89581409673,-225.67905509386614,125873.21675900287,266,0,37.25,37,7,15,40.36663027656476,0.5788288288288288,48.90350877192983,1004.3859649122815,27.14556661925085,0
1693,4,2,2,38,0.05,0.05,0.95,40,1550,1300,250,0.8387096774193549,18,13,5,364.591192598822,0.47538728632478633,0.19576758808874128,0.1861380473903979,125864.58510487525,1177.8238378684757,127042.40894274373,267,0,41.4,34,6,18,39.99065725471585,0.5824142156862745,49.13690476190476,1003.4523809523807,29.513305322128843,0
1694,4,5,5,38,0.11627906976744186,0.11627906976744186,0.8837209302325582,43,1400,900,500,0.6428571428571429,19,9,10,336.6318533544949,0.4780823181985973,0.18826951293937344,0.17722153126334514,127120.40323685168,-35.48868780529955,127084.91454904639,268,0,36.69767441860465,36,7,19,39.40163781872322,0.5911458333333333,47.88851351351351,1008.4459459459456,28.012387387387378,0
1695,4,3,4,37,0.07317073170731707,0.0975609756097561,0.9024390243902439,41,800,400,400,0.5,12,4,8,343.3126524520486,0.47423780487804873,0.189429123455513,0.18204962111484602,127413.15593117707,548.5097040037656,127961.66563518083,269,0,37.26829268292683,35,6,16,38.93311265237496,0.5961309523809524,47.598379629629626,1009.606481481481,28.845899470899457,0
1696,4,0,0,37,0.0,0.0,1.0,37,1550,1200,350,0.7741935483870968,19,12,7,373.65823771314024,0.4733796296296296,0.20040162954584728,0.195808693052434,126932.92018990399,2085.9062531884324,129018.82644309242,270,1,41.108108108108105,32,5,21,38.66109092427848,0.5979817708333333,48.07449494949494,1007.7020202020194,31.490688131313107,0
1697,4,1,1,37,0.02631578947368421,0.02631578947368421,0.9736842105263158,38,1350,800,550,0.5925925925925926,19,8,11,363.3072734248777,0.4731063300142247,0.1886343438333169,0.19248784963763385,127378.63363751145,1655.6164549535765,129034.25009246502,271,0,41.0,32,6,16,38.46388367729833,0.6025390625,47.63257575757576,1009.4696969696967,31.54592803030302,0
1698,4,0,0,37,0.0,0.0,1.0,37,1000,700,300,0.7,13,7,6,374.4140743167125,0.47156531531531537,0.19626337747143197,0.19761309589958354,127223.34120008668,2126.8419053819357,129350.18310546862,272,3,43.108108108108105,31,6,23,38.343228360006904,0.603494623655914,47.78645833333333,1008.8541666666656,32.54368279569889,0
1699,4,2,0,39,0.05128205128205128,0.0,1.0,39,950,500,450,0.5263157894736842,14,5,9,403.26524959641705,0.47205353126405764,0.2139532248774909,0.19972048562079087,124602.03294706366,2268.115797559834,126870.1487446235,273,0,41.84615384615385,33,6,18,40.33271449613353,0.5716540404040404,50.39828431372549,998.4068627450984,30.25475341651813,16
1700,4,6,1,44,0.13333333333333333,0.022222222222222223,0.9777777777777777,45,1300,1200,100,0.9230769230769231,14,12,2,397.8496301613553,0.4773989898989899,0.1310986964618246,0.19247319945643973,123614.96913580269,1194.7226160344544,124809.69175183715,274,0,37.13333333333333,35,10,19,41.49790502793296,0.5571428571428572,51.3888888888889,994.4444444444463,28.412698412698465,16
1701,4,4,2,46,0.08333333333333333,0.041666666666666664,0.9583333333333334,48,1450,1100,350,0.7586206896551724,18,11,7,370.74065550991065,0.48037640366430256,0.14447796432319016,0.1775456506034896,123183.72938368036,-416.9668692129829,122766.76251446738,275,0,35.604166666666664,39,9,14,42.621983210912916,0.545405982905983,51.82291666666666,992.7083333333317,25.454059829059787,16
1702,4,10,12,44,0.17857142857142858,0.21428571428571427,0.7857142857142857,56,1800,1400,400,0.7777777777777778,22,14,8,335.3552472872673,0.48574134199134195,0.23545223687054295,0.1692136018754836,125379.07483930202,-2759.2268566345365,122619.84798266749,276,0,31.196428571428573,43,13,11,41.224628088754415,0.562015503875969,49.62121212121212,1001.5151515151508,23.291050035236065,0
1703,4,9,10,43,0.16981132075471697,0.18867924528301888,0.8113207547169812,53,1600,1200,400,0.75,20,12,8,335.12992523021717,0.48609095307208516,0.21738298442343784,0.17083210811956823,125800.69674486185,-2168.084381197066,123632.61236366478,277,0,29.39622641509434,42,11,13,40.79554235487301,0.5677083333333333,49.20058139534883,1003.1976744186027,23.885658914728634,0
1704,4,3,2,44,0.06521739130434782,0.043478260869565216,0.9565217391304348,46,1600,1100,500,0.6875,21,11,10,382.42081979486846,0.48464170692431563,0.2665408494091024,0.19452841033614388,125713.73523584176,415.1099376731257,126128.84517351488,278,0,33.84782608695652,37,9,18,39.69950433705079,0.5748873873873874,49.28728070175438,1002.8508771929821,27.10407776197249,0
1705,4,2,4,42,0.043478260869565216,0.08695652173913043,0.9130434782608696,46,1450,800,650,0.5517241379310345,21,8,13,368.641251382026,0.4852556360708535,0.26610096183552034,0.1902693598208939,126312.95351473909,114.13152634090005,126427.08504107999,279,0,34.19565217391305,34,12,15,39.42617045633981,0.5870098039215687,48.69047619047618,1005.238095238094,29.56582633053218,0
1706,4,2,3,41,0.045454545454545456,0.06818181818181818,0.9318181818181819,44,850,400,450,0.47058823529411764,13,4,9,379.64619811474495,0.484375,0.2494005617592654,0.1960274338125551,126329.27284205692,792.0856290174436,127121.35847107436,280,0,35.84090909090909,32,12,16,39.132755589047974,0.591796875,48.67424242424242,1005.3030303030303,31.415719696969695,0
1707,4,4,3,42,0.08888888888888889,0.06666666666666667,0.9333333333333333,45,1050,700,350,0.6666666666666666,14,7,7,362.0894934922969,0.48274410774410775,0.22163438828530868,0.19020929472039533,127032.00113378688,199.390589569158,127231.39172335604,281,0,32.977777777777774,34,11,20,38.85067312234292,0.5943627450980392,47.976190476190474,1008.0952380952383,29.649859943977596,0
1708,4,0,3,39,0.0,0.07142857142857142,0.9285714285714286,42,1550,900,650,0.5806451612903226,22,9,13,392.30856909320846,0.4817073170731707,0.23485142536766213,0.20391075524690064,126600.14046563055,1533.263990614159,128133.40445624471,282,1,36.26190476190476,31,11,20,38.53465842929227,0.5971102150537635,48.40494791666667,1006.3802083333344,32.463877688172076,0
1709,4,3,1,41,0.07142857142857142,0.023809523809523808,0.9761904761904762,42,1500,1200,300,0.8,18,12,6,376.2659055451847,0.48066686024003097,0.2190583440583438,0.19888340721674064,127283.05785123979,1178.4550045913809,128461.51285583117,283,0,35.214285714285715,32,10,23,38.2351101101101,0.6015625,47.727272727272734,1009.0909090909101,31.534090909090942,0
1710,4,2,2,41,0.046511627906976744,0.046511627906976744,0.9534883720930233,43,900,600,300,0.6666666666666666,12,6,6,367.91067033976105,0.4779900332225913,0.22800281888653973,0.19683936642691507,127772.55893166101,801.7775615148158,128574.33649317583,284,0,35.13953488372093,33,10,18,37.94343434343434,0.6041666666666667,47.242647058823536,1011.0294117647068,30.637254901960812,0
1711,4,2,1,42,0.046511627906976744,0.023255813953488372,0.9767441860465116,43,1400,900,500,0.6428571428571429,19,9,10,364.5786386034493,0.4789128829826504,0.22740895979808862,0.19596101824935402,127958.47750865057,730.185505574786,128688.66301422536,285,0,35.97674418604651,33,10,20,37.83712855297157,0.6060606060606061,47.05882352941177,1011.7647058823534,30.659536541889498,0
1712,4,1,5,38,0.023255813953488372,0.11627906976744186,0.8837209302325582,43,1150,900,250,0.782608695652174,14,9,5,367.72493786663233,0.4767211148025101,0.22979542777183126,0.19889878767222982,128210.45769585494,829.5068467318658,129039.96454258681,286,0,36.69767441860465,31,12,21,37.49946430101998,0.6135752688172043,46.80989583333333,1012.7604166666658,32.66969086021503,0
1713,4,0,1,37,0.0,0.02631578947368421,0.9736842105263158,38,1000,600,400,0.6,14,6,8,409.8229380915185,0.47455844001896635,0.22919818456883534,0.21766417698052795,127477.43296682076,2848.635223765401,130326.06819058617,287,1,39.421052631578945,29,9,22,37.1881160317242,0.6117097701149425,47.53472222222221,1009.8611111111093,34.822796934865835,0
1714,4,3,4,36,0.075,0.1,0.9,40,1450,1200,250,0.8275862068965517,17,12,5,399.9920179045102,0.4776709401709402,0.22572189987855928,0.19540809787015992,124027.43678821252,2146.5532704487373,126173.99005866126,288,0,37.075,30,10,21,41.01363963477714,0.5732638888888889,50.9744623655914,996.1021505376345,33.20340501792115,16
1715,4,10,6,40,0.21739130434782608,0.13043478260869565,0.8695652173913043,46,1400,1100,300,0.7857142857142857,17,11,6,336.19929997783566,0.4813003220611916,0.23454600799738046,0.17558730198842423,126795.9347491599,-674.2590994594211,126121.67564970048,289,0,29.543478260869566,38,8,15,39.74532371556876,0.5841557017543859,48.210470085470085,1007.1581196581196,26.504161043634728,0
1716,4,1,0,41,0.024390243902439025,0.0,1.0,41,1500,1100,400,0.7333333333333333,19,11,8,364.9173071421356,0.47987804878048784,0.24979282585533302,0.18876034864847635,126402.7228599773,1025.3082482993163,127428.03110827661,290,0,33.609756097560975,34,7,19,39.427212817173746,0.5879289215686274,48.601190476190474,1005.5952380952378,29.57633053221288,0
1717,4,2,2,41,0.046511627906976744,0.046511627906976744,0.9534883720930233,43,1650,1000,650,0.6060606060606061,23,10,13,348.67836896386837,0.48025101513473606,0.2563905439169707,0.18343514193316576,127092.0138888891,262.8472222222457,127354.86111111134,291,0,33.0,36,7,22,39.127066115702476,0.5908564814814814,47.91666666666668,1008.3333333333351,28.00925925925931,0
1718,4,1,0,42,0.023809523809523808,0.0,1.0,42,1600,1100,500,0.6875,21,11,10,357.30528368553587,0.48060636856368566,0.25441458011602536,0.18869110972309305,127246.52364775582,693.1710459919425,127939.69469374776,292,0,34.30952380952381,33,9,24,38.750936272723585,0.598800505050505,47.76348039215687,1008.9460784313738,30.57412358882951,0
1719,4,1,2,41,0.023255813953488372,0.046511627906976744,0.9534883720930233,43,1600,1300,300,0.8125,19,13,6,346.33397554585963,0.4808047249907715,0.2495983716401089,0.18445084030139194,127588.49511584814,237.64614947705235,127826.14126532519,293,0,34.48837209302326,35,8,18,38.67723011417879,0.5979166666666667,47.42476851851853,1010.3009259259278,28.865740740740794,0
1720,4,0,2,39,0.0,0.04878048780487805,0.9512195121951219,41,1400,1100,300,0.7857142857142857,17,11,6,354.41586577443144,0.4802591463414634,0.24059674892565086,0.18854035241981523,127542.56129535157,840.6214569161134,128383.18275226768,294,1,35.75609756097561,34,7,20,38.520182675309385,0.5995710784313726,47.4702380952381,1010.1190476190484,29.709383753501424,0
1721,4,1,1,39,0.025,0.025,0.975,40,850,500,350,0.5882352941176471,12,5,7,353.8228038247439,0.4812633547008547,0.22400506299305278,0.1893520524816352,127783.17920918364,1042.5205498866148,128825.69975907025,295,0,35.375,34,6,21,38.288639664037035,0.6020220588235294,47.232142857142854,1011.0714285714283,29.737394957983184,0
1722,4,2,4,37,0.04878048780487805,0.0975609756097561,0.9024390243902439,41,1400,1000,400,0.7142857142857143,18,10,8,338.4667482080876,0.48038617886178864,0.21797138810735261,0.1848738630145692,128601.0181422978,505.4336853745706,129106.45182767238,296,0,34.78048780487805,36,5,17,37.84186373561303,0.6061921296296297,46.42454954954955,1014.3018018018026,28.175050050050075,0
1723,4,1,0,38,0.02631578947368421,0.0,1.0,38,1250,1100,150,0.88,14,11,3,368.0391324300542,0.4792407539118066,0.22275777757968585,0.1993585497160436,128268.64216887722,1841.575956362918,130110.21812524015,297,0,37.71052631578947,33,5,24,37.43195015727075,0.6092171717171717,46.75245098039215,1012.9901960784304,30.696672608437282,0
1724,4,2,3,37,0.05,0.075,0.925,40,1150,900,250,0.782608695652174,14,9,5,355.0553795629043,0.4788995726495726,0.226669135239832,0.19587184578401037,128995.54887099173,1160.1127132630088,130155.66158425473,298,0,36.775,35,5,20,37.01874691428355,0.6122023809523809,46.03587962962962,1015.8564814814797,29.02447089947085,0
1725,4,0,2,35,0.0,0.05405405405405406,0.9459459459459459,37,1250,1000,250,0.8,15,10,5,370.6580983457169,0.477759009009009,0.17785345141246323,0.18120799427751305,124057.77189466683,1802.9599266941773,125860.73182136101,299,1,38.891891891891895,31,6,19,41.71254846860977,0.5709005376344086,50.944010416666664,996.2239583333329,32.1362567204301,15
1726,4,3,2,36,0.07894736842105263,0.05263157894736842,0.9473684210526316,38,1400,1100,300,0.7857142857142857,17,11,6,358.3305226027412,0.4776849217638692,0.1670521276801924,0.17746618648295018,124602.03294706352,1329.7423166570413,125931.77526372056,300,0,37.6578947368421,33,5,16,41.45429299128513,0.5716540404040404,50.39828431372548,998.4068627450971,30.254753416518096,0
1727,4,4,2,38,0.1,0.05,0.95,40,1050,600,450,0.5714285714285714,15,6,9,342.5362976613301,0.47751068376068373,0.20071201564600982,0.17394720367270877,125644.21023464522,608.8095624279031,126253.01979707312,301,0,36.675,33,7,18,40.77117202460989,0.5823863636363636,49.35661764705882,1002.5735294117637,30.38101604278072,0
1728,4,4,3,39,0.09523809523809523,0.07142857142857142,0.9285714285714286,42,1100,700,400,0.6363636363636364,15,7,8,317.59041115213824,0.4774608013937282,0.18922922794901376,0.1649992973288084,126581.54776398005,-359.78284027272207,126221.76492370733,302,0,34.595238095238095,36,6,16,40.4335925843032,0.5856481481481481,48.423423423423415,1006.306306306305,27.952952952952916,0
1729,4,4,2,41,0.09302325581395349,0.046511627906976744,0.9534883720930233,43,1050,700,350,0.6666666666666666,14,7,7,309.42283985935825,0.4769979697305278,0.20135816988504884,0.16267255646122328,127064.37467538069,-736.6760685980518,126327.69860678264,303,0,34.348837209302324,37,6,20,40.14489305782125,0.5886824324324325,47.94407894736841,1008.2236842105248,27.249288762446614,0
1730,4,2,2,41,0.046511627906976744,0.046511627906976744,0.9534883720930233,43,1400,1100,300,0.7857142857142857,17,11,6,312.02557867133197,0.47448320413436695,0.2155113139547853,0.16519109637514187,127347.63215495921,-652.8532711524363,126694.77888380678,304,0,34.93023255813954,36,7,17,39.78973743910149,0.5934606481481481,47.6632882882883,1009.3468468468485,28.037412412412458,0
1731,4,1,4,38,0.023809523809523808,0.09523809523809523,0.9047619047619048,42,1000,600,400,0.6,14,6,8,316.8928208945844,0.47487175764614786,0.21015774730945003,0.1677973461458212,127354.73632812523,-328.4396701388612,127026.29665798637,305,0,36.285714285714285,35,7,18,39.65965772273821,0.5955357142857143,47.656250000000014,1009.3750000000018,28.839285714285765,0
1732,4,2,3,37,0.05,0.075,0.925,40,1400,1100,300,0.7857142857142857,17,11,6,323.90554502455234,0.4744524572649573,0.20473205084163526,0.17300716359017843,127705.45488522391,272.90099344137593,127978.35587866529,306,0,36.95,35,5,19,39.12422706973549,0.5991071428571428,47.309027777777786,1010.76388888889,28.87896825396829,0
1733,4,5,6,36,0.11904761904761904,0.14285714285714285,0.8571428571428572,42,1050,700,350,0.6666666666666666,14,7,7,311.57176265528636,0.47545247773906313,0.19998358511646663,0.16848856653992755,128201.54772593566,-410.45003953133374,127791.09768640432,307,0,35.92857142857143,36,6,20,38.93027910597134,0.6021412037037037,46.81869369369371,1012.7252252252274,28.131256256256318,0
1734,4,1,1,36,0.02702702702702703,0.02702702702702703,0.972972972972973,37,1150,700,450,0.6086956521739131,16,7,9,352.9525518136758,0.47266016016016016,0.22161756553952694,0.18714911169112403,127410.50020406075,1593.9722349760152,129004.47243903676,308,0,41.486486486486484,32,5,20,38.692523345005846,0.6028645833333333,47.6010101010101,1009.5959595959591,31.549873737373723,0
1735,4,1,0,37,0.02702702702702703,0.0,1.0,37,1300,900,400,0.6923076923076923,17,9,8,351.7103140789469,0.472535035035035,0.22297133338142805,0.18701912313797933,127524.87775134559,1570.3629613610083,129095.2407127066,309,0,42.45945945945946,33,4,21,38.60662865000403,0.6016414141414141,47.48774509803921,1010.0490196078428,30.607546048722508,0
1736,4,2,1,38,0.05128205128205128,0.02564102564102564,0.9743589743589743,39,650,300,350,0.46153846153846156,10,3,7,339.5485105590272,0.47340305892937473,0.23150786113749056,0.18335619570187484,128144.53125000012,902.2569444444584,129046.78819444457,310,0,41.23076923076923,35,4,23,38.28017832647463,0.6035714285714286,46.87500000000001,1012.5000000000009,28.928571428571455,0
1737,4,3,4,37,0.07317073170731707,0.0975609756097561,0.9024390243902439,41,1200,700,500,0.5833333333333334,17,7,10,318.4636625181961,0.4738313008130081,0.2007558167019361,0.1749057472728299,128819.24518014811,4.849724579875556,128824.09490472799,311,0,39.51219512195122,35,6,18,38.127185231634535,0.6104166666666666,46.209490740740726,1015.1620370370354,29.00462962962958,0
1738,4,1,1,37,0.02631578947368421,0.02631578947368421,0.9736842105263158,38,1500,1100,400,0.7333333333333333,19,11,8,343.89478007685227,0.47218764817449027,0.1988392431229129,0.18758927522320054,128548.11137843617,1241.404898356402,129789.51627679256,312,0,42.60526315789474,33,5,18,37.75818227593151,0.6120580808080809,46.47671568627451,1014.0931372549019,30.73009506833036,0
1739,4,0,1,36,0.0,0.02702702702702703,0.972972972972973,37,1300,1100,200,0.8461538461538461,15,11,4,386.62523070007455,0.471753003003003,0.17059054896892722,0.1957544589123538,125521.37586805574,2497.676825019248,128019.05269307499,313,2,44.75675675675676,33,4,17,39.79339916839917,0.5811237373737373,49.47916666666668,1002.0833333333348,30.366161616161662,16
1740,4,3,2,37,0.07692307692307693,0.05128205128205128,0.9487179487179487,39,1400,1000,400,0.7142857142857143,18,10,8,361.46309370935677,0.4728969860548808,0.17348282234305712,0.18666280808320304,126334.56173911194,1334.1413751714827,127668.70311428343,314,0,43.07692307692308,35,4,16,39.58429273159873,0.5851190476190475,48.66898148148149,1005.3240740740753,28.723544973545007,0
1741,4,6,3,40,0.13953488372093023,0.06976744186046512,0.9302325581395349,43,1250,800,450,0.64,17,8,9,334.9741341715384,0.4757751937984496,0.1107579785879449,0.1688180901354575,125329.16378116352,194.78686194756278,125523.95064311108,315,0,39.93023255813954,37,6,15,41.28568039129801,0.5709459459459459,49.67105263157895,1001.315789473685,27.062588904694188,16
1742,4,4,0,44,0.09090909090909091,0.0,1.0,44,1200,800,400,0.6666666666666666,16,8,8,314.3625851635002,0.47594036293164205,0.12289102316424727,0.16129444790164665,126069.35046103533,-873.70261583711,125195.64784519821,316,0,37.95454545454545,40,4,19,41.0403174121298,0.5734375,48.932926829268304,1004.2682926829286,25.106707317073216,0
1743,4,3,8,39,0.06382978723404255,0.1702127659574468,0.8297872340425532,47,1200,1000,200,0.8333333333333334,14,10,4,299.4430431196638,0.47826086956521735,0.13725927403738925,0.15645251791814171,126812.07561728427,-1805.4012345678757,125006.67438271639,317,0,36.46808510638298,44,3,12,40.654302261445125,0.5752840909090908,48.19444444444446,1007.2222222222248,22.8914141414142,0
1744,4,2,1,40,0.04878048780487805,0.024390243902439025,0.975609756097561,41,1100,700,400,0.6363636363636364,15,7,8,336.39962016766145,0.4733231707317073,0.14357191230428645,0.17381847611660958,126357.83420138882,301.34548611110176,126659.17968749991,318,0,41.5609756097561,39,2,14,40.19028871391074,0.5779914529914529,48.64583333333333,1005.4166666666661,25.779914529914514,0
1745,4,2,8,34,0.047619047619047616,0.19047619047619047,0.8095238095238095,42,1350,1100,250,0.8148148148148148,16,11,5,323.6111972223944,0.4729965156794425,0.1499531308586426,0.16982901672414905,126992.00050390522,-180.79333585286707,126811.20716805235,319,0,41.11904761904762,41,1,17,39.86138451443569,0.5813008130081301,48.01587301587301,1007.9365079365075,24.583817266744084,0
1746,4,3,2,35,0.08108108108108109,0.05405405405405406,0.9459459459459459,37,1400,900,500,0.6428571428571429,19,9,10,347.9441964982368,0.4723786286286286,0.16150385021893432,0.18253813356736348,126978.48820103894,1436.2856099342735,128414.77381097322,320,0,44.75675675675676,36,1,19,39.26210428305402,0.5896990740740741,48.02927927927929,1007.8828828828835,27.996746746746762,0
1747,4,4,4,35,0.10256410256410256,0.10256410256410256,0.8974358974358975,39,1200,600,600,0.5,18,6,12,335.5510681262617,0.47208164642375167,0.17351308485329042,0.17883765718817252,127617.7300347223,764.5038514020814,128382.23388612439,321,0,43.35897435897436,37,2,17,38.9196735395189,0.5943130630630631,47.395833333333336,1010.4166666666674,27.30855855855858,0
1748,4,3,3,35,0.07894736842105263,0.07894736842105263,0.9210526315789473,38,1300,700,600,0.5384615384615384,19,7,12,342.48339047949446,0.47073553816974867,0.1634696079606761,0.18303503633799753,127728.54538175194,1148.9810566712663,128877.52643842321,322,0,42.81578947368421,37,1,19,38.63115576526739,0.5954391891891893,47.28618421052631,1010.8552631578937,27.32041251778091,0
1749,4,1,1,35,0.027777777777777776,0.027777777777777776,0.9722222222222222,36,950,800,150,0.8421052631578947,11,8,3,358.7736718089346,0.4695271164021164,0.17625278573702707,0.1905234501845982,127471.58893014808,1946.6900023576527,129418.27893250572,323,0,46.083333333333336,35,1,20,38.482927411652334,0.5967261904761905,47.540509259259245,1009.837962962961,28.85251322751317,0
1750,4,1,0,36,0.027777777777777776,0.0,1.0,36,1300,900,400,0.6923076923076923,17,9,8,389.05020877075674,0.46911375661375665,0.13317558789999695,0.1920505800893103,124464.8596938778,2516.6120823972856,126981.4717762751,324,0,43.388888888888886,34,2,19,40.8303010419152,0.5680147058823529,50.5357142857143,997.8571428571449,29.34873949579838,16
1751,4,2,1,37,0.05263157894736842,0.02631578947368421,0.9736842105263158,38,1600,1400,200,0.875,18,14,4,375.94142381510943,0.4715949502133712,0.1286848995853116,0.1882395615550982,125059.5308956916,1805.3075396825386,126864.83843537414,325,0,42.05263157894737,34,4,21,40.53970284852812,0.5741421568627452,49.94047619047619,1000.2380952380952,29.418767507002798,0
1752,4,2,4,35,0.05128205128205128,0.10256410256410256,0.8974358974358975,39,700,200,500,0.2857142857142857,12,2,10,359.465612329692,0.47247525865946916,0.12189929682346246,0.18231358492003374,125591.91528944505,1229.1949466358515,126821.1102360809,326,0,40.97435897435897,36,3,16,40.40089128562333,0.5755208333333333,49.4087837837838,1002.3648648648666,27.843468468468515,0
1753,4,4,3,36,0.10256410256410256,0.07692307692307693,0.9230769230769231,39,1200,800,400,0.6666666666666666,16,8,8,357.0371487006962,0.47011358524516417,0.13532966164545157,0.18320957338437174,126073.7244897958,1204.2238684492445,127277.94835824505,327,0,39.30769230769231,34,5,21,39.96438873083611,0.5845588235294117,48.92857142857142,1004.2857142857133,29.53781512605039,0
1754,4,1,2,35,0.02702702702702703,0.05405405405405406,0.9459459459459459,37,950,500,450,0.5263157894736842,14,5,9,362.26255207965505,0.46996996996997,0.12059959118782593,0.17243697478991593,122925.3472222223,1694.7526927437684,124620.09991496608,328,0,41.91891891891892,34,3,18,43.10224089635854,0.5520833333333333,52.083333333333336,991.6666666666674,29.16666666666669,15
1755,4,5,3,37,0.125,0.075,0.925,40,900,500,400,0.5555555555555556,13,5,8,337.6635199579234,0.4759748931623931,0.13416400484634927,0.1643778604663799,123878.622809422,365.85836507385835,124244.48117449586,329,0,38.95,37,3,18,42.72026563131036,0.5560247747747749,51.123903508771924,995.5043859649112,26.9055239449976,0
1756,4,4,3,38,0.0975609756097561,0.07317073170731707,0.926829268292683,41,1250,700,550,0.56,18,7,11,349.6301730561799,0.47903963414634143,0.13345302875452303,0.1690708887232241,123596.30534250481,498.8758554178818,124095.18119792269,330,0,38.853658536585364,36,5,20,42.71611929029821,0.5549768518518519,51.407657657657666,994.3693693693706,27.621371371371406,16
1757,4,8,9,37,0.17391304347826086,0.1956521739130435,0.8043478260869565,46,1550,1100,450,0.7096774193548387,20,11,9,307.25899045792926,0.48285024154589373,0.1685901900308424,0.15498362719110892,125364.84917534747,-1480.2526000451226,123884.59657530235,331,0,34.65217391304348,39,7,15,41.94273975452465,0.5678418803418803,49.63541666666668,1001.4583333333353,25.678418803418854,0
1758,4,5,5,37,0.11904761904761904,0.11904761904761904,0.8809523809523809,42,1300,800,500,0.6153846153846154,18,8,10,347.42650940559327,0.4771583430120015,0.2030112854390307,0.17492661853075545,125289.51930084005,305.7800711591017,125595.29937199915,332,0,37.476190476190474,35,7,18,41.01493256262041,0.5744047619047619,49.71064814814814,1001.1574074074064,28.604497354497326,0
1759,4,3,2,38,0.075,0.05,0.95,40,1200,900,300,0.75,15,9,6,344.9201771518805,0.4753071581196581,0.21261690335988925,0.17500607230887114,125608.37733892718,664.9727527005809,126273.35009162776,333,0,38.95,35,5,21,40.748397990994114,0.5776785714285715,49.39236111111109,1002.4305555555532,28.64087301587295,0
1760,4,2,2,38,0.05,0.05,0.95,40,1600,1300,300,0.8125,19,13,6,333.8720502563827,0.4762820512820513,0.207953367875648,0.17229226122856084,126305.47417534697,434.72704475305306,126740.20122010002,334,0,39.175,35,5,17,40.307642487046614,0.5848214285714286,48.69791666666665,1005.2083333333313,28.720238095238038,0
1761,4,2,1,39,0.05,0.025,0.975,40,1200,800,400,0.6666666666666666,16,8,8,329.4566355267608,0.47584134615384616,0.20169761718313062,0.17152084245624388,126666.55411746175,346.2273506614401,127012.7814681232,335,0,36.35,36,4,19,40.04782414140284,0.5865162037037037,48.33896396396395,1006.6441441441417,27.96233733733727,0
1762,4,2,4,37,0.04878048780487805,0.0975609756097561,0.9024390243902439,41,1150,600,550,0.5217391304347826,17,6,11,320.0731703457423,0.47594004065040646,0.19675001888222865,0.16923699043326396,127296.33012099168,-49.74532890077677,127246.5847920909,336,0,34.951219512195124,35,6,21,39.63912623771843,0.5949404761904762,47.71412037037036,1009.1435185185164,28.8326719576719,0
1763,4,2,4,35,0.05128205128205128,0.10256410256410256,0.8974358974358975,39,1000,400,600,0.4,16,4,12,329.6073937705012,0.47708614484930273,0.19391157912558699,0.17482178277471067,127422.3373724491,599.8689058957074,128022.2062783448,337,0,35.87179487179487,34,5,15,39.269641944739234,0.5983455882352942,47.58928571428572,1009.6428571428581,29.695378151260535,0
1764,4,3,0,38,0.07894736842105263,0.0,1.0,38,1100,700,400,0.6363636363636364,15,7,8,332.011996032777,0.473565670934092,0.18995270087066518,0.17759490418532206,127763.95486379038,883.8331350737388,128647.78799886412,338,0,36.44736842105263,35,3,19,38.85959263499332,0.5997023809523809,47.25115740740741,1010.9953703703711,28.88558201058203,0
1765,4,2,3,37,0.05,0.075,0.925,40,1200,1000,200,0.8333333333333334,14,10,4,373.9694437441565,0.474465811965812,0.18945539850338555,0.1895513995714661,125566.11571712008,2291.314993718669,127857.43071083874,339,0,35.575,34,6,16,40.06414063427959,0.5793504901960784,49.4345238095238,1002.2619047619039,29.478291316526587,16
1766,4,2,2,37,0.05128205128205128,0.05128205128205128,0.9487179487179487,39,1000,700,300,0.7,13,7,6,380.07641371937956,0.4732624831309042,0.20992004209300008,0.19387449215704405,125828.57442149638,1764.8946619088656,127593.46908340525,340,0,36.46153846153846,33,6,19,39.63944363014538,0.584280303030303,49.17279411764705,1003.3088235294105,30.403297682709407,0
1767,4,1,1,37,0.02631578947368421,0.02631578947368421,0.9736842105263158,38,1300,900,400,0.6923076923076923,17,9,8,382.86600693530977,0.47358048838312,0.22379501713600858,0.19575156485576664,125924.3214994329,2042.428429705195,127966.7499291381,341,0,38.18421052631579,34,4,20,39.47040683192981,0.5830269607843137,49.07738095238094,1003.6904761904744,29.520308123249247,0
1768,4,3,3,37,0.075,0.075,0.925,40,1300,1100,200,0.8461538461538461,15,11,4,372.78665786736144,0.47533386752136747,0.1666387959866218,0.18272657492187078,124168.05555555574,1331.221655328818,125499.27721088455,342,0,37.05,34,6,19,41.54473244147157,0.5649509803921569,50.83333333333334,996.6666666666681,29.31372549019612,16
1769,4,4,4,37,0.0975609756097561,0.0975609756097561,0.9024390243902439,41,1300,1000,300,0.7692307692307693,16,10,6,357.5530961289791,0.4794207317073171,0.17533417288328956,0.17852853435619206,124942.13632758919,734.6895361797048,125676.8258637689,343,0,34.48780487804878,35,6,16,41.1211121401559,0.5708333333333333,50.057870370370374,999.7685185185188,28.564814814814824,0
1770,4,4,1,40,0.0975609756097561,0.024390243902439025,0.975609756097561,41,1500,1000,500,0.6666666666666666,20,10,10,392.16734412761696,0.48051321138211384,0.29567316352631723,0.19100524602474606,123899.49178200713,1639.4482876363106,125538.94006964343,344,0,33.41463414634146,33,8,20,41.34201132447072,0.5643939393939394,51.1029411764706,995.5882352941194,30.169340463458163,16
1771,4,5,3,42,0.1111111111111111,0.06666666666666667,0.9333333333333333,45,1600,1200,400,0.75,20,12,8,352.7175294823411,0.48356481481481484,0.28212094653812403,0.1772910577706395,125219.39442905526,-161.7189937867331,125057.67543526852,345,0,29.822222222222223,37,8,22,40.95502848378616,0.5698198198198199,49.78070175438597,1000.8771929824575,27.050734945471824,0
1772,4,6,5,43,0.125,0.10416666666666667,0.8958333333333334,48,1200,900,300,0.75,15,9,6,333.8720502563832,0.4833314864066194,0.2963946459412785,0.17229226122856084,126305.47417534678,-1152.5006792956008,125152.97349605119,346,0,28.770833333333332,35,13,15,40.30764248704664,0.5848214285714286,48.69791666666664,1005.2083333333297,28.720238095237992,0
1773,4,1,4,40,0.022727272727272728,0.09090909090909091,0.9090909090909091,44,1500,1200,300,0.8,18,12,6,360.2917258099753,0.48245903805496826,0.30043140391977596,0.18503038597923518,126107.23913695032,287.07896515661827,126394.31810210693,347,0,28.977272727272727,32,12,22,39.84810391787135,0.5895182291666667,48.89520202020202,1004.4191919191919,31.388099747474747,0
1774,4,4,3,41,0.09090909090909091,0.06818181818181818,0.9318181818181819,44,1250,700,550,0.56,18,7,11,359.802814321907,0.48120375264270615,0.2940733299849321,0.18606945540647224,126392.7469135805,295.2932098765807,126688.04012345707,348,0,29.5,32,12,19,39.566068139963164,0.5924479166666667,48.61111111111113,1005.5555555555577,31.423611111111178,0
1775,4,3,3,41,0.06818181818181818,0.06818181818181818,0.9318181818181819,44,1350,800,550,0.5925925925925926,19,8,11,363.4772533987406,0.4815451021846371,0.3141431353456676,0.18948788793934346,126721.57343329492,412.0818915801693,127133.65532487509,349,0,30.431818181818183,33,11,21,39.13502109704643,0.5934343434343434,48.2843137254902,1006.8627450980395,30.510992275698165,0
1776,4,0,1,40,0.0,0.024390243902439025,0.975609756097561,41,1600,1400,200,0.875,18,14,4,373.36504161712253,0.47970020325203255,0.29214465937762846,0.19474075911684458,126742.13927469139,1264.2168209876622,128006.35609567906,350,1,31.048780487804876,32,9,23,38.86494252873564,0.5960286458333333,48.26388888888889,1006.9444444444447,31.467013888888896,0
1777,4,3,3,40,0.06976744186046512,0.06976744186046512,0.9302325581395349,43,1300,800,500,0.6153846153846154,18,8,10,347.28451482623046,0.4797203765227021,0.28089187245264946,0.1850911974623314,127617.73003472213,264.89679783949646,127882.62683256163,351,0,30.11627906976744,33,10,17,38.623281786941575,0.6025883838383839,47.39583333333333,1010.4166666666658,30.618686868686844,0
1778,4,3,3,40,0.06976744186046512,0.06976744186046512,0.9302325581395349,43,1200,900,300,0.75,15,9,6,350.9655333000694,0.4806432262827612,0.28698222490641556,0.18855499241400783,127939.53517500429,380.4734385716758,128320.00861357596,352,0,30.6046511627907,35,8,20,38.20083991152805,0.6014880952380952,47.0775462962963,1011.6898148148149,28.905423280423282,0
1779,4,2,6,36,0.047619047619047616,0.14285714285714285,0.8571428571428572,42,1300,700,600,0.5384615384615384,19,7,12,342.6534058922876,0.479590108401084,0.2789302022178737,0.18666939276221634,128496.33487654322,406.1054580332665,128902.44033457649,353,0,30.928571428571427,35,7,16,37.84246575342466,0.6071428571428572,46.52777777777778,1013.8888888888889,28.96825396825397,0
1780,4,1,0,37,0.02702702702702703,0.0,1.0,37,1500,900,600,0.6,21,9,12,358.0571576370578,0.47541291291291293,0.24399154322984584,0.19470682122393845,128423.86529519889,1796.6168360726547,130220.48213127155,354,0,32.432432432432435,33,4,18,37.52607000362711,0.6107954545454546,46.59926470588235,1013.60294117647,30.715240641711212,0
1781,4,0,2,35,0.0,0.05405405405405406,0.9459459459459459,37,1350,1000,350,0.7407407407407407,17,10,7,399.9724842470963,0.4754441941941942,0.14668500087007863,0.20013784255977557,125031.5676493469,2811.800159186399,127843.36780853331,355,1,33.432432432432435,32,5,20,39.9678596978496,0.5784505208333333,49.96843434343434,1000.1262626262619,31.253945707070685,16
1782,4,3,2,36,0.07894736842105263,0.05263157894736842,0.9473684210526316,38,1650,1400,250,0.8484848484848485,19,14,5,383.6069452255027,0.47321005215742057,0.14652927370350133,0.19538412238150213,125767.10467428391,2049.02696679162,127816.13164107552,356,0,32.78947368421053,33,5,17,39.614513337405825,0.5836489898989898,49.23406862745098,1003.063725490196,30.39587046939988,0
1783,4,0,2,34,0.0,0.05555555555555555,0.9444444444444444,36,1150,900,250,0.782608695652174,14,9,5,405.6131839868706,0.4709986772486772,0.1572004965859719,0.20553026182665832,125553.99788750533,2985.2713690863634,128539.2692565917,357,1,35.611111111111114,31,5,18,39.28383894157897,0.5863575268817205,49.44661458333333,1002.2135416666658,32.329469086021476,0
1784,4,1,5,30,0.02857142857142857,0.14285714285714285,0.8571428571428572,35,1050,700,350,0.6666666666666666,14,7,7,403.840718205132,0.46960784313725495,0.1772266399747906,0.2062558260574521,125880.45120239252,3167.1303643120523,129047.58156670457,358,0,37.05714285714286,31,4,19,38.98958198174818,0.5897177419354839,49.12109374999999,1003.5156249999995,32.37147177419353,0
1785,4,3,1,32,0.09090909090909091,0.030303030303030304,0.9696969696969697,33,1550,800,750,0.5161290322580645,23,8,15,412.2525539980097,0.471551452020202,0.17602896912804367,0.2004803752724432,123834.79882473696,3610.2424178654837,127445.04124260246,359,0,36.90909090909091,32,1,18,40.90976362636897,0.5660807291666667,51.16792929292927,995.3282828282803,31.10400883838376,16
1786,4,6,3,35,0.15789473684210525,0.07894736842105263,0.9210526315789473,38,1300,1100,200,0.8461538461538461,15,11,4,366.1811567520579,0.4786925082977715,0.15272790962431038,0.1849368699226777,125417.0138888887,1590.6532177838762,127007.66710667258,360,0,32.39473684210526,34,4,17,40.413546866333895,0.5778186274509804,49.58333333333332,1001.666666666665,29.46078431372544,0
1787,4,4,2,37,0.10256410256410256,0.05128205128205128,0.9487179487179487,39,750,400,350,0.5333333333333333,11,4,7,358.57345228896367,0.4771986054880792,0.17595935759930725,0.18321687712419568,125898.59992551844,1228.779122728024,127127.37904824647,361,0,32.46153846153846,35,4,20,40.1065092453773,0.580654761904762,49.103009259259245,1003.5879629629609,28.67394179894174,0
1788,4,1,0,38,0.02631578947368421,0.0,1.0,38,950,700,250,0.7368421052631579,12,7,5,368.35015192569733,0.47660324798482695,0.2036503452017886,0.18942760098116745,126163.40880102031,1694.4621598639328,127857.87096088425,362,0,34.05263157894737,34,4,21,39.587776987794754,0.5854779411764706,48.83928571428571,1004.6428571428564,29.548319327731072,0
1789,4,2,1,39,0.05,0.025,0.975,40,1250,900,350,0.72,16,9,7,352.52131320104075,0.47692307692307695,0.20020688883918636,0.183911644261593,126751.58900454489,936.5273212401406,127688.11632578503,363,0,33.3,36,4,22,39.37993923805264,0.5873842592592593,48.254504504504496,1006.9819819819804,27.97172172172168,0
1790,4,1,2,38,0.025,0.05,0.95,40,1250,800,450,0.64,17,8,9,354.9927884672978,0.4761351495726496,0.19194034852546937,0.18649621140605913,127035.24470416353,1019.3191502313028,128054.56385439483,364,0,33.675,36,4,23,39.02619526362824,0.5902777777777778,47.97297297297297,1008.1081081081073,28.00300300300298,0
1791,4,2,3,37,0.05,0.075,0.925,40,1250,800,450,0.64,17,8,9,341.55609165458077,0.4752804487179487,0.18126288069613072,0.18256737481708118,127734.70320001703,725.7258803316488,128460.42908034868,365,0,33.3,35,5,17,38.648290206854455,0.5994047619047619,47.28009259259259,1010.8796296296287,28.882275132275105,0
1792,4,0,0,37,0.0,0.0,1.0,37,1150,500,650,0.43478260869565216,18,5,13,357.6774436798941,0.4741616616616617,0.17183154027814185,0.1899009108197377,127462.99500192235,1718.1276432141435,129181.1226451365,366,1,35.4054054054054,33,4,17,38.51941747572815,0.601010101010101,47.549019607843135,1009.8039215686276,30.600118835412957,0
1793,4,1,3,35,0.02631578947368421,0.07894736842105263,0.9210526315789473,38,1100,600,500,0.5454545454545454,16,6,10,349.8405217763038,0.47443990042674256,0.17420464050060414,0.1875012764977729,127843.36911848077,1344.958191609984,129188.32731009075,367,0,35.44736842105263,34,4,18,38.32769276044733,0.6026348039215687,47.17261904761905,1011.3095238095241,29.74439775910365,0
1794,4,1,0,36,0.027777777777777776,0.0,1.0,36,850,400,450,0.47058823529411764,13,4,9,368.49008551372054,0.4741732804232804,0.18497798335903104,0.19585064412121256,127506.12381708497,2196.9484937761376,129703.07231086111,368,0,38.0,32,4,19,38.20217110472141,0.6038411458333333,47.50631313131313,1009.9747474747473,31.561710858585855,0
1795,4,0,0,36,0.0,0.0,1.0,36,1300,900,400,0.6923076923076923,17,9,8,368.1997947107835,0.4726025132275132,0.18238705738705718,0.19709518422753727,127793.20987654333,2210.6867283950755,130003.8966049384,369,1,39.0,32,4,19,37.914949633699635,0.6067708333333333,47.22222222222223,1011.1111111111121,31.597222222222253,0
1796,4,3,3,36,0.07692307692307693,0.07692307692307693,0.9230769230769231,39,1100,700,400,0.6363636363636364,15,7,8,341.3629465332623,0.47270017993702207,0.17212377264014367,0.1865781698146201,128627.12762188203,982.189310909539,129609.31693279157,370,0,36.92307692307692,34,5,19,37.741804561279956,0.6106004901960784,46.39880952380952,1014.4047619047615,29.835434173669455,0
1797,4,1,1,36,0.02702702702702703,0.02702702702702703,0.972972972972973,37,800,700,100,0.875,9,7,2,359.6453812674221,0.4726288788788789,0.1889197944518155,0.19529863532153793,128368.35048719526,1833.4168707274869,130201.76735792274,371,0,39.13513513513514,32,5,20,37.54256998089542,0.6126302083333333,46.65404040404041,1013.383838383839,31.66824494949497,0
1798,4,1,3,34,0.02702702702702703,0.08108108108108109,0.9189189189189189,37,1350,1100,250,0.8148148148148148,16,11,5,360.33312768454033,0.47306681681681684,0.1864590545112541,0.19670956231644163,128579.18228565934,1866.2677816224527,130445.45006728178,372,0,39.7027027027027,33,4,21,37.30969067182213,0.6123737373737373,46.44607843137255,1014.2156862745096,30.73380867498514,0
1799,4,1,0,35,0.02857142857142857,0.0,1.0,35,1300,900,400,0.6923076923076923,17,9,8,372.70861801408273,0.4707633053221289,0.1785540002568382,0.2030988109500115,128507.33651055238,2579.158359103739,131086.49486965613,373,0,41.51428571428571,31,4,22,37.069394503659936,0.6165994623655914,46.516927083333336,1013.9322916666674,32.70749327956992,0
1800,4,0,2,33,0.0,0.05714285714285714,0.9428571428571428,35,1100,700,400,0.6363636363636364,15,7,8,385.88878685848385,0.4710434173669468,0.16604136604136643,0.1906336821306882,124496.47583896987,2666.3803513414855,127162.85619031136,374,1,42.51428571428571,30,5,19,40.87626262626263,0.578125,50.50403225806452,997.9838709677423,33.26612903225808,15
1801,4,5,4,34,0.13157894736842105,0.10526315789473684,0.8947368421052632,38,850,500,350,0.5882352941176471,12,5,7,350.0259075689409,0.47512150308202944,0.15105959606009378,0.177020750577409,125473.93322428841,1184.8416646839305,126658.77488897234,375,0,39.63157894736842,32,6,16,40.75929426591051,0.5830078125,49.526515151515156,1001.89393939394,31.309185606060623,0
1802,4,2,2,34,0.05555555555555555,0.05555555555555555,0.9444444444444444,36,750,500,250,0.6666666666666666,10,5,5,372.11562645296715,0.47321428571428575,0.1771019811433352,0.18726467471768224,125268.96172967965,2122.907633830492,127391.86936351014,376,0,42.77777777777778,30,6,18,40.41828902613678,0.5861111111111111,49.73118279569892,1001.0752688172036,33.36917562724012,0
1803,4,4,0,38,0.10526315789473684,0.0,1.0,38,1400,900,500,0.6428571428571429,19,9,10,343.9892920880427,0.47344713134186817,0.14964056482670074,0.1771804142664543,126228.49384851994,1084.250048058453,127312.7438965784,377,0,40.3421052631579,33,5,23,40.132621951219505,0.5883838383838385,48.774509803921575,1004.9019607843148,30.451574569221663,0
1804,4,0,5,33,0.0,0.13157894736842105,0.868421052631579,38,1150,700,450,0.6086956521739131,16,7,9,344.61528593685813,0.4731063300142247,0.14262753678051054,0.1779030327589708,126320.8730566368,1106.4207576412878,127427.29381427809,378,1,41.3421052631579,33,5,14,40.021816205453284,0.5893308080808081,48.682598039215684,1005.2696078431368,30.462715389185963,0
1805,4,2,2,33,0.05714285714285714,0.05714285714285714,0.9428571428571428,35,850,600,250,0.7058823529411765,11,6,5,371.0853233085933,0.4724089635854342,0.15342638417764953,0.18952648023454788,125880.45120239259,2342.4775865342885,128222.92878892687,379,0,44.4,31,4,22,39.811345746291245,0.5897177419354839,49.12109375,1003.5156250000001,32.37147177419355,0
1806,4,5,1,37,0.13157894736842105,0.02631578947368421,0.9736842105263158,38,750,500,250,0.6666666666666666,10,5,5,361.78985696638233,0.4780109056424846,0.19139413611116374,0.1767131192783254,124019.78635204055,1492.0333827703903,125511.81973481094,380,0,39.39473684210526,34,4,17,41.972929365363925,0.5634191176470589,50.98214285714284,996.0714285714264,29.296218487394896,16
1807,4,6,5,38,0.13953488372093023,0.11627906976744186,0.8837209302325582,43,1150,700,450,0.6086956521739131,16,7,9,329.0310555052945,0.4819582871908454,0.21354688352258688,0.16664747843626648,125534.7587478995,-335.17474694789763,125199.5840009516,381,0,35.55813953488372,38,5,17,41.2224591329069,0.5712719298245614,49.46581196581195,1002.1367521367499,26.372019793072365,0
1808,4,3,1,40,0.07317073170731707,0.024390243902439025,0.975609756097561,41,1400,1200,200,0.8571428571428571,16,12,4,336.7988294663922,0.48264735772357725,0.23284552845528506,0.17177866720275833,125823.7210006923,275.4563904277992,126099.1773911201,382,0,37.51219512195122,37,4,20,40.729963570127474,0.5760135135135135,49.177631578947356,1003.2894736842086,27.115931721194826,0
1809,4,2,4,38,0.047619047619047616,0.09523809523809523,0.9047619047619048,42,1350,1100,250,0.8148148148148148,16,11,5,328.35567629664627,0.4825662988772745,0.22972776505651904,0.1698448904295849,126401.93527094864,-98.65667801632435,126303.27859293231,383,0,36.666666666666664,37,5,18,40.34717678915419,0.5819256756756757,48.60197368421052,1005.592105263157,27.17816500711235,0
1810,4,0,0,38,0.0,0.0,1.0,38,1450,1000,450,0.6896551724137931,19,10,9,338.76908367884494,0.48008534850640117,0.20982981042941096,0.1754412000696759,126450.94548396773,967.5341863854587,127418.47967035319,384,1,39.18421052631579,35,3,18,40.035001917913334,0.5863095238095238,48.55324074074074,1005.7870370370367,28.736772486772477,0
1811,4,1,1,38,0.02564102564102564,0.02564102564102564,0.9743589743589743,39,1200,800,400,0.6666666666666666,16,8,8,328.0518023436437,0.48034750337381915,0.20306843840097377,0.17153169653563208,126843.3691736881,522.2391745537157,127365.60834824182,385,0,39.15384615384615,37,2,19,39.90183139218461,0.5864301801801801,48.16337719298246,1007.3464912280706,27.225580844001907,0
1812,4,1,2,37,0.02564102564102564,0.05128205128205128,0.9487179487179487,39,1350,800,550,0.5925925925925926,19,8,11,329.21248548596395,0.479251012145749,0.20915448188175434,0.1731943945382682,127092.0138888891,568.0555555555796,127660.06944444467,386,0,40.05128205128205,37,2,21,39.61776859504132,0.5889639639639639,47.91666666666668,1008.3333333333351,27.252252252252298,0
1813,4,2,2,37,0.05128205128205128,0.05128205128205128,0.9487179487179487,39,1250,700,550,0.56,18,7,11,335.319106970099,0.4801788124156545,0.2215263359586357,0.17789769899963992,127432.8953108517,746.1369308498058,128179.03224170151,387,0,40.743589743589745,36,3,21,39.114664659082464,0.5943287037037037,47.57882882882885,1009.6846846846872,28.04679679679687,0
1814,4,0,1,36,0.0,0.02702702702702703,0.972972972972973,37,900,500,400,0.5555555555555556,13,5,8,346.2623245422345,0.47944819819819817,0.21038941996602079,0.18338277637686495,127362.24666950117,1420.1495181405928,128782.39618764176,388,1,42.62162162162162,34,3,21,38.910838542280935,0.5977328431372548,47.648809523809526,1009.4047619047622,29.688375350140063,0
1815,4,2,1,37,0.05263157894736842,0.02631578947368421,0.9736842105263158,38,1200,900,300,0.75,15,9,6,396.78929219788716,0.48023352299668093,0.16943976660895177,0.19785964930047442,124887.41275058835,2508.1332228532906,127395.54597344164,389,0,40.68421052631579,36,2,17,40.19734865555054,0.568287037037037,50.11261261261261,999.5495495495489,27.76526526526525,16
1816,4,3,4,36,0.075,0.1,0.9,40,1000,600,400,0.6,14,6,8,379.2103825851481,0.48080929487179486,0.18200127877237882,0.19256007739064007,125641.84746877039,1528.9893358695158,127170.8368046399,390,0,39.35,38,2,17,39.85440643648763,0.5723684210526316,49.35897435897435,1002.5641025641013,26.383265856950032,0
1817,4,1,2,35,0.02702702702702703,0.05405405405405406,0.9459459459459459,37,1100,800,300,0.7272727272727273,14,8,6,383.93281012486227,0.4801363863863864,0.17383469523278028,0.19589838322380396,125840.52861636227,2262.8615558556176,128103.39017221789,391,0,41.054054054054056,35,2,18,39.53034279232515,0.5800595238095239,49.160879629629626,1003.3564814814811,28.66732804232803,0
1818,4,1,1,35,0.027777777777777776,0.027777777777777776,0.9722222222222222,36,1050,500,550,0.47619047619047616,16,5,11,373.1076063035427,0.4795965608465609,0.23532960751937004,0.18010277035118272,123520.81619541367,2044.5685581881453,125565.38475360181,392,0,42.75,32,4,16,42.21124941784156,0.5628255208333333,51.483585858585855,994.0656565656561,31.064551767676754,16
1819,4,2,0,37,0.05405405405405406,0.0,1.0,37,1150,700,450,0.6086956521739131,16,7,9,365.19152409553675,0.4812625125125125,0.24594627842259809,0.17851123868746954,124052.04916678683,1660.5513804786688,125712.60054726551,393,0,42.486486486486484,33,4,18,41.85465104358881,0.5659722222222222,50.94975490196079,996.200980392157,30.18790849673203,0
1820,4,6,2,41,0.13953488372093023,0.046511627906976744,0.9534883720930233,43,1300,1200,100,0.9230769230769231,14,12,2,322.79305110473916,0.48401162790697677,0.2565267290848683,0.1639516156666553,125651.88937717034,-488.08865017359057,125163.80072699675,394,0,37.41860465116279,39,4,16,41.258116883116884,0.5707799145299146,49.34895833333334,1002.6041666666683,25.707799145299187,0
1821,4,1,0,42,0.023809523809523808,0.0,1.0,42,1050,700,350,0.6666666666666666,14,7,7,329.46581000909185,0.48237272551296945,0.26577152600170484,0.16730017105656497,125641.84746877068,-121.06139053253102,125520.78607823815,395,0,39.285714285714285,38,4,18,41.10120950554135,0.5723684210526316,49.358974358974365,1002.5641025641037,26.383265856950096,0
1822,4,2,5,39,0.045454545454545456,0.11363636363636363,0.8863636363636364,44,1600,1200,400,0.75,20,12,8,340.81827422195664,0.4820846546863989,0.18264117498100796,0.16760789102148277,124306.52006172837,-124.56660000730767,124181.95346172106,396,0,38.45454545454545,38,6,15,42.19765552460538,0.5586622807017544,50.69444444444444,997.2222222222221,26.24269005847953,16
1823,4,2,2,39,0.04878048780487805,0.04878048780487805,0.9512195121951219,41,1100,700,400,0.6363636363636364,15,7,8,356.8823070105042,0.47997967479674797,0.08734461897871326,0.17344657233517938,123808.74608574579,649.0865133922221,124457.83259913801,397,0,41.46341463414634,40,1,17,42.3146635351782,0.5502604166666667,51.194105691056905,995.2235772357714,24.880589430894283,15
1824,4,4,7,36,0.09302325581395349,0.16279069767441862,0.8372093023255813,43,1000,500,500,0.5,15,5,10,326.1108534492875,0.48128922111480255,0.05164857776022358,0.16236192516287842,124822.21772960888,-225.75806398306165,124596.45966562582,398,0,36.651162790697676,40,3,12,42.030873927929775,0.5606770833333333,50.17784552845529,999.2886178861803,24.98221544715451,15
1825,4,7,2,41,0.16279069767441862,0.046511627906976744,0.9534883720930233,43,1450,1000,450,0.6896551724137931,19,10,9,328.36849949535934,0.482327427094869,0.15013559917033614,0.16925821779467637,126258.49364681492,-301.9357062980714,125956.55794051685,399,0,35.883720930232556,38,5,16,40.49422415931399,0.5786732456140351,48.74465811965812,1005.0213675213672,26.447930724246504,0
1826,4,0,2,39,0.0,0.04878048780487805,0.9512195121951219,41,1900,1400,500,0.7368421052631579,24,14,10,339.67354359715125,0.48107215447154467,0.14701253465204123,0.17428963505917702,126071.36480695994,364.6214460218592,126435.9862529818,400,1,38.609756097560975,37,4,16,40.40276867925901,0.5785472972972974,48.93092105263158,1004.2763157894746,27.14260312944526,0
1827,4,3,5,37,0.07142857142857142,0.11904761904761904,0.8809523809523809,42,1300,1000,300,0.7692307692307693,16,10,6,330.58810611331035,0.4815379403794038,0.15767936710011843,0.17254282880531896,126769.03558514123,-18.332922419470947,126750.70266272176,401,0,38.023809523809526,38,4,15,39.914200084871645,0.5838815789473684,48.23717948717948,1007.0512820512811,26.50134952766529,0
1828,4,3,1,39,0.075,0.025,0.975,40,1200,700,500,0.5833333333333334,17,7,10,328.63899038654034,0.48536324786324786,0.11259933082392237,0.16069035296814332,124064.25781250047,154.4704861111552,124218.72829861162,402,0,40.075,39,1,17,42.752335145685194,0.5544871794871795,50.93750000000002,996.2500000000039,25.544871794871895,16
1829,4,4,1,42,0.09302325581395349,0.023255813953488372,0.9767441860465116,43,1500,1100,400,0.7333333333333333,19,11,8,310.6166566614319,0.48583425618309334,0.1423928154502696,0.1555026661763855,125052.08875868077,-820.8007812499751,124231.2879774308,403,0,37.81395348837209,39,4,19,42.18088245504408,0.5646367521367521,49.94791666666668,1000.2083333333351,25.646367521367566,0
1830,4,3,6,39,0.06666666666666667,0.13333333333333333,0.8666666666666667,45,1000,600,400,0.6,14,6,8,301.96774960407544,0.4840277777777778,0.15073229394837417,0.15347555367892823,125679.21474070096,-1409.7860705486187,124269.42867015234,404,0,36.977777777777774,42,3,19,41.752029377657514,0.566468253968254,49.3217054263566,1002.713178294576,23.874123292728,0
1831,4,5,4,40,0.11363636363636363,0.09090909090909091,0.9090909090909091,44,1400,1200,200,0.8571428571428571,16,12,4,301.88696872750535,0.4826902748414376,0.16048795507394265,0.155762337385694,126299.08954863173,-1173.8619835120157,125125.22756511971,405,0,35.47727272727273,40,4,14,41.117977622754694,0.57578125,48.704268292682926,1005.1829268292679,25.129573170731696,0
1832,4,4,3,41,0.09090909090909091,0.06818181818181818,0.9318181818181819,44,1400,800,600,0.5714285714285714,20,8,12,364.9014785372566,0.4834280303030303,0.1861591731053751,0.1785756793195603,124100.72234396574,432.18647260176994,124532.9088165675,406,0,36.11363636363637,36,8,18,41.8112379445449,0.5601851851851851,50.90090090090091,996.3963963963977,27.677677677677714,15
1833,4,9,10,40,0.18,0.2,0.8,50,1800,1300,500,0.7222222222222222,23,13,10,318.5504509028158,0.48467687074829935,0.1935337156416841,0.16255394855858166,125844.67612276424,-1979.1778457419243,123865.49827702231,407,0,32.06,41,9,17,41.16612286599434,0.5696138211382114,49.156746031746046,1003.3730158730185,24.472512582268745,0
1834,4,3,2,41,0.06976744186046512,0.046511627906976744,0.9534883720930233,43,1100,700,400,0.6363636363636364,15,7,8,355.2123542850176,0.48546511627906974,0.21215255298172475,0.1797237493305315,125492.38207572428,315.28889639058144,125807.67097211487,408,0,36.23255813953488,35,8,20,40.610320164799184,0.5764880952380953,49.50810185185184,1001.9675925925912,28.627645502645464,0
1835,4,1,2,40,0.023809523809523808,0.047619047619047616,0.9523809523809523,42,1100,700,400,0.6363636363636364,15,7,8,359.7134600821196,0.4856634727061557,0.21369238332570495,0.1833820525173635,125804.8628826529,650.7405045351284,126455.60338718804,409,0,37.26190476190476,34,8,21,40.174686523476126,0.5818014705882353,49.19642857142856,1003.2142857142844,29.506302521008365,0
1836,4,2,2,40,0.047619047619047616,0.047619047619047616,0.9523809523809523,42,1200,700,500,0.5833333333333334,17,7,10,359.0616029625964,0.4859780294231513,0.21685315908565128,0.1846508755271998,126163.40880102031,660.087159863933,126823.49596088425,410,0,37.76190476190476,34,8,23,39.82106884701979,0.5854779411764706,48.83928571428571,1004.6428571428564,29.548319327731072,0
1837,4,0,1,39,0.0,0.025,0.975,40,1550,1100,450,0.7096774193548387,20,11,9,363.06706460478574,0.48603098290598296,0.18588970140158478,0.18771047669075416,126382.4779682094,1177.0630586793611,127559.54102688875,411,1,38.2,33,7,19,39.494591712370514,0.5899621212121212,48.62132352941177,1005.5147058823534,30.470142602495557,0
1838,4,5,2,42,0.11363636363636363,0.045454545454545456,0.9545454545454546,44,950,800,150,0.8421052631578947,11,8,3,330.3169587685599,0.48420983086680763,0.20131655695358797,0.17579307415438974,127559.26354595342,-369.0300701949749,127190.23347575845,412,0,35.52272727272727,35,9,17,39.1116712496181,0.5976190476190476,47.45370370370371,1010.1851851851857,28.862433862433875,0
1839,4,0,4,38,0.0,0.09523809523809523,0.9047619047619048,42,1400,900,500,0.6428571428571429,19,9,10,346.9438888034307,0.4839092140921409,0.20695106678123576,0.18374373723699494,127362.24666950114,437.5106292517038,127799.75729875284,413,1,38.095238095238095,34,8,19,38.89363918701106,0.5977328431372548,47.648809523809526,1009.4047619047619,29.688375350140056,0
1840,4,0,0,38,0.0,0.0,1.0,38,1050,600,450,0.5714285714285714,15,6,9,367.0793824238834,0.4819967994310099,0.19041798185208858,0.19326717385758446,127123.84458537394,1732.908472349761,128856.7530577237,414,2,41.10526315789474,32,6,24,38.63048286799383,0.5999348958333333,47.88510101010101,1008.459595959596,31.514362373737374,0
1841,4,0,0,38,0.0,0.0,1.0,38,850,500,350,0.5882352941176471,12,5,7,365.6017448324907,0.4816263632053106,0.18891436251161164,0.19279157356216278,127187.5179350321,1699.9956955922835,128887.51363062438,415,3,42.10526315789474,32,6,24,38.60229690824885,0.6005859375,47.821969696969695,1008.7121212121208,31.522253787878775,0
1842,4,3,3,38,0.07317073170731707,0.07317073170731707,0.926829268292683,41,1650,1400,250,0.8484848484848485,19,14,5,344.660013656981,0.48104674796747965,0.20136193374519973,0.1862606731751233,128175.553347871,642.5716063294938,128818.1249542005,416,0,39.951219512195124,33,8,23,38.119100205736416,0.608270202020202,46.84436274509804,1012.6225490196077,30.68553178847296,0
1843,4,1,1,38,0.02564102564102564,0.02564102564102564,0.9743589743589743,39,900,600,300,0.6666666666666666,12,6,6,353.644531136538,0.47812640575798465,0.1796213253612362,0.19234812303279963,128432.3347107436,1283.878558310351,129716.21326905394,417,0,40.43589743589744,32,7,16,37.62923517688091,0.61328125,46.59090909090908,1013.6363636363619,31.67613636363631,0
1844,4,1,3,36,0.02564102564102564,0.07692307692307693,0.9230769230769231,39,1050,600,450,0.5714285714285714,15,6,9,357.21641754465213,0.478210751237067,0.1865190703731725,0.1950727044280208,128592.36501696234,1387.0607909906885,129979.42580795303,418,0,41.41025641025641,32,7,18,37.37525415992366,0.6149088541666667,46.433080808080796,1014.2676767676751,31.695864898989846,0
1845,4,0,1,35,0.0,0.027777777777777776,0.9722222222222222,36,950,500,450,0.5263157894736842,14,5,9,389.1033388743409,0.4759424603174603,0.20452398872507804,0.2094037911640392,128008.47867166702,2761.7052910740804,130770.1839627411,419,1,45.47222222222222,30,6,22,37.16546022048078,0.6142361111111111,47.00940860215052,1011.9623655913961,33.73207885304654,0
1846,4,1,0,36,0.027777777777777776,0.0,1.0,36,1050,800,250,0.7619047619047619,13,8,5,390.38716901035053,0.47458664021164026,0.204927774730298,0.21117976531331437,128214.85339506177,2810.7589910843913,131025.61238614617,420,0,46.083333333333336,29,7,23,36.92116931797403,0.6192528735632183,46.80555555555556,1012.777777777778,34.92337164750959,0
1847,4,0,0,36,0.0,0.0,1.0,36,1550,900,650,0.5806451612903226,22,9,13,393.85325321155216,0.47418981481481487,0.2029844270904686,0.21437247540575113,128461.13281250013,2918.9670138889023,131380.09982638902,421,1,47.083333333333336,29,7,20,36.58078161391971,0.6217672413793103,46.56250000000001,1013.750000000001,34.95689655172417,0
1848,4,0,1,35,0.0,0.027777777777777776,0.9722222222222222,36,1300,1100,200,0.8461538461538461,15,11,4,391.604686950163,0.47390873015873014,0.19462111508620095,0.2140072825787749,128621.2843428432,2873.7395580414095,131495.0239008846,422,2,48.083333333333336,30,6,21,36.47365399054814,0.6204861111111111,46.40456989247313,1014.3817204301082,33.81272401433694,0
1849,4,1,2,34,0.027777777777777776,0.05555555555555555,0.9444444444444444,36,1150,800,350,0.6956521739130435,15,8,7,386.09650028682955,0.4726025132275132,0.1721442856302573,0.21263448660111417,128928.2359232282,2755.7481356226294,131683.98405885082,423,0,46.94444444444444,30,6,22,36.29924342685724,0.6236111111111111,46.102150537634415,1015.5913978494631,33.853046594982104,0
1850,4,2,3,33,0.05555555555555555,0.08333333333333333,0.9166666666666666,36,1300,900,400,0.6923076923076923,17,9,8,376.12425902561074,0.4713128306878307,0.16234942852531686,0.2102132113358636,129509.0314812407,2542.586751358555,132051.61823259926,424,0,46.666666666666664,30,6,17,35.95971433601832,0.6295138888888889,45.53091397849463,1017.8763440860223,33.929211469534074,0
1851,4,0,0,33,0.0,0.0,1.0,33,800,500,300,0.625,11,5,6,405.3795095309267,0.4708017676767677,0.1654583161936105,0.22397217901583713,129055.35737878196,3863.2794953098264,132918.63687409178,425,1,50.39393939393939,28,5,23,35.679440045248874,0.6309523809523809,45.97701149425288,1016.0919540229892,36.2889983579639,0
1852,4,0,0,33,0.0,0.0,1.0,33,1050,800,250,0.7619047619047619,13,8,5,406.55670566494763,0.4702099116161616,0.16735838954920212,0.22524578641969503,129164.87327008195,3902.569072862997,133067.44234294494,426,2,51.39393939393939,28,5,23,35.53739693757362,0.6320684523809523,45.86925287356322,1016.5229885057474,36.304392446633834,0
1853,4,0,0,33,0.0,0.0,1.0,33,750,400,350,0.5333333333333333,11,4,7,404.72721177804976,0.4696180555555556,0.1595587126754816,0.22487038742204798,129277.0448022958,3864.3927388013094,133141.4375410971,427,3,52.39393939393939,27,6,23,35.469100575553604,0.6365740740740741,45.75892857142856,1016.9642857142848,37.66534391534388,0
1854,4,0,0,33,0.0,0.0,1.0,33,1150,1000,150,0.8695652173913043,13,10,3,406.3742677785735,0.46938131313131315,0.15759171353730417,0.22643690862282856,129390.57019292083,3916.1996439200584,133306.7698368409,428,4,53.39393939393939,27,6,23,35.31108307737312,0.6377314814814814,45.64732142857142,1017.4107142857135,37.68187830687828,0
1855,4,1,0,34,0.029411764705882353,0.0,1.0,34,1050,500,550,0.47619047619047616,16,5,11,394.0110083578295,0.4695484254307784,0.15938730671972823,0.2223952350277487,129896.16620838287,3436.1038859162336,133332.2700942991,429,0,52.794117647058826,28,6,19,35.10952548743246,0.6395089285714286,45.150862068965516,1019.3965517241379,36.407019704433495,0
1856,4,0,1,33,0.0,0.029411764705882353,0.9705882352941176,34,650,400,250,0.6153846153846154,9,4,5,395.7076688221146,0.468972816399287,0.1618703843380387,0.22377189845661724,129969.40904098951,3485.9783739595605,133455.38741494907,430,1,53.794117647058826,28,6,19,34.99160443379831,0.6402529761904762,45.07902298850574,1019.6839080459766,36.417282430213454,0
1857,4,0,1,32,0.0,0.030303030303030304,0.9696969696969697,33,900,500,400,0.5555555555555556,13,5,8,406.86550135383,0.46942077020202017,0.1639408099688473,0.22912951918347263,129807.25623582762,3962.8188775510125,133770.07511337864,431,2,55.484848484848484,27,6,19,34.87271222741433,0.6419753086419753,45.238095238095234,1019.0476190476187,37.74250440917106,0
1858,4,1,0,33,0.030303030303030304,0.0,1.0,33,800,700,100,0.875,9,7,2,404.1041649929418,0.4696575126262626,0.1655368805522024,0.2286809118659477,129996.88042534707,3906.4561631944202,133903.33658854148,432,0,56.21212121212121,27,6,21,34.74953183520599,0.6439043209876543,45.05208333333332,1019.7916666666654,37.770061728395014,0
1859,4,0,1,32,0.0,0.030303030303030304,0.9696969696969697,33,1100,700,400,0.6363636363636364,15,7,8,402.2335837589152,0.468789457070707,0.1645887202068559,0.228533032948465,130152.60643744204,3870.349864579178,134022.95630202122,433,1,57.21212121212121,28,5,21,34.638423448793766,0.6421130952380952,44.89942528735631,1020.4022988505734,36.442939244663336,0
1860,4,1,1,32,0.030303030303030304,0.030303030303030304,0.9696969696969697,33,850,400,450,0.47058823529411764,13,4,9,392.69233450438344,0.46567234848484845,0.14932236514363817,0.22629889430507674,130702.97275482229,3665.2575472321296,134368.2303020544,434,0,56.03030303030303,28,5,21,34.321870170015465,0.6476934523809523,44.360632183908045,1022.5574712643677,36.51990968801313,0
1861,4,1,0,33,0.030303030303030304,0.0,1.0,33,900,500,400,0.5555555555555556,13,5,8,390.3744905356724,0.4661458333333333,0.15086841455838962,0.2260363513491917,130886.68623662303,3618.9646915048193,134505.65092812784,435,0,56.57575757575758,28,5,22,34.19451464944303,0.6495535714285714,44.18103448275862,1023.2758620689652,36.545566502463046,0
1862,4,1,1,33,0.029411764705882353,0.029411764705882353,0.9705882352941176,34,1450,1000,450,0.6896551724137931,19,10,9,379.7248272600967,0.4654077540106952,0.14025279533300927,0.2226170730744063,131363.71768904332,3176.4130015432247,134540.13069058655,436,0,55.88235294117647,29,5,24,33.983510590254255,0.6512212643678161,43.715277777777786,1025.1388888888898,35.34961685823758,0
1863,4,0,1,32,0.0,0.030303030303030304,0.9696969696969697,33,950,600,350,0.631578947368421,13,6,7,390.8246198832434,0.463738952020202,0.13694998215469334,0.22847222860715505,131254.50026423577,3659.4980347470037,134913.99829898277,437,1,57.63636363636363,28,5,24,33.80976584408302,0.6532738095238095,43.821839080459775,1024.7126436781614,36.59688013136291,0
1864,4,0,2,30,0.0,0.0625,0.9375,32,800,500,300,0.625,11,5,6,415.3626572213283,0.4625336021505377,0.18640061956986154,0.21910302151397043,127200.69372192491,4166.883628947011,131367.57735087193,438,2,57.75,28,4,19,37.333831837819865,0.6119791666666667,47.808908045977006,1008.7643678160915,36.027298850574695,16
1865,4,1,1,30,0.03225806451612903,0.03225806451612903,0.967741935483871,31,1350,1000,350,0.7407407407407407,17,10,7,420.9961285154859,0.46424731182795703,0.17369141813755284,0.2231279481132074,127392.29024943306,4526.332199546475,131918.62244897953,439,0,58.58064516129032,27,4,18,36.993907232704395,0.617283950617284,47.61904761904761,1009.5238095238092,37.38977072310404,0
1866,4,0,1,29,0.0,0.03333333333333333,0.9666666666666667,30,900,600,300,0.6666666666666666,12,6,6,489.0510524348953,0.4613745210727969,0.23852098729652726,0.232594163532268,122889.72959192081,6116.330777257367,129006.06036917817,440,1,59.43333333333333,28,2,16,39.99661884751002,0.5673363095238095,52.119252873563205,991.5229885057456,35.41153530377663,16
1867,4,8,3,34,0.21621621621621623,0.08108108108108109,0.9189189189189189,37,700,400,300,0.5714285714285714,10,4,6,414.4447966373486,0.47500625625625625,0.19112063605455698,0.20906437519261784,125367.91738754314,2996.2661342922943,128364.18352183544,441,0,47.54054054054054,33,4,16,39.25599608418992,0.5795454545454546,49.632352941176464,1001.4705882352932,30.347593582887672,0
1868,4,7,3,38,0.17073170731707318,0.07317073170731707,0.926829268292683,41,1350,1000,350,0.7407407407407407,17,10,7,371.2205786332957,0.4744664634146341,0.16710235780817762,0.18677642725999866,125260.55230034728,1153.8195570814164,126414.37185742869,442,0,43.73170731707317,35,6,16,40.44940166493235,0.5741071428571429,49.739583333333336,1001.0416666666672,28.601190476190492,16
1869,4,2,4,36,0.05,0.1,0.9,40,1000,700,300,0.7,13,7,6,369.23960322431014,0.47305021367521366,0.1137648895570722,0.18552090930160395,125202.62834630041,1278.7771133401739,126481.40545964058,443,0,45.725,35,5,20,40.55898481168806,0.5735119047619048,49.797453703703695,1000.8101851851837,28.59457671957668,16
1870,4,3,6,33,0.07692307692307693,0.15384615384615385,0.8461538461538461,39,950,400,550,0.42105263157894735,15,4,11,364.2733382477578,0.4718848403058929,0.15977946765811568,0.1858673083737381,125840.52861636227,1368.0698891889492,127208.59850555121,444,0,47.35897435897436,35,4,14,40.02347925558504,0.5800595238095239,49.160879629629626,1003.3564814814811,28.66732804232803,0
1871,4,5,2,36,0.13157894736842105,0.05263157894736842,0.9473684210526316,38,1600,1100,500,0.6875,21,11,10,353.18680424104946,0.4710763394973921,0.18634667962059948,0.18322785037698627,126522.46492346922,1337.2130102040596,127859.67793367327,445,0,48.73684210526316,34,4,14,39.59886403975861,0.5891544117647058,48.48214285714285,1006.0714285714271,29.590336134453736,0
1872,4,3,1,38,0.07692307692307693,0.02564102564102564,0.9743589743589743,39,1000,500,500,0.5,15,5,10,352.00209927108136,0.47050719748088166,0.21183404803501182,0.1859851091785021,127267.13204089495,1159.659529320976,128426.79157021594,446,0,48.41025641025641,35,4,17,38.86355815554025,0.5946428571428571,47.74305555555555,1009.0277777777769,28.829365079365054,0
1873,4,0,1,37,0.0,0.02631578947368421,0.9736842105263158,38,900,700,200,0.7777777777777778,11,7,4,359.4752719841,0.4693130630630631,0.21847820684856645,0.18939518061251806,127152.04081632633,1541.6028911564422,128693.64370748277,447,1,50.63157894736842,34,4,17,38.793230642115205,0.5955882352941176,47.85714285714285,1008.571428571427,29.66386554621844,0
1874,4,2,1,38,0.05128205128205128,0.02564102564102564,0.9743589743589743,39,1100,700,400,0.6363636363636364,15,7,8,349.4101025099419,0.47180049482681063,0.21243407684085658,0.18649443857682224,127676.20991941013,1122.2715192043872,128798.48143861452,448,0,50.07692307692308,35,4,18,38.509696136814775,0.5988095238095238,47.33796296296296,1010.648148148148,28.875661375661373,0
1875,4,1,2,37,0.02564102564102564,0.05128205128205128,0.9487179487179487,39,1000,700,300,0.7,13,7,6,342.6834249501969,0.47135065227170486,0.19269152290855152,0.18426155434934285,127973.55791179693,970.8834256553866,128944.44133745231,449,0,49.07692307692308,36,3,19,38.37553329623448,0.5998263888888888,47.04391891891892,1011.8243243243243,28.10623123123123,0
1876,4,5,4,38,0.11904761904761904,0.09523809523809523,0.9047619047619048,42,1100,800,300,0.7272727272727273,14,8,6,320.3246922362027,0.4721254355400697,0.19963670455877214,0.17668588227870202,128989.67013888907,-136.2847222221981,128853.38541666686,450,0,46.095238095238095,39,3,18,37.906754170084774,0.6047008547008548,46.04166666666668,1015.8333333333348,26.047008547008584,0
1877,4,0,1,37,0.0,0.02631578947368421,0.9736842105263158,38,1350,800,550,0.5925925925925926,19,8,11,347.7200225182962,0.47128378378378377,0.21232876712328763,0.18942956450623602,128496.33487654323,1336.1496913580283,129832.48456790127,451,1,51.78947368421053,35,3,19,37.71404109589042,0.6071428571428572,46.52777777777778,1013.888888888889,28.968253968253972,0
1878,4,0,1,36,0.0,0.02702702702702703,0.972972972972973,37,950,800,150,0.8421052631578947,11,8,3,352.8464726152557,0.47147147147147145,0.10712848367240602,0.17927911978099456,125666.39506440745,1468.1888449502594,127134.58390935771,452,2,53.75675675675676,35,2,18,40.489846665897105,0.5782738095238096,49.33449074074073,1002.6620370370359,28.64748677248674,15
1879,4,2,1,37,0.05263157894736842,0.02631578947368421,0.9736842105263158,38,1150,600,550,0.5217391304347826,17,6,11,343.3475728211024,0.4722913703176861,0.11844379354885648,0.1764306444354258,126131.01912133466,1061.921832133031,127192.94095346768,453,0,53.18421052631579,35,3,20,40.249092637400615,0.5830357142857143,48.871527777777764,1004.5138888888871,28.700396825396773,0
1880,4,0,2,35,0.0,0.05405405405405406,0.9459459459459459,37,1150,600,550,0.5217391304347826,17,6,11,348.7442340137717,0.47169044044044045,0.13239882866881136,0.180131196100691,126342.87308673453,1412.2696995464678,127755.142786281,454,1,55.4054054054054,34,3,19,39.89540161831459,0.5873161764705883,48.66071428571428,1005.3571428571415,29.569327731092397,0
1881,4,2,0,37,0.05405405405405406,0.0,1.0,37,1250,800,450,0.64,17,8,9,367.9934791751672,0.47159659659659664,0.15245077758427672,0.1876032092564512,125804.8628826532,2188.669217687085,127993.53210034028,455,0,55.810810810810814,34,3,16,39.96702068747279,0.5818014705882353,49.19642857142858,1003.2142857142868,29.506302521008436,16
1882,4,3,2,38,0.075,0.05,0.95,40,1400,1100,300,0.7857142857142857,17,11,6,344.3031387793425,0.4746394230769231,0.1652538581972709,0.17962419293844142,126751.58900454536,728.4207452764658,127480.00974982182,456,0,52.55,36,4,17,39.58682807723848,0.5873842592592593,48.25450450450452,1006.9819819819842,27.97172172172178,0
1883,4,2,0,40,0.05,0.0,1.0,40,1350,1100,250,0.8148148148148148,16,11,5,336.98399634387795,0.4734775641025641,0.15409377376942301,0.17813117279452687,127285.57254395605,578.6401825561954,127864.21272651224,457,0,50.075,37,3,20,39.22350954398927,0.5909346846846847,47.7247807017544,1009.1008771929843,27.272996680891467,0
1884,4,1,2,39,0.024390243902439025,0.04878048780487805,0.9512195121951219,41,1450,1200,250,0.8275862068965517,17,12,5,332.13252167633266,0.47339939024390243,0.15413644307654262,0.17755016497748363,127739.20323800134,285.2687376725912,128024.47197567394,458,0,49.829268292682926,38,3,16,38.88184316212218,0.59375,47.27564102564103,1010.8974358974361,26.60256410256411,0
1885,4,0,1,38,0.0,0.02564102564102564,0.9743589743589743,39,800,300,500,0.375,13,3,10,340.8167715499607,0.47292510121457493,0.1466164876395566,0.18170819317396325,127631.95363860494,899.8220771447293,128531.77571574967,459,1,52.17948717948718,36,3,16,38.772103347078286,0.5963541666666667,47.381756756756765,1010.472972972974,28.068693693693724,0
1886,4,1,2,37,0.02564102564102564,0.05128205128205128,0.9487179487179487,39,700,400,300,0.5714285714285714,10,4,6,339.04444918427964,0.47216599190283404,0.1456398835017989,0.18165985403787785,127831.16731596473,868.0895422449587,128699.25685820969,460,0,53.05128205128205,36,3,18,38.613121752041565,0.5983796296296297,47.18468468468469,1011.2612612612622,28.09059059059062,0
1887,4,0,2,35,0.0,0.05405405405405406,0.9459459459459459,37,1100,800,300,0.7272727272727273,14,8,6,350.04113479309814,0.4707832832832833,0.15471301690382955,0.18690875688008832,127692.92091836744,1539.554988662141,129232.47590702958,461,1,56.21621621621622,34,3,18,38.47663918335296,0.6011029411764706,47.32142857142858,1010.7142857142865,29.72689075630254,0
1888,4,1,1,35,0.027777777777777776,0.027777777777777776,0.9722222222222222,36,1050,700,350,0.6666666666666666,14,7,7,343.0382278620759,0.4702215608465608,0.1470624746821385,0.1849622099880299,128084.27047902494,1587.5602324263052,129671.83071145124,226,0,45.52777777777778,34,2,20,38.253410560978494,0.6050857843137255,46.93452380952381,1012.2619047619047,29.772408963585434,0
1889,4,0,1,34,0.0,0.02857142857142857,0.9714285714285714,35,1250,800,450,0.64,17,8,9,351.6524104614556,0.4688025210084034,0.14644067796610205,0.18959849284671168,128082.49831795461,2008.1038542868139,130090.60217224143,227,1,47.371428571428574,33,2,21,38.03722760290558,0.6073232323232323,46.93627450980392,1012.2549019607842,30.67439096850861,0
1890,4,2,0,36,0.05555555555555555,0.0,1.0,36,1150,900,250,0.782608695652174,14,9,5,340.76952836730254,0.4658399470899471,0.14523418241577613,0.1859715318488822,128566.75347222229,1562.3263888888937,130129.07986111118,228,0,46.583333333333336,34,2,17,37.818405916187345,0.6099877450980392,46.458333333333336,1014.1666666666672,29.828431372549034,0
1891,4,2,1,37,0.05263157894736842,0.02631578947368421,0.9736842105263158,38,850,600,250,0.7058823529411765,11,6,5,323.2762944730804,0.46685336652441917,0.1501777700064113,0.17953166907084359,129258.63997443397,757.2508319130033,130015.89080634697,229,0,45.078947368421055,36,2,20,37.55860095976373,0.6128472222222222,45.77702702702703,1016.8918918918926,28.246996996997016,0
1892,4,1,2,36,0.02631578947368421,0.05263157894736842,0.9473684210526316,38,1050,800,250,0.7619047619047619,13,8,5,325.7335128664796,0.46695708866761493,0.15221444135022066,0.18142272227100967,129373.18019032551,828.2360908205546,130201.41628114607,230,0,45.86842105263158,36,2,21,37.37985204043982,0.6140046296296297,45.664414414414416,1017.3423423423427,28.25950950950952,0
1893,4,0,1,35,0.0,0.027777777777777776,0.9722222222222222,36,1500,1200,300,0.8,18,12,6,342.09923738889955,0.46418650793650795,0.15864371047083692,0.18941914972934007,129140.88010204083,1635.7993197278984,130776.67942176873,231,1,48.77777777777778,34,2,22,37.19987116420709,0.6158088235294117,45.892857142857146,1016.4285714285716,29.89495798319328,0
1894,4,0,2,33,0.0,0.05714285714285714,0.9428571428571428,35,1350,800,550,0.5925925925925926,19,8,11,366.32165433650266,0.46516106442577027,0.02820602909142056,0.17945347548580948,124143.62865244123,2113.667231598509,126257.29588403973,232,2,49.371428571428574,33,2,22,41.731226430562415,0.5669191919191919,50.857843137254896,996.5686274509792,30.19904931669634,16
1895,4,2,1,34,0.05714285714285714,0.02857142857142857,0.9714285714285714,35,850,500,350,0.5882352941176471,12,5,7,363.7516933297568,0.465126050420168,0.06506767655515833,0.18028277355540517,124632.62326989628,2067.065551710893,126699.68882160718,233,0,50.142857142857146,33,2,22,41.28722794959909,0.571969696969697,50.367647058823536,998.5294117647067,30.25846702317293,0
1896,4,6,3,37,0.15,0.075,0.925,40,850,500,350,0.5882352941176471,12,5,7,322.52273220884064,0.46860309829059826,0.09719405392947666,0.16561256036143887,126101.95500042857,157.98339484515296,126259.93839527373,234,0,44.625,35,5,21,40.80193208880694,0.5827380952380952,48.900462962962955,1004.3981481481474,28.697089947089925,0
1897,4,5,2,40,0.11904761904761904,0.047619047619047616,0.9523809523809523,42,1050,800,250,0.7619047619047619,13,8,5,307.5212323687895,0.4709881920247774,0.11637821559449923,0.16079667397678254,126843.36917368798,-598.594158779633,126244.77501490836,235,0,43.333333333333336,37,5,22,40.418866332861654,0.5864301801801801,48.16337719298245,1007.3464912280697,27.225580844001882,0
1898,4,2,2,40,0.047619047619047616,0.047619047619047616,0.9523809523809523,42,1050,600,450,0.5714285714285714,15,6,9,312.7317211405996,0.47004452187379014,0.13619153970912756,0.1646391865264004,127120.40323685174,-448.84003639527657,126671.56320045645,236,0,44.26190476190476,36,6,25,40.0041876046901,0.5911458333333333,47.888513513513516,1008.4459459459462,28.012387387387392,0
1899,4,1,0,41,0.024390243902439025,0.0,1.0,41,1100,500,600,0.45454545454545453,17,5,12,312.7675784094262,0.47004573170731706,0.13298231108983694,0.16616704047249642,127489.7532667805,-225.06771974674712,127264.68554703376,237,0,44.31707317073171,36,5,18,39.62584559916742,0.5949074074074074,47.522522522522536,1009.9099099099117,28.0530530530531,0
1900,4,2,4,39,0.046511627906976744,0.09302325581395349,0.9069767441860466,43,1000,700,300,0.7,13,7,6,302.630019136649,0.47099944629014395,0.1441286247487794,0.16342021033379073,128144.53125000028,-843.9236111110822,127300.6076388892,238,0,43.2093023255814,38,5,22,39.21467764060357,0.5978618421052632,46.875000000000014,1012.5000000000022,26.64473684210532,0
1901,4,2,2,39,0.04878048780487805,0.04878048780487805,0.9512195121951219,41,1400,1000,400,0.7142857142857143,18,10,8,319.5651069450794,0.46920731707317076,0.1579845428083908,0.172565157750343,128144.53125000013,-9.895833333319842,128134.63541666682,239,0,45.829268292682926,36,5,24,38.78600823045267,0.6015625,46.87500000000001,1012.500000000001,28.12500000000003,0
1902,4,1,3,37,0.025,0.075,0.925,40,1000,600,400,0.6,14,6,8,323.5838323796691,0.4698317307692308,0.1595263281617303,0.1751304863795307,128234.94897959172,298.9512471655168,128533.90022675724,240,0,47.2,34,6,25,38.59210938724336,0.6066176470588236,46.78571428571428,1012.8571428571419,29.789915966386527,0
1903,4,2,4,35,0.05128205128205128,0.10256410256410256,0.8974358974358975,39,750,500,250,0.6666666666666666,10,5,5,366.9943797873078,0.47050719748088166,0.1465910147893219,0.18075516366676447,124370.31256011465,1395.1412861139336,125765.45384622859,241,0,44.35897435897436,37,2,16,41.478761313253436,0.5610923423423424,50.63048245614035,997.4780701754386,26.95886676149834,15
1904,4,5,2,38,0.125,0.05,0.95,40,1000,800,200,0.8,12,8,4,354.1355929491627,0.47590811965811963,0.2097340774786609,0.1791855508510214,125493.90798130183,889.9619354031931,126383.86991670502,242,0,43.575,37,3,15,40.63571532793465,0.5726351351351351,49.50657894736842,1001.9736842105254,27.080369843527716,0
1905,4,2,3,37,0.05,0.075,0.925,40,1000,400,600,0.4,16,4,12,387.07305544370695,0.47620192307692305,0.11914225941422574,0.18879685765519602,123960.50347222232,1651.5273930440235,125612.03086526634,243,0,42.8,37,3,18,41.405160390516045,0.5568693693693694,51.04166666666667,995.8333333333342,26.914414414414438,16
1906,4,9,3,43,0.1956521739130435,0.06521739130434782,0.9347826086956522,46,1200,600,600,0.5,18,6,12,350.4298780757021,0.47876409017713367,0.102291499661191,0.1727860428462664,124416.33333539881,-193.70156239673275,124222.63177300208,244,0,37.67391304347826,40,6,13,41.84407999728362,0.5565104166666667,50.58434959349593,997.6626016260154,24.941565040650385,16
1907,4,6,10,39,0.12244897959183673,0.20408163265306123,0.7959183673469388,49,1650,1300,350,0.7878787878787878,20,13,7,336.54276069983786,0.4813633786848073,0.12397803791567386,0.16930266562274776,125254.19413874007,-1365.2239696939719,123888.97016904611,245,0,36.244897959183675,40,9,12,41.32381556683587,0.5651041666666667,49.74593495934959,1001.0162601626009,25.025406504065025,0
1908,4,3,0,42,0.07142857142857142,0.0,1.0,42,1400,1100,300,0.7857142857142857,17,11,6,364.14148794556513,0.47793263646922185,0.11563006540392884,0.18233115504878666,125059.53089569171,707.872732426317,125767.40362811803,246,0,40.214285714285715,34,8,20,40.83477148298024,0.5741421568627452,49.9404761904762,1000.2380952380961,29.418767507002826,0
1909,4,2,4,40,0.045454545454545456,0.09090909090909091,0.9090909090909091,44,1800,1400,400,0.7777777777777778,22,14,8,345.4197888460736,0.48044397463002114,0.1207024190007453,0.17542911466609218,125648.36109335705,-119.71392845546649,125528.64716490157,247,0,39.34090909090909,36,8,16,40.69461604702533,0.576099537037037,49.352477477477485,1002.5900900900915,27.849724724724766,0
1910,4,2,4,38,0.047619047619047616,0.09523809523809523,0.9047619047619048,42,1350,900,450,0.6666666666666666,18,9,9,353.1357974305972,0.4785859465737514,0.13115814226925337,0.18020847394654196,125846.0212746531,488.14701525851206,126334.16828991161,248,0,41.76190476190476,36,6,19,40.2971848110737,0.578125,49.15540540540541,1003.378378378379,27.87162162162164,0
1911,4,2,0,40,0.05,0.0,1.0,40,1300,1100,200,0.8461538461538461,15,11,4,372.46201554100173,0.47562767094017094,0.15766435986159166,0.19017936835927485,125869.56259645069,1376.3261959876668,127245.88879243836,249,0,44.175,35,5,21,39.78806228373703,0.5803571428571428,49.13194444444445,1003.4722222222229,28.67063492063494,0
1912,4,3,1,42,0.06976744186046512,0.023255813953488372,0.9767441860465116,43,1200,800,400,0.6666666666666666,16,8,8,351.15161746409103,0.47732096714654854,0.17041086484996337,0.18319706904106778,126751.58900454517,302.0462255611586,127053.63523010633,250,0,42.02325581395349,36,7,18,39.4144207112503,0.5873842592592593,48.25450450450451,1006.9819819819826,27.97172172172174,0
1913,4,1,2,41,0.023255813953488372,0.046511627906976744,0.9534883720930233,43,1000,700,300,0.7,13,7,6,342.8229775079054,0.476375046142488,0.2287136286421032,0.17185194654090064,125106.86043538601,25.866263789640357,125132.72669917565,251,0,43.0,38,5,18,41.31892531681618,0.5668859649122807,49.89316239316239,1000.4273504273499,26.32703553756184,16
1914,4,2,4,39,0.046511627906976744,0.09302325581395349,0.9069767441860466,43,1150,1000,150,0.8695652173913043,13,10,3,350.18427030925517,0.47492155777039496,0.2433087091667263,0.17030532157114672,123837.04299138635,279.6439819147545,124116.6869733011,252,0,43.27906976744186,41,2,16,42.45188793647628,0.5490345528455285,51.1656746031746,995.3373015873015,24.276519550909793,16
1915,4,4,1,42,0.09302325581395349,0.023255813953488372,0.9767441860465116,43,1550,1000,550,0.6451612903225806,21,10,11,350.6112639052156,0.47296050203026946,0.2585521260007011,0.1742990924390044,124759.73095414208,148.61792648108928,124908.34888062318,253,0,40.16279069767442,38,5,18,41.483531173136576,0.5633223684210527,50.24038461538462,999.0384615384621,26.29048582995953,0
1916,4,2,3,41,0.045454545454545456,0.06818181818181818,0.9318181818181819,44,1250,800,450,0.64,17,8,9,345.57050580964284,0.47197630373502464,0.2570154431856557,0.17313608590564364,125084.47372626026,-154.2056119368719,124930.26811432338,254,0,40.02272727272727,36,8,20,41.27335922548689,0.5703125,49.915540540540555,1000.3378378378396,27.78716216216221,0
1917,4,4,5,40,0.08888888888888889,0.1111111111111111,0.8888888888888888,45,1100,700,400,0.6363636363636364,15,7,8,353.58134758809825,0.47253787878787884,0.2041498868561351,0.18324242646918068,126480.04979263108,58.82944723297703,126538.87923986405,255,0,37.46666666666667,35,10,16,39.632594062823614,0.5866071428571429,48.52430555555555,1005.9027777777769,28.74007936507934,16
1918,4,3,3,40,0.06976744186046512,0.06976744186046512,0.9302325581395349,43,800,600,200,0.75,10,6,4,349.4050299707907,0.47148394241417496,0.21664280546969494,0.18356741974579677,127036.73846760519,277.45508233300194,127314.1935499382,256,0,38.04651162790697,37,6,19,39.16548836197519,0.5884009009009009,47.971491228070164,1008.1140350877174,27.246325272641013,0
1919,4,0,2,38,0.0,0.05,0.95,40,1200,1100,100,0.9166666666666666,13,11,2,360.9726111604401,0.46768162393162394,0.22066115702479405,0.18990298239310097,127092.01388888883,1175.35924515235,128267.37313404118,257,1,41.375,34,6,20,38.81714876033058,0.5949754901960784,47.916666666666664,1008.3333333333328,29.656862745098024,0
1920,4,1,3,36,0.02564102564102564,0.07692307692307693,0.9230769230769231,39,950,600,350,0.631578947368421,13,6,7,352.39640289299837,0.46935447593342333,0.19285051152016597,0.18663142411803427,127362.24666950095,1176.3995181405637,128538.64618764151,258,0,40.82051282051282,34,5,16,38.75604434485197,0.5977328431372548,47.64880952380951,1009.4047619047604,29.688375350140014,0
1921,4,1,0,37,0.02702702702702703,0.0,1.0,37,850,600,250,0.7058823529411765,11,6,5,370.2223755322533,0.4682807807807808,0.20799074634639636,0.19553516212017424,127251.20722694111,2022.2488457810362,129273.45607272215,259,0,43.7027027027027,32,5,21,38.42030617778333,0.6012369791666667,47.75883838383838,1008.9646464646464,31.5301452020202,0
1922,4,1,1,37,0.02631578947368421,0.02631578947368421,0.9736842105263158,38,1200,600,600,0.5,18,6,12,361.33863810866586,0.4674460644855382,0.2117694105684751,0.1927972155188223,127662.84190759624,1625.9034863945399,129288.74539399079,260,0,43.526315789473685,34,4,17,38.22201280087954,0.600796568627451,47.35119047619047,1010.5952380952372,29.72338935574227,0
1923,4,0,0,37,0.0,0.0,1.0,37,900,600,300,0.6666666666666666,12,6,6,373.72292651002374,0.4660598098098098,0.2214557150866745,0.19887657089878166,127555.8247579057,2134.10722438486,129689.93198229057,261,1,45.67567567567568,33,4,17,38.01900097052044,0.6019570707070707,47.45710784313726,1010.1715686274517,30.611259655377324,0
1924,4,1,1,37,0.02631578947368421,0.02631578947368421,0.9736842105263158,38,1150,900,250,0.782608695652174,14,9,5,371.771626297578,0.46637920815552397,0.2232198142414863,0.20000372300819053,127993.90589569151,1916.9005102040705,129910.80640589558,262,0,45.44736842105263,34,4,18,37.61887254901961,0.6041666666666667,47.02380952380952,1011.9047619047611,29.761904761904738,0
1925,4,0,1,36,0.0,0.02702702702702703,0.972972972972973,37,1700,1000,700,0.5882352941176471,24,10,14,378.305226791977,0.46631006006006004,0.22200257898974285,0.20365349171109187,128020.48040417161,2286.1633746636103,130306.64377883522,263,1,47.432432432432435,33,4,18,37.42633405990152,0.6066919191919191,46.99754901960785,1012.0098039215698,30.666963755199085,0
1926,4,2,2,36,0.05263157894736842,0.05263157894736842,0.9473684210526316,38,1200,800,400,0.6666666666666666,16,8,8,370.61917245795973,0.4664236605026079,0.21568764717113198,0.201381114075383,128392.8131608037,1917.0277056901396,130309.84086649383,264,0,46.921052631578945,33,5,16,37.23952035469569,0.610479797979798,46.62990196078432,1013.4803921568639,30.71152703505648,0
1927,4,0,2,34,0.0,0.05555555555555555,0.9444444444444444,36,800,400,400,0.5,12,4,8,393.86428051894273,0.46514550264550264,0.2287273861509671,0.21200955059498505,128016.72222541072,2884.2428387409523,130900.96506415166,265,3,50.52777777777778,32,4,20,37.036546059471824,0.6090494791666667,47.00126262626263,1011.9949494949499,31.624842171717184,0
1928,4,1,0,35,0.02857142857142857,0.0,1.0,35,850,500,350,0.5882352941176471,12,5,7,393.11450742152357,0.4641456582633053,0.19633398229438392,0.2126317551268851,128210.45769585493,3080.3419536819733,131290.7996495369,266,0,49.94285714285714,31,4,21,36.85662552498501,0.6135752688172043,46.80989583333333,1012.7604166666657,32.66969086021502,0
1929,4,2,1,36,0.05405405405405406,0.02702702702702703,0.972972972972973,37,1100,500,600,0.45454545454545453,17,5,12,408.32759541262385,0.4650275275275275,0.26702615528787677,0.2101180708818603,126189.15741008642,2921.596038357855,129110.75344844427,267,0,48.189189189189186,35,2,17,38.55702588027493,0.5836309523809524,48.8136574074074,1004.745370370369,28.707010582010543,15
1930,4,2,0,38,0.05263157894736842,0.0,1.0,38,1450,1100,350,0.7586206896551724,18,11,7,395.6373559437952,0.4665718349928876,0.28876181062986084,0.2069808062148067,126865.01323959102,2438.5076799772805,129303.5209195683,268,0,47.578947368421055,36,2,16,38.17744429540203,0.5885416666666667,48.141891891891895,1007.4324324324331,27.98423423423425,0
1931,4,2,1,39,0.05,0.025,0.975,40,950,500,450,0.5263157894736842,14,5,9,377.9823676338202,0.46870993589743587,0.2769834900252235,0.20028932020061824,127383.94445516098,1630.3857015642764,129014.33015672525,269,0,46.15,35,5,14,38.088072307574706,0.5958333333333333,47.6273148148148,1009.4907407407392,28.84259259259255,0
1932,4,2,2,39,0.04878048780487805,0.04878048780487805,0.9512195121951219,41,950,600,350,0.631578947368421,13,6,7,319.395452503035,0.46994410569105693,0.09738189494477001,0.1722282976934487,128087.52745566555,-17.885241660525736,128069.64221400503,270,0,45.97560975609756,36,5,18,38.84840731264139,0.6009837962962963,46.93130630630633,1012.2747747747783,28.118743743743842,16
1933,4,1,0,40,0.025,0.0,1.0,40,1050,800,250,0.7619047619047619,13,8,5,328.8643205946157,0.4697649572649573,0.11540109701748347,0.17797722136818098,128232.43694540916,434.2146508487911,128666.65159625796,271,0,46.85,35,5,21,38.46096160438806,0.6044642857142857,46.78819444444446,1012.847222222224,28.938492063492113,0
1934,4,2,0,42,0.047619047619047616,0.0,1.0,42,1700,1600,100,0.9411764705882353,18,16,2,367.71981316502206,0.4696815718157181,0.21760783835427078,0.1892614405612064,126197.70828827865,1632.1284431869315,127829.83673146558,272,0,45.57142857142857,33,9,20,39.56821461966907,0.5880681818181819,48.805147058823536,1004.7794117647068,30.44786096256687,16
1935,4,3,1,44,0.06666666666666667,0.022222222222222223,0.9777777777777777,45,1050,900,150,0.8571428571428571,12,9,3,339.48678536421,0.471969696969697,0.21609545569941702,0.1779933282534199,126953.84787867402,-380.16925881041743,126573.6786198636,273,0,43.46666666666667,37,8,20,39.500485075980144,0.5875563063063063,48.05372807017543,1007.7850877192967,27.237434803224236,0
1936,4,1,1,44,0.022222222222222223,0.022222222222222223,0.9777777777777777,45,1600,1200,400,0.75,20,12,8,339.60996014677215,0.4703493265993266,0.07748996197988833,0.17211674965623286,125561.52664776462,-471.53584452362605,125089.990803241,274,0,44.37777777777778,38,7,17,40.929804924848085,0.571546052631579,49.43910256410256,1002.2435897435897,26.374831309041834,16
1937,4,2,4,42,0.043478260869565216,0.08695652173913043,0.9130434782608696,46,1550,1100,450,0.7096774193548387,20,11,9,340.40410350060097,0.4724033816425121,0.003783442738426235,0.16829511967172248,124529.21395699498,-634.6297147707841,123894.5842422242,275,0,44.34782608695652,41,5,16,41.977168439187615,0.5561483739837398,50.471230158730165,998.1150793650806,24.3442702284166,16
1938,4,3,3,42,0.06666666666666667,0.06666666666666667,0.9333333333333333,45,1250,800,450,0.64,17,8,9,325.74941759051814,0.47500000000000003,0.03344570031066163,0.16345814058795846,125148.85381235824,-844.7902888007087,124304.06352355753,223,0,39.6,41,4,19,41.70260757485624,0.5625,49.851190476190474,1000.5952380952378,24.404761904761898,0
1939,4,8,7,43,0.16,0.14,0.86,50,1200,800,400,0.6666666666666666,16,8,8,306.4634148000848,0.47784013605442177,0.11277226869017865,0.1595894127272823,126676.5914728609,-2235.6518403983673,124440.93963246254,224,0,35.7,47,3,15,40.61619743611854,0.5702570921985816,48.32899305555554,1006.6840277777753,21.418809101654794,0
1940,4,4,2,45,0.0851063829787234,0.0425531914893617,0.9574468085106383,47,1450,1200,250,0.8275862068965517,17,12,5,314.1689467011048,0.4765070921985815,0.15082242789706735,0.16480621613694088,126975.33543381341,-1421.6585219478802,125553.67691186554,225,0,38.4468085106383,44,3,20,40.1163680906446,0.5769412878787878,48.032407407407405,1007.87037037037,22.90614478114477,0
1941,4,1,1,45,0.021739130434782608,0.021739130434782608,0.9782608695652174,46,1350,1100,250,0.8148148148148148,16,11,5,312.02986183843217,0.4762781803542673,0.15403751132691657,0.16496713901354085,127292.15876165249,-1256.1018903446434,126036.05687130785,226,0,39.65217391304348,41,5,21,39.846310132389554,0.584349593495935,47.718253968253954,1009.1269841269815,24.612853271389792,0
1942,4,1,2,44,0.021739130434782608,0.043478260869565216,0.9565217391304348,46,1400,1100,300,0.7857142857142857,17,11,6,311.4894078044757,0.47514090177133655,0.1611155235581967,0.1657045533053904,127542.56129535152,-1254.3686224489797,126288.19267290254,227,0,40.56521739130435,41,5,17,39.60420349636611,0.586890243902439,47.470238095238095,1010.119047619048,24.637049941928,0
1943,4,2,2,44,0.043478260869565216,0.043478260869565216,0.9565217391304348,46,950,500,450,0.5263157894736842,14,5,9,310.6584759051196,0.47500000000000003,0.18480550952257935,0.16703891891870568,127972.89544648789,-1248.8270686857531,126724.06837780213,228,0,40.869565217391305,42,4,19,39.18629892102406,0.589781746031746,47.044573643410864,1011.821705426359,24.09099298634188,0
1944,4,1,2,43,0.022222222222222223,0.044444444444444446,0.9555555555555556,45,1850,1300,550,0.7027027027027027,24,13,11,319.9038087012479,0.4730429292929293,0.1861911294010059,0.17274805669867407,128144.53125000015,-801.2152777777642,127343.31597222238,229,0,40.355555555555554,41,4,20,38.77743484224967,0.5929878048780488,46.87500000000001,1012.5000000000011,24.69512195121954,0
1945,4,0,1,42,0.0,0.023255813953488372,0.9767441860465116,43,1300,500,800,0.38461538461538464,21,5,16,326.41158436625,0.4709763750461425,0.18197477051600086,0.1763783775221968,128170.899793837,-232.7067057291479,127938.19308810786,230,1,42.23255813953488,39,4,20,38.585815073895,0.5964209401709402,46.84895833333334,1012.6041666666682,25.964209401709443,0
1946,4,0,1,41,0.0,0.023809523809523808,0.9761904761904762,42,1350,800,550,0.5925925925925926,19,8,11,354.442953320028,0.46960898180410376,0.1697634166432065,0.17886640528315667,125384.06649161282,565.1308199999032,125949.19731161272,231,2,44.0,37,5,15,40.74155171155389,0.571509009009009,49.61622807017544,1001.5350877192984,27.068515884305363,16
1947,4,1,1,41,0.023809523809523808,0.023809523809523808,0.9761904761904762,42,1500,900,600,0.6,21,9,12,348.1609141267502,0.470383275261324,0.14592770549613832,0.17742366460222797,125788.84225865909,358.95166154408093,126147.79392020317,232,0,42.30952380952381,40,2,17,40.48095431060684,0.5705729166666667,49.21239837398375,1003.1504065040668,25.07876016260167,0
1948,4,4,5,40,0.08888888888888889,0.1111111111111111,0.8888888888888888,45,1150,600,550,0.5217391304347826,17,6,11,328.03727175963144,0.47413720538720544,0.17658319932613553,0.17183468639827643,126917.01630015447,-672.7812542458753,126244.2350459086,233,0,40.22222222222222,41,4,17,39.826699977027346,0.5805386178861789,48.090277777777786,1007.63888888889,24.576558265582683,0
1949,4,1,1,40,0.024390243902439025,0.024390243902439025,0.975609756097561,41,1450,1000,450,0.6896551724137931,19,10,9,382.77651374825587,0.47040142276422764,0.19053991981445018,0.18644640833875975,123902.88092635463,1566.576110253775,125469.45703660841,234,0,44.292682926829265,35,6,16,41.572211888708054,0.5601190476190476,51.09953703703704,995.6018518518521,28.445767195767203,16
1950,4,5,7,38,0.1111111111111111,0.15555555555555556,0.8444444444444444,45,1900,1400,500,0.7368421052631579,24,14,10,344.215500867752,0.47371632996633,0.2268695500087452,0.1737487323903398,125394.4548433569,-362.5808694705694,125031.87397388634,235,0,41.13333333333333,36,9,14,40.986901281763,0.5734953703703703,49.60585585585586,1001.5765765765768,27.821571571571578,0
1951,4,1,1,38,0.02564102564102564,0.02564102564102564,0.9743589743589743,39,1350,800,550,0.5925925925925926,19,8,11,386.79377526688114,0.47281264057579847,0.2375325533486219,0.19281231265822638,124873.7692582391,1860.0793286399555,126733.84858687906,236,0,46.1025641025641,32,7,17,40.46130200437931,0.5768229166666667,50.12626262626264,999.4949494949508,31.234217171717212,0
1952,4,2,0,40,0.05,0.0,1.0,40,1550,900,650,0.5806451612903226,22,9,13,379.6019708600495,0.4729300213675214,0.2416120494076135,0.19183197686647332,125442.30977706352,1523.6933731251938,126966.00315018871,237,0,45.425,32,8,18,40.05125619695826,0.5826822916666667,49.55808080808081,1001.7676767676764,31.30523989898989,0
1953,4,0,2,38,0.0,0.05,0.95,40,1400,1000,400,0.7142857142857143,18,10,8,383.47766746985195,0.4728231837606838,0.24978611586409238,0.19488287423840556,125674.92821270667,1638.7056660899707,127313.63387879664,238,1,46.425,33,7,19,39.71319155870611,0.5827020202020202,49.325980392156865,1002.6960784313726,30.384729649435535,0
1954,4,3,1,40,0.07317073170731707,0.024390243902439025,0.975609756097561,41,1450,1200,250,0.8275862068965517,17,12,5,361.90112312996564,0.471239837398374,0.24695530286606893,0.18823900723663106,126629.04779712118,966.5202386101332,127595.56803573131,239,0,45.48780487804878,33,8,20,39.26993283006615,0.5924873737373737,48.37622549019607,1006.4950980392148,30.499851455733783,0
1955,4,3,1,42,0.06976744186046512,0.023255813953488372,0.9767441860465116,43,1150,800,350,0.6956521739130435,15,8,7,343.06453599325266,0.4731912144702843,0.24505306364344737,0.18128522488022505,127272.13718820855,133.35611511760715,127405.49330332616,240,0,44.30232558139535,34,9,23,39.08388390750353,0.5968137254901961,47.738095238095234,1009.0476190476186,29.67787114845937,0
1956,4,1,4,39,0.023255813953488372,0.09302325581395349,0.9069767441860466,43,1300,800,500,0.6153846153846154,18,8,10,336.8031629794595,0.47464470284237725,0.23998009754277239,0.17969510015325035,127660.4032241702,-0.7144813732527666,127659.68874279693,241,0,44.02325581395349,36,7,18,38.844393061436755,0.5966435185185186,47.35360360360361,1010.5855855855862,28.07182182182184,0
1957,4,0,1,38,0.0,0.02564102564102564,0.9743589743589743,39,1400,1100,300,0.7857142857142857,17,11,6,364.1122854820524,0.4732624831309042,0.23630599826859267,0.19243264176246586,127277.43686322556,1468.6556853133295,128746.09254853889,242,1,46.23076923076923,33,6,22,38.54748603351956,0.5991161616161615,47.732843137254896,1009.0686274509794,30.577837195484225,0
1958,4,2,5,35,0.05,0.125,0.875,40,1350,1100,250,0.8148148148148148,16,11,5,348.8044626333894,0.47280982905982905,0.2450343053173245,0.1879417760769553,128056.65569540874,933.3465952931846,128990.00229070193,243,0,45.025,35,5,22,38.13572041166381,0.6026785714285714,46.96180555555554,1012.1527777777761,28.918650793650745,0
1959,4,1,3,33,0.027777777777777776,0.08333333333333333,0.9166666666666666,36,1250,800,450,0.64,17,8,9,374.0344264300633,0.4724867724867725,0.08541104229527274,0.18648414752415743,124880.98072562352,2214.325303327337,127095.30602895086,244,0,43.44444444444444,34,2,21,40.77263974908685,0.5723039215686274,50.11904761904761,999.5238095238091,29.397759103641445,16
1960,4,4,4,33,0.10810810810810811,0.10810810810810811,0.8918918918918919,37,1050,800,250,0.7619047619047619,13,8,5,355.91081330505386,0.4746934434434435,0.12645177732739477,0.18137605977811314,125789.53108513913,1553.970862754638,127343.50194789376,245,0,42.21621621621622,36,1,19,40.285885346505005,0.5775462962962963,49.21171171171171,1003.1531531531525,27.86536536536535,0
1961,4,5,3,35,0.13157894736842105,0.07894736842105263,0.9210526315789473,38,1100,800,300,0.7272727272727273,14,8,6,351.12288148453933,0.47491405879563775,0.16333898771318545,0.1832223036110231,126760.5417051399,1301.705332409958,128062.24703754985,246,0,40.63157894736842,37,1,17,39.40594149245066,0.5855855855855856,48.24561403508771,1007.017543859648,27.21669037458508,0
1962,4,1,0,36,0.027777777777777776,0.0,1.0,36,1100,1000,100,0.9090909090909091,12,10,2,364.2985352336109,0.4731646825396825,0.1812230142306026,0.18974063829113436,126683.87372470838,2030.1499271261873,128714.02365183456,247,0,43.666666666666664,35,1,18,39.15315781405689,0.5886904761904762,48.32175925925925,1006.7129629629619,28.763227513227484,0
1963,4,1,0,37,0.02702702702702703,0.0,1.0,37,1500,1100,400,0.7333333333333333,19,11,8,354.82549006215424,0.4729416916916917,0.16863971409425949,0.1866690621631334,127092.01388888895,1619.0972222222322,128711.11111111118,248,0,43.45945945945946,36,1,21,38.97210743801652,0.5908564814814814,47.91666666666667,1008.3333333333339,28.009259259259277,0
1964,4,4,3,38,0.0975609756097561,0.07317073170731707,0.926829268292683,41,1050,600,450,0.5714285714285714,15,6,9,328.7511662453857,0.47291666666666665,0.1294247905377346,0.16925144311644494,126209.04989996942,98.27446906742335,126307.32436903685,249,0,40.1219512195122,37,4,18,40.535428488287494,0.579954954954955,48.793859649122815,1004.8245614035104,27.157420578473253,15
1965,4,1,0,39,0.02564102564102564,0.0,1.0,39,1250,700,550,0.56,18,7,11,378.6698412142643,0.47154745838956363,0.18624611093230325,0.18469814704124335,123960.50347222229,1637.8077870113984,125598.31125923368,250,0,43.0,35,4,17,41.61436541143655,0.5607142857142857,51.04166666666667,995.8333333333339,28.45238095238097,16
1966,4,3,1,41,0.07142857142857142,0.023809523809523808,0.9761904761904762,42,1300,600,700,0.46153846153846156,20,6,14,388.7416549099238,0.47396438250096784,0.16467006089647596,0.18730279736569028,123442.38281249977,1549.001736111082,124991.38454861085,251,0,40.857142857142854,37,5,17,41.90469951083156,0.5515202702702703,51.562499999999986,993.7499999999982,26.85810810810806,16
1967,4,8,4,45,0.16326530612244897,0.08163265306122448,0.9183673469387755,49,1750,1400,350,0.8,21,14,7,307.90911490238375,0.4807610544217687,0.21863855744101746,0.15002024071342718,123914.40436385488,-2159.359460733854,121755.04490312102,252,0,35.734693877551024,44,5,17,43.423734461700626,0.5456912878787878,51.087962962962976,995.6481481481505,22.628367003367057,14
1968,4,3,3,45,0.0625,0.0625,0.9375,48,1700,1200,500,0.7058823529411765,22,12,10,309.39922906681903,0.48117981678487,0.2203599275967696,0.15240776839217385,124375.78125,-1903.6115397805206,122472.16971021947,253,0,37.0625,39,9,14,42.90935672514618,0.5576923076923077,50.625,997.5,25.576923076923077,0
1969,4,11,10,46,0.19642857142857142,0.17857142857142858,0.8214285714285714,56,1600,1400,200,0.875,18,14,4,274.0340866305316,0.48323863636363634,0.25701179849813927,0.1409045922493841,126157.55885219705,-4282.580717680153,121874.9781345169,254,0,32.07142857142857,45,11,15,41.962608571514444,0.5673611111111111,48.84510869565215,1004.6195652173873,22.32487922705305,0
1970,4,3,1,48,0.061224489795918366,0.02040816326530612,0.9795918367346939,49,1300,700,600,0.5384615384615384,19,7,12,316.12679326751413,0.4805661848072562,0.2876769585839678,0.1606381849952117,125670.53970025489,-1854.4350552721332,123816.10464498276,255,0,36.46938775510204,41,8,19,41.40601810626299,0.5678353658536586,49.33035714285713,1002.6785714285697,24.455574912891944,0
1971,4,1,4,45,0.02040816326530612,0.08163265306122448,0.9183673469387755,49,1550,1200,350,0.7741935483870968,19,12,7,315.98920958002685,0.48014101473922904,0.2866823574968089,0.1617346895164536,125969.13309594645,-1839.0226403061513,124130.1104556403,256,0,37.244897959183675,41,8,20,41.10244342326316,0.5708841463414633,49.03273809523808,1003.8690476190454,24.484610917537694,0
1972,4,1,4,42,0.021739130434782608,0.08695652173913043,0.9130434782608696,46,1200,900,300,0.75,15,9,6,319.8098722326621,0.4812902576489533,0.255726567096199,0.16464818365955675,126209.04989996899,-1127.3756868283122,125081.67421314068,257,0,36.869565217391305,37,9,22,40.76003928415539,0.579954954954955,48.793859649122794,1004.8245614035069,27.157420578473157,0
1973,4,2,4,40,0.045454545454545456,0.09090909090909091,0.9090909090909091,44,1300,1100,200,0.8461538461538461,15,11,4,314.9929884655479,0.4792437455954898,0.24730550467560053,0.1648381732092184,126876.6493626268,-806.9490101541528,126069.70035247265,258,0,35.31818181818182,38,6,18,40.19662424885116,0.5849780701754386,48.130341880341874,1007.4786324786314,26.512595591542933,0
1974,4,2,2,40,0.047619047619047616,0.047619047619047616,0.9523809523809523,42,1450,1200,250,0.8275862068965517,17,12,5,320.7171863725275,0.47850125822686795,0.24329202485951407,0.1690796844225269,127177.19144397796,-242.23516947765268,126934.9562745003,259,0,37.07142857142857,36,6,21,39.744752707379725,0.591724537037037,47.83220720720722,1008.6711711711728,28.01864364364369,0
1975,4,1,2,39,0.024390243902439025,0.04878048780487805,0.9512195121951219,41,1000,600,400,0.6,14,6,8,325.03422859803527,0.4793445121951219,0.24006338522862758,0.17147565487521818,127205.59030314126,69.23418350786329,127274.82448664913,260,0,38.51219512195122,36,5,22,39.60682257944482,0.5920138888888888,47.80405405405407,1008.783783783786,28.021771771771835,0
1976,4,1,3,37,0.025,0.075,0.925,40,1400,1000,400,0.7142857142857143,18,10,8,323.7389381224499,0.4770165598290598,0.21920588891367299,0.17175404255656165,127432.89531085163,250.99804196090244,127683.89335281253,261,0,39.35,36,4,19,39.40697263737078,0.5943287037037037,47.57882882882884,1009.6846846846867,28.04679679679685,0
1977,4,2,3,36,0.05128205128205128,0.07692307692307693,0.9230769230769231,39,1200,900,300,0.75,15,9,6,329.3250838983922,0.4771986054880792,0.197138333465519,0.1753922304666912,127588.49511584801,603.618371699261,128192.11348754728,262,0,40.30769230769231,35,4,20,39.106832588689045,0.5979166666666667,47.424768518518526,1010.3009259259268,28.865740740740765,0
1978,4,2,2,36,0.05263157894736842,0.05263157894736842,0.9473684210526316,38,1550,1200,350,0.7741935483870968,19,12,7,336.36021963219315,0.4772552157420578,0.1908491343775769,0.1797378618563216,127723.00347222215,992.1874999999957,128715.19097222215,263,0,41.89473684210526,34,4,21,38.79156361637813,0.6014093137254901,47.291666666666664,1010.8333333333327,29.730392156862727,0
1979,4,1,0,37,0.02702702702702703,0.0,1.0,37,1250,900,350,0.72,16,9,7,344.1325252525253,0.47603853853853856,0.19931203931203956,0.1841175961954171,127772.55893166078,1394.1386726258984,129166.69760428667,264,0,43.86486486486486,33,4,22,38.544444444444444,0.6041666666666667,47.24264705882352,1011.029411764705,30.637254901960755,0
1980,4,1,0,38,0.02631578947368421,0.0,1.0,38,650,300,350,0.46153846153846156,10,3,7,337.1775982658471,0.4767958748221906,0.20955165692007816,0.18207590306355717,128144.53124999977,1041.4930555555263,129186.0243055553,265,0,43.68421052631579,34,4,23,38.34019204389575,0.6056985294117647,46.874999999999986,1012.4999999999982,29.779411764705827,0
1981,4,0,0,38,0.0,0.0,1.0,38,1350,1000,350,0.7407407407407407,17,10,7,334.8932133482284,0.47652916073968704,0.21009338858309157,0.18152492010149154,128295.24518140557,993.0413832199227,129288.2865646255,266,1,44.68421052631579,34,4,24,38.24422248335293,0.6072303921568627,46.72619047619046,1013.0952380952355,29.796918767506924,0
1982,4,0,0,38,0.0,0.0,1.0,38,1450,1300,150,0.896551724137931,16,13,3,335.0742425883718,0.475966097676624,0.20745469827692786,0.18244835357305458,128476.21882086163,1009.8143424036216,129486.03316326525,267,2,45.68421052631579,34,4,20,38.055082589635205,0.6090686274509804,46.547619047619044,1013.8095238095234,29.817927170868334,0
1983,4,1,1,38,0.02564102564102564,0.02564102564102564,0.9743589743589743,39,1050,600,450,0.5714285714285714,15,6,9,325.240109266456,0.4759615384615385,0.19904686723386855,0.17849535408428138,128789.87295310342,577.5264703360597,129367.39942343948,268,0,45.48717948717949,35,4,21,37.98508171797795,0.6101190476190477,46.23842592592592,1015.0462962962952,29.001322751322718,0
1984,4,2,2,38,0.05,0.05,0.95,40,900,400,500,0.4444444444444444,14,4,10,312.27346562679264,0.47529380341880345,0.18068534100974376,0.17367327226238824,129315.9037415791,76.38508440870456,129392.2888259878,269,0,42.775,36,4,23,37.780253542958405,0.6134259259259259,45.720720720720706,1017.1171171171145,28.25325325325318,0
1985,4,2,5,35,0.05,0.125,0.875,40,850,500,350,0.5882352941176471,12,5,7,308.8620389223901,0.4745325854700855,0.16503318584070836,0.17277925939717853,129545.0856261666,2.311855774683096,129547.39748194128,270,0,40.45,36,4,15,37.63481747787611,0.6157407407407407,45.49549549549549,1018.0180180180173,28.278278278278258,0
1986,4,0,1,34,0.0,0.02857142857142857,0.9714285714285714,35,1150,800,350,0.6956521739130435,15,8,7,393.37569696740906,0.4730742296918768,0.07104890940221842,0.19607479544946976,124869.82557508687,2855.2240248324792,127725.04959991935,271,1,46.02857142857143,31,4,18,40.30093798853569,0.5793010752688172,50.130208333333336,999.4791666666672,32.24126344086023,16
1987,4,2,1,35,0.05555555555555555,0.027777777777777776,0.9722222222222222,36,900,700,200,0.7777777777777778,11,7,4,376.2920554018976,0.47538029100529106,0.05182035700205301,0.18995892333537404,125398.60157451447,2237.299506199523,127635.90108071399,272,0,44.638888888888886,33,3,16,40.17942717892246,0.5798611111111112,49.6017156862745,1001.5931372549009,30.35130718954245,0
1988,4,3,1,37,0.07894736842105263,0.02631578947368421,0.9736842105263158,38,1200,900,300,0.75,15,9,6,357.72567881200087,0.47550675675675674,0.07122981707469256,0.18356288482104838,126073.7244897957,1421.617498102156,127495.34198789786,273,0,43.21052631578947,34,4,20,39.94710170697013,0.5845588235294117,48.928571428571416,1004.2857142857125,29.53781512605037,0
1989,4,2,3,36,0.05128205128205128,0.07692307692307693,0.9230769230769231,39,1400,800,600,0.5714285714285714,20,8,12,346.58932618854664,0.47615834457939726,0.07249133012641251,0.18044041856723453,126666.55411746203,980.2551284392468,127646.80924590128,274,0,41.41025641025641,36,3,18,39.616661073199836,0.5865162037037037,48.33896396396396,1006.644144144144,27.96233733733733,0
1990,4,2,2,36,0.05263157894736842,0.05263157894736842,0.9473684210526316,38,800,600,200,0.75,10,6,4,339.2594653111303,0.4709726173541963,0.07235372934345663,0.17872986890155812,127148.79575521493,1027.9998326029017,128176.79558781783,275,0,41.63157894736842,36,2,20,39.306284427571846,0.5914351851851851,47.860360360360374,1008.5585585585607,28.015515515515574,0
1991,4,2,4,34,0.05263157894736842,0.10526315789473684,0.8947368421052632,38,950,500,450,0.5263157894736842,14,5,9,389.3583649621054,0.47258771929824567,-0.003004917137133356,0.19880665631457334,125869.56259645069,2460.3685576060434,128329.93115405673,276,0,41.973684210526315,35,3,19,39.36418685121107,0.5803571428571428,49.13194444444445,1003.4722222222229,28.67063492063494,16
1992,4,1,1,34,0.02857142857142857,0.02857142857142857,0.9714285714285714,35,1450,900,550,0.6206896551724138,20,9,11,412.1282107300018,0.47405462184873953,-0.024421388667198674,0.1993809451910011,123614.96913580266,3189.163773148172,126804.13290895084,277,0,46.08571428571429,32,3,20,41.14292364990688,0.5638020833333333,51.3888888888889,994.444444444446,31.07638888888894,16
1993,4,7,8,33,0.17073170731707318,0.1951219512195122,0.8048780487804879,41,850,400,450,0.47058823529411764,13,4,9,348.4200570286227,0.47751524390243905,0.011591674621199699,0.1756321511960612,125338.06610664753,535.0237343199474,125873.08984096747,278,0,39.8780487804878,36,5,13,40.93988978857401,0.5729166666666667,49.66216216216218,1001.3513513513542,27.815315315315395,0
1994,4,7,5,35,0.175,0.125,0.875,40,1150,900,250,0.782608695652174,14,9,5,354.41124298957584,0.4761752136752137,0.0370976116303221,0.1805809666661174,125782.47070312512,915.7443576389039,126698.21506076402,279,0,41.075,35,5,18,40.330780546902055,0.5794642857142858,49.21875000000001,1003.1250000000009,28.660714285714313,0
1995,4,4,4,35,0.10256410256410256,0.10256410256410256,0.8974358974358975,39,1100,900,200,0.8181818181818182,13,9,4,367.2448088561137,0.47247525865946916,0.11292537387960944,0.19145198918539533,126721.57343329486,1508.1105374134906,128229.68397070836,280,0,42.205128205128204,33,6,17,39.04018581629341,0.5934343434343434,48.28431372549019,1006.862745098039,30.51099227569815,0
1996,4,2,3,34,0.05405405405405406,0.08108108108108109,0.9189189189189189,37,750,500,250,0.6666666666666666,10,5,5,361.0946724707512,0.46975100100100103,0.13598755200757706,0.1905644935958589,127219.3605882054,1788.1873261467392,129007.54791435214,281,0,42.972972972972975,32,5,19,38.68324989570297,0.6009114583333333,47.79040404040405,1008.8383838383847,31.526199494949523,0
1997,4,1,4,31,0.02857142857142857,0.11428571428571428,0.8857142857142857,35,750,500,250,0.6666666666666666,10,5,5,379.156598255105,0.46736694677871143,0.0016585712593295554,0.19526911811295578,126223.21605725646,2571.6730442177177,128794.88910147418,282,0,46.22857142857143,34,1,18,39.254580815859114,0.5860906862745099,48.77976190476192,1004.8809523809542,29.555322128851596,16
1998,4,1,2,30,0.03125,0.0625,0.9375,32,1400,1100,300,0.7857142857142857,17,11,6,394.4491313854786,0.46572580645161293,0.020617219917012042,0.20226008651893695,126043.83680555565,3543.5763888888946,129587.41319444454,283,0,51.09375,31,1,20,39.05601659751036,0.5913978494623655,48.958333333333336,1004.1666666666674,32.3924731182796,0
1999,4,3,3,30,0.09090909090909091,0.09090909090909091,0.9090909090909091,33,1050,700,350,0.6666666666666666,14,7,7,378.0083748734691,0.4674873737373737,0.031837553271497177,0.19762456190960284,126837.51179726566,2989.1283414957775,129826.64013876143,284,0,48.93939393939394,32,1,18,38.64977646862205,0.5970052083333333,48.169191919191924,1007.3232323232329,31.478851010101028,0
2000,4,0,1,29,0.0,0.03333333333333333,0.9666666666666667,30,1000,800,200,0.8,12,8,4,413.6015384145781,0.4643199233716475,0.044198895027623974,0.21389108129439618,126392.74691358021,4455.246913580239,130847.99382716045,285,1,54.6,29,1,18,38.21362799263352,0.6005747126436782,48.61111111111111,1005.5555555555553,34.6743295019157,0
2001,4,2,0,31,0.06451612903225806,0.0,1.0,31,1050,800,250,0.7619047619047619,13,8,5,398.4367316006628,0.4667114695340502,0.0658496401670765,0.20908866691906014,126990.38770739388,3919.527004566998,130909.91471196088,286,0,53.645161290322584,30,1,21,37.9775636751567,0.6038194444444445,48.01747311827957,1007.9301075268813,33.597670250896044,0
2002,4,1,0,32,0.03125,0.0,1.0,32,950,600,350,0.631578947368421,13,6,7,389.5961507615297,0.467741935483871,0.0658128062935257,0.20662985998665528,127420.45932345913,3528.5040961371424,130948.96341959627,287,0,52.9375,31,1,17,37.757394033187175,0.605510752688172,47.59114583333333,1009.6354166666661,32.56888440860213,0
2003,4,0,0,32,0.0,0.0,1.0,32,800,600,200,0.75,10,6,4,389.53334518066964,0.4672589045698925,0.06850667139358002,0.20710145021017526,127519.07560560443,3534.5864189995705,131053.66202460401,288,1,53.9375,31,1,17,37.657519015083146,0.606518817204301,47.493489583333336,1010.0260416666671,32.581485215053775,0
2004,4,0,1,31,0.0,0.03125,0.96875,32,900,600,300,0.6666666666666666,12,6,6,393.52986017279994,0.46641885080645157,0.058172581476233054,0.21025273947153808,127716.42261081288,3652.0451863606963,131368.46779717357,289,2,54.9375,31,1,18,37.35360577955257,0.6085349462365591,47.29817708333334,1010.807291666668,32.606686827957034,0
2005,4,2,2,31,0.06060606060606061,0.06060606060606061,0.9393939393939394,33,1150,1000,150,0.8695652173913043,13,10,3,379.4793958105737,0.46756628787878785,0.06605184446659984,0.20573936972865203,128304.38220589771,3137.773887868628,131442.15609376633,290,0,53.333333333333336,32,1,20,37.105610252575595,0.6119791666666667,46.71717171717174,1013.131313131316,31.660353535353625,0
2006,4,1,1,31,0.03125,0.03125,0.96875,32,1500,1000,500,0.6666666666666666,20,10,10,381.65373711390515,0.4656838037634408,0.06058625840179266,0.20858545061041614,128624.38303489455,3417.995293847589,132042.37832874214,291,0,54.5,32,0,17,36.72283420463034,0.615234375,46.40151515151516,1014.3939393939406,31.699810606060645,0
2007,4,1,0,32,0.03125,0.0,1.0,32,900,700,200,0.7777777777777778,11,7,4,420.82349541916966,0.465788810483871,0.18509883073496658,0.20763708730022773,124445.06172839506,4656.590367054387,129101.65209544945,292,0,55.4375,29,3,18,40.05834725315516,0.5804597701149425,50.55555555555556,997.7777777777777,34.406130268199234,16
2008,4,2,0,34,0.058823529411764705,0.0,1.0,34,1300,900,400,0.6923076923076923,17,9,8,394.6832829808577,0.467208853238265,0.16714658783706215,0.19749591508638223,125032.55420260954,3069.6517944335887,128102.20599704313,293,0,53.11764705882353,31,3,20,40.09908106583343,0.580981182795699,49.967447916666664,1000.1302083333328,32.26226478494622,0
2009,4,1,1,34,0.02857142857142857,0.02857142857142857,0.9714285714285714,35,950,800,150,0.8421052631578947,11,8,3,385.10966513397136,0.46764705882352936,0.16440458180246376,0.19431869362866813,125379.0748393022,2656.938705234167,128036.01354453636,294,0,52.57142857142857,32,3,17,39.97888300554713,0.58203125,49.621212121212125,1001.5151515151522,31.297348484848506,0
2010,4,1,3,32,0.02857142857142857,0.08571428571428572,0.9142857142857143,35,1450,1100,350,0.7586206896551724,18,11,7,381.2700266277165,0.4684523809523809,0.16300933671541884,0.19370859126364032,125663.75760445376,2582.364841597809,128246.12244605157,295,0,53.142857142857146,32,3,18,39.780096965117735,0.5849609375,49.33712121212122,1002.6515151515162,31.33285984848488,0
2011,4,3,2,33,0.08571428571428572,0.05714285714285714,0.9428571428571428,35,1250,1000,250,0.8,15,10,5,373.68595490012893,0.47090336134453786,0.15441493180186683,0.1926515674226051,126265.8147127843,2436.752308437901,128702.5670212222,296,0,49.94285714285714,32,3,16,39.348042294807364,0.5911458333333333,48.73737373737373,1005.0505050505042,31.407828282828255,0
2012,4,4,2,35,0.10810810810810811,0.05405405405405406,0.9459459459459459,37,800,600,200,0.75,10,6,4,354.80169378166437,0.472190940940941,0.16053383566673673,0.1859688134898937,126942.00857426284,1607.8479308389865,128549.85650510182,297,0,47.891891891891895,34,3,19,39.126796613506635,0.5934436274509804,48.06547619047618,1007.7380952380936,29.63935574229687,0
2013,4,0,0,35,0.0,0.0,1.0,35,650,600,50,0.9230769230769231,7,6,1,368.37149754019623,0.4698879551820729,0.1579326277333042,0.19243611236923053,126805.71697084501,2342.322371441709,129148.03934228672,298,1,51.02857142857143,32,3,19,38.92519117462703,0.5966796875,48.200757575757585,1007.1969696969713,31.474905303030354,0
2014,4,0,1,34,0.0,0.02857142857142857,0.9714285714285714,35,1050,600,450,0.5714285714285714,15,6,9,369.5550205764503,0.46918767507002807,0.16380331859595154,0.19365847795276764,126932.92018990414,2381.739586521795,129314.65977642593,299,2,52.02857142857143,32,3,19,38.76446142922776,0.5979817708333333,48.074494949494955,1007.7020202020205,31.490688131313142,0
2015,4,2,2,34,0.05555555555555555,0.05555555555555555,0.9444444444444444,36,1300,1000,300,0.7692307692307693,16,10,6,367.47446280884117,0.4676752645502646,0.1422120479380562,0.184924761086747,125268.00063775493,2006.5582482993,127274.55888605423,300,0,51.388888888888886,34,2,18,40.535438220953736,0.5762867647058824,49.73214285714285,1001.0714285714271,29.443277310924326,16
2016,4,1,1,34,0.02857142857142857,0.02857142857142857,0.9714285714285714,35,1000,700,300,0.7,13,7,6,369.23062058570645,0.46635154061624645,0.15279153835854942,0.17203889614189888,122008.85202331947,2009.8808299039642,124018.73285322344,301,0,53.65714285714286,35,0,20,43.88960481099657,0.5404761904761906,53.00925925925925,987.9629629629617,28.227513227513192,16
2017,4,5,2,37,0.1282051282051282,0.05128205128205128,0.9487179487179487,39,1250,900,350,0.72,16,9,7,338.5454229147701,0.47104138551506974,0.1800521968412847,0.16212753167727378,123183.72938368014,554.3749732081138,123738.10435688826,302,0,48.92307692307692,35,4,16,43.42099510318295,0.5526785714285714,51.82291666666664,992.7083333333298,28.363095238095138,0
2018,4,8,5,40,0.17777777777777778,0.1111111111111111,0.8888888888888888,45,1200,700,500,0.5833333333333334,17,7,10,305.5816634567919,0.4751052188552189,0.21766022380467964,0.1518638903832286,124746.06405743917,-1373.5366408780549,123372.52741656112,303,0,43.22222222222222,40,5,13,42.622287216005404,0.5598958333333333,50.254065040650396,998.9837398373969,24.974593495934922,0
2019,4,7,6,41,0.14893617021276595,0.1276595744680851,0.8723404255319149,47,1600,1300,300,0.8125,19,13,6,312.2464984353693,0.47581329016342894,0.2818619893224026,0.1558575075168885,124928.9873611828,-1591.5565460494477,123337.43081513334,304,0,40.765957446808514,43,4,18,42.267077926178544,0.5574127906976745,50.07102272727273,999.7159090909086,23.249207188160664,16
2020,4,3,0,44,0.06818181818181818,0.0,1.0,44,1100,700,400,0.6363636363636364,15,7,8,334.23843453998154,0.4744648520084567,0.3199191604027791,0.16869829648829002,125390.93017578141,-417.88618159577373,124973.04399418563,305,0,40.40909090909091,39,5,15,41.24035794765124,0.5681089743589743,49.60937500000001,1001.5625000000013,25.681089743589776,0
2021,4,4,5,43,0.08333333333333333,0.10416666666666667,0.8958333333333334,48,950,500,450,0.5263157894736842,14,5,9,310.87890773843526,0.4755466903073286,0.19250337577160437,0.15988058112262396,126165.4948620877,-1449.300901904554,124716.19396018314,306,0,37.958333333333336,42,6,17,41.02908789866254,0.5714285714285714,48.83720930232558,1004.6511627906983,23.92026578073091,14
2022,4,1,3,41,0.022727272727272728,0.06818181818181818,0.9318181818181819,44,1150,700,450,0.6086956521739131,16,7,9,328.9281501498325,0.4738702431289641,0.16260965011337647,0.1628137715178439,124578.72855450059,-454.25737113683334,124124.47118336376,307,0,41.77272727272727,41,3,13,42.212291728775384,0.5566565040650406,50.42162698412699,998.3134920634927,24.349109562524212,16
2023,4,4,5,40,0.08888888888888889,0.1111111111111111,0.8888888888888888,45,1650,1300,350,0.7878787878787878,20,13,7,329.5100108344201,0.4756313131313132,0.22277693218332462,0.16627348472981135,125381.3880316778,-735.6933397394778,124645.69469193832,308,0,41.666666666666664,40,5,15,41.36859462201929,0.56640625,49.6189024390244,1001.5243902439042,25.038109756097604,0
2024,4,2,4,38,0.047619047619047616,0.09523809523809523,0.9047619047619048,42,1000,400,600,0.4,16,4,12,398.0792414800819,0.47587591947348046,0.22505029099676044,0.19198191723635025,123482.19972468754,1442.7305070378802,124924.93023172542,309,0,42.95238095238095,38,4,12,41.6310598731592,0.5501644736842105,51.52243589743589,993.910256410255,26.155533063427765,16
2025,4,4,4,38,0.09523809523809523,0.09523809523809523,0.9047619047619048,42,1150,700,450,0.6086956521739131,16,7,9,391.7771555124435,0.47836817653890823,0.2831237442503238,0.1931581350673282,124413.08372598434,1348.4408101395215,125761.52453612386,310,0,43.26190476190476,38,4,13,40.81619904333546,0.5597587719298245,50.587606837606835,997.6495726495724,26.253936122357167,0
2026,4,5,3,40,0.11627906976744186,0.06976744186046512,0.9302325581395349,43,1500,1100,400,0.7333333333333333,19,11,8,374.1951846596446,0.4810354374307863,0.2648547101026675,0.18842466821308557,125293.9760597009,778.2616288625569,126072.23768856346,311,0,42.51162790697674,38,5,11,40.34032298225019,0.5688048245614035,49.706196581196565,1001.175213675211,26.346716149347657,0
2027,4,1,2,39,0.024390243902439025,0.04878048780487805,0.9512195121951219,41,1500,1100,400,0.7333333333333333,19,11,8,386.96708932273805,0.47568597560975606,0.2728577899172353,0.1941390507415317,125140.8053957674,1485.0746439006605,126625.88003966806,312,0,45.5609756097561,36,5,17,40.17960982930034,0.5708912037037037,49.859234234234236,1000.5630630630632,27.793418418418423,0
2028,4,4,4,39,0.09302325581395349,0.09302325581395349,0.9069767441860466,43,1050,700,350,0.6666666666666666,14,7,7,406.2886182354068,0.48172757475083056,0.2409278412148026,0.2000585727766752,124359.79618671938,1523.5347160990516,125883.33090281843,313,0,43.604651162790695,38,5,14,40.509854327335056,0.5592105263157895,50.64102564102565,997.4358974358984,26.248313090418378,15
2029,4,4,2,41,0.09302325581395349,0.046511627906976744,0.9534883720930233,43,1300,900,400,0.6923076923076923,17,9,8,391.5402885046234,0.4826734957548911,0.26354670134845515,0.19669974810291618,125197.1497468752,1207.2329373492269,126404.38268422443,314,0,44.02325581395349,36,7,18,40.00670454971681,0.5714699074074074,49.802927927927925,1000.7882882882878,27.799674674674662,0
2030,4,1,3,39,0.023809523809523808,0.07142857142857142,0.9285714285714286,42,1250,700,550,0.56,18,7,11,356.88648918573125,0.4838850174216028,0.1844905559989365,0.17265589611958307,123614.96913580217,426.15582925264124,124041.12496505481,315,0,44.73809523809524,38,4,19,42.51629422718808,0.5515350877192983,51.38888888888887,994.4444444444418,26.169590643274784,15
2031,4,7,7,39,0.15217391304347827,0.15217391304347827,0.8478260869565217,46,1350,1000,350,0.7407407407407407,17,10,7,335.54556109947816,0.4857085346215781,0.24546347515897193,0.16897833346386887,125297.796201814,-782.6955782312998,124515.1006235827,316,0,39.891304347826086,41,5,13,41.30375544986127,0.5640243902439024,49.70238095238095,1001.1904761904757,24.41927990708477,0
2032,4,3,2,40,0.07142857142857142,0.047619047619047616,0.9523809523809523,42,1250,900,350,0.72,16,9,7,382.6815557953446,0.48596593108788233,0.19146343431734913,0.18765177010219344,124184.89171181305,1248.591296757304,125433.48300857036,317,0,43.523809523809526,36,6,16,41.28064625466048,0.5610532407407407,50.816441441441434,996.7342342342333,27.687062062062036,15
2033,4,6,4,42,0.13043478260869565,0.08695652173913043,0.9130434782608696,46,800,300,500,0.375,13,3,10,349.28376343524,0.4870571658615137,0.21615765327809133,0.17690815087138334,125535.48216713355,-419.8336427643656,125115.64852436919,318,0,40.32608695652174,36,10,13,40.71431246956587,0.5749421296296297,49.4650900900901,1002.1396396396412,27.837212212212258,0
2034,4,7,9,40,0.14285714285714285,0.1836734693877551,0.8163265306122449,49,1100,600,500,0.5454545454545454,16,6,10,334.33508640120186,0.4847647392290249,0.27272727272727226,0.17588932806324112,127092.013888889,-1298.6544821848784,125793.35940670413,319,0,38.61224489795919,37,12,17,39.488636363636346,0.5889639639639639,47.91666666666667,1008.3333333333344,27.25225225225228,0
2035,4,1,2,39,0.024390243902439025,0.04878048780487805,0.9512195121951219,41,1150,800,350,0.6956521739130435,15,8,7,380.9420451764605,0.4817835365853658,0.27544899177805315,0.19715421636325592,126424.48992768594,1432.0807506887013,127856.57067837464,320,0,44.926829268292686,32,9,18,39.00188323917138,0.5927734375,48.57954545454545,1005.681818181818,31.427556818181813,0
2036,4,4,5,38,0.09302325581395349,0.11627906976744186,0.8837209302325582,43,1050,800,250,0.7619047619047619,13,8,5,355.12265993778226,0.4805970837947582,0.261609393385025,0.1880752675585542,127362.24666950101,447.6015957347002,127809.8482652357,321,0,42.0,34,9,15,38.68724692377247,0.5977328431372548,47.64880952380952,1009.4047619047609,29.688375350140028,0
2037,4,2,2,38,0.05,0.05,0.95,40,1300,800,500,0.6153846153846154,18,8,10,367.1808772766714,0.4797943376068376,0.2399612209156865,0.19438701542713316,127346.77105652483,1351.8598229772406,128698.63087950207,322,0,45.3,32,8,15,38.39885122174963,0.6022135416666667,47.66414141414141,1009.3434343434342,31.541982323232318,0
2038,4,0,3,35,0.0,0.07894736842105263,0.9210526315789473,38,1200,800,400,0.6666666666666666,16,8,8,386.64076010389334,0.4778775486012328,0.25169318645450844,0.20275064249350483,126960.75439453113,2217.640516493039,129178.39491102417,323,2,48.68421052631579,31,7,21,38.305340223944874,0.6008064516129032,48.04687499999999,1007.8124999999991,32.51008064516126,0
2039,4,0,4,31,0.0,0.11428571428571428,0.8857142857142857,35,1050,500,550,0.47619047619047616,16,5,11,391.4065561024295,0.4752100840336135,0.12514956322244797,0.18670807729223138,123016.50995110052,2850.230614802601,125866.74056590312,324,3,48.22857142857143,33,2,20,42.284203211859186,0.555239898989899,51.99142156862745,992.0343137254902,30.0616458704694,16
2040,4,8,5,34,0.20512820512820512,0.1282051282051282,0.8717948717948718,39,750,600,150,0.8,9,6,3,335.30129800726087,0.4817251461988304,0.14555342560612106,0.16644466068382233,124698.646759099,569.539898605354,125268.18665770435,325,0,43.282051282051285,37,2,16,41.929113148168504,0.5644707207207207,50.3015350877193,998.7938596491232,26.99442863916549,0
2041,4,5,1,38,0.1282051282051282,0.02564102564102564,0.9743589743589743,39,1250,800,450,0.64,17,8,9,350.55014915154777,0.4817251461988304,0.16467634929173358,0.16821701788144733,123269.91705246909,1341.995280064799,124611.91233253389,326,0,44.15384615384615,35,4,17,43.03321678321676,0.5535714285714286,51.73611111111111,993.0555555555552,28.373015873015863,16
2042,4,6,3,41,0.13636363636363635,0.06818181818181818,0.9318181818181819,44,1550,900,650,0.5806451612903226,22,9,13,323.2398886673757,0.48501365398167723,0.19215807765054516,0.15377140876292442,122900.15373000511,-508.49588217258855,122391.65784783252,327,0,39.97727272727273,40,4,20,44.09590550374091,0.5408854166666667,52.10873983739837,991.5650406504051,24.789126016260127,16
2043,4,7,4,44,0.14583333333333334,0.08333333333333333,0.9166666666666666,48,1500,1300,200,0.8666666666666667,17,13,4,294.6727045297049,0.4861388150118204,0.2449982602644405,0.14551363450487487,124479.70920138877,-2263.8351582639375,122215.87404312483,328,0,37.270833333333336,41,7,15,43.169363256784976,0.555640243902439,50.52083333333333,997.9166666666657,24.33943089430892,0
2044,4,4,2,46,0.08333333333333333,0.041666666666666664,0.9583333333333334,48,1000,500,500,0.5,15,5,10,300.94573696471343,0.4845042848699764,0.2687743930674078,0.15029391165165432,124950.40174634676,-2079.3418524817243,122871.05989386504,329,0,37.958333333333336,41,7,17,42.52745253687903,0.5604674796747968,50.04960317460318,999.8015873015879,24.385404568331413,0
2045,4,5,8,43,0.09803921568627451,0.1568627450980392,0.8431372549019608,51,1400,900,500,0.6428571428571429,19,9,10,295.3471815984368,0.4863562091503268,0.3015113021952964,0.15067712145954168,125834.72222222235,-2767.0138888888782,123067.70833333347,330,0,36.627450980392155,44,7,17,41.758374861572534,0.5653409090909092,49.16666666666667,1003.3333333333344,22.803030303030326,0
2046,4,3,5,41,0.06521739130434782,0.10869565217391304,0.8913043478260869,46,1550,1000,550,0.6451612903225806,21,10,11,351.49020607890515,0.4855776972624799,0.2404965301178481,0.17018400038749454,123649.5008680558,-403.86284722219705,123245.6380208336,331,0,39.82608695652174,39,7,14,42.61450914676721,0.5502136752136753,51.35416666666668,994.5833333333353,25.502136752136803,16
2047,4,5,3,43,0.10869565217391304,0.06521739130434782,0.9347826086956522,46,1550,1000,550,0.6451612903225806,21,10,11,351.332150748994,0.484933574879227,0.2619134065535078,0.17349288681316313,124479.70920138895,-452.4739583333286,124027.23524305562,332,0,40.17391304347826,37,9,17,41.75582811412664,0.5622184684684685,50.520833333333336,997.9166666666672,26.970720720720735,0
2048,4,1,3,41,0.022727272727272728,0.06818181818181818,0.9318181818181819,44,900,500,400,0.5555555555555556,13,5,8,358.3837252929197,0.48546511627906974,0.2605775051040822,0.1769157765916749,124465.66234731372,121.2935486162051,124586.95589592992,333,0,42.20454545454545,36,8,18,41.59448707820788,0.5639467592592593,50.53490990990992,997.8603603603618,27.718343343343385,0
2049,4,2,2,41,0.046511627906976744,0.046511627906976744,0.9534883720930233,43,1500,1200,300,0.8,18,12,6,367.55028481084616,0.4844499815430048,0.2876475915452048,0.18458890687363896,125183.89111159173,605.7085096997379,125789.59962129146,334,0,43.604651162790695,33,10,20,40.620662911258066,0.5776515151515151,49.81617647058824,1000.7352941176473,30.325311942959008,0
2050,4,5,5,41,0.10869565217391304,0.10869565217391304,0.8913043478260869,46,1150,700,450,0.6086956521739131,16,7,9,349.27516631942154,0.4831924315619968,0.3114498915232471,0.18171253996292136,126638.21549590131,-353.68324405486464,126284.53225184645,335,0,41.391304347826086,36,10,17,39.57820541508168,0.5862268518518519,48.36711711711712,1006.5315315315316,27.959209209209213,0
2051,4,1,5,37,0.023809523809523808,0.11904761904761904,0.8809523809523809,42,1050,500,550,0.47619047619047616,16,5,11,375.4896173894314,0.48011033681765386,0.30731814910264443,0.19398720535660544,126351.67363514031,1088.7483179546257,127440.42195309493,336,0,45.333333333333336,33,9,17,39.21410287664552,0.5896464646464646,48.65196078431372,1005.392156862745,30.466428995840758,0
2052,4,1,1,37,0.02631578947368421,0.02631578947368421,0.9736842105263158,38,1150,1000,150,0.8695652173913043,13,10,3,405.84428366200495,0.48131519677572304,0.312600001409711,0.2074222632514846,125908.90429890732,2619.8818143715903,128528.78611327891,337,0,49.31578947368421,30,8,21,38.90981429400472,0.5927083333333334,49.092741935483865,1003.629032258064,33.454301075268795,0
2053,4,0,0,37,0.0,0.0,1.0,37,1100,700,400,0.6363636363636364,15,7,8,414.8311495323688,0.48066816816816815,0.31283428460289797,0.21199221262524004,125904.40779320977,3045.814043209859,128950.22183641963,338,1,51.37837837837838,29,8,21,38.688993449580224,0.5955459770114943,49.097222222222214,1003.6111111111103,34.60727969348656,0
2054,4,2,0,39,0.05128205128205128,0.0,1.0,39,950,600,350,0.631578947368421,13,6,7,395.28834315955885,0.4807973459289249,0.3103344422084413,0.20623260911917934,126753.41802520529,2220.9068806927025,128974.32490589799,339,0,49.69230769230769,30,9,22,38.30141039330843,0.6013888888888889,48.252688172043015,1006.9892473118284,33.56630824372761,0
2055,4,2,1,40,0.04878048780487805,0.024390243902439025,0.975609756097561,41,1100,800,300,0.7272727272727273,14,8,6,373.5867079578651,0.4817327235772358,0.2926451807721584,0.198138942100225,127420.45932345935,1320.9696268343632,128741.42895029372,340,0,48.21951219512195,31,10,17,38.161486544579134,0.605510752688172,47.59114583333334,1009.6354166666679,32.56888440860219,0
2056,4,1,3,38,0.024390243902439025,0.07317073170731707,0.926829268292683,41,1000,800,200,0.8,12,8,4,375.3123371521922,0.48099593495934956,0.2997126490986486,0.1997032312501173,127551.95617675793,1374.3645562066126,128926.32073296454,341,0,49.19512195121951,31,10,18,37.98283492309014,0.6068548387096775,47.46093750000001,1010.1562500000009,32.585685483870996,0
2057,4,0,1,37,0.0,0.02631578947368421,0.9736842105263158,38,1100,700,400,0.6363636363636364,15,7,8,391.18004877688816,0.4784850640113798,0.281654962716281,0.20758240544583773,127442.37075617285,2370.5825617283926,129812.95331790125,342,1,52.0,29,9,18,37.694864740944496,0.6113505747126438,47.56944444444444,1009.7222222222224,34.81800766283526,0
2058,4,1,0,38,0.02631578947368421,0.0,1.0,38,1650,1200,450,0.7272727272727273,21,12,9,382.52948136682113,0.4769736842105263,0.2558583032429833,0.20538158540005763,127913.92220391172,2186.169264051655,130100.09146796337,343,0,51.86842105263158,31,7,19,37.4288035783241,0.6105510752688172,47.102864583333336,1011.588541666667,32.63188844086022,0
2059,4,1,2,37,0.02564102564102564,0.05128205128205128,0.9487179487179487,39,1050,500,550,0.47619047619047616,16,5,11,374.9780884723755,0.4765519568151147,0.2551450406603617,0.203524824261572,128348.74561004146,1826.008835482792,130174.75444552425,344,0,51.51282051282051,30,9,22,37.174194190210926,0.6177083333333333,46.673387096774185,1013.3064516129018,33.77688172043006,0
2060,4,0,3,34,0.0,0.08108108108108109,0.9189189189189189,37,1000,500,500,0.5,15,5,10,390.05766581361854,0.4750688188188188,0.2495816890815059,0.19459941162334435,124908.10513083887,2545.348235181322,127453.4533660202,345,1,54.567567567567565,33,4,20,40.34405520820564,0.5748106060606061,50.09191176470587,999.6323529411745,30.291889483065894,15
2061,4,3,4,33,0.08108108108108109,0.10810810810810811,0.8918918918918919,37,1100,800,300,0.7272727272727273,14,8,6,380.2338620579516,0.4743180680680681,0.22138269739327576,0.19318215602061348,125663.75760445338,2156.3569660210633,127820.11457047444,244,0,43.2972972972973,32,5,20,39.80606976451329,0.5849609375,49.3371212121212,1002.6515151515131,31.332859848484784,0
2062,4,4,1,36,0.10810810810810811,0.02702702702702703,0.972972972972973,37,1100,800,300,0.7272727272727273,14,8,6,372.0801465083791,0.4733483483483483,0.232634863709116,0.1915505330623854,126207.32837253138,1992.9960883134381,128200.32446084481,245,0,43.486486486486484,31,6,24,39.44875491339469,0.5930779569892473,48.795572916666664,1004.8177083333326,32.41347446236556,0
2063,4,1,3,34,0.02702702702702703,0.08108108108108109,0.9189189189189189,37,1050,700,350,0.6666666666666666,14,7,7,372.62353895513525,0.4733483483483483,0.23049438147198043,0.19275094382789776,126403.65812513581,2020.1956854926466,128423.85381062847,246,0,44.351351351351354,31,6,21,39.232514351072545,0.5950940860215054,48.60026041666668,1005.5989583333348,32.438676075268866,0
2064,4,6,7,33,0.15,0.175,0.825,40,1000,600,400,0.6,14,6,8,341.12431209393776,0.4736511752136752,0.1937666909444038,0.18083539787836955,127401.12727076138,693.793581706306,128094.9208524677,247,0,41.325,33,7,14,39.000667637776154,0.6003787878787878,47.610294117647065,1009.5588235294128,30.59269162210342,0
2065,4,4,3,34,0.10810810810810811,0.08108108108108109,0.9189189189189189,37,950,600,350,0.631578947368421,13,6,7,354.57040616339134,0.4724724724724725,0.19453103341019262,0.18771098191193056,127346.77105652496,1630.6792674217018,128977.45032394666,248,0,38.86486486486486,32,5,15,38.717058627303786,0.6022135416666667,47.66414141414142,1009.3434343434353,31.541982323232354,0
2066,4,8,3,39,0.19047619047619047,0.07142857142857142,0.9285714285714286,42,900,600,300,0.6666666666666666,12,6,6,374.62599748442784,0.4760210994967093,0.28418049279282287,0.19021162896893978,125637.3845271776,1360.46491411732,126997.84944129491,249,0,35.04761904761905,35,7,18,39.97392826906796,0.5779761904761904,49.363425925925924,1002.546296296296,28.644179894179885,15
2067,4,0,3,36,0.0,0.07692307692307693,0.9230769230769231,39,1300,800,500,0.6153846153846154,18,8,10,395.8434741033106,0.47345928924876296,0.30269075682382174,0.20034526852575713,125505.56065707578,2136.1114299561264,127641.67208703191,250,1,38.51282051282051,32,7,18,39.578870547715056,0.5833333333333333,49.494949494949495,1002.0202020202017,31.313131313131304,0
2068,4,3,1,38,0.07692307692307693,0.02564102564102564,0.9743589743589743,39,1050,600,450,0.5714285714285714,15,6,9,389.34331099038985,0.4726720647773279,0.3033296602032465,0.20041358789531194,126202.37252576271,2028.3617424242461,128230.73426818695,251,0,38.743589743589745,32,7,21,39.02022074223004,0.5904947916666667,48.80050505050505,1004.79797979798,31.399936868686876,0
2069,4,3,0,41,0.07317073170731707,0.0,1.0,41,900,600,300,0.6666666666666666,12,6,6,368.14425244177295,0.47256097560975613,0.2987300947389635,0.19367588932806323,127092.01388888898,1160.7635700438827,128252.77745893286,252,0,37.34146341463415,34,7,22,38.63636363636362,0.5949754901960784,47.91666666666667,1008.3333333333342,29.656862745098064,0
2070,4,1,2,40,0.023809523809523808,0.047619047619047616,0.9523809523809523,42,1650,1100,550,0.6666666666666666,22,11,11,356.39024310145237,0.4725125822686798,0.2852476463364717,0.18925775234693681,127471.58893014833,685.9261134687945,128157.51504361712,253,0,37.42857142857143,35,7,18,38.54309933142311,0.5967261904761905,47.54050925925926,1009.837962962963,28.85251322751323,0
2071,4,0,2,38,0.0,0.05,0.95,40,1550,1300,250,0.8387096774193549,18,13,5,365.33727630188775,0.4711672008547008,0.26827557755775566,0.19420560477100332,127512.49999999988,1317.0138888888753,128829.51388888876,254,2,38.575,34,6,18,38.27523377337733,0.5992647058823529,47.49999999999999,1009.9999999999991,29.70588235294115,0
2072,4,2,1,39,0.05,0.025,0.975,40,1250,900,350,0.72,16,9,7,351.307413057272,0.4719684829059829,0.20311575139756655,0.17600096262062043,125082.25036790186,788.4643592259365,125870.7147271278,255,0,39.425,37,3,18,41.132188790237116,0.5684121621621622,49.91776315789475,1000.3289473684226,27.035917496443854,15
2073,4,3,2,40,0.07142857142857142,0.047619047619047616,0.9523809523809523,42,1000,700,300,0.7,13,7,6,343.39023045756335,0.47103658536585363,0.23763071023345006,0.1756320732849832,125939.25781250015,249.2621527777926,126188.51996527794,256,0,38.38095238095238,39,3,19,40.445551404455514,0.5737179487179487,49.06250000000001,1003.7500000000011,25.737179487179517,0
2074,4,2,1,41,0.047619047619047616,0.023809523809523808,0.9761904761904762,42,1450,900,550,0.6206896551724138,20,9,11,349.13181062112096,0.47172619047619047,0.25700636942675215,0.18150229889905933,126607.70052596959,440.59854741944685,127048.29907338903,257,0,33.714285714285715,38,4,16,39.613190021231446,0.5822368421052632,48.39743589743589,1006.410256410255,26.484480431848816,0
2075,4,1,0,42,0.023809523809523808,0.0,1.0,42,1500,900,600,0.6,21,9,12,346.8470399810395,0.47143583042973286,0.2366856374420674,0.18166869526740623,126912.74957242682,403.8623050102146,127316.61187743704,258,0,30.952380952380953,40,2,17,39.35724491511179,0.58203125,48.094512195121936,1007.6219512195097,25.19054878048774,0
2076,4,2,1,43,0.045454545454545456,0.022727272727272728,0.9772727272727273,44,1450,1000,450,0.6896551724137931,19,10,9,343.3619771950308,0.4710183227625088,0.26729906007815507,0.1831200956992299,127644.04432508674,-33.998164289717465,127610.04616079702,259,0,30.5,39,5,15,38.69543088341408,0.5910790598290598,47.369791666666664,1010.5208333333328,25.910790598290586,0
2077,4,1,4,40,0.022727272727272728,0.09090909090909091,0.9090909090909091,44,1350,900,450,0.6666666666666666,18,9,9,343.41688981710286,0.4702585447498238,0.2731611736334405,0.1841425047122741,127861.72251966425,-18.024985127896798,127843.69753453636,260,0,31.25,40,4,16,38.47132904608788,0.5916666666666667,47.15447154471545,1011.3821138211384,25.28455284552846,0
2078,4,1,2,39,0.024390243902439025,0.04878048780487805,0.9512195121951219,41,800,300,500,0.375,13,3,10,360.28413281122687,0.47184959349593497,0.2682529895712318,0.19228366254320098,127673.13169677218,999.7207073330342,128672.85240410522,261,0,33.19512195121951,37,4,17,38.23810621677335,0.5948761261261262,47.34100877192983,1010.6359649122815,27.31448553816977,0
2079,4,1,2,38,0.025,0.05,0.95,40,1450,900,550,0.6206896551724138,20,9,11,369.58663490730856,0.470045405982906,0.271458008465137,0.19774426747305235,127774.23327043265,1444.729780456139,129218.9630508888,262,0,34.775,36,4,19,37.8993558327764,0.5978009259259259,47.240990990990994,1011.0360360360365,28.084334334334347,0
2080,4,1,0,39,0.02564102564102564,0.0,1.0,39,1000,500,500,0.5,15,5,10,374.68787643726125,0.471097615834458,0.27407718288466554,0.20089981004674876,127859.63909433075,1781.4913308578766,129641.13042518863,263,0,34.743589743589745,36,3,20,37.68279330438331,0.5986689814814814,47.15653153153153,1011.3738738738733,28.093718718718705,0
2081,4,2,1,40,0.04878048780487805,0.024390243902439025,0.975609756097561,41,1250,800,450,0.64,17,8,9,370.8666990549485,0.4711636178861789,0.29168641192351763,0.20257103446864294,128601.01814229773,1339.4010987338752,129940.4192410316,264,0,34.0,36,5,17,37.02028052255654,0.6061921296296297,46.42454954954955,1014.3018018018021,28.175050050050057,0
2082,4,0,2,38,0.0,0.05,0.95,40,1250,800,450,0.64,17,8,9,399.58397352900795,0.4704861111111111,0.31276086422784233,0.1977527975921808,124571.4463787965,2087.974884691328,126659.42126348783,265,1,35.85,33,7,17,40.45646124887472,0.5713383838383839,50.428921568627445,998.2843137254894,30.251039809863315,15
2083,4,2,0,40,0.05,0.0,1.0,40,1600,1000,600,0.625,22,10,12,401.9667145575673,0.47222222222222227,0.31894168875425977,0.20144100439213197,125094.71490472912,2057.518206602039,127152.23311133115,266,0,36.05,32,8,19,39.85232866338509,0.5791015625,49.90530303030303,1000.378787878788,31.261837121212125,0
2084,4,1,1,40,0.024390243902439025,0.024390243902439025,0.975609756097561,41,1400,1100,300,0.7857142857142857,17,11,6,407.57624107905076,0.4741615853658536,0.3067702391945968,0.19263340236262524,122621.71550605551,1972.0920325065863,124593.80753856209,267,0,36.146341463414636,33,8,15,42.29769858945805,0.5511363636363636,52.38970588235295,990.4411764705894,30.013368983957257,16
2085,4,10,8,42,0.2,0.16,0.84,50,1450,900,550,0.6206896551724138,20,9,11,352.0833333333334,0.48238095238095235,0.3125000000000002,0.17604166666666682,125000.0000000001,-1160.1607554786474,123839.83924452146,268,0,30.42,38,12,17,41.19791666666668,0.5657894736842105,50.00000000000001,1000.0000000000008,26.31578947368423,0
2086,4,5,3,44,0.10638297872340426,0.06382978723404255,0.9361702127659575,47,1000,500,500,0.5,15,5,10,360.33949832770895,0.48117098365710764,0.33642255362243256,0.1810252753893923,125197.1497468753,-377.30437363037817,124819.84537324491,269,0,32.59574468085106,36,11,20,40.78733918457672,0.5714699074074074,49.80292792792793,1000.7882882882886,27.799674674674684,0
2087,4,3,2,45,0.06382978723404255,0.0425531914893617,0.9574468085106383,47,1600,900,700,0.5625,23,9,14,356.18175287888783,0.48007246376811596,0.34245408991722903,0.18118121867799267,125713.73523584177,-444.6122845490939,125269.12295129268,270,0,32.8936170212766,37,10,20,40.357351118886214,0.5748873873873874,49.28728070175438,1002.8508771929822,27.104077761972494,0
2088,4,3,2,46,0.0625,0.041666666666666664,0.9583333333333334,48,1000,600,400,0.6,14,6,8,388.59238491733987,0.4798869680851064,0.24864398422090717,0.19506568232979335,125164.52778739609,592.6193636503491,125757.14715104643,271,0,32.0,37,11,19,40.11432537073563,0.5692567567567568,49.83552631578947,1000.6578947368419,27.044807965860592,16
2089,4,2,1,47,0.041666666666666664,0.020833333333333332,0.9791666666666666,48,1350,900,450,0.6666666666666666,18,9,9,337.10335307386936,0.4790096778959811,0.2896148989898999,0.16141301729537036,123177.42415229023,-1222.0998604064125,121955.32429188382,272,0,32.895833333333336,40,8,13,43.463349713349736,0.54375,51.829268292682926,992.6829268292677,24.817073170731692,16
2090,4,7,0,54,0.12962962962962962,0.0,1.0,54,1750,1400,350,0.8,21,14,7,317.01969912395447,0.48131405776846026,0.3462477296444344,0.15287593107260938,123478.49555502973,-1760.4550940222134,121718.04046100752,273,0,30.074074074074073,42,12,17,43.649052679470934,0.5438988095238095,51.526162790697676,993.8953488372092,23.664174972314505,16
2091,4,6,8,52,0.1,0.13333333333333333,0.8666666666666667,60,1700,1100,600,0.6470588235294118,23,11,12,285.3677128551803,0.48365701506591335,0.3509334817012857,0.14142488122381752,124629.90397805237,-4883.1740857772575,119746.72989227512,274,0,27.966666666666665,44,16,14,43.24674672354103,0.553030303030303,50.37037037037038,998.5185185185205,22.693602693602738,0
2092,4,4,5,51,0.07142857142857142,0.08928571428571429,0.9107142857142857,56,1750,800,950,0.45714285714285713,27,8,19,301.7443906994475,0.48319805194805193,0.33338160591747634,0.146258047863434,123695.79564816899,-3726.573410791133,119969.22223737786,275,0,29.589285714285715,46,10,15,43.80347117012742,0.5409873188405797,51.30762411347517,994.7695035460983,21.62542399013257,16
2093,4,2,2,51,0.03773584905660377,0.03773584905660377,0.9622641509433962,53,2100,1600,500,0.7619047619047619,26,16,10,316.3154553275698,0.4809960087082728,0.3315897801227916,0.15411599869222287,123914.40436385472,-2760.7917524005356,121153.61261145418,276,0,31.0188679245283,44,9,18,43.21449052977467,0.5456912878787878,51.08796296296297,995.6481481481491,22.628367003367025,0
2094,4,9,9,51,0.15,0.15,0.85,60,1400,800,600,0.5714285714285714,20,8,12,292.63136297570924,0.48496351224105466,0.35888126204238957,0.14889772292587555,125725.6878806973,-4632.240518059541,121093.44736263776,277,0,28.0,45,15,16,41.93837307321773,0.5629629629629629,49.27536231884058,1002.8985507246373,22.286634460547496,0
2095,4,1,3,49,0.019230769230769232,0.057692307692307696,0.9423076923076923,52,1350,800,550,0.5925925925925926,19,8,11,326.09435830493584,0.4826860231271996,0.3500283408660376,0.1624800585293289,124854.69341535967,-2257.117773871756,122597.57564148791,278,0,32.36538461538461,42,10,19,41.99772962316593,0.5580357142857143,50.145348837209305,999.4186046511629,23.795681063122927,0
2096,4,5,5,49,0.09259259259259259,0.09259259259259259,0.9074074074074074,54,1600,1000,600,0.625,22,10,12,312.37138416277105,0.4858781737712556,0.3572548009317402,0.15904359062807885,125752.09690110272,-2943.5596756505042,122808.53722545221,279,0,31.59259259259259,42,12,21,41.416288281325485,0.5672123015873016,49.24903100775194,1003.0038759689924,23.88104466592839,0
2097,4,3,3,49,0.057692307692307696,0.057692307692307696,0.9423076923076923,52,1150,700,450,0.6086956521739131,16,7,9,312.9415717392458,0.48479135243841126,0.34034350739125774,0.16088516123915378,126151.14239763659,-2503.0605620698557,123648.08183556673,138,0,27.98076923076923,38,14,24,40.99201495976459,0.5775767543859649,48.85149572649571,1004.5940170940155,26.43668466036883,0
2098,4,0,2,47,0.0,0.04081632653061224,0.9591836734693877,49,1300,900,400,0.6923076923076923,17,9,8,329.95677627677117,0.4856327947845805,0.33532989915542943,0.16908311358489087,126017.68798828126,-1483.9219835069448,124533.76600477433,139,1,29.714285714285715,39,10,24,40.70194435799009,0.5745192307692308,48.984375,1004.0625000000001,25.74519230769231,0
2099,4,5,5,47,0.09615384615384616,0.09615384615384616,0.9038461538461539,52,1050,700,350,0.6666666666666666,14,7,7,301.24666688345496,0.4851212921065862,0.30971619106699766,0.15828214700656065,127040.78260294761,-2745.8721111720834,124294.91049177553,140,0,27.153846153846153,40,12,20,40.37508400537635,0.5833333333333333,47.96747967479673,1008.1300813008099,25.203252032520247,0
2100,4,3,6,44,0.06,0.12,0.88,50,1600,1200,400,0.75,20,12,8,312.62783865071236,0.4841326530612245,0.24653734238603286,0.15540949934854625,124757.86930623176,-2123.500150541901,122634.36915568986,141,0,27.98,42,8,16,42.43412544455222,0.5570436507936508,50.24224806201551,999.0310077519393,23.786452565522364,16
2101,4,2,0,46,0.043478260869565216,0.0,1.0,46,1150,700,450,0.6086956521739131,16,7,9,338.2684299294558,0.4862218196457327,0.247878044082934,0.1562861327617911,121643.77112044768,-886.0026420163348,120757.76847843135,142,0,30.456521739130434,40,6,15,45.03665739500703,0.5278645833333333,53.37906504065042,986.4837398374,24.662093495935,16
2102,4,13,16,43,0.22033898305084745,0.2711864406779661,0.728813559322034,59,1700,1200,500,0.7058823529411765,22,12,10,297.22445861198986,0.4902347555036041,0.3109624235254975,0.14575124521240387,124186.11176748604,-4325.087931954668,119861.02383553138,143,0,24.52542372881356,45,14,10,43.40883618078275,0.5472222222222223,50.81521739130436,996.7391304347844,22.149758454106323,0
2103,4,6,2,47,0.12244897959183673,0.04081632653061224,0.9591836734693877,49,1350,900,450,0.6666666666666666,18,9,9,300.0777125417312,0.4900793650793651,0.13849140016042405,0.14308426550809586,122999.14301658161,-2182.2058138590987,120816.93720272252,144,0,28.857142857142858,41,8,17,44.56726922692271,0.5403963414634146,52.00892857142857,991.9642857142854,24.194250871080133,16
2104,4,5,10,42,0.09615384615384616,0.19230769230769232,0.8076923076923077,52,1350,800,550,0.5925925925925926,19,8,11,298.6879834451631,0.4906359979889392,0.21207685577764268,0.1465237618359753,124201.85953556014,-2969.2522599279564,121232.60727563218,145,0,27.903846153846153,42,10,12,43.35609669161723,0.5513392857142857,50.79941860465118,996.8023255813985,23.73338870431901,0
2105,4,3,0,45,0.06666666666666667,0.0,1.0,45,1350,800,550,0.5925925925925926,19,8,11,319.4972076819385,0.4911826599326599,0.22240818224081815,0.15583639313465955,123960.50347222206,-1078.9930555555748,122881.51041666648,146,0,31.77777777777778,38,7,18,43.087517433751756,0.5550986842105263,51.04166666666666,995.833333333332,26.20614035087716,0
2106,4,7,4,48,0.1346153846153846,0.07692307692307693,0.9230769230769231,52,1250,600,650,0.48,19,6,13,307.4983284429515,0.49294557566616387,0.28374972605741955,0.14990543511593857,123938.43368039814,-2235.293040465789,121703.14063993236,147,0,28.365384615384617,46,6,18,43.409084164292494,0.5434782608695652,51.063829787234035,995.744680851062,21.646623496762217,16
2107,4,6,13,41,0.1111111111111111,0.24074074074074073,0.7592592592592593,54,1300,900,400,0.6923076923076923,17,9,8,294.02039315536956,0.4933758443978569,0.31572736129979506,0.1466841111139267,124907.42455418402,-3454.926125648207,121452.49842853581,148,0,27.055555555555557,44,10,15,42.74480517475609,0.5558712121212122,50.0925925925926,999.6296296296314,22.718855218855257,0
2108,4,11,9,43,0.21153846153846154,0.17307692307692307,0.8269230769230769,52,1600,1300,300,0.8125,19,13,6,319.8440952569098,0.49135872297637007,0.3332501178331475,0.1628650868973447,125756.34901258694,-2355.4119847929433,123400.937027794,149,0,27.21153846153846,39,13,16,41.22453439263335,0.5718482905982907,49.24479166666667,1003.0208333333345,25.718482905982935,0
2109,4,3,4,42,0.06521739130434782,0.08695652173913043,0.9130434782608696,46,950,600,350,0.631578947368421,13,6,7,350.6673436261174,0.48938204508856686,0.34022571109762545,0.1758086162965251,125112.6379758136,-425.4167173930748,124687.22125842053,150,0,30.891304347826086,36,10,23,41.1167548401621,0.5706018518518519,49.887387387387385,1000.45045045045,27.79029029029028,0
2110,4,4,6,40,0.08695652173913043,0.13043478260869565,0.8695652173913043,46,1150,800,350,0.6956521739130435,15,8,7,335.0504124464572,0.48838566827697266,0.30184910140714094,0.17082427328066876,125808.59510633697,-769.5556640624832,125039.03944227449,151,0,28.67391304347826,39,7,18,40.789399681583774,0.5723824786324787,49.19270833333334,1003.229166666668,25.72382478632482,0
2111,4,2,6,36,0.047619047619047616,0.14285714285714285,0.8571428571428572,42,1450,900,550,0.6206896551724138,20,9,11,404.1782648256262,0.48825251645373596,0.24859539191399116,0.19454799948480622,123400.42058528119,1879.634910987841,125280.05549626902,152,0,32.095238095238095,36,6,18,41.5651327968567,0.5529513888888888,51.604729729729726,993.5810810810808,27.599474474474466,16
2112,4,4,5,35,0.1,0.125,0.875,40,1300,800,500,0.6153846153846154,18,8,10,395.0543524646766,0.4878739316239316,0.30598885793871844,0.19428015415728628,124306.52006172849,1825.3708381805338,126131.89089990902,153,0,32.275,32,8,18,40.845519962859804,0.5709635416666667,50.69444444444445,997.222222222223,31.163194444444468,0
2113,4,3,2,36,0.07894736842105263,0.05263157894736842,0.9473684210526316,38,1300,700,600,0.5384615384615384,19,7,12,385.6578557277794,0.486782835467046,0.2594474403689213,0.19297967360554213,125032.55420260955,2045.8863623348236,127078.44056494438,154,0,29.44736842105263,31,7,22,40.3247461268064,0.580981182795699,49.967447916666664,1000.1302083333329,32.262264784946225,0
2114,4,2,2,36,0.05263157894736842,0.05263157894736842,0.9473684210526316,38,1700,1400,300,0.8235294117647058,20,14,6,373.73850547456703,0.48510846372688476,0.2488137641930379,0.19049958940316336,125797.83767060736,1803.0991685889887,127600.93683919635,155,0,28.44736842105263,33,5,18,39.8301978988517,0.5839646464646464,49.20343137254901,1003.1862745098031,30.399584076054637,0
2115,4,1,2,35,0.02702702702702703,0.05405405405405406,0.9459459459459459,37,1450,800,650,0.5517241379310345,21,8,13,384.8371270991455,0.4849537037037037,0.2511687684665418,0.19672477963415486,125917.07996951841,2291.513461636565,128208.59343115498,156,0,29.972972972972972,32,5,19,39.428439636012904,0.5875651041666667,49.08459595959596,1003.661616161616,31.3644255050505,0
2116,4,3,6,32,0.07894736842105263,0.15789473684210525,0.8421052631578947,38,1350,1100,250,0.8148148148148148,16,11,5,367.779450644798,0.4851825509720247,0.2038835555887588,0.1912181719404134,126612.30867346936,1713.0810657596307,128325.389739229,157,0,28.789473684210527,34,4,13,39.1392634650264,0.5900735294117647,48.39285714285714,1006.4285714285712,29.600840336134446,0
2117,4,2,1,33,0.058823529411764705,0.029411764705882353,0.9705882352941176,34,1100,900,200,0.8181818181818182,13,9,4,399.1888081539769,0.4835115864527629,0.19918372808778217,0.2050266641467129,126111.33015738828,3268.4463160481127,129379.77647343639,158,0,27.823529411764707,30,4,23,38.86714394040768,0.5947916666666666,48.89112903225807,1004.4354838709689,33.48118279569896,0
2118,4,0,1,32,0.0,0.030303030303030304,0.9696969696969697,33,1200,900,300,0.75,15,9,6,413.9243002411202,0.48338857323232326,0.14692114077333196,0.2014291072783808,123863.27319675016,3654.003736707895,127517.27693345805,159,1,27.757575757575758,31,2,19,40.83837475474168,0.5688844086021505,51.139322916666664,995.4427083333328,32.111055107526866,16
2119,4,8,6,34,0.2,0.15,0.85,40,1050,600,450,0.5714285714285714,15,6,9,345.12159853854894,0.4872863247863248,0.13315925426774466,0.17539741514767365,125676.58875091319,679.9714155238277,126356.56016643702,160,0,23.55,36,4,17,40.672965333932304,0.5763888888888888,49.32432432432433,1002.7027027027036,27.852852852852877,0
2120,4,1,3,32,0.02857142857142857,0.08571428571428572,0.9142857142857143,35,900,500,400,0.5555555555555556,13,5,8,394.29132135272494,0.482703081232493,0.18413028928385566,0.19776334943043972,125130.24224175341,2867.553710937496,127997.79595269091,161,0,27.571428571428573,31,4,23,40.00737463126845,0.581989247311828,49.869791666666664,1000.5208333333328,32.274865591397834,0
2121,4,4,2,34,0.1111111111111111,0.05555555555555555,0.9444444444444444,36,1050,600,450,0.5714285714285714,15,6,9,395.10759446043954,0.4812169312169312,0.18887961417176857,0.19559458601801905,124583.68055555546,2660.0504557291615,127243.73101128462,162,0,25.555555555555557,34,2,18,40.55543962159156,0.5692401960784313,50.416666666666664,998.3333333333326,29.362745098039195,16
2122,4,5,6,33,0.1282051282051282,0.15384615384615385,0.8461538461538461,39,1050,800,250,0.7619047619047619,13,8,5,355.5657704592508,0.4810503823661718,0.1930675969741973,0.181200222153948,125789.53108513939,1145.984751643555,126935.51583678294,163,0,24.358974358974358,36,3,15,40.29453861697349,0.5775462962962963,49.21171171171172,1003.1531531531548,27.86536536536541,0
2123,4,3,2,34,0.08333333333333333,0.05555555555555555,0.9444444444444444,36,900,700,200,0.7777777777777778,11,7,4,381.57469885414275,0.48267195767195764,0.1973705649924642,0.19406002241910836,125705.64994533366,2393.2191044310057,128098.86904976466,164,0,26.194444444444443,33,3,17,39.729087742881575,0.5830176767676767,49.29534313725491,1002.8186274509815,30.388443256090348,0
2124,4,1,2,33,0.02857142857142857,0.05714285714285714,0.9428571428571428,35,1400,1200,200,0.8571428571428571,16,12,4,386.9449774211683,0.4811624649859944,0.19862550148264502,0.19782018508610272,125920.80720155699,2744.8847798923443,128665.69198144933,165,0,27.857142857142858,33,2,19,39.371693121693134,0.5852272727272727,49.080882352941174,1003.6764705882345,30.41443850267377,0
2125,4,1,1,33,0.029411764705882353,0.029411764705882353,0.9705882352941176,34,850,600,250,0.7058823529411765,11,6,5,356.1714311127452,0.4807078134284017,0.03610890064154515,0.1722698299991176,123605.10381235828,2004.9213435374188,125610.02515589571,166,0,26.470588235294116,34,0,16,42.54434534498584,0.5591299019607843,51.398809523809526,994.4047619047619,29.24719887955182,16
2126,4,4,2,35,0.10810810810810811,0.05405405405405406,0.9459459459459459,37,950,400,550,0.42105263157894735,15,4,11,342.49715374992024,0.481763013013013,0.07258619462306948,0.17035120441972018,124780.79793782708,1147.4136272699432,125928.21156509702,107,0,20.72972972972973,37,0,16,41.66438030436056,0.5653153153153153,50.21929824561404,999.1228070175443,27.00331910858228,0
2127,4,0,3,32,0.0,0.08571428571428572,0.9142857142857143,35,750,200,550,0.26666666666666666,13,2,11,351.2428685941548,0.480812324929972,0.08414500910445288,0.1744088582259813,124710.81559713643,1760.7569230109668,126471.5725201474,108,1,22.742857142857144,35,0,16,41.51844341444572,0.5684523809523809,50.28935185185185,998.8425925925922,28.538359788359777,0
2128,4,3,4,31,0.08571428571428572,0.11428571428571428,0.8857142857142857,35,950,600,350,0.631578947368421,13,6,7,346.25541902049156,0.48060224089635856,0.09527769527769503,0.1753145858409018,125521.37586805577,1692.4913194444687,127213.86718750023,109,0,20.82857142857143,35,0,15,40.804747054747054,0.5767857142857142,49.47916666666668,1002.0833333333351,28.63095238095243,0
2129,4,4,3,32,0.11428571428571428,0.08571428571428572,0.9142857142857143,35,1400,1000,400,0.7142857142857143,18,10,8,386.97101067163453,0.4772058823529412,-0.0333828333828331,0.19592953277163802,125521.37586805549,2907.769097222218,128429.14496527771,110,0,21.17142857142857,33,2,16,39.78473665973666,0.5811237373737373,49.479166666666664,1002.0833333333328,30.3661616161616,15
2130,4,3,0,35,0.08571428571428572,0.0,1.0,35,1150,800,350,0.6956521739130435,15,8,7,381.76694487239865,0.4779761904761905,0.015953142721717217,0.19632731552578758,126163.40880102043,2633.003826530615,128796.41262755105,111,0,22.0,34,1,19,39.25079985780305,0.5854779411764706,48.839285714285715,1004.6428571428573,29.548319327731097,0
2131,4,2,1,36,0.05405405405405406,0.02702702702702703,0.972972972972973,37,1050,700,350,0.6666666666666666,14,7,7,364.52003994285917,0.47760260260260257,0.021711077061630668,0.19030371962691128,126779.9403077064,1842.7657809836921,128622.7060886901,112,0,21.756756756756758,36,1,18,39.04869730515487,0.5876736111111112,48.226351351351354,1007.094594594595,27.97484984984986,0
2132,4,0,1,35,0.0,0.027777777777777776,0.9722222222222222,36,1250,800,450,0.64,17,8,9,367.45746697195085,0.476521164021164,0.03431785408930299,0.19262204484796958,126946.17419249388,2129.4639221107577,129075.63811460465,113,1,23.22222222222222,35,1,19,38.803668504268614,0.5913690476190476,48.06134259259259,1007.7546296296287,28.79298941798939,0
2133,4,0,1,34,0.0,0.02857142857142857,0.9714285714285714,35,1250,900,350,0.72,16,9,7,370.8763062632333,0.47552521008403364,0.0042502951593861305,0.19511318720804893,127092.01388888895,2427.083333333342,129519.09722222229,88,2,21.65714285714286,34,1,19,38.56749311294765,0.5949754901960784,47.91666666666667,1008.3333333333339,29.656862745098056,0
2134,4,2,3,33,0.05555555555555555,0.08333333333333333,0.9166666666666666,36,1350,1300,50,0.9629629629629629,14,13,1,361.24893512753835,0.4752645502645503,0.007419502692792346,0.19211574996087893,127530.03532503842,2014.0178915894849,129544.0532166279,89,0,21.77777777777778,35,1,15,38.36047610862838,0.5973214285714286,47.48263888888888,1010.0694444444432,28.85912698412695,0
2135,4,1,2,32,0.029411764705882353,0.058823529411764705,0.9411764705882353,34,1300,800,500,0.6153846153846154,18,8,10,369.25127163868217,0.4737262329174094,0.01565821574809889,0.19694993440702285,127648.68830497887,2626.8880959246458,130275.57640090352,90,0,22.941176470588236,33,1,16,38.03662381760853,0.6029040404040404,47.365196078431374,1010.5392156862747,30.622400475341657,0
2136,4,1,4,29,0.030303030303030304,0.12121212121212122,0.8787878787878788,33,900,700,200,0.7777777777777778,11,7,4,373.5589545734218,0.4717092803030303,-0.004110040078567856,0.19980538071271806,127761.29548324159,2945.275195133155,130706.57067837474,91,0,22.303030303030305,32,1,17,37.812226801548626,0.6064453125,47.25378787878788,1010.9848484848491,31.593276515151533,0
2137,4,2,2,29,0.06451612903225806,0.06451612903225806,0.935483870967742,31,1000,700,300,0.7,13,7,6,386.2129172552819,0.46904121863799286,0.023793000042839685,0.20802455414393933,128042.48504162327,3690.3323361082203,131732.8173777315,92,0,23.258064516129032,30,1,21,37.20368525896414,0.6145833333333333,46.975806451612904,1012.0967741935481,33.73655913978494,0
2138,4,1,0,30,0.03333333333333333,0.0,1.0,30,950,600,350,0.631578947368421,13,6,7,392.98469372386046,0.4666666666666666,0.01999634101719705,0.21183967809611648,128074.22839506168,4066.2422839506135,132140.4706790123,93,0,24.266666666666666,29,1,22,36.99974844493231,0.617816091954023,46.94444444444444,1012.222222222222,34.904214559386965,0
2139,4,0,2,28,0.0,0.06666666666666667,0.9333333333333333,30,1150,900,250,0.782608695652174,14,9,5,395.76150677344333,0.4653735632183908,0.0115375828192823,0.21465280237265927,128320.37278163577,4156.8528163580195,132477.2255979938,94,1,25.266666666666666,29,1,22,36.676804889193505,0.6203304597701149,46.701388888888886,1013.1944444444442,34.937739463601524,0
2140,4,0,0,28,0.0,0.0,1.0,28,1100,800,300,0.7272727272727273,14,8,6,435.2992426202924,0.4613095238095238,-0.027620760534429856,0.20864343008351927,123220.66326530604,5275.262286627599,128495.92555193363,95,2,26.5,27,1,19,40.98096522781773,0.5740740740740741,51.78571428571428,992.8571428571421,36.772486772486744,16
2141,4,6,3,31,0.17647058823529413,0.08823529411764706,0.9117647058823529,34,950,700,250,0.7368421052631579,12,7,5,363.49420737573803,0.47179515745692213,-0.021927023775933252,0.182022826221909,125063.13928425692,2294.1597646481564,127357.29904890507,96,0,22.647058823529413,32,2,22,40.847218715812495,0.5787760416666667,49.9368686868687,1000.252525252527,31.25789141414147,0
2142,4,3,5,29,0.08823529411764706,0.14705882352941177,0.8529411764705882,34,1250,1000,250,0.8,15,10,5,365.57540255558587,0.46980837789661317,-0.012149546570172642,0.18460277966094607,125410.6903154015,2369.4127193653685,127780.10303476687,97,0,23.352941176470587,32,2,17,40.43525988486909,0.5823567708333333,49.589646464646464,1001.6414141414143,31.301294191919197,0
2143,4,2,1,30,0.06451612903225806,0.03225806451612903,0.967741935483871,31,700,600,100,0.8571428571428571,8,6,2,397.76647537470836,0.4685035842293907,-0.002061504539791592,0.19855222536388015,124930.56520061727,3738.6381172839474,128669.20331790122,98,0,26.35483870967742,29,2,23,40.128044827266834,0.5854885057471264,50.06944444444444,999.7222222222222,34.47318007662835,0
2144,4,5,2,33,0.14285714285714285,0.05714285714285714,0.9428571428571428,35,1200,800,400,0.6666666666666666,16,8,8,346.6313150803551,0.47398459383753505,0.017172604962477633,0.1799587146842234,126552.40929705191,1773.4056122448765,128325.8149092968,99,0,23.314285714285713,34,1,18,39.73295275280013,0.5894607843137255,48.45238095238094,1006.1904761904742,29.593837535013947,0
2145,4,1,0,34,0.029411764705882353,0.0,1.0,34,1300,1100,200,0.8461538461538461,15,11,4,354.3980262328256,0.4724079025549614,0.02299204700150481,0.18391958251400115,126536.55595203767,2168.861135140331,128705.41708717801,100,0,24.941176470588236,33,1,21,39.55389768574909,0.591540404040404,48.46813725490196,1006.1274509803922,30.488710635769458,0
2146,4,0,1,33,0.0,0.029411764705882353,0.9705882352941176,34,1050,600,450,0.5714285714285714,15,6,9,351.8143140672903,0.4718137254901961,0.01822569787593653,0.18313072089662358,126659.88592128023,2112.152177047286,128772.03809832752,101,1,25.941176470588236,33,1,22,39.492025809593386,0.5928030303030303,48.345588235294116,1006.6176470588232,30.50356506238858,0
2147,4,2,1,34,0.05714285714285714,0.02857142857142857,0.9714285714285714,35,1150,700,450,0.6086956521739131,16,7,9,339.17405746347407,0.47345938375350144,0.02629893118446347,0.17896394538888422,127212.08191609984,1629.4075963718874,128841.48951247173,102,0,25.314285714285713,34,1,24,39.24356856266225,0.5962009803921569,47.79761904761905,1008.8095238095243,29.67086834733895,0
2148,4,2,3,33,0.05555555555555555,0.08333333333333333,0.9166666666666666,36,750,400,350,0.5333333333333333,11,4,7,330.7046444893185,0.4723875661375661,0.03396334478808716,0.17625467316188975,127617.73003472238,1240.7552083333521,128858.48524305574,103,0,25.27777777777778,35,1,14,39.04209621993127,0.5982142857142857,47.39583333333334,1010.416666666668,28.869047619047656,0
2149,4,0,1,32,0.0,0.030303030303030304,0.9696969696969697,33,1050,800,250,0.7619047619047619,13,8,5,383.5124275428044,0.4711963383838384,0.0018067264039605124,0.1865039152572442,123834.79882473731,2899.521931754416,126734.32075649172,104,1,27.424242424242426,32,1,17,41.624910144192135,0.5660807291666667,51.167929292929294,995.3282828282832,31.10400883838385,16
2150,4,10,10,32,0.23809523809523808,0.23809523809523808,0.7619047619047619,42,850,500,350,0.5882352941176471,12,5,7,324.5167102735438,0.4770252613240418,0.05813631964606647,0.1668251148122634,126148.45920138911,-173.48488834045196,125974.97431304866,105,0,21.238095238095237,39,3,17,40.704064703442555,0.5758547008547008,48.85416666666668,1004.5833333333352,25.758547008547055,0
2151,4,4,4,32,0.1111111111111111,0.1111111111111111,0.8888888888888888,36,1450,1100,350,0.7586206896551724,18,11,7,364.6182412631457,0.4739748677248677,0.07190692249522579,0.18604329214303753,125840.52861636227,1976.750444744506,127817.27906110678,106,0,24.61111111111111,35,1,20,40.01482773868574,0.5800595238095239,49.160879629629626,1003.3564814814811,28.66732804232803,0
2152,4,1,0,33,0.030303030303030304,0.0,1.0,33,1100,900,200,0.8181818181818182,13,9,4,395.0855542245903,0.4723011363636364,0.10747444219299207,0.20072772783733,125663.7576044535,3329.5870638200036,128993.3446682735,107,0,27.515151515151516,32,1,21,39.43379297317719,0.5849609375,49.337121212121204,1002.651515151514,31.332859848484812,0
2153,4,3,2,34,0.08333333333333333,0.05555555555555555,0.9444444444444444,36,800,500,300,0.625,11,5,6,368.55406733733355,0.47473544973544973,0.10985278995507919,0.19155481018823942,126598.21342752781,2132.8051373279673,128731.01856485578,108,0,26.13888888888889,33,3,18,39.13429534015261,0.5921717171717171,48.40686274509803,1006.3725490196073,30.49613784907901,0
2154,4,0,2,32,0.0,0.058823529411764705,0.9411764705882353,34,850,700,150,0.8235294117647058,10,7,3,386.29453493455526,0.47326203208556145,0.11705963631527228,0.19930594897044673,126297.54178463925,2957.6100334149496,129255.1518180542,109,1,28.41176470588235,32,2,18,38.99845078089015,0.5914713541666667,48.705808080808076,1005.1767676767671,31.411773989898972,0
2155,4,2,0,34,0.058823529411764705,0.0,1.0,34,900,600,300,0.6666666666666666,12,6,6,368.13093965099074,0.47097816399286985,0.09086264778864384,0.1926711281549993,126882.03125000012,2541.8402777777933,129423.87152777791,110,0,27.176470588235293,34,0,20,38.85270195754067,0.5928308823529411,48.12500000000001,1007.5000000000009,29.632352941176496,0
2156,4,3,5,32,0.08108108108108109,0.13513513513513514,0.8648648648648649,37,850,500,350,0.5882352941176471,12,5,7,349.5699426094114,0.46934434434434436,0.11424787816769966,0.18729940839096165,127831.16731596473,1537.3603755782924,129368.52769154303,111,0,25.89189189189189,36,1,21,38.34702115812917,0.5983796296296297,47.18468468468469,1011.2612612612622,28.09059059059062,0
2157,4,1,1,32,0.030303030303030304,0.030303030303030304,0.9696969696969697,33,1050,700,350,0.6666666666666666,14,7,7,381.093817851761,0.4646464646464647,0.12584808747994813,0.20171521104287277,127339.27455786221,3105.642060745853,130444.91661860807,112,0,29.454545454545453,33,0,21,38.055488101019925,0.5997474747474747,47.671568627450974,1009.3137254901949,30.585264408793783,0
2158,4,1,0,33,0.030303030303030304,0.0,1.0,33,1100,600,500,0.5454545454545454,16,6,10,380.61430545222686,0.46456755050505055,0.13420805998125607,0.20285487708168107,127617.73003472204,3114.6267361110863,130732.35677083312,113,0,30.424242424242426,33,0,22,37.78135738831615,0.6025883838383839,47.39583333333332,1010.4166666666652,30.618686868686822,0
2159,4,2,2,33,0.05714285714285714,0.05714285714285714,0.9428571428571428,35,850,600,250,0.7058823529411765,11,6,5,391.7876779162421,0.46516106442577027,0.14826782325833632,0.19368865502988708,124526.96352731866,3029.9784062213084,127556.94193353997,114,0,29.62857142857143,32,3,19,40.697343453510456,0.5732421875,50.47348484848485,998.1060606060607,31.190814393939398,15
2160,4,3,2,34,0.08333333333333333,0.05555555555555555,0.9444444444444444,36,900,600,300,0.6666666666666666,12,6,6,368.8395613852392,0.46438492063492065,0.191040511010254,0.18610912219514725,125379.07483930203,2050.746097336999,127429.82093663904,115,0,29.61111111111111,32,4,18,40.386251891074146,0.58203125,49.62121212121212,1001.5151515151509,31.297348484848467,0
2161,4,5,3,36,0.1282051282051282,0.07692307692307693,0.9230769230769231,39,1150,700,450,0.6086956521739131,16,7,9,342.4538402078521,0.46688034188034183,0.18549176193167627,0.17598206477916295,126133.51048752827,840.7386422199618,126974.24912974823,116,0,28.205128205128204,34,5,20,40.26897171525638,0.585171568627451,48.86904761904761,1004.523809523809,29.54481792717085,0
2162,4,1,1,36,0.02702702702702703,0.02702702702702703,0.972972972972973,37,1250,800,450,0.64,17,8,9,359.95242799809637,0.46527777777777773,0.200064209059712,0.18392147926761868,125898.59992551846,1663.5013449502476,127562.1012704687,117,0,30.7027027027027,35,2,22,40.07191115980471,0.580654761904762,49.103009259259245,1003.587962962961,28.673941798941744,0
2163,4,7,5,38,0.16279069767441862,0.11627906976744186,0.8837209302325582,43,1000,700,300,0.7,13,7,6,317.48128245381,0.4672849760059062,0.21096345514950166,0.1699458629605687,127793.20987654307,-485.35839441873986,127307.85148212433,118,0,27.046511627906977,38,5,14,39.19700091575093,0.5942982456140351,47.222222222222214,1011.1111111111101,26.608187134502895,0
2164,4,1,0,39,0.02564102564102564,0.0,1.0,39,1100,700,400,0.6363636363636364,15,7,8,337.2488549381835,0.4642375168690958,0.20420837332602138,0.18018724535268643,127717.31190650095,814.5034392500484,128531.815345751,119,0,28.641025641025642,36,3,16,38.77492758467023,0.5972222222222222,47.29729729729729,1010.8108108108097,28.078078078078047,0
2165,4,1,0,40,0.025,0.0,1.0,40,1200,600,600,0.5,18,6,12,330.7934296196967,0.46523771367521366,0.2000000000000004,0.17788821494933316,127978.05574792229,466.85999538318094,128444.91574330548,120,0,28.9,37,3,18,38.67170567837018,0.597972972972973,47.03947368421052,1011.8421052631567,27.34708392603126,0
2166,4,1,1,40,0.024390243902439025,0.024390243902439025,0.975609756097561,41,1350,800,550,0.5925925925925926,19,8,11,322.0476545428482,0.465625,0.19270456716685724,0.17487452545740323,128366.66690712528,68.14500615574102,128434.81191328102,121,0,29.170731707317074,37,4,19,38.49680805020557,0.6019144144144144,46.655701754385966,1013.3771929824563,27.38857278330963,0
2167,4,2,4,38,0.047619047619047616,0.09523809523809523,0.9047619047619048,42,1100,800,300,0.7272727272727273,14,8,6,321.0907176550274,0.4656165311653116,0.20454340439606677,0.17635861266809674,128821.50472094402,-127.32211995030366,128694.18260099372,122,0,29.30952380952381,38,4,14,38.058215814214556,0.6047149122807017,46.20726495726497,1015.1709401709418,26.715024741340574,0
2168,4,0,1,37,0.0,0.02631578947368421,0.9736842105263158,38,1150,600,550,0.5217391304347826,17,6,11,344.27844256316683,0.4622895922238028,0.20325860318108901,0.1874167109018508,128466.99948827596,1245.6837009173646,129712.68318919333,123,1,31.42105263157895,35,3,15,37.8312069490429,0.606845238095238,46.55671296296297,1013.7731481481487,28.964947089947106,0
2169,4,0,0,37,0.0,0.0,1.0,37,1100,800,300,0.7272727272727273,14,8,6,350.26309662886354,0.46211836836836834,0.19709349941908094,0.19043039621316382,128415.88010204089,1595.868764172344,130011.74886621322,124,2,32.21621621621622,34,3,15,37.73172617649361,0.6084558823529411,46.60714285714286,1013.5714285714291,29.810924369747916,0
2170,4,0,1,36,0.0,0.02702702702702703,0.972972972972973,37,1300,1100,200,0.8461538461538461,15,11,4,352.61378456824787,0.4618055555555556,0.19134678233058122,0.19228964257057227,128536.57171201831,1664.753401360564,130201.32511337887,125,3,33.21621621621622,34,3,15,37.5489160209752,0.6096813725490196,46.48809523809525,1014.0476190476204,29.824929971988837,0
2171,4,2,1,37,0.05263157894736842,0.02631578947368421,0.9736842105263158,38,1350,1000,350,0.7407407407407407,17,10,7,334.1910513271076,0.46258594120436225,0.17170724595422038,0.1849217803940619,129115.53603857252,1029.851346278731,130145.38738485126,126,0,31.605263157894736,36,2,18,37.42659279778394,0.611400462962963,45.9177927927928,1016.3288288288302,28.231356356356393,0
2172,4,1,4,34,0.02631578947368421,0.10526315789473684,0.8947368421052632,38,700,300,400,0.42857142857142855,11,3,8,335.93120128997555,0.4614746325272641,0.17536669542709182,0.18628912071535014,129201.38888888896,1080.5555555555607,130281.94444444453,127,0,32.39473684210526,36,2,19,37.29508196721311,0.6122685185185186,45.833333333333336,1016.6666666666673,28.24074074074076,0
2173,4,0,0,34,0.0,0.0,1.0,34,850,400,450,0.47058823529411764,13,4,9,370.8557153382665,0.45881610219845514,0.1923516232482536,0.20268400115834254,128624.38303489455,2740.2175160698134,131364.60055096436,128,1,35.85294117647059,32,2,20,36.99667040079663,0.615234375,46.40151515151516,1014.3939393939406,31.699810606060645,0
2174,4,0,0,34,0.0,0.0,1.0,34,1450,1200,250,0.8275862068965517,17,12,5,372.966782309721,0.4576091800356506,0.19988777930877766,0.20456363517146423,128765.6865748751,2805.0647587466437,131570.75133362174,129,2,36.85294117647059,33,1,20,36.7986798679868,0.6142676767676767,46.26225490196079,1014.9509803921572,30.756090314913855,0
2175,4,1,1,34,0.02857142857142857,0.02857142857142857,0.9714285714285714,35,900,500,400,0.5555555555555556,13,5,8,362.89114501128887,0.4584033613445378,0.19442631182525716,0.2004709335062365,129050.14349489806,2366.230867346949,131416.374362245,130,0,36.77142857142857,34,1,21,36.7640597539543,0.6148897058823529,45.98214285714286,1016.0714285714294,29.88445378151263,0
2176,4,1,2,33,0.02857142857142857,0.05714285714285714,0.9428571428571428,35,950,600,350,0.631578947368421,13,6,7,363.4992992123191,0.4584733893557423,0.19281754639672233,0.20189539389985425,129263.69214965389,2397.5408790967253,131661.2330287506,131,0,37.2,33,2,22,36.530890977745656,0.6193181818181819,45.772058823529406,1016.9117647058815,30.81550802139035,0
2177,4,0,0,33,0.0,0.0,1.0,33,1050,700,350,0.6666666666666666,14,7,7,372.74074633816053,0.45928030303030304,0.16423163637915894,0.2068750879996228,129234.48562622057,3034.191724989137,132268.6773512097,132,1,37.21212121212121,31,2,23,36.32574059845478,0.623991935483871,45.80078124999999,1016.796874999999,32.799899193548356,0
2178,4,0,1,32,0.0,0.030303030303030304,0.9696969696969697,33,1000,600,400,0.6,14,6,8,371.22255749995907,0.4583727904040404,0.15745242473124343,0.20703685750118814,129426.12879106712,3009.1797074277993,132435.3084984949,133,2,38.21212121212121,32,1,18,36.16893121561814,0.6233723958333333,45.61237373737373,1017.5505050505042,31.798453282828255,0
2179,4,0,0,32,0.0,0.0,1.0,32,1100,800,300,0.7272727272727273,14,8,6,373.4511994921056,0.45774529569892475,0.13693065506653013,0.20849246965930684,129466.28146701376,3269.86762152776,132736.1490885415,134,3,38.65625,31,1,18,36.07130672125553,0.6263440860215054,45.57291666666666,1017.7083333333322,32.82930107526878,0
2180,4,0,0,32,0.0,0.0,1.0,32,950,600,350,0.631578947368421,13,6,7,373.31708755879583,0.4574932795698925,0.1356884753133798,0.20876916956614178,129532.54699707018,3271.342637803806,132803.88963487398,135,4,39.65625,31,1,19,36.00718427560331,0.627016129032258,45.50781249999999,1017.968749999999,32.837701612903196,0
2181,4,0,4,28,0.0,0.125,0.875,32,1000,900,100,0.9,11,9,2,391.95016389269006,0.4571572580645162,-0.014792110874200182,0.20654452456817055,127159.78725864274,3793.516976820407,130953.30423546315,136,5,40.65625,30,2,20,37.96641791044777,0.6055555555555556,47.84946236559141,1008.6021505376355,33.62007168458785,15
2182,4,0,1,27,0.0,0.03571428571428571,0.9642857142857143,28,700,300,400,0.42857142857142855,11,3,8,408.23568679070274,0.453069885361552,0.012549638529681495,0.21419396730267592,126983.38050353405,4767.829510173063,131751.2100137071,137,10,44.107142857142854,28,0,20,37.73788310762652,0.6097470238095238,48.024425287356316,1007.9022988505739,35.99651067323478,0
2183,4,1,0,28,0.03571428571428571,0.0,1.0,28,650,400,250,0.6153846153846154,9,4,5,407.2669864692656,0.45271164021164023,0.022425722425722272,0.21464070908515345,127164.46195005938,4757.977440877248,131922.43939093663,138,0,44.714285714285715,28,0,21,37.575379867046536,0.6116071428571428,47.84482758620689,1008.6206896551719,36.02216748768471,0
2184,4,1,1,28,0.034482758620689655,0.034482758620689655,0.9655172413793104,29,950,700,250,0.7368421052631579,12,7,5,395.3191333215833,0.45422824302134646,0.01962857427329201,0.210325973419742,127547.57185570982,4284.39911265431,131831.97096836413,139,0,44.13793103448276,29,0,21,37.482097025528205,0.6124281609195402,47.46527777777777,1010.1388888888883,34.83237547892718,0
2185,4,1,0,29,0.034482758620689655,0.0,1.0,29,1000,500,500,0.5,15,5,10,430.3419914717714,0.45879515599343185,0.04724117917825743,0.2031450003577704,122569.40315761656,4750.745921090773,127320.14907870733,140,0,42.275862068965516,28,1,17,41.7890912168698,0.5639880952380952,52.44252873563218,990.2298850574709,35.365353037766816,16
2186,4,6,1,34,0.17142857142857143,0.02857142857142857,0.9714285714285714,35,800,600,200,0.75,10,6,4,391.76318377836526,0.46918767507002807,0.10466699826767112,0.1863504030662477,122895.83510487496,2637.0623849023978,125532.89748977736,141,0,35.857142857142854,34,1,21,42.40179893544643,0.5517769607843137,52.11309523809522,991.5476190476163,29.16316526610636,16
2187,4,10,9,35,0.22727272727272727,0.20454545454545456,0.7954545454545454,44,950,600,350,0.631578947368421,13,6,7,325.4778407313397,0.4801136363636364,0.12358424643574661,0.16347189995337563,125187.03572439535,-588.113053680836,124598.92267071451,142,0,26.568181818181817,38,6,15,41.67000284687377,0.5677083333333333,49.81303418803418,1000.747863247862,26.335470085470053,0
2188,4,4,1,38,0.10256410256410256,0.02564102564102564,0.9743589743589743,39,800,300,500,0.375,13,3,10,369.5050294178622,0.47553981106612686,0.1958940203469226,0.18581329469769045,125238.20861677999,1455.2295918367286,126693.43820861672,143,0,29.897435897435898,34,5,15,40.515481287662546,0.5759803921568627,49.76190476190476,1000.9523809523805,29.439775910364133,0
2189,4,2,2,38,0.05,0.05,0.95,40,1100,900,200,0.8181818181818182,13,9,4,363.82792677206623,0.4751736111111111,0.2027172692566812,0.18515722947611574,125733.05357722599,1149.0392419446628,126882.09281917065,144,0,30.0,36,4,17,40.14568830002245,0.5769675925925926,49.268018018018026,1002.927927927929,27.859109109109138,0
2190,4,2,1,39,0.05,0.025,0.975,40,1550,1200,350,0.7741935483870968,19,12,7,356.7352458744334,0.47268963675213677,0.14307172799254797,0.17211473548143988,123499.8981910149,811.7369277435378,124311.63511875844,145,0,30.8,35,5,16,42.63992392485638,0.555952380952381,51.50462962962962,993.9814814814799,28.399470899470856,15
2191,4,7,5,41,0.15217391304347827,0.10869565217391304,0.8913043478260869,46,1250,1000,250,0.8,15,10,5,333.8300926937362,0.4810386473429951,0.14215448141850828,0.16150158538426676,123614.9691358023,-344.60090877917366,123270.36822702312,146,0,27.565217391304348,41,5,19,43.08950186219738,0.5467479674796748,51.38888888888888,994.4444444444431,24.25474254742544,15
2192,4,4,3,42,0.08888888888888889,0.06666666666666667,0.9333333333333333,45,1800,1400,400,0.7777777777777778,22,14,8,361.4863111197602,0.48036616161616164,0.29385758530393025,0.17557606476758145,123782.73986678007,116.01277084907883,123898.75263762915,147,0,27.6,34,11,20,42.22719025401761,0.560968137254902,51.220238095238095,995.1190476190478,29.26820728291317,16
2193,4,7,6,43,0.14285714285714285,0.12244897959183673,0.8775510204081632,49,1150,700,450,0.6086956521739131,16,7,9,320.60171332358556,0.48047760770975056,0.3042504771692842,0.16204959327992152,125450.85626166717,-1749.8370828426264,123701.01917882454,148,0,26.0,36,13,15,41.52006519784172,0.5740740740740741,49.54954954954955,1001.8018018018026,27.82782782782785,0
2194,4,4,2,45,0.0851063829787234,0.0425531914893617,0.9574468085106383,47,2100,1600,500,0.7619047619047619,26,16,10,351.14475216087806,0.4808048103607771,0.24308896337957053,0.17351354691467508,124507.06587603898,-468.79048486794113,124038.27539117103,149,0,27.51063829787234,37,10,16,41.732128469933336,0.5625,50.49342105263159,998.0263157894753,26.97368421052636,16
2195,4,7,8,44,0.1346153846153846,0.15384615384615385,0.8461538461538461,52,2150,1800,350,0.8372093023255814,25,18,7,327.43963983289717,0.4865510306686777,0.2797869626227836,0.1687573528369549,126253.12500000015,-2129.02287242227,124124.10212757788,150,0,25.576923076923077,39,13,17,40.52307904919845,0.5769230769230769,48.75000000000001,1005.0000000000011,25.7692307692308,0
2196,4,1,1,44,0.022222222222222223,0.022222222222222223,0.9777777777777777,45,1500,900,600,0.6,21,9,12,357.43017117960693,0.48247053872053874,0.2793839175040227,0.18208625286332294,125775.00708616749,-8.843537414998991,125766.16354875249,151,0,28.08888888888889,34,11,18,40.262777909644754,0.5814950980392157,49.22619047619046,1003.0952380952356,29.502801120448105,0
2197,4,2,3,43,0.043478260869565216,0.06521739130434782,0.9347826086956522,46,1250,1000,250,0.8,15,10,5,347.9836055129652,0.48313204508856683,0.277519535163294,0.17893943695808853,126160.08659122074,-419.67163923183443,125740.4149519889,152,0,27.369565217391305,35,11,20,40.102726574500764,0.5833333333333333,48.84259259259259,1004.6296296296287,28.703703703703678,0
2198,4,5,7,41,0.10416666666666667,0.14583333333333334,0.8541666666666666,48,1700,1300,400,0.7647058823529411,21,13,8,331.3016429952997,0.4844304078014185,0.2645941438102293,0.17487319255475764,127226.70945878072,-1169.9164246840642,126056.79303409666,153,0,25.666666666666668,38,10,19,39.42713297327824,0.5885416666666667,47.78311965811965,1008.867521367521,26.54914529914529,0
2199,4,3,1,43,0.06818181818181818,0.022727272727272728,0.9772727272727273,44,1000,600,400,0.6,14,6,8,367.44679584669973,0.48419881959126143,0.29154447702834796,0.1923130632808055,126882.03125000022,524.4791666666961,127406.51041666692,154,0,28.477272727272727,34,10,23,38.86993382961126,0.5928308823529411,48.125000000000014,1007.5000000000017,29.63235294117652,0
2200,4,0,1,42,0.0,0.023255813953488372,0.9767441860465116,43,1150,600,550,0.5217391304347826,17,6,11,376.3794910046706,0.48378091546696195,0.29149550161262927,0.19680912315893095,126844.99351211087,948.3708189158214,127793.36433102669,155,1,29.930232558139537,33,10,23,38.683090024330895,0.5946969696969697,48.16176470588236,1007.3529411764719,30.525846702317327,0
2201,4,1,5,38,0.023255813953488372,0.11627906976744186,0.8837209302325582,43,1200,900,300,0.75,15,9,6,420.43584008388535,0.48198135843484685,0.2500582227101842,0.21170472654911535,125293.14041137685,2548.2153558492614,127841.35576722611,156,0,30.58139534883721,31,12,16,39.183817791650405,0.5836693548387097,49.70703124999999,1001.1718749999992,32.29586693548384,16
2202,4,4,1,41,0.09523809523809523,0.023809523809523808,0.9761904761904762,42,1100,600,500,0.5454545454545454,16,6,10,401.2483797729291,0.4824090205187766,0.2967914758612431,0.20606396779171404,126107.23913695023,1720.0650762677146,127827.30421321794,157,0,31.61904761904762,32,10,20,38.81966268594175,0.5895182291666667,48.895202020202014,1004.4191919191912,31.388099747474726,0
2203,4,3,5,39,0.06818181818181818,0.11363636363636363,0.8863636363636364,44,1150,800,350,0.6956521739130435,15,8,7,382.45922136036324,0.48272330866807606,0.30324966960707456,0.19987569313959433,126822.06809807244,900.8538832199416,127722.92198129238,158,0,31.113636363636363,34,10,20,38.55360871449396,0.592218137254902,48.1845238095238,1007.2619047619038,29.625350140055993,0
2204,4,1,1,39,0.025,0.025,0.975,40,1350,900,450,0.6666666666666666,18,9,9,405.2352465506744,0.47926014957264956,0.3118513006341399,0.21029232707166304,126534.62939792215,2255.2583482530436,128789.8877461752,159,0,34.45,31,9,21,38.277172037444444,0.5964381720430108,48.470052083333336,1006.1197916666672,32.455477150537654,0
2205,4,1,1,39,0.025,0.025,0.975,40,900,300,600,0.3333333333333333,15,3,12,385.88701214767957,0.4786458333333334,0.144425274352302,0.1877190589088248,123848.38544203015,1558.2966835078619,125406.682125538,160,0,35.025,36,4,19,41.55164611381379,0.5575810185185186,51.154279279279294,995.3828828828853,27.64952452452459,16
2206,4,5,5,39,0.11363636363636363,0.11363636363636363,0.8863636363636364,44,1250,1000,250,0.8,15,10,5,352.16524587101185,0.4815561134601832,0.1499952626841634,0.17553379398090202,124869.82557508709,-4.986708493722261,124864.83886659336,161,0,32.43181818181818,39,5,19,41.33066267153033,0.562767094017094,50.13020833333335,999.479166666669,25.627670940171,0
2207,4,3,1,41,0.07142857142857142,0.023809523809523808,0.9761904761904762,42,800,300,500,0.375,13,3,10,362.63176620884275,0.4825662988772745,0.18363743545269595,0.18144547158549643,125029.7636763037,668.1562566432676,125697.91993294697,162,0,34.785714285714285,34,8,23,40.90336467880808,0.5738357843137255,49.97023809523809,1000.1190476190463,29.41526610644254,0
2208,4,8,8,41,0.16326530612244897,0.16326530612244897,0.8367346938775511,49,1150,900,250,0.782608695652174,14,9,5,309.91758364002186,0.4847470238095238,0.18721452286740892,0.16143468162741395,126688.3552144968,-1935.1228003529113,124753.23241414389,163,0,30.53061224489796,38,11,16,40.517218507906186,0.5830592105263157,48.31730769230768,1006.7307692307672,26.492914979757032,0
2209,4,2,1,42,0.046511627906976744,0.023255813953488372,0.9767441860465116,43,1250,900,350,0.72,16,9,7,361.21113156298844,0.4843576965669989,0.1748230886451534,0.18224839191921524,125376.44039619782,770.9234197000924,126147.36381589792,164,0,34.372093023255815,35,8,18,40.579977079240344,0.5752976190476191,49.6238425925926,1001.5046296296307,28.61441798941802,16
2210,4,5,4,43,0.10638297872340426,0.0851063829787234,0.9148936170212766,47,1200,600,600,0.5,18,6,12,343.2142613209475,0.48386910268270117,0.2656936873571296,0.1805605461731946,127092.01388888927,-672.4984460733484,126419.51544281591,165,0,32.319148936170215,38,9,20,39.264807162534424,0.587171052631579,47.916666666666686,1008.3333333333364,26.53508771929833,0
2211,4,1,3,41,0.022727272727272728,0.06818181818181818,0.9318181818181819,44,1150,600,550,0.5217391304347826,17,6,11,357.22223079694294,0.48458421423537706,0.30138022409080434,0.1882003941453787,127150.37321030539,284.18799296983957,127434.56120327523,166,0,35.20454545454545,35,9,21,38.851751970009936,0.593452380952381,47.858796296296305,1008.5648148148163,28.81613756613761,0
2212,4,1,2,40,0.023809523809523808,0.047619047619047616,0.9523809523809523,42,1050,800,250,0.7619047619047619,13,8,5,370.61395431419817,0.48311072396438254,0.3174718867138693,0.1955701328150308,127215.61418685126,1029.576364859675,128245.19055171094,167,0,37.285714285714285,33,9,22,38.447015711046326,0.5984848484848485,47.794117647058826,1008.8235294117652,30.570409982174702,0
2213,4,4,3,41,0.09090909090909091,0.06818181818181818,0.9318181818181819,44,900,400,500,0.4444444444444444,14,4,10,347.360714015241,0.48101656095842144,0.31035477732835637,0.18689075216216944,127998.08873724715,92.30149927127249,128090.39023651842,168,0,36.22727272727273,35,9,24,38.232133325708205,0.6020833333333333,47.01967592592593,1011.9212962962968,28.91203703703705,0
2214,4,0,1,40,0.0,0.024390243902439025,0.975609756097561,41,1150,700,450,0.6086956521739131,16,7,9,369.8703496827299,0.4811991869918699,0.31930376275277017,0.19736281859070476,127665.5762167126,1243.9422635445424,128909.51848025713,169,1,39.36585365853659,32,9,24,38.00365442278862,0.60546875,47.34848484848485,1010.6060606060607,31.581439393939398,0
2215,4,1,0,41,0.024390243902439025,0.0,1.0,41,1100,700,400,0.6363636363636364,15,7,8,362.43861902731015,0.4813770325203252,0.30320212392098433,0.19526291940942955,128051.48748378032,1082.1608576028486,129133.64834138317,170,0,38.292682926829265,33,8,25,37.79601545788432,0.6070075757575757,46.966911764705884,1012.1323529411768,30.670677361853844,0
2216,4,1,1,41,0.023809523809523808,0.023809523809523808,0.9761904761904762,42,1650,1300,350,0.7878787878787878,20,13,7,351.7683954922251,0.48098141695702673,0.2911170632372635,0.1916879283203611,128507.33651055244,641.0652879292054,129148.40179848165,171,0,38.357142857142854,31,11,20,37.60019369889988,0.6165994623655914,46.51692708333334,1013.9322916666679,32.70749327956993,0
2217,4,1,3,39,0.023809523809523808,0.07142857142857142,0.9285714285714286,42,1400,800,600,0.5714285714285714,20,8,12,341.4207406965619,0.4791061749903213,0.2731896536419953,0.1885664173222538,129040.97995421405,411.4533912356087,129452.43334544967,172,0,37.976190476190474,32,10,21,37.318773041713264,0.6194661458333333,45.99116161616163,1016.0353535353552,31.75110479797985,0
2218,4,0,2,37,0.0,0.05128205128205128,0.9487179487179487,39,1300,1000,300,0.7692307692307693,16,10,6,390.83638709164023,0.47739541160593796,0.1920908216568915,0.19513116559936355,124938.73299932723,1971.875755188284,126910.60875451552,173,1,39.05128205128205,33,6,19,40.29275966331617,0.5751262626262627,50.06127450980392,999.7549019607847,30.295603089720746,16
2219,4,4,3,38,0.0975609756097561,0.07317073170731707,0.926829268292683,41,900,500,400,0.5555555555555556,13,5,8,373.8666551248772,0.47845528455284553,0.22711010461225167,0.191427899372683,125984.0720663265,1220.2637427519958,127204.33580907849,174,0,37.78048780487805,34,7,19,39.63447171824972,0.5836397058823529,49.01785714285714,1003.9285714285711,29.52731092436974,0
2220,4,4,4,38,0.09523809523809523,0.09523809523809523,0.9047619047619048,42,1450,900,550,0.6206896551724138,20,9,11,360.97261116043956,0.4790093883081688,0.23376623376623362,0.18990298239310102,127092.01388888899,780.2118764172451,127872.22576530624,175,0,34.595238095238095,33,9,18,38.81714876033057,0.5972222222222222,47.91666666666667,1008.3333333333343,30.555555555555586,0
2221,4,0,0,38,0.0,0.0,1.0,38,1200,1000,200,0.8333333333333334,14,10,4,386.0421664900387,0.4750622332859175,0.2399418478052031,0.20155619594759447,126783.27596357166,2188.7381055363257,128972.01406910799,176,1,37.526315789473685,33,5,18,38.503386874340876,0.5940656565656566,48.22303921568627,1007.1078431372546,30.518419489007716,0
2222,4,2,2,38,0.05,0.05,0.95,40,1550,1300,250,0.8387096774193549,18,13,5,367.366300683151,0.47399839743589745,0.2338449405484111,0.19534406775680807,127524.87775134543,1370.4194300268919,128895.29718137231,177,0,36.6,33,7,18,38.21129580198981,0.6016414141414141,47.487745098039206,1010.0490196078414,30.607546048722465,0
2223,4,0,1,37,0.0,0.02631578947368421,0.9736842105263158,38,1100,900,200,0.8181818181818182,13,9,4,386.86611509540666,0.47300260787102894,0.24504689909054456,0.2043507515933407,127256.18362426768,2246.221076117637,129502.40470038532,178,1,39.28947368421053,31,7,19,37.99535961629458,0.6038306451612903,47.75390625000001,1008.9843750000008,32.54788306451616,0
2224,4,0,0,37,0.0,0.0,1.0,37,1300,900,400,0.6923076923076923,17,9,8,395.2089906347552,0.47212837837837834,0.2579668700959019,0.20892699027417153,127289.03028700096,2661.153835720496,129950.18412272146,179,2,41.0,31,6,20,37.7510752688172,0.6041666666666667,47.72135416666667,1009.1145833333342,32.55208333333336,0
2225,4,0,0,37,0.0,0.0,1.0,37,1650,1300,350,0.7878787878787878,20,13,7,389.88486002625933,0.47159659659659664,0.2573297500126768,0.20656921510337597,127378.63363751149,2532.600149219468,129911.23378673095,180,3,42.0,32,5,18,37.79315196998125,0.6025390625,47.63257575757576,1009.469696969697,31.54592803030303,0
2226,4,0,2,35,0.0,0.05405405405405406,0.9459459459459459,37,1350,900,450,0.6666666666666666,18,9,9,379.2912332475532,0.4712525025025025,0.09504418867536724,0.19183383527712777,125476.64399092963,2118.438208616769,127595.0821995464,181,4,43.0,34,3,17,40.02346720532317,0.5784313725490196,49.52380952380952,1001.9047619047612,29.46778711484592,16
2227,4,3,2,36,0.07894736842105263,0.05263157894736842,0.9473684210526316,38,1350,900,450,0.6666666666666666,18,9,9,361.2524799813973,0.46972795163584635,0.10639045795049573,0.18628958053197464,126276.38996056245,1523.5318072702394,127799.92176783268,182,0,40.60526315789474,35,3,17,39.64954705972671,0.5845238095238094,48.726851851851855,1005.0925925925928,28.716931216931226,0
2228,4,2,1,37,0.05263157894736842,0.02631578947368421,0.9736842105263158,38,1350,1100,250,0.8148148148148148,16,11,5,422.946108941195,0.4671941678520626,0.2047588258114572,0.20840080670589142,124388.00581507108,3037.303850370934,127425.30966544202,183,0,39.6578947368421,33,5,13,40.065008190008186,0.5694444444444444,50.61274509803921,997.5490196078429,30.228758169934633,16
2229,4,3,3,37,0.075,0.075,0.925,40,1350,900,450,0.6666666666666666,18,9,9,401.9061956838326,0.4713274572649573,0.21361055022715858,0.20156358826573972,125126.29451076414,2062.312080029253,127188.6065907934,184,0,38.45,32,8,17,39.821007908463734,0.5794270833333333,49.87373737373737,1000.5050505050499,31.26578282828281,0
2230,4,3,4,36,0.075,0.1,0.9,40,1200,800,400,0.6666666666666666,16,8,8,395.48811265316397,0.4750934829059829,0.20508070432868664,0.2003904451844841,125552.07882785464,1930.8709390618938,127482.94976691653,185,0,36.325,33,7,15,39.53951658922311,0.5814393939393939,49.4485294117647,1002.2058823529409,30.36987522281639,0
2231,4,8,3,41,0.18181818181818182,0.06818181818181818,0.9318181818181819,44,1450,1200,250,0.8275862068965517,17,12,5,347.99535550850385,0.47842891120507397,0.1990984222389185,0.18307581746316906,127092.0138888886,47.408448673553636,127139.42233756215,186,0,32.0,36,8,17,39.14428374655648,0.5908564814814814,47.91666666666665,1008.333333333331,28.009259259259196,0
2232,4,1,3,39,0.023809523809523808,0.07142857142857142,0.9285714285714286,42,700,300,400,0.42857142857142855,11,3,8,347.9328911564026,0.4764203445605885,0.15391626557789095,0.1725624742636539,124661.68755425338,435.37055121527146,125097.05810546865,187,0,34.476190476190474,39,3,16,41.651998365842644,0.5606303418803419,50.338541666666664,998.6458333333326,25.6063034188034,16
2233,4,5,2,42,0.11363636363636363,0.045454545454545456,0.9545454545454546,44,1250,800,450,0.64,17,8,9,333.1722860216368,0.4780214940098661,0.13440713671936333,0.166484617682422,124974.59478691609,-312.1318057930707,124662.46298112301,188,0,33.40909090909091,40,4,19,41.69694582782803,0.5622395833333333,50.02540650406505,999.8983739837417,24.997459349593544,16
2234,4,4,7,39,0.08695652173913043,0.15217391304347827,0.8478260869565217,46,1050,700,350,0.6666666666666666,14,7,7,334.4533101772484,0.4771739130434782,0.21286301829780085,0.17119250461641763,125970.87014001563,-773.7250991526959,125197.14504086293,189,0,32.78260869565217,42,4,16,40.63726673101672,0.5694444444444444,49.031007751937985,1003.8759689922481,23.901808785529717,0
2235,4,2,2,39,0.04878048780487805,0.04878048780487805,0.9512195121951219,41,1750,1500,250,0.8571428571428571,20,15,5,373.11884400721914,0.4738567073170732,0.2556059188910471,0.19068435394740788,125906.24188452215,1195.59828504924,127101.8401695714,190,0,36.609756097560975,37,4,19,39.73367110965438,0.5768581081081081,49.0953947368421,1003.6184210526316,27.124822190611663,0
2236,4,1,0,40,0.025,0.0,1.0,40,1550,1500,50,0.967741935483871,16,15,1,371.7216335025165,0.47510683760683764,0.25013824884792624,0.1911459584598249,126160.08659122088,1379.3618374148414,127539.44842863572,191,0,37.4,35,5,20,39.50652841781875,0.5833333333333333,48.842592592592595,1004.6296296296299,28.703703703703713,0
2237,4,3,2,41,0.06976744186046512,0.046511627906976744,0.9534883720930233,43,1700,1500,200,0.8823529411764706,19,15,4,344.50691757829105,0.47669804355850864,0.2398040162859698,0.18100040502610004,127038.15563591213,153.10468259186658,127191.26031850399,192,0,35.72093023255814,38,5,20,39.28748057086333,0.5866228070175439,47.97008547008547,1008.1196581196589,26.529464687359443,0
2238,4,3,1,43,0.06818181818181818,0.022727272727272728,0.9772727272727273,44,1200,900,300,0.75,15,9,6,340.9014813406261,0.4769644115574348,0.24789703050572598,0.18136929345346506,127546.62390430998,-103.79915138227926,127442.8247529277,193,0,35.56818181818182,36,8,17,38.85730211817169,0.5954861111111112,47.46621621621623,1010.1351351351373,28.05930930930937,0
2239,4,0,4,39,0.0,0.09302325581395349,0.9069767441860466,43,1850,1500,350,0.8108108108108109,22,15,7,342.0065411110154,0.47563676633444074,0.23327322472329248,0.18272920910788573,127717.3119065014,136.0312170278691,127853.34312352927,194,1,36.18604651162791,36,7,17,38.65469956922162,0.5972222222222222,47.29729729729731,1010.8108108108133,28.07807807807815,0
2240,4,1,3,37,0.025,0.075,0.925,40,1150,800,350,0.6956521739130435,15,8,7,366.7351287919487,0.4751736111111111,0.23748673505482842,0.19451411052436013,127422.337372449,1346.0494614512497,128768.38683390024,195,0,37.625,34,6,17,38.33249813308179,0.5983455882352942,47.589285714285715,1009.6428571428573,29.69537815126051,0
2241,4,1,1,37,0.02631578947368421,0.02631578947368421,0.9736842105263158,38,1450,1100,350,0.7586206896551724,18,11,7,375.7246206051466,0.4748844238975818,0.2223428717424627,0.1994826593934541,127462.99500192232,1978.1970876585888,129441.1920895809,196,0,38.05263157894737,33,5,17,38.06381472491908,0.601010101010101,47.549019607843135,1009.8039215686273,30.60011883541295,0
2242,4,1,2,36,0.02631578947368421,0.05263157894736842,0.9473684210526316,38,750,500,250,0.6666666666666666,10,5,5,362.1703550641583,0.4748696064485538,0.16636551126840393,0.18733943596000874,126402.72285997719,1555.863803854857,127958.58666383204,197,0,39.026315789473685,34,4,16,39.49627086539599,0.5879289215686274,48.60119047619047,1005.595238095237,29.576330532212854,16
2243,4,4,3,37,0.1,0.075,0.925,40,1100,800,300,0.7272727272727273,14,8,6,343.96408690432264,0.47423878205128206,0.19654960981047953,0.18299868680496853,127546.62390430951,774.2916057949565,128320.91551010447,198,0,36.55,36,4,16,38.779960981047935,0.5954861111111112,47.4662162162162,1010.1351351351334,28.05930930930926,0
2244,4,0,1,36,0.0,0.02702702702702703,0.972972972972973,37,1150,800,350,0.6956521739130435,15,8,7,360.48723805401033,0.4730980980980981,0.09878733148422936,0.17769900322897658,124405.47052154178,1570.7150398812896,125976.18556142307,199,1,39.972972972972975,34,3,16,41.604514717581566,0.5674019607843137,50.59523809523809,997.6190476190461,29.341736694677827,16
2245,4,5,2,39,0.12195121951219512,0.04878048780487805,0.9512195121951219,41,1050,600,450,0.5714285714285714,15,6,9,397.22222222222223,0.47479674796747967,0.12703252032520318,0.19861111111111104,124999.99999999999,2328.2738095238074,127328.27380952379,200,0,36.34146341463415,32,9,18,40.06944444444444,0.578125,50.0,999.9999999999999,31.249999999999996,16
2246,4,4,5,38,0.09302325581395349,0.11627906976744186,0.8837209302325582,43,950,400,550,0.42105263157894735,15,4,11,368.2262822528929,0.47752860834256183,0.15235494953775364,0.1881490921281573,125898.59992551844,671.8346782835793,126570.43460380202,201,0,35.46511627906977,35,8,19,39.86432264636912,0.580654761904762,49.103009259259245,1003.5879629629609,28.67394179894174,0
2247,4,2,1,39,0.05,0.025,0.975,40,1300,900,400,0.6923076923076923,17,9,8,387.871447648217,0.4772702991452991,0.17796077445310576,0.19904061255444605,126075.53597847141,1780.2201305988983,127855.75610907031,202,0,37.75,32,8,21,39.188353868074756,0.5891927083333333,48.92676767676767,1004.2929292929279,31.384154040403995,0
2248,4,0,3,36,0.0,0.07692307692307693,0.9230769230769231,39,1150,800,350,0.6956521739130435,15,8,7,385.1282299735636,0.4768049932523617,0.17304067963698544,0.19839712507181811,126234.09162649207,1923.2624540862955,128157.35408057836,203,1,39.23076923076923,32,7,21,39.09332202538006,0.5908203125,48.768939393939384,1004.9242424242414,31.403882575757542,0
2249,4,3,3,36,0.07692307692307693,0.07692307692307693,0.9230769230769231,39,1150,800,350,0.6956521739130435,15,8,7,370.2504512029693,0.4762426900584795,0.18829991965770487,0.19567665052665245,127277.43686322542,1627.8111605199247,128905.24802374534,204,0,36.48717948717949,33,6,21,38.392640272042755,0.5991161616161615,47.73284313725489,1009.0686274509783,30.57783719548419,0
2250,4,0,1,35,0.0,0.027777777777777776,0.9722222222222222,36,700,500,200,0.7142857142857143,9,5,4,387.6271789196987,0.4736772486772487,0.18147943974845915,0.19424190678462258,125091.92866025091,2512.2388324202348,127604.16749267114,205,1,37.888888888888886,33,3,19,40.21384601249542,0.5767045454545454,49.90808823529412,1000.3676470588239,30.31417112299466,16
2251,4,3,3,35,0.07894736842105263,0.07894736842105263,0.9210526315789473,38,1550,1200,350,0.7741935483870968,19,12,7,367.3924706624925,0.4746028923660503,0.20532989534354673,0.18825337761353328,126014.78273158851,1659.3764735510845,127674.15920513959,206,0,36.78947368421053,35,3,22,39.765249759846306,0.5818452380952381,48.98726851851851,1004.0509259259247,28.687169312169278,0
2252,4,2,2,35,0.05405405405405406,0.05405405405405406,0.9459459459459459,37,950,800,150,0.8421052631578947,11,8,3,356.09514301841745,0.4750688188188188,0.16397743344264337,0.18507156416886694,126596.50051708262,1616.079791452351,128212.58030853498,207,0,33.86486486486486,35,2,21,39.44951600536709,0.5877976190476191,48.408564814814824,1006.365740740742,28.753306878306915,0
2253,4,1,1,35,0.027777777777777776,0.027777777777777776,0.9722222222222222,36,850,500,350,0.5882352941176471,12,5,7,398.8389171943984,0.47551256613756615,0.17646717698909775,0.19695241374857417,124479.70920138893,3155.072230795616,127634.78143218455,208,0,35.55555555555556,31,5,16,40.5706332637439,0.575268817204301,50.520833333333336,997.9166666666671,32.190860215053775,16
2254,4,2,1,36,0.05405405405405406,0.02702702702702703,0.972972972972973,37,850,600,250,0.7058823529411765,11,6,5,381.14915508952777,0.4772897897897898,0.2016844561335287,0.1910085234518868,125094.71490472919,2135.948978420584,127230.66388314977,209,0,35.513513513513516,32,5,20,40.37296478606591,0.5791015625,49.90530303030304,1000.3787878787886,31.261837121212142,0
2255,4,4,2,38,0.1,0.05,0.95,40,1400,1000,400,0.7142857142857143,18,10,8,349.30378510982956,0.47739049145299145,0.20182421227197378,0.18002579694121998,126253.1250000001,827.3129017447343,127080.43790174484,210,0,33.45,34,6,19,39.97374239911554,0.5863970588235294,48.75000000000001,1005.0000000000008,29.55882352941179,0
2256,4,2,3,37,0.05,0.075,0.925,40,700,400,300,0.5714285714285714,10,4,6,351.44526599936273,0.4763221153846154,0.22432033096926718,0.18353252779966728,126792.09183673473,912.096088435376,127704.1879251701,211,0,34.075,34,6,17,39.365395981087474,0.5919117647058824,48.214285714285715,1007.1428571428575,29.621848739495807,0
2257,4,2,0,39,0.05128205128205128,0.0,1.0,39,1400,1000,400,0.7142857142857143,18,10,8,356.69633503016433,0.4735436347278452,0.22353986439092877,0.18722574062687286,126999.35308835529,1260.040759563613,128259.3938479189,212,0,32.35897435897436,33,6,19,39.0201367781155,0.5962752525252526,48.00857843137254,1007.9656862745086,30.544414735591168,0
2258,4,2,1,40,0.04878048780487805,0.024390243902439025,0.975609756097561,41,1700,1300,400,0.7647058823529411,21,13,8,346.18420770117115,0.4721798780487805,0.22969875801539263,0.18544521291754315,127822.46823827569,650.0239786951029,128472.49221697079,213,0,31.73170731707317,35,6,17,38.44151787417495,0.600297619047619,47.193287037037024,1011.2268518518501,28.89219576719572,0
2259,4,0,2,38,0.0,0.05,0.95,40,1000,900,100,0.9,11,9,2,356.4095750284261,0.472275641025641,0.22747320692497963,0.19045146013633513,127723.00347222216,1104.3402777777733,128827.34374999993,214,1,33.5,34,6,17,38.28489969771916,0.6014093137254901,47.291666666666664,1010.8333333333328,29.73039215686273,0
2260,4,0,3,35,0.0,0.07894736842105263,0.9210526315789473,38,1050,800,250,0.7619047619047619,13,8,5,373.24347386803754,0.47061699857752487,0.23025410844856276,0.1980642375927469,127442.37075617291,1913.4066358024797,129355.7773919754,215,2,35.86842105263158,32,6,17,38.14763869784501,0.6031901041666667,47.56944444444445,1009.7222222222229,31.553819444444464,0
2261,4,3,2,36,0.07894736842105263,0.05263157894736842,0.9473684210526316,38,1200,800,400,0.6666666666666666,16,8,8,362.67260894556307,0.46937233285917496,0.19831565814098506,0.1952196749965542,128016.72222541085,1685.6317276298546,129702.3539530407,216,0,31.55263157894737,32,6,18,37.82569141193594,0.6090494791666667,47.00126262626264,1011.994949494951,31.62484217171722,0
2262,4,0,1,35,0.0,0.027777777777777776,0.9722222222222222,36,950,500,450,0.5263157894736842,14,5,9,382.5052382926893,0.4682374338624338,0.22098814696580038,0.20394853769393176,127634.70668574407,2564.1887790496075,130198.89546479368,217,1,34.30555555555556,30,6,19,37.71614791167865,0.6104166666666666,47.37903225806452,1010.4838709677423,33.68279569892474,0
2263,4,2,1,36,0.05405405405405406,0.02702702702702703,0.972972972972973,37,1200,900,300,0.75,15,9,6,367.57010331715816,0.46909409409409414,0.21468094492127388,0.19930752431434215,128309.3791537816,2032.538350423195,130341.9175042048,218,0,33.67567567567568,31,6,22,37.40213875680076,0.6145833333333333,46.71223958333334,1013.1510416666678,32.6822916666667,0
2264,4,3,2,37,0.07692307692307693,0.05128205128205128,0.9487179487179487,39,1250,900,350,0.72,16,9,7,347.1630845544937,0.4701698155645524,0.19720819720819738,0.1913090189353487,128952.3260284506,1153.4974529027288,130105.82348135332,219,0,32.666666666666664,33,6,18,37.26321187258687,0.6161616161616161,46.07843137254902,1015.6862745098039,30.77837195484254,0
2265,4,0,1,36,0.0,0.02702702702702703,0.972972972972973,37,1000,700,300,0.7,13,7,6,362.44045422061816,0.4692817817817818,0.2019107573418879,0.19856400344724676,128720.46100206621,1930.7004706152545,130651.16147268146,220,1,34.62162162162162,32,5,18,37.1119509767326,0.6162109375,46.30681818181819,1014.772727272728,31.71164772727275,0
2266,4,1,1,36,0.02702702702702703,0.02702702702702703,0.972972972972973,37,1150,600,550,0.5217391304347826,17,6,11,353.66835005959234,0.46918793793793795,0.18180514732238828,0.1958161078367331,129139.1006463861,1734.4825307574085,130873.5831771435,221,0,33.7027027027027,33,4,19,36.90770436460092,0.6180555555555556,45.89460784313726,1016.4215686274517,30.800653594771266,0
2267,4,0,1,35,0.0,0.027777777777777776,0.9722222222222222,36,1000,600,400,0.6,14,6,8,362.60740117923734,0.4681216931216931,0.19057088408318856,0.20010556583594935,129008.91012396685,2155.9171258034767,131164.82724977034,222,1,35.5,32,4,19,36.81332339050459,0.619140625,46.022727272727266,1015.9090909090901,31.747159090909065,0
2268,4,0,3,32,0.0,0.08571428571428572,0.9142857142857143,35,1250,900,350,0.72,16,9,7,366.408248169067,0.4674019607843137,0.06820777991821281,0.19050524784878778,126612.30867346923,2278.3588435373927,128890.66751700663,223,2,37.17142857142857,34,1,16,39.17376389874613,0.5900735294117647,48.39285714285713,1006.4285714285702,29.600840336134418,16
2269,4,1,0,33,0.030303030303030304,0.0,1.0,33,1250,800,450,0.64,17,8,9,388.095040051377,0.46709280303030304,0.11177139967126037,0.19244160951513112,124653.01890432101,3075.4436728395044,127728.46257716052,224,0,39.696969696969695,32,1,14,40.658321743161785,0.5745442708333333,50.34722222222222,998.6111111111113,31.20659722222223,15
2270,4,4,1,36,0.10810810810810811,0.02702702702702703,0.972972972972973,37,1050,700,350,0.6666666666666666,14,7,7,353.4719917471238,0.47291041041041043,0.11880845588458411,0.17988694619999365,125733.05357722602,1488.622575277996,127221.67615250402,225,0,36.2972972972973,36,1,16,40.40534471143048,0.5769675925925926,49.268018018018026,1002.9279279279292,27.859109109109145,0
2271,4,1,0,37,0.02702702702702703,0.0,1.0,37,900,400,500,0.4444444444444444,14,4,10,350.733166737812,0.4733796296296296,0.1198059660288866,0.17885986161804063,125817.77459469617,1425.6933031004123,127243.46789779658,226,0,37.270270270270274,36,1,17,40.386594080892,0.5778356481481481,49.183558558558566,1003.2657657657667,27.868493493493517,0
2272,4,3,6,34,0.075,0.15,0.85,40,1150,900,250,0.782608695652174,14,9,5,329.19694874536367,0.4736778846153846,0.11362453531598504,0.17057728521946053,126473.33311646208,327.12997752736413,126800.46309398944,227,0,35.4,38,2,13,40.25269959284828,0.5808662280701755,48.5309829059829,1005.876068376068,26.47042285200179,0
2273,4,3,2,35,0.08108108108108109,0.05405405405405406,0.9459459459459459,37,1050,700,350,0.6666666666666666,14,7,7,345.6595974190806,0.47372372372372373,0.12630452234412637,0.17850173978490658,126334.56173911155,1333.7507501714379,127668.312489283,228,0,37.5945945945946,35,2,14,39.981483613477614,0.5851190476190475,48.66898148148147,1005.3240740740721,28.723544973544918,0
2274,4,3,2,36,0.07894736842105263,0.05263157894736842,0.9473684210526316,38,950,700,250,0.7368421052631579,12,7,5,379.8647750110111,0.47688477951635844,0.13322034324669363,0.18580293992210117,124079.08340419497,1936.313613665622,126015.3970178606,229,0,37.526315789473685,34,4,18,41.46104672003823,0.564031862745098,50.922619047619044,996.3095238095234,29.303221288515395,16
2275,4,3,4,35,0.07692307692307693,0.10256410256410256,0.8974358974358975,39,1500,900,600,0.6,21,9,12,365.6059205345414,0.4769455690508322,0.13861492090103278,0.18103999256779293,124595.23560742446,1310.5511616940921,125905.78676911855,230,0,37.30769230769231,35,4,17,41.2797550042507,0.5672619047619047,50.40509259259259,998.3796296296289,28.525132275132254,0
2276,4,3,1,37,0.07894736842105263,0.02631578947368421,0.9736842105263158,38,1100,800,300,0.7272727272727273,14,8,6,376.1816545943951,0.47510668563300146,0.16745663789059395,0.18796028421289607,124971.06648930443,1802.364513674522,126773.43100297895,231,0,38.421052631578945,35,3,19,40.6254823089092,0.5711309523809525,50.02893518518517,999.8842592592571,28.56812169312163,0
2277,4,4,3,38,0.0975609756097561,0.07317073170731707,0.926829268292683,41,1350,1100,250,0.8148148148148148,16,11,5,353.98999866207475,0.47609247967479673,0.17430666819511131,0.1804264344155606,125796.22005088067,706.1241024808007,126502.34415336147,232,0,36.51219512195122,37,4,19,40.327153240791354,0.5757319819819819,49.2050438596491,1003.1798245614004,27.1129682313892,0
2278,4,4,0,42,0.09523809523809523,0.0,1.0,42,1000,800,200,0.8,12,8,4,345.806937811381,0.47536778939217966,0.22473058053541628,0.1802042737221394,126705.33842143722,363.3604811095525,127068.69890254678,233,0,36.38095238095238,37,5,20,39.596493138749715,0.5850225225225225,48.30043859649122,1006.7982456140339,27.21076339497389,0
2279,4,1,2,41,0.023255813953488372,0.046511627906976744,0.9534883720930233,43,1450,800,650,0.5517241379310345,21,8,13,341.4738940868293,0.47639811738648946,0.23025646207037664,0.1795258572979054,127065.0833356159,77.88176181602617,127142.96509743192,234,0,36.51162790697674,38,5,21,39.33630037794497,0.5868969298245614,47.943376068376054,1008.2264957264933,26.532276203328774,0
2280,4,3,3,41,0.06818181818181818,0.06818181818181818,0.9318181818181819,44,1100,700,400,0.6363636363636364,15,7,8,328.39498031507935,0.47605047568710357,0.22495244134432446,0.17555216405317953,127739.20323800115,-410.2145198699917,127328.98871813116,235,0,35.81818181818182,38,6,16,38.976299936588454,0.59375,47.275641025641015,1010.8974358974345,26.602564102564067,0
2281,4,0,1,40,0.0,0.024390243902439025,0.975609756097561,41,1250,900,350,0.72,16,9,7,355.30258395757926,0.47375508130081306,0.23967330498993045,0.1879999109290103,127325.53155006857,847.8180727023268,128173.3496227709,236,1,39.41463414634146,35,6,18,38.720374617736994,0.5952380952380952,47.68518518518518,1009.2592592592591,28.835978835978832,0
2282,4,1,1,40,0.024390243902439025,0.024390243902439025,0.975609756097561,41,1450,1100,350,0.7586206896551724,18,11,7,390.3557237337214,0.47451727642276426,0.13105949447689724,0.19651622434823351,125284.25232438018,1825.426561490328,127109.67888587051,237,0,40.09756097560975,32,9,15,39.94592634632362,0.5810546875,49.71590909090909,1001.1363636363639,31.28551136363637,16
2283,4,2,2,40,0.047619047619047616,0.047619047619047616,0.9523809523809523,42,1500,1100,400,0.7333333333333333,19,11,8,383.5742979681347,0.473988579171506,0.16529263687854012,0.18684842411752467,123905.9133579562,1238.9689953870013,125144.8823533432,238,0,39.95238095238095,37,5,18,41.549192364170345,0.5563063063063063,51.09649122807017,995.6140350877185,26.908487434803202,16
2284,4,8,6,42,0.16666666666666666,0.125,0.875,48,1600,1400,200,0.875,18,14,4,331.39455880966835,0.4797115100472813,0.212299321846239,0.1692818228829454,125886.98459201407,-1241.8840713007648,124645.1005207133,239,0,35.479166666666664,39,9,16,40.80037713653034,0.5731837606837606,49.11458333333334,1003.5416666666681,25.731837606837644,0
2285,4,3,2,43,0.06666666666666667,0.044444444444444446,0.9555555555555556,45,1850,1200,650,0.6486486486486487,25,12,13,349.68691781261924,0.476746632996633,0.21675021823169982,0.17844847867757374,125846.02127465299,-198.65854029705793,125647.36273435593,240,0,38.022222222222226,36,9,17,40.38369809203143,0.578125,49.1554054054054,1003.3783783783781,27.871621621621614,0
2286,4,2,0,45,0.044444444444444446,0.0,1.0,45,1400,900,500,0.6428571428571429,19,9,10,359.87762985173066,0.47640993265993264,0.2582527253185938,0.18558060199717497,126276.38996056233,88.96493465436589,126365.35489521669,241,0,38.977777777777774,35,10,16,39.68409335175802,0.5845238095238094,48.72685185185185,1005.0925925925919,28.716931216931197,0
2287,4,2,7,40,0.0425531914893617,0.14893617021276595,0.851063829787234,47,1600,1100,500,0.6875,21,11,10,349.11321174153045,0.47799105766265804,0.13256462481230114,0.17687299684914487,125547.47314453112,-535.8855573238322,125011.5875872073,242,0,38.276595744680854,39,8,19,40.706202577694626,0.5697115384615384,49.45312499999999,1002.187499999999,25.69711538461536,16
2288,4,2,1,41,0.047619047619047616,0.023809523809523808,0.9761904761904762,42,1050,700,350,0.6666666666666666,14,7,7,362.0877079165824,0.4740248741773132,0.17854931768402826,0.18504683364380053,125906.2418845217,717.8205072714193,126624.06239179312,243,0,38.73809523809524,37,5,21,40.01044739429695,0.5768581081081081,49.09539473684208,1003.6184210526278,27.124822190611564,0
2289,4,3,3,41,0.06818181818181818,0.06818181818181818,0.9318181818181819,44,1350,1000,350,0.7407407407407407,17,10,7,346.42568370986885,0.4758853065539112,0.19595611285266434,0.18068965517241392,126742.13927469157,-18.352976129384615,126723.78629856218,244,0,37.34090909090909,35,9,21,39.543103448275865,0.5892857142857143,48.2638888888889,1006.9444444444462,28.76984126984132,0
2290,4,1,2,40,0.023809523809523808,0.047619047619047616,0.9523809523809523,42,1600,1100,500,0.6875,21,11,10,353.3693621076484,0.47368612078977934,0.1997202852302724,0.18467314223550443,126822.06809807279,563.0066609977619,127385.07475907056,245,0,39.357142857142854,34,8,22,39.28613639049757,0.592218137254902,48.184523809523824,1007.2619047619066,29.625350140056078,0
2291,4,2,2,40,0.047619047619047616,0.047619047619047616,0.9523809523809523,42,1300,900,400,0.6923076923076923,17,9,8,337.1010650592337,0.4727666473093302,0.1879411120656258,0.17879638103610795,127422.33737244923,191.41510770978152,127613.752480159,246,0,38.166666666666664,34,8,19,39.0804936524781,0.5983455882352942,47.58928571428573,1009.6428571428592,29.695378151260563,0
2292,4,1,0,41,0.024390243902439025,0.0,1.0,41,1050,900,150,0.8571428571428571,12,9,3,339.78295088320095,0.47268800813008127,0.18402633054026496,0.18075600866733313,127542.56129535167,467.3575680272388,128009.9188633789,247,0,39.75609756097561,34,7,21,38.88970732665489,0.5995710784313726,47.47023809523811,1010.1190476190492,29.709383753501445,0
2293,4,1,2,40,0.023809523809523808,0.047619047619047616,0.9523809523809523,42,1050,500,550,0.47619047619047616,16,5,11,334.1708729255513,0.47245209059233445,0.18755823647687686,0.17927067271309985,127880.99500868077,146.82074652780153,128027.81575520856,248,0,39.785714285714285,35,7,22,38.68541881222107,0.6008928571428571,47.13541666666668,1011.4583333333351,28.898809523809575,0
2294,4,0,0,40,0.0,0.0,1.0,40,1400,1100,300,0.7857142857142857,17,11,6,341.6925304189948,0.4718616452991453,0.16655385520894694,0.18313426157156854,127843.36911848074,736.62485827665,128579.9939767574,249,1,39.675,34,6,22,38.53369629193646,0.6026348039215687,47.17261904761905,1011.3095238095239,29.74439775910364,0
2295,4,1,0,41,0.024390243902439025,0.0,1.0,41,800,500,300,0.625,11,5,6,330.944102913388,0.47190040650406506,0.16223081708893994,0.17897911528825106,128204.8061933105,286.07922335599375,128490.8854166665,250,0,39.68292682926829,34,7,23,38.436483680106605,0.6063112745098039,46.81547619047618,1012.7380952380939,29.78641456582629,0
2296,4,1,1,41,0.023809523809523808,0.023809523809523808,0.9761904761904762,42,1100,500,600,0.45454545454545453,17,5,12,325.28272167388593,0.4721496322106078,0.17070217917675623,0.16393916402316094,125330.5027286171,-230.04737278116704,125100.45535583593,251,0,39.714285714285715,40,2,12,41.52690381947969,0.5658854166666667,49.669715447154466,1001.321138211381,25.033028455284526,16
2297,4,2,3,40,0.046511627906976744,0.06976744186046512,0.9302325581395349,43,1150,800,350,0.6956521739130435,15,8,7,317.5157759579163,0.47153008490217796,0.20257437307715365,0.16202596155592136,125844.67612276376,-608.4660021416116,125236.21012062216,252,0,39.651162790697676,41,2,14,41.192076988992156,0.5696138211382114,49.156746031746025,1003.3730158730145,24.472512582268646,0
2298,4,4,4,40,0.09090909090909091,0.09090909090909091,0.9090909090909091,44,900,500,400,0.5555555555555556,13,5,8,313.76006940995626,0.4717010218463707,0.21919932013413512,0.162292518913305,126401.26294079279,-867.7512524469936,125533.5116883458,253,0,38.72727272727273,40,4,12,40.714797035539824,0.5768229166666667,48.60264227642278,1005.5894308943111,25.139735772357778,0
2299,4,3,6,37,0.06976744186046512,0.13953488372093023,0.8604651162790697,43,1050,800,250,0.7619047619047619,13,8,5,309.05258681557933,0.47206072351421186,0.20409005267283664,0.1608024382477369,126642.26367630392,-772.1761621315142,125870.08751417241,254,0,38.51162790697674,41,2,13,40.58619160260201,0.5777439024390244,48.36309523809524,1006.5476190476196,24.549941927990723,0
2300,4,2,2,37,0.05128205128205128,0.05128205128205128,0.9487179487179487,39,1000,600,400,0.6,14,6,8,354.6112248292549,0.46814552406657667,0.24016712329532308,0.18466736557897842,126677.7412881848,1184.2697993613356,127862.01108754614,255,0,40.56410256410256,37,2,15,39.403273971608016,0.584740990990991,48.32785087719298,1006.6885964912278,27.20779990516832,0
2301,4,1,0,38,0.02631578947368421,0.0,1.0,38,1250,700,550,0.56,18,7,11,363.4552379633795,0.4682017543859649,0.24302886171922355,0.189484156421608,126723.24087178399,1611.6451333089863,128334.88600509297,256,0,42.026315789473685,36,2,16,39.13385900160309,0.5870949074074074,48.28265765765766,1006.8693693693697,27.968593593593603,0
2302,4,3,2,39,0.07317073170731707,0.04878048780487805,0.9512195121951219,41,1350,900,450,0.6666666666666666,18,9,9,340.71370887246536,0.4695884146341463,0.23433805285832743,0.18109140060151613,127506.96277941272,489.74563437129876,127996.70841378401,257,0,39.8780487804878,37,4,13,38.902648101907154,0.5931869369369369,47.50548245614034,1009.9780701754371,27.296704599336138,0
2303,4,1,0,40,0.025,0.0,1.0,40,1550,1100,450,0.7096774193548387,20,11,9,348.0475609892509,0.46908386752136755,0.2379096989966556,0.18517121127364045,127546.62390430961,878.4582724616386,128425.08217677125,258,0,41.85,36,4,15,38.67683946488294,0.5954861111111112,47.46621621621621,1010.1351351351343,28.059309309309285,0
2304,4,3,5,38,0.06976744186046512,0.11627906976744186,0.8837209302325582,43,1400,1000,400,0.7142857142857143,18,10,8,331.38882237818564,0.46836932447397567,0.25140942516484177,0.18025403189279599,128434.73442925325,-87.6329210069643,128347.10150824628,259,0,39.86046511627907,39,4,11,38.190769191244485,0.5990918803418803,46.58854166666666,1013.6458333333316,25.990918803418758,0
2305,4,0,0,38,0.0,0.0,1.0,38,1050,600,450,0.5714285714285714,15,6,9,365.6488749482899,0.46618658131816026,0.24493556545826745,0.1963004402363671,127910.26341735266,1754.0487825788875,129664.31219993155,260,1,40.6578947368421,35,3,17,37.859458428680405,0.6011904761904762,47.10648148148149,1011.574074074075,28.90211640211643,0
2306,4,1,3,36,0.02564102564102564,0.07692307692307693,0.9230769230769231,39,1200,700,500,0.5833333333333334,17,7,10,378.2808656644404,0.46682411156095366,0.22074925969285886,0.196530105556828,126581.54776398026,1843.1728353102972,128424.72059929055,261,0,40.58974358974359,36,3,15,38.906762906595056,0.5856481481481481,48.42342342342343,1006.3063063063069,27.95295295295297,15
2307,4,0,2,34,0.0,0.05555555555555555,0.9444444444444444,36,1350,1000,350,0.7407407407407407,17,10,7,395.27440168049066,0.46552579365079366,0.24626289706718696,0.20451587264754764,126413.28605584391,2793.587202037682,129206.8732578816,262,1,43.083333333333336,33,3,15,38.65311966853523,0.5902777777777778,48.59068627450981,1005.6372549019609,30.47385620915033,0
2308,4,1,1,34,0.02857142857142857,0.02857142857142857,0.9714285714285714,35,1200,900,300,0.75,15,9,6,406.6499900906329,0.4664915966386554,0.26526006591202167,0.2122670367122309,126773.92612998674,3310.5231609019465,130084.44929088868,263,0,44.22857142857143,32,3,17,37.994190906051486,0.5963541666666667,48.23232323232323,1007.070707070707,31.470959595959595,0
2309,4,5,5,34,0.1282051282051282,0.1282051282051282,0.8717948717948718,39,1000,800,200,0.8,12,8,4,373.248403442732,0.4699167791273054,0.23536244126498107,0.20067266561478236,127968.81028163563,1753.2293818870276,129722.03966352265,264,0,39.69230769230769,35,4,17,37.60724090597116,0.6017857142857144,47.0486111111111,1011.8055555555541,28.908730158730116,0
2310,4,0,2,32,0.0,0.058823529411764705,0.9411764705882353,34,900,500,400,0.5555555555555556,13,5,8,423.6933621187397,0.4655934343434343,0.267433839207325,0.22327212003785246,127159.7872586425,3975.3515579835694,131135.13881662607,265,1,46.1764705882353,30,4,18,37.16601146055438,0.6055555555555556,47.84946236559139,1008.6021505376334,33.62007168458778,0
2311,4,0,0,32,0.0,0.0,1.0,32,1200,1000,200,0.8333333333333334,14,10,4,443.68269987522604,0.4653267809139785,0.2545012060647833,0.23241285108987453,126917.01630015418,4862.176890432085,131779.19319058626,266,2,47.53125,29,3,18,36.91347920974042,0.6059626436781609,48.09027777777777,1007.6388888888878,34.74616858237544,0
2312,4,0,0,32,0.0,0.0,1.0,32,1250,900,350,0.72,16,9,7,445.6662796257084,0.4649907594086022,0.24922520661156988,0.23445921667265546,127092.01388888895,4928.125000000008,132020.13888888896,267,3,48.53125,29,3,18,36.682162534435264,0.6077586206896552,47.91666666666667,1008.3333333333339,34.77011494252876,0
2313,4,3,1,34,0.08571428571428572,0.02857142857142857,0.9714285714285714,35,900,600,300,0.6666666666666666,12,6,6,409.78224217793326,0.4676120448179271,0.22101316079700029,0.2205559270226381,128012.72922092007,3491.468641493044,131504.1978624131,268,0,45.285714285714285,31,4,21,36.63793103448275,0.6115591397849462,47.00520833333333,1011.9791666666661,32.64448924731181,0
2314,4,1,3,32,0.02857142857142857,0.08571428571428572,0.9142857142857143,35,550,400,150,0.7272727272727273,7,4,3,413.17991773233086,0.46936274509803927,0.17814426862788824,0.20854198997356227,125390.93017578124,3601.7388237847217,128992.66899956595,269,0,44.0,31,4,15,39.26373721615533,0.5846774193548387,49.609375,1001.5624999999999,32.30846774193548,16
2315,4,5,3,34,0.13513513513513514,0.08108108108108109,0.9189189189189189,37,1100,900,200,0.8181818181818182,13,9,4,384.9199150594735,0.47300425425425424,0.1640836917812174,0.19859672351189028,126297.54178463928,2324.5832321996695,128622.12501683895,270,0,40.567567567567565,32,5,16,39.032994179960625,0.5914713541666667,48.705808080808076,1005.1767676767673,31.41177398989898,0
2316,4,8,4,38,0.19047619047619047,0.09523809523809523,0.9047619047619048,42,1500,1200,300,0.8,18,12,6,340.3622004484107,0.4735772357723577,0.1758269562433521,0.18227759654676193,127811.68845221598,300.45350492458203,128112.14195714056,271,0,36.54761904761905,37,5,16,38.59972529458541,0.5962837837837838,47.20394736842105,1011.184210526315,27.329302987197703,0
2317,4,1,1,38,0.02564102564102564,0.02564102564102564,0.9743589743589743,39,1550,1200,350,0.7741935483870968,19,12,7,360.1603817220074,0.4721097615834458,0.19023791826054404,0.1917390840208877,127572.62613378659,1389.3211451246862,128961.94727891128,272,0,40.333333333333336,34,5,19,38.34428274019953,0.5998774509803921,47.440476190476176,1010.2380952380931,29.712885154061563,0
2318,4,1,4,35,0.02564102564102564,0.10256410256410256,0.8974358974358975,39,1650,1100,550,0.6666666666666666,22,11,11,350.69731527722263,0.47098515519568146,0.18135763162060892,0.1890997977444259,128085.94419795948,1183.879350994506,129269.823548954,273,0,40.35897435897436,35,4,21,38.057874075767955,0.6029761904761906,46.93287037037037,1012.2685185185181,28.92195767195766,0
2319,4,1,0,36,0.027777777777777776,0.0,1.0,36,1000,600,400,0.6,14,6,8,376.01135128607666,0.47055224867724865,0.18246336996336998,0.20127666451195853,127793.20987654309,2410.339506172823,130203.54938271591,274,0,41.77777777777778,32,4,22,37.71749084249083,0.6067708333333333,47.222222222222214,1011.1111111111102,31.597222222222193,0
2320,4,1,4,33,0.02702702702702703,0.10810810810810811,0.8918918918918919,37,1050,600,450,0.5714285714285714,15,6,9,379.37589477971136,0.4707207207207207,0.16262553778924782,0.1895525366005228,124970.23986677971,2163.640085663852,127133.87995244356,275,0,41.62162162162162,34,3,17,40.54649363019406,0.5732230392156863,50.029761904761884,999.8809523809496,29.408263305322045,16
2321,4,0,2,31,0.0,0.06060606060606061,0.9393939393939394,33,1050,800,250,0.7619047619047619,13,8,5,413.0543727648667,0.4691445707070707,0.20610630952672437,0.2042171619275565,124530.01250144522,3687.5332408370887,128217.54574228231,276,1,46.18181818181818,30,3,17,40.16350210970465,0.5784722222222223,50.47043010752688,998.1182795698923,33.27060931899641,0
2322,4,4,0,35,0.11428571428571428,0.0,1.0,35,1150,900,250,0.782608695652174,14,9,5,389.012565718952,0.47338935574229696,0.17217618224776965,0.18649584659496748,123229.35439494431,2613.640295860961,125842.99469080527,277,0,42.857142857142854,33,2,17,42.120772648728696,0.557449494949495,51.77696078431373,992.8921568627457,30.087641117052897,16
2323,4,6,4,37,0.14634146341463414,0.0975609756097561,0.9024390243902439,41,1150,900,250,0.782608695652174,14,9,5,343.4721087272993,0.47903963414634143,0.17668270196037472,0.1707241889042236,124753.41120585153,374.1887030750951,125127.59990892663,278,0,37.4390243902439,37,4,15,41.66838162660518,0.5650337837837838,50.24671052631577,999.0131578947346,27.00035561877661,0
2324,4,6,4,39,0.13953488372093023,0.09302325581395349,0.9069767441860466,43,850,500,350,0.5882352941176471,12,5,7,327.29383341825536,0.47812846068660025,0.19751105023642612,0.16554481159307693,125479.06172642265,-385.56498176108784,125093.49674466156,279,0,36.41860465116279,36,7,13,41.32338616012889,0.5743634259259259,49.52139639639641,1001.9144144144168,27.83095595595602,0
2325,4,6,4,41,0.13333333333333333,0.08888888888888889,0.9111111111111111,45,1400,1000,400,0.7142857142857143,18,10,8,310.1872413380848,0.47984006734006734,0.19654793549530325,0.15967766857059054,126204.81231508886,-1170.575484878362,125034.23683021049,280,0,33.51111111111111,38,7,17,41.00611376927166,0.578125,48.79807692307693,1004.8076923076932,26.442307692307715,0
2326,4,4,3,42,0.08888888888888889,0.06666666666666667,0.9333333333333333,45,1150,800,350,0.6956521739130435,15,8,7,323.783967822737,0.4798611111111111,0.2371718843377928,0.16902502164741998,126777.10503472204,-790.3211805555742,125986.78385416647,281,0,34.31111111111111,39,6,16,40.077230726796316,0.5822649572649572,48.22916666666666,1007.0833333333319,25.822649572649535,0
2327,4,3,2,43,0.06666666666666667,0.044444444444444446,0.9555555555555556,45,1250,600,650,0.48,19,6,13,323.99876942508706,0.47800925925925924,0.23641560767296865,0.1703413410790559,127065.7565646702,-766.1702473958294,126299.58631727437,282,0,35.2,39,6,19,39.77608310087128,0.5852029914529915,47.942708333333336,1008.2291666666672,25.85202991452993,0
2328,4,1,1,43,0.022727272727272728,0.022727272727272728,0.9772727272727273,44,1050,600,450,0.5714285714285714,15,6,9,335.32547014933766,0.47750396405919665,0.24507258662710574,0.17629339620051798,127065.08333561609,-278.3682381839588,126786.71509743213,283,0,36.79545454545455,38,6,20,39.491275475963405,0.5868969298245614,47.94337606837606,1008.2264957264949,26.532276203328813,0
2329,4,1,0,44,0.022727272727272728,0.0,1.0,44,1550,1300,250,0.8387096774193549,18,13,5,330.37231551626144,0.4779664376321353,0.23734353803673325,0.17508065111122575,127388.4383104135,-382.8773330776492,127005.56097733586,284,0,37.5,38,6,15,39.285021342646495,0.5901864035087719,47.62286324786325,1009.5085470085473,26.566014394961773,0
2330,4,1,2,43,0.022222222222222223,0.044444444444444446,0.9555555555555556,45,1150,600,550,0.5217391304347826,17,6,11,324.10929877593276,0.478030303030303,0.24213358984048416,0.17307828981964102,127696.68104383691,-722.4636501736072,126974.2173936633,285,0,37.644444444444446,39,6,16,39.1280402968154,0.5916132478632479,47.317708333333336,1010.7291666666675,25.916132478632502,0
2331,4,2,2,43,0.044444444444444446,0.044444444444444446,0.9555555555555556,45,1250,800,450,0.64,17,8,9,333.9614460572671,0.4756523569023569,0.2609224577530811,0.18010196075385823,128091.8023003474,-444.45529513887107,127647.34700520852,286,0,38.22222222222222,39,6,18,38.475423612540304,0.5956196581196581,46.92708333333334,1012.2916666666681,25.956196581196618,0
2332,4,2,2,43,0.044444444444444446,0.044444444444444446,0.9555555555555556,45,1600,1300,300,0.8125,19,13,6,373.026251760103,0.47367424242424244,0.2513766139298059,0.19217456983593834,126236.59593576871,688.3555517082231,126924.95148747694,287,0,39.0,37,8,17,39.39477632296783,0.5802364864864865,48.766447368421055,1004.9342105263158,27.160384068278805,16
2333,4,3,3,43,0.06521739130434782,0.06521739130434782,0.9347826086956522,46,1350,800,550,0.5925925925925926,19,8,11,355.85001024520153,0.47224235104669887,0.25961192957240353,0.18720804886812795,127092.01388888899,-151.9726021468046,126940.04128674218,288,0,38.76086956521739,39,7,18,38.94628099173553,0.5854700854700854,47.91666666666667,1008.3333333333343,25.85470085470088,0
2334,4,2,3,42,0.044444444444444446,0.06666666666666667,0.9333333333333333,45,900,500,400,0.5555555555555556,13,5,8,351.2459265553211,0.4701388888888889,0.254046162570432,0.1864336448212076,127451.5971861534,-46.6291310788003,127404.9680550746,289,0,39.355555555555554,37,8,16,38.693465631447495,0.5926238738738738,47.560307017543856,1009.7587719298243,27.29077761972498,0
2335,4,0,2,40,0.0,0.047619047619047616,0.9523809523809523,42,1000,800,200,0.8,12,8,4,360.9882016619078,0.4695121951219512,0.24253818972250007,0.1908705961364566,127296.33012099174,790.4946577074554,128086.8247786992,290,1,40.42857142857143,35,7,20,38.60689777115114,0.5949404761904762,47.71412037037036,1009.1435185185169,28.83267195767191,0
2336,4,1,3,38,0.024390243902439025,0.07317073170731707,0.926829268292683,41,1050,700,350,0.6666666666666666,14,7,7,357.5284761783519,0.4700965447154472,0.23250518253149033,0.18991321624426782,127482.44224773235,915.7206632652931,128398.16291099765,291,0,41.4390243902439,34,7,17,38.50323195410428,0.5989583333333333,47.5297619047619,1009.8809523809517,29.702380952380935,0
2337,4,0,0,38,0.0,0.0,1.0,38,1200,800,400,0.6666666666666666,16,8,8,383.1705484598048,0.46972795163584635,0.23879947803392798,0.20158102766798416,127092.01388888886,2139.583333333329,129231.59722222219,292,1,44.3421052631579,31,7,20,38.25757575757574,0.6021505376344086,47.916666666666664,1008.333333333333,32.5268817204301,0
2338,4,1,0,39,0.02564102564102564,0.0,1.0,39,1500,900,600,0.6,21,9,12,373.34103119992494,0.4692420152946469,0.229773462783172,0.19821714543088773,127462.99500192217,1717.433198769686,129180.42820069185,293,0,44.17948717948718,33,6,18,38.123988673139166,0.601010101010101,47.54901960784313,1009.803921568626,30.60011883541291,0
2339,4,0,1,38,0.0,0.02564102564102564,0.9743589743589743,39,1250,1000,250,0.8,15,10,5,411.4251254077468,0.46921390013495273,0.21345146999597286,0.19944720546416134,123701.30750868037,2610.9024699033785,126312.20997858375,294,1,45.17948717948718,35,4,15,41.07002617801047,0.5580357142857143,51.30208333333332,994.7916666666652,28.422619047619005,16
2340,4,1,4,35,0.02564102564102564,0.10256410256410256,0.8974358974358975,39,1150,900,250,0.782608695652174,14,9,5,394.9201120006521,0.4699730094466936,0.17144240858826376,0.1891250586616186,123183.7293836804,2323.1553819444234,125506.88476562483,295,0,45.38461538461539,35,4,14,42.02190451206714,0.5526785714285714,51.82291666666666,992.708333333332,28.3630952380952,15
2341,4,4,1,38,0.10256410256410256,0.02564102564102564,0.9743589743589743,39,1600,1500,100,0.9375,17,15,2,372.31939515470816,0.4741621682411156,0.17809499392124906,0.1793341633523533,123429.11193522181,1391.010460040918,124820.12239526273,296,0,41.0,38,1,15,42.32654194889439,0.5496162280701755,51.575854700854705,993.696581196582,26.149910031489,16
2342,4,4,2,40,0.09523809523809523,0.047619047619047616,0.9523809523809523,42,800,600,200,0.75,10,6,4,360.6540199137109,0.47436362756484707,0.20550456108442972,0.17757176866858246,124355.9903706855,569.8975655077037,124925.8879361932,297,0,38.976190476190474,41,1,14,41.651747231615964,0.5543699186991871,50.64484126984128,997.4206349206364,24.327332559039913,0
2343,4,6,4,42,0.13043478260869565,0.08695652173913043,0.9130434782608696,46,900,700,200,0.7777777777777778,11,7,4,356.87017345097905,0.4751710950080515,0.2522969036573528,0.17790534376638348,124876.02281942853,-231.2416343852508,124644.78118504328,298,0,36.32608695652174,41,5,14,41.20667907361457,0.5597052845528455,50.12400793650793,999.5039682539668,24.378145567169923,16
2344,4,3,4,41,0.06666666666666667,0.08888888888888889,0.9111111111111111,45,1050,700,350,0.6666666666666666,14,7,7,368.05553913273945,0.4753577441077441,0.27045031226032656,0.1848785308566048,125191.95960535922,215.7033731467187,125407.66297850595,299,0,37.577777777777776,37,8,18,40.59966308754245,0.5695382882882882,49.80811403508771,1000.7675438596482,27.04777145566617,0
2345,4,5,6,40,0.10869565217391304,0.13043478260869565,0.8695652173913043,46,1100,700,400,0.6363636363636364,15,7,8,364.27389392368616,0.473359500805153,0.2929213941100084,0.18880501146078538,126484.64551592815,20.787886657456653,126505.43340258561,300,0,35.82608695652174,37,9,15,39.358967371557306,0.5827702702702703,48.519736842105274,1005.9210526315803,27.1870554765292,0
2346,4,1,0,41,0.024390243902439025,0.0,1.0,41,1200,700,500,0.5833333333333334,17,7,10,399.95867839741004,0.4738313008130081,0.3246634955976111,0.20508519466760844,126043.83680555575,1882.465277777797,127926.30208333355,301,0,40.75609756097561,36,5,18,38.91770401106501,0.580150462962963,48.95833333333334,1004.1666666666682,27.89351851851856,0
2347,4,3,3,41,0.06818181818181818,0.06818181818181818,0.9318181818181819,44,1450,1100,350,0.7586206896551724,18,11,7,378.3654692425329,0.47561002466525726,0.3215033011681059,0.1984977110035564,126978.48820103898,808.855054378717,127787.3432554177,302,0,38.90909090909091,36,8,17,38.49557728119182,0.5896990740740741,48.02927927927929,1007.8828828828838,27.996746746746773,0
2348,4,2,1,42,0.046511627906976744,0.023255813953488372,0.9767441860465116,43,1150,700,450,0.6086956521739131,16,7,9,381.4457173199903,0.47478313030638614,0.33145469530589433,0.201687398988053,127296.33012099187,1111.378717442879,128407.70883843474,303,0,39.30232558139535,35,8,19,38.090783537867495,0.5949404761904762,47.71412037037037,1009.143518518518,28.832671957671945,0
2349,4,1,4,39,0.023255813953488372,0.09302325581395349,0.9069767441860466,43,1700,1300,400,0.7647058823529411,21,13,8,380.59062080092195,0.47436784791435954,0.330810292727733,0.2035798574829179,127763.95486379013,1125.1525795181565,128889.10744330828,304,0,39.86046511627907,35,8,17,37.63177351650448,0.5997023809523809,47.2511574074074,1010.995370370369,28.88558201058197,0
2350,4,0,0,39,0.0,0.0,1.0,39,900,700,200,0.7777777777777778,11,7,4,413.0355355775288,0.4715755735492578,0.33580788969448383,0.2178046794540512,127187.51793503213,2706.592917814506,129894.11085284663,305,1,43.76923076923077,32,7,19,37.406120916259844,0.6005859375,47.821969696969695,1008.7121212121211,31.522253787878785,0
2351,4,0,0,39,0.0,0.0,1.0,39,900,400,500,0.4444444444444444,14,4,10,416.162220779338,0.4712944219523167,0.3365865865865869,0.21997145955479297,127283.05785123965,2794.0800045913657,130077.13785583101,306,2,44.76923076923077,32,7,20,37.22863488488488,0.6015625,47.72727272727273,1009.0909090909089,31.534090909090903,0
2352,4,1,2,38,0.025,0.05,0.95,40,800,500,300,0.625,11,5,6,421.30165434162836,0.4717147435897436,0.2928060981419722,0.21005039725963834,124880.98072562349,2528.323705515249,127409.30443113873,307,0,44.625,34,6,21,39.59152175639192,0.5723039215686274,50.11904761904761,999.5238095238088,29.397759103641437,16
2353,4,2,1,39,0.05,0.025,0.975,40,750,400,350,0.5333333333333333,11,4,7,414.1312143296718,0.47142094017094016,0.29356242118537157,0.20864425220040028,125315.85584379155,2379.5548897551153,127695.41073354667,308,0,45.15,32,8,16,39.31799075241698,0.5813802083333333,49.68434343434344,1001.2626262626271,31.289457070707098,0
2354,4,4,1,42,0.09302325581395349,0.023255813953488372,0.9767441860465116,43,1100,600,500,0.5454545454545454,16,6,10,387.6892365400602,0.4718761535622001,0.2907252287005406,0.19951811929256724,126193.31065759611,1186.86601572827,127380.17667332439,309,0,42.906976744186046,34,9,20,39.07113941548184,0.5857843137254901,48.809523809523796,1004.7619047619027,29.551820728291254,0
2355,4,0,3,39,0.0,0.07142857142857142,0.9285714285714286,42,1700,1300,400,0.7647058823529411,21,13,8,397.7469027106901,0.4713995354239257,0.2174445836283425,0.1914293808825949,123395.33473944016,1772.1909493825465,125167.52568882272,310,1,44.38095238095238,32,10,16,41.73020714194942,0.5615234375,51.609848484848506,993.5606060606086,31.04876893939402,16
2356,4,4,3,40,0.09302325581395349,0.06976744186046512,0.9302325581395349,43,1000,600,400,0.6,14,6,8,389.1632271477197,0.47153008490217796,0.24731757051997838,0.19217441835438961,124479.70920138905,1089.8763917585138,125569.58559314757,311,0,41.906976744186046,33,10,19,40.81202157272095,0.5703914141414141,50.52083333333334,997.916666666668,30.23989898989903,0
2357,4,7,4,43,0.14893617021276595,0.0851063829787234,0.9148936170212766,47,1300,900,400,0.6923076923076923,17,9,8,363.0370140348055,0.4761023743447425,0.27351871877319955,0.18564250752106864,125930.78033692502,-255.40803683748697,125675.37230008753,312,0,38.8936170212766,36,11,18,39.96129249410972,0.5789930555555556,49.07094594594596,1003.7162162162183,27.881006006006064,0
2358,4,2,1,44,0.044444444444444446,0.022222222222222223,0.9777777777777777,45,1350,900,450,0.6666666666666666,18,9,9,374.47702346722724,0.4768308080808081,0.30133702166897236,0.1920190694800034,126043.83680555534,440.15489306872155,126483.99169862407,313,0,41.46666666666667,33,12,21,39.55739972337483,0.586489898989899,48.95833333333332,1004.1666666666649,30.429292929292878,0
2359,4,2,3,43,0.043478260869565216,0.06521739130434782,0.9347826086956522,46,1700,1200,500,0.7058823529411765,22,12,10,366.52316166861084,0.4759359903381643,0.30699705755262485,0.1902858576426962,126552.40929705196,76.87783446709958,126629.28713151906,314,0,41.47826086956522,34,12,15,39.2325780880265,0.5894607843137255,48.45238095238094,1006.1904761904746,29.593837535013957,0
2360,4,1,3,41,0.022727272727272728,0.06818181818181818,0.9318181818181819,44,1900,1500,400,0.7894736842105263,23,15,8,369.49922725957305,0.4754889006342495,0.30007895330475964,0.19338725790338707,126882.0312500001,576.5625000000148,127458.59375000012,315,0,42.86363636363637,34,10,19,38.81823821339952,0.5928308823529411,48.12500000000001,1007.5000000000008,29.632352941176492,0
2361,4,0,1,40,0.0,0.024390243902439025,0.975609756097561,41,1150,600,550,0.5217391304347826,17,6,11,404.37341311236673,0.4752032520325203,0.1990929807540449,0.20331519049975252,125231.58864883389,2094.905264060343,127326.49391289424,316,1,45.78048780487805,35,6,14,39.64982269503545,0.5738095238095238,49.76851851851851,1000.9259259259248,28.597883597883566,16
2362,4,0,1,39,0.0,0.025,0.975,40,700,400,300,0.5714285714285714,10,4,6,408.66651170875315,0.4735977564102564,0.21787583254043819,0.20550646115114793,125238.20861677996,2236.132369614506,127474.34098639447,317,2,47.85,34,6,14,39.53551181414528,0.5759803921568627,49.76190476190476,1000.9523809523803,29.439775910364126,0
2363,4,2,1,40,0.04878048780487805,0.024390243902439025,0.975609756097561,41,1050,700,350,0.6666666666666666,14,7,7,399.43677534702823,0.47423780487804873,0.2256604283494359,0.20309390971869992,125695.40895061706,1841.4737654320718,127536.88271604913,318,0,47.5609756097561,35,6,17,39.291897506925196,0.5785714285714285,49.30555555555554,1002.7777777777759,28.6507936507936,0
2364,4,1,1,40,0.024390243902439025,0.024390243902439025,0.975609756097561,41,1300,800,500,0.6153846153846154,18,8,10,397.5025971604367,0.47423780487804873,0.2201552678603198,0.20326681861680826,125930.78033692458,1811.5624492735801,127742.34278619816,319,0,46.609756097560975,36,5,18,39.096450876996144,0.5789930555555556,49.07094594594594,1003.7162162162148,27.881006006005965,0
2365,4,2,4,38,0.047619047619047616,0.09523809523809523,0.9047619047619048,42,1250,900,350,0.72,16,9,7,388.19389119186735,0.4747749709639954,0.21316334184982755,0.2002150900020121,126283.03748582769,1404.6129218366184,127687.6504076643,320,0,46.26190476190476,34,8,14,38.965711240080545,0.586703431372549,48.720238095238095,1005.1190476190478,29.562324929971993,0
2366,4,3,1,40,0.07317073170731707,0.024390243902439025,0.975609756097561,41,1200,600,600,0.5,18,6,12,384.9863481988613,0.47451727642276426,0.19550859414899602,0.20001779971265968,126582.35721371876,1546.4958900226684,128128.85310374142,321,0,45.707317073170735,34,7,17,38.73723332938995,0.5897671568627452,48.422619047619044,1006.3095238095233,29.597338935574214,0
2367,4,2,1,41,0.047619047619047616,0.023809523809523808,0.9761904761904762,42,1300,700,600,0.5384615384615384,19,7,12,379.175853456264,0.4730691056910569,0.20408280432393444,0.19905018129901153,127004.50002411265,1231.4079378858005,128235.90796199845,322,0,45.57142857142857,35,7,20,38.44837237340682,0.5919642857142857,48.00347222222222,1007.9861111111111,28.799603174603174,0
2368,4,1,1,41,0.023809523809523808,0.023809523809523808,0.9761904761904762,42,1450,1000,450,0.6896551724137931,19,10,9,379.8459725612322,0.47184717382888114,0.2221930974224553,0.20098646120958413,127325.53155006867,1272.8180727023432,128598.34962277101,323,0,46.45238095238095,35,7,16,38.10110856269114,0.5952380952380952,47.68518518518519,1009.2592592592599,28.835978835978853,0
2369,4,1,0,42,0.023809523809523808,0.0,1.0,42,1200,700,500,0.5833333333333334,17,7,10,375.9112344059934,0.4715084204413473,0.22537209200820607,0.20005812523753097,127559.2635459533,1190.1920438957452,128749.45558984905,324,0,46.976190476190474,35,7,18,37.960204705163456,0.5976190476190476,47.4537037037037,1010.1851851851848,28.86243386243385,0
2370,4,1,2,41,0.023255813953488372,0.046511627906976744,0.9534883720930233,43,1500,1000,500,0.6666666666666666,20,10,10,372.5290001359465,0.47196843853820597,0.23344333579221144,0.2003095790677128,127973.55791179695,934.7723145442749,128908.33022634122,325,0,46.86046511627907,36,7,19,37.62057132257467,0.5998263888888888,47.04391891891892,1011.8243243243244,28.106231231231234,0
2371,4,1,4,38,0.023809523809523808,0.09523809523809523,0.9047619047619048,42,1500,1100,400,0.7333333333333333,19,11,8,375.23465166839094,0.47080671699574134,0.24213559266696127,0.2030722595392755,128232.4369454088,1223.5648963645351,129456.00184177334,326,0,48.30952380952381,35,7,20,37.286810078848134,0.6044642857142857,46.788194444444436,1012.8472222222209,28.938492063492028,0
2372,4,1,2,37,0.02564102564102564,0.05128205128205128,0.9487179487179487,39,1750,1300,450,0.7428571428571429,22,13,9,390.25185646685884,0.46738641475483583,0.23506886653641135,0.21057752458084827,128114.39909297053,2199.3764172335623,130313.7755102041,327,0,50.56410256410256,34,5,23,37.02767325180307,0.6053921568627452,46.904761904761905,1012.3809523809524,29.77591036414566,0
2373,4,1,3,35,0.02631578947368421,0.07894736842105263,0.9210526315789473,38,1050,700,350,0.6666666666666666,14,7,7,385.0562968710653,0.4666162873399715,0.2056228101073394,0.2098224235733117,128506.3934948979,2296.4392006802645,130802.83269557817,328,0,50.1578947368421,34,4,17,36.75736761770576,0.609375,46.51785714285714,1013.928571428571,29.82142857142856,0
2374,4,0,1,34,0.0,0.02857142857142857,0.9714285714285714,35,700,400,300,0.5714285714285714,10,4,6,397.2972311992313,0.463235294117647,0.1880480640854474,0.2155720270705768,128336.36435376496,3197.5364439853106,131533.90079775028,329,2,51.74285714285714,32,3,24,36.62149532710281,0.6123046875,46.68560606060606,1013.2575757575761,31.664299242424253,0
2375,4,1,0,35,0.02857142857142857,0.0,1.0,35,1000,800,200,0.8,12,8,4,392.01145864020083,0.4630252100840336,0.17034772096992135,0.21459155869432237,128688.43102744612,3089.4679114375986,131777.8989388837,330,0,51.51428571428571,32,3,19,36.394557823129254,0.6158854166666667,46.338383838383834,1014.6464646464641,31.707702020202003,0
2376,4,0,0,35,0.0,0.0,1.0,35,1300,1100,200,0.8461538461538461,15,11,4,394.18255559693756,0.46172969187675067,0.1603879149571057,0.21700275801958724,128912.72454660239,3163.0294421487592,132075.75398875115,331,1,52.51428571428571,32,3,20,36.10981598905881,0.6181640625,46.11742424242424,1015.5303030303031,31.735321969696972,0
2377,4,1,2,34,0.027777777777777776,0.05555555555555555,0.9444444444444444,36,1250,900,350,0.72,16,9,7,384.6236028451151,0.461359126984127,0.15372155287817924,0.2139662133789852,129326.01042868142,2748.367214532888,132074.3776432143,332,0,52.02777777777778,33,3,22,35.93022088353413,0.619949494949495,45.7107843137255,1017.1568627450991,30.822935234699973,0
2378,4,0,0,34,0.0,0.0,1.0,34,1000,600,400,0.6,14,6,8,397.43327852108615,0.46132278669043375,0.16070648489869743,0.22076485812586635,129267.58660210496,3475.048149956593,132742.63475206154,333,1,55.0,31,3,22,35.664212548015385,0.6243279569892473,45.768229166666664,1016.9270833333327,32.80409946236557,0
2379,4,0,1,33,0.0,0.029411764705882353,0.9705882352941176,34,600,400,200,0.6666666666666666,8,4,4,398.42336903929487,0.46113710635769456,0.1622993283334837,0.22168684892699242,129333.80126953137,3505.9217664930707,132839.72303602443,334,2,56.0,31,3,23,35.57134323263356,0.625,45.70312500000001,1017.1875000000009,32.81250000000003,0
2380,4,1,0,34,0.029411764705882353,0.0,1.0,34,850,400,450,0.47058823529411764,13,4,9,383.85535972999827,0.4606914735591206,0.0794702224262469,0.19786284130394183,126259.28316332655,2893.060511582081,129152.34367490862,335,0,56.5,33,1,19,39.09927143031339,0.588699494949495,48.743872549019606,1005.0245098039211,30.455288175876397,15
2381,4,1,0,35,0.02857142857142857,0.0,1.0,35,1150,700,450,0.6086956521739131,16,7,9,372.23585869092483,0.4626050420168067,0.08321335631484716,0.19353517523819674,126612.30867346941,2425.9282879818647,129038.23696145127,336,0,55.857142857142854,34,1,15,39.02713705543729,0.5900735294117647,48.392857142857146,1006.4285714285716,29.600840336134457,0
2382,4,1,1,35,0.027777777777777776,0.027777777777777776,0.9722222222222222,36,1100,900,200,0.8181818181818182,13,9,4,364.3270842344288,0.4636739417989418,0.08144403594771243,0.19057109021493218,126858.71056241434,2043.6128257887601,128902.3233882031,337,0,55.27777777777778,35,1,16,38.97250306372548,0.5904761904761905,48.14814814814815,1007.4074074074081,28.783068783068803,0
2383,4,2,2,35,0.05405405405405406,0.05405405405405406,0.9459459459459459,37,800,500,300,0.625,11,5,6,355.9644976595652,0.46433933933933935,0.09157626135944397,0.18794321781335127,127237.93730977792,1658.6520222479414,128896.58933202586,338,0,54.24324324324324,35,2,18,38.79356907957632,0.5943452380952381,47.77199074074074,1008.9120370370367,28.826058201058192,0
2384,4,2,2,35,0.05405405405405406,0.05405405405405406,0.9459459459459459,37,1050,600,450,0.5714285714285714,15,6,9,356.55223721968287,0.46602852852852855,0.06831986625801023,0.19003058796873218,127617.73003472234,1700.477430555562,129318.2074652779,339,0,53.24324324324324,35,2,17,38.389175257731935,0.5982142857142857,47.395833333333336,1010.4166666666677,28.86904761904765,0
2385,4,0,0,35,0.0,0.0,1.0,35,1100,800,300,0.7272727272727273,14,8,6,373.8879084563065,0.4630252100840336,0.07004630673442169,0.19805239240865571,127370.199037029,2524.4354635236455,129894.63450055265,340,2,57.285714285714285,33,2,17,38.20553093763911,0.6000631313131313,47.64093137254902,1009.4362745098036,30.588978015448596,0
2386,4,0,1,34,0.0,0.02857142857142857,0.9714285714285714,35,1150,800,350,0.6956521739130435,15,8,7,377.0045160687344,0.46162464985994395,0.0674152630484508,0.20077682367381422,127586.77551903107,2620.158112264506,130206.93363129557,341,3,58.285714285714285,33,2,18,37.90433446546984,0.6022727272727273,47.42647058823529,1010.2941176470583,30.61497326203207,0
2387,4,2,3,33,0.05555555555555555,0.08333333333333333,0.9166666666666666,36,1850,1500,350,0.8108108108108109,22,15,7,365.85959437825284,0.4599867724867725,0.0781005017246783,0.19741560854014345,128114.39909297045,2174.3764172335477,130288.775510204,342,0,57.5,34,2,20,37.64502978990278,0.6053921568627452,46.9047619047619,1012.3809523809517,29.775910364145638,0
2388,4,3,1,35,0.08333333333333333,0.027777777777777776,0.9722222222222222,36,950,500,450,0.5263157894736842,14,5,9,360.46611849263246,0.4582010582010582,0.09711955884078383,0.19731873653903056,128687.51594387746,2077.497874149649,130765.0138180271,343,0,55.52777777777778,34,2,21,37.195676405021715,0.6112132352941176,46.33928571428571,1014.6428571428564,29.842436974789894,0
2389,4,0,1,34,0.0,0.02857142857142857,0.9714285714285714,35,1300,700,600,0.5384615384615384,19,7,12,371.5621229676336,0.45766806722689074,0.10246781486211343,0.20315662179168226,128641.33536380233,2559.649533833137,131200.98489763547,344,1,58.08571428571429,33,2,21,36.961423854393196,0.6130050505050505,46.384803921568626,1014.460784313725,30.741235888294696,0
2390,4,0,0,34,0.0,0.0,1.0,34,1100,800,300,0.7272727272727273,14,8,6,373.55522078217587,0.45785056446821154,0.08816939770680432,0.20415936352136058,128624.3830348944,2809.6619605142296,131434.04499540862,345,2,58.970588235294116,32,2,21,36.92821135175502,0.615234375,46.40151515151515,1014.3939393939395,31.69981060606061,0
2391,4,1,0,35,0.02857142857142857,0.0,1.0,35,1500,1000,500,0.6666666666666666,20,10,10,365.4327581325929,0.4592436974789916,0.09529013145056808,0.20281392151907476,129233.48263251224,2446.5209226099632,131680.0035551222,346,0,58.25714285714286,32,3,23,36.512531561736814,0.6214192708333333,45.80176767676769,1016.7929292929314,31.774779040404106,0
2392,4,0,0,35,0.0,0.0,1.0,35,1100,700,400,0.6363636363636364,15,7,8,366.76420974677296,0.45913865546218485,0.10454795297788988,0.20421694802555299,129361.89746263139,2489.0628188450196,131850.9602814764,347,1,59.25714285714286,32,3,23,36.34779280956518,0.6227213541666667,45.67550505050505,1017.29797979798,31.790561868686876,0
2393,4,0,2,33,0.0,0.05714285714285714,0.9428571428571428,35,1550,1300,250,0.8387096774193549,18,13,5,366.9347408936346,0.45854341736694676,0.10906256090430766,0.20531539318704914,129554.63927469148,2507.6195987654532,132062.25887345694,348,2,60.25714285714286,32,3,19,36.147112323783546,0.6246744791666667,45.48611111111112,1018.0555555555566,31.814236111111143,0
2394,4,1,0,34,0.029411764705882353,0.0,1.0,34,900,600,300,0.6666666666666666,12,6,6,399.6109592975872,0.4571264111705288,0.10707537594278471,0.21597338359741905,128178.55568562834,3446.240132128303,131624.79581775665,349,0,61.794117647058826,30,4,18,36.7249026634811,0.6159722222222221,46.84139784946236,1012.6344086021501,33.754480286738335,16
2395,4,1,0,35,0.02857142857142857,0.0,1.0,35,1250,900,350,0.72,16,9,7,386.4796258154965,0.45742296918767505,0.1102224178080935,0.21130265015638827,128639.3928527832,2943.30088297526,131582.69373575845,350,0,61.0,31,4,18,36.58508214606597,0.6179435483870968,46.38671875,1014.453125,32.72429435483871,0
2396,4,0,2,33,0.0,0.05714285714285714,0.9428571428571428,35,1250,800,450,0.64,17,8,9,395.6400788120925,0.45665266106442576,0.10902361714212438,0.21739293125425535,128837.60452270495,3194.664001464829,132032.26852416978,351,1,62.0,31,4,18,36.14972104655636,0.6199596774193548,46.19140624999999,1015.234374999999,32.7494959677419,0
2397,4,1,2,32,0.029411764705882353,0.058823529411764705,0.9411764705882353,34,1400,800,600,0.5714285714285714,20,8,12,410.8585083741578,0.4553624480095068,0.12542714584841508,0.22646664827013233,128962.36423647255,3797.0569213204008,132759.42115779297,352,0,64.08823529411765,30,4,19,35.63555864320056,0.6239583333333334,46.06854838709678,1015.725806451614,33.85752688172047,0
2398,4,2,0,34,0.058823529411764705,0.0,1.0,34,750,500,250,0.6666666666666666,10,5,5,401.76179130217906,0.454211229946524,0.14305853435188065,0.2233941987627835,129307.31336805562,3590.3688739305217,132897.68224198616,353,0,64.58823529411765,29,5,21,35.513536119076875,0.6303879310344828,45.72916666666667,1017.0833333333339,35.07183908045979,0
2399,4,0,2,32,0.0,0.058823529411764705,0.9411764705882353,34,750,500,250,0.6666666666666666,10,5,5,399.5515285831702,0.45396984551396313,0.14071107243584247,0.22291854258682278,129440.63484579157,3543.640702682412,132984.275548474,354,1,65.58823529411765,30,4,19,35.433452207986626,0.6288194444444444,45.5981182795699,1017.6075268817217,33.92025089605739,0
2400,4,1,2,31,0.030303030303030304,0.06060606060606061,0.9393939393939394,33,800,600,200,0.75,10,6,4,389.3808868182531,0.4516256313131313,0.09854291509886837,0.2196018430845309,129864.12896050361,3513.321940104191,133377.4509006078,209,0,55.75757575757576,31,2,20,35.26017714188384,0.6303763440860215,45.18229166666668,1019.2708333333345,32.87970430107531,0
2401,4,0,1,30,0.0,0.03225806451612903,0.967741935483871,31,950,700,250,0.7368421052631579,12,7,5,407.25046112965947,0.44834229390681,0.10988246993544859,0.22807892517506015,129589.99083719152,4355.116705246935,133945.10754243846,210,1,59.54838709677419,29,2,20,35.08488496339745,0.6332614942528736,45.4513888888889,1018.1944444444458,35.110153256705026,0
2402,4,1,0,31,0.03225806451612903,0.0,1.0,31,900,700,200,0.7777777777777778,11,7,4,392.3597168497425,0.4484767025089606,0.07745167243564133,0.22179141669315552,129954.04996242348,3997.7468493467586,133951.79681177024,211,0,56.806451612903224,30,1,21,35.09260479831269,0.6340277777777779,45.09408602150538,1019.6236559139791,33.98745519713263,0
2403,4,0,0,31,0.0,0.0,1.0,31,1050,900,150,0.8571428571428571,12,9,3,390.05105184861156,0.44735663082437277,0.0674826809469169,0.2212621437616565,130091.13228407918,3948.4365967164,134039.5688807956,212,1,57.806451612903224,30,1,21,35.01180281071586,0.6354166666666667,44.95967741935485,1020.1612903225814,34.005376344086045,0
2404,4,1,0,32,0.03125,0.0,1.0,32,950,600,350,0.631578947368421,13,6,7,381.7571512391572,0.4467825940860215,0.07157655880031566,0.21886258399095573,130502.81282518209,3564.189321019767,134067.00214620185,213,0,56.96875,30,2,18,34.80471147943524,0.6395833333333334,44.556451612903224,1021.774193548387,34.05913978494623,0
2405,4,0,0,32,0.0,0.0,1.0,32,1250,900,350,0.72,16,9,7,382.05333802321263,0.44573252688172044,0.0705723346917313,0.22000603651344278,130674.53833174359,3584.928712856982,134259.46704460058,214,1,57.96875,30,2,18,34.62271591954777,0.6413194444444444,44.388440860215056,1022.4462365591401,34.081541218638,0
2406,4,0,0,32,0.0,0.0,1.0,32,1300,1000,300,0.7692307692307693,16,10,6,384.5443261572246,0.4447874663978495,0.07176087924672325,0.22270699036622152,130894.72664727099,3666.96489122178,134561.69153849277,215,2,58.96875,31,1,19,34.335501760190006,0.6407930107526882,44.17317708333333,1023.3072916666661,33.009912634408586,0
2407,4,0,1,31,0.0,0.03125,0.96875,32,950,600,350,0.631578947368421,13,6,7,388.34942191464035,0.44428343413978494,0.06900594556784956,0.22569042901070338,131028.00369262695,3776.929897732204,134804.93359035917,216,3,59.96875,31,1,20,34.1028922379075,0.6421370967741935,44.04296875,1023.828125,33.026713709677416,0
2408,4,0,3,28,0.0,0.0967741935483871,0.9032258064516129,31,1050,800,250,0.7619047619047619,13,8,5,399.44114670216453,0.44135304659498203,0.07408254742960785,0.23145699322604876,130915.14373048901,4258.579026477042,135173.72275696605,217,4,62.74193548387097,30,1,20,33.93365292005953,0.64375,44.15322580645161,1023.3870967741931,34.112903225806434,0
2409,4,1,0,29,0.034482758620689655,0.0,1.0,29,950,700,250,0.7368421052631579,12,7,5,401.9969857506085,0.4393986042692939,0.02357155885640494,0.2339324211475326,131079.1112075619,4738.681520061747,135817.79272762363,218,0,54.41379310344828,29,0,21,33.70165355576653,0.6483477011494253,43.993055555555564,1024.027777777779,35.31130268199238,0
2410,4,1,2,28,0.03333333333333333,0.06666666666666667,0.9333333333333333,30,950,700,250,0.7368421052631579,12,7,5,425.3546396192113,0.4385536398467433,0.04717588124454197,0.22242950260693153,126847.05102237656,4791.232638888887,131638.28366126545,219,0,53.56666666666667,29,1,20,37.44757916264534,0.6052442528735632,48.15972222222222,1007.3611111111113,34.73659003831418,16
2411,4,4,1,31,0.125,0.03125,0.96875,32,950,600,350,0.631578947368421,13,6,7,383.8770329092483,0.4409022177419355,0.05834839232303102,0.20812360216647352,128304.38220589735,3450.621110090806,131755.00331598814,220,0,49.0,32,0,21,36.99422565636425,0.6119791666666667,46.717171717171716,1013.131313131313,31.660353535353533,0
2412,4,0,1,30,0.0,0.03225806451612903,0.967741935483871,31,1200,900,300,0.75,15,9,6,395.6619719771546,0.44009856630824373,0.06714520897868148,0.21418611551915667,128243.4272766111,3948.209465874537,132191.63674248563,221,1,51.58064516129032,31,0,21,36.75828619788319,0.6139112903225806,46.777343749999986,1012.8906249999982,32.6738911290322,0
2413,4,1,0,31,0.03225806451612903,0.0,1.0,31,900,600,300,0.6666666666666666,12,6,6,389.59589424138784,0.44094982078853046,0.08271850934352987,0.21230113565134243,128507.33651055212,3813.1861368814857,132320.5226474336,222,0,52.29032258064516,31,0,17,36.64133063653096,0.6165994623655914,46.51692708333332,1013.9322916666652,32.707493279569846,0
2414,4,1,0,32,0.03125,0.0,1.0,32,1500,1200,300,0.8,18,12,6,377.3795962089167,0.44195228494623656,0.07845909995027367,0.20792064876058378,128944.78242016103,3332.2259845933845,132277.00840475442,223,0,51.625,32,0,19,36.50365696999834,0.6184895833333333,46.085858585858574,1015.6565656565642,31.739267676767632,0
2415,4,0,2,30,0.0,0.0625,0.9375,32,800,600,200,0.75,10,6,4,410.47711601647484,0.44134324596774194,0.14601321297749892,0.1995984144293849,123830.87158203113,3772.647539054515,127603.51912108564,224,1,52.625,31,1,14,40.95804988662132,0.5685483870967742,51.17187499999999,995.3124999999991,32.10685483870965,16
2416,4,7,4,33,0.1891891891891892,0.10810810810810811,0.8918918918918919,37,1050,700,350,0.6666666666666666,14,7,7,365.688353324989,0.4549236736736737,0.14748973993663217,0.18496471174146825,125479.0617264224,1777.2462919000104,127256.30801832241,225,0,45.83783783783784,36,1,13,40.36168558690194,0.5743634259259259,49.5213963963964,1001.9144144144146,27.83095595595596,0
2417,4,3,3,33,0.08333333333333333,0.08333333333333333,0.9166666666666666,36,850,500,350,0.5882352941176471,12,5,7,373.2262568021407,0.45405092592592594,0.15794640794640857,0.18897034686508377,125521.37586805547,2169.574652777773,127690.95052083324,226,0,48.02777777777778,35,1,14,40.12907137907138,0.5767857142857142,49.479166666666664,1002.0833333333327,28.630952380952362,0
2418,4,5,4,34,0.13157894736842105,0.10526315789473684,0.8947368421052632,38,800,600,200,0.75,10,6,4,355.2784240242164,0.457340564248459,0.1629678284931657,0.18409170953153528,126473.33311646208,1386.649294141275,127859.98241060335,227,0,43.63157894736842,38,0,12,39.59683129757479,0.5808662280701755,48.5309829059829,1005.876068376068,26.47042285200179,0
2419,4,5,1,38,0.1282051282051282,0.02564102564102564,0.9743589743589743,39,900,700,200,0.7777777777777778,11,7,4,355.15782998503323,0.45886752136752135,0.1944091486658197,0.18759007530081956,127253.6571334648,1240.5360828037099,128494.19321626851,228,0,41.97435897435897,38,1,18,38.79778166031344,0.5888157894736843,47.756410256410255,1008.9743589743588,26.551956815114703,0
2420,4,2,4,36,0.05,0.1,0.9,40,1250,700,550,0.56,18,7,11,346.42224531851,0.4624332264957265,0.18192196680754624,0.18475218261873896,127644.0443250866,843.7472873263691,128487.79161241297,229,0,41.825,39,1,16,38.61811926605505,0.5910790598290598,47.36979166666666,1010.5208333333317,25.910790598290557,0
2421,4,0,2,34,0.0,0.05555555555555555,0.9444444444444444,36,1050,900,150,0.8571428571428571,12,9,3,340.7465401426279,0.4566633597883598,0.06409846747616021,0.1688876227749963,124634.27690782002,1293.7397279035865,125928.0166357236,230,1,47.30555555555556,36,0,18,41.85979850381564,0.5656828703703703,50.365990990990994,998.5360360360364,27.737112112112122,16
2422,4,0,1,33,0.0,0.029411764705882353,0.9705882352941176,34,1350,900,450,0.6666666666666666,18,9,9,347.9758469673735,0.4557895127748069,0.09066086212819102,0.1728753896923166,124732.28635204064,1880.7645975056464,126613.05094954629,231,2,50.705882352941174,34,0,20,41.577781750288004,0.5707720588235294,50.26785714285713,998.92857142857,29.380252100840295,0
2423,4,2,1,34,0.05714285714285714,0.02857142857142857,0.9714285714285714,35,700,400,300,0.5714285714285714,10,4,6,384.200648643676,0.4592787114845938,0.02269471547008095,0.1805529207818983,122377.18582153322,2941.7051665636955,125318.89098809691,232,0,49.48571428571429,31,4,21,43.133005439312186,0.5534274193548387,52.63671875,989.4531250000001,31.917842741935488,16
2424,4,8,0,42,0.19047619047619047,0.0,1.0,42,1600,1500,100,0.9375,17,15,2,387.085409113961,0.47055265195509094,0.273281781214586,0.18474922755706413,123040.15024862817,1744.8695911464947,124785.01983977466,233,0,41.95238095238095,35,7,16,42.3666200031109,0.5511904761904762,51.96759259259259,992.1296296296289,28.346560846560823,16
2425,4,9,6,45,0.17647058823529413,0.11764705882352941,0.8823529411764706,51,1650,900,750,0.5454545454545454,24,9,15,335.7222944282439,0.47725490196078435,0.31454094658954745,0.16977763903008672,125471.67427445506,-1764.9842595217224,123706.69001493334,234,0,35.372549019607845,41,10,11,41.11989223355448,0.5658028455284553,49.528769841269835,1001.8849206349198,24.43621757646146,0
2426,4,4,4,45,0.08163265306122448,0.08163265306122448,0.9183673469387755,49,1150,800,350,0.6956521739130435,15,8,7,348.0627285338508,0.47652706916099774,0.3327540261846831,0.17660960670050965,125610.49970255815,-1055.9333482054162,124554.56635435273,235,0,37.673469387755105,40,9,14,40.66745235198702,0.56875,49.39024390243903,1002.4390243902452,25.06097560975613,0
2427,4,4,6,43,0.08163265306122448,0.12244897959183673,0.8775510204081632,49,1650,1100,550,0.6666666666666666,22,11,11,347.75875531728843,0.4751806972789116,0.27350885392324775,0.17230104745296868,124619.19290972671,-919.1874876065499,123700.00542212016,236,0,38.36734693877551,40,9,15,41.70038167938931,0.55859375,50.381097560975626,998.4756097561005,24.961890243902513,16
2428,4,5,2,46,0.10416666666666667,0.041666666666666664,0.9583333333333334,48,2000,1500,500,0.75,25,15,10,347.2515986329915,0.4749556737588652,0.33830020604639666,0.17621750946313428,125615.07100819975,-875.4122145972698,124739.65879360249,237,0,39.375,38,10,19,40.6830615652421,0.5720942982456141,49.38568376068375,1002.4572649572629,26.380454340980602,0
2429,4,3,2,47,0.061224489795918366,0.04081632653061224,0.9591836734693877,49,2050,1700,350,0.8292682926829268,24,17,7,331.5298678306527,0.47698767006802717,0.3276581350772356,0.17144830307813708,126392.7469135799,-1417.9448370955174,124974.80207648438,238,0,39.30612244897959,38,11,17,40.2768186003683,0.5800438596491229,48.61111111111109,1005.5555555555527,26.46198830409349,0
2430,4,4,3,48,0.0784313725490196,0.058823529411764705,0.9411764705882353,51,1700,1200,500,0.7058823529411765,22,12,10,317.2883209296729,0.4774836601307189,0.24915748289837292,0.16041290709495765,125460.6950172013,-2149.3405260768454,123311.35449112445,239,0,38.6078431372549,42,9,12,41.59291678756811,0.5642361111111112,49.539728682170534,1001.8410852713163,23.853359173126577,15
2431,4,0,4,44,0.0,0.08333333333333333,0.9166666666666666,48,1400,900,500,0.6428571428571429,19,9,10,330.80138617972204,0.47649785756501184,0.2693424519797518,0.16685857957669736,125364.84917534744,-1305.8268229166415,124059.0223524308,240,1,41.895833333333336,39,9,13,41.35332154496915,0.5678418803418803,49.63541666666668,1001.4583333333351,25.678418803418847,0
2432,4,1,0,45,0.022222222222222223,0.0,1.0,45,1550,1300,250,0.8387096774193549,18,13,5,337.1805616471545,0.4757154882154882,0.2546020626581047,0.17038062008896068,125438.98122499259,-540.8827716220048,124898.09845337058,241,0,44.022222222222226,37,8,14,41.1171008464682,0.572072072072072,49.561403508771946,1001.7543859649146,27.074442863916612,0
2433,4,1,2,44,0.021739130434782608,0.043478260869565216,0.9565217391304348,46,1450,900,550,0.6206896551724138,20,9,11,333.5833554038314,0.4756944444444444,0.27214076382105,0.17016193865276394,125829.3625926841,-805.0838036014068,125024.2787890827,242,0,44.04347826086956,38,8,17,40.804804245199314,0.5742872807017544,49.17200854700856,1003.3119658119674,26.402946468735983,0
2434,4,3,1,46,0.06382978723404255,0.02127659574468085,0.9787234042553191,47,1300,700,600,0.5384615384615384,19,7,12,318.93005678956706,0.4759096515572001,0.26594347873737156,0.165586077203645,126554.60048788774,-1327.5868158833819,125227.01367200437,243,0,43.38297872340426,40,7,13,40.42752415580917,0.5783854166666667,48.45020325203253,1006.1991869918719,25.1549796747968,0
2435,4,0,3,43,0.0,0.06521739130434782,0.9347826086956522,46,1200,1000,200,0.8333333333333334,14,10,4,325.8092356328757,0.4748490338164251,0.2688481569340597,0.16910217125083027,126541.1797417537,-954.3429904513619,125586.83675130234,244,1,45.32608695652174,39,7,13,40.26825154432826,0.5798611111111112,48.46354166666668,1006.1458333333352,25.79861111111116,0
2436,4,1,0,44,0.022727272727272728,0.0,1.0,44,1200,800,400,0.6666666666666666,16,8,8,334.59159990793603,0.472141472868217,0.2607307406489965,0.17353747479679546,126512.2216090528,-334.0146727839352,126178.20693626886,245,0,47.38636363636363,37,7,14,40.0770890099909,0.5830518018018018,48.49232456140351,1006.030701754386,27.190018966334755,0
2437,4,2,1,45,0.043478260869565216,0.021739130434782608,0.9782608695652174,46,1450,1200,250,0.8275862068965517,17,12,5,327.1628309224422,0.4735305958132045,0.2758418302759682,0.17291846323796672,127280.6076617174,-870.3776871256819,126410.22997459171,246,0,46.28260869565217,38,8,17,39.476354332098104,0.5890899122807017,47.72970085470085,1009.0811965811963,26.554768331084112,0
2438,4,2,3,44,0.0425531914893617,0.06382978723404255,0.9361702127659575,47,1500,1300,200,0.8666666666666667,17,13,4,335.78625683473643,0.4737897008942337,0.24858509611765434,0.1644030665353065,124120.14351167006,-608.7830557381731,123511.36045593189,247,0,46.148936170212764,38,9,21,42.516350380615414,0.5567434210526316,50.88141025641026,996.4743589743599,26.22300944669368,16
2439,4,5,3,46,0.10204081632653061,0.061224489795918366,0.9387755102040817,49,1550,1100,450,0.7096774193548387,20,11,9,318.7028966526501,0.476296768707483,0.2855113018515023,0.1606229995252462,125330.5027286173,-1808.2536121309363,123522.24911648636,248,0,43.204081632653065,40,9,15,41.691616766467064,0.5658854166666667,49.66971544715447,1001.3211382113827,25.03302845528457,0
2440,4,4,2,48,0.08,0.04,0.96,50,2000,1400,600,0.7,26,14,12,312.86190510364463,0.4767517006802721,0.3017556346381971,0.1598439915165895,125894.45153061244,-2122.484410430819,123771.96712018162,249,0,43.06,41,9,19,41.25766113088181,0.5701219512195121,49.10714285714287,1003.5714285714301,24.477351916376346,0
2441,4,1,1,48,0.02040816326530612,0.02040816326530612,0.9795918367346939,49,1650,1200,450,0.7272727272727273,21,12,9,319.3051534408701,0.47796201814058953,0.318532999060414,0.1646091696534877,126264.14497730052,-1736.3758314960564,124527.76914580446,250,0,44.38775510204081,37,12,21,40.71614299221761,0.5805180180180181,48.73903508771929,1005.0438596491213,27.163347558084357,0
2442,4,3,1,50,0.058823529411764705,0.0196078431372549,0.9803921568627451,51,1600,900,700,0.5625,23,9,14,306.62277835018216,0.47883986928104577,0.3403228288424003,0.16172848505137055,127197.0703125,-2396.9910212757763,124800.07929122422,251,0,43.294117647058826,39,12,20,40.07985680848134,0.5865384615384616,47.8125,1008.75,25.865384615384617,0
2443,4,2,3,49,0.038461538461538464,0.057692307692307696,0.9423076923076923,52,1200,700,500,0.5833333333333334,17,7,10,344.06229889522905,0.4787503142282554,0.31237830926157373,0.17480478026404417,125663.75760445345,-1629.373636937574,124034.38396751588,252,0,43.38461538461539,43,9,14,40.71275657977585,0.564922480620155,49.337121212121204,1002.6515151515136,23.317477096546828,16
2444,4,1,4,46,0.02,0.08,0.92,50,1750,1100,650,0.6285714285714286,24,11,13,358.7744408051919,0.4772959183673469,0.27136052128974275,0.18196303690068433,125591.91528944482,-740.8779413347927,124851.03734811003,253,0,45.66,36,14,17,40.41821143691722,0.5755208333333333,49.40878378378378,1002.3648648648646,27.84346846846846,15
2445,4,3,2,47,0.061224489795918366,0.04081632653061224,0.9591836734693877,49,1950,1600,350,0.8205128205128205,23,16,7,362.76989133460995,0.4754287131519275,0.309653708050585,0.18756064619147267,126383.31056986042,-630.3880316126907,125752.92253824773,254,0,46.265306122448976,36,13,19,39.50120394221076,0.5836226851851851,48.6204954954955,1005.5180180180182,27.93105605605606,0
2446,4,2,0,49,0.04081632653061224,0.0,1.0,49,2000,1300,700,0.65,27,13,14,362.7370498478367,0.4738343253968254,0.3170609325536202,0.19003343805845707,126921.74437951484,-592.1561764466935,126329.58820306815,255,0,46.89795918367347,36,13,21,38.94771643570259,0.5891203703703703,48.0855855855856,1007.6576576576592,27.990490490490533,0
2447,4,2,2,49,0.0392156862745098,0.0392156862745098,0.9607843137254902,51,1850,1400,450,0.7567567567567568,23,14,9,324.79152550237114,0.47503267973856206,0.19881299430838162,0.1615497066789654,124782.07181246635,-2094.2539737318402,122687.81783873451,256,0,46.01960784313726,42,9,16,42.105316328839734,0.5572916666666667,50.21802325581396,999.1279069767455,23.78875968992251,16
2448,4,7,4,52,0.125,0.07142857142857142,0.9285714285714286,56,1600,900,700,0.5625,23,9,14,293.4502436312664,0.47679247835497834,0.21613344021004988,0.14966094669558566,125821.38037730759,-3510.3397071859526,122311.04067012164,257,0,42.732142857142854,46,10,16,41.819644487643934,0.5627264492753623,49.179964539007095,1003.2801418439726,21.810437866173316,16
2449,4,3,1,54,0.05454545454545454,0.01818181818181818,0.9818181818181818,55,1800,1100,700,0.6111111111111112,25,11,14,293.97134233900016,0.4771184062850729,0.2370016830364996,0.15176637488228836,126322.92631172841,-3572.5429936594937,122750.38331806893,258,0,42.8,44,11,14,41.29248411163305,0.5703125,48.68055555555556,1005.2777777777778,22.847222222222225,0
2450,4,4,8,50,0.06896551724137931,0.13793103448275862,0.8620689655172413,58,2000,1700,300,0.85,23,17,6,286.79439298857613,0.47738329300262144,0.28097326233662656,0.15166288642321654,127302.17013888898,-4288.753858024687,123013.41628086429,259,0,40.98275862068966,44,14,18,40.47274979355904,0.5802556818181819,47.708333333333336,1009.1666666666674,22.935606060606077,0
2451,4,1,5,46,0.0196078431372549,0.09803921568627451,0.9019607843137255,51,1700,1200,500,0.7058823529411765,22,12,10,314.8692029232976,0.4755392156862745,0.25927726462485845,0.1656485806683437,127092.0138888891,-2196.5277777777533,124895.48611111134,260,0,46.0,43,8,20,39.979338842975224,0.5794573643410852,47.91666666666668,1008.3333333333351,23.449612403100815,0
2452,4,0,2,44,0.0,0.043478260869565216,0.9565217391304348,46,950,700,250,0.7368421052631579,12,7,5,364.25735073867565,0.4728160225442834,0.24659690595861505,0.184558478645184,125550.37300936655,246.00841799555667,125796.38142736211,261,1,50.19565217391305,35,11,14,40.32377199060707,0.5770833333333334,49.45023148148149,1002.1990740740752,28.63425925925929,14
2453,4,3,3,44,0.06382978723404255,0.06382978723404255,0.9361702127659575,47,1700,1400,300,0.8235294117647058,20,14,6,353.0186131203815,0.47309589885908104,0.2745791639055879,0.18214127980997266,126298.39932838257,-482.8628459540438,125815.53648242852,262,0,49.91489361702128,36,11,13,39.8337721263724,0.5827546296296297,48.704954954954964,1005.1801801801812,27.9216716716717,0
2454,4,4,4,44,0.08333333333333333,0.08333333333333333,0.9166666666666666,48,1350,700,650,0.5185185185185185,20,7,13,341.25243734682834,0.4754081708037825,0.273549860419096,0.1789346437739094,126957.38965821087,-935.0962679889076,126022.29339022197,263,0,49.0,38,10,17,39.452365807979064,0.5858004385964912,48.05021367521367,1007.7991452991446,26.521030139451174,0
2455,4,1,5,40,0.022222222222222223,0.1111111111111111,0.8888888888888888,45,1500,1000,500,0.6666666666666666,20,10,10,361.31613332655695,0.4726430976430977,0.19154929577464785,0.1820567097600264,125320.71827744899,75.80904375775364,125396.52732120674,264,0,46.93333333333333,38,7,15,40.635003201024304,0.569078947368421,49.679487179487175,1001.2820512820508,26.349527665317126,16
2456,4,5,5,40,0.1111111111111111,0.1111111111111111,0.8888888888888888,45,1300,400,900,0.3076923076923077,22,4,18,339.77776681701687,0.47561026936026934,0.1869521547496662,0.17468181199455501,126151.14239763682,-425.2490594638001,125725.89333817303,265,0,43.68888888888889,38,7,19,40.318027934347185,0.5775767543859649,48.85149572649573,1004.5940170940174,26.43668466036888,0
2457,4,2,3,39,0.047619047619047616,0.07142857142857142,0.9285714285714286,42,1250,800,450,0.64,17,8,9,360.89711521033246,0.4712301587301588,0.22570901848468417,0.18544855316225398,126131.01912133467,704.0641878857762,126835.08330922044,266,0,47.11904761904762,35,7,21,39.80837366055995,0.5830357142857143,48.871527777777764,1004.5138888888872,28.700396825396776,0
2458,4,2,5,36,0.04878048780487805,0.12195121951219512,0.8780487804878049,41,800,400,400,0.5,12,4,8,352.9074553033652,0.47022357723577235,0.19668864772801742,0.1833477337552829,126581.54776397994,734.3143819494869,127315.86214592942,162,0,40.41463414634146,36,5,15,39.54509847806626,0.5856481481481481,48.42342342342341,1006.3063063063041,27.95295295295289,0
2459,4,4,2,38,0.1,0.05,0.95,40,800,600,200,0.75,10,6,4,350.68612794383813,0.47202190170940167,0.2654969930784068,0.16769380605366485,123120.85470183013,663.216637245338,123784.07133907547,121,0,38.125,36,4,20,43.185256628465496,0.5500578703703703,51.886261261261254,992.4549549549544,27.568193193193178,16
2460,4,6,0,44,0.13636363636363635,0.0,1.0,44,1400,1100,300,0.7857142857142857,17,11,6,329.93669595742057,0.4775920542635659,0.2921992046610564,0.16396752888076077,124746.06405743952,-565.4857981222481,124180.57825931728,122,0,34.93181818181818,40,4,19,42.014030179721956,0.5598958333333333,50.25406504065042,998.9837398373996,24.97459349593499,0
2461,4,2,3,43,0.043478260869565216,0.06521739130434782,0.9347826086956522,46,1250,800,450,0.64,17,8,9,326.4645120000001,0.4795289855072464,0.3127443478260874,0.16481447495961216,125400.96205210367,-1011.1744391478094,124389.78761295586,123,0,34.369565217391305,38,8,17,41.42466666666667,0.5699013157894737,49.599358974358964,1001.6025641025624,26.357962213225324,0
2462,4,2,3,42,0.044444444444444446,0.06666666666666667,0.9333333333333333,45,1000,500,500,0.5,15,5,10,330.4575642751018,0.48230218855218854,0.3198659087596558,0.16831992193700598,125768.722106802,-687.754886118822,125080.96722068317,124,0,35.62222222222222,37,8,19,40.94565296603992,0.5754504504504505,49.23245614035087,1003.0701754385957,27.11000474158367,0
2463,4,1,1,42,0.023255813953488372,0.023255813953488372,0.9767441860465116,43,1300,900,400,0.6923076923076923,17,9,8,347.11005873717386,0.48082779623477295,0.3303978537007142,0.1764492210756779,125686.24630896011,125.39206775157982,125811.6383767117,125,0,38.116279069767444,37,6,21,40.61315381811555,0.5746058558558558,49.31469298245612,1002.7412280701726,27.10111427216683,0
2464,4,2,0,44,0.045454545454545456,0.0,1.0,44,1700,1300,400,0.7647058823529411,21,13,8,335.70706218297266,0.47995947850599013,0.3253691601297146,0.17318101513963455,126291.69702456506,-319.5811451600696,125972.11587940498,126,0,37.45454545454545,37,7,19,40.27569452019926,0.5807995495495495,48.711622807017534,1005.1535087719283,27.166311047889952,0
2465,4,3,1,46,0.06382978723404255,0.02127659574468085,0.9787234042553191,47,1250,500,750,0.4,20,5,15,311.9916974173586,0.4799375578168363,0.3120481591809343,0.16403124695694807,127066.39695493733,-1471.2678258642554,125595.12912907307,127,0,36.0,40,7,22,40.07807512683534,0.58359375,47.942073170731696,1008.2317073170715,25.205792682926788,0
2466,4,2,3,45,0.041666666666666664,0.0625,0.9375,48,850,700,150,0.8235294117647058,10,7,3,302.3376835250954,0.48124445921985815,0.3032149489322189,0.16040280056971795,127433.60595703112,-1894.398590416703,125539.20736661441,128,0,35.791666666666664,39,9,13,39.94646050414388,0.5889423076923077,47.57812499999999,1009.687499999999,25.889423076923052,0
2467,4,1,5,41,0.021739130434782608,0.10869565217391304,0.8913043478260869,46,1600,1000,600,0.625,22,10,12,307.34501511655424,0.47937801932367147,0.28595636079369013,0.16353107022661897,127550.26989051429,-1359.612074475861,126190.65781603842,129,0,37.21739130434783,38,8,15,39.700995945707724,0.5918311403508771,47.462606837606835,1010.1495726495727,26.58288349077823,0
2468,4,2,2,41,0.046511627906976744,0.046511627906976744,0.9534883720930233,43,1550,1100,450,0.7096774193548387,20,11,9,355.0012055360728,0.4793512366186785,0.21612502661876687,0.17864782389903291,125268.00063775525,997.0320091657311,126265.03264692098,130,0,39.16279069767442,34,9,17,40.84760375787848,0.5762867647058824,49.73214285714287,1001.0714285714298,29.443277310924405,16
2469,4,2,4,39,0.046511627906976744,0.09302325581395349,0.9069767441860466,43,800,600,200,0.75,10,6,4,337.41790638107705,0.48055094130675524,0.14703118417783778,0.16548080921149377,124191.12761488323,182.4706142745019,124373.59822915772,131,0,39.46511627906977,35,8,14,42.40207462455492,0.5630952380952381,50.810185185185176,996.7592592592578,28.478835978835935,16
2470,4,4,1,42,0.09302325581395349,0.023255813953488372,0.9767441860465116,43,1150,700,450,0.6086956521739131,16,7,9,363.3881303856087,0.4810354374307863,0.17027295451502078,0.17369285865220377,123102.49433106573,893.0826317152355,123995.57696278096,132,0,37.23255813953488,34,9,19,42.88927543186182,0.553921568627451,51.904761904761905,992.3809523809521,29.187675070028003,16
2471,4,11,12,41,0.20754716981132076,0.22641509433962265,0.7735849056603774,53,1250,800,450,0.64,17,8,9,293.28758514582967,0.486151427189163,0.20898993424503054,0.1492120884871258,125720.28066145428,-3205.0885574137233,122515.19210404056,133,0,29.566037735849058,41,12,16,41.92746974643057,0.5683434959349594,49.28075396825396,1002.8769841269832,24.46041424699959,0
2472,4,5,4,42,0.10869565217391304,0.08695652173913043,0.9130434782608696,46,950,400,550,0.42105263157894735,15,4,11,366.1432937002475,0.484128421900161,0.20909994552075428,0.18045350412160632,124397.65721183442,-59.51704642114032,124338.14016541328,134,0,28.73913043478261,37,9,16,41.47156884296915,0.5613738738738738,50.603070175438596,997.5877192982457,26.961830251303937,16
2473,4,4,4,42,0.08695652173913043,0.08695652173913043,0.9130434782608696,46,1150,1000,150,0.8695652173913043,13,10,3,359.15491318929065,0.48322262479871175,0.24587318351620424,0.18104339501582614,125338.06610664717,-193.93400053868524,125144.13210610847,135,0,26.630434782608695,36,10,16,40.67115572049783,0.5729166666666667,49.66216216216216,1001.3513513513511,27.81531531531531,0
2474,4,5,4,43,0.10638297872340426,0.0851063829787234,0.9148936170212766,47,1400,1000,400,0.7142857142857143,18,10,8,344.33242727899744,0.4808048103607771,0.27533541130234473,0.17900725524106803,126607.70052596962,-678.9911330549467,125928.70939291466,136,0,26.51063829787234,38,9,17,39.733943736730374,0.5822368421052632,48.39743589743589,1006.4102564102552,26.484480431848823,0
2475,4,1,3,41,0.022727272727272728,0.06818181818181818,0.9318181818181819,44,1200,800,400,0.6666666666666666,16,8,8,358.02755103755817,0.480432963354475,0.2661702216733306,0.18488866280096464,126334.56173911164,246.2507501714517,126580.8124892831,137,0,28.90909090909091,35,9,17,39.67063857548546,0.5851190476190475,48.668981481481474,1005.3240740740728,28.723544973544936,0
2476,4,1,6,36,0.023809523809523808,0.14285714285714285,0.8571428571428572,42,1250,800,450,0.64,17,8,9,389.1456894631321,0.4809088269454123,0.2875133262260132,0.18623400852878472,123155.00685871059,1446.1344735939706,124601.14133230456,138,0,30.833333333333332,35,7,15,42.19527363184079,0.5523809523809524,51.851851851851855,992.5925925925928,28.359788359788368,15
2477,4,10,7,39,0.21739130434782608,0.15217391304347827,0.8478260869565217,46,1600,1200,400,0.75,20,12,8,342.8840642977857,0.4822161835748792,0.3145168579951185,0.17360761571287875,125521.37586805539,-570.5498756858913,124950.8259923695,139,0,27.58695652173913,37,9,19,40.8892065142065,0.5729166666666667,49.47916666666666,1002.083333333332,27.083333333333297,0
2478,4,2,1,40,0.04878048780487805,0.024390243902439025,0.975609756097561,41,1050,800,250,0.7619047619047619,13,8,5,363.2069029347597,0.4808434959349594,0.30641132389675296,0.18251526796010292,125208.42013888874,895.3124999999824,126103.73263888873,140,0,28.073170731707318,34,7,21,40.703927282819855,0.5756740196078431,49.79166666666666,1000.8333333333321,29.436274509803887,0
2479,4,3,3,40,0.06976744186046512,0.06976744186046512,0.9302325581395349,43,1150,700,450,0.6086956521739131,16,7,9,349.1190524206923,0.48135843484680696,0.30768467365774654,0.1791464918625887,126073.7244897958,208.50340136053455,126282.22789115633,141,0,27.302325581395348,34,9,23,40.16318950529478,0.5845588235294117,48.92857142857142,1004.2857142857133,29.53781512605039,0
2480,4,4,6,38,0.09090909090909091,0.13636363636363635,0.8636363636363636,44,1350,900,450,0.6666666666666666,18,9,9,332.6817355270621,0.48162218111346017,0.28038943612576617,0.1736820058854943,126779.94030770643,-364.5258856829727,126415.41442202346,142,0,25.954545454545453,36,8,17,39.85030191211002,0.5876736111111112,48.226351351351354,1007.0945945945953,27.974849849849868,0
2481,4,1,4,35,0.02564102564102564,0.10256410256410256,0.8974358974358975,39,1000,400,600,0.4,16,4,12,379.3038073364161,0.4808816914080072,0.20961930126899553,0.18269179918275064,123427.59530895708,1735.4292188631212,125163.0245278202,143,0,29.435897435897434,34,5,19,42.154616429056354,0.5572916666666667,51.57738095238096,993.6904761904776,29.226190476190517,16
2482,4,5,1,39,0.125,0.025,0.975,40,1200,800,400,0.6666666666666666,16,8,8,361.7822004992464,0.48303952991452986,0.23802988186240448,0.18013999533509192,124826.44917052473,1031.9974922839567,125858.4466628087,144,0,28.125,35,5,20,41.135337039610846,0.5696428571428571,50.173611111111114,999.3055555555559,28.55158730158731,0
2483,4,2,2,39,0.04878048780487805,0.04878048780487805,0.9512195121951219,41,1150,600,550,0.5217391304347826,17,6,11,350.91833659691275,0.48346036585365854,0.2388915792617683,0.17684686214000195,125327.59530895686,596.1913816452425,125923.78669060211,145,0,28.26829268292683,34,7,15,40.888172234771936,0.5768995098039216,49.672619047619044,1001.3095238095234,29.450280112044805,0
2484,4,5,5,39,0.11363636363636363,0.11363636363636363,0.8863636363636364,44,750,500,250,0.6666666666666666,10,5,5,323.54848020754855,0.4842318534178999,0.2268043536443931,0.16735832554898036,126401.93527094852,-618.528373231822,125783.4068977167,146,0,24.59090909090909,37,7,12,40.46802875004543,0.5819256756756757,48.60197368421051,1005.5921052631561,27.178165007112327,0
2485,4,3,4,38,0.07142857142857142,0.09523809523809523,0.9047619047619048,42,1250,900,350,0.72,16,9,7,341.66987451664636,0.4838366240805265,0.09050268229684066,0.16942113088101274,124653.01890432085,768.7232556598415,125421.7421599807,147,0,26.238095238095237,38,4,17,41.81733889661565,0.5622258771929824,50.347222222222214,998.6111111111101,26.279239766081844,16
2486,4,1,5,34,0.02564102564102564,0.1282051282051282,0.8717948717948718,39,1100,800,300,0.7272727272727273,14,8,6,394.4859035880995,0.48195006747638325,0.022810018862131187,0.18538641814260792,122377.1858215333,2302.263556586384,124679.4493781197,148,0,28.846153846153847,31,8,15,42.87858599815764,0.5534274193548387,52.63671875000001,989.4531250000008,31.91784274193551,16
2487,4,9,6,37,0.20930232558139536,0.13953488372093023,0.8604651162790697,43,1150,700,450,0.6086956521739131,16,7,9,351.32087329809406,0.48712624584717606,0.13067402799296368,0.1745976172004141,124746.7500228269,166.45237350123477,124913.20239632814,149,0,26.11627906976744,36,7,16,41.479258257242684,0.5668402777777778,50.25337837837838,998.9864864864867,27.74962462462463,0
2488,4,5,4,38,0.11904761904761904,0.09523809523809523,0.9047619047619048,42,1200,1000,200,0.8333333333333334,14,10,4,347.07563189170963,0.4853126209833527,0.13991280221958058,0.17478479426402832,125297.79620181385,298.0759630976615,125595.87216491152,150,0,26.80952380952381,34,8,19,41.01516052318669,0.576593137254902,49.70238095238094,1001.1904761904744,29.44677871148454,0
2489,4,3,6,35,0.07317073170731707,0.14634146341463414,0.8536585365853658,41,950,700,250,0.7368421052631579,12,7,5,336.61356838887093,0.48589939024390244,0.12200471306340699,0.17103128111160046,125666.39506440755,260.20273383916367,125926.59779824672,151,0,27.317073170731707,35,6,19,40.89674958636348,0.5782738095238096,49.33449074074074,1002.6620370370368,28.64748677248677,0
2490,4,5,5,35,0.125,0.125,0.875,40,1000,500,500,0.5,15,5,10,341.62084346459807,0.48522970085470085,0.1272844344904822,0.1767482115955306,126411.62065781993,636.9688945702453,127048.58955239019,152,0,26.925,36,4,16,40.00373273609557,0.583912037037037,48.59234234234234,1005.6306306306302,27.934184184184172,0
2491,4,1,2,34,0.027777777777777776,0.05555555555555555,0.9444444444444444,36,900,800,100,0.8888888888888888,10,8,2,374.9350896872635,0.4833498677248677,-0.02887327801057138,0.181300555287393,123594.65860486346,2110.240463506613,125704.89906837008,153,0,30.61111111111111,33,3,18,42.088776600115025,0.5612373737373737,51.40931372549019,994.3627450980388,30.132204396910264,15
2492,4,5,3,36,0.1282051282051282,0.07692307692307693,0.9230769230769231,39,950,900,50,0.9473684210526315,10,9,1,378.132161246484,0.4870389113810167,0.03282686494365317,0.1797618823338964,122870.98554362886,1667.4672740002002,124538.45281762906,154,0,28.974358974358974,37,2,20,42.76570449015702,0.5456081081081081,52.13815789473684,991.447368421053,26.795874822190623,16
2493,4,7,2,41,0.16279069767441862,0.046511627906976744,0.9534883720930233,43,1350,900,450,0.6666666666666666,18,9,9,351.62052840414515,0.4889719453672942,0.13897532946396263,0.16792024258910182,123064.97956994174,268.31053301001066,123333.29010295175,155,0,26.767441860465116,36,7,17,43.22035902092083,0.5494791666666667,51.94256756756758,992.2297297297313,27.56193693693698,16
2494,4,6,6,41,0.1276595744680851,0.1276595744680851,0.8723404255319149,47,1400,800,600,0.5714285714285714,20,8,12,328.964776979801,0.48849444958371874,0.21595041590498587,0.1639821886262716,124872.99975419704,-1180.9898072794033,123692.00994691763,156,0,24.893617021276597,40,7,19,41.90709201830199,0.5611979166666667,50.127032520325194,999.4918699186976,24.98729674796744,0
2495,4,7,9,39,0.14583333333333334,0.1875,0.8125,48,1250,700,550,0.56,18,7,11,313.2757096037925,0.48766252955082745,0.23301888309850138,0.16054218115304128,126019.51223634386,-1704.1650270022385,124315.34720934162,157,0,24.75,42,6,14,41.1187914173583,0.5699404761904762,48.98255813953488,1004.0697674418595,23.90642303432999,0
2496,4,4,4,39,0.09302325581395349,0.09302325581395349,0.9069767441860466,43,1000,800,200,0.8,12,8,4,344.626814503134,0.48698781838316724,0.23561751223621785,0.17425872739984158,125466.4431002809,47.820122537708755,125514.26322281861,158,0,27.86046511627907,37,6,16,40.90226095363177,0.5723536036036037,49.53399122807018,1001.8640350877197,27.077406353722154,0
2497,4,2,2,39,0.04878048780487805,0.04878048780487805,0.9512195121951219,41,1050,700,350,0.6666666666666666,14,7,7,347.7815627476318,0.48592479674796746,0.23715142116597487,0.17650806565447094,125620.13660620087,537.6734842951136,126157.81009049599,159,0,29.609756097560975,36,5,20,40.6645510372201,0.5758101851851851,49.380630630630634,1002.4774774774781,27.846596596596616,0
2498,4,1,3,37,0.025,0.075,0.925,40,1100,800,300,0.7272727272727273,14,8,6,358.78181863481984,0.48502938034188037,0.25591642651296875,0.18384124492953677,126014.78273158844,1042.362584662183,127057.14531625062,160,0,30.575,35,5,23,39.981388088376555,0.5818452380952381,48.987268518518505,1004.0509259259242,28.68716931216926,0
2499,4,2,0,39,0.05128205128205128,0.0,1.0,39,1050,700,350,0.6666666666666666,14,7,7,358.6577381596208,0.4832433648223122,0.23611996649539302,0.18529144104921486,126351.67363514041,1263.404444712187,127615.0780798526,161,0,29.17948717948718,33,6,16,39.63716886071833,0.5896464646464646,48.65196078431373,1005.3921568627458,30.46642899584078,0
2500,4,1,5,35,0.025,0.125,0.875,40,850,500,350,0.5882352941176471,12,5,7,332.41439565184044,0.48386752136752137,0.12557863992064378,0.16119699688664588,123714.94263860011,420.10291370259614,124135.0455523027,162,0,29.425,37,3,19,43.02084481428413,0.5543355855855856,51.288377192982445,994.8464912280683,26.88774300616401,16
2501,4,7,3,39,0.16666666666666666,0.07142857142857142,0.9285714285714286,42,1200,1000,200,0.8333333333333334,14,10,4,327.88365536827814,0.48470770421989934,0.19002604417864366,0.16460870969505775,125168.97598612135,-178.30493232689332,124990.67105379446,163,0,27.785714285714285,36,6,22,41.628451121614525,0.5711805555555556,49.83108108108109,1000.6756756756765,27.79654654654657,0
2502,4,10,11,38,0.20408163265306123,0.22448979591836735,0.7755102040816326,49,700,300,400,0.42857142857142855,11,3,8,295.3338462336046,0.4835955215419501,0.2322885049700072,0.1562578810306834,127322.68248273183,-2232.4339487927564,125090.24853393908,164,0,24.244897959183675,40,9,10,40.2363810291008,0.5861979166666667,47.6880081300813,1009.2479674796748,25.23119918699187,0
2503,4,5,3,40,0.11627906976744186,0.06976744186046512,0.9302325581395349,43,1300,900,400,0.6923076923076923,17,9,8,327.6906988662791,0.4827427094868955,0.25843173357883376,0.1727661488578112,127179.55789448284,-264.888358410518,126914.66953607232,165,0,28.11627906976744,35,8,21,39.56648020654045,0.59375,47.8298611111111,1008.6805555555541,28.8194444444444,0
2504,4,3,3,40,0.06976744186046512,0.06976744186046512,0.9302325581395349,43,1050,800,250,0.7619047619047619,13,8,5,327.98866207207607,0.48271963824289404,0.2678518712894018,0.17504756793968287,127673.13169677205,-224.9320704447589,127448.19962632729,166,0,28.74418604651163,37,6,17,39.05408032259232,0.5948761261261262,47.34100877192982,1010.6359649122803,27.314485538169738,0
2505,4,0,3,37,0.0,0.075,0.925,40,1500,900,600,0.6,21,9,12,351.30079964760137,0.4823183760683761,0.2695086705202314,0.1857752263638627,127302.17013888902,944.2708333333512,128246.44097222238,167,1,31.7,34,6,23,38.845306908890734,0.5971200980392157,47.70833333333334,1009.1666666666678,29.681372549019642,0
2506,4,1,2,36,0.02631578947368421,0.05263157894736842,0.9473684210526316,38,1700,1300,400,0.7647058823529411,21,13,8,373.0052480157297,0.48177453769559037,0.21116670002001192,0.18234271417869302,124054.82380624424,1654.6200642791523,125709.44387052339,168,0,33.421052631578945,32,6,20,41.657160963244614,0.568359375,50.946969696969695,996.212121212121,31.131628787878782,16
2507,4,2,2,36,0.05263157894736842,0.05263157894736842,0.9473684210526316,38,1250,900,350,0.72,16,9,7,362.9130678063279,0.4838637980085348,0.2191118920214037,0.1798193320935115,124621.49908172643,1445.354109274571,126066.853191001,169,0,33.3421052631579,32,6,18,41.319707890743565,0.57421875,50.37878787878788,998.4848484848491,31.202651515151533,0
2508,4,6,3,39,0.14285714285714285,0.07142857142857142,0.9285714285714286,42,1500,1000,500,0.6666666666666666,20,10,10,330.35659897452734,0.4856634727061557,0.2239741143904539,0.16869957899495794,125874.27112501029,-83.32077854879861,125790.95034646148,170,0,30.952380952380953,36,6,19,40.8395054801182,0.5784143518518519,49.12725225225226,1003.4909909909923,27.874749749749785,0
2509,4,2,3,38,0.04878048780487805,0.07317073170731707,0.926829268292683,41,1100,600,500,0.5454545454545454,16,6,10,333.4304129017792,0.4833587398373984,0.24017531683271165,0.17203467430990083,126298.39932838257,222.34548737928964,126520.74481576186,171,0,32.073170731707314,36,5,18,40.326013892000915,0.5827546296296297,48.704954954954964,1005.1801801801812,27.9216716716717,0
2510,4,4,5,37,0.09523809523809523,0.11904761904761904,0.8809523809523809,42,900,700,200,0.7777777777777778,11,7,4,320.0226722850196,0.48424796747967475,0.22286273656732658,0.16813076851362685,127036.73846760546,-269.07269544474576,126767.66577216072,172,0,30.666666666666668,37,5,21,39.90600754115002,0.5884009009009009,47.97149122807018,1008.1140350877198,27.246325272641077,0
2511,4,1,2,36,0.02631578947368421,0.05263157894736842,0.9473684210526316,38,1000,900,100,0.9,11,9,2,344.6394761118731,0.4842786865813182,0.24501614308409736,0.17966738170908336,126721.57343329508,1134.6513360246288,127856.22476931971,173,0,33.31578947368421,33,5,22,39.609197500811426,0.5934343434343434,48.28431372549021,1006.8627450980408,30.510992275698207,0
2512,4,3,2,37,0.07692307692307693,0.05128205128205128,0.9487179487179487,39,1000,500,500,0.5,15,5,10,325.1723687220206,0.4840587044534413,0.22006431412372018,0.17285478547854807,127512.50000000022,492.70833333336327,128005.20833333358,174,0,31.564102564102566,34,5,20,39.28939768976899,0.5992647058823529,47.500000000000014,1010.0000000000017,29.705882352941227,0
2513,4,0,1,36,0.0,0.02702702702702703,0.972972972972973,37,950,600,350,0.631578947368421,13,6,7,334.9327421979374,0.4828578578578579,0.2043937371040172,0.17768904462130125,127432.05925905913,1136.2338103133518,128568.29306937248,175,1,33.054054054054056,33,4,21,39.12527309139457,0.6006944444444444,47.579656862745104,1009.6813725490206,30.5964052287582,0
2514,4,0,1,35,0.0,0.027777777777777776,0.9722222222222222,36,1350,1000,350,0.7407407407407407,17,10,7,343.5444526187217,0.48217592592592595,0.20032311861580165,0.18201709070156902,127378.63363751138,1552.0445936638985,128930.67823117528,176,2,34.44444444444444,32,4,21,38.96263289555973,0.6025390625,47.63257575757575,1009.4696969696961,31.545928030303003,0
2515,4,0,1,34,0.0,0.02857142857142857,0.9714285714285714,35,1150,600,550,0.5217391304347826,17,6,11,346.45130260587695,0.4809873949579832,0.18353504651377017,0.1838966359827908,127453.32717895496,1831.2742445203853,129284.60142347535,177,3,35.0,31,4,21,38.81272834730282,0.6058467741935484,47.55859374999999,1009.7656249999991,32.573084677419324,0
2516,4,0,0,34,0.0,0.0,1.0,34,900,600,300,0.6666666666666666,12,6,6,347.75003936094436,0.47927807486631013,0.16137421712691302,0.1850373666229223,127551.95617675783,2071.2395562065976,129623.19573296442,178,4,35.05882352941177,31,3,21,38.678890607544886,0.6068548387096775,47.4609375,1010.1562500000001,32.58568548387097,0
2517,4,0,1,33,0.0,0.029411764705882353,0.9705882352941176,34,1200,800,400,0.6666666666666666,16,8,8,349.35103809363073,0.4787767379679144,0.16015260928537312,0.18664914719345163,127716.42261081254,2123.5729641384305,129839.99557495097,179,5,36.05882352941177,31,3,21,38.4700126669243,0.6085349462365591,47.29817708333332,1010.8072916666653,32.60668682795694,0
2518,4,1,0,34,0.029411764705882353,0.0,1.0,34,1350,1000,350,0.7407407407407407,17,10,7,364.4768304154538,0.478665329768271,0.09051970302684165,0.18376768862205753,125347.46334876546,2387.607470853829,127735.07081961929,180,0,36.8235294117647,32,2,16,40.528201571890904,0.5817057291666667,49.65277777777778,1001.3888888888891,31.293402777777786,16
2519,4,2,1,35,0.05555555555555555,0.027777777777777776,0.9722222222222222,36,1350,900,450,0.6666666666666666,18,9,9,348.5441861802644,0.4788525132275132,0.10668286515744119,0.1789815763118011,126103.61571712024,1590.5364229024972,127694.15214002274,181,0,35.72222222222222,34,2,18,40.14682351546758,0.5848651960784313,48.898809523809526,1004.4047619047623,29.541316526610654,0
2520,4,5,1,39,0.125,0.025,0.975,40,1250,700,550,0.56,18,7,11,346.43657284624885,0.47940705128205124,0.20600737888995835,0.17222373166854216,124759.73095414221,644.2667241946351,125403.99767833685,182,0,32.65,38,2,15,41.5877980964603,0.5633223684210527,50.24038461538463,999.0384615384633,26.29048582995956,16
2521,4,2,2,39,0.04878048780487805,0.04878048780487805,0.9512195121951219,41,1650,1300,350,0.7878787878787878,20,13,7,336.57267485587386,0.4811737804878049,0.11148171834340359,0.16471211433212243,124100.72234396572,486.57128662327557,124587.293630589,183,0,32.609756097560975,36,5,18,42.51690589210367,0.5601851851851851,50.90090090090091,996.3963963963976,27.67767767767771,16
2522,4,3,2,40,0.07142857142857142,0.047619047619047616,0.9523809523809523,42,1450,900,550,0.6206896551724138,20,9,11,319.8663668212759,0.48012243515292297,0.13351253145895048,0.15923601748399077,124817.7747938369,-414.99837239582513,124402.77642144107,184,0,32.42857142857143,39,3,19,42.1914633934466,0.562232905982906,50.18229166666667,999.2708333333342,25.62232905982908,0
2523,4,6,3,43,0.13043478260869565,0.06521739130434782,0.9347826086956522,46,1250,800,450,0.64,17,8,9,346.52556024428054,0.48427938808373594,0.24767850811204495,0.16814828522227815,123742.21515273924,-280.3524431796376,123461.8627095596,185,0,29.782608695652176,37,9,17,42.64152156344132,0.5546171171171171,51.2609649122807,994.9561403508767,26.890706495969642,16
2524,4,7,3,47,0.14,0.06,0.94,50,1400,800,600,0.5714285714285714,20,8,12,318.4467838201908,0.48775510204081635,0.26229058787694126,0.16010119315186633,125228.76310603826,-2023.8758956560664,123204.88721038219,186,0,27.62,40,10,15,41.80289031035301,0.56484375,49.77134146341464,1000.9146341463429,25.022865853658573,0
2525,4,3,6,44,0.06,0.12,0.88,50,1000,600,400,0.6,14,6,8,324.91190819640184,0.48704081632653057,0.2940308191403078,0.16486270897372995,125610.49970255817,-1837.5305704276382,123772.96913213053,187,0,28.56,40,10,18,41.24763449580965,0.56875,49.39024390243903,1002.4390243902453,25.060975609756134,0
2526,4,2,5,41,0.043478260869565216,0.10869565217391304,0.8913043478260869,46,1450,1200,250,0.8275862068965517,17,12,5,333.4991492882522,0.48723832528180355,0.27897996599253294,0.1705503470717688,125933.75485726378,-800.239977685445,125133.51487957833,188,0,30.282608695652176,37,9,21,40.699421018134124,0.5771396396396397,49.06798245614035,1003.7280701754387,27.12778568041726,0
2527,4,1,6,36,0.023809523809523808,0.14285714285714285,0.8571428571428572,42,1450,1200,250,0.8275862068965517,17,12,5,336.2589198739969,0.4875629113433992,0.10028700739595986,0.16160050690390082,123333.44304257048,113.51197002920202,123446.95501259968,189,0,28.547619047619047,37,5,15,43.321903631747425,0.5503941441441442,51.672149122807,993.3114035087694,26.84625414888566,16
2528,4,3,2,37,0.07692307692307693,0.05128205128205128,0.9487179487179487,39,1300,1100,200,0.8461538461538461,15,11,4,338.51539503323613,0.490019118308592,0.18165570488990568,0.16556480229807366,124075.78875171463,600.3129286694061,124676.10168038403,190,0,30.615384615384617,35,4,19,42.49438506815366,0.5619047619047619,50.925925925925924,996.2962962962958,28.465608465608454,0
2529,4,2,2,37,0.05128205128205128,0.05128205128205128,0.9487179487179487,39,950,700,250,0.7368421052631579,12,7,5,326.91080953685747,0.4896817363922627,0.16999575010624768,0.16224801173936143,124690.50712452314,352.5349251278273,125043.04204965096,191,0,28.743589743589745,36,3,18,42.14703837336042,0.5662615740740741,50.30968468468468,998.7612612612609,27.74336836836836,0
2530,4,2,2,37,0.05128205128205128,0.05128205128205128,0.9487179487179487,39,1000,500,500,0.5,15,5,10,330.2083333333333,0.48748875393612234,0.17841880341880345,0.16510416666666666,125000.00000000001,455.2083333333345,125455.20833333334,192,0,29.41025641025641,36,3,20,41.74479166666667,0.5694444444444444,50.0,1000.0000000000001,27.777777777777782,0
2531,4,2,2,37,0.05128205128205128,0.05128205128205128,0.9487179487179487,39,1250,1000,250,0.8,15,10,5,329.39965101391596,0.4861673414304993,0.1948095719582068,0.1670647460783401,125591.91528944498,473.98661330250457,126065.90190274749,193,0,29.71794871794872,36,3,20,41.154317866906325,0.5755208333333333,49.40878378378379,1002.3648648648659,27.843468468468497,0
2532,4,3,1,39,0.075,0.025,0.975,40,900,700,200,0.7777777777777778,11,7,4,328.38006658072874,0.48624465811965817,0.19468770122343892,0.15986653398115075,123880.7219756737,135.99194608807932,124016.71392176178,194,0,28.325,38,2,18,42.94913071474566,0.5542763157894737,51.12179487179486,995.5128205128188,26.197705802968915,16
2533,4,8,11,36,0.1702127659574468,0.23404255319148937,0.7659574468085106,47,1450,1000,450,0.6896551724137931,19,10,9,290.1635089054648,0.4879548257786001,0.2099578997210474,0.14635626474075034,125363.63617157904,-2114.716415869218,123248.91975570982,195,0,24.893617021276597,42,5,11,42.371996452185115,0.5632440476190477,49.636627906976734,1001.4534883720914,23.844130675525985,0
2534,4,4,3,37,0.1,0.075,0.925,40,1300,900,400,0.6923076923076923,17,9,8,351.61065616995865,0.48631143162393164,0.14915589829095488,0.17536672851387308,124895.85503472202,1107.7804584685216,126003.63549319054,196,0,28.275,39,1,19,41.317562873419476,0.563034188034188,50.10416666666666,999.5833333333317,25.630341880341838,16
2535,4,1,2,36,0.02631578947368421,0.05263157894736842,0.9473684210526316,38,1300,800,500,0.6153846153846154,18,8,10,354.25453681698804,0.48408605974395447,0.20468668934109613,0.1782990033704024,125274.27309364417,1275.83932075253,126550.1124143967,197,0,30.526315789473685,37,1,15,40.85980284775463,0.5703828828828829,49.72587719298245,1001.0964912280699,27.05666192508297,0
2536,4,5,5,36,0.12195121951219512,0.12195121951219512,0.8780487804878049,41,1500,1100,400,0.7333333333333333,19,11,8,330.21097006069044,0.4838160569105691,0.1944563593604398,0.1706952632069213,126375.71571980973,146.12953599048964,126521.84525580022,198,0,27.975609756097562,40,1,15,40.32747119466343,0.5765625,48.62804878048781,1005.4878048780495,25.137195121951237,0
2537,4,4,2,38,0.1,0.05,0.95,40,1300,800,500,0.6153846153846154,18,8,10,337.2097362815131,0.48333333333333334,0.20313082177603037,0.17535632249472421,126619.79709201369,539.4856770833122,127159.282769097,199,0,29.225,39,1,18,39.90072793762507,0.5806623931623931,48.38541666666666,1006.4583333333317,25.80662393162389,0
2538,4,0,5,33,0.0,0.13157894736842105,0.868421052631579,38,1250,900,350,0.72,16,9,7,352.7732820748129,0.48215979137031767,0.20431529603470144,0.18272102295156695,126457.0724285354,1322.1352964373266,127779.20772497272,200,1,31.763157894736842,37,1,18,39.67656437370542,0.5824887387387387,48.547149122807,1005.8114035087694,27.184091986723498,0
2539,4,2,1,34,0.05714285714285714,0.02857142857142857,0.9714285714285714,35,1450,1200,250,0.8275862068965517,17,12,5,362.17882097748446,0.48172268907563026,0.1768598111901103,0.18899880608565953,126762.11911848072,2182.110969387757,128944.23008786848,201,0,32.57142857142857,34,1,21,39.12598021830793,0.5916053921568627,48.24404761904762,1007.0238095238095,29.618347338935575,0
2540,4,2,1,35,0.05555555555555555,0.027777777777777776,0.9722222222222222,36,900,600,300,0.6666666666666666,12,6,6,352.52302970060475,0.4821593915343915,0.1762881518379027,0.18588193833860864,127184.70848051248,1767.965179331556,128952.67365984403,202,0,32.388888888888886,33,3,23,38.93499676021541,0.5981691919191919,47.824754901960794,1008.7009803921583,30.566696375519946,0
2541,4,3,3,35,0.07894736842105263,0.07894736842105263,0.9210526315789473,38,1150,900,250,0.782608695652174,14,9,5,330.610866049602,0.48178935514461835,0.16085417180980133,0.1776195193693652,127939.5351750043,859.6401052383417,128799.17528024265,203,0,30.210526315789473,35,3,18,38.71565515005911,0.6014880952380952,47.0775462962963,1011.689814814815,28.905423280423285,0
2542,4,1,3,33,0.027777777777777776,0.08333333333333333,0.9166666666666666,36,1200,1100,100,0.9166666666666666,13,11,2,346.04986418706886,0.4795469576719577,0.1692127245680286,0.18564332493129476,127880.99500868036,1650.6401909722008,129531.63519965256,204,0,32.27777777777778,35,1,20,38.38504119464469,0.6008928571428571,47.13541666666666,1011.4583333333318,28.89880952380948,0
2543,4,0,1,32,0.0,0.030303030303030304,0.9696969696969697,33,900,700,200,0.7777777777777778,11,7,4,365.36201478749445,0.4784564393939394,0.1464187160804109,0.19502527740792658,127679.65032980098,2729.8588583717665,130409.50918817274,201,1,29.545454545454547,33,0,20,38.10312335798874,0.603219696969697,47.334558823529406,1010.6617647058818,30.626114081996416,0
2544,4,1,1,32,0.030303030303030304,0.030303030303030304,0.9696969696969697,33,700,300,400,0.42857142857142855,11,3,8,356.09878275043553,0.4778251262626263,0.12479445618980467,0.19140309572835895,127958.47750865035,2513.1716166858655,130471.64912533622,202,0,29.939393939393938,33,0,22,38.05161902454781,0.6060606060606061,47.058823529411754,1011.7647058823517,30.659536541889445,0
2545,4,0,2,30,0.0,0.0625,0.9375,32,1150,700,450,0.6086956521739131,16,7,9,366.3628994850211,0.47584845430107525,0.12665376934598105,0.1967358948172916,127920.90730537703,2973.0949010305117,130894.00220640753,203,1,31.625,32,0,22,37.830493842569474,0.6080729166666667,47.0959595959596,1011.6161616161618,31.613005050505055,0
2546,4,4,0,34,0.11764705882352941,0.0,1.0,34,1100,800,300,0.7272727272727273,14,8,6,347.7202427849228,0.4735034165181224,0.1374267722754896,0.19142463468303464,128912.7245466025,2165.5033606264815,131078.22790722898,204,0,30.08823529411765,32,2,22,37.28941315429566,0.6181640625,46.11742424242425,1015.530303030304,31.735321969697,0
2547,4,1,2,33,0.02857142857142857,0.05714285714285714,0.9428571428571428,35,1300,900,400,0.6923076923076923,17,9,8,337.98258343594784,0.47226890756302525,0.13469436937324608,0.18787122973442286,129294.849411885,1739.8814458381557,131034.73085772316,205,0,30.2,33,2,23,37.14792444872875,0.6196338383838385,45.74142156862746,1017.0343137254914,30.819221628045195,0
2548,4,1,1,33,0.029411764705882353,0.029411764705882353,0.9705882352941176,34,650,500,150,0.7692307692307693,8,5,3,347.06656187225667,0.47155377302436124,0.13722326070448054,0.19309172806926125,129329.78777675766,2177.2089582695917,131506.99673502723,206,0,31.38235294117647,32,2,24,36.88141343925852,0.6223958333333333,45.70707070707072,1017.1717171717187,31.78661616161621,0
2549,4,2,3,32,0.05714285714285714,0.08571428571428572,0.9142857142857143,35,1050,800,250,0.7619047619047619,13,8,5,337.2769434721333,0.4705182072829132,0.11697341513292425,0.18957290271019925,129731.44531250025,1751.0850694444741,131482.53038194473,207,0,29.285714285714285,33,2,21,36.72247784594409,0.6240530303030303,45.312500000000014,1018.7500000000019,30.87121212121218,0
2550,4,0,0,32,0.0,0.0,1.0,32,1050,600,450,0.5714285714285714,15,6,9,364.6372299750983,0.4680779569892473,0.12223414795244403,0.2032624323204337,129406.44330269376,3037.2814053647576,132443.72470805852,208,1,32.09375,30,2,26,36.35650594451784,0.6284722222222222,45.631720430107514,1017.4731182795683,33.91577060931895,0
2551,4,0,0,32,0.0,0.0,1.0,32,900,600,300,0.6666666666666666,12,6,6,365.0732367321419,0.4672799059139785,0.11561757327700017,0.20421452695784648,129543.23657359226,3058.5537345357766,132601.79030812805,209,2,33.09375,30,2,24,36.20609981515711,0.6298611111111111,45.497311827956985,1018.0107526881716,33.93369175627239,0
2552,4,0,2,30,0.0,0.0625,0.9375,32,1200,1000,200,0.8333333333333334,14,10,4,384.4073414267698,0.46622983870967744,0.10671048225050206,0.1961449626623947,125841.46514409168,3289.0807463290325,129130.5458904207,210,3,34.09375,30,2,20,39.51747041750388,0.5920138888888888,49.15994623655913,1003.3602150537624,33.44534050179208,16
2553,4,5,1,34,0.14285714285714285,0.02857142857142857,0.9714285714285714,35,800,500,300,0.625,11,5,6,348.37278891286377,0.47121848739495803,0.09221462576511419,0.18270115644562943,126964.73095857572,1846.3740745730806,128811.1050331488,211,0,31.428571428571427,32,3,22,39.265430552075486,0.5983072916666667,48.042929292929294,1007.8282828282834,31.494633838383855,0
2554,4,1,0,35,0.02857142857142857,0.0,1.0,35,800,500,300,0.625,11,5,6,349.4950665804094,0.4690476190476191,0.1091936349007685,0.18444290501832714,127219.3605882053,1892.5077798183877,129111.86836802369,212,0,32.4,32,3,25,38.97580308719233,0.6009114583333333,47.79040404040404,1008.838383838384,31.5261994949495,0
2555,4,1,1,35,0.027777777777777776,0.027777777777777776,0.9722222222222222,36,1150,800,350,0.6956521739130435,15,8,7,341.70986054638456,0.46987433862433864,0.11817851079311192,0.18225999418276093,127648.68830497877,1523.7630959246324,129172.4514009034,213,0,32.47222222222222,33,3,20,38.73241571671113,0.6029040404040404,47.36519607843137,1010.5392156862739,30.622400475341635,0
2556,4,2,7,30,0.05405405405405406,0.1891891891891892,0.8108108108108107,37,1100,700,400,0.6363636363636364,15,7,8,335.58328349193596,0.47037662662662666,0.11362603341904776,0.18094259096587995,128084.2704790247,1196.5880102040528,129280.85848922875,214,0,32.37837837837838,34,3,23,38.44206946567878,0.6050857843137255,46.934523809523796,1012.2619047619028,29.772408963585377,0
2557,4,2,0,32,0.0625,0.0,1.0,32,1150,900,250,0.782608695652174,14,9,5,378.8703900105905,0.4659988239247312,0.11859877646411854,0.2017498694683042,127582.64853395055,3267.457561728382,130850.10609567893,215,0,35.5,29,3,25,37.861447163413054,0.6127873563218391,47.43055555555555,1010.2777777777771,34.83716475095783,0
2558,4,1,2,31,0.030303030303030304,0.06060606060606061,0.9393939393939394,33,1100,700,400,0.6363636363636364,15,7,8,416.4998725805277,0.46677714646464646,0.06427000583456755,0.20608557985713394,124563.55368033881,4092.190229923822,128655.74391026264,216,0,35.39393939393939,30,3,17,40.0425250213186,0.5788194444444444,50.43682795698925,998.2526881720433,33.27508960573478,16
2559,4,7,4,34,0.18421052631578946,0.10526315789473684,0.8947368421052632,38,1000,800,200,0.8,12,8,4,370.00051652003197,0.47478070175438597,0.0662808473465819,0.18972366910920815,126043.83680555577,1727.256944444465,127771.09375000023,217,0,30.605263157894736,35,3,18,39.66977869986167,0.5821428571428571,48.95833333333334,1004.1666666666683,28.69047619047624,0
2560,4,5,6,33,0.1282051282051282,0.15384615384615385,0.8461538461538461,39,900,800,100,0.8888888888888888,10,8,2,358.82531966788,0.474274628879892,0.08525773743165055,0.18635766602106005,126567.38281249975,1283.1163194444164,127850.49913194418,218,0,30.615384615384617,35,4,12,39.41080055210489,0.5875,48.437499999999986,1006.2499999999981,28.749999999999943,0
2561,4,1,1,33,0.029411764705882353,0.029411764705882353,0.9705882352941176,34,850,600,250,0.7058823529411765,11,6,5,403.2740768681007,0.4673573975044563,0.08967169151073895,0.2046675753333889,125619.25464206276,3331.7977905273533,128951.05243259012,219,0,36.0,31,3,18,39.27471641338702,0.5870295698924731,49.38151041666667,1002.4739583333338,32.337869623655926,0
2562,4,3,3,33,0.08333333333333333,0.08333333333333333,0.9166666666666666,36,1200,700,500,0.5833333333333334,17,7,10,387.6949123107964,0.46947751322751324,0.10877974323589723,0.20158618043244314,126615.03170913662,2618.3170385159024,129233.34874765252,220,0,34.30555555555556,32,4,16,38.63536570066491,0.5947265625,48.3901515151515,1006.4393939393923,31.45123106060601,0
2563,4,0,0,33,0.0,0.0,1.0,33,1100,600,500,0.5454545454545454,16,6,10,411.14083722293174,0.465988005050505,0.08788405233681229,0.2129112031099788,126449.0679016358,3797.6751286275576,130246.74303026336,221,1,36.121212121212125,30,3,17,38.21718116619895,0.5982638888888889,48.555107526881706,1005.7795698924713,33.52598566308237,0
2564,4,1,2,32,0.029411764705882353,0.058823529411764705,0.9411764705882353,34,850,600,250,0.7058823529411765,11,6,5,405.51961751362967,0.4659090909090909,0.1037487743514518,0.21247910087596328,126927.95011732302,3494.354756673168,130422.3048739962,222,0,36.029411764705884,31,3,18,37.86355364603525,0.6004704301075269,48.07942708333333,1007.6822916666657,32.50588037634405,0
2565,4,4,2,34,0.1111111111111111,0.05555555555555555,0.9444444444444444,36,1200,1000,200,0.8333333333333334,14,10,4,379.79181168635165,0.46750992063492064,0.08935645565526729,0.20257201029532057,127648.68830497889,2495.9853181468707,130144.67362312575,223,0,34.5,33,3,16,37.770333090791496,0.6029040404040404,47.365196078431374,1010.5392156862748,30.62240047534166,0
2566,4,1,0,35,0.02857142857142857,0.0,1.0,35,900,700,200,0.7777777777777778,11,7,4,387.36874999999964,0.46642156862745093,0.09595714285714263,0.20604720744680854,127538.00632588525,2880.847617590054,130418.8539434753,224,0,36.457142857142856,32,3,18,37.692708333333314,0.6041666666666667,47.47474747474748,1010.1010101010112,31.5656565656566,0
2567,4,1,0,36,0.027777777777777776,0.0,1.0,36,900,600,300,0.6666666666666666,12,6,6,383.9406645603425,0.46709656084656087,0.09840529369791473,0.20589098795428873,127865.50132461055,2618.5531105824507,130484.054435193,225,0,36.416666666666664,33,3,19,37.44282382164063,0.6051136363636364,47.15073529411764,1011.3970588235279,30.648395721925088,0
2568,4,2,2,36,0.05263157894736842,0.05263157894736842,0.9473684210526316,38,1050,800,250,0.7619047619047619,13,8,5,363.19813061719793,0.4688833570412518,0.09587431874583108,0.19771612343542788,128466.99948827576,1731.7948120284477,130198.7943003042,226,0,35.44736842105263,35,3,17,37.351700156029985,0.606845238095238,46.556712962962955,1013.7731481481471,28.96494708994706,0
2569,4,1,1,36,0.02702702702702703,0.02702702702702703,0.972972972972973,37,950,500,450,0.5263157894736842,14,5,9,363.65863203701844,0.4677177177177177,0.11159665937316965,0.19957986251343243,128789.87295310343,1967.1098036693916,130756.98275677282,227,0,36.432432432432435,35,2,18,37.010167236792086,0.6101190476190477,46.23842592592592,1015.0462962962953,29.00132275132272,0
2570,4,1,1,36,0.02702702702702703,0.02702702702702703,0.972972972972973,37,1250,1000,250,0.8,15,10,5,364.6352322876827,0.4659972472472473,0.12674170583292543,0.20175563797845864,129113.15164448287,2015.8408082561518,131128.99245273904,228,0,37.2972972972973,35,2,19,36.655491971301664,0.6133928571428571,45.92013888888888,1016.3194444444432,29.037698412698376,0
2571,4,1,1,36,0.02702702702702703,0.02702702702702703,0.972972972972973,37,1000,500,500,0.5,15,5,10,365.11809478548196,0.46637262262262263,0.1311757617490099,0.2036877087153527,129436.83556241433,2051.9461591220906,131488.78172153642,229,0,37.24324324324324,35,2,15,36.313315134971184,0.6166666666666667,45.601851851851855,1017.5925925925931,29.074074074074087,0
2572,4,0,2,34,0.0,0.05555555555555555,0.9444444444444444,36,1050,500,550,0.47619047619047616,16,5,11,372.6547309411379,0.46527777777777773,0.0630025125628142,0.19211992605514627,126265.81471278438,2431.2610532938816,128697.07576607827,230,1,39.138888888888886,32,4,18,39.373953098827485,0.5911458333333333,48.73737373737374,1005.0505050505049,31.407828282828277,15
2573,4,2,0,36,0.05555555555555555,0.0,1.0,36,1250,1000,250,0.8,15,10,5,377.1586950744101,0.4664021164021164,-0.018744946783835426,0.18631239486203757,124494.55959467108,2390.820722036885,126885.38031670796,231,0,38.75,34,2,17,41.096067438069106,0.5683210784313726,50.50595238095237,997.9761904761895,29.352240896358513,16
2574,4,0,3,33,0.0,0.08333333333333333,0.9166666666666666,36,750,500,250,0.6666666666666666,10,5,5,378.08226875549923,0.4662202380952381,-0.008508131494572746,0.18760620454808516,124681.91557623878,2228.0043027691922,126909.91987900797,232,1,39.75,35,1,17,40.87826418665739,0.5681547619047619,50.31828703703703,998.7268518518513,28.535052910052894,0
2575,4,1,0,34,0.029411764705882353,0.0,1.0,34,800,200,600,0.25,14,2,12,384.6979268107158,0.4670603089720737,0.036570223206271235,0.18446734734387032,123238.57259463343,2769.7818112558252,126008.35440588926,233,0,41.26470588235294,32,2,16,42.21823075618854,0.5598958333333333,51.76767676767678,992.9292929292949,31.029040404040465,16
2576,4,6,5,35,0.15,0.125,0.875,40,1250,900,350,0.72,16,9,7,341.24245689172864,0.4732772435897436,0.08551683368989949,0.17073657800875738,125028.15473835332,557.9803899508643,125586.13512830419,234,0,35.925,36,4,16,41.43982471943849,0.5697337962962963,49.97184684684685,1000.1126126126135,27.78090590590593,0
2577,4,3,4,34,0.07894736842105263,0.10526315789473684,0.8947368421052632,38,1500,1000,500,0.6666666666666666,20,10,10,344.78597873415873,0.4726173541963015,0.11347259475046023,0.17344666468409395,125253.50677958374,1037.1305849768817,126290.63736456062,235,0,38.18421052631579,36,2,15,41.11823602204973,0.5720486111111112,49.74662162162163,1001.0135135135143,27.805930930930955,0
2578,4,4,5,33,0.10526315789473684,0.13157894736842105,0.868421052631579,38,1400,900,500,0.6428571428571429,19,9,10,348.46608549808263,0.47230618776671407,0.06492035214556302,0.17526980135052314,125246.83225848338,1142.249612178393,126389.08187066177,236,0,37.78947368421053,37,1,17,41.03304031109652,0.5701013513513513,49.75328947368421,1000.9868421052632,27.053698435277386,16
2579,4,1,0,34,0.029411764705882353,0.0,1.0,34,1050,600,450,0.5714285714285714,15,6,9,368.45859885327496,0.46887997623291744,0.08457896137735887,0.18396642765575497,124940.48327664379,2407.0790816326266,127347.56235827642,237,0,41.970588235294116,34,0,21,40.85025204413748,0.5729166666666667,50.059523809523796,999.7619047619031,29.404761904761855,0
2580,4,3,3,34,0.08108108108108109,0.08108108108108109,0.9189189189189189,37,1300,900,400,0.6923076923076923,17,9,8,388.328417656337,0.4741616616616617,0.13358393722841533,0.18160262870919824,122166.97191284601,2592.950369486032,124759.92228233205,238,0,39.486486486486484,33,4,19,43.25169930994589,0.5464015151515151,52.849264705882355,988.6029411764705,29.95766488413547,14
2581,4,5,0,39,0.1282051282051282,0.0,1.0,39,650,300,350,0.46153846153846156,10,3,7,367.347855016754,0.47733918128654973,0.20005959457259292,0.17693321095353995,123427.59530895698,1270.5190807940896,124698.11438975108,239,0,38.07692307692308,34,5,23,42.45162932790224,0.5572916666666667,51.577380952380956,993.6904761904767,29.226190476190492,0
2582,4,7,2,44,0.15217391304347827,0.043478260869565216,0.9565217391304348,46,800,300,500,0.375,13,3,10,332.58742609513564,0.4827395330112721,0.2038934426229504,0.15849869524846297,122975.74195254136,-1007.7144613298588,121968.0274912115,240,0,33.130434782608695,40,6,18,43.78543374316937,0.5416666666666667,52.032520325203244,991.869918699186,24.79674796747965,16
2583,4,12,13,43,0.21428571428571427,0.23214285714285715,0.7678571428571428,56,1750,1100,650,0.6285714285714286,24,11,13,287.1395124493389,0.48681682900432904,0.2631608496921982,0.14469369467041707,125324.284122085,-3954.131465283339,121370.15265680166,241,0,27.928571428571427,44,12,10,42.48813266752975,0.5601325757575757,49.675925925925924,1001.2962962962958,22.756734006733996,0
2584,4,11,12,42,0.2037037037037037,0.2222222222222222,0.7777777777777778,54,1300,800,500,0.6153846153846154,18,8,10,301.32979876512263,0.4874432215234102,0.3008056461084212,0.15460524849971316,126068.74296304201,-3198.22669744335,122870.51626559866,242,0,29.185185185185187,41,13,17,41.36815091046792,0.571900406504065,48.93353174603176,1004.2658730158755,24.494289585753062,0
2585,4,3,3,42,0.06666666666666667,0.06666666666666667,0.9333333333333333,45,1100,900,200,0.8181818181818182,13,9,4,352.86760796849956,0.48419612794612793,0.32310356771735416,0.1790384506511523,125608.37733892727,-135.37446952162625,125473.00286940564,243,0,35.13333333333333,35,10,19,40.54922930377557,0.5776785714285715,49.3923611111111,1002.4305555555538,28.640873015872966,0
2586,4,3,3,42,0.06666666666666667,0.06666666666666667,0.9333333333333333,45,1150,700,450,0.6086956521739131,16,7,9,340.12174281477286,0.48440656565656565,0.30705757858699023,0.17536606323638643,126270.10192202346,-410.5585737764681,125859.543348247,244,0,34.422222222222224,36,9,14,40.186974789915965,0.5824652777777778,48.73310810810811,1005.0675675675683,27.918543543543564,0
2587,4,5,3,44,0.10638297872340426,0.06382978723404255,0.9361702127659575,47,1350,900,450,0.6666666666666666,18,9,9,326.55207646615145,0.4844665433240826,0.3127183653583736,0.171226555714575,126957.38965821086,-1108.3601568777974,125849.02950133306,245,0,33.765957446808514,38,9,18,39.82274108625746,0.5858004385964912,48.05021367521367,1007.7991452991445,26.52103013945117,0
2588,4,4,6,42,0.08333333333333333,0.125,0.875,48,1350,1000,350,0.7407407407407407,17,10,7,317.7243259875436,0.48114287825059104,0.30803022077452,0.1687566921767749,127479.27847991687,-1499.203755090076,125980.0747248268,246,0,33.75,37,11,16,39.511400651465785,0.5929054054054055,47.5328947368421,1009.8684210526314,27.29374110953058,0
2589,4,2,2,42,0.045454545454545456,0.045454545454545456,0.9545454545454546,44,1050,700,350,0.6666666666666666,14,7,7,343.15882775194297,0.47818666314305847,0.29421533773489084,0.18002763824032175,126978.48820103887,-85.24216784351916,126893.24603319535,247,0,37.13636363636363,36,8,23,39.382681564245814,0.5896990740740741,48.02927927927928,1007.8828828828828,27.996746746746744,0
2590,4,0,3,39,0.0,0.07142857142857142,0.9285714285714286,42,1000,600,400,0.6,14,6,8,343.25523417609446,0.47759388308168793,0.27143478666210963,0.18033649274371477,127036.7384676053,321.2050823330159,127357.94354993833,248,1,37.73809523809524,37,5,23,39.320480748314125,0.5884009009009009,47.97149122807017,1008.1140350877183,27.246325272641037,0
2591,4,2,3,38,0.04878048780487805,0.07317073170731707,0.926829268292683,41,1200,800,400,0.6666666666666666,16,8,8,354.49134767949545,0.4765243902439025,0.22053557984570094,0.17258654150651773,123882.71620008702,583.0702039930808,124465.78640408009,249,0,36.8780487804878,39,2,16,42.297203620382966,0.5526175213675213,51.11979166666668,995.5208333333351,25.52617521367526,16
2592,4,5,2,41,0.11627906976744186,0.046511627906976744,0.9534883720930233,43,750,600,150,0.8,9,6,3,356.70232751288506,0.4802048726467331,0.23904545875150407,0.1715972552272279,123376.03556002984,488.71824013862704,123864.75380016846,250,0,35.69767441860465,38,5,16,42.769831881564315,0.5490679824561404,51.6292735042735,993.482905982905,26.144286999550133,15
2593,4,6,1,46,0.1276595744680851,0.02127659574468085,0.9787234042553191,47,1650,1100,550,0.6666666666666666,22,11,11,392.3548019680592,0.48296330558125194,0.35576014933031863,0.18866001486228887,123356.13486207578,1109.5465779435285,124465.68144001931,251,0,33.340425531914896,35,12,15,41.905146801817544,0.5544642857142856,51.649305555555564,993.4027777777792,28.38293650793655,16
2594,4,4,1,49,0.08,0.02,0.98,50,1650,1200,450,0.7272727272727273,21,12,9,374.1751262022591,0.4852295918367347,0.3766824644549758,0.18483500381295576,124493.75684806454,-680.5527638420758,123813.20408422247,252,0,32.16,36,14,15,41.171340179041614,0.5642361111111112,50.50675675675677,997.9729729729752,27.72147147147153,0
2595,4,5,8,46,0.09259259259259259,0.14814814814814814,0.8518518518518519,54,1700,1400,300,0.8235294117647058,20,14,6,355.1077399147136,0.4861911833216865,0.41124333133465574,0.18162516888631544,125939.25781250013,-1854.5717486912447,124084.68606380888,253,0,30.64814814814815,39,15,17,40.151515151515156,0.5737179487179487,49.06250000000001,1003.750000000001,25.737179487179514,0
2596,4,2,4,44,0.041666666666666664,0.08333333333333333,0.9166666666666666,48,2000,1600,400,0.8,24,16,8,380.0616448116453,0.4848274970449173,0.41373371382451296,0.19447048055760488,125956.68463059429,-25.73905285491543,125930.94557773937,254,0,34.520833333333336,35,13,19,39.5073071601522,0.58125,49.0451388888889,1003.8194444444458,28.680555555555596,0
2597,4,2,2,44,0.043478260869565216,0.043478260869565216,0.9565217391304348,46,950,500,450,0.5263157894736842,14,5,9,391.9957964574821,0.483756038647343,0.4161993857251536,0.20148218318917216,126141.91903008362,689.4806850103741,126831.399715094,255,0,33.91304347826087,31,15,21,39.01612119248217,0.5924059139784946,48.860677083333336,1004.5572916666673,32.405073924731205,0
2598,4,1,2,43,0.022222222222222223,0.044444444444444446,0.9555555555555556,45,1350,1000,350,0.7407407407407407,17,10,7,385.5854843664152,0.4843855218855219,0.3284783538349305,0.18695182046613154,123708.30923829255,540.0256675594761,124248.33490585203,256,0,33.44444444444444,36,9,17,41.70534299298168,0.5561342592592593,51.29504504504506,994.8198198198215,27.633883883883932,16
2599,4,5,4,44,0.10416666666666667,0.08333333333333333,0.9166666666666666,48,800,600,200,0.75,10,6,4,364.7943798026856,0.4885398197399527,0.33615136876006413,0.1809666237060384,124671.26904432151,-503.6107411315443,124167.65830318996,257,0,32.083333333333336,37,11,18,41.22108768847898,0.5641891891891893,50.32894736842106,998.6842105263173,26.99146514935993,0
2600,4,4,2,46,0.08333333333333333,0.041666666666666664,0.9583333333333334,48,1050,500,550,0.47619047619047616,16,5,11,356.87274386360696,0.48779181442080377,0.33906970856306895,0.17928366731011183,125197.14974687545,-663.2442782163914,124533.90546865907,258,0,31.854166666666668,36,12,22,40.87407636622782,0.5714699074074074,49.80292792792794,1000.78828828829,27.799674674674723,0
2601,4,1,7,40,0.02127659574468085,0.14893617021276595,0.851063829787234,47,1450,1000,450,0.6896551724137931,19,10,9,366.9944757024629,0.48876426148627816,0.29388373505785625,0.17298919227347734,122506.92573908374,-365.27587553769195,122141.64986354606,259,0,31.638297872340427,36,11,15,43.422723998028275,0.5436921296296297,52.505630630630634,989.977477477478,27.49937437437439,16
2602,4,10,7,43,0.2,0.14,0.86,50,1350,900,450,0.6666666666666666,18,9,9,295.350184792704,0.4908248299319728,0.16892086330935197,0.14480324121914948,124177.71336608392,-2572.0107590369503,121605.70260704697,260,0,28.84,42,8,15,43.46421511439498,0.5510912698412698,50.82364341085272,996.7054263565904,23.73108157991882,16
2603,4,9,8,44,0.17307692307692307,0.15384615384615385,0.8461538461538461,52,1150,900,250,0.782608695652174,14,9,5,286.44956296390995,0.48924553795877324,0.2112464117047872,0.14314524897951234,124976.85292352535,-3240.0870198902658,121736.76590363508,261,0,28.5,44,8,15,42.86257215174244,0.5565814393939394,50.023148148148145,999.9074074074072,22.725168350168346,0
2604,4,6,9,41,0.12,0.18,0.8200000000000001,50,1100,700,400,0.6363636363636364,15,7,8,293.8398471840429,0.49004251700680274,0.22565880721220544,0.1481528180557306,125347.4633487653,-2633.581961591233,122713.88138717407,262,0,30.06,41,9,12,42.29657882570504,0.5645325203252032,49.65277777777777,1001.3888888888879,24.424119241192386,0
2605,4,3,3,41,0.06818181818181818,0.06818181818181818,0.9318181818181819,44,1300,1100,200,0.8461538461538461,15,11,4,319.83657747308854,0.48908782593375616,0.2375433375264624,0.16089571800556257,125253.506779584,-787.869415023089,124465.63736456091,263,0,32.11363636363637,36,8,14,41.742603217459774,0.5720486111111112,49.74662162162164,1001.0135135135165,27.805930930931012,0
2606,4,3,4,40,0.06818181818181818,0.09090909090909091,0.9090909090909091,44,1150,800,350,0.6956521739130435,15,8,7,360.54239961155076,0.4889336680761099,0.25512683797141245,0.1785792689919561,124606.1665550688,629.5784382355605,125235.74499330437,264,0,32.40909090909091,36,8,19,41.394794721407635,0.5653935185185186,50.39414414414416,998.4234234234252,27.733983983984032,16
2607,4,2,3,39,0.047619047619047616,0.07142857142857142,0.9285714285714286,42,1350,1100,250,0.8148148148148148,16,11,5,375.60478483932616,0.488433991482772,0.27057882249075793,0.1865057130703902,124710.81559713642,968.3958118998538,125679.21140903627,265,0,34.642857142857146,35,7,21,40.91010042487447,0.5684523809523809,50.28935185185185,998.842592592592,28.538359788359774,0
2608,4,9,7,41,0.1875,0.14583333333333334,0.8541666666666666,48,1000,500,500,0.5,15,5,10,319.926586542553,0.4885859929078014,0.24182859064203388,0.16610080441332745,126553.9450014608,-1480.811450901392,125073.1335505594,266,0,30.020833333333332,38,10,15,40.40312876052949,0.5816885964912281,48.45085470085469,1006.1965811965794,26.478857399909984,0
2609,4,2,3,40,0.046511627906976744,0.06976744186046512,0.9302325581395349,43,1400,1100,300,0.7857142857142857,17,11,6,360.6244232160121,0.4856035437430786,0.27230149846448515,0.1844088057443667,125930.78033692458,482.74300482913384,126413.52334175371,267,0,34.44186046511628,36,7,21,40.02183140730768,0.5789930555555556,49.07094594594594,1003.7162162162148,27.881006006005965,0
2610,4,1,1,40,0.024390243902439025,0.024390243902439025,0.975609756097561,41,1000,700,300,0.7,13,7,6,363.87586394856976,0.48523882113821143,0.2568654501913217,0.1863123959124642,125984.07206632635,968.5126133786619,126952.58467970502,268,0,35.31707317073171,34,7,22,39.88522273607652,0.5836397058823529,49.01785714285713,1003.92857142857,29.527310924369704,0
2611,4,3,1,42,0.06976744186046512,0.023255813953488372,0.9767441860465116,43,1200,800,400,0.6666666666666666,16,8,8,348.8957486856874,0.4845653377630122,0.24420610154263334,0.1815886490915271,126654.74597318645,237.8746565176664,126892.62062970412,269,0,34.30232558139535,35,8,20,39.57075715764058,0.5883928571428572,48.35069444444443,1006.5972222222199,28.75992063492057,0
2612,4,0,1,41,0.0,0.023809523809523808,0.9761904761904762,42,1550,1300,250,0.8387096774193549,18,13,5,356.7395621792905,0.4838850174216028,0.24903551012362346,0.1856143383523631,126642.26367630379,635.6611394557735,127277.92481575956,270,1,36.11904761904762,34,8,20,39.386211314803845,0.5903799019607843,48.363095238095234,1006.5476190476186,29.604341736694664,0
2613,4,1,0,42,0.023809523809523808,0.0,1.0,42,1050,700,350,0.6666666666666666,14,7,7,357.9888106826206,0.48396970576848625,0.2627908503166947,0.18752410263555325,126917.01630015433,686.9743441358042,127603.99064429013,271,0,37.023809523809526,35,7,22,39.07219159200551,0.5910714285714286,48.09027777777778,1007.6388888888889,28.78968253968254,0
2614,4,4,5,41,0.08695652173913043,0.10869565217391304,0.8913043478260869,46,1300,1000,300,0.7692307692307693,16,10,6,333.68815930750395,0.484158615136876,0.2663903956824629,0.179827168445921,128063.41428336615,-653.2304393582475,127410.1838440079,272,0,34.71739130434783,38,8,20,38.511320455984816,0.5970394736842105,46.955128205128204,1012.1794871794867,26.63630229419702,0
2615,4,1,5,37,0.023809523809523808,0.11904761904761904,0.8809523809523809,42,1500,900,600,0.6,21,9,12,331.48785098709544,0.481937185443283,0.21567966729452137,0.17969902059739773,128299.6792850104,106.03404005540875,128405.71332506581,273,0,35.404761904761905,33,9,22,38.32594955848555,0.6095328282828283,46.721813725490186,1013.1127450980379,30.700386215092056,0
2616,4,0,4,33,0.0,0.10810810810810811,0.8918918918918919,37,1500,1400,100,0.9333333333333333,16,14,2,345.891691925262,0.48113738738738737,0.17111445586021845,0.18649251797014746,128082.49831795442,1460.5344098423413,129543.03272779676,274,1,36.891891891891895,33,4,22,38.18301049233253,0.6073232323232323,46.93627450980391,1012.2549019607826,30.674390968508565,0
2617,4,0,1,32,0.0,0.030303030303030304,0.9696969696969697,33,1150,1000,150,0.8695652173913043,13,10,3,389.1366415087916,0.4797585227272727,0.18265182776874678,0.20649805720940972,127442.37075617276,3318.499228395058,130760.86998456782,275,2,41.18181818181818,29,4,22,37.74644658413574,0.6113505747126438,47.56944444444444,1009.7222222222217,34.81800766283523,0
2618,4,0,0,32,0.0,0.0,1.0,32,550,200,350,0.36363636363636365,9,2,7,399.8618051949697,0.47878864247311825,0.1809564056939501,0.21168268134850496,127345.67241792168,3784.134091359477,131129.80650928116,276,3,42.9375,28,4,22,37.5753262158956,0.6134672619047619,47.665229885057464,1009.3390804597693,36.04782430213462,0
2619,4,3,1,34,0.08571428571428572,0.02857142857142857,0.9714285714285714,35,900,500,400,0.5555555555555556,13,5,8,365.03856041131127,0.4774509803921569,0.1555930958501659,0.19777158774373269,128276.40109592007,2365.1665581597176,130641.56765407979,277,0,40.17142857142857,31,4,25,37.500000000000014,0.614247311827957,46.744791666666664,1013.0208333333327,32.67809139784944,0
2620,4,1,2,33,0.02857142857142857,0.05714285714285714,0.9428571428571428,35,850,800,50,0.9411764705882353,9,8,1,373.9260300692172,0.47836134453781515,0.10344282729682752,0.18384508197421282,124296.33621984345,2295.5271109669466,126591.86333081039,278,0,40.82857142857143,33,2,16,41.38285506533939,0.5684974747474747,50.704656862745104,997.1813725490206,30.217617349970322,16
2621,4,1,0,34,0.029411764705882353,0.0,1.0,34,1200,800,400,0.6666666666666666,16,8,8,376.8329550782357,0.47918523469994057,0.12805635983357022,0.1860156679564834,124463.95975219372,2580.4243508315567,127044.38410302528,279,0,42.794117647058826,32,2,19,41.13601375005272,0.5725911458333333,50.536616161616166,997.8535353535359,31.182922979797997,0
2622,4,5,3,36,0.1282051282051282,0.07692307692307693,0.9230769230769231,39,900,600,300,0.6666666666666666,12,6,6,334.48611086806324,0.4821749887539361,0.12590762781645348,0.17022476019377006,125733.0535772261,612.3438473420863,126345.39742456819,280,0,38.17948717948718,36,3,15,40.88138146567857,0.5769675925925926,49.26801801801803,1002.9279279279299,27.859109109109163,0
2623,4,5,2,39,0.12195121951219512,0.04878048780487805,0.9512195121951219,41,750,400,350,0.5333333333333333,11,4,7,332.67678201955493,0.4814024390243902,0.1688519496659937,0.172947863500232,126607.7005259696,223.88847797500352,126831.58900394461,281,0,37.19512195121951,38,3,14,40.02720276008495,0.5822368421052632,48.39743589743589,1006.4102564102551,26.48448043184882,0
2624,4,3,4,38,0.07142857142857142,0.09523809523809523,0.9047619047619048,42,700,400,300,0.5714285714285714,10,4,6,329.0235733200501,0.4805579752226094,0.18866058512679706,0.17287134324600675,127039.50195312501,-40.20182291666572,126999.30013020834,282,0,37.023809523809526,39,3,19,39.67632775366812,0.5849358974358974,47.96875,1008.1250000000001,25.849358974358978,0
2625,4,1,4,35,0.02564102564102564,0.10256410256410256,0.8974358974358975,39,1100,600,500,0.5454545454545454,16,6,10,352.5090548192915,0.48096603688708955,0.19957986203655187,0.18454643144928043,126893.37722435285,1146.2128936368958,128039.59011798975,283,0,37.97435897435897,36,3,23,39.23451995082152,0.5888310185185186,48.113738738738746,1007.545045045046,27.98736236236239,0
2626,4,1,1,35,0.027777777777777776,0.027777777777777776,0.9722222222222222,36,900,500,400,0.5555555555555556,13,5,8,389.25383791908587,0.4807208994708995,0.13422836563923313,0.19352003600811424,124762.0181405895,2512.8188775510107,127274.8370181405,284,0,38.861111111111114,34,2,17,40.516017238639996,0.571078431372549,50.238095238095234,999.0476190476185,29.383753501400545,16
2627,4,4,4,35,0.10256410256410256,0.10256410256410256,0.8974358974358975,39,1750,1300,450,0.7428571428571429,22,13,9,363.6506846293174,0.4817251461988304,0.13446334333863041,0.1853504241600906,125796.22005088103,1349.1763090566337,127145.39635993767,285,0,36.58974358974359,37,2,17,40.08486810944728,0.5757319819819819,49.20504385964912,1003.1798245614035,27.112968231389285,0
2628,4,1,1,35,0.027777777777777776,0.027777777777777776,0.9722222222222222,36,1000,500,500,0.5,15,5,10,368.5587937487667,0.4812334656084656,0.0961982231452636,0.18778948062437165,125782.470703125,2071.647135416667,127854.11783854167,283,0,31.75,35,1,18,39.975986500519205,0.5794642857142858,49.21875,1003.125,28.660714285714285,0
2629,4,2,2,35,0.05405405405405406,0.05405405405405406,0.9459459459459459,37,1200,900,300,0.75,15,9,6,356.7416980130209,0.4816691691691692,0.0952076872649954,0.1834902192042407,126170.65741059574,1603.1519822594469,127773.80939285518,284,0,31.7027027027027,32,5,20,39.87186334883331,0.5901692708333333,48.8320707070707,1004.6717171717162,31.39599116161613,0
2630,4,3,2,36,0.07894736842105263,0.05263157894736842,0.9473684210526316,38,900,400,500,0.4444444444444444,14,4,10,394.03590871132786,0.48454540066382173,0.1606574264843612,0.18950333311373596,123363.9743393528,2393.8861468217165,125757.86048617453,285,0,31.55263157894737,32,6,16,41.85519403490935,0.5611979166666667,51.641414141414124,993.4343434343407,31.044823232323147,16
2631,4,2,1,37,0.05263157894736842,0.02631578947368421,0.9736842105263158,38,950,600,350,0.631578947368421,13,6,7,388.8186594792211,0.4830488383119962,0.20386810399492705,0.1893659746753339,123897.64317735414,2034.7431065707274,125932.38628392486,286,0,32.39473684210526,32,6,18,41.42728809976748,0.5667317708333333,51.104797979797965,995.5808080808064,31.1119002525252,0
2632,4,3,1,39,0.075,0.025,0.975,40,1200,1000,200,0.8333333333333334,14,10,4,364.91154530233666,0.48490918803418803,0.2135684503127171,0.1816981708270112,124826.44917052465,1110.122492283942,125936.5716628086,287,0,31.3,35,5,19,41.057157748436396,0.5696428571428571,50.17361111111111,999.3055555555552,28.55158730158729,0
2633,4,3,7,35,0.07142857142857142,0.16666666666666666,0.8333333333333334,42,1000,400,600,0.4,16,4,12,345.47897558421175,0.4845383275261324,0.20005102412712317,0.17573696944900988,125713.73523584174,286.4110565002852,126000.14629234203,288,0,30.023809523809526,37,5,17,40.6256833588454,0.5748873873873874,49.28728070175438,1002.850877192982,27.104077761972487,0
2634,4,5,2,38,0.125,0.05,0.95,40,1200,600,600,0.5,18,6,12,353.17789646136856,0.48731303418803423,0.20708663819402062,0.18123311593618768,126074.60359296919,906.6511352874513,126981.25472825664,289,0,31.225,33,7,20,40.060377262558475,0.5868055555555556,48.92769607843138,1004.2892156862756,30.433006535947747,0
2635,4,2,2,38,0.05,0.05,0.95,40,1100,700,400,0.6363636363636364,15,7,8,399.8351798956463,0.4852430555555556,0.2860871768879878,0.19575057318464284,124117.72395673918,2027.4619439993933,126145.18590073858,290,0,32.175,32,8,19,40.923297854367284,0.5690104166666667,50.88383838383839,996.4646464646471,31.139520202020222,16
2636,4,5,3,40,0.11627906976744186,0.06976744186046512,0.9302325581395349,43,1450,900,550,0.6206896551724138,20,9,11,373.71910567733534,0.4862264673311185,0.2723952049411684,0.1873947114625494,125119.07596371892,755.0025156221175,125874.07847934104,291,0,30.53488372093023,34,9,20,40.53352570204664,0.5747549019607843,49.88095238095239,1000.4761904761913,29.425770308123273,0
2637,4,5,6,39,0.1111111111111111,0.13333333333333333,0.8666666666666667,45,1300,1100,200,0.8461538461538461,15,11,4,355.0059189631349,0.48600589225589225,0.28809906441927957,0.18228542263858385,126100.38406227181,-43.31855124566695,126057.06551102614,292,0,29.31111111111111,36,9,18,39.98790036252196,0.5807291666666667,48.90202702702703,1004.3918918918926,27.899774774774794,0
2638,4,4,3,40,0.09302325581395349,0.06976744186046512,0.9302325581395349,43,1050,700,350,0.6666666666666666,14,7,7,355.380756439257,0.4838270579549649,0.27921028595517483,0.18476078070376023,126609.88004474061,398.9429885966981,127008.8230333373,293,0,28.976744186046513,36,7,18,39.45372235276565,0.5859375,48.39527027027027,1006.4189189189183,27.956081081081063,0
2639,4,2,5,37,0.047619047619047616,0.11904761904761904,0.8809523809523809,42,1250,1000,250,0.8,15,10,5,367.461238986408,0.4829292489353465,0.30716253443526176,0.1933165648580669,127092.01388888895,940.2777777777853,128032.29166666673,294,0,29.928571428571427,36,6,20,38.65358126721762,0.5908564814814814,47.91666666666667,1008.3333333333339,28.009259259259277,0
2640,4,1,0,38,0.02631578947368421,0.0,1.0,38,1250,900,350,0.72,16,9,7,382.82904173212194,0.48112256993835945,0.28903871248368795,0.20140136543298603,127092.01388888896,2130.9027777777846,129222.91666666674,295,0,29.92105263157895,33,5,21,38.26618457300273,0.5972222222222222,47.91666666666667,1008.333333333334,30.55555555555558,0
2641,4,3,3,38,0.07317073170731707,0.07317073170731707,0.926829268292683,41,1250,800,450,0.64,17,8,9,362.36182989152354,0.48064024390243903,0.2948918545789232,0.195246716106061,128056.65569540887,1080.5688175154214,129137.2245129243,296,0,28.658536585365855,35,6,21,37.79266723842193,0.6026785714285714,46.96180555555555,1012.1527777777771,28.918650793650777,0
2642,4,0,2,36,0.0,0.05263157894736842,0.9473684210526316,38,1050,600,450,0.5714285714285714,15,6,9,370.74664137948173,0.47879623044096725,0.2728033006244426,0.19885501673990363,127873.46938775491,1881.731859410408,129755.20124716533,297,1,30.210526315789473,34,4,21,37.768263496547384,0.6029411764705883,47.14285714285713,1011.42857142857,29.747899159663824,0
2643,4,0,1,35,0.0,0.027777777777777776,0.9722222222222222,36,1050,800,250,0.7619047619047619,13,8,5,400.0384262047344,0.47931547619047615,0.25410136947621065,0.1926745663544221,123426.6991250892,2682.2308941559377,126108.93001924513,298,2,32.388888888888886,32,4,17,41.6404595510377,0.5618489583333333,51.57828282828282,993.686868686868,31.052714646464626,16
2644,4,6,5,36,0.14634146341463414,0.12195121951219512,0.8780487804878049,41,1350,900,450,0.6666666666666666,18,9,9,329.8656899687209,0.4817073170731707,0.1956346430116378,0.1664637133797952,125384.06649161263,213.9620064102357,125598.02849802286,299,0,29.21951219512195,37,4,13,41.35692650171521,0.571509009009009,49.61622807017543,1001.5350877192968,27.06851588430532,16
2645,4,4,4,36,0.1,0.1,0.9,40,1600,1100,500,0.6875,21,11,10,340.03884239813897,0.48086271367521366,0.2131567130669063,0.17328752906651165,125789.53108513924,554.6653071990963,126344.19639233834,300,0,30.325,36,4,16,40.68393578805568,0.5775462962962963,49.211711711711715,1003.1531531531535,27.865365365365378,0
2646,4,1,1,36,0.02702702702702703,0.02702702702702703,0.972972972972973,37,950,600,350,0.631578947368421,13,6,7,404.8403305485288,0.4799486986986987,0.2269802567550372,0.19341277554899,123081.9100888939,2594.253686155803,125676.1637750497,301,0,32.189189189189186,32,5,16,41.88244899690376,0.5582682291666667,51.925505050505045,992.2979797979791,31.009311868686847,16
2647,4,10,8,38,0.21739130434782608,0.17391304347826086,0.8260869565217391,46,950,600,350,0.631578947368421,13,6,7,322.734618060947,0.48661433172302737,0.1741476384110101,0.1546900410705918,123220.66326530611,-1033.7438950940045,122186.91937021211,302,0,26.652173913043477,41,5,15,43.77498001598721,0.5426829268292683,51.785714285714285,992.8571428571428,24.216027874564457,16
2648,4,8,4,42,0.17391304347826086,0.08695652173913043,0.9130434782608696,46,700,500,200,0.7142857142857143,9,5,4,348.701951127923,0.4874597423510467,0.17393087705531918,0.16539598382293333,122774.22499834768,-560.9698725315902,122213.2551258161,303,0,26.369565217391305,40,6,18,43.5961853978671,0.5395833333333333,52.23577235772358,991.0569105691068,24.776422764227668,16
2649,4,3,7,38,0.06666666666666667,0.15555555555555556,0.8444444444444444,45,1150,800,350,0.6956521739130435,15,8,7,334.51035585755824,0.48840488215488215,0.17204391301307553,0.16058518291772214,123287.15820312503,-751.6478661118549,122535.51033701317,304,0,27.044444444444444,39,6,13,43.41348507097405,0.546474358974359,51.71875,993.1250000000002,25.464743589743595,0
2650,4,7,5,40,0.15555555555555556,0.1111111111111111,0.8888888888888888,45,1600,1300,300,0.8125,19,13,6,309.19306749314256,0.4875841750841751,0.1869489972513494,0.15300773309748789,124568.46252437355,-1296.8589918368868,123271.60353253667,305,0,26.6,40,5,13,42.71543825715158,0.5580729166666667,50.43191056910568,998.2723577235759,24.956808943089396,0
2651,4,4,4,40,0.09090909090909091,0.09090909090909091,0.9090909090909091,44,1300,1000,300,0.7692307692307693,16,10,6,317.5545041780473,0.48884557787174066,0.19789495623176379,0.1583811342043939,124895.85503472215,-867.7517361111161,124028.10329861104,306,0,27.977272727272727,39,5,17,42.16861192163402,0.563034188034188,50.104166666666664,999.5833333333327,25.630341880341863,0
2652,4,2,2,40,0.047619047619047616,0.047619047619047616,0.9523809523809523,42,1000,800,200,0.8,12,8,4,327.3757458838664,0.4879379597367402,0.1999781213906653,0.16358300083967486,124973.29202507505,-217.3550615457474,124755.9369635293,307,0,29.452380952380953,38,4,19,41.84319015564341,0.565515350877193,50.02670940170941,999.8931623931638,26.31297795771484,0
2653,4,4,4,40,0.09090909090909091,0.09090909090909091,0.9090909090909091,44,1150,800,350,0.6956521739130435,15,8,7,318.59728446951306,0.4856633192389006,0.2055675257589562,0.16255870747118903,125839.82051234407,-781.5549813272331,125058.26553101683,308,0,28.75,40,4,15,41.16994159154594,0.57109375,49.16158536585367,1003.3536585365873,25.083841463414682,0
2654,4,4,3,41,0.09090909090909091,0.06818181818181818,0.9318181818181819,44,1150,800,350,0.6956521739130435,15,8,7,323.3143294032877,0.4858064658210007,0.23179556761646358,0.16663123130784835,126253.12500000012,-635.9458655562012,125617.17913444391,309,0,29.431818181818183,39,5,19,40.626727473742406,0.5769230769230769,48.75000000000001,1005.0000000000009,25.76923076923079,0
2655,4,4,8,37,0.08888888888888889,0.17777777777777778,0.8222222222222222,45,900,600,300,0.6666666666666666,12,6,6,310.35434007134364,0.48476430976430973,0.21737931034482738,0.16187546514512527,126742.13927469132,-1133.0054012345754,125609.13387345674,310,0,29.133333333333333,41,4,15,40.451149425287355,0.578760162601626,48.263888888888886,1006.9444444444441,24.559620596205953,0
2656,4,0,1,36,0.0,0.02702702702702703,0.972972972972973,37,1750,1100,650,0.6285714285714286,24,11,13,365.45580850903895,0.48119994994994997,0.12475660552135293,0.17513295672572823,123212.45525763027,1613.457540294924,124825.9127979252,311,1,35.91891891891892,35,2,17,42.72314836403203,0.5529761904761905,51.79398148148148,992.8240740740737,28.366402116402107,16
2657,4,6,5,37,0.14285714285714285,0.11904761904761904,0.8809523809523809,42,1150,800,350,0.6956521739130435,15,8,7,354.90090013250426,0.48236062717770034,0.203877790834313,0.17756426115127588,125026.71082849371,513.0388773985295,125539.74970589225,312,0,32.142857142857146,38,4,18,41.09982017590717,0.5660635964912281,49.9732905982906,1000.1068376068379,26.31860098965363,0
2658,4,6,4,39,0.13953488372093023,0.09302325581395349,0.9069767441860466,43,1300,800,500,0.6153846153846154,18,8,10,333.229041866665,0.48325027685492805,0.2163124513185719,0.1715390880545146,126204.81231508864,-180.73715665863836,126024.07515843,313,0,31.372093023255815,38,5,19,40.42729930887828,0.578125,48.79807692307692,1004.8076923076912,26.442307692307665,0
2659,4,2,2,39,0.04878048780487805,0.04878048780487805,0.9512195121951219,41,1550,1100,450,0.7096774193548387,20,11,9,355.01129225818846,0.4813262195121952,0.24727282659164818,0.1836761784394913,126411.62065781983,775.5105612368965,127187.13121905673,314,0,33.63414634146341,36,5,15,39.66708659947741,0.583912037037037,48.592342342342334,1005.6306306306294,27.93418418418415,0
2660,4,3,3,39,0.07142857142857142,0.07142857142857142,0.9285714285714286,42,1150,700,450,0.6086956521739131,16,7,9,350.0850156155449,0.47962640340689117,0.2534648284294685,0.18354999307030623,126953.847878674,488.92796341180315,127442.7758420858,315,0,33.714285714285715,37,5,18,39.233466615892375,0.5875563063063063,48.05372807017543,1007.7850877192966,27.237434803224232,0
2661,4,2,1,40,0.04878048780487805,0.024390243902439025,0.975609756097561,41,1150,700,450,0.6086956521739131,16,7,9,367.9075599796382,0.4781758130081301,0.23046677637242818,0.18408159964007248,125028.93685967496,1225.2812204176435,126254.2180800926,316,0,34.19512195121951,35,6,16,40.772311267985955,0.5717261904761906,49.97106481481481,1000.1157407407399,28.574735449735424,15
2662,4,2,3,39,0.047619047619047616,0.07142857142857142,0.9285714285714286,42,1200,700,500,0.5833333333333334,17,7,10,364.96640894516327,0.4795417150600077,0.24716702078906794,0.1854029357441432,125658.76038781181,772.2453062480964,126431.0056940599,317,0,34.166666666666664,37,5,14,40.193934091571876,0.5743243243243243,49.342105263157904,1002.6315789473699,27.098150782361348,0
2663,4,4,1,42,0.09302325581395349,0.023255813953488372,0.9767441860465116,43,1350,1000,350,0.7407407407407407,17,10,7,331.5238292129294,0.47928202288667404,0.198713066688045,0.16811411452581598,125585.03252239074,-223.27877987076948,125361.75374251997,318,0,32.83720930232558,40,3,13,41.10818209469737,0.5684895833333333,49.415650406504064,1002.3373983739834,25.058434959349587,16
2664,4,0,4,38,0.0,0.09523809523809523,0.9047619047619048,42,1550,1000,550,0.6451612903225806,21,10,11,334.8827795581041,0.47898519163763065,0.19617810760667864,0.17009217695233522,125651.88937717021,15.730794270840192,125667.62017144106,319,1,34.476190476190474,39,3,14,40.95508658008657,0.5707799145299146,49.348958333333336,1002.6041666666673,25.707799145299163,0
2665,4,0,4,34,0.0,0.10526315789473684,0.8947368421052632,38,1350,1100,250,0.8148148148148148,16,11,5,348.58219333667944,0.47741820768136556,0.08038555343156895,0.16345955173924487,122284.05929155511,925.8194711550675,123209.87876271017,320,2,36.8421052631579,36,2,15,44.111493794830935,0.5413773148148149,52.73085585585586,989.0765765765769,27.47434934934936,16
2666,4,9,9,34,0.20930232558139536,0.20930232558139536,0.7906976744186046,43,1200,900,300,0.75,15,9,6,308.54998283449305,0.48419619785898854,0.09120436533714438,0.14927147818209277,123614.96913580269,-971.7206790123228,122643.24845679037,321,0,32.06976744186046,41,2,13,43.717993482309126,0.5467479674796748,51.3888888888889,994.4444444444463,24.25474254742552,0
2667,4,10,7,37,0.22727272727272727,0.1590909090909091,0.8409090909090909,44,1100,900,200,0.8181818181818182,13,9,4,302.1956253646585,0.4840887068357999,0.14410741867756816,0.1500899849271969,124720.6846639731,-1261.0264342396222,123459.65822973347,322,0,31.40909090909091,40,4,13,42.733026418421666,0.5596354166666666,50.27947154471544,998.8821138211376,24.97205284552844,0
2668,4,12,14,35,0.24489795918367346,0.2857142857142857,0.7142857142857143,49,650,400,250,0.6153846153846154,9,4,5,283.52699208498586,0.48733347505668934,0.1827879189564865,0.1453026679270487,126021.09854973985,-2653.923397789349,123367.1751519505,323,0,28.6734693877551,45,4,13,41.86391144188842,0.5659722222222222,48.980978260869556,1004.0760869565199,22.31280193236711,0
2669,4,1,2,34,0.027777777777777776,0.05555555555555555,0.9444444444444444,36,900,700,200,0.7777777777777778,11,7,4,365.59695667871455,0.4810185185185185,0.20197704350761714,0.17992837138972984,124338.00002869595,1891.5188820018247,126229.51891069778,324,0,38.083333333333336,32,4,17,41.547189517660456,0.5712890625,50.66287878787878,997.3484848484841,31.167140151515127,0
2670,4,4,0,38,0.10526315789473684,0.0,1.0,38,1550,1300,250,0.8387096774193549,18,13,5,342.36933726480396,0.4806039592223803,0.19921684988812172,0.17310449669183042,125463.39163237289,990.9636488339934,126454.35528120688,325,0,34.31578947368421,35,3,18,40.96195317313616,0.5761904761904761,49.537037037037024,1001.8518518518499,28.62433862433857,0
2671,4,2,0,40,0.05,0.0,1.0,40,1000,700,300,0.7,13,7,6,336.767062530674,0.48050213675213677,0.2271071508630349,0.1732777238695892,126185.2287253471,500.3453544260075,126685.57407977311,326,0,33.55,36,4,20,40.358570574609566,0.5815972222222222,48.81756756756757,1004.7297297297308,27.909159159159188,0
2672,4,1,0,41,0.024390243902439025,0.0,1.0,41,1400,900,500,0.6428571428571429,19,9,10,335.1840417956924,0.4800558943089431,0.23780155657532154,0.17431469233102903,126622.5560388774,288.3720231225042,126910.9280619999,327,0,33.707317073170735,37,4,17,39.948864255365486,0.584177927927928,48.38267543859649,1006.4692982456145,27.201872925557147,0
2673,4,0,3,38,0.0,0.07317073170731707,0.926829268292683,41,550,400,150,0.7272727272727273,7,4,3,332.44752964103884,0.4794461382113821,0.22724205895947036,0.17324252083791228,126705.33842143719,224.5753501077074,126929.9137715449,328,1,34.707317073170735,37,4,17,39.93274885645828,0.5850225225225225,48.30043859649122,1006.7982456140337,27.210763394973885,0
2674,4,0,2,36,0.0,0.05263157894736842,0.9473684210526316,38,850,400,450,0.47058823529411764,13,4,9,381.13729120408306,0.47845542911332384,0.10378536155526574,0.18552132663533227,123874.07467689055,2154.685051997849,126028.7597288884,329,2,37.31578947368421,35,3,17,41.64305022671782,0.5598214285714286,51.12847222222223,995.4861111111121,28.442460317460345,16
2675,4,8,6,38,0.18181818181818182,0.13636363636363635,0.8636363636363636,44,1200,900,300,0.75,15,9,6,345.36438619132076,0.4819635306553911,0.16471000308031591,0.17603001500080256,125796.2200508816,-90.51794248651692,125705.70210839508,330,0,32.88636363636363,37,7,15,40.54347925091997,0.5757319819819819,49.20504385964915,1003.179824561408,27.112968231389406,0
2676,4,5,3,40,0.11627906976744186,0.06976744186046512,0.9302325581395349,43,1300,800,500,0.6153846153846154,18,8,10,357.60403574318576,0.4836424880029531,0.19280131236128462,0.1833671757746976,126043.8368055558,414.7569444444656,126458.59375000026,331,0,33.627906976744185,36,7,21,39.980982019363736,0.580150462962963,48.95833333333334,1004.1666666666686,27.893518518518572,0
2677,4,1,2,39,0.024390243902439025,0.04878048780487805,0.9512195121951219,41,1150,600,550,0.5217391304347826,17,6,11,353.89720901553306,0.4836128048780488,0.18559112766971397,0.18279277860160095,126342.87308673467,742.4780328798191,127085.3511196145,332,0,34.926829268292686,34,7,12,39.76588711268996,0.5873161764705883,48.660714285714285,1005.3571428571427,29.569327731092432,0
2678,4,2,5,36,0.04878048780487805,0.12195121951219512,0.8780487804878049,41,1400,1100,300,0.7857142857142857,17,11,6,348.7815814674651,0.4841463414634146,0.1881236633212473,0.18240974921988198,126852.0479024943,648.7315759637206,127500.77947845803,333,0,35.51219512195122,34,7,15,39.37086386197117,0.5925245098039216,48.154761904761905,1007.3809523809522,29.62885154061624,0
2679,4,3,5,34,0.07692307692307693,0.1282051282051282,0.8717948717948718,39,1350,900,450,0.6666666666666666,18,9,9,358.5026154603478,0.48155645524066576,0.17607648932950148,0.18703593595159856,126752.42282115048,1288.2150194636622,128040.63784061414,334,0,37.666666666666664,33,6,15,39.228504928806146,0.59375,48.25367647058823,1006.9852941176467,30.51470588235293,0
2680,4,0,0,34,0.0,0.0,1.0,34,1550,1300,250,0.8387096774193549,18,13,5,411.0338202873106,0.4814319667260844,0.19877084057928163,0.2101162596439764,125917.07996951841,3551.2356838587875,129468.3156533772,335,2,43.588235294117645,32,2,21,38.77112425042982,0.5875651041666667,49.08459595959596,1003.661616161616,31.3644255050505,0
2681,4,4,4,34,0.10526315789473684,0.10526315789473684,0.8947368421052632,38,1000,700,300,0.7,13,7,6,368.78472838832715,0.4814485538169749,0.18173652508500493,0.1935834033021678,127002.00007086166,1767.4071581877283,128769.40722904938,336,0,39.89473684210526,34,4,18,38.71279674028582,0.5940563725490196,48.00595238095238,1007.9761904761903,29.64635854341736,0
2682,4,1,0,35,0.02857142857142857,0.0,1.0,35,800,500,300,0.625,11,5,6,386.60341021450256,0.48077731092436976,0.17740855459867855,0.2022759744328864,126869.31060924918,2809.621626619748,129678.93223586892,337,0,42.02857142857143,32,3,19,38.40054100346744,0.5973307291666667,48.13762626262627,1007.4494949494959,31.482796717171748,0
2683,4,2,2,35,0.05405405405405406,0.05405405405405406,0.9459459459459459,37,1050,800,250,0.7619047619047619,13,8,5,368.7108088000847,0.4788538538538538,0.17787684591808262,0.19651070578905633,127617.73003472228,2011.0025842388573,129628.73261896113,338,0,40.7027027027027,33,4,19,38.082044673539514,0.6025883838383839,47.395833333333336,1010.4166666666672,30.618686868686886,0
2684,4,0,0,35,0.0,0.0,1.0,35,1100,600,500,0.5454545454545454,16,6,10,367.6966856421511,0.4759803921568628,0.15499089968238122,0.19651399634519767,127729.38507550252,2393.1343102744627,130122.51938577698,339,1,43.0,32,3,20,37.99311974352568,0.6061197916666667,47.285353535353536,1010.8585858585859,31.58933080808081,0
2685,4,0,1,34,0.0,0.02857142857142857,0.9714285714285714,35,950,800,150,0.8421052631578947,11,8,3,397.711479629333,0.47580532212885157,0.09727090228419533,0.19573351885309032,124338.00002869595,2890.8035532088443,127228.8035819048,340,2,44.0,32,3,13,40.746455247499675,0.5712890625,50.66287878787878,997.3484848484841,31.167140151515127,16
2686,4,2,1,35,0.05555555555555555,0.027777777777777776,0.9722222222222222,36,1350,1100,250,0.8148148148148148,16,11,5,385.09727311058674,0.47605820105820107,0.10250122609122103,0.1919837016803146,124877.48101691662,2417.9954825067325,127295.47649942336,341,0,43.666666666666664,33,3,16,40.499836521170515,0.5744949494949495,50.122549019607845,999.509803921569,30.28817587641118,0
2687,4,4,3,36,0.10256410256410256,0.07692307692307693,0.9230769230769231,39,950,500,450,0.5263157894736842,14,5,9,348.21681329078444,0.4778452541610436,0.0967932176279529,0.17806405374990056,125930.78033692502,970.3030778780055,126901.08341480303,342,0,40.23076923076923,36,3,16,40.33317438946855,0.5789930555555556,49.07094594594596,1003.7162162162183,27.881006006006064,0
2688,4,3,3,36,0.07692307692307693,0.07692307692307693,0.9230769230769231,39,1300,900,400,0.6923076923076923,17,9,8,353.0821858084877,0.4793353576248313,0.11666652311596915,0.1828044638524989,126439.93391617986,1128.7376481211172,127568.67156430097,343,0,41.0,36,3,16,39.68643862202814,0.5842013888888888,48.5641891891892,1005.7432432432446,27.93731231231235,0
2689,4,2,3,35,0.05263157894736842,0.07894736842105263,0.9210526315789473,38,850,400,450,0.47058823529411764,13,4,9,363.18980188401514,0.47934447605500236,0.11368384717402757,0.18822197782790528,126480.04979263106,1587.2528452931992,128067.30263792427,344,0,42.578947368421055,35,3,17,39.390964791163285,0.5866071428571429,48.52430555555555,1005.9027777777768,28.74007936507934,0
2690,4,3,1,37,0.07894736842105263,0.02631578947368421,0.9736842105263158,38,950,400,550,0.42105263157894735,15,4,11,370.3000046071984,0.47864805595068755,0.14075592150603944,0.19397303490434833,126917.01630015431,1799.4743441358041,128716.49064429011,345,0,42.0,35,3,20,38.76206064782909,0.5910714285714286,48.09027777777778,1007.6388888888888,28.789682539682538,0
2691,4,1,0,38,0.02631578947368421,0.0,1.0,38,1400,1200,200,0.8571428571428571,16,12,4,372.007987252571,0.478351706970128,0.1500630634548834,0.19585330391650266,127122.02558106568,1858.202337648015,128980.2279187137,346,0,42.973684210526315,34,4,21,38.50809624995082,0.595281862745098,47.88690476190476,1008.4523809523803,29.660364145658242,0
2692,4,0,3,35,0.0,0.07894736842105263,0.9210526315789473,38,1000,700,300,0.7,13,7,6,369.2658434924864,0.4778775486012328,0.14853283651606897,0.19498616969463053,127242.10778061215,1797.2328514739138,129039.34063208607,347,1,43.973684210526315,34,4,22,38.45378564405113,0.5965073529411764,47.76785714285714,1008.9285714285706,29.674369747899135,0
2693,4,2,1,36,0.05405405405405406,0.02702702702702703,0.972972972972973,37,1300,900,400,0.6923076923076923,17,9,8,370.8009742665556,0.4781343843843844,0.14310855052943117,0.19792852005024475,127679.65032980092,2068.747747260656,129748.39807706157,348,0,44.351351351351354,33,4,21,37.965699648356996,0.603219696969697,47.334558823529406,1010.6617647058813,30.626114081996402,0
2694,4,0,2,34,0.0,0.05555555555555555,0.9444444444444444,36,1250,600,650,0.48,19,6,13,376.329826091452,0.47792658730158727,0.13626520073296677,0.20080959520239872,127665.5762167125,2408.872819100083,130074.44903581259,349,1,45.916666666666664,32,4,21,37.8404547726137,0.60546875,47.348484848484844,1010.60606060606,31.581439393939377,0
2695,4,0,1,33,0.0,0.029411764705882353,0.9705882352941176,34,800,500,300,0.625,11,5,6,383.9302795196092,0.4768085264408794,0.1101879927228624,0.20462218194176945,127617.73003472204,2999.2621527777533,130616.9921874998,350,2,46.26470588235294,31,3,21,37.697594501718214,0.6075268817204301,47.39583333333332,1010.4166666666652,32.594086021505326,0
2696,4,0,1,32,0.0,0.030303030303030304,0.9696969696969697,33,1100,800,300,0.7272727272727273,14,8,6,382.661518399164,0.476523042929293,0.09557710021388521,0.20461322512748648,127749.32861328105,3176.950412326359,130926.27902560741,351,3,47.333333333333336,31,2,22,37.59445303108363,0.6088709677419355,47.265624999999986,1010.9374999999984,32.61088709677414,0
2697,4,1,3,30,0.030303030303030304,0.09090909090909091,0.9090909090909091,33,850,500,350,0.5882352941176471,12,5,7,424.20741821142315,0.47612847222222227,0.16997608729362046,0.20973131076151993,124530.01250144532,4191.14109673988,128721.1535981852,352,0,43.36363636363637,30,3,16,39.88520064637761,0.5784722222222223,50.47043010752689,998.118279569893,33.270609318996435,16
2698,4,4,4,30,0.11764705882352941,0.11764705882352941,0.8823529411764706,34,650,300,350,0.46153846153846156,10,3,7,410.8753089708697,0.4772727272727273,0.16589243828457523,0.20852531336629682,125619.25464206266,3523.6552306938333,129142.9098727565,353,0,39.470588235294116,31,3,18,39.08421548253021,0.5870295698924731,49.381510416666664,1002.4739583333328,32.3378696236559,0
2699,4,3,1,32,0.09090909090909091,0.030303030303030304,0.9696969696969697,33,1200,800,400,0.6666666666666666,16,8,8,402.7437834801715,0.47462910353535354,0.1669302065341669,0.20702249227859695,126145.08360793146,3561.5459633116006,129706.62957124306,354,0,40.333333333333336,30,3,21,38.74291990009813,0.5951388888888889,48.857526881720425,1004.5698924731175,33.48566308243725,0
2700,4,1,3,30,0.030303030303030304,0.09090909090909091,0.9090909090909091,33,1050,800,250,0.7619047619047619,13,8,5,446.0184180671247,0.47514204545454547,0.16402272317993583,0.2166876881475715,123793.24921956286,4547.161160249728,128340.41037981259,355,0,41.03030303030303,30,3,20,40.11317080857195,0.5708333333333333,51.20967741935483,995.1612903225798,33.17204301075266,16
2701,4,7,4,33,0.1891891891891892,0.10810810810810811,0.8918918918918919,37,1000,700,300,0.7,13,7,6,384.8362934224448,0.477195945945946,0.15222361726029243,0.19528293301461538,125613.4960111496,2268.352262657329,127881.84827380693,356,0,36.4054054054054,33,4,17,39.74276691116545,0.5820707070707071,49.38725490196079,1002.4509803921571,30.377302436125973,0
2702,4,5,1,37,0.13157894736842105,0.02631578947368421,0.9736842105263158,38,900,700,200,0.7777777777777778,11,7,4,373.17934739185193,0.47790718349928873,0.16383381172206724,0.19209322422667244,126202.3725257626,1820.69559338976,128023.06811915236,357,0,36.26315789473684,32,6,21,39.4262586914635,0.5904947916666667,48.800505050505045,1004.7979797979792,31.39993686868685,0
2703,4,0,5,32,0.0,0.13513513513513514,0.8648648648648649,37,900,500,400,0.5555555555555556,13,5,8,384.991451623048,0.47760260260260257,0.049208608678438015,0.18739736702941912,123874.07467689042,2173.3083976603148,126047.38307455073,358,1,38.24324324324324,35,2,18,41.54713114754097,0.5598214285714286,51.12847222222222,995.4861111111111,28.442460317460316,16
2704,4,9,5,36,0.21951219512195122,0.12195121951219512,0.8780487804878049,41,1200,700,500,0.5833333333333334,17,7,10,335.80920336555783,0.48051321138211384,0.10699088478599372,0.1717193017554341,125930.78033692474,267.9908829155701,126198.77121984032,359,0,34.51219512195122,36,5,19,40.64451737162945,0.5789930555555556,49.070945945945944,1003.716216216216,27.881006006006,0
2705,4,4,2,38,0.1,0.05,0.95,40,1050,700,350,0.6666666666666666,14,7,7,332.70168972957197,0.4783520299145299,0.12659433636468354,0.17193215816066545,126363.65265185587,408.3308779366893,126771.98352979256,360,0,35.025,35,5,16,40.277258163539415,0.5854166666666667,48.64004629629628,1005.4398148148126,28.72685185185179,0
2706,4,0,1,37,0.0,0.02631578947368421,0.9736842105263158,38,1150,700,450,0.6086956521739131,16,7,9,350.17846519928594,0.47688477951635844,0.1274711168164313,0.1803683049393308,126228.4938485198,1240.5000480584379,127468.99389657825,361,1,37.63157894736842,33,5,23,39.97713414634146,0.5883838383838385,48.77450980392157,1004.9019607843138,30.45157456922163,0
2707,4,1,5,33,0.02631578947368421,0.13157894736842105,0.868421052631579,38,1150,1000,150,0.8695652173913043,13,10,3,339.6216709746281,0.47707740635372214,0.11316334314045928,0.17638415815133884,126567.38281249978,997.0052083333044,127564.38802083308,362,0,37.78947368421053,35,3,17,39.8938923395445,0.5875,48.437499999999986,1006.2499999999983,28.74999999999995,0
2708,4,3,2,34,0.08333333333333333,0.05555555555555555,0.9444444444444444,36,1350,800,550,0.5925925925925926,19,8,11,431.9040622556437,0.47511574074074076,0.18275002113449967,0.21050651637503168,123929.07133200717,4089.946298528243,128019.01763053541,363,0,40.22222222222222,32,4,19,40.32198410685605,0.5670572916666667,51.07323232323234,995.7070707070726,31.11584595959602,16
2709,4,3,3,34,0.08108108108108109,0.08108108108108109,0.9189189189189189,37,1100,800,300,0.7272727272727273,14,8,6,397.5028753949536,0.47800925925925924,0.1924062045366064,0.19785143118714885,124810.67780073479,2522.5286322824445,127333.20643301723,364,0,39.86486486486486,32,5,20,40.259350518069255,0.576171875,50.18939393939395,999.2424242424256,31.2263257575758,0
2710,4,3,1,36,0.08108108108108109,0.02702702702702703,0.972972972972973,37,1300,900,400,0.6923076923076923,17,9,8,389.74777724313935,0.4783533533533533,0.19567806464985726,0.19686997047481752,125423.53524102099,2376.8522950900096,127800.387536111,365,0,40.24324324324324,31,6,19,39.81663525282726,0.585013440860215,49.576822916666664,1001.6927083333328,32.312668010752674,0
2711,4,4,2,38,0.1,0.05,0.95,40,950,500,450,0.5263157894736842,14,5,9,361.985418821814,0.48050213675213677,0.22148099360180695,0.18821825006057918,126615.0317091367,1169.6192913913505,127784.65100052806,366,0,38.125,32,8,22,39.282241876803425,0.5947265625,48.39015151515151,1006.439393939393,31.45123106060603,0
2712,4,4,1,41,0.09523809523809523,0.023809523809523808,0.9761904761904762,42,950,500,450,0.5263157894736842,14,5,9,342.1805831024754,0.47971109175377463,0.24393640008782036,0.18195176554390952,127524.87775134544,328.20415741241777,127853.08190875786,367,0,37.11904761904762,33,9,19,38.847266035751844,0.6016414141414141,47.487745098039206,1010.0490196078415,30.60754604872247,0
2713,4,1,1,41,0.023809523809523808,0.023809523809523808,0.9761904761904762,42,1300,1100,200,0.8461538461538461,15,11,4,339.37689623507833,0.47927555168408825,0.24720923520923632,0.18157324214911758,127772.55893166062,272.61089484810617,128045.16982650873,368,0,38.04761904761905,33,9,22,38.66464646464647,0.6041666666666667,47.242647058823515,1011.0294117647036,30.637254901960716,0
2714,4,0,2,39,0.0,0.04878048780487805,0.9512195121951219,41,1600,1200,400,0.75,20,12,8,347.47674184608434,0.4778963414634146,0.24899762186505536,0.18581690754136937,127753.08956916086,678.2454648525879,128431.33503401345,369,1,39.90243902439025,34,7,22,38.47984377453289,0.6017156862745099,47.26190476190475,1010.9523809523798,29.733893557422935,0
2715,4,2,3,38,0.04878048780487805,0.07317073170731707,0.926829268292683,41,1050,800,250,0.7619047619047619,13,8,5,386.90930270292534,0.4789380081300813,0.20404641377950195,0.19663472781203462,125676.58875091304,1550.0953501074123,127226.68410102045,370,0,40.41463414634146,36,5,19,39.625449236298294,0.5763888888888888,49.32432432432432,1002.7027027027024,27.852852852852845,16
2716,4,1,2,37,0.02564102564102564,0.05128205128205128,0.9487179487179487,39,1950,1600,350,0.8205128205128205,23,16,7,387.21785093231847,0.47835132703553757,0.19448877540163845,0.19855213207380606,126043.8368055557,1961.8205198441865,128005.65732539988,371,0,37.97435897435897,33,6,20,39.23755186721993,0.586489898989899,48.95833333333334,1004.1666666666678,30.429292929292963,0
2717,4,2,3,36,0.05128205128205128,0.07692307692307693,0.9230769230769231,39,800,500,300,0.625,11,5,6,374.38232669618014,0.4790260908681961,0.20762611313025348,0.19458402954614124,126598.21342752787,1679.2267397154924,128277.44016724336,372,0,38.61538461538461,33,6,19,38.98766033446988,0.5921717171717171,48.40686274509804,1006.3725490196077,30.496137849079023,0
2718,4,1,1,36,0.02702702702702703,0.02702702702702703,0.972972972972973,37,1100,900,200,0.8181818181818182,13,9,4,393.45433025826725,0.47754004004004,0.20692020692020696,0.20336374419373068,126370.92590332018,2544.2376030815817,128915.16350640176,373,0,40.4054054054054,31,6,19,38.742661659328334,0.594758064516129,48.63281249999999,1005.468749999999,32.43447580645158,0
2719,4,2,0,38,0.05263157894736842,0.0,1.0,38,1500,1100,400,0.7333333333333333,19,11,8,381.87399976180455,0.477195945945946,0.21468039931952188,0.20027058252948232,126964.73095857544,2096.905927966508,129061.63688654195,374,0,40.28947368421053,32,6,21,38.42134385701161,0.5983072916666667,48.04292929292928,1007.8282828282811,31.494633838383784,0
2720,4,1,2,37,0.02564102564102564,0.05128205128205128,0.9487179487179487,39,900,600,300,0.6666666666666666,12,6,6,370.82743421565823,0.4772829509671615,0.06761060588618983,0.19163461755094752,126363.65265185632,2153.020484153774,128516.6731360101,375,0,40.23076923076923,35,4,14,39.31892962664518,0.5854166666666667,48.640046296296305,1005.4398148148163,28.726851851851894,16
2721,4,2,3,36,0.05128205128205128,0.07692307692307693,0.9230769230769231,39,1050,600,450,0.5714285714285714,15,6,9,356.9310636978041,0.4769455690508322,0.13342928147670863,0.18739390454448412,127009.10526556264,1266.6990083487422,128275.80427391139,376,0,41.12820512820513,37,2,17,39.00420156640922,0.5881193693693694,47.99890350877194,1008.0043859649136,27.243361782835503,0
2722,4,2,1,37,0.05263157894736842,0.02631578947368421,0.9736842105263158,38,1050,700,350,0.6666666666666666,14,7,7,358.98726634798754,0.47750711237553345,0.11078501958583065,0.17776258091376215,124595.23560742443,1547.1549724820284,126142.39057990645,377,0,40.10526315789474,35,3,16,41.444953242136194,0.5672619047619047,50.40509259259259,998.3796296296285,28.525132275132243,16
2723,4,1,3,35,0.02631578947368421,0.07894736842105263,0.9210526315789473,38,1550,900,650,0.5806451612903226,22,9,13,347.8263713146104,0.47621799431009953,0.11278804791557451,0.17367191881015046,124942.13632758912,1091.6339806241342,126033.77030821325,378,0,40.94736842105263,35,3,17,41.36422397159835,0.5708333333333333,50.05787037037037,999.7685185185182,28.564814814814806,0
2724,4,3,2,36,0.07894736842105263,0.05263157894736842,0.9473684210526316,38,1550,1000,550,0.6451612903225806,21,10,11,341.1163103774526,0.47426209103840683,0.14324514819720724,0.17319750764885675,125637.3845271777,971.392211076826,126608.77673825453,379,0,41.526315789473685,35,3,15,40.81380358654661,0.5779761904761904,49.36342592592593,1002.5462962962968,28.644179894179906,0
2725,4,1,1,36,0.02702702702702703,0.02702702702702703,0.972972972972973,37,1350,800,550,0.5925925925925926,19,8,11,346.80291651705915,0.47450575575575576,0.14469183027720156,0.1761624947470852,125655.61933106575,1315.5470521541924,126971.16638321994,380,0,43.5945945945946,34,3,16,40.65245784849203,0.5802696078431373,49.345238095238095,1002.6190476190476,29.488795518207283,0
2726,4,3,2,37,0.07692307692307693,0.05128205128205128,0.9487179487179487,39,1100,700,400,0.6363636363636364,15,7,8,324.15010044513815,0.47621457489878544,0.13555164966455302,0.16747755189665467,126355.00365230087,391.5974251278243,126746.6010774287,381,0,41.743589743589745,36,3,15,40.501092069892486,0.5833333333333333,48.648648648648646,1005.4054054054048,27.92792792792791,0
2727,4,2,1,38,0.05128205128205128,0.02564102564102564,0.9743589743589743,39,900,500,400,0.5555555555555556,13,5,8,324.70146732181627,0.4757085020242915,0.14547802505273189,0.16857685127951355,126553.21865361978,418.4031582257941,126971.62181184557,382,0,42.69230769230769,36,3,17,40.283762357769085,0.5853587962962963,48.45157657657658,1006.1936936936933,27.949824824824812,0
2728,4,2,3,37,0.05,0.075,0.925,40,1350,1100,250,0.8148148148148148,16,11,5,318.30759104106124,0.4762686965811966,0.15533072236727596,0.16700247584757008,126981.47506925173,83.83348722679636,127065.30855647853,383,0,42.425,37,3,19,40.00580214679431,0.5878378378378378,48.026315789473664,1007.8947368421025,27.240398293029795,0
2729,4,2,0,39,0.05128205128205128,0.0,1.0,39,1150,700,450,0.6086956521739131,16,7,9,323.7886883892399,0.4763270355375619,0.15330224462746478,0.17069895714552205,127177.19144397762,435.7072021345454,127612.89864611217,384,0,42.8974358974359,36,3,21,39.66729931896839,0.591724537037037,47.8322072072072,1008.67117117117,28.018643643643614,0
2730,4,1,3,37,0.025,0.075,0.925,40,1400,1100,300,0.7857142857142857,17,11,6,337.23145896779675,0.4768429487179487,0.016596504316317207,0.17113265438046665,125615.07100819971,680.0460757981687,126295.11708399787,385,0,42.8,38,2,15,40.934180610323665,0.5720942982456141,49.38568376068375,1002.4572649572625,26.38045434098059,16
2731,4,3,2,38,0.075,0.05,0.95,40,750,500,250,0.6666666666666666,10,5,5,323.54118108346574,0.4745860042735042,0.07188958009331281,0.1664295835493347,126174.62158203122,164.53721788194326,126339.15879991316,386,0,43.45,39,1,18,40.70168049075513,0.5761217948717949,48.828125,1004.6874999999998,25.761217948717942,0
2732,4,2,6,34,0.05,0.15,0.85,40,1000,800,200,0.8,12,8,4,319.21779423804816,0.47522702991452986,0.08555900621117996,0.16578730603976038,126567.38281249999,80.51215277777635,126647.89496527777,387,0,43.875,39,1,17,40.407177363699105,0.5801282051282051,48.4375,1006.2499999999999,25.801282051282048,0
2733,4,3,2,35,0.08108108108108109,0.05405405405405406,0.9459459459459459,37,1000,500,500,0.5,15,5,10,333.3630716468606,0.4696571571571571,0.10035326284207202,0.17319374466490398,126581.5477639803,1039.522715282862,127621.07047926316,388,0,47.2972972972973,36,1,18,40.0367893912265,0.5856481481481481,48.42342342342343,1006.3063063063072,27.952952952952977,0
2734,4,2,1,36,0.05405405405405406,0.02702702702702703,0.972972972972973,37,1350,900,450,0.6666666666666666,18,9,9,335.4313942287689,0.47040790790790793,0.11548131315573174,0.1752393919382076,126808.294781268,1107.0966236507077,127915.39140491872,389,0,48.24324324324324,36,1,20,39.75197525342876,0.587962962962963,48.19819819819821,1007.2072072072093,27.977977977978036,0
2735,4,0,0,36,0.0,0.0,1.0,36,1800,1500,300,0.8333333333333334,21,15,6,337.56816216125515,0.46908068783068785,0.09621065435408527,0.17734214716358934,127035.24470416395,1376.6108168980124,128411.85552106197,390,1,49.111111111111114,36,0,20,39.4653429401251,0.5902777777777778,47.97297297297299,1008.1081081081109,28.00300300300308,0
2736,4,0,2,34,0.0,0.05555555555555555,0.9444444444444444,36,1300,1000,300,0.7692307692307693,16,10,6,339.2325104052975,0.4684689153439154,0.08799035110565412,0.17909157694290298,127233.99233270447,1432.3813255823518,128666.37365828682,391,2,50.111111111111114,36,0,21,39.2196394686907,0.5923032407407407,47.77590090090091,1008.8963963963976,28.024899899899932,0
2737,4,1,1,34,0.02857142857142857,0.02857142857142857,0.9714285714285714,35,1200,700,500,0.5833333333333334,17,7,10,345.52020797455896,0.47013305322128857,0.09175880878667253,0.18295578225538126,127354.73632812501,1800.726996527778,129155.4633246528,392,0,50.6,35,0,17,38.93726350189196,0.5955357142857143,47.65625,1009.3750000000001,28.83928571428572,0
2738,4,0,0,34,0.0,0.0,1.0,34,1100,800,300,0.7272727272727273,14,8,6,350.0328186187253,0.4691770647653,0.08570338512763587,0.18551739386792432,127392.29024943306,2118.2964852607593,129510.58673469382,393,1,52.14705882352941,34,0,18,38.784886006289284,0.5980392156862745,47.61904761904761,1009.5238095238092,29.69187675070027,0
2739,4,0,0,34,0.0,0.0,1.0,34,1750,1400,350,0.8,21,14,7,349.7059754151004,0.46913992869875226,0.0890813764789109,0.18561990509830287,127452.38803854863,2114.172335600895,129566.56037414953,394,2,53.14705882352941,34,0,18,38.731529513479536,0.5986519607843137,47.5595238095238,1009.7619047619037,29.698879551820696,0
2740,4,0,0,34,0.0,0.0,1.0,34,1050,900,150,0.8571428571428571,12,9,3,347.9124563844714,0.4690285204991087,0.08855415840623349,0.18521863895097995,127572.62613378662,2076.8211451246866,129649.4472789113,395,3,54.14705882352941,34,0,18,38.653615759289785,0.5998774509803921,47.440476190476176,1010.2380952380934,29.71288515406157,0
2741,4,0,0,34,0.0,0.0,1.0,34,900,500,400,0.5555555555555556,13,5,8,350.79926665957214,0.4686014557338087,0.08840159930151859,0.18717378847725358,127662.84190759622,2156.806264172318,129819.64817176854,396,4,55.14705882352941,34,0,18,38.48828876585385,0.600796568627451,47.35119047619047,1010.5952380952369,29.723389355742263,0
2742,4,0,0,34,0.0,0.0,1.0,34,1150,700,450,0.6086956521739131,16,7,9,400.61998816022225,0.4684343434343434,0.11939462299364023,0.20137695917223097,125221.05724224576,3311.290633869106,128532.34787611487,397,5,56.14705882352941,32,2,16,39.754688616963115,0.5804036458333333,49.77904040404041,1000.883838383839,31.27761994949497,14
2743,4,0,0,34,0.0,0.0,1.0,34,1100,600,500,0.5454545454545454,16,6,10,401.4416252985312,0.46806298276886515,0.12017315439229037,0.20209718393600348,125284.2523243802,3258.8627754820977,128543.11509986229,398,6,57.14705882352941,32,2,16,39.668463866818,0.5810546875,49.71590909090909,1001.136363636364,31.285511363636374,0
2744,4,0,2,32,0.0,0.058823529411764705,0.9411764705882353,34,1050,500,550,0.47619047619047616,16,5,11,398.8452671366914,0.46759878193701726,0.11584839415218129,0.20179201139292013,125490.67666282206,3210.2724913494912,128700.94915417155,399,7,58.14705882352941,33,1,16,39.519121004566216,0.5808080808080809,49.50980392156863,1001.9607843137261,30.362448009506853,0
2745,4,4,1,35,0.1111111111111111,0.027777777777777776,0.9722222222222222,36,700,300,400,0.42857142857142855,11,3,8,374.2301048787908,0.47172619047619047,0.09638052270048392,0.19290138844192095,126259.28316332646,2252.4379145040202,128511.72107783047,400,0,49.388888888888886,33,3,21,39.34111185627769,0.588699494949495,48.7438725490196,1005.0245098039204,30.455288175876376,0
2746,4,0,4,31,0.0,0.11428571428571428,0.8857142857142857,35,1200,800,400,0.6666666666666666,16,8,8,378.61549216351153,0.47132352941176475,0.07804930563031554,0.19549523661516716,126329.27284205689,2566.043962350776,128895.31680440766,401,1,47.885714285714286,32,3,14,39.15865988445115,0.591796875,48.67424242424242,1005.30303030303,31.41571969696969,0
2747,4,3,0,34,0.08823529411764706,0.0,1.0,34,850,300,550,0.35294117647058826,14,3,11,392.4429088770425,0.4708667557932264,-0.03656400525470749,0.19274761727206657,124252.42318047427,3057.9262067026007,127310.34938717687,402,0,50.088235294117645,31,3,19,40.96700731356929,0.5729166666666667,50.74869791666667,997.0052083333342,32.16145833333336,16
2748,4,4,2,36,0.10526315789473684,0.05263157894736842,0.9473684210526316,38,1350,1100,250,0.8148148148148148,16,11,5,370.85208303091906,0.4787665955429113,-0.009131261889663733,0.17292540950318117,122041.52494331049,1619.4588762832432,123660.98381959373,403,0,45.71052631578947,34,4,18,43.81526104417671,0.5428921568627452,52.97619047619047,988.0952380952368,29.06162464985991,16
2749,4,9,6,39,0.2,0.13333333333333333,0.8666666666666667,45,1100,700,400,0.6363636363636364,15,7,8,320.713716062189,0.4843013468013468,0.09670673311834244,0.1578577901137269,124342.9709141275,-961.233852959458,123381.73706116804,404,0,39.13333333333333,37,8,20,42.661151421870436,0.5608108108108107,50.65789473684211,997.3684210526321,26.955903271692762,0
2750,4,6,4,41,0.13333333333333333,0.08888888888888889,0.9111111111111111,45,1200,700,500,0.5833333333333334,17,7,10,343.43430578951836,0.4833543771043771,0.08936078936078928,0.16782921735751904,124040.3106508873,-354.02402776187466,123686.28662312543,405,0,39.577777777777776,38,7,20,42.408703346203325,0.555921052631579,50.961538461538446,996.1538461538439,26.214574898785365,16
2751,4,3,7,37,0.06818181818181818,0.1590909090909091,0.8409090909090909,44,1150,900,250,0.782608695652174,14,9,5,355.9686002946617,0.4815671247357294,0.14591987537945328,0.17612707266753264,124561.78824253615,68.01708217912869,124629.80532471527,406,0,41.31818181818182,37,7,17,41.55499414176918,0.5630630630630631,50.43859649122807,998.2456140350876,26.9796111901375,0
2752,4,4,1,40,0.0975609756097561,0.024390243902439025,0.975609756097561,41,1750,1600,150,0.9142857142857143,19,16,3,379.2269334285718,0.48064024390243903,0.17086536841065336,0.18880372948988292,124821.49234693854,1267.1343537414705,126088.62670068,407,0,43.829268292682926,34,7,21,40.70467000238266,0.5716911764705883,50.178571428571416,999.2857142857124,29.390756302520952,0
2753,4,4,3,41,0.09090909090909091,0.06818181818181818,0.9318181818181819,44,650,400,250,0.6153846153846154,9,4,5,355.28019874225674,0.48328488372093026,0.18560168762200635,0.1803890434645617,125637.38452717736,127.55009089537717,125764.93461807274,408,0,41.75,35,9,18,40.458804741014376,0.5779761904761904,49.36342592592591,1002.546296296294,28.64417989417983,0
2754,4,1,3,39,0.023809523809523808,0.07142857142857142,0.9285714285714286,42,1600,1100,500,0.6875,21,11,10,360.4628770504713,0.4821549554781262,0.09733014544730012,0.17581760737767918,123960.50347222245,562.0573988340425,124522.5608710565,409,0,43.61904761904762,36,6,18,42.067642956764274,0.5587384259259259,51.04166666666668,995.8333333333353,27.66203703703709,16
2755,4,3,7,35,0.07142857142857142,0.16666666666666666,0.8333333333333334,42,1150,900,250,0.782608695652174,14,9,5,356.84767805958126,0.4797836817653891,0.13925080983836358,0.17706950051616607,124681.91557623885,498.4904138803162,125180.40599011916,410,0,43.88095238095238,35,7,18,41.40845308455982,0.5681547619047619,50.31828703703704,998.7268518518518,28.53505291005291,0
2756,4,8,3,40,0.18604651162790697,0.06976744186046512,0.9302325581395349,43,1100,400,700,0.36363636363636365,18,4,14,374.7952448651566,0.4796050203026947,0.2461191739037516,0.1846213613595029,124375.78124999988,1458.8644815243338,125834.64573152422,411,0,41.76744186046512,34,9,14,41.27854358117516,0.5670955882352942,50.62499999999999,997.4999999999991,29.33823529411762,16
2757,4,5,4,41,0.1111111111111111,0.08888888888888889,0.9111111111111111,45,1650,1200,450,0.7272727272727273,21,12,9,362.5580793506591,0.4786616161616162,0.25219100474043255,0.18241796557904877,125260.55230034716,84.40755208332428,125344.95985243049,412,0,40.111111111111114,35,10,14,40.66618973291708,0.5741071428571429,49.73958333333333,1001.0416666666661,28.60119047619046,0
2758,4,2,2,41,0.046511627906976744,0.046511627906976744,0.9534883720930233,43,1400,800,600,0.5714285714285714,20,8,12,403.90864850741417,0.47976651901070505,0.2784647881547109,0.1957403450459006,123687.67313019381,1426.968935153113,125114.64206534692,413,0,42.76744186046512,37,6,17,41.271219135802475,0.5540540540540541,51.315789473684205,994.7368421052624,26.884779516358446,16
2759,4,4,5,40,0.08888888888888889,0.1111111111111111,0.8888888888888888,45,1450,1000,450,0.6896551724137931,19,10,9,370.3890204226211,0.4818602693602694,0.25732972485340566,0.18370301080021273,124662.39043097153,235.9184280672083,124898.30885903873,414,0,40.62222222222222,36,9,16,41.09062546985417,0.5659722222222222,50.33783783783784,998.6486486486488,27.740240240240244,0
2760,4,6,4,42,0.13043478260869565,0.08695652173913043,0.9130434782608696,46,1000,500,500,0.5,15,5,10,343.3024546450778,0.4835547504025765,0.18015222650385798,0.16875635256985588,124288.29663935039,-159.8204336655142,124128.47620568487,415,0,40.32608695652174,37,9,14,42.15462576057473,0.5602477477477478,50.7127192982456,997.1491228070159,26.949976292081512,16
2761,4,7,5,44,0.14285714285714285,0.10204081632653061,0.8979591836734694,49,1700,1400,300,0.8235294117647058,20,14,6,312.4369465251573,0.48460530045351474,0.18243236577237543,0.15833098176921578,125557.7914206625,-1954.2214072171457,123603.57001344535,416,0,36.224489795918366,42,7,13,41.61449772793195,0.5652281746031746,49.442829457364326,1002.22868217054,23.86258767072714,0
2762,4,5,5,44,0.10204081632653061,0.10204081632653061,0.8979591836734694,49,1300,900,400,0.6923076923076923,17,9,8,315.9763270811492,0.48453443877551017,0.21452017764047038,0.16154406692529844,125922.23743314714,-1842.3107836067468,124079.92664954039,417,0,37.12244897959184,42,7,17,41.15096221921863,0.5689484126984127,49.07945736434109,1003.6821705426364,23.897194536729437,0
2763,4,2,6,40,0.043478260869565216,0.13043478260869565,0.8695652173913043,46,1200,800,400,0.6666666666666666,16,8,8,320.0986209888306,0.48365539452495976,0.2124422908497161,0.16393231087344018,125992.81724048196,-1133.9745893647826,124858.84265111719,418,0,39.869565217391305,40,6,19,40.97496372777273,0.57265625,49.00914634146342,1003.9634146341472,25.09908536585368,0
2764,4,5,3,42,0.1111111111111111,0.06666666666666667,0.9333333333333333,45,1400,1000,400,0.7142857142857143,18,10,8,319.95892759182505,0.48341750841750847,0.228327105006229,0.16612025915504228,126554.60048788728,-901.5451492167595,125653.05533867051,419,0,39.977777777777774,40,5,17,40.401642931690404,0.5783854166666667,48.45020325203251,1006.1991869918681,25.154979674796703,0
2765,4,3,3,42,0.06666666666666667,0.06666666666666667,0.9333333333333333,45,1350,1100,250,0.8148148148148148,16,11,5,327.15120461630727,0.48122895622895623,0.2548898303185172,0.17124482801299193,126887.15071220828,-697.7431588340327,126189.40755337426,420,0,40.86666666666667,40,5,21,39.87963149754556,0.5817708333333333,48.11991869918699,1007.5203252032516,25.18800813008129,0
2766,4,2,0,44,0.045454545454545456,0.0,1.0,44,1000,600,400,0.6,14,6,8,330.8883750036012,0.47890239605355883,0.26662597487322914,0.17419464137997268,127119.65610812955,-387.18622076308407,126732.46988736646,421,0,42.40909090909091,37,7,23,39.54720289224746,0.5892454954954955,47.88925438596492,1008.4429824561414,27.255215742057874,0
2767,4,0,1,43,0.0,0.022727272727272728,0.9772727272727273,44,1600,1100,500,0.6875,21,11,10,328.86783448013784,0.47888037350246654,0.2615356850666537,0.17381962488331854,127280.6076617175,-428.3004373949798,126852.30722432252,422,1,43.40909090909091,38,6,24,39.43334215634375,0.5890899122807017,47.72970085470086,1009.0811965811971,26.554768331084134,0
2768,4,0,7,36,0.0,0.16279069767441862,0.8372093023255813,43,1600,1300,300,0.8125,19,13,6,369.70839612167515,0.4782438169066076,0.12579451563328292,0.1909207567605749,126334.56173911181,761.6185865729562,127096.18032568476,423,2,45.16279069767442,35,8,16,39.377062706270614,0.5851190476190475,48.66898148148148,1005.3240740740741,28.723544973544975,14
2769,4,2,3,35,0.05263157894736842,0.07894736842105263,0.9210526315789473,38,1300,1000,300,0.7692307692307693,16,10,6,389.75167178991495,0.4737286628733997,0.16955212645841167,0.20265561486219238,126615.03170913672,2269.684056473815,128884.71576561053,424,0,49.73684210526316,32,6,18,38.58361560657383,0.5947265625,48.39015151515151,1006.4393939393931,31.451231060606034,0
2770,4,2,2,35,0.05405405405405406,0.05405405405405406,0.9459459459459459,37,1550,1100,450,0.7096774193548387,20,11,9,367.4600735325854,0.4732232232232232,0.13636900620873393,0.19449878956390587,127339.27455786239,1959.3165901306227,129298.59114799301,425,0,47.270270270270274,33,4,18,38.39950623279908,0.5997474747474747,47.67156862745098,1009.3137254901964,30.58526440879383,0
2771,4,0,2,33,0.0,0.05714285714285714,0.9428571428571428,35,1350,1200,150,0.8888888888888888,15,12,3,415.33864697387884,0.47303921568627455,0.06206835892835194,0.20185309108766403,123808.00240592548,3317.6249819780705,127125.62738790354,426,1,49.48571428571429,33,2,19,40.86101362722161,0.5634469696969697,51.194852941176464,995.2205882352931,30.15819964349373,15
2772,4,3,3,33,0.08333333333333333,0.08333333333333333,0.9166666666666666,36,1400,1300,100,0.9285714285714286,15,13,2,390.99326063862213,0.47493386243386243,0.08764299332697867,0.19438480114213938,124762.01814058937,2556.3155194675687,127318.33366005693,427,0,46.27777777777778,34,2,20,40.47257308547823,0.571078431372549,50.23809523809523,999.0476190476174,29.383753501400513,0
2773,4,7,4,36,0.175,0.1,0.9,40,1300,700,600,0.5384615384615384,19,7,12,352.56170297721576,0.4777644230769231,0.09871384542437212,0.18091304904597255,126073.7244897957,903.3092403627862,126977.03373015848,428,0,42.25,34,6,21,40.07675438596491,0.5845588235294117,48.928571428571416,1004.2857142857125,29.53781512605037,0
2774,4,3,4,35,0.07692307692307693,0.10256410256410256,0.8974358974358975,39,1000,700,300,0.7,13,7,6,375.611335291496,0.47722672064777333,0.16214444267530825,0.19537022778651406,126629.04779712128,1712.661145953478,128341.70894307476,429,0,44.256410256410255,33,6,19,38.92495129672469,0.5924873737373737,48.37622549019608,1006.4950980392156,30.499851455733804,0
2775,4,1,0,36,0.027777777777777776,0.0,1.0,36,1100,800,300,0.7272727272727273,14,8,6,381.7203304932296,0.47590939153439155,0.1408528686640762,0.19940950074292665,126805.71697084473,2480.864038108347,129286.58100895309,430,0,45.30555555555556,32,4,20,38.589068572144896,0.5966796875,48.20075757575757,1007.1969696969691,31.474905303030283,0
2776,4,4,4,36,0.1,0.1,0.9,40,1350,1000,350,0.7407407407407407,17,10,7,355.90622494714586,0.4751736111111111,0.17156125088173035,0.19233407556546517,128174.66695011329,1124.278030771522,129298.94498088481,431,0,41.675,34,6,16,37.83530253154635,0.6060049019607843,46.84523809523809,1012.6190476190468,29.78291316526608,0
2777,4,3,5,34,0.07692307692307693,0.1282051282051282,0.8717948717948718,39,1250,800,450,0.64,17,8,9,375.065927730173,0.47511808367071523,0.211429261809835,0.20491225635793012,128610.25694744806,1847.4650675221042,130457.72201497016,432,0,43.30769230769231,33,6,16,36.90434839515123,0.6126893939393939,46.41544117647059,1014.3382352941173,30.73752228163992,0
2778,4,0,0,34,0.0,0.0,1.0,34,1350,700,650,0.5185185185185185,20,7,13,424.1064787243505,0.47274212715389186,0.22952595477760296,0.22670254630318684,127736.59030306968,4034.7831035379727,131771.37340660766,433,1,50.05882352941177,30,4,18,36.56013163143197,0.6114583333333333,47.27822580645161,1010.8870967741932,33.69623655913977,0
2779,4,1,0,35,0.02857142857142857,0.0,1.0,35,1050,500,550,0.47619047619047616,16,5,11,413.33869190095595,0.4718837535014006,0.22640279041552924,0.22377301596017274,128246.61810613945,3602.5082379465816,131849.12634408602,434,0,49.6,30,5,19,36.307391188959656,0.6166666666666667,46.774193548387096,1012.9032258064517,33.763440860215056,0
2780,4,2,2,35,0.05405405405405406,0.05405405405405406,0.9459459459459459,37,1600,1200,400,0.75,20,12,8,390.41733540344626,0.47112737737737737,0.22170638672448084,0.21548333625130311,129014.56921616697,2673.904868319889,131688.47408448686,435,0,47.86486486486486,33,4,20,36.10122637716124,0.6167929292929293,46.017156862745104,1015.9313725490206,30.78579916815214,0
2781,4,1,1,35,0.027777777777777776,0.027777777777777776,0.9722222222222222,36,950,500,450,0.5263157894736842,14,5,9,392.89876776300076,0.47118055555555555,0.20399650066146013,0.21842934341614226,129300.69181654185,2960.68682584428,132261.37864238612,436,0,48.02777777777778,31,5,21,35.74566316732812,0.6246639784946236,45.73567708333333,1017.0572916666663,32.808299731182785,0
2782,4,0,2,33,0.0,0.05714285714285714,0.9428571428571428,35,900,700,200,0.7777777777777778,11,7,4,399.1392109316009,0.4700630252100841,0.1950587924428595,0.22230203734667292,129372.25627601445,3327.5080572898437,132699.76433330428,437,1,49.857142857142854,30,5,21,35.5138283348747,0.628125,45.66532258064515,1017.3387096774184,33.91129032258061,0
2783,4,1,0,34,0.029411764705882353,0.0,1.0,34,1350,1100,250,0.8148148148148148,16,11,5,407.3599124493522,0.46869429590017825,0.18951127517855682,0.22793497391250003,129554.63927469132,3755.073302469129,133309.71257716045,438,0,49.529411764705884,29,5,21,35.1182355616189,0.6329022988505747,45.48611111111111,1018.0555555555553,35.10536398467432,0
2784,4,0,0,34,0.0,0.0,1.0,34,1250,1000,250,0.8,15,10,5,441.8968563285447,0.4688985442661913,0.14265002172796604,0.2218423530253553,125168.06720791436,4262.275082379487,129430.34229029385,439,1,50.529411764705884,30,4,19,38.77714349675397,0.5850694444444444,49.83198924731184,1000.6720430107539,33.35573476702513,16
2785,4,1,1,34,0.02857142857142857,0.02857142857142857,0.9714285714285714,35,1250,900,350,0.72,16,9,7,431.62729816125847,0.47107843137254907,0.1497838870647601,0.21940342066929722,125684.52835083017,3849.7746785481904,129534.30302937835,440,0,50.05714285714286,31,4,17,38.49621802363332,0.5877016129032258,49.31640625000001,1002.7343750000007,32.34627016129034,0
2786,4,4,3,35,0.10526315789473684,0.07894736842105263,0.9210526315789473,38,850,400,450,0.47058823529411764,13,4,9,360.52317894914836,0.47095779990516834,0.097820094151575,0.18630962852654684,126363.65265185619,1709.9135201327294,128073.56617198892,441,0,45.05263157894737,35,3,16,39.57793733931928,0.5854166666666667,48.6400462962963,1005.4398148148152,28.726851851851865,16
2787,4,1,1,35,0.027777777777777776,0.027777777777777776,0.9722222222222222,36,850,500,350,0.5882352941176471,12,5,7,366.7671065897322,0.47132936507936507,0.13136435958631654,0.18079460901305636,124405.47052154207,1938.0284471363275,126343.4989686784,442,0,48.27777777777778,34,2,18,41.447891805887025,0.5674019607843137,50.5952380952381,997.6190476190486,29.341736694677902,16
2788,4,4,1,38,0.10256410256410256,0.02564102564102564,0.9743589743589743,39,1150,700,450,0.6086956521739131,16,7,9,355.5793540592518,0.4769736842105263,0.1384054689353258,0.16843978166392484,122718.83680555587,1188.2050736961837,123907.04187925205,443,0,45.30769230769231,34,5,19,43.483669750490584,0.5499387254901961,52.291666666666686,990.833333333336,29.142156862745175,16
2789,4,10,8,40,0.20833333333333334,0.16666666666666666,0.8333333333333334,48,900,700,200,0.7777777777777778,11,7,4,312.7852729298154,0.4849567819148936,0.20314615224409072,0.1566863315568607,125078.13720703138,-1735.723198784706,123342.41400824668,444,0,37.5625,39,9,19,42.09979954180986,0.5649038461538461,49.92187500000001,1000.312500000001,25.64903846153849,0
2790,4,2,0,42,0.047619047619047616,0.0,1.0,42,1250,800,450,0.64,17,8,9,345.9786599918884,0.48200977545489737,0.2478027707433339,0.17191374866954465,124739.71896701395,231.45616319445458,124971.1751302084,445,0,43.595238095238095,35,7,21,41.619960027806734,0.56875,50.26041666666667,998.9583333333339,28.541666666666686,0
2791,4,9,8,43,0.17647058823529413,0.1568627450980392,0.8431372549019608,51,1200,900,300,0.75,15,9,6,307.2059644119289,0.48565359477124187,0.2873166589470437,0.16121965900956617,126992.00050390545,-2383.625367102835,124608.37513680261,446,0,36.72549019607843,41,10,12,40.274770341207365,0.5813008130081301,48.01587301587303,1007.9365079365094,24.583817266744134,0
2792,4,3,2,44,0.06521739130434782,0.043478260869565216,0.9565217391304348,46,1200,800,400,0.6666666666666666,16,8,8,321.96366063687975,0.4838264895330113,0.26722325071445296,0.1689436214925405,126987.00086805546,-1022.9600694444542,125964.04079861101,169,0,29.73913043478261,39,7,17,39.9080198429103,0.5844017094017093,48.02083333333333,1007.9166666666658,25.844017094017072,0
2793,4,3,1,46,0.06382978723404255,0.02127659574468085,0.9787234042553191,47,1200,900,300,0.75,15,9,6,314.776022169397,0.48334875115633674,0.2789623104160388,0.1678213989672015,127631.22420374006,-1364.8633825517027,126266.36082118835,170,0,29.361702127659573,38,9,13,39.43068478184253,0.5926535087719298,47.38247863247862,1010.4700854700841,26.591318038686424,0
2794,4,2,7,41,0.041666666666666664,0.14583333333333334,0.8541666666666666,48,850,600,250,0.7058823529411765,11,6,5,311.77496655320164,0.48288822399527187,0.2915809327846368,0.1683584819387289,128144.53124999999,-1608.518472861423,126536.01277713856,171,0,29.645833333333332,38,10,16,38.9831961591221,0.5978618421052632,46.875,1012.4999999999999,26.64473684210526,0
2795,4,1,1,41,0.023809523809523808,0.023809523809523808,0.9761904761904762,42,1400,1000,400,0.7142857142857143,18,10,8,354.0060866113275,0.48113869531552456,0.3015304677520967,0.18780786526662757,127432.059259059,622.3449214244492,128054.40418048344,172,0,33.30952380952381,33,9,17,38.64382307723428,0.6006944444444444,47.5796568627451,1009.6813725490193,30.59640522875816,0
2796,4,1,1,41,0.023809523809523808,0.023809523809523808,0.9761904761904762,42,1400,800,600,0.5714285714285714,20,8,12,348.15622095573497,0.4810661053039102,0.29192180876118745,0.18618026626927575,127753.08956916095,495.60657596371306,128248.69614512466,173,0,33.666666666666664,34,8,19,38.46267074894018,0.6017156862745099,47.26190476190476,1010.9523809523805,29.733893557422956,0
2797,4,2,1,42,0.046511627906976744,0.023255813953488372,0.9767441860465116,43,1400,1100,300,0.7857142857142857,17,11,6,340.9351960682493,0.4805047988187523,0.2871303569569019,0.18424771256454828,128175.55334787091,141.10904472081427,128316.66239259172,174,0,33.651162790697676,33,10,22,38.213396062769775,0.608270202020202,46.84436274509803,1012.622549019607,30.68553178847294,0
2798,4,1,2,41,0.023255813953488372,0.046511627906976744,0.9534883720930233,43,1850,1300,550,0.7027027027027027,24,13,11,340.5728187260507,0.47983573274270946,0.2792272623724923,0.18491113841403212,128361.7647809735,143.30560962127657,128505.07039059479,175,0,34.41860465116279,33,10,24,38.032485790301116,0.6101641414141414,46.66053921568626,1013.3578431372537,30.707813428401625,0
2799,4,1,0,42,0.023809523809523808,0.0,1.0,42,1350,800,550,0.5925925925925926,19,8,11,339.7421626668719,0.4787916182733256,0.2690165481368969,0.18546874262737628,128579.18228565899,336.7538927335203,128915.93617839251,176,0,35.38095238095238,33,9,19,37.83178266473335,0.6123737373737373,46.44607843137253,1014.2156862745068,30.733808674985053,0
2800,4,0,2,40,0.0,0.047619047619047616,0.9523809523809523,42,1550,800,750,0.5161290322580645,23,8,15,339.3782492652921,0.47850125822686795,0.26620709885596994,0.18570472740696303,128672.41753472216,333.72395833332877,129006.14149305549,177,1,36.38095238095238,33,9,19,37.74597878165641,0.6133207070707071,46.354166666666664,1014.5833333333328,30.74494949494948,0
2801,4,0,0,40,0.0,0.0,1.0,40,1750,1100,650,0.6285714285714286,24,11,13,355.822219598683,0.4777777777777778,0.27007186858316246,0.1947027201624253,128672.41753472216,1156.9010416666629,129829.31857638882,178,2,37.95,31,9,20,37.32888432580425,0.6182795698924731,46.354166666666664,1014.5833333333328,32.7284946236559,0
2802,4,0,1,39,0.0,0.025,0.975,40,1800,1400,400,0.7777777777777778,22,14,8,353.1449491791952,0.4773771367521367,0.25943390178227954,0.1943667931297491,128903.7089877659,1104.3387518988761,130008.04773966478,179,3,38.95,31,9,22,37.160880668461765,0.6206317204301075,46.126302083333336,1015.4947916666672,32.75789650537636,0
2803,4,0,0,39,0.0,0.0,1.0,39,1300,1000,300,0.7692307692307693,16,10,6,372.4635224915091,0.47584907782276203,0.09614274934528888,0.18951241470281385,125724.42618580653,1565.5525280778245,127289.97871388435,180,4,37.56410256410256,35,4,17,39.93808905558762,0.5788690476190477,49.27662037037036,1002.8935185185167,28.654100529100475,16
2804,4,3,6,36,0.07142857142857142,0.14285714285714285,0.8571428571428572,42,1250,900,350,0.72,16,9,7,353.4605498593055,0.47645663956639567,0.11015181004281804,0.18332394262064017,126512.22160905265,543.8211093233854,127056.04271837603,181,0,35.80952380952381,37,5,18,39.602520435967286,0.5830518018018018,48.4923245614035,1006.0307017543848,27.190018966334726,0
2805,4,1,2,35,0.02702702702702703,0.05405405405405406,0.9459459459459459,37,1100,500,600,0.45454545454545453,17,5,12,388.636949940086,0.47419294294294295,0.11915637418993219,0.19942891701684404,126074.60359296876,2399.4498810553364,128474.0534740241,182,0,39.62162162162162,33,4,21,39.17009863738055,0.5868055555555556,48.92769607843136,1004.2892156862722,30.43300653594764,0
2806,4,3,2,36,0.07894736842105263,0.05263157894736842,0.9473684210526316,38,600,400,200,0.6666666666666666,8,4,4,375.78315921831626,0.47424727358937885,0.11809724263332333,0.19509332074405422,126552.4092970519,1911.2528344670975,128463.662131519,183,0,38.921052631578945,34,4,21,38.99964505442502,0.5894607843137255,48.45238095238094,1006.1904761904741,29.593837535013943,0
2807,4,5,2,39,0.12195121951219512,0.04878048780487805,0.9512195121951219,41,1450,1000,450,0.6896551724137931,19,10,9,352.9860273672549,0.4759654471544716,0.14405793634396447,0.1880635770510101,127603.50722343968,809.5989777698323,128413.1062012095,184,0,36.951219512195124,36,5,17,38.49383266458612,0.5960648148148149,47.40990990990991,1010.3603603603606,28.06556556556557,0
2808,4,0,1,38,0.0,0.02564102564102564,0.9743589743589743,39,1050,700,350,0.6666666666666666,14,7,7,365.9995388756074,0.473993477282951,0.14477894520357348,0.19369189079821483,127332.20663265312,1520.7057823129276,128852.91241496605,185,1,39.84615384615385,34,5,18,38.44361877801367,0.5974264705882353,47.67857142857143,1009.2857142857148,29.684873949579845,0
2809,4,2,2,38,0.05,0.05,0.95,40,1650,1300,350,0.7878787878787878,20,13,7,363.05530030530775,0.4745860042735042,0.11973684210526292,0.18215978358324947,125144.71778817307,1425.9885504806407,126570.70633865372,186,0,38.65,35,5,19,40.773689030267974,0.5729166666666667,49.855324074074076,1000.5787037037043,28.58796296296298,15
2810,4,2,5,35,0.05,0.125,0.875,40,1150,700,450,0.6086956521739131,16,7,9,359.89828300903173,0.47533386752136747,0.12621331176334705,0.18171293705718547,125405.42079260966,1026.6391246570602,126432.05991726671,187,0,39.4,35,5,18,40.582871119328274,0.575595238095238,49.594907407407405,1001.6203703703696,28.617724867724846,0
2811,4,3,0,38,0.07894736842105263,0.0,1.0,38,950,700,250,0.7368421052631579,12,7,5,371.8327715749404,0.475343764817449,0.20371087286373468,0.18983515636615217,125864.58510487527,1760.1155045351438,127624.70060941041,188,0,41.71052631578947,34,4,21,39.808992763079836,0.5824142156862745,49.13690476190476,1003.4523809523808,29.513305322128847,0
2812,4,1,3,36,0.02564102564102564,0.07692307692307693,0.9230769230769231,39,1000,700,300,0.7,13,7,6,365.714636650513,0.47565227170490326,0.20475595380538358,0.18792405751863833,126131.0191213348,1425.591965663568,127556.61108699837,189,0,41.61538461538461,35,4,22,39.68739198064292,0.5830357142857143,48.87152777777777,1004.5138888888882,28.70039682539681,0
2813,4,3,4,35,0.07692307692307693,0.10256410256410256,0.8974358974358975,39,1400,1000,400,0.7142857142857143,18,10,8,356.67917846514666,0.47688933873144396,0.20512246631315634,0.18530727550956666,126581.54776398007,1229.8004930606123,127811.34825704068,190,0,41.76923076923077,36,3,17,39.45021075798271,0.5856481481481481,48.423423423423415,1006.3063063063051,27.95295295295292,0
2814,4,1,2,34,0.027777777777777776,0.05555555555555555,0.9444444444444444,36,1300,900,400,0.6923076923076923,17,9,8,377.60006957430573,0.47321428571428575,0.21551397185311627,0.19493098620000182,126320.87305663683,2339.7540909746194,128660.62714761145,191,0,45.5,33,3,19,39.19285119265309,0.5893308080808081,48.682598039215684,1005.269607843137,30.46271538918597,0
2815,4,1,1,34,0.02857142857142857,0.02857142857142857,0.9714285714285714,35,1150,700,450,0.6086956521739131,16,7,9,373.82817020948255,0.47422969187675074,0.19118603963324432,0.1941494690442798,126567.38281250013,2462.890625000014,129030.27343750015,192,0,43.17142857142857,33,2,20,39.033385093167695,0.5918560606060606,48.43750000000001,1006.250000000001,30.492424242424274,0
2816,4,4,3,35,0.10526315789473684,0.07894736842105263,0.9210526315789473,38,1300,900,400,0.6923076923076923,17,9,8,345.5489505047051,0.47424727358937885,0.17511490162490762,0.1836333825885541,127500.81045310372,1212.6393175583178,128713.44977066205,193,0,40.55263157894737,35,3,14,38.78686301474522,0.5970238095238095,47.51157407407408,1009.953703703705,28.85582010582014,0
2817,4,2,0,37,0.05405405405405406,0.0,1.0,37,1300,1000,300,0.7692307692307693,16,10,6,356.2121373153361,0.4711586586586587,0.19771524101420979,0.18984932593180026,127617.7300347224,1691.7968750000198,129309.52690972241,194,0,42.5945945945946,35,2,17,38.39776632302405,0.5982142857142857,47.39583333333334,1010.4166666666681,28.86904761904766,0
2818,4,1,3,35,0.02631578947368421,0.07894736842105263,0.9210526315789473,38,900,600,300,0.6666666666666666,12,6,6,346.6452802197394,0.472365457562826,0.1890942804164879,0.18602691739541022,127894.85857427311,1266.8298178285886,129161.6883921017,195,0,42.44736842105263,37,1,19,38.35580397470641,0.5971283783783784,47.1217105263158,1011.5131578947389,27.338193456614565,0
2819,4,0,1,34,0.0,0.02857142857142857,0.9714285714285714,35,1050,800,250,0.7619047619047619,13,8,5,361.93762217310996,0.4700980392156863,0.16940938919737492,0.1932610322169628,127692.92091836756,2243.374433106601,129936.29535147415,196,1,43.68571428571428,34,1,21,38.17604043973302,0.6011029411764706,47.321428571428584,1010.7142857142874,29.72689075630257,0
2820,4,0,1,33,0.0,0.029411764705882353,0.9705882352941176,34,1400,1200,200,0.8571428571428571,16,12,4,372.24196221926996,0.47025401069518713,0.16050175528726762,0.19824048685630893,127586.77551903119,2698.6303344867415,130285.40585351794,197,2,45.088235294117645,33,1,21,38.0246239689471,0.6022727272727273,47.4264705882353,1010.2941176470592,30.6149732620321,0
2821,4,0,0,33,0.0,0.0,1.0,33,1300,1100,200,0.8461538461538461,15,11,4,393.77797741580224,0.4700915404040404,0.15487942635430452,0.1913078835161812,123793.24921956299,3424.4555131381076,127217.7047327011,198,3,44.54545454545455,30,3,19,41.41286241671169,0.5708333333333333,51.20967741935484,995.161290322581,33.172043010752695,16
2822,4,4,2,35,0.10810810810810811,0.05405405405405406,0.9459459459459459,37,950,700,250,0.7368421052631579,12,7,5,361.1634587239123,0.4754441941941942,0.15631778480075642,0.18032406220947803,124940.48327664415,1624.7874149660006,126565.27069161016,199,0,40.62162162162162,34,3,18,41.032587123918375,0.5729166666666667,50.05952380952382,999.7619047619062,29.404761904761948,0
2823,4,4,4,35,0.10256410256410256,0.10256410256410256,0.8974358974358975,39,550,200,350,0.36363636363636365,9,2,7,357.6364468056077,0.47823886639676116,0.14629185734001604,0.1723725637935276,123456.3718067731,1053.7174584954623,124510.08926526856,200,0,39.282051282051285,36,3,14,42.66288951841359,0.5535300925925926,51.54842342342343,993.8063063063072,27.605730730730755,16
2824,4,3,2,36,0.07894736842105263,0.05263157894736842,0.9473684210526316,38,1450,900,550,0.6206896551724138,20,9,11,360.77634255374267,0.4781442626837364,0.09595850766458947,0.17027946216183895,122562.67405496712,1243.5426558315044,123806.21671079863,201,0,40.60526315789474,36,2,18,43.51828158762651,0.5442708333333333,52.44932432432432,990.2027027027026,27.505630630630627,16
2825,4,6,7,35,0.14285714285714285,0.16666666666666666,0.8333333333333334,42,1250,1100,150,0.88,14,11,3,336.11201115511545,0.4821791521486643,0.13562364355930057,0.1643547196655188,124066.91875091281,-51.461886215906645,124015.4568646969,202,0,36.904761904761905,38,4,16,42.56344950848973,0.5561951754385965,50.93482905982904,996.260683760681,26.217386414754763,0
2826,4,7,2,40,0.16666666666666666,0.047619047619047616,0.9523809523809523,42,1150,800,350,0.6956521739130435,15,8,7,335.0580695499832,0.4805216802168022,0.2116268885482817,0.16908400040163218,125384.06649161263,5.684275685680689,125389.7507672983,203,0,37.0,37,5,14,41.22691774323044,0.571509009009009,49.61622807017543,1001.5350877192967,27.068515884305317,0
2827,4,2,3,39,0.047619047619047616,0.07142857142857142,0.9285714285714286,42,1350,900,450,0.6666666666666666,18,9,9,378.449370478232,0.4791061749903213,0.2722853670741294,0.18517412534522504,124093.52970450718,1085.7292103634038,125179.25891487059,204,0,37.92857142857143,38,4,15,41.48125312745727,0.5564692982456141,50.90811965811965,996.3675213675207,26.22019793072423,16
2828,4,8,6,41,0.1702127659574468,0.1276595744680851,0.8723404255319149,47,1100,700,400,0.6363636363636364,15,7,8,348.53297669571333,0.48271276595744683,0.2932290756407683,0.17652201762693523,125534.10590794176,-639.5487024524629,124894.5572054893,205,0,34.59574468085106,40,7,18,40.73454348781394,0.56796875,49.46646341463415,1002.1341463414639,25.053353658536597,0
2829,4,2,2,41,0.046511627906976744,0.046511627906976744,0.9534883720930233,43,800,300,500,0.375,13,3,10,380.3052177532927,0.4797203765227021,0.3277526355717162,0.1914446990841885,125281.69005153788,929.0560831101177,126210.746134648,206,0,38.674418604651166,36,7,19,40.20013123359579,0.572337962962963,49.71846846846846,1001.126126126125,27.809059059059027,0
2830,4,4,3,42,0.08888888888888889,0.06666666666666667,0.9333333333333333,45,1700,1400,300,0.8235294117647058,20,14,6,374.60740082945443,0.4823653198653199,0.24472796597741664,0.18390553392772144,124233.63438750395,338.36213595306754,124571.99652345701,207,0,37.75555555555555,37,8,17,41.43111159994135,0.5596846846846847,50.76754385964913,996.9298245614043,26.944049312470387,15
2831,4,4,2,44,0.08695652173913043,0.043478260869565216,0.9565217391304348,46,1550,1000,550,0.6451612903225806,21,10,11,354.10398492642554,0.4842693236714976,0.2636322066836867,0.17798795013262197,125219.39442905525,-329.50619421358874,124889.88823484165,208,0,36.76086956521739,37,9,21,40.9203366929594,0.5698198198198199,49.78070175438597,1000.8771929824574,27.05073494547182,0
2832,4,3,3,44,0.06382978723404255,0.06382978723404255,0.9361702127659575,47,1500,1200,300,0.8,18,12,6,341.4622527101018,0.48452436016034534,0.2775152994894887,0.1745210229574916,125909.76902074656,-801.3133263934571,125108.4556943531,209,0,36.723404255319146,38,9,19,40.52431516570861,0.575109649122807,49.09188034188034,1003.6324786324784,26.411381016644167,0
2833,4,3,5,42,0.06382978723404255,0.10638297872340426,0.8936170212765957,47,1100,800,300,0.7272727272727273,14,8,6,329.9592325663819,0.4865672217082948,0.2620634633492436,0.1710195479979651,126484.64551592778,-1052.9020083988025,125431.74350752898,210,0,35.91489361702128,37,10,15,40.221913378388216,0.5827702702702703,48.51973684210525,1005.9210526315774,27.187055476529117,0
2834,4,1,0,43,0.023255813953488372,0.0,1.0,43,800,500,300,0.625,11,5,6,353.70693796152295,0.48528054632705797,0.27647323114410205,0.18163271062576783,126103.61571711999,320.7447562358028,126424.36047335579,211,0,39.74418604651163,34,9,22,40.01718620362688,0.5848651960784313,48.89880952380951,1004.4047619047603,29.541316526610597,0
2835,4,1,1,43,0.022727272727272728,0.022727272727272728,0.9772727272727273,44,1350,1000,350,0.7407407407407407,17,10,7,343.6752225626436,0.48485949612403095,0.27654478517340997,0.17823538392091254,126509.15745027413,-104.38743141291658,126404.7700188612,212,0,39.81818181818182,35,9,18,39.85177941402057,0.5869047619047619,48.49537037037036,1006.0185185185167,28.74338624338619,0
2836,4,2,3,42,0.044444444444444446,0.06666666666666667,0.9333333333333333,45,1350,1000,350,0.7407407407407407,17,10,7,333.87463949412836,0.485290404040404,0.26653756873844014,0.17527929021184413,127006.86486740116,-519.1257558233963,126487.73911157777,213,0,38.577777777777776,36,9,21,39.58752280936953,0.5899884259259259,48.001126126126124,1007.9954954954952,27.999874874874866,0
2837,4,2,4,40,0.045454545454545456,0.09090909090909091,0.9090909090909091,44,1200,800,400,0.6666666666666666,16,8,8,343.7375936670523,0.484375,0.26297956032261083,0.18096590052090786,127121.19187510703,-60.733480152623315,127060.4583949544,214,0,39.79545454545455,35,9,23,39.22168503003175,0.5931547619047619,47.887731481481474,1008.449074074073,28.812830687830658,0
2838,4,1,1,40,0.024390243902439025,0.024390243902439025,0.975609756097561,41,1650,1100,550,0.6666666666666666,22,11,11,358.87910091861636,0.48313008130081303,0.25336730979250044,0.1885305771412032,127033.66796339175,917.9457090192191,127951.61367241097,215,0,42.146341463414636,35,6,24,38.929869881362414,0.5922619047619048,47.974537037037045,1008.1018518518528,28.80291005291008,0
2839,4,1,4,37,0.024390243902439025,0.0975609756097561,0.9024390243902439,41,1150,900,250,0.782608695652174,14,9,5,399.18323324139857,0.48246951219512196,0.23197272179287665,0.19569362483136193,124174.16265679066,1835.2301083302523,126009.39276512092,216,0,42.78048780487805,33,8,16,40.880645723185374,0.5672348484848485,50.82720588235294,996.6911764705883,30.20276292335116,16
2840,4,5,5,37,0.11904761904761904,0.11904761904761904,0.8809523809523809,42,900,400,500,0.4444444444444444,14,4,10,376.88995793216486,0.48451413085559425,0.22399038355499679,0.18792272960174233,124884.2860510975,1013.5266632373259,125897.81271433482,217,0,40.642857142857146,35,7,14,40.697853944727505,0.5702380952380952,50.11574074074075,999.537037037038,28.558201058201085,0
2841,4,6,2,41,0.13953488372093023,0.046511627906976744,0.9534883720930233,43,1400,1200,200,0.8571428571428571,16,12,4,401.3422420430604,0.4829272794389074,0.24464835111358618,0.1954895790517784,123902.88092635461,1549.6993955761338,125452.58032193074,218,0,40.395348837209305,35,8,18,41.110110051925915,0.5601190476190476,51.09953703703704,995.601851851852,28.4457671957672,16
2842,4,8,10,39,0.16326530612244897,0.20408163265306123,0.7959183673469388,49,1350,800,550,0.5925925925925926,19,8,11,341.8593635924175,0.48446357709750565,0.21291765036976762,0.17285938047282345,125466.44310028091,-1211.9256765020718,124254.51742377885,219,0,31.632653061224488,37,12,12,40.97157619203969,0.5723536036036037,49.53399122807018,1001.8640350877198,27.077406353722157,0
2843,4,3,2,40,0.07142857142857142,0.047619047619047616,0.9523809523809523,42,1250,800,450,0.64,17,8,9,375.8421926488772,0.4817678087495161,0.2064455847531399,0.17490859447306148,121956.88139284251,832.5507726241785,122789.43216546669,220,0,37.57142857142857,32,10,23,43.78089181473434,0.5465494791666667,53.061868686868685,987.7525252525247,30.867266414141397,16
2844,4,6,1,45,0.13043478260869565,0.021739130434782608,0.9782608695652174,46,1200,800,400,0.6666666666666666,16,8,8,378.5199532921173,0.48862721417069244,0.2618643065308799,0.17940869532942905,122743.12313773546,678.5719716166568,123421.69510935212,221,0,31.434782608695652,33,13,22,42.8899744414214,0.5523989898989898,52.2671568627451,990.9313725490193,30.028223410576345,16
2845,4,6,8,43,0.11764705882352941,0.1568627450980392,0.8431372549019608,51,1250,900,350,0.72,16,9,7,330.11067363106616,0.49049019607843136,0.26888349037394943,0.1624951365265024,124346.09552154188,-1983.9925308358647,122362.10299070601,222,0,29.15686274509804,34,17,13,42.423609453330165,0.5667892156862745,50.654761904761905,997.3809523809518,29.334733893557406,0
2846,4,4,3,44,0.0851063829787234,0.06382978723404255,0.9361702127659575,47,1250,800,450,0.64,17,8,9,367.2871579967257,0.48884135060129513,0.299118500014357,0.179288395306702,123993.9678720083,-291.72158631055663,123702.24628569775,223,0,32.234042553191486,30,17,21,41.86291048133155,0.5729166666666667,51.00806451612903,995.9677419354837,33.19892473118279,0
2847,4,4,2,46,0.08333333333333333,0.041666666666666664,0.9583333333333334,48,1500,900,600,0.6,21,9,12,343.65368936932146,0.4904052157210402,0.292995893872394,0.1711780334397848,124842.22153670547,-1019.5019959697983,123822.71954073568,224,0,32.270833333333336,32,16,18,41.571909875763296,0.5764973958333333,50.157828282828284,999.3686868686872,31.230271464646474,0
2848,4,7,8,45,0.1320754716981132,0.1509433962264151,0.8490566037735849,53,1050,700,350,0.6666666666666666,14,7,7,328.4722222222223,0.49076257861635225,0.17468553459119507,0.16423611111111114,125000.0,-2001.9734912253853,122998.02650877461,225,0,30.09433962264151,44,9,16,41.78819444444445,0.5568181818181819,50.0,1000.0,22.727272727272727,15
2849,4,3,4,44,0.0625,0.08333333333333333,0.9166666666666666,48,1500,1200,300,0.8,18,12,6,340.3208891459808,0.4854000443262411,0.20486007924715222,0.17169112323481642,125372.30061295354,-1066.6374362244917,124305.66317672904,226,0,33.0,41,7,15,41.10729321446258,0.5647865853658536,49.62797619047619,1001.4880952380954,24.42653890824623,0
2850,4,2,4,42,0.043478260869565216,0.08695652173913043,0.9130434782608696,46,1200,600,600,0.5,18,6,12,339.6378833221525,0.4849235104669887,0.20444359503177512,0.1729263025217712,125752.09690110301,-657.9647970374094,125094.1321040656,227,0,33.32608695652174,42,4,18,40.73257817280133,0.5672123015873016,49.24903100775195,1003.0038759689949,23.88104466592845,0
2851,4,4,3,43,0.08695652173913043,0.06521739130434782,0.9347826086956522,46,1300,1000,300,0.7692307692307693,16,10,6,346.020219004071,0.4851751207729469,0.22946960036408415,0.17844730588830984,126279.29823133668,-459.9478524075603,125819.35037892911,228,0,33.869565217391305,39,7,14,40.02929923653576,0.577190170940171,48.72395833333333,1005.1041666666656,25.771901709401682,0
2852,4,2,3,42,0.044444444444444446,0.06666666666666667,0.9333333333333333,45,1100,900,200,0.8181818181818182,13,9,4,346.9651179037759,0.48339646464646463,0.22044996835260977,0.17962188811586868,126436.39458550327,-226.19628906252228,126210.19829644074,229,0,35.022222222222226,39,6,16,39.84388486103917,0.5787927350427351,48.56770833333332,1005.7291666666649,25.787927350427307,0
2853,4,2,2,42,0.045454545454545456,0.045454545454545456,0.9545454545454546,44,950,700,250,0.7368421052631579,12,7,5,349.0811185851217,0.48189746300211417,0.22952195514972562,0.18263363004801164,126867.03913336142,57.37758645122676,126924.41671981265,230,0,34.90909090909091,41,3,18,39.34791974396852,0.5800304878048781,48.13988095238094,1007.4404761904741,24.57171893147498,0
2854,4,0,2,40,0.0,0.047619047619047616,0.9523809523809523,42,1150,700,450,0.6086956521739131,16,7,9,360.2461635090521,0.4814653503677894,0.23085464151538027,0.18842296632212213,126855.79562716997,739.8627387152587,127595.65836588522,231,1,35.61904761904762,39,3,18,39.078279564333236,0.5830662393162394,48.15104166666666,1007.3958333333319,25.830662393162356,0
2855,4,0,1,39,0.0,0.025,0.975,40,1400,1200,200,0.8571428571428571,16,12,4,375.75800252009844,0.48133012820512816,0.23586741628567953,0.1789881997878256,122955.73104394946,1376.4039634695825,124332.13500741904,232,2,36.75,33,7,19,42.73587771325015,0.5546085858585859,52.052696078431374,991.7892156862747,30.05421865715984,16
2856,4,7,4,42,0.15217391304347827,0.08695652173913043,0.9130434782608696,46,1250,900,350,0.72,16,9,7,333.6815804167639,0.48501409017713365,0.11991799568678618,0.16265731964793306,123935.20411957175,-804.9326525373654,123130.27146703438,233,0,32.67391304347826,40,6,19,42.760639926515616,0.5515625,51.06707317073171,995.7317073170736,24.89329268292684,16
2857,4,6,5,43,0.125,0.10416666666666667,0.8958333333333334,48,1300,1000,300,0.7692307692307693,16,10,6,328.25055583760826,0.4869422281323877,0.08690725244072572,0.1601058833575272,123960.50347222212,-662.4024018441446,123298.10107037798,234,0,30.479166666666668,40,8,17,42.869595536959594,0.5518229166666666,51.041666666666664,995.8333333333325,24.89583333333331,16
2858,4,4,11,36,0.0851063829787234,0.23404255319148937,0.7659574468085106,47,1450,1000,450,0.6896551724137931,19,10,9,316.93849784927085,0.4851796176379895,0.12554058153139547,0.15655613927966985,124492.38631105806,-1508.7140177804379,122983.67229327762,235,0,30.97872340425532,40,7,15,42.60077223353701,0.5572916666666667,50.508130081300806,997.9674796747953,24.949186991869883,0
2859,4,5,2,39,0.12195121951219512,0.04878048780487805,0.9512195121951219,41,850,500,350,0.5882352941176471,12,5,7,328.3232437117057,0.4846798780487805,0.11299007837166775,0.15896705532248284,123649.50086805537,-70.99147849330973,123578.50938956207,236,0,34.78048780487805,39,2,19,43.19054601312667,0.5502136752136753,51.35416666666666,994.5833333333318,25.502136752136714,16
2860,4,4,4,39,0.09302325581395349,0.09302325581395349,0.9069767441860466,43,900,600,300,0.6666666666666666,12,6,6,312.84104518021104,0.48629568106312293,0.14114383466642,0.15457666574228482,124504.46034895415,-809.9788989670215,123694.48144998713,237,0,33.627906976744185,41,2,17,42.690523525513576,0.5558943089430894,50.49603174603173,998.0158730158711,24.34185056136271,0
2861,4,3,4,38,0.07142857142857142,0.09523809523809523,0.9047619047619048,42,1550,1200,350,0.7741935483870968,19,12,7,313.5090892257251,0.4874661246612466,0.08359351269525939,0.15319813082604009,124038.31515841995,-593.991280322912,123444.32387809704,238,0,34.642857142857146,39,3,20,43.15602234305829,0.5542200854700854,50.96354166666666,996.1458333333318,25.542200854700816,15
2862,4,6,6,38,0.13636363636363635,0.13636363636363635,0.8636363636363636,44,1150,600,550,0.5217391304347826,17,6,11,330.0602107678893,0.48730399929527835,0.18636656450699873,0.16028054239270711,123774.38659690267,-178.54005689729433,123595.84654000537,239,0,33.0,38,6,16,43.01767947892064,0.5531798245614035,51.228632478632484,995.0854700854704,26.186459739091326,16
2863,4,5,4,39,0.11627906976744186,0.09302325581395349,0.9069767441860466,43,1400,1100,300,0.7857142857142857,17,11,6,346.7645266822455,0.48558047249907715,0.26218084762695204,0.17316021561859427,124946.5869037184,65.4088136460021,125011.9957173644,240,0,34.093023255813954,38,5,15,41.386158010970995,0.5652412280701755,50.05341880341881,999.7863247863256,26.310166441745412,0
2864,4,6,3,42,0.13333333333333333,0.06666666666666667,0.9333333333333333,45,1450,900,550,0.6206896551724138,20,9,11,334.5866292789804,0.48341750841750847,0.2777635752497276,0.17034160930971104,125748.98184673846,-585.1915771787324,125163.79026955973,241,0,31.77777777777778,38,7,17,40.862448515835815,0.5734649122807017,49.252136752136764,1002.9914529914547,26.394511920827757,0
2865,4,1,4,39,0.023255813953488372,0.09302325581395349,0.9069767441860466,43,1300,900,400,0.6923076923076923,17,9,8,346.51472822563187,0.4821659283868586,0.27577438860043024,0.1762638322776212,125713.73523584177,112.33215989534875,125826.06739573712,242,0,33.97674418604651,37,6,18,40.5997157227203,0.5748873873873874,49.28728070175438,1002.8508771929822,27.104077761972494,0
2866,4,2,2,39,0.04878048780487805,0.04878048780487805,0.9512195121951219,41,1450,1000,450,0.6896551724137931,19,10,9,347.47687691268567,0.48053861788617885,0.25133838618026694,0.17855250531232664,126131.01912133479,566.3881721886526,126697.40729352344,243,0,34.65853658536585,35,6,20,40.14539405461457,0.5830357142857143,48.87152777777777,1004.5138888888881,28.700396825396805,0
2867,4,0,0,39,0.0,0.0,1.0,39,1200,900,300,0.75,15,9,6,361.62315735945225,0.47995389113810166,0.23753734314360142,0.18569778324051706,126103.61571711999,1320.3975340135803,127424.01325113357,244,1,36.743589743589745,34,5,20,39.81840899213779,0.5848651960784313,48.89880952380951,1004.4047619047603,29.541316526610597,0
2868,4,1,1,39,0.025,0.025,0.975,40,1450,1000,450,0.6896551724137931,19,10,9,356.0589315758794,0.4798744658119658,0.23573852525020178,0.18478927117546945,126538.26845689703,1011.0161340448906,127549.28459094193,245,0,36.8,35,5,16,39.510357950841666,0.587202380952381,48.46643518518517,1006.1342592592571,28.74669312169306,0
2869,4,3,4,38,0.07142857142857142,0.09523809523809523,0.9047619047619048,42,750,400,350,0.5333333333333333,11,4,7,334.7978770123938,0.480316008517228,0.21399869245610947,0.1767503936449046,127233.99233270409,121.95206675171846,127355.94439945581,246,0,35.07142857142857,36,6,19,39.33149160992671,0.5923032407407407,47.775900900900886,1008.8963963963945,28.024899899899847,0
2870,4,2,5,35,0.05,0.125,0.875,40,1050,800,250,0.7619047619047619,13,8,5,401.142081471553,0.480715811965812,0.25239516800888673,0.20090579073422268,125069.45408950609,2796.573755624979,127866.02784513107,247,0,36.175,29,11,20,39.899217809867636,0.5869252873563218,49.93055555555555,1000.277777777777,34.492337164750936,16
2871,4,2,1,36,0.05405405405405406,0.02702702702702703,0.972972972972973,37,950,500,450,0.5263157894736842,14,5,9,389.5194693933119,0.47897897897897895,0.2480557790292306,0.19762151039015752,125605.5703694067,2385.1630246271006,127990.7333940338,248,0,38.810810810810814,30,7,20,39.633614910163566,0.5895833333333333,49.39516129032257,1002.4193548387083,33.413978494623606,0
2872,4,3,2,37,0.07692307692307693,0.05128205128205128,0.9487179487179487,39,1400,900,500,0.6428571428571429,19,9,10,409.14026108799095,0.48107849752586596,0.17861751325691566,0.20562760075726888,125214.55277116956,2556.2364652795295,127770.78923644908,249,0,37.743589743589745,33,6,19,39.548258234357775,0.5779671717171717,49.78553921568626,1000.8578431372534,30.32902554961374,15
2873,4,4,3,38,0.0975609756097561,0.07317073170731707,0.926829268292683,41,1250,1100,150,0.88,14,11,3,386.8896404111558,0.4817581300813008,0.21221187111231798,0.19997979821986678,126372.79620181414,1583.9392926288288,127956.73549444297,250,0,36.53658536585366,34,7,16,38.90574433656958,0.5876225490196079,48.63095238095239,1005.4761904761912,29.572829131652682,0
2874,4,2,1,39,0.05,0.025,0.975,40,1450,900,550,0.6206896551724138,20,9,11,380.1182083473999,0.47983440170940167,0.21611030037699175,0.19921682774000413,126937.59799416068,1650.2584642925526,128587.85645845323,251,0,33.225,33,7,18,38.493529328306785,0.5956439393939394,48.06985294117646,1007.7205882352923,30.536987522281585,0
2875,4,2,4,37,0.04878048780487805,0.0975609756097561,0.9024390243902439,41,1750,1200,550,0.6857142857142857,23,12,11,366.76096027929015,0.4791666666666667,0.20856539274054153,0.19523981657981385,127569.89282024799,1157.7190069736414,128727.61182722163,252,0,32.65853658536585,32,9,19,38.18038370203723,0.6044921875,47.44318181818182,1010.2272727272731,31.569602272727284,0
2876,4,2,3,36,0.05128205128205128,0.07692307692307693,0.9230769230769231,39,1200,900,300,0.75,15,9,6,376.11201770561024,0.47795771479982,0.2006013130714004,0.201217254422589,127770.56054168122,1811.2086657417153,129581.76920742293,253,0,34.333333333333336,30,9,21,37.73819019764246,0.6118055555555555,47.24462365591398,1011.0215053763449,33.70071684587816,0
2877,4,1,1,36,0.02702702702702703,0.02702702702702703,0.972972972972973,37,1350,1000,350,0.7407407407407407,17,10,7,420.5421299686586,0.47841591591591587,0.10561818099506515,0.20411678991161786,123753.12500000038,3008.6805555555998,126761.80555555598,254,0,36.62162162162162,34,3,18,40.78901451702959,0.5606617647058824,51.25000000000002,995.0000000000032,29.264705882353034,16
2878,4,5,2,39,0.12195121951219512,0.04878048780487805,0.9512195121951219,41,950,500,450,0.5263157894736842,14,5,9,384.8393156728201,0.4822154471544715,0.13315205894050375,0.1933588357131245,125202.62834630045,1443.175984867954,126645.8043311684,255,0,33.5609756097561,35,6,21,40.168676034077315,0.5735119047619048,49.797453703703695,1000.8101851851841,28.59457671957669,0
2879,4,1,5,35,0.025,0.125,0.875,40,1250,700,550,0.56,18,7,11,390.05767719634343,0.4814503205128205,0.07998860774673267,0.1868288897266113,123191.11571712005,1784.9137537923953,124976.02947091244,256,0,34.35,34,6,16,42.13484830315386,0.5548406862745099,51.81547619047618,992.738095238094,29.19817927170865,16
2880,4,9,12,32,0.20454545454545456,0.2727272727272727,0.7272727272727273,44,1600,1100,500,0.6875,21,11,10,331.3748393050013,0.4856082628611698,0.10379994751319477,0.16494672017135018,124813.10410046359,-523.2252876770083,124289.87881278658,257,0,31.386363636363637,38,6,15,41.90879040593038,0.5638706140350878,50.1869658119658,999.2521367521344,26.296108861898276,0
2881,4,4,1,35,0.1111111111111111,0.027777777777777776,0.9722222222222222,36,900,400,500,0.4444444444444444,14,4,10,386.3286324252809,0.4806382275132275,0.10650158646605545,0.1815529547185969,122377.18582153332,2441.9173159917473,124819.10313752506,258,0,38.80555555555556,31,5,16,43.08036693424572,0.5534274193548387,52.63671875000001,989.4531250000009,31.917842741935512,15
2882,4,6,7,34,0.14634146341463414,0.17073170731707318,0.8292682926829268,41,1100,500,600,0.45454545454545453,17,5,12,338.89271765773304,0.4851371951219512,0.1075898860426392,0.16420402496274036,123680.30350874526,182.870835362392,123863.17434410765,259,0,34.73170731707317,36,5,14,42.895722480093596,0.5558449074074074,51.3231981981982,994.7072072072075,27.630755755755764,0
2883,4,11,7,38,0.24444444444444444,0.15555555555555556,0.8444444444444444,45,1000,700,300,0.7,13,7,6,323.13497303154776,0.4808080808080808,0.16245428687525432,0.16196235613658602,125101.64667195424,-915.0565552911913,124186.59011666305,260,0,32.08888888888889,40,5,17,41.81671576594881,0.5635416666666666,49.89837398373982,1000.4065040650382,25.010162601625957,0
2884,4,2,3,37,0.05,0.075,0.925,40,850,600,250,0.7058823529411765,11,6,5,359.8041658907925,0.4820379273504274,0.17613122171945705,0.17731001176745217,124393.0995611496,951.4310860339434,125344.53064718355,261,0,36.95,35,5,18,41.63439784197703,0.5651785714285714,50.607638888888886,997.5694444444438,28.50198412698411,0
2885,4,10,14,33,0.2127659574468085,0.2978723404255319,0.7021276595744681,47,1150,800,350,0.6956521739130435,15,8,7,316.4732744818951,0.481922602528523,0.20019870198572942,0.16359386508484197,126375.71571980987,-1379.3310157070268,124996.38470410285,262,0,31.851063829787233,40,7,14,40.67279832895358,0.5765625,48.628048780487816,1005.4878048780506,25.137195121951265,0
2886,4,2,0,35,0.05714285714285714,0.0,1.0,35,1350,1200,150,0.8888888888888888,15,12,3,405.46351431291475,0.4760854341736695,0.2313309504592802,0.2017547366400405,124798.46839229959,3120.2451150421903,127918.71350734177,263,0,42.2,30,5,20,40.07319971303021,0.58125,50.2016129032258,999.1935483870959,33.306451612903196,0
2887,4,2,1,36,0.05405405405405406,0.02702702702702703,0.972972972972973,37,1350,900,450,0.6666666666666666,18,9,9,387.48701404631004,0.4762887887887888,0.22889757910536201,0.1968672027218007,125663.75760445348,2338.614841597779,128002.37244605126,264,0,40.86486486486486,32,5,20,39.624260168744506,0.5849609375,49.337121212121204,1002.6515151515139,31.33285984848481,0
2888,4,0,0,36,0.0,0.0,1.0,36,1350,700,650,0.5185185185185185,20,7,13,406.60513921650204,0.4750992063492063,0.1761533548181058,0.19924172442785568,124155.07846408413,2920.666756117634,127075.74522020176,265,1,43.0,31,5,21,40.71563888163054,0.5719086021505376,50.846354166666664,996.6145833333327,32.1488575268817,14
2889,4,4,3,37,0.1,0.075,0.925,40,1050,500,550,0.47619047619047616,16,5,11,375.3264769972542,0.47692307692307695,0.19686888454011786,0.1898929007382148,125490.67666282205,1425.7252365751865,126916.40189939724,266,0,39.6,33,7,16,40.108243639921724,0.5808080808080809,49.50980392156863,1001.960784313726,30.36244800950685,0
2890,4,1,1,37,0.02631578947368421,0.02631578947368421,0.9736842105263158,38,1150,800,350,0.6956521739130435,15,8,7,378.97182017889634,0.47686996206733046,0.18385038843442936,0.19287968758358748,125736.37543252594,1930.108612072282,127666.48404459821,267,0,40.23684210526316,33,5,18,39.76254480286738,0.5833333333333333,49.26470588235294,1002.9411764705881,30.392156862745093,0
2891,4,4,1,40,0.0975609756097561,0.024390243902439025,0.975609756097561,41,1500,1000,500,0.6666666666666666,20,10,10,351.93966704012206,0.47754065040650406,0.18353104786364582,0.18343458140095995,126713.00482520997,719.4420021227206,127432.4468273327,268,0,37.8780487804878,35,6,19,39.43425010537609,0.5889880952380953,48.29282407407407,1006.828703703703,28.76653439153437,0
2892,4,3,4,39,0.06976744186046512,0.09302325581395349,0.9069767441860466,43,750,500,250,0.6666666666666666,10,5,5,358.7491742884717,0.4782668881506091,0.14591344686565333,0.18224458053854392,125658.7603878118,599.6600546191526,126258.42044243094,269,0,36.906976744186046,37,6,15,40.34977398658501,0.5743243243243243,49.342105263157904,1002.6315789473698,27.098150782361348,16
2893,4,1,2,38,0.025,0.05,0.95,40,1300,1000,300,0.7692307692307693,16,10,6,370.19657327239634,0.47717681623931624,0.1936275673750445,0.18818139629893746,125685.4609552154,1305.6653911564617,126991.12634637186,270,0,40.475,34,6,16,40.03522102180536,0.5805759803921569,49.31547619047619,1002.7380952380952,29.492296918767504,0
2894,4,3,1,40,0.07317073170731707,0.024390243902439025,0.975609756097561,41,900,800,100,0.8888888888888888,10,8,2,365.02712058418126,0.476905487804878,0.21972743647547888,0.17902127348923516,124191.12761488341,998.3507163153289,125189.47833119874,271,0,39.53658536585366,35,6,14,41.71408112710946,0.5630952380952381,50.81018518518518,996.7592592592594,28.47883597883598,16
2895,4,2,4,38,0.047619047619047616,0.09523809523809523,0.9047619047619048,42,1200,800,400,0.6666666666666666,16,8,8,354.7836785638476,0.47723093302361597,0.23466473398829613,0.1761999568231429,124718.62698847515,449.62665368072817,125168.25364215588,272,0,39.523809523809526,36,6,17,41.42192784667418,0.5665509259259259,50.28153153153154,998.8738738738754,27.746496496496537,0
2896,4,2,2,38,0.05,0.05,0.95,40,1350,900,450,0.6666666666666666,18,9,9,362.2846266438172,0.47717681623931624,0.2460986787287227,0.18127177775072714,125029.76367630388,1059.5892905798783,126089.35296688376,273,0,40.9,34,6,20,40.91204420108716,0.5738357843137255,49.970238095238095,1000.1190476190478,29.415266106442584,0
2897,4,2,4,36,0.05,0.1,0.9,40,1050,600,450,0.5714285714285714,15,6,9,350.7275868832543,0.47570779914529915,0.22239530706186117,0.17861238515546884,125761.29074598257,821.5908053323705,126582.88155131493,274,0,36.6,36,4,18,40.44501515661838,0.5772569444444444,49.23986486486487,1003.0405405405413,27.86223723723726,0
2898,4,4,4,36,0.1,0.1,0.9,40,1150,900,250,0.782608695652174,14,9,5,342.93876716118143,0.47552083333333334,0.22089892294946178,0.17765111243070666,126462.58680555574,674.4188022482198,127137.00560780396,275,0,36.375,34,6,18,39.91818558409279,0.5885416666666667,48.54166666666668,1005.8333333333348,29.58333333333338,0
2899,4,2,3,35,0.05263157894736842,0.07894736842105263,0.9210526315789473,38,1550,1100,450,0.7096774193548387,20,11,9,353.32216905529134,0.4763809862494073,0.21181468610013598,0.1830015863910569,126456.23692735448,1335.9583843485534,127792.19531170304,276,0,37.8421052631579,32,6,20,39.663622478868525,0.5930989583333333,48.54797979797981,1005.8080808080817,31.431502525252554,0
2900,4,1,1,35,0.027777777777777776,0.027777777777777776,0.9722222222222222,36,1150,600,550,0.5217391304347826,17,6,11,359.61477512785933,0.47301587301587306,0.19963547733057307,0.18661809049113284,126534.62939792199,1900.7444593641403,128435.37385728613,277,0,38.138888888888886,31,5,21,39.424663517535926,0.5964381720430108,48.47005208333333,1006.1197916666658,32.45547715053761,0
2901,4,0,2,33,0.0,0.05714285714285714,0.9428571428571428,35,1200,900,300,0.75,15,9,6,370.2761706059437,0.47216386554621853,0.2015656623515485,0.19159103101477654,126415.27380332972,2361.71269799975,128776.98650132948,278,1,39.628571428571426,30,5,22,39.279548694644916,0.5979166666666667,48.588709677419345,1005.6451612903213,33.521505376344045,0
2902,4,3,0,36,0.08333333333333333,0.0,1.0,36,1250,1000,250,0.8,15,10,5,355.9517774448766,0.47299933862433857,0.163418191461151,0.17546328794047447,124405.47052154197,1714.1398137038364,126119.6103352458,279,0,34.69444444444444,34,2,14,41.71763126491646,0.5674019607843137,50.595238095238095,997.6190476190478,29.341736694677877,16
2903,4,7,3,40,0.16279069767441862,0.06976744186046512,0.9302325581395349,43,1550,1200,350,0.7741935483870968,19,12,7,309.98296667816516,0.4761212624584718,0.19288576565566307,0.16033881104445616,126401.26294079264,-762.1350707891597,125639.12787000349,280,0,29.88372093023256,40,3,14,40.80975240020212,0.5768229166666667,48.60264227642277,1005.58943089431,25.13973577235775,0
2904,4,2,0,42,0.047619047619047616,0.0,1.0,42,1250,800,450,0.64,17,8,9,328.05511870545627,0.47654132791327913,0.23345542083265647,0.1718071014205673,126908.26958550341,-73.41851128473013,126834.85107421868,281,0,31.261904761904763,39,3,16,39.83521572073467,0.5836004273504274,48.09895833333333,1007.6041666666661,25.83600427350426,0
2905,4,1,5,38,0.023255813953488372,0.11627906976744186,0.8837209302325582,43,950,700,250,0.7368421052631579,12,7,5,333.1156911275439,0.47646733111849393,0.13211566825082288,0.1672005124919923,125160.30777449049,313.5399331237687,125473.84770761426,282,0,31.511627906976745,38,5,17,41.506512919068975,0.5674342105263157,49.83974358974359,1000.6410256410259,26.33265856950068,16
2906,4,4,1,41,0.09523809523809523,0.023809523809523808,0.9761904761904762,42,1350,800,550,0.5925925925925926,19,8,11,333.8608738791106,0.4757065427797135,0.21327359352242725,0.17173803352341468,126174.62158203137,24.953884548624956,126199.57546657999,283,0,32.26190476190476,39,3,18,40.442478831864534,0.5761217948717949,48.82812500000001,1004.6875000000009,25.761217948717974,0
2907,4,3,3,41,0.06818181818181818,0.06818181818181818,0.9318181818181819,44,1400,800,600,0.5714285714285714,20,8,12,322.53580205132727,0.4768322762508809,0.21360233876238954,0.1685386514784932,126817.07180846862,-619.3908060909705,126197.68100237765,284,0,31.65909090909091,41,3,16,40.06769345677794,0.5795223577235773,48.18948412698412,1007.2420634920625,24.56687959736738,0
2908,4,4,7,38,0.08888888888888889,0.15555555555555556,0.8444444444444444,45,1200,800,400,0.6666666666666666,16,8,8,323.785456108225,0.4762626262626262,0.22983415763213388,0.17171258920340815,127417.32927256536,-748.5266676115036,126668.80260495386,285,0,31.6,41,4,14,39.4217148144509,0.5856199186991871,47.594246031746025,1009.6230158730147,24.624951606658893,0
2909,4,3,1,40,0.07317073170731707,0.024390243902439025,0.975609756097561,41,1200,700,500,0.5833333333333334,17,7,10,333.8196031639317,0.4754827235772358,0.2248606161257214,0.17797439722234862,127631.2242037402,321.16092300386714,127952.38512674408,286,0,34.24390243902439,38,3,17,38.949610558962426,0.5926535087719298,47.38247863247863,1010.4700854700852,26.591318038686452,0
2910,4,1,2,39,0.024390243902439025,0.04878048780487805,0.9512195121951219,41,1000,400,600,0.4,16,4,12,332.0027700191717,0.4744410569105691,0.22775736525588353,0.17795799665920048,127847.22792935937,289.1267623639459,128136.35469172332,287,0,35.21951219512195,38,3,18,38.77473765758152,0.5948464912280702,47.16880341880342,1011.3247863247866,26.613810166441752,0
2911,4,1,4,36,0.025,0.1,0.9,40,1150,900,250,0.782608695652174,14,9,5,447.411400791619,0.4736645299145299,0.2904326275853628,0.2255273631010681,125337.23695513724,3596.795532262669,128934.0324873999,288,0,36.7,33,7,16,38.46262697344265,0.579229797979798,49.66299019607842,1001.3480392156846,30.343879976232866,16
2912,4,3,2,37,0.07692307692307693,0.05128205128205128,0.9487179487179487,39,1600,1200,400,0.75,20,12,8,444.68378346309373,0.4757647323436797,0.2794174606863431,0.22644666511736,125758.72359963266,3384.5730027548198,129143.29660238748,289,0,37.58974358974359,32,7,19,38.091641490433034,0.5859375,49.24242424242424,1003.0303030303029,31.344696969696965,0
2913,4,1,0,38,0.02631578947368421,0.0,1.0,38,1200,900,300,0.75,15,9,6,408.72548249848825,0.47538821716453294,0.2649099948568494,0.20356703946631388,124837.29256523974,2854.8508755322173,127692.14344077195,290,0,39.44736842105263,31,7,18,39.951275787187846,0.5789650537634409,50.162760416666664,999.3489583333328,32.237063172042994,16
2914,4,4,3,39,0.09523809523809523,0.07142857142857142,0.9285714285714286,42,1000,700,300,0.7,13,7,6,370.6914623837697,0.4788521099496709,0.15431711145996863,0.18293342232604723,124452.35553247179,1049.065030263249,125501.42056273503,291,0,36.595238095238095,37,5,17,41.301282051282065,0.5619369369369369,50.5482456140351,997.8070175438618,26.967757230915183,16
2915,4,1,1,39,0.025,0.025,0.975,40,1350,900,450,0.6666666666666666,18,9,9,376.85352990222145,0.47755074786324786,0.18254653130287668,0.1865330286199438,124578.05937271731,1389.5362845954091,125967.59565731272,292,0,37.525,36,4,18,41.01687347245723,0.5651041666666667,50.4222972972973,998.3108108108108,27.730855855855857,0
2916,4,3,2,40,0.07142857142857142,0.047619047619047616,0.9523809523809523,42,950,400,550,0.42105263157894735,15,4,11,395.94732387059906,0.4809935152922958,0.24675957007977822,0.19112773027794164,123520.81619541379,1823.9703202988994,125344.7865157127,293,0,36.166666666666664,32,10,20,41.64364494686481,0.5628255208333333,51.48358585858586,994.065656565657,31.064551767676782,16
2917,4,7,3,44,0.14893617021276595,0.06382978723404255,0.9361702127659575,47,700,500,200,0.7142857142857143,9,5,4,343.4885794209482,0.48560360777058276,0.2533598721919226,0.1720930090804448,125084.47372626017,-789.3741464316172,124295.09957982856,294,0,32.638297872340424,36,11,21,41.32542496904199,0.5703125,49.91554054054055,1000.3378378378388,27.78716216216219,0
2918,4,4,2,46,0.08333333333333333,0.041666666666666664,0.9583333333333334,48,1750,1100,650,0.6285714285714286,24,11,13,341.2110563117717,0.4851876477541371,0.27642796248934287,0.17326431560766606,125641.84746877066,-1025.9225016436428,124615.92496712702,295,0,32.875,38,10,19,40.80682544757033,0.5723684210526316,49.358974358974365,1002.5641025641036,26.383265856950093,0
2919,4,6,6,46,0.11538461538461539,0.11538461538461539,0.8846153846153846,52,1650,1300,350,0.7878787878787878,20,13,7,319.00607670540325,0.4862132352941177,0.30313550766687136,0.16749982660218032,127013.25005425328,-2294.4741233409536,124718.77593091232,296,0,31.21153846153846,39,13,19,39.95567238469223,0.5846688034188035,47.99479166666666,1008.0208333333318,25.846688034187995,0
2920,4,2,4,44,0.041666666666666664,0.08333333333333333,0.9166666666666666,48,1550,1000,550,0.6451612903225806,21,10,11,352.7539041891171,0.4824357269503546,0.3357905002294632,0.18611398480098953,127208.74592764067,-625.3236454046514,126583.42228223602,297,0,34.3125,35,13,23,38.90450512467492,0.594047619047619,47.80092592592593,1008.7962962962969,28.82275132275134,0
2921,4,1,2,43,0.022222222222222223,0.044444444444444446,0.9555555555555556,45,1400,1000,400,0.7142857142857143,18,10,8,360.8866009639533,0.4811868686868687,0.3240229613902643,0.1909860551168789,127332.20663265325,190.49744897960983,127522.70408163287,298,0,35.91111111111111,34,11,15,38.57262915782022,0.5974264705882353,47.67857142857144,1009.2857142857158,29.684873949579877,0
2922,4,0,2,41,0.0,0.046511627906976744,0.9534883720930233,43,950,700,250,0.7368421052631579,12,7,5,372.51496992488006,0.4811969361387966,0.3272051120888335,0.1969007698174366,127283.05785123963,882.9688934802555,128166.02674471989,299,1,38.18604651162791,32,11,25,38.32973598598599,0.6015625,47.72727272727273,1009.0909090909088,31.5340909090909,0
2923,4,0,2,39,0.0,0.04878048780487805,0.9512195121951219,41,1250,700,550,0.56,18,7,11,373.08464400421207,0.4806910569105691,0.3094615117193935,0.19813618743331252,127474.24529384756,1311.7366850321407,128785.9819788797,300,2,39.34146341463415,32,9,17,38.11890472618153,0.603515625,47.53787878787879,1009.8484848484848,31.55776515151515,0
2924,4,0,2,37,0.0,0.05128205128205128,0.9487179487179487,39,1500,1200,300,0.8,18,12,6,367.271999845917,0.4798976608187135,0.21459537793627903,0.17964344633024415,124079.08340419497,1314.1546201813987,125393.23802437638,301,3,40.41025641025641,34,5,18,41.774704265742606,0.564031862745098,50.922619047619044,996.3095238095234,29.303221288515395,16
2925,4,4,2,39,0.0975609756097561,0.04878048780487805,0.9512195121951219,41,1350,900,450,0.6666666666666666,18,9,9,347.6382257331331,0.47911585365853654,0.21072467510349124,0.17370173361195795,124971.84843204709,488.9983311013908,125460.84676314848,302,0,39.09756097560975,36,5,18,41.33817622104592,0.5691550925925926,50.02815315315316,999.8873873873889,27.774649649649692,0
2926,4,6,4,41,0.13333333333333333,0.08888888888888889,0.9111111111111111,45,900,500,400,0.5555555555555556,13,5,8,328.8833458238725,0.482260101010101,0.15295429208472755,0.16120675475629134,124168.05555555531,-630.630503814649,123537.42505174066,303,0,36.48888888888889,39,6,18,42.63865663322188,0.5555555555555556,50.83333333333332,996.6666666666647,25.555555555555504,16
2927,4,7,6,42,0.14583333333333334,0.125,0.875,48,1000,700,300,0.7,13,7,6,297.1153648581601,0.48298980496453897,0.1693549687238025,0.15012603332862415,125436.42678474808,-2143.404280091386,123293.02250465669,304,0,32.041666666666664,42,6,13,42.12311375507834,0.5639880952380952,49.56395348837207,1001.7441860465082,23.851052048726384,0
2928,4,4,1,45,0.08695652173913043,0.021739130434782608,0.9782608695652174,46,850,600,250,0.7058823529411765,11,6,5,311.244717042018,0.48191425120772946,0.20684501318286408,0.15893739101021387,125873.61411573821,-1364.5005182981804,124509.11359744002,305,0,31.217391304347824,42,4,17,41.31964561606796,0.5684523809523809,49.127906976744185,1003.488372093023,23.89258028792912,0
2929,4,4,7,42,0.08163265306122448,0.14285714285714285,0.8571428571428572,49,1250,800,450,0.64,17,8,9,291.2133877654189,0.4833829365079365,0.1944341372912799,0.15132744331495837,126590.17029641909,-2427.0495300356833,124163.1207663834,306,0,29.040816326530614,45,4,14,41.08835883588361,0.5717592592592593,48.41485507246378,1006.3405797101472,22.363123993558826,0
2930,4,4,5,41,0.08695652173913043,0.10869565217391304,0.8913043478260869,46,1200,800,400,0.6666666666666666,16,8,8,336.562933051119,0.4814210950080515,0.18445060898233123,0.1675989149471846,124830.4838670303,-561.8710201470084,124268.61284688329,307,0,31.391304347826086,42,4,17,41.761207537412325,0.5577876984126984,50.16957364341086,999.3217054263571,23.793373938722787,15
2931,4,2,1,42,0.046511627906976744,0.023255813953488372,0.9767441860465116,43,1500,1000,500,0.6666666666666666,20,10,10,346.6267514721707,0.4790051679586564,0.2000938475250822,0.17409398289757758,125187.03572439545,78.86514567986865,125265.90087007532,308,0,33.395348837209305,38,5,20,41.14088466602612,0.5677083333333333,49.81303418803419,1000.7478632478628,26.335470085470075,0
2932,4,1,1,42,0.023255813953488372,0.023255813953488372,0.9767441860465116,43,1100,700,400,0.6363636363636364,15,7,8,351.82528257330154,0.47870524178663715,0.1900784353672198,0.1734740732808693,124416.33333539919,301.60386075328404,124717.93719615247,309,0,34.02325581395349,40,3,13,41.80927642524872,0.5565104166666667,50.58434959349595,997.6626016260186,24.941565040650467,16
2933,4,5,6,41,0.10638297872340426,0.1276595744680851,0.8723404255319149,47,1400,1200,200,0.8571428571428571,16,12,4,332.3046760121556,0.48024591427690405,0.2258858226248155,0.16815016170955785,125496.523841018,-1055.2860875027152,124441.23775351529,310,0,32.0,41,6,13,41.1798679867987,0.5660569105691057,49.50396825396826,1001.9841269841279,24.438637243515316,0
2934,4,4,5,40,0.08888888888888889,0.1111111111111111,0.8888888888888888,45,1050,600,450,0.5714285714285714,15,6,9,342.9425284447858,0.4787247474747475,0.2228077286853123,0.17444107580892532,125712.39424284502,-377.5747323021851,125334.81951054285,311,0,33.022222222222226,40,5,16,40.69065835697877,0.5697916666666667,49.28861788617887,1002.845528455286,25.07113821138215,0
2935,4,1,2,39,0.024390243902439025,0.04878048780487805,0.9512195121951219,41,1100,500,600,0.45454545454545453,17,5,12,367.27810784957717,0.4754573170731707,0.22638246080425328,0.1858354014135902,125493.907981302,1018.2330140043177,126512.14099530633,312,0,36.4390243902439,37,4,17,40.30650397607063,0.5726351351351351,49.506578947368425,1001.9736842105269,27.080369843527755,0
2936,4,3,0,42,0.07142857142857142,0.0,1.0,42,1350,700,650,0.5185185185185185,20,7,13,360.89840314810294,0.4751621176926055,0.24732707833296996,0.18605144900199713,126264.14497730053,714.9079524468858,126979.05292974741,313,0,36.023809523809526,37,5,20,39.67106698668994,0.5805180180180181,48.73903508771929,1005.0438596491214,27.16334755808436,0
2937,4,1,2,41,0.023255813953488372,0.046511627906976744,0.9534883720930233,43,1700,1500,200,0.8823529411764706,19,15,4,351.2575575627283,0.4754983388704319,0.23421840974987695,0.18301370856300614,126698.43885633664,300.7568359374818,126999.19569227412,314,0,36.16279069767442,39,4,16,39.46639506811518,0.5814636752136753,48.30729166666666,1006.770833333332,25.814636752136717,0
2938,4,2,3,40,0.046511627906976744,0.06976744186046512,0.9302325581395349,43,1450,1100,350,0.7586206896551724,18,11,7,350.1144558589052,0.4752906976744186,0.24217286796430093,0.1848194554422137,127230.25504241673,310.25100571808207,127540.5060481348,315,0,36.651162790697676,37,6,20,38.94900463717709,0.5903716216216216,47.77960526315788,1008.8815789473671,27.267069701280192,0
2939,4,0,2,38,0.0,0.05,0.95,40,950,500,450,0.5263157894736842,14,5,9,368.506424849391,0.4741720085470085,0.241174991619175,0.1931906265950325,126950.11470507689,1356.3865808376145,128306.5012859145,316,1,39.225,36,4,20,38.77318694826237,0.5894097222222222,48.05743243243244,1007.7702702702719,27.993618618618665,0
2940,4,2,1,39,0.05,0.025,0.975,40,1250,900,350,0.72,16,9,7,367.46123898640786,0.47533386752136747,0.24607438016528937,0.1933165648580669,127092.01388888896,1340.277777777787,128432.29166666674,317,0,39.925,37,3,22,38.65358126721762,0.5889639639639639,47.91666666666667,1008.333333333334,27.252252252252273,0
2941,4,1,2,38,0.025,0.05,0.95,40,1050,1000,50,0.9523809523809523,11,10,1,366.9907482845399,0.4758680555555555,0.23485552115583075,0.19432460933755152,127354.736328125,1347.6019965277774,128702.33832465278,318,0,40.55,35,5,16,38.39546783625731,0.5955357142857143,47.65625,1009.375,28.839285714285715,0
2942,4,1,2,37,0.02564102564102564,0.05128205128205128,0.9487179487179487,39,1100,600,500,0.5454545454545454,16,6,10,378.6568785694781,0.4737966711650922,0.22998013659492278,0.20083733503112827,127422.33737244888,1849.8689058956788,129272.20627834456,319,0,42.02564102564103,34,5,17,38.03158039539362,0.5983455882352942,47.58928571428571,1009.6428571428563,29.69537815126048,0
2943,4,0,1,36,0.0,0.02702702702702703,0.972972972972973,37,1250,900,350,0.72,16,9,7,408.25646113015,0.47528778778778774,0.25387570311428154,0.19809488384886598,123740.56218753192,2800.9124042944404,126541.47459182637,320,3,38.567567567567565,32,5,19,41.107762267343475,0.5651041666666667,51.26262626262626,994.9494949494953,31.092171717171727,16
2944,4,6,3,39,0.14285714285714285,0.07142857142857142,0.9285714285714286,42,1100,800,300,0.7272727272727273,14,8,6,354.2369197065343,0.47683168795973674,0.20383053063674272,0.17783894172385706,125168.9759861215,474.4666921174677,125643.44267823896,321,0,32.88095238095238,36,6,18,40.969174356665924,0.5711805555555556,49.831081081081095,1000.6756756756777,27.7965465465466,0
2945,4,6,5,40,0.13333333333333333,0.1111111111111111,0.8888888888888888,45,1100,700,400,0.6363636363636364,15,7,8,356.7585113228474,0.47716750841750843,0.21730316194428267,0.17450956296010997,124081.15216182903,-140.5050652548578,123940.64709657418,322,0,31.288888888888888,42,3,16,42.03442099461841,0.5500992063492063,50.920542635658904,996.3178294573628,23.721853082318162,16
2946,4,5,0,45,0.1111111111111111,0.0,1.0,45,1150,600,550,0.5217391304347826,17,6,11,355.5352561172533,0.48057659932659935,0.27227544078856014,0.1782129749347655,125104.18836805585,-94.0412845156199,125010.14708354023,323,0,30.711111111111112,39,6,19,41.00374843815079,0.5651709401709402,49.89583333333335,1000.4166666666691,25.651709401709464,0
2947,4,3,1,47,0.0625,0.020833333333333332,0.9791666666666666,48,1250,800,450,0.64,17,8,9,354.4282022561877,0.4829343971631206,0.31717553711760926,0.18196435963106017,126094.86669847666,-654.6533664650398,125440.21333201163,324,0,29.729166666666668,40,8,19,40.00809470808459,0.5736979166666667,48.907520325203265,1004.3699186991889,25.109247967479725,0
2948,4,1,4,44,0.020833333333333332,0.08333333333333333,0.9166666666666666,48,1350,1100,250,0.8148148148148148,16,11,5,355.308199459662,0.4823803191489362,0.3238904328785579,0.18378330547064103,126401.26294079279,-617.7189710159008,125783.54396977689,325,0,29.833333333333332,40,8,16,39.67028802425468,0.5768229166666667,48.60264227642278,1005.5894308943111,25.139735772357778,0
2949,4,3,5,42,0.06382978723404255,0.10638297872340426,0.8936170212765957,47,1500,1000,500,0.6666666666666666,20,10,10,354.08634967344005,0.4846785383903793,0.3159947007126551,0.18476259288647276,126759.19514054143,-423.2598610284807,126335.93527951295,326,0,30.829787234042552,40,7,17,39.33271941332794,0.58046875,48.2469512195122,1007.0121951219519,25.1753048780488,0
2950,4,0,3,39,0.0,0.07142857142857142,0.9285714285714286,42,1000,600,400,0.6,14,6,8,366.9588116297616,0.48298974061169186,0.20455955901142686,0.18481527352406768,125301.71693453733,796.5501798366931,126098.26711437402,327,1,29.738095238095237,37,5,15,40.51342952579127,0.5706644144144144,49.69846491228069,1001.2061403508753,27.059625414888522,15
2951,4,4,7,36,0.09302325581395349,0.16279069767441862,0.8372093023255813,43,1350,900,450,0.6666666666666666,18,9,9,355.7619264936776,0.483296419342931,0.18112891723782742,0.1815932616102511,125856.16188180295,354.96612243407685,126211.12800423703,328,0,28.558139534883722,38,5,16,40.220843980692806,0.5745614035087719,49.14529914529915,1003.4188034188037,26.40575798470536,0
2952,4,3,3,36,0.07692307692307693,0.07692307692307693,0.9230769230769231,39,1400,1200,200,0.8571428571428571,16,12,4,396.98366861607917,0.4837494376968061,0.14922319060250144,0.19279350413651675,123777.51345636282,2309.845228602702,126087.35868496553,329,0,28.256410256410255,33,6,18,41.34954844006569,0.5631313131313131,51.225490196078425,995.0980392156854,30.15448603683895,16
2953,4,8,5,39,0.18181818181818182,0.11363636363636363,0.8863636363636364,44,1150,600,550,0.5217391304347826,17,6,11,347.6410649906061,0.48481545102184637,0.16640574389980545,0.1763336004349939,125595.94671201793,-55.25332682095208,125540.69338519698,330,0,24.795454545454547,34,10,19,40.69304235946157,0.579656862745098,49.40476190476189,1002.3809523809507,29.481792717086787,0
2954,4,1,2,38,0.025,0.05,0.95,40,1000,800,200,0.8,12,8,4,366.4496979381664,0.48241185897435895,0.17654071900220103,0.18567692873223776,125552.07882785429,1201.7042723951836,126753.78310024948,331,0,27.525,33,7,20,40.26707834026249,0.5814393939393939,49.44852941176468,1002.205882352938,30.369875222816304,0
2955,4,2,2,38,0.05,0.05,0.95,40,1050,800,250,0.7619047619047619,13,8,5,348.7941560550566,0.482144764957265,0.16465601366186888,0.1793861035971987,126166.9264826025,802.2184976931526,126969.14498029565,332,0,27.225,33,7,23,40.07532324957306,0.5877525252525253,48.83578431372547,1004.6568627450953,30.44414735591198,0
2956,4,2,3,37,0.05,0.075,0.925,40,1050,700,350,0.6666666666666666,14,7,7,333.5198110881493,0.48205128205128206,0.15586514596383427,0.17429963691271322,126822.06809807233,459.5344387754829,127281.60253684781,333,0,27.45,34,6,19,39.785978804711824,0.592218137254902,48.184523809523796,1007.2619047619029,29.625350140055968,0
2957,4,3,1,39,0.075,0.025,0.975,40,1100,600,500,0.5454545454545454,16,6,10,325.867865882947,0.482144764957265,0.15253717252773202,0.17194298228468816,127212.08191609972,290.86592970520775,127502.94784580493,334,0,27.825,34,6,22,39.579153882464006,0.5962009803921569,47.797619047619044,1008.8095238095234,29.670868347338924,0
2958,4,0,4,35,0.0,0.10256410256410256,0.8974358974358975,39,700,500,200,0.7142857142857143,9,5,4,358.3224053345609,0.4821749887539361,0.05045891363098676,0.18273006921154,125817.77459469606,1282.1984051412155,127099.97299983728,335,1,29.23076923076923,36,3,16,40.196243499083316,0.5778356481481481,49.18355855855856,1003.2657657657659,27.868493493493496,16
2959,4,2,4,33,0.05405405405405406,0.10810810810810811,0.8918918918918919,37,850,600,250,0.7058823529411765,11,6,5,366.84073290752514,0.4796046046046046,0.07880478343111763,0.1874222653582083,125894.45153061223,1836.6425736961387,127731.09410430837,336,0,31.45945945945946,34,3,18,39.90337089758796,0.5827205882352942,49.107142857142854,1003.5714285714286,29.516806722689076,0
2960,4,5,8,30,0.13157894736842105,0.21052631578947367,0.7894736842105263,38,1300,1000,300,0.7692307692307693,16,10,6,357.1037889211161,0.4775960170697013,0.09503092059880625,0.18599333868478254,126683.87372470855,1447.8582604595354,128131.73198516808,337,0,30.81578947368421,35,3,17,39.334233923507306,0.5886904761904762,48.32175925925926,1006.7129629629634,28.763227513227527,0
2961,4,3,4,29,0.09090909090909091,0.12121212121212122,0.8787878787878788,33,1050,600,450,0.5714285714285714,15,6,9,377.06832166868327,0.47490530303030304,0.10734366624468206,0.1960607692120729,126615.03170913698,2948.5035009182893,129563.53521005527,338,0,32.09090909090909,32,1,18,38.902741186802146,0.5947265625,48.39015151515152,1006.4393939393952,31.4512310606061,0
2962,4,1,0,30,0.03333333333333333,0.0,1.0,30,650,300,350,0.46153846153846156,10,3,7,427.3871418838967,0.4744492337164751,0.06762475049900174,0.20628223322141853,123516.3336167802,4576.224033001652,128092.55764978185,93,0,23.966666666666665,27,3,19,40.867015968063875,0.5771604938271605,51.48809523809525,994.0476190476203,36.816578483245195,16
2963,4,9,10,29,0.23076923076923078,0.2564102564102564,0.7435897435897436,39,1050,700,350,0.6666666666666666,14,7,7,336.4094987813347,0.4792791273054431,0.058875011827041135,0.1720131588108335,125927.64060356657,681.5086013829443,126609.14920494951,94,0,19.205128205128204,35,4,16,40.63268757687577,0.5809523809523809,49.074074074074076,1003.703703703704,28.677248677248688,0
2964,4,3,2,30,0.09375,0.0625,0.9375,32,800,600,200,0.75,10,6,4,395.62567810038627,0.477528561827957,0.10843530213865371,0.19901257034840375,125251.5632225195,3510.5469266085397,128762.11014912804,95,0,23.6875,28,4,21,39.8479737811588,0.5918898809523809,49.74856321839081,1001.005747126437,35.750205254515606,0
2965,4,3,2,31,0.09090909090909091,0.06060606060606061,0.9393939393939394,33,950,700,250,0.7368421052631579,12,7,5,373.25981525278553,0.47593118686868685,0.1007538496536684,0.19354398205657883,126501.88022189679,2843.613688151052,129345.49391004784,96,0,21.21212121212121,31,2,17,39.11521701613597,0.5961021505376345,48.50260416666667,1005.9895833333342,32.45127688172046,0
2966,4,3,2,32,0.08823529411764706,0.058823529411764705,0.9411764705882353,34,1200,800,400,0.6666666666666666,16,8,8,355.21487765589615,0.4766042780748663,0.10543110999874883,0.18760886234952198,127251.20722694129,2240.3044013366202,129491.5116282779,97,0,21.147058823529413,32,2,22,38.79885704751178,0.6012369791666667,47.758838383838395,1008.9646464646478,31.530145202020243,0
2967,4,1,1,32,0.030303030303030304,0.030303030303030304,0.9696969696969697,33,1150,800,350,0.6956521739130435,15,8,7,355.3795425600589,0.47447127525252525,0.10482165996044479,0.18873343833966463,127474.24529384758,2460.3477961432536,129934.59308999083,98,0,21.78787878787879,32,1,19,38.56589147286821,0.603515625,47.53787878787879,1009.8484848484849,31.557765151515152,0
2968,4,1,0,33,0.030303030303030304,0.0,1.0,33,1150,900,250,0.782608695652174,14,9,5,358.52995836295236,0.47348484848484845,0.10739911926966772,0.19116024362283204,127633.67776566166,2552.099435006632,130185.7772006683,99,0,22.636363636363637,32,1,20,38.32286850764297,0.6051432291666667,47.380050505050505,1010.479797979798,31.57749368686869,0
2969,4,0,1,32,0.0,0.030303030303030304,0.9696969696969697,33,1250,800,450,0.64,17,8,9,359.70897234633503,0.47328756313131315,0.09573759573759588,0.1925500969618615,127793.20987654309,2593.672839506157,130386.88271604924,100,1,23.636363636363637,32,1,20,38.12957875457875,0.6067708333333333,47.222222222222214,1011.1111111111102,31.597222222222193,0
2970,4,2,0,34,0.058823529411764705,0.0,1.0,34,650,400,250,0.6153846153846154,9,4,5,347.7372530979073,0.47452465834818774,0.0930536279847689,0.1882153501541717,128237.60880730957,2118.5987660995593,130356.20757340913,101,0,23.41176470588235,33,1,22,37.97779290179469,0.6089015151515151,46.78308823529411,1012.8676470588226,30.692959001782505,0
2971,4,0,2,32,0.0,0.058823529411764705,0.9411764705882353,34,1150,900,250,0.782608695652174,14,9,5,351.9107595149819,0.473577688651218,0.08792240300375487,0.1915135396518374,128454.92118415986,2240.9337754709622,130695.85495963081,102,1,24.41176470588235,33,1,16,37.65010477111541,0.6111111111111112,46.56862745098039,1013.7254901960778,30.718954248365993,0
2972,4,1,1,32,0.030303030303030304,0.030303030303030304,0.9696969696969697,33,1250,800,450,0.64,17,8,9,351.87630030219924,0.47273516414141414,0.060417515121347964,0.19262111370766127,128688.4310274459,2456.481800326461,131144.91282777235,103,0,23.818181818181817,32,1,19,37.41263273602123,0.6158854166666667,46.33838383838382,1014.6464646464624,31.70770202020195,0
2973,4,3,0,35,0.08571428571428572,0.0,1.0,35,1150,600,550,0.5217391304347826,17,6,11,336.6815585198568,0.47037815126050425,0.07163250977901114,0.18756718377514284,129383.0002834465,1712.1740362811524,131095.17431972764,104,0,23.314285714285713,34,1,22,37.091426788361005,0.6182598039215687,45.65476190476189,1017.3809523809507,29.922969187675022,0
2974,4,0,2,33,0.0,0.05714285714285714,0.9428571428571428,35,1300,1000,300,0.7692307692307693,16,10,6,370.6369406417875,0.47030812324929977,-0.012988909362722456,0.1935129846374973,126783.2759635716,2866.4981678945996,129649.77413146621,105,1,24.314285714285713,33,2,17,38.89125496876776,0.5940656565656566,48.22303921568627,1007.1078431372541,30.5184194890077,16
2975,4,3,4,32,0.08333333333333333,0.1111111111111111,0.8888888888888888,36,800,500,300,0.625,11,5,6,363.23380299361537,0.47172619047619047,0.00626204238920991,0.19208564865732244,127302.17013888895,2048.090277777783,129350.26041666673,106,0,24.333333333333332,34,2,20,38.54424717864024,0.5971200980392157,47.708333333333336,1009.1666666666672,29.681372549019624,0
2976,4,1,0,33,0.030303030303030304,0.0,1.0,33,700,500,200,0.7142857142857143,9,5,4,376.980597728226,0.4704861111111111,0.024805460388282796,0.19848016045190114,127123.84458537392,2984.644583460872,130108.4891688348,107,0,26.393939393939394,32,1,21,38.38085847836067,0.5999348958333333,47.88510101010101,1008.4595959595958,31.51436237373737,0
2977,4,0,1,32,0.0,0.030303030303030304,0.9696969696969697,33,750,600,150,0.8,9,6,3,377.60979225473176,0.4705255681818182,0.023064900380874498,0.19896748156535587,127155.67926742163,3003.0459264360697,130158.7251938577,108,1,27.393939393939394,32,1,21,38.3322379402437,0.6002604166666667,47.85353535353535,1008.585858585858,31.518308080808062,0
2978,4,0,0,32,0.0,0.0,1.0,32,1000,800,200,0.8,12,8,4,389.65917628577307,0.4702410954301075,0.01833677685950419,0.2049946101329501,127092.01388888883,3504.5138888888832,130596.52777777772,109,2,29.125,31,1,21,38.09400826446281,0.6021505376344086,47.916666666666664,1008.3333333333328,32.52688172043009,0
2979,4,2,0,34,0.058823529411764705,0.0,1.0,34,1050,800,250,0.7619047619047619,13,8,5,369.4623261719074,0.4703097147950089,0.032989352755883106,0.19827971652944862,127896.48963139161,2650.5869136870247,130547.07654507864,110,0,28.352941176470587,33,1,19,37.777138357160155,0.6054292929292929,47.12009803921568,1011.519607843136,30.65210932857988,0
2980,4,1,4,31,0.02857142857142857,0.11428571428571428,0.8857142857142857,35,1000,800,200,0.8,12,8,4,384.7858172380376,0.4704131652661065,0.035001530976763506,0.19211838841647083,124940.483276644,2660.495435919467,127600.97871256346,111,0,28.514285714285716,34,1,14,40.44216877034216,0.5729166666666667,50.05952380952381,999.7619047619047,29.4047619047619,16
2981,4,7,2,36,0.18421052631578946,0.05263157894736842,0.9473684210526316,38,800,500,300,0.625,11,5,6,385.2083092457699,0.47927038880986245,0.13632647928063868,0.188549330315035,124108.73724489813,3339.314058956937,127448.05130385507,112,0,26.473684210526315,34,4,19,41.29704301075269,0.5643382352941176,50.89285714285715,996.4285714285729,29.306722689075674,16
2982,4,4,4,36,0.1,0.1,0.9,40,1400,1100,300,0.7857142857142857,17,11,6,402.3643897395776,0.48202457264957266,0.12288928945226218,0.19558685061450679,123816.4722249013,2297.1834752097775,126113.65570011108,113,0,24.475,35,5,17,41.17496705043223,0.5592261904761905,51.18634259259259,995.2546296296288,28.435846560846535,15
2983,4,6,5,37,0.14285714285714285,0.11904761904761904,0.8809523809523809,42,750,400,350,0.5333333333333333,11,4,7,367.9663581487324,0.4822033488192025,0.1638267774759279,0.18485681316380922,125197.14974687531,819.4649325681804,126016.61467944349,114,0,23.571428571428573,36,6,19,40.59651738494432,0.5714699074074074,49.80292792792793,1000.7882882882888,27.799674674674687,0
2984,4,6,6,37,0.13953488372093023,0.13953488372093023,0.8604651162790697,43,1350,1000,350,0.7407407407407407,17,10,7,363.7182031823854,0.4794435215946844,0.18392807204674333,0.18625939810925823,125990.20113092673,564.9859147856363,126555.18704571236,115,0,23.558139534883722,38,5,16,39.88285268348053,0.5759320175438596,49.01175213675216,1003.952991452995,26.4198155645525,0
2985,4,3,0,40,0.075,0.0,1.0,40,1100,900,200,0.8181818181818182,13,9,4,382.82707795060844,0.48003472222222227,0.19199753252579654,0.196165875115381,126015.56793279784,1648.4343295998951,127664.00226239774,116,0,25.7,36,4,19,39.3770094960371,0.5798611111111112,48.9864864864865,1004.0540540540557,27.890390390390436,0
2986,4,3,8,35,0.06976744186046512,0.18604651162790697,0.813953488372093,43,1050,600,450,0.5714285714285714,15,6,9,358.71451808330494,0.4804355850867479,0.18734518169356162,0.18750104810084128,126829.5627170141,499.12109375002024,127328.68381076411,117,0,24.837209302325583,39,4,16,39.14382971389175,0.5827991452991452,48.17708333333334,1007.2916666666683,25.827991452991494,0
2987,4,2,2,35,0.05405405405405406,0.05405405405405406,0.9459459459459459,37,900,600,300,0.6666666666666666,12,6,6,397.7761826577449,0.47769644644644643,0.17982161265743346,0.2050077249082224,126253.12500000001,2644.097222222223,128897.22222222223,78,0,26.18918918918919,34,3,21,38.75587341072415,0.5863970588235294,48.75,1005.0000000000001,29.558823529411768,0
2988,4,2,1,36,0.05405405405405406,0.02702702702702703,0.972972972972973,37,1200,800,400,0.6666666666666666,16,8,8,397.86590643546833,0.477759009009009,0.16446369491904678,0.20701269162534697,126642.263676304,2677.32780612247,129319.59148242648,79,0,25.972972972972972,34,3,19,38.35132071752416,0.5903799019607843,48.36309523809525,1006.5476190476203,29.604341736694714,0
2989,4,1,1,36,0.02702702702702703,0.02702702702702703,0.972972972972973,37,1200,800,400,0.6666666666666666,16,8,8,399.36930290785693,0.47760260260260257,0.16995719123378672,0.2085595248518811,126792.09183673486,2727.3738662131686,129519.46570294803,80,0,26.91891891891892,34,3,20,38.15873719464143,0.5919117647058824,48.21428571428572,1007.1428571428585,29.62184873949584,0
2990,4,3,5,34,0.07692307692307693,0.1282051282051282,0.8717948717948718,39,850,400,450,0.47058823529411764,13,4,9,387.3327488316376,0.4769174538911381,0.1361925523868841,0.19434077850548506,125144.71778817296,2016.5001717958176,127161.21795996878,81,0,25.82051282051282,35,4,17,40.166401580875245,0.5729166666666667,49.85532407407407,1000.5787037037032,28.58796296296295,16
2991,4,3,0,37,0.08108108108108109,0.0,1.0,37,1400,1100,300,0.7857142857142857,17,11,6,395.8264035993763,0.475975975975976,0.16374533529345237,0.19306634787806345,123960.50347222242,2413.3680555555793,126373.871527778,82,0,26.945945945945947,36,1,17,41.187238493723854,0.5587384259259259,51.04166666666668,995.8333333333351,27.662037037037084,16
2992,4,7,6,38,0.1590909090909091,0.13636363636363635,0.8636363636363636,44,650,300,350,0.46153846153846156,10,3,7,346.39779050572514,0.47879228329809725,0.18191264263583484,0.1758297645478429,125625.78125000012,-83.68055555554105,125542.10069444457,83,0,23.5,39,5,14,40.693405375450254,0.5705128205128205,49.37500000000001,1002.5000000000009,25.70512820512823,0
2993,4,6,4,40,0.13636363636363635,0.09090909090909091,0.9090909090909091,44,1100,700,400,0.6363636363636364,15,7,8,333.22904186666443,0.4815340909090909,0.180853994490358,0.1715390880545147,126204.81231508894,-387.58937376723634,125817.22294132171,84,0,23.34090909090909,38,6,16,40.42729930887825,0.578125,48.798076923076934,1004.8076923076939,26.442307692307732,0
2994,4,3,4,39,0.06976744186046512,0.09302325581395349,0.9069767441860466,43,1200,800,400,0.6666666666666666,16,8,8,341.2583739091785,0.47925895164267257,0.2118885587074919,0.17663779940716626,126429.50234687599,29.02527700831382,126458.5276238843,85,0,24.813953488372093,37,6,18,39.99445777002472,0.5822072072072072,48.574561403508774,1005.7017543859652,27.181128496917978,0
2995,4,1,0,40,0.025,0.0,1.0,40,950,700,250,0.7368421052631579,12,7,5,355.06498222337825,0.4771501068376069,0.2109543010752688,0.1834502408154122,126355.00365230103,972.8474251278383,127327.85107742887,86,0,26.75,36,4,20,39.72404233870967,0.5833333333333333,48.64864864864865,1005.4054054054061,27.927927927927946,0
2996,4,1,1,40,0.024390243902439025,0.024390243902439025,0.975609756097561,41,1350,1000,350,0.7407407407407407,17,10,7,344.693618651745,0.4770071138211382,0.2145438612796582,0.1799892488525454,126788.14785559008,540.6130972991557,127328.76095288924,87,0,27.073170731707318,37,4,21,39.53944383959354,0.5858671171171171,48.21820175438596,1007.1271929824554,27.219653864390686,0
2997,4,1,1,40,0.024390243902439025,0.024390243902439025,0.975609756097561,41,1250,1000,250,0.8,15,10,5,339.81338164629614,0.47820121951219513,0.21155751608009554,0.17902864617084804,127150.37321030535,442.2070469095125,127592.58025721487,88,0,26.829268292682926,35,6,22,39.29070078800399,0.593452380952381,47.858796296296305,1008.5648148148159,28.8161375661376,0
2998,4,5,3,42,0.1111111111111111,0.06666666666666667,0.9333333333333333,45,1350,800,550,0.5925925925925926,19,8,11,349.315991141592,0.47933501683501684,0.1878665676182394,0.18195713568420238,126688.35521449706,647.5759600926567,127335.93117458971,89,0,25.044444444444444,38,7,19,39.525628780643096,0.5830592105263157,48.31730769230769,1006.7307692307693,26.492914979757085,16
2999,4,3,4,41,0.06666666666666667,0.08888888888888889,0.9111111111111111,45,2000,1500,500,0.75,25,15,10,338.2739049916084,0.4773148148148148,0.2172217518110835,0.17914864654488274,127361.47636788628,-382.7451557820482,126978.73121210423,90,0,25.8,38,7,15,39.113216200959656,0.5899122807017544,47.64957264957263,1009.4017094017066,26.56320287899228,0
3000,4,3,2,42,0.06818181818181818,0.045454545454545456,0.9545454545454546,44,1600,1100,500,0.6875,21,11,10,350.41463022168665,0.4743437279774489,0.20129398902983775,0.18036817092414037,126200.78667534728,118.54196771815339,126319.32864306543,91,0,25.477272727272727,39,5,19,39.99974082521253,0.5763888888888888,48.802083333333336,1004.7916666666672,25.763888888888903,16
3001,4,2,2,42,0.045454545454545456,0.045454545454545456,0.9545454545454546,44,1200,800,400,0.6666666666666666,16,8,8,348.3581040852383,0.4754008104298802,0.23778305868535954,0.1816595839619233,126733.6117720934,29.736144160224796,126763.34791625362,92,0,26.295454545454547,40,4,17,39.50322130265103,0.5802083333333333,48.27235772357724,1006.9105691056916,25.17276422764229,0
3002,4,3,4,41,0.06666666666666667,0.08888888888888889,0.9111111111111111,45,1100,600,500,0.5454545454545454,16,6,10,342.57174277795536,0.47438973063973067,0.2513901787454562,0.18151245266600158,127381.02349175359,-271.5600280943209,127109.46346365927,93,0,26.266666666666666,39,6,13,38.98473239775734,0.5884081196581197,47.630208333333336,1009.4791666666677,25.88408119658122,0
3003,4,1,1,41,0.023809523809523808,0.023809523809523808,0.9761904761904762,42,1100,800,300,0.7272727272727273,14,8,6,367.188385748378,0.47317799070847855,0.259227820507143,0.19279880677629155,127013.25005425341,927.5580512152733,127940.80810546868,94,0,28.047619047619047,39,3,21,38.741453101856635,0.5846688034188035,47.994791666666664,1008.0208333333328,25.84668803418802,0
3004,4,4,5,40,0.08888888888888889,0.1111111111111111,0.8888888888888888,45,1250,800,450,0.64,17,8,9,348.33486750346344,0.4742424242424242,0.2645441654087195,0.18760651733168782,128039.0842013888,-79.8312717013942,127959.25292968741,95,0,26.622222222222224,39,6,17,38.16556882118843,0.5950854700854701,46.979166666666664,1012.0833333333326,25.95085470085468,0
3005,4,1,5,36,0.024390243902439025,0.12195121951219512,0.8780487804878049,41,750,400,350,0.5333333333333333,11,4,7,370.4962502464041,0.4720274390243902,0.26965652846923005,0.19962968012352442,128056.65569540886,1288.902150848755,129345.55784625761,96,0,27.878048780487806,35,6,19,37.58683533447683,0.6026785714285714,46.96180555555555,1012.152777777777,28.918650793650773,0
3006,4,3,3,36,0.07692307692307693,0.07692307692307693,0.9230769230769231,39,1400,1100,300,0.7857142857142857,17,11,6,366.0470255019948,0.469804318488529,0.21791862284820063,0.19991799085108947,128596.93877551022,1614.5053854875332,130211.44416099775,97,0,24.923076923076923,34,5,17,37.14666471048514,0.6102941176470589,46.42857142857143,1014.2857142857144,29.831932773109248,0
3007,4,0,2,34,0.0,0.05555555555555555,0.9444444444444444,36,1000,700,300,0.7,13,7,6,393.2637243224316,0.4696924603174603,0.23341262697698362,0.21253731647363092,128177.4923536512,2881.5116034613675,131059.00395711258,98,1,27.47222222222222,31,5,21,36.886679739402524,0.613239247311828,46.842447916666664,1012.6302083333329,32.665490591397834,0
3008,4,1,0,35,0.02857142857142857,0.0,1.0,35,1400,1100,300,0.7857142857142857,17,11,6,387.9884214688738,0.4684523809523809,0.18566292464597534,0.21160040801117555,128540.34423828116,2974.4330512152637,131514.77728949641,89,0,24.885714285714286,31,4,20,36.64826228385551,0.6169354838709677,46.48437499999999,1014.0624999999993,32.711693548387075,0
3009,4,1,1,35,0.027777777777777776,0.027777777777777776,0.9722222222222222,36,1150,1000,150,0.8695652173913043,13,10,3,379.27543364878807,0.4692956349206349,0.17833257333941344,0.20845890375734125,128848.62075617276,2573.8233024691253,131422.44405864188,90,0,25.166666666666668,32,4,21,36.553807569539444,0.6175130208333333,46.18055555555555,1015.2777777777771,31.727430555555536,0
3010,4,1,1,35,0.027777777777777776,0.027777777777777776,0.9722222222222222,36,1150,1000,150,0.8695652173913043,13,10,3,378.12871357534175,0.46798941798941796,0.09444707335988589,0.19645494873093788,126582.35721371861,2372.884778911542,128955.24199263015,91,0,23.86111111111111,34,2,17,38.90975590520132,0.5897671568627452,48.42261904761904,1006.3095238095221,29.597338935574182,15
3011,4,2,3,34,0.05405405405405406,0.08108108108108109,0.9189189189189189,37,1150,1000,150,0.8695652173913043,13,10,3,362.7867990415986,0.4682182182182182,0.12385862976662598,0.19154527724080023,127237.9373097778,1832.0487986539626,129069.98610843177,92,0,24.135135135135137,35,2,19,38.62149152996062,0.5943452380952381,47.77199074074073,1008.9120370370358,28.826058201058167,0
3012,4,2,3,33,0.05555555555555555,0.08333333333333333,0.9166666666666666,36,1000,700,300,0.7,13,7,6,361.0965528854617,0.4692956349206349,0.09831117224514796,0.19161838974286885,127442.37075617265,2003.8001543209693,129446.17091049362,85,0,22.63888888888889,35,1,15,38.45426409903715,0.5964285714285714,47.569444444444436,1009.7222222222207,28.849206349206305,0
3013,4,0,2,31,0.0,0.06060606060606061,0.9393939393939394,33,1050,700,350,0.6666666666666666,14,7,7,384.950641574462,0.46531723484848486,0.11509229098805629,0.20188410125146888,126964.73095857567,3175.0309279665344,130139.76188654221,86,2,25.575757575757574,32,1,20,38.3438256911384,0.5983072916666667,48.042929292929294,1007.828282828283,31.494633838383844,0
3014,4,1,2,30,0.03125,0.0625,0.9375,32,600,100,500,0.16666666666666666,11,1,10,424.61226016715614,0.46555779569892475,0.18131567425569206,0.2094283592837742,124429.41606327328,4186.380374399841,128615.79643767313,87,0,26.1875,30,2,17,39.980185459607526,0.5774305555555556,50.57123655913979,997.7150537634413,33.25716845878138,13
3015,4,1,4,27,0.03225806451612903,0.12903225806451613,0.8709677419354839,31,800,500,300,0.625,11,5,6,417.84194640933043,0.46653225806451615,0.15701256423363597,0.20788070279866722,124791.75347222242,4228.645833333367,129020.3993055558,88,0,26.548387096774192,29,2,19,39.77098971365029,0.584051724137931,50.20833333333335,999.1666666666683,34.454022988505805,0
3016,4,6,3,30,0.18181818181818182,0.09090909090909091,0.9090909090909091,33,950,700,250,0.7368421052631579,12,7,5,385.6954685157989,0.4717092803030303,0.13848995794521102,0.1974576402560962,125978.46984863281,3117.8649902343755,129096.33483886719,89,0,23.939393939393938,31,2,17,39.343385214007775,0.5907258064516129,49.0234375,1003.90625,32.38407258064516,0
3017,4,2,1,31,0.0625,0.03125,0.96875,32,700,300,400,0.42857142857142855,11,3,8,394.10478469723313,0.4684139784946237,0.15339730290456433,0.20208351725964524,126043.83680555568,3534.9127875434215,129578.7495930991,90,0,25.59375,29,3,20,39.06466113416321,0.5969827586206897,48.95833333333334,1004.1666666666677,34.62643678160923,0
3018,4,1,1,31,0.03125,0.03125,0.96875,32,800,400,400,0.5,12,4,8,398.4921095204665,0.46984206989247307,0.1553867403314919,0.2060773480662984,126392.74691358027,3673.3024691358087,130066.04938271608,91,0,24.90625,29,3,16,38.59346224677717,0.6005747126436782,48.611111111111114,1005.5555555555558,34.674329501915715,0
3019,4,0,0,31,0.0,0.0,1.0,31,750,500,250,0.6666666666666666,10,5,5,408.93701898103353,0.47011648745519713,0.15225290027481164,0.21098255050083417,126296.44768133179,4129.458564539578,130425.90624587136,92,1,26.06451612903226,28,3,16,38.430591290261106,0.6026785714285714,48.70689655172414,1005.1724137931037,35.89901477832513,0
3020,4,3,3,31,0.08823529411764706,0.08823529411764706,0.9117647058823529,34,850,600,250,0.7058823529411765,11,6,5,384.9107998429329,0.4727978312537136,0.07267294486350306,0.18919428146323353,124284.87989637579,3027.2939534085795,127312.17384978436,93,0,24.676470588235293,31,3,17,41.12094106381126,0.573252688172043,50.71614583333333,997.135416666666,32.165658602150515,15
3021,4,3,0,34,0.08823529411764706,0.0,1.0,34,1300,1100,200,0.8461538461538461,15,11,4,365.2590286024369,0.46941844919786097,0.10703119778399905,0.1827679573948138,125031.56764934697,2333.7817888480677,127365.34943819503,94,0,24.823529411764707,32,2,20,40.83580566426797,0.5784505208333333,49.96843434343434,1000.1262626262624,31.2539457070707,0
3022,4,4,3,35,0.10526315789473684,0.07894736842105263,0.9210526315789473,38,1300,1100,200,0.8461538461538461,15,11,4,339.59076593543017,0.47298779042200095,0.13231542418118503,0.17606293163674971,126496.5699440995,991.4134151042921,127487.98335920379,95,0,23.105263157894736,36,2,17,39.96744281503042,0.5847800925925926,48.50788288288288,1005.9684684684684,27.943568568568566,0
3023,4,3,1,37,0.07894736842105263,0.02631578947368421,0.9736842105263158,38,1550,1200,350,0.7741935483870968,19,12,7,326.0147187730626,0.4718912991939308,0.1218182031998778,0.17115294708138898,127006.86486740115,681.2214663988266,127688.08633379998,96,0,22.36842105263158,36,2,20,39.78559192641418,0.5899884259259259,48.001126126126124,1007.9954954954951,27.999874874874862,0
3024,4,1,4,34,0.02631578947368421,0.10526315789473684,0.8947368421052632,38,1250,900,350,0.72,16,9,7,352.9830054688099,0.4716838549075391,0.052100994084283814,0.17527291928629626,124710.81559713652,1599.6512649880908,126310.46686212461,97,0,23.210526315789473,35,3,17,41.474990343762066,0.5684523809523809,50.289351851851855,998.8425925925928,28.538359788359795,16
3025,4,4,3,35,0.10526315789473684,0.07894736842105263,0.9210526315789473,38,1100,500,600,0.45454545454545453,17,5,12,364.43455771556637,0.4721580132764343,0.019193300731603413,0.18194964025970556,124938.73299932708,1575.8830126322391,126514.61601195933,98,0,23.894736842105264,33,5,19,40.95264362180273,0.5751262626262627,50.061274509803916,999.7549019607835,30.295603089720714,16
3026,4,2,4,33,0.05405405405405406,0.10810810810810811,0.8918918918918919,37,1050,700,350,0.6666666666666666,14,7,7,350.77009317519475,0.4749436936936937,-0.004257682339873892,0.17746882931933125,125490.67666282206,1403.67526912727,126894.35193194934,99,0,23.37837837837838,33,4,17,40.72335697977822,0.5808080808080809,49.50980392156863,1001.9607843137261,30.362448009506853,0
3027,4,5,7,31,0.13157894736842105,0.18421052631578946,0.8157894736842105,38,1150,800,350,0.6956521739130435,15,8,7,338.48253710758104,0.47424727358937885,0.04684384968102018,0.17521448979686569,126432.65306122463,959.0490362811897,127391.70209750581,100,0,23.36842105263158,34,4,17,40.06101049558079,0.5882352941176471,48.57142857142858,1005.7142857142869,29.579831932773146,0
3028,4,3,3,31,0.08823529411764706,0.08823529411764706,0.9117647058823529,34,950,500,450,0.5263157894736842,14,5,9,356.07935783510953,0.4728349673202614,0.051782992989942045,0.18375218198442841,126305.4741753473,2194.9544270833444,128500.42860243065,101,0,25.08823529411765,31,3,18,39.74956822107082,0.5940860215053764,48.69791666666667,1005.208333333334,32.42607526881723,0
3029,4,2,1,32,0.06060606060606061,0.030303030303030304,0.9696969696969697,33,700,500,200,0.7142857142857143,9,5,4,368.18542097852276,0.46851325757575757,0.07272565246098184,0.19035211709331915,126381.48422144173,2706.3639943924068,129087.84821583414,102,0,26.545454545454547,30,3,20,39.36695183353383,0.5975694444444444,48.622311827956985,1005.5107526881716,33.51702508960572,0
3030,4,4,1,35,0.1111111111111111,0.027777777777777776,0.9722222222222222,36,900,500,400,0.5555555555555556,13,5,8,339.5269572619555,0.4674768518518519,0.10012058256874545,0.1812348748569157,127679.6503298011,1470.1366361495607,129149.78696595065,103,0,25.02777777777778,33,3,19,38.75588597873972,0.603219696969697,47.33455882352941,1010.6617647058828,30.626114081996448,0
3031,4,1,1,35,0.027777777777777776,0.027777777777777776,0.9722222222222222,36,950,600,350,0.631578947368421,13,6,7,340.01774918943244,0.46612103174603176,0.10634458986373696,0.18219652378644124,127834.51677239512,1493.200932333701,129327.71770472881,104,0,26.0,33,3,20,38.585090483115216,0.6047979797979798,47.1813725490196,1011.2745098039206,30.64468211527032,0
3032,4,2,3,34,0.05405405405405406,0.08108108108108109,0.9189189189189189,37,1350,1100,250,0.8148148148148148,16,11,5,331.3581419750648,0.4667167167167167,0.10387442397775914,0.18042493203706217,128476.21882086161,1114.328231292509,129590.54705215413,105,0,25.54054054054054,34,3,18,38.14926804446532,0.6090686274509804,46.547619047619044,1013.8095238095233,29.81792717086833,0
3033,4,2,2,34,0.05555555555555555,0.05555555555555555,0.9444444444444444,36,1000,600,400,0.6,14,6,8,354.4604231468418,0.4656084656084656,0.05873410724156991,0.1826834488526031,126253.12500000001,1750.347222222223,128003.47222222223,106,0,26.555555555555557,34,2,22,39.8441818684356,0.5863970588235294,48.75,1005.0000000000001,29.558823529411768,15
3034,4,1,4,31,0.02857142857142857,0.11428571428571428,0.8857142857142857,35,1200,1000,200,0.8333333333333334,14,10,4,351.85446424160915,0.465126050420168,0.0743803954330271,0.18232458601610665,126474.9134948098,1900.15258554404,128375.06608035385,107,0,28.0,33,2,19,39.681306855100715,0.5909090909090908,48.52941176470589,1005.8823529411774,30.48128342245992,0
3035,4,2,0,33,0.06060606060606061,0.0,1.0,33,1000,700,300,0.7,13,7,6,353.1964862467711,0.4631076388888889,0.07919384512460326,0.18379127861352867,126646.80262218142,2346.241136108567,128993.04375828999,108,0,29.363636363636363,32,1,22,39.47069953169427,0.5950520833333333,48.35858585858586,1006.5656565656567,31.45517676767677,0
3036,4,2,0,35,0.05714285714285714,0.0,1.0,35,650,300,350,0.46153846153846156,10,3,7,386.5095725218375,0.46411064425770304,0.16316171138506164,0.18754282213498039,123740.56218753189,2813.4198678706266,126553.98205540252,109,0,28.62857142857143,32,3,16,41.64868866328256,0.5651041666666667,51.26262626262626,994.949494949495,31.09217171717172,16
3037,4,10,9,36,0.2222222222222222,0.2,0.8,45,1000,700,300,0.7,13,7,6,317.9838395668299,0.4753577441077441,0.16937284808701003,0.16266639970729796,125946.55261289848,-990.2063239889825,124956.3462889095,110,0,23.044444444444444,42,3,13,41.07559449110272,0.5691964285714286,49.055232558139515,1003.7790697674387,23.899501661129495,0
3038,4,6,1,41,0.14285714285714285,0.023809523809523808,0.9761904761904762,42,1600,1000,600,0.625,22,10,12,341.11780931267975,0.47182297715834304,0.22880025920638292,0.17571490221221625,126231.65155416774,212.01044665492756,126443.66200082266,111,0,25.357142857142858,38,4,18,40.201511446594374,0.5783991228070176,48.77136752136753,1004.9145299145312,26.445119208277134,0
3039,4,2,3,40,0.046511627906976744,0.06976744186046512,0.9302325581395349,43,900,700,200,0.7777777777777778,11,7,4,330.86207298221103,0.4726375046142488,0.19725093625315027,0.16499664427274802,124890.37492305321,-315.47338397401666,124574.90153907919,112,0,25.72093023255814,37,6,18,41.84172517185898,0.5664414414414414,50.109649122807014,999.5614035087716,27.01517306780464,16
3040,4,4,2,42,0.09090909090909091,0.045454545454545456,0.9545454545454546,44,1450,800,650,0.5517241379310345,21,8,13,351.87450351416766,0.4757641825229035,0.21202208137395218,0.1698932079652313,123530.76562396715,90.2927537283619,123621.05837769552,113,0,25.65909090909091,40,4,17,42.72856607374087,0.5473958333333333,51.47357723577235,994.10569105691,24.85264227642275,16
3041,4,8,2,48,0.16,0.04,0.96,50,1400,900,500,0.6428571428571429,19,9,10,361.60377170448976,0.48324829931972785,0.3368416631667359,0.17254079768104044,123028.66753472245,-249.19755209364087,122779.46998262881,114,0,23.24,39,11,15,43.010639787204255,0.5438034188034189,51.97916666666668,992.0833333333353,25.438034188034237,16
3042,4,2,11,39,0.04,0.22,0.78,50,1450,1100,350,0.7586206896551724,18,11,7,330.91824025592086,0.4845663265306122,0.12913373564337172,0.16113052134546607,123888.14242683751,-1291.8200200183069,122596.3224068192,115,0,24.04,42,8,13,42.87826065797158,0.5481150793650793,51.11434108527133,995.5426356589162,23.703396087117053,16
3043,4,1,3,37,0.025,0.075,0.925,40,1200,800,400,0.6666666666666666,16,8,8,369.82496524039504,0.4805822649572649,0.17413121629718398,0.17787834783464535,123368.45415249429,1124.9468537414907,124493.40100623578,116,0,27.35,34,6,14,42.4518174555622,0.5566789215686274,51.63690476190476,993.4523809523806,29.219187675070017,0
3044,4,3,2,38,0.075,0.05,0.95,40,550,400,150,0.7272727272727273,7,4,3,361.8634127553789,0.48038194444444443,0.2038702928870293,0.176500725813338,123960.5034722223,971.3541666666758,124931.85763888898,117,0,28.05,34,6,17,42.032775453277544,0.5628063725490196,51.04166666666667,995.833333333334,29.28921568627453,0
3045,4,9,4,43,0.19148936170212766,0.0851063829787234,0.9148936170212766,47,1500,1100,400,0.7333333333333333,19,11,8,320.21130429890377,0.48622032069071847,0.2372400338878291,0.1640941068764156,126018.93310854446,-1329.462612591325,124689.47049595314,118,0,24.23404255319149,41,6,17,40.945291143826346,0.5713922764227642,48.983134920634924,1004.0674603174613,24.489450251645398,0
3046,4,5,7,41,0.10416666666666667,0.14583333333333334,0.8541666666666666,48,1300,800,500,0.6153846153846154,18,8,10,317.04253555859583,0.48478132387706857,0.2657022273573406,0.164804993709288,126603.94977014599,-1572.2325506279637,125031.71721951803,119,0,24.583333333333332,42,6,17,40.42440946145455,0.5758928571428572,48.401162790697676,1006.395348837209,23.961794019933546,0
3047,4,1,1,41,0.023809523809523808,0.023809523809523808,0.9761904761904762,42,1500,1300,200,0.8666666666666667,17,13,4,346.523252009151,0.48403019744483156,0.2550349362926432,0.17817486635006557,126156.9440005885,343.2628997240619,126500.20690031257,120,0,28.071428571428573,36,6,20,40.1426409595337,0.5813078703703703,48.84572072072073,1004.6171171171177,27.90603103103105,0
3048,4,3,1,43,0.06818181818181818,0.022727272727272728,0.9772727272727273,44,750,200,550,0.26666666666666666,13,2,11,336.28477432379907,0.4840446617336152,0.20553743056167884,0.16716952860551465,124757.86930623176,-409.16561504715634,124348.70369118461,121,0,27.40909090909091,42,2,15,41.84327513740705,0.5570436507936508,50.24224806201551,999.0310077519393,23.786452565522364,15
3049,4,4,5,42,0.0851063829787234,0.10638297872340426,0.8936170212765957,47,1450,1000,450,0.6896551724137931,19,10,9,323.95950263595205,0.4853723404255319,0.24162082145776753,0.1650650799145088,125782.47070312497,-1249.845197150487,124532.62550597449,122,0,26.48936170212766,43,4,15,41.09445309795777,0.5661337209302326,49.21875,1003.1249999999998,23.32848837209302,0
3050,4,2,1,43,0.045454545454545456,0.022727272727272728,0.9772727272727273,44,1550,1200,350,0.7741935483870968,19,12,7,338.6017719271555,0.48613680408738547,0.2446594477132309,0.172765648280972,125839.820512344,-278.08275910501237,125561.73775323898,123,0,26.227272727272727,40,4,18,40.668152199601614,0.57109375,49.16158536585367,1003.3536585365867,25.083841463414668,0
3051,4,2,4,41,0.044444444444444446,0.08888888888888889,0.9111111111111111,45,1750,1500,250,0.8571428571428571,20,15,5,340.8917789468718,0.48558501683501687,0.24239579513506926,0.1671362605516215,124178.98415858723,-412.6567412450542,123766.32741734218,124,0,26.488888888888887,37,8,19,42.32810781078107,0.5591216216216216,50.82236842105263,996.7105263157893,26.93812233285917,16
3052,4,5,7,39,0.10869565217391304,0.15217391304347827,0.8478260869565217,46,1400,900,500,0.6428571428571429,19,9,10,325.3136933384819,0.484158615136876,0.2509699436622401,0.1628711037669394,125054.83057286874,-1058.1799207448253,123996.65065212392,125,0,26.282608695652176,37,9,17,41.81054958707885,0.5681306306306306,49.9451754385965,1000.2192982456154,27.032954006638253,0
3053,4,9,10,38,0.1875,0.20833333333333334,0.7916666666666666,48,1400,1000,400,0.7142857142857143,18,10,8,306.49418809993426,0.48535387115839246,0.261203665319377,0.1580631972729168,126279.2982313371,-1855.3303735884738,124423.96785774863,126,0,24.791666666666668,39,9,11,41.0224936953743,0.577190170940171,48.72395833333335,1005.1041666666691,25.77190170940177,0
3054,4,2,0,40,0.05,0.0,1.0,40,1350,1200,150,0.8888888888888888,15,12,3,355.9891196006521,0.4840277777777778,0.26539010466222646,0.1790165381341078,125238.20861678003,916.687925170064,126154.89654195009,127,0,29.125,34,6,18,40.85370084046938,0.5759803921568627,49.76190476190476,1000.9523809523808,29.439775910364144,0
3055,4,1,1,40,0.024390243902439025,0.024390243902439025,0.975609756097561,41,1400,1000,400,0.7142857142857143,18,10,8,346.1831385527763,0.48318089430894307,0.2667559793530083,0.1762645757167075,125753.44676997612,506.74457733197414,126260.1913473081,128,0,29.390243902439025,35,6,19,40.56706285098855,0.5791666666666666,49.24768518518519,1003.0092592592603,28.657407407407437,0
3056,4,2,2,40,0.047619047619047616,0.047619047619047616,0.9523809523809523,42,1150,800,350,0.6956521739130435,15,8,7,335.42233715726735,0.4825421022067364,0.2616140219716323,0.17361702462790377,126429.50234687599,81.45583256387135,126510.95817943985,129,0,28.976190476190474,37,5,17,40.14119058002617,0.5822072072072072,48.574561403508774,1005.7017543859652,27.181128496917978,0
3057,4,3,0,43,0.06976744186046512,0.0,1.0,43,1150,900,250,0.782608695652174,14,9,5,331.90967907295385,0.4808739387227759,0.27947884502120535,0.17449758447974728,127065.08333561609,-165.17379373951462,126899.90954187658,130,0,28.953488372093023,38,5,20,39.577372752640315,0.5868969298245614,47.94337606837606,1008.2264957264949,26.532276203328813,0
3058,4,2,5,40,0.044444444444444446,0.1111111111111111,0.8888888888888888,45,1450,1100,350,0.7586206896551724,18,11,7,321.16541835660144,0.4813131313131313,0.19158670865987992,0.15869965460813137,124507.06587603847,-748.1087543575688,123758.9571216809,131,0,28.622222222222224,37,8,13,42.480132571595966,0.5625,50.49342105263156,998.0263157894711,26.973684210526248,16
3059,4,7,4,43,0.14893617021276595,0.0851063829787234,0.9148936170212766,47,900,300,600,0.3333333333333333,15,3,12,322.4680238561653,0.4839654640764724,0.2504316809577076,0.16300715146626762,125454.47216971657,-1204.245087789619,124250.22708192695,132,0,27.27659574468085,38,9,18,41.46959759695708,0.5704495614035088,49.54594017094017,1001.8162393162394,26.363585245164195,15
3060,4,5,2,46,0.10416666666666667,0.041666666666666664,0.9583333333333334,48,1600,1100,500,0.6875,21,11,10,324.18132612976234,0.48396867612293143,0.2806551843359908,0.16634043507128785,126071.3648069595,-1423.2412996133648,124648.12350734613,133,0,27.5625,37,11,22,40.79173035629799,0.5785472972972974,48.93092105263156,1004.2763157894709,27.14260312944516,0
3061,4,4,5,45,0.08,0.1,0.9,50,1200,500,700,0.4166666666666667,19,5,14,310.2982749154377,0.4850340136054421,0.29898759705556177,0.16273019525840254,126963.95503874993,-2120.6607550069475,124843.29428374299,134,0,26.38,40,10,21,40.22553863735674,0.5825520833333333,48.043699186991866,1007.8252032520313,25.195630081300784,0
3062,4,1,3,43,0.021739130434782608,0.06521739130434782,0.9347826086956522,46,1750,1400,350,0.8,21,14,7,319.2188998843714,0.48537640901771334,0.2860898696380456,0.16805439438357136,127120.40323685184,-1084.088396130005,126036.31484072184,135,0,26.543478260869566,36,10,23,39.840638377070555,0.5911458333333333,47.88851351351352,1008.445945945947,28.012387387387417,0
3063,4,1,4,40,0.022727272727272728,0.09090909090909091,0.9090909090909091,44,1550,1200,350,0.7741935483870968,19,12,7,352.49942404282785,0.4838134249471459,0.20214028017031227,0.17512271563903886,124732.28635204065,172.63480386065038,124904.9211559013,136,0,27.75,34,10,18,41.46481349064473,0.5707720588235294,50.26785714285713,998.9285714285701,29.380252100840295,16
3064,4,2,4,38,0.047619047619047616,0.09523809523809523,0.9047619047619048,42,1050,800,250,0.7619047619047619,13,8,5,353.81944444444446,0.48274777390631046,0.1990079365079367,0.17690972222222212,124999.99999999988,445.4861111110966,125445.48611111098,137,0,29.071428571428573,33,9,20,41.15451388888889,0.5757575757575757,49.99999999999999,999.9999999999991,30.303030303030276,0
3065,4,2,0,40,0.05,0.0,1.0,40,1400,1000,400,0.7142857142857143,18,10,8,368.411768087101,0.4817174145299145,0.2115156839776129,0.184638461462048,125097.67532348624,1217.4911499023303,126315.16647338857,138,0,29.65,31,9,23,40.68845177664974,0.5816532258064516,49.90234374999999,1000.3906249999993,32.270665322580626,0
3066,4,3,2,41,0.06976744186046512,0.046511627906976744,0.9534883720930233,43,1250,800,450,0.64,17,8,9,340.0959155663079,0.4824658545588778,0.2172056131787672,0.1745201019452656,126074.60359296898,-20.943829610879845,126053.6597633581,139,0,28.511627906976745,33,10,24,40.38882957087653,0.5868055555555556,48.92769607843137,1004.289215686274,30.433006535947698,0
3067,4,2,6,37,0.046511627906976744,0.13953488372093023,0.8604651162790697,43,1350,1100,250,0.8148148148148148,16,11,5,325.87482607940285,0.48228128460686603,0.18872174617909643,0.16912417093183552,126538.26845689715,-352.87275484398174,126185.39570205317,140,0,28.41860465116279,35,8,18,40.26958951646919,0.587202380952381,48.466435185185176,1006.134259259258,28.746693121693085,0
3068,4,4,5,36,0.0975609756097561,0.12195121951219512,0.8780487804878049,41,1100,600,500,0.5454545454545454,16,6,10,338.92845489777386,0.4823678861788618,0.21274568862862675,0.1774126398006687,126887.86175679431,401.1813861025213,127289.04314289683,141,0,29.634146341463413,35,6,21,39.582256366073125,0.5907738095238095,48.119212962962955,1007.5231481481474,28.78637566137564,0
3069,4,1,2,35,0.02702702702702703,0.05405405405405406,0.9459459459459459,37,700,300,400,0.42857142857142855,11,3,8,351.36647159126073,0.4792605105105105,0.19573000748586633,0.18383954602142089,126869.31060924908,1515.524404397511,128384.83501364659,142,0,30.08108108108108,32,5,22,39.288026903956215,0.5973307291666667,48.13762626262626,1007.4494949494951,31.482796717171723,0
3070,4,0,1,34,0.0,0.02857142857142857,0.9714285714285714,35,950,700,250,0.7368421052631579,12,7,5,372.01332078541384,0.4790266106442577,0.20059929382574637,0.19296740859867104,126516.6696475026,2413.177282055723,128929.84692955832,143,1,32.34285714285714,30,5,22,39.131318191939414,0.5989583333333333,48.48790322580645,1006.0483870967741,33.534946236559136,0
3071,4,1,1,34,0.02857142857142857,0.02857142857142857,0.9714285714285714,35,1250,800,450,0.64,17,8,9,373.2514012049647,0.4788515406162465,0.2052305285847813,0.19425154576956105,126651.92733625285,2454.601868713157,129106.529204966,144,0,33.17142857142857,30,5,23,38.96075354965059,0.6003472222222221,48.35349462365592,1006.5860215053772,33.55286738351257,0
3072,4,1,0,35,0.02857142857142857,0.0,1.0,35,1200,900,300,0.75,15,9,6,371.41084702966583,0.4779761904761905,0.19841079288858365,0.1945819091671143,126922.65950182106,2428.0904945658485,129350.74999638692,145,0,33.8,30,5,24,38.728269085411924,0.603125,48.08467741935484,1007.6612903225811,33.58870967741937,0
3073,4,0,0,35,0.0,0.0,1.0,35,1000,300,700,0.3,17,3,14,374.14857595043844,0.4776260504201681,0.19854876492658136,0.1966705303576901,127058.13397863909,2507.7239782055635,129565.85795684466,146,1,34.8,30,5,24,38.51986401813091,0.6045138888888889,47.9502688172043,1008.1989247311823,33.60663082437274,0
3074,4,3,1,37,0.07894736842105263,0.02631578947368421,0.9736842105263158,38,1000,600,400,0.6,14,6,8,344.3497873929911,0.47786273115220484,0.19424712738959093,0.18480254519777284,127896.48963139165,1208.2258025759124,129104.71543396756,147,0,32.973684210526315,33,5,20,38.41218399160001,0.6054292929292929,47.12009803921568,1011.5196078431363,30.65210932857989,0
3075,4,3,2,38,0.075,0.05,0.95,40,600,300,300,0.5,9,3,6,327.4382493856622,0.4784455128205128,0.19554628958182274,0.17847325925012947,128517.04422577833,416.75977989232103,128933.80400567065,148,0,32.25,33,7,18,38.207034082668606,0.6117424242424243,46.50735294117646,1013.9705882352923,30.726381461675526,0
3076,4,2,2,38,0.05,0.05,0.95,40,1400,1100,300,0.7857142857142857,17,11,6,330.6294431662606,0.4779513888888889,0.2081382015691009,0.18176940521781457,128858.98940611763,520.9151828623345,129379.90458897996,149,0,33.1,33,7,20,37.77798732649368,0.6152146464646464,46.17034313725489,1015.3186274509787,30.767231134878145,0
3077,4,1,3,36,0.02564102564102564,0.07692307692307693,0.9230769230769231,39,1400,900,500,0.6428571428571429,19,9,10,361.11137401799914,0.4749493927125506,0.13860424162377938,0.18651899410287448,126342.87308673447,1332.3726947886698,127675.24578152315,150,0,34.46153846153846,34,5,16,39.58456680481546,0.5873161764705883,48.66071428571427,1005.3571428571411,29.569327731092386,16
3078,4,3,2,37,0.07692307692307693,0.05128205128205128,0.9487179487179487,39,1850,1400,450,0.7567567567567568,23,14,9,343.80005468724966,0.47376855600539813,0.156514006224989,0.18180867520797367,127302.17013888904,955.5130385487721,128257.68317743781,151,0,34.43589743589744,34,5,21,39.0345444536196,0.5971200980392157,47.70833333333334,1009.1666666666679,29.681372549019642,0
3079,4,1,2,36,0.02631578947368421,0.05263157894736842,0.9473684210526316,38,800,400,400,0.5,12,4,8,389.8326289776199,0.47369902797534374,0.23360732784047844,0.18918416704538515,123747.02826136572,2210.973093281418,125958.00135464713,152,0,35.26315789473684,33,5,20,41.559279673194574,0.5628156565656566,51.25612745098039,994.9754901960775,30.15077243018417,16
3080,4,4,0,40,0.1,0.0,1.0,40,1050,600,450,0.5714285714285714,15,6,9,364.4602356129325,0.4768830128205128,0.2396012269938652,0.18089835080666242,124693.81517925783,1089.555399365612,125783.37057862343,153,0,34.15,33,7,20,41.206032719836394,0.5726010101010102,50.3063725490196,998.7745098039204,30.26589423648244,0
3081,4,4,4,40,0.09090909090909091,0.09090909090909091,0.9090909090909091,44,1200,700,500,0.5833333333333334,17,7,10,331.1626487705293,0.48035588442565186,0.23992229364821327,0.16897286652099572,125840.52861636225,-464.51253103404133,125376.01608532821,154,0,31.954545454545453,35,9,18,40.854024877917496,0.5800595238095239,49.160879629629626,1003.356481481481,28.667328042328027,0
3082,4,0,0,40,0.0,0.0,1.0,40,1250,900,350,0.72,16,9,7,362.62375164720885,0.4789529914529915,0.25735224164585535,0.18248372995819137,125268.00063775507,1085.0304705215358,126353.03110827661,155,1,35.7,34,6,18,40.65683592975778,0.5762867647058824,49.732142857142854,1001.0714285714283,29.443277310924362,0
3083,4,8,7,41,0.16666666666666666,0.14583333333333334,0.8541666666666666,48,2000,1600,400,0.8,24,16,8,303.29278111470387,0.48224179964539005,0.23855434974413336,0.16030220020304273,127280.60766171721,-1869.761605195462,125410.84605652174,156,0,30.583333333333332,38,10,18,40.07852479265929,0.5890899122807017,47.729700854700845,1009.0811965811947,26.554768331084073,0
3084,4,1,4,38,0.023809523809523808,0.09523809523809523,0.9047619047619048,42,1300,1100,200,0.8461538461538461,15,11,4,362.17346555264555,0.4810177119628339,0.2585505071178422,0.1780261119406665,124286.73469387746,700.5517403926137,124987.28643427008,157,0,33.11904761904762,34,8,18,41.68581860872334,0.5661764705882353,50.71428571428571,997.1428571428564,29.327731092436952,16
3085,4,4,3,39,0.09523809523809523,0.07142857142857142,0.9285714285714286,42,1000,700,300,0.7,13,7,6,350.25921045198396,0.4834494773519164,0.26418879858537125,0.17538008857077259,125059.53089569137,362.691326530582,125422.22222222194,158,0,33.023809523809526,34,8,22,41.181911052923894,0.5741421568627452,49.940476190476176,1000.2380952380933,29.41876750700274,0
3086,4,3,2,40,0.07142857142857142,0.047619047619047616,0.9523809523809523,42,850,400,450,0.47058823529411764,13,4,9,379.9122892628118,0.4848891792489354,0.2599090061768381,0.18072313686499752,122898.16488005915,974.7294914329864,123872.89437149213,159,0,33.523809523809526,37,5,18,42.69312820229275,0.5458896396396397,52.11074561403508,991.5570175438588,26.798838311996185,16
3087,4,5,3,42,0.1111111111111111,0.06666666666666667,0.9333333333333333,45,600,200,400,0.3333333333333333,10,2,8,372.12264928685516,0.4852693602693603,0.31020203161688076,0.18223095315657908,124128.77562951473,251.94393127874662,124380.71956079347,160,0,32.08888888888889,36,9,20,41.60215843598149,0.560474537037037,50.87274774774775,996.5090090090097,27.680805805805825,0
3088,4,5,2,45,0.10638297872340426,0.0425531914893617,0.9574468085106383,47,1400,1000,400,0.7142857142857143,18,10,8,335.85148956471625,0.48616250385445575,0.1767710655613517,0.16690698394444692,124746.06405743927,-513.2045050048357,124232.85955243444,161,0,30.70212765957447,40,7,18,41.86631061376739,0.5598958333333333,50.2540650406504,998.9837398373977,24.974593495934943,16
3089,4,3,5,43,0.0625,0.10416666666666667,0.8958333333333334,48,1200,800,400,0.6666666666666666,16,8,8,317.7891750711096,0.4850768321513002,0.18292719004631985,0.16075338517322055,125483.18962133977,-1624.0437446295232,123859.14587671024,162,0,30.354166666666668,40,8,13,41.55720661324677,0.5674479166666666,49.517276422764226,1001.9308943089427,25.04827235772357,0
3090,4,2,9,36,0.044444444444444446,0.2,0.8,45,1150,500,650,0.43478260869565216,18,5,13,315.423195784881,0.4841750841750842,0.19053597947887146,0.1612380684043214,125916.30725758504,-1056.6151926762866,124859.69206490876,163,0,32.266666666666666,40,5,15,41.170936276495205,0.571875,49.08536585365855,1003.658536585368,25.091463414634198,0
3091,4,3,0,39,0.07692307692307693,0.0,1.0,39,1050,800,250,0.7619047619047619,13,8,5,341.85464224755106,0.48220310391363025,0.1973433188106164,0.17442836336927714,125840.52861636224,803.8337780778392,126644.36239444008,161,0,32.23076923076923,35,4,18,40.58582785403932,0.5800595238095239,49.160879629629626,1003.3564814814808,28.667328042328023,0
3092,4,2,1,40,0.04878048780487805,0.024390243902439025,0.975609756097561,41,1450,1000,450,0.6896551724137931,19,10,9,330.43402783259154,0.4817581300813008,0.19206429807750136,0.1714342395270829,126524.89271365936,161.79008410075173,126686.6827977601,162,0,31.609756097560975,36,5,16,40.168644131035016,0.5850694444444444,48.47972972972972,1006.081081081079,27.946696696696637,0
3093,4,4,3,41,0.09090909090909091,0.06818181818181818,0.9318181818181819,44,1000,600,400,0.6,14,6,8,315.79005355517546,0.48003655743481327,0.21820009937468976,0.1679767498258108,127538.8034396699,-744.9028862847459,126793.90055338515,163,0,30.25,39,5,13,39.49943711113403,0.5900106837606838,47.47395833333332,1010.1041666666647,25.90010683760679,0
3094,4,1,3,39,0.023809523809523808,0.07142857142857142,0.9285714285714286,42,1450,1200,250,0.8275862068965517,17,12,5,332.6899126982981,0.48023132017034453,0.22276454307958948,0.17610181980378548,127340.90206842464,73.00671841332803,127413.90878683796,164,0,32.54761904761905,37,5,13,39.27519011406842,0.5914977477477478,47.66995614035086,1009.3201754385943,27.27892366050255,0
3095,4,1,3,37,0.025,0.075,0.925,40,1150,900,250,0.782608695652174,14,9,5,350.0443958745989,0.4796875,0.23409090909090935,0.18415379087315847,127092.01388888883,897.5694444444398,127989.58333333327,165,0,34.9,35,5,21,39.0926308539945,0.5928571428571429,47.916666666666664,1008.3333333333328,28.809523809523796,0
3096,4,1,3,35,0.02631578947368421,0.07894736842105263,0.9210526315789473,38,1250,900,350,0.72,16,9,7,346.6258009967959,0.47898885727833096,0.19454443892750728,0.18371167452830206,127392.29024943337,1231.4909297052475,128623.78117913862,166,0,35.10526315789474,34,4,15,38.87087264150943,0.5980392156862745,47.619047619047635,1009.5238095238117,29.691876750700345,0
3097,4,2,3,34,0.05405405405405406,0.08108108108108109,0.9189189189189189,37,1450,1200,250,0.8275862068965517,17,12,5,341.6925304189941,0.4778215715715716,0.15872611870257458,0.18313426157156845,127843.36911848096,1336.6248582766661,129179.99397675763,167,0,31.756756756756758,34,3,18,38.533696291936415,0.6026348039215687,47.17261904761906,1011.3095238095257,29.744397759103695,0
3098,4,2,4,32,0.05555555555555555,0.1111111111111111,0.8888888888888888,36,1100,800,300,0.7272727272727273,14,8,6,339.95408767833203,0.47452050264550266,0.13251740731779482,0.18414551040295507,128268.64216887743,1521.089845251837,129789.73201412926,168,0,29.083333333333332,33,3,20,38.14319703201872,0.6092171717171717,46.75245098039216,1012.990196078432,30.696672608437332,0
3099,4,1,1,32,0.030303030303030304,0.030303030303030304,0.9696969696969697,33,1150,800,350,0.6956521739130435,15,8,7,368.58638928129886,0.473208648989899,0.12030262787234869,0.198530437145077,128042.48504162315,2838.9434472193057,130881.42848884246,169,0,30.393939393939394,30,3,21,37.64967906153164,0.6145833333333333,46.97580645161289,1012.096774193547,33.7365591397849,0
3100,4,1,1,32,0.030303030303030304,0.030303030303030304,0.9696969696969697,33,700,400,300,0.5714285714285714,10,4,6,369.4745047123426,0.47277462121212116,0.11910450402619244,0.1996858621594536,128178.5556856281,2871.7416753381517,131050.29736096626,170,0,31.03030303030303,30,3,22,37.4878329351385,0.6159722222222221,46.841397849462346,1012.6344086021481,33.75448028673827,0
3101,4,0,0,32,0.0,0.0,1.0,32,1150,800,350,0.6956521739130435,15,8,7,379.2022228692995,0.4724672379032258,0.12385560965573972,0.20494910355374787,128179.68991126528,3321.20466820985,131500.89457947513,171,1,32.6875,29,3,24,37.24040483701367,0.6188936781609196,46.840277777777764,1012.6388888888877,34.918582375478884,0
3102,4,0,0,32,0.0,0.0,1.0,32,1000,600,400,0.6,14,6,8,378.8169797437674,0.4714801747311828,0.12135074013157898,0.2056435032894736,128355.55555555543,3324.6527777777596,131680.2083333332,172,2,33.6875,29,3,24,37.069969846491226,0.6206896551724138,46.66666666666666,1013.3333333333323,34.94252873563215,0
3103,4,0,1,31,0.0,0.03125,0.96875,32,950,700,250,0.7368421052631579,12,7,5,381.4152964474112,0.4700730846774193,0.12990447822514373,0.20815354967556055,128566.75347222235,3407.465277777798,131974.21875000015,173,3,34.6875,29,3,21,36.78786633798959,0.6228448275862069,46.45833333333334,1014.1666666666678,34.97126436781613,0
3104,4,0,0,31,0.0,0.0,1.0,31,1300,1200,100,0.9230769230769231,14,12,2,389.05349542538556,0.4692204301075269,0.11741258965017587,0.21201162295111564,128508.47463750176,3799.334249900924,132307.80888740267,174,4,34.70967741935484,28,3,21,36.653913372065546,0.6253720238095238,46.515804597701155,1013.9367816091963,36.212027914614154,0
3105,4,2,3,30,0.06060606060606061,0.09090909090909091,0.9090909090909091,33,1100,800,300,0.7272727272727273,14,8,6,366.5857090684565,0.46942077020202017,0.10580013304160363,0.20293712532764777,129133.07354896527,2867.66786622732,132000.7414151926,175,0,33.54545454545455,30,3,23,36.5856144758882,0.6256944444444444,45.90053763440861,1016.3978494623661,33.87992831541221,0
3106,4,4,0,34,0.11764705882352941,0.0,1.0,34,900,600,300,0.6666666666666666,12,6,6,372.5333033855136,0.4696041295306001,0.11912907554598706,0.19476216870312094,126837.51179726543,2932.5155827953186,129770.02738006074,176,0,28.441176470588236,32,2,20,38.78765563633324,0.5970052083333333,48.16919191919191,1007.3232323232311,31.47885101010097,16
3107,4,1,0,35,0.02857142857142857,0.0,1.0,35,1050,700,350,0.6666666666666666,14,7,7,361.16549102180363,0.46978291316526616,0.11999356257711513,0.19045221833486375,127187.51793503201,2187.4035493826987,129374.9214844147,177,0,28.6,32,3,21,38.71416948303918,0.6005859375,47.82196969696969,1008.7121212121201,31.522253787878753,0
3108,4,3,1,37,0.07894736842105263,0.02631578947368421,0.9736842105263158,38,1050,800,250,0.7619047619047619,13,8,5,335.4487646869925,0.4708837126600285,0.12408078279393897,0.1808776138071784,128085.94419795946,993.2543509945051,129079.19854895397,178,0,27.263157894736842,35,3,22,38.44376476865615,0.6029761904761906,46.93287037037037,1012.2685185185179,28.921957671957653,0
3109,4,1,2,36,0.02631578947368421,0.05263157894736842,0.9473684210526316,38,850,700,150,0.8235294117647058,10,7,3,334.2718438519943,0.47094298245614036,0.14042817653933914,0.18132489885432232,128325.3985969385,979.1269163271967,129304.52551326569,179,0,28.026315789473685,34,4,23,38.229203383856174,0.6075367647058824,46.696428571428555,1013.2142857142834,29.80042016806716,0
3110,4,0,0,36,0.0,0.0,1.0,36,1250,800,450,0.64,17,8,9,340.2641879241818,0.4688657407407408,0.14074342847927745,0.18460002006280382,128330.7201557091,1533.2696559015399,129863.98981161065,180,1,29.61111111111111,33,3,23,38.0719843573617,0.6098484848484849,46.69117647058822,1013.2352941176451,30.704099821746823,0
3111,4,0,3,33,0.0,0.08333333333333333,0.9166666666666666,36,1300,900,400,0.6923076923076923,17,9,8,340.7953798761911,0.4676752645502646,0.1344994912733819,0.18584475325130564,128536.57171201808,1560.9339569160902,130097.50566893417,181,2,30.61111111111111,34,2,18,37.84852664944822,0.6096813725490196,46.488095238095234,1014.0476190476186,29.82492997198878,0
3112,4,0,0,33,0.0,0.0,1.0,33,1600,1300,300,0.8125,19,13,6,353.5240986005525,0.4650410353535353,0.12182338891341482,0.19274623461378404,128528.34093778701,2487.5731749311367,131015.91411271815,182,3,32.03030303030303,32,1,19,37.5342423110447,0.6142578125,46.496212121212125,1014.015151515152,31.6879734848485,0
3113,4,1,1,33,0.029411764705882353,0.029411764705882353,0.9705882352941176,34,750,500,250,0.6666666666666666,10,5,5,349.62009472005263,0.464572192513369,0.1387132486002003,0.1928144354713583,128983.44574502594,2219.0409037389454,131202.48664876487,183,0,32.05882352941177,33,1,20,37.16911469015161,0.6164772727272727,46.04779411764706,1015.8088235294117,30.782085561497325,0
3114,4,0,1,32,0.0,0.030303030303030304,0.9696969696969697,33,800,500,300,0.625,11,5,6,360.00779683671215,0.4635416666666667,0.145228403437359,0.19770919990212857,128816.57483930199,2674.994260789699,131491.5691000917,184,1,33.878787878787875,32,1,20,37.075559701492544,0.6171875,46.212121212121204,1015.1515151515141,31.723484848484816,0
3115,4,0,2,30,0.0,0.0625,0.9375,32,1050,600,450,0.5714285714285714,15,6,9,393.1080466205067,0.46295362903225806,0.045134106872331436,0.20698749285797682,127127.02787422847,3778.765599492409,130905.79347372089,185,2,35.34375,29,3,23,37.970980810723965,0.608117816091954,47.88194444444445,1008.4722222222229,34.774904214559406,16
3116,4,3,3,30,0.09090909090909091,0.09090909090909091,0.9090909090909091,33,1300,800,500,0.6153846153846154,18,8,10,363.84855901906855,0.4645280934343434,0.08261558897887489,0.19696436608276488,128243.42727661121,2732.23724365233,130975.66452026354,186,0,34.63636363636363,31,2,22,37.56387389124566,0.6139112903225806,46.77734374999999,1012.8906249999991,32.67389112903223,0
3117,4,2,2,30,0.0625,0.0625,0.9375,32,1000,700,300,0.7,13,7,6,358.4755247725271,0.46196656586021506,0.08515835579514808,0.19599177638615853,128639.39285278322,2822.8147718641494,131462.20762464736,187,0,34.4375,31,1,20,37.295303341462365,0.6179435483870968,46.38671875,1014.4531250000001,32.72429435483871,0
3118,4,0,0,30,0.0,0.0,1.0,30,1450,900,550,0.6206896551724138,20,9,11,373.278126567975,0.45950670498084295,0.0733059548254622,0.20425443554899297,128672.41753472215,3606.1197916666615,132278.53732638882,188,1,35.43333333333333,29,1,21,36.88612251882274,0.6239224137931034,46.354166666666664,1014.5833333333327,34.985632183908024,0
3119,4,0,1,29,0.0,0.03333333333333333,0.9666666666666667,30,1250,1000,250,0.8,15,10,5,405.9390150750585,0.4580699233716475,0.03167105323913755,0.20622616114193162,125660.59268904332,4202.107445987671,129862.70013503099,189,2,36.43333333333333,29,1,19,39.165021701990106,0.5930316091954023,49.340277777777786,1002.6388888888897,34.57375478927206,16
3120,4,3,0,32,0.09375,0.0,1.0,32,900,600,300,0.6666666666666666,12,6,6,446.665987944711,0.45940440188172044,0.03853687839531972,0.21948084376831456,124271.89670138873,4909.370177469114,129181.26687885784,190,0,35.0,29,3,18,39.595086363003205,0.5786637931034483,50.72916666666666,997.083333333332,34.38218390804593,16
3121,4,2,1,33,0.058823529411764705,0.029411764705882353,0.9705882352941176,34,550,200,350,0.36363636363636365,9,2,7,437.863770413126,0.46496212121212116,-0.03726668165900959,0.1999323101312802,121132.53699849694,3965.33174897387,125097.86874747081,191,0,33.88235294117647,30,4,13,43.12192790824685,0.5430555555555556,53.89784946236559,984.4086021505377,32.81362007168459,16
3122,4,8,5,36,0.1951219512195122,0.12195121951219512,0.8780487804878049,41,1000,700,300,0.7,13,7,6,381.7058312956253,0.476244918699187,0.08460512545802468,0.18494830542151716,123680.30350874523,1246.6769834719992,124926.98049221723,192,0,28.804878048780488,36,5,16,41.83105966262879,0.5558449074074074,51.3231981981982,994.7072072072073,27.630755755755757,0
3123,4,4,3,37,0.1,0.075,0.925,40,1050,800,250,0.7619047619047619,13,8,5,388.79201382229695,0.47434561965811967,0.11257547607988849,0.1906763566650126,124191.12761488339,1657.2207608634615,125848.34837574685,193,0,29.975,35,5,15,41.12188419259947,0.5630952380952381,50.81018518518518,996.7592592592591,28.478835978835974,0
3124,4,8,8,37,0.17777777777777778,0.17777777777777778,0.8222222222222222,45,1050,700,350,0.6666666666666666,14,7,7,348.97898998305186,0.47775673400673396,0.13829160007103525,0.17732365029728983,125668.6267829097,-220.98111013708638,125447.64567277262,194,0,27.066666666666666,38,7,16,40.58448765760966,0.5726425438596492,49.33226495726496,1002.6709401709408,26.386077372919495,0
3125,4,5,2,40,0.11904761904761904,0.047619047619047616,0.9523809523809523,42,850,700,150,0.8235294117647058,10,7,3,376.12302547105025,0.4749927409988386,0.1785844392401763,0.19183532235563586,125823.72100069244,1065.0397237611455,126888.76072445359,195,0,29.738095238095237,37,5,20,39.74362477231327,0.5760135135135135,49.17763157894736,1003.28947368421,27.115931721194862,0
3126,4,4,4,40,0.09090909090909091,0.09090909090909091,0.9090909090909091,44,700,400,300,0.5714285714285714,10,4,6,356.30661382943606,0.47589631782945735,0.20353422430001533,0.1862748486676976,126836.65242522935,239.31709454739246,127075.96951977674,196,0,29.09090909090909,36,8,21,39.19717719396312,0.5882523148148149,48.17004504504505,1007.3198198198203,27.981106106106118,0
3127,4,0,1,39,0.0,0.025,0.975,40,1250,900,350,0.72,16,9,7,376.22979457720044,0.4746127136752137,0.1911557580778791,0.19489672191188043,126462.58680555574,1515.7986111111363,127978.38541666688,197,1,31.325,34,6,21,39.08105495719415,0.5885416666666667,48.54166666666668,1005.8333333333348,29.58333333333338,0
3128,4,0,2,37,0.0,0.05128205128205128,0.9487179487179487,39,1500,1300,200,0.8666666666666667,17,13,4,377.34994740044795,0.47351551956815113,0.18293114429268997,0.19625808269104655,126625.62157064478,1756.4343278463725,128382.05589849116,198,2,32.58974358974359,35,4,22,38.88473627721559,0.5880952380952381,48.37962962962963,1006.481481481482,28.75661375661377,0
3129,4,5,1,41,0.11904761904761904,0.023809523809523808,0.9761904761904762,42,1250,900,350,0.72,16,9,7,346.6837445462867,0.47358933410762677,0.18232634480195675,0.18617603185006112,127922.58795975722,470.59370000840084,128393.18165976561,199,0,30.166666666666668,37,5,24,38.32646867548233,0.5974099099099099,47.094298245614056,1011.6228070175468,27.341156946420185,0
3130,4,0,3,38,0.0,0.07317073170731707,0.926829268292683,41,1250,700,550,0.56,18,7,11,352.99146126076795,0.47372967479674793,0.18335920537997508,0.18917142633399592,127839.4088205028,825.2439452524201,128664.65276575522,200,1,31.902439024390244,37,4,24,38.252082655679644,0.5965653153153153,47.176535087719316,1011.2938596491255,27.33226647700339,0
3131,4,0,1,37,0.0,0.02631578947368421,0.9736842105263158,38,1400,800,600,0.5714285714285714,20,8,12,362.3410522028631,0.4720246562351826,0.15618732722640738,0.1943829622591053,127880.99500868077,1667.3068576389128,129548.30186631969,201,2,33.36842105263158,35,3,24,37.9730947476828,0.6008928571428571,47.13541666666668,1011.4583333333351,28.898809523809575,0
3132,4,0,2,35,0.0,0.05405405405405406,0.9459459459459459,37,750,600,150,0.8,9,6,3,362.2889463670684,0.4717842842842843,0.14542054410258665,0.19461008003965544,127933.68055555572,1869.7916666666858,129803.47222222241,202,3,34.351351351351354,34,3,24,37.92044206479956,0.6035539215686274,47.08333333333334,1011.666666666668,29.754901960784352,0
3133,4,0,0,35,0.0,0.0,1.0,35,1400,900,500,0.6428571428571429,19,9,10,379.9792183874705,0.47027310924369753,0.15337871780214396,0.20282774200915657,127679.65032980108,2703.1227472606715,130382.77307706175,203,4,36.94285714285714,33,2,24,37.73379713835333,0.603219696969697,47.33455882352941,1010.6617647058827,30.626114081996445,0
3134,4,4,2,37,0.10256410256410256,0.05128205128205128,0.9487179487179487,39,1000,600,400,0.6,14,6,8,346.3763261166142,0.471097615834458,0.16331684731137552,0.19037676270018403,128848.62075617275,1127.7119310414691,129976.33268721422,204,0,34.05128205128205,35,4,20,37.38885088919288,0.6107142857142858,46.18055555555555,1015.277777777777,29.00793650793649,0
3135,4,0,2,35,0.0,0.05405405405405406,0.9459459459459459,37,1400,900,500,0.6428571428571429,19,9,10,357.6633238907693,0.47009509509509506,0.11312594645927998,0.18194177780530446,125715.30612244907,1767.3264676240979,127482.63259007316,205,1,34.86486486486486,34,3,17,40.31858380816714,0.5808823529411764,49.28571428571429,1002.8571428571436,29.49579831932775,16
3136,4,3,3,35,0.07894736842105263,0.07894736842105263,0.9210526315789473,38,1250,900,350,0.72,16,9,7,365.68636212824407,0.47334340919867235,0.13410762241799024,0.18128706888485288,124643.11224489793,1652.0160147392226,126295.12825963715,206,0,33.8421052631579,34,4,17,41.228044031155605,0.5698529411764706,50.357142857142854,998.5714285714283,29.369747899159655,16
3137,4,4,1,38,0.10256410256410256,0.02564102564102564,0.9743589743589743,39,950,500,450,0.5263157894736842,14,5,9,348.00944556197567,0.4753992352676563,0.1544383937269953,0.17632614330726415,125550.3730093663,939.053344299381,126489.42635366568,207,0,32.53846153846154,35,4,17,40.7308628787004,0.5770833333333334,49.450231481481474,1002.199074074073,28.634259259259228,0
3138,4,3,3,38,0.07317073170731707,0.07317073170731707,0.926829268292683,41,1000,700,300,0.7,13,7,6,401.210033920612,0.476854674796748,0.214050212777678,0.1972634564334828,124297.16192121197,1774.821565281677,126071.98348649364,208,0,31.609756097560975,36,5,17,40.70181629964239,0.5622106481481481,50.70382882882884,997.1846846846865,27.699574574574626,16
3139,4,5,6,37,0.11627906976744186,0.13953488372093023,0.8604651162790697,43,1450,1100,350,0.7586206896551724,18,11,7,377.37965283249423,0.47955887781469175,0.2561814752915361,0.19255469160711539,125840.52861636225,903.8755005435477,126744.4041169058,209,0,30.302325581395348,35,8,18,39.69472161341178,0.5800595238095239,49.160879629629626,1003.356481481481,28.667328042328027,0
3140,4,3,3,37,0.075,0.075,0.925,40,1000,700,300,0.7,13,7,6,392.81499107674034,0.4782719017094017,0.26797560975609813,0.2023293295747028,126228.49384851965,1916.8889369473109,128145.38278546697,210,0,31.45,33,7,21,38.90599593495936,0.5883838383838385,48.77450980392156,1004.9019607843125,30.451574569221588,0
3141,4,2,3,36,0.05128205128205128,0.07692307692307693,0.9230769230769231,39,1200,900,300,0.75,15,9,6,394.3813835999198,0.4769455690508322,0.135170476245962,0.19748984329194486,125063.1392842568,2460.020716872168,127523.16000112897,211,0,32.56410256410256,32,7,18,40.07484431540856,0.5787760416666667,49.93686868686869,1000.2525252525261,31.25789141414144,15
3142,4,0,1,35,0.0,0.027777777777777776,0.9722222222222222,36,950,600,350,0.631578947368421,13,6,7,415.3392415677546,0.4754133597883598,0.13259400084495176,0.20303758463256383,124054.82380624412,3295.576822518093,127350.40062876222,212,1,36.05555555555556,32,4,17,40.60282002534854,0.568359375,50.94696969696969,996.2121212121201,31.131628787878753,16
3143,4,1,2,34,0.027777777777777776,0.05555555555555555,0.9444444444444444,36,1400,1000,400,0.7142857142857143,18,10,8,408.0771778296803,0.4750330687830688,0.1280827115214367,0.20204547558542751,124589.98324469422,2968.4657496683753,127558.4489943626,213,0,36.47222222222222,32,4,15,40.225169680873485,0.5738932291666667,50.41035353535352,998.3585858585842,31.198705808080756,0
3144,4,2,0,36,0.05555555555555555,0.0,1.0,36,900,600,300,0.6666666666666666,12,6,6,353.1446739651235,0.475297619047619,0.14730092377561,0.1731937319013466,124191.12761488352,1571.4870541838245,125762.61466906735,214,0,37.25,35,1,16,42.01017959436446,0.5630952380952381,50.81018518518519,996.7592592592601,28.478835978836003,16
3145,4,9,7,38,0.2,0.15555555555555556,0.8444444444444444,45,1300,1000,300,0.7692307692307693,16,10,6,295.35760433758776,0.479776936026936,0.18259922039115217,0.15239343059484006,126299.08954863194,-1506.6346536555054,124792.45489497643,215,0,30.6,40,5,10,41.28205776294948,0.57578125,48.70426829268293,1005.1829268292697,25.129573170731742,0
3146,4,1,1,38,0.02564102564102564,0.02564102564102564,0.9743589743589743,39,1200,700,500,0.5833333333333334,17,7,10,333.5348337363341,0.4744714349977508,0.20134822890728432,0.16943569553805762,125658.76038781146,582.3147506924986,126241.07513850396,216,0,36.12820512820513,37,2,21,40.98179133858265,0.5743243243243243,49.34210526315788,1002.631578947367,27.09815078236127,0
3147,4,4,1,41,0.09523809523809523,0.023809523809523808,0.9761904761904762,42,1000,600,400,0.6,14,6,8,315.5679984262074,0.47459349593495936,0.21738383317665866,0.16426970614208403,126661.46746475242,-404.7605997314256,126256.706865021,217,0,33.88095238095238,38,4,18,40.40255961225499,0.5827850877192983,48.344017094017076,1006.6239316239293,26.490103463787612,0
3148,4,1,0,42,0.023809523809523808,0.0,1.0,42,1550,1100,450,0.7096774193548387,20,11,9,314.9045516771443,0.473081204026326,0.21452203710268236,0.16481368094271306,126882.03124999988,-408.8541666666815,126473.1770833332,218,0,34.857142857142854,39,3,21,40.19334160463193,0.5833333333333333,48.12499999999999,1007.4999999999991,25.83333333333331,0
3149,4,3,1,44,0.06666666666666667,0.022222222222222223,0.9777777777777777,45,1550,1000,550,0.6451612903225806,21,10,11,304.63348546398515,0.47371632996633,0.24745592817763895,0.16368031005066971,127943.71712805447,-1204.6382905014345,126739.07883755304,219,0,33.46666666666667,41,4,17,39.36842191279334,0.5909552845528455,47.073412698412675,1011.7063492063455,24.675764614788914,0
3150,4,1,2,43,0.022222222222222223,0.044444444444444446,0.9555555555555556,45,1750,1300,450,0.7428571428571429,22,13,9,303.79829852549955,0.4740319865319866,0.2453350753987702,0.16394826210749422,128119.42087309434,-1215.507586136332,126903.913286958,220,0,34.422222222222224,41,4,19,39.210660623877196,0.5927337398373984,46.899801587301575,1012.4007936507915,24.692702284165644,0
3151,4,1,0,44,0.022727272727272728,0.0,1.0,44,1900,1600,300,0.8421052631578947,22,16,6,305.7227852061702,0.4730554087385483,0.24251846448436232,0.16583548250846133,128324.66310562505,-953.6428564660332,127371.02024915902,221,0,35.45454545454545,40,4,20,38.95310932798395,0.5963541666666667,46.69715447154472,1013.2113821138219,25.330284552845548,0
3152,4,0,3,41,0.0,0.06818181818181818,0.9318181818181819,44,1100,700,400,0.6363636363636364,15,7,8,332.1730450614464,0.4729893410852713,0.20353924227841436,0.16513291570279545,124759.7309541419,-332.1199958463884,124427.61095829551,222,1,36.45454545454545,38,6,15,41.94404341781627,0.5633223684210527,50.240384615384606,999.0384615384606,26.29048582995949,15
3153,4,3,4,40,0.06818181818181818,0.09090909090909091,0.9090909090909091,44,1650,1200,450,0.7272727272727273,21,12,9,332.32523145733745,0.473727096546864,0.24018414944632438,0.16740530497944425,125309.8764938927,-470.8109799488261,124839.06551394387,223,0,37.25,36,8,15,41.37189292543023,0.5726273148148149,49.690315315315324,1001.2387387387402,27.812187187187227,0
3154,4,3,2,41,0.06976744186046512,0.046511627906976744,0.9534883720930233,43,750,300,450,0.4,12,3,9,401.38254702549847,0.47473698781838314,0.24779276815246853,0.19782114912448456,124397.65721183442,1541.701973507159,125939.35918534157,224,0,38.16279069767442,37,6,18,40.5927126841064,0.5613738738738738,50.603070175438596,997.5877192982457,26.961830251303937,14
3155,4,1,4,38,0.023809523809523808,0.09523809523809523,0.9047619047619048,42,1350,700,650,0.5185185185185185,20,7,13,406.4044600151177,0.47511372435152927,0.2603414560770154,0.20102506325747815,124549.95536076635,1723.5314706598701,126273.48683142623,225,0,39.857142857142854,36,6,19,40.30864545728039,0.5648148148148149,50.45045045045046,998.1981981981997,27.72772772772777,0
3156,4,4,3,39,0.09523809523809523,0.07142857142857142,0.9285714285714286,42,800,300,500,0.375,13,3,10,377.02313848433926,0.47707365466511803,0.2527525381617497,0.19156313482051782,125666.39506440748,1078.262601138882,126744.65766554636,226,0,38.45238095238095,35,7,18,39.88382103967062,0.5782738095238096,49.33449074074073,1002.6620370370362,28.647486772486747,0
3157,4,1,2,38,0.025,0.05,0.95,40,1250,800,450,0.64,17,8,9,367.7332237153139,0.4765892094017094,0.1820924639230359,0.183278865629023,124866.48866106002,1183.5112818686612,126049.99994292868,227,0,39.325,38,2,16,40.94512738286121,0.5644188596491229,50.13354700854701,999.4658119658123,26.301731893837168,16
3158,4,6,6,38,0.13636363636363635,0.13636363636363635,0.8636363636363636,44,1000,600,400,0.6,14,6,8,338.2571200924869,0.47995947850599013,0.1995598275242545,0.1732369461202415,125994.03187200827,-276.25298681271363,125717.77888519556,228,0,36.38636363636363,41,3,17,40.517951251646906,0.5711382113821138,49.00793650793652,1003.9682539682557,24.4870305845916,0
3159,4,4,1,41,0.09523809523809523,0.023809523809523808,0.9761904761904762,42,1000,800,200,0.8,12,8,4,359.61860151601155,0.4764082462253194,0.24896437448218722,0.18629169615014002,126462.58680555563,695.6695641219549,127158.25636967759,229,0,38.095238095238095,39,3,16,39.49875724937863,0.579059829059829,48.54166666666667,1005.833333333334,25.790598290598307,0
3160,4,1,6,36,0.023809523809523808,0.14285714285714285,0.8571428571428572,42,950,700,250,0.7368421052631579,12,7,5,386.01242966322343,0.47673490127758417,0.19926303854875305,0.18706756206756203,123687.67313019381,1412.3639004308907,125100.0370306247,230,0,38.95238095238095,37,5,16,41.716269841269835,0.5540540540540541,51.315789473684205,994.7368421052624,26.884779516358446,15
3161,4,5,1,40,0.12195121951219512,0.024390243902439025,0.975609756097561,41,1200,800,400,0.6666666666666666,16,8,8,383.3487455006491,0.4747205284552845,0.26979851770225105,0.19154834028605042,124972.5892221646,1381.6170600569542,126354.20628222157,231,0,39.0,37,4,19,40.44474448952735,0.5672860360360361,50.02741228070176,999.8903508771938,27.024063537221455,0
3162,4,6,4,42,0.13043478260869565,0.08695652173913043,0.9130434782608696,46,1750,1400,350,0.8,21,14,7,346.3926607511967,0.47888486312399353,0.2807208750145962,0.1799630707251567,126581.5477639803,-416.8919988599516,126164.65576512035,232,0,35.28260869565217,36,10,17,39.70899544911967,0.5856481481481481,48.42342342342343,1006.3063063063072,27.952952952952977,0
3163,4,1,0,43,0.023255813953488372,0.0,1.0,43,1550,1200,350,0.7741935483870968,19,12,7,371.04654265255994,0.47623661867847916,0.3059279741773431,0.191510819447324,126312.95351473946,773.596938775537,127086.550453515,233,0,38.69767441860465,34,9,19,39.365723195957685,0.5870098039215687,48.690476190476204,1005.2380952380971,29.565826330532268,0
3164,4,2,0,45,0.044444444444444446,0.0,1.0,45,1550,1100,450,0.7096774193548387,20,11,9,360.34948466180504,0.476199494949495,0.3173387486703412,0.18906007208968684,126981.47506925212,151.5418205601731,127133.0168898123,234,0,37.93333333333333,37,8,21,38.94645706411371,0.5878378378378378,48.026315789473685,1007.8947368421057,27.240398293029884,0
3165,4,2,3,44,0.0425531914893617,0.06382978723404255,0.9361702127659575,47,1300,800,500,0.6153846153846154,18,8,10,337.7746509878771,0.4783186864014801,0.2228130444212777,0.16922120488535963,125082.25036790149,-768.9157962065467,124313.33457169494,235,0,37.276595744680854,37,10,15,41.47061913113373,0.5684121621621622,49.917763157894726,1000.3289473684197,27.035917496443776,16
3166,4,4,1,47,0.08333333333333333,0.020833333333333332,0.9791666666666666,48,1500,1100,400,0.7333333333333333,19,11,8,321.88697009850296,0.47825243794326244,0.26699147435215753,0.16548404482428763,126151.14239763666,-1471.354155125934,124679.78824251072,236,0,36.875,38,10,18,40.7673526179588,0.5775767543859649,48.85149572649572,1004.5940170940161,26.436684660368844,0
3167,4,1,3,45,0.020833333333333332,0.0625,0.9375,48,1700,1200,500,0.7058823529411765,22,12,10,318.88157959141404,0.47765218676122934,0.26903750518027336,0.1647668632878118,126357.8342013887,-1541.3628472222467,124816.47135416645,237,0,37.854166666666664,39,9,15,40.63061196297828,0.5779914529914529,48.64583333333332,1005.4166666666652,25.779914529914493,0
3168,4,1,1,45,0.021739130434782608,0.021739130434782608,0.9782608695652174,46,1100,700,400,0.6363636363636364,15,7,8,347.7847672143838,0.4773148148148148,0.2341236278771046,0.1753148907830035,125338.77088758699,-383.81347656248244,124954.9574110245,238,0,39.869565217391305,39,7,16,40.95506518950032,0.5675747863247863,49.66145833333334,1001.3541666666681,25.6757478632479,15
3169,4,3,3,45,0.0625,0.0625,0.9375,48,1400,1100,300,0.7857142857142857,17,11,6,331.33625872808614,0.4794529403073286,0.2662875481853224,0.17081148186173414,126264.14497730053,-1224.911962094128,125039.2330152064,239,0,39.041666666666664,37,11,22,40.4138482798749,0.5805180180180181,48.73903508771929,1005.0438596491214,27.16334755808436,0
3170,4,1,4,42,0.021739130434782608,0.08695652173913043,0.9130434782608696,46,1350,1000,350,0.7407407407407407,17,10,7,327.4305555555556,0.4788647342995169,0.11974637681159406,0.1637152777777778,124999.99999999999,-1011.5309518313327,123988.46904816866,240,0,40.78260869565217,42,4,17,41.81423611111112,0.5595238095238095,50.0,999.9999999999999,23.809523809523807,16
3171,4,4,7,39,0.08695652173913043,0.15217391304347827,0.8478260869565217,46,1550,1100,450,0.7096774193548387,20,11,9,327.1839417608947,0.47679146537842193,0.17104872549884842,0.1671074251086039,125881.1771262002,-962.7400548696921,124918.43707133051,173,0,36.26086956521739,44,2,16,40.9119917573968,0.5658143939393939,49.12037037037037,1003.518518518518,22.807239057239045,0
3172,4,3,0,42,0.07142857142857142,0.0,1.0,42,1050,900,150,0.8571428571428571,12,9,3,354.60464272729064,0.47547667440960123,0.23879580841868409,0.1832250541543797,126357.8342013891,561.519954561061,126919.35415595016,174,0,39.023809523809526,39,3,17,39.732697886448406,0.5779914529914529,48.64583333333334,1005.4166666666683,25.779914529914574,0
3173,4,0,2,40,0.0,0.047619047619047616,0.9523809523809523,42,1550,900,650,0.5806451612903226,22,9,13,352.53983632997495,0.475258904374758,0.23846316629873887,0.1830360209492964,126554.60048788752,523.1076285610477,127077.70811644857,175,1,40.023809523809526,40,2,17,39.58207083459584,0.5783854166666667,48.45020325203252,1006.1991869918701,25.154979674796753,0
3174,4,2,1,41,0.047619047619047616,0.023809523809523808,0.9761904761904762,42,1100,500,600,0.45454545454545453,17,5,12,332.7584049743339,0.47680749128919864,0.1714081160606109,0.16199000315077627,123878.62280942219,-143.4670612596592,123735.15574816254,176,0,38.11904761904762,37,5,18,42.84234221830597,0.5560247747747749,51.12390350877193,995.5043859649128,26.905523944997643,16
3175,4,5,5,41,0.10869565217391304,0.10869565217391304,0.8913043478260869,46,1400,1000,400,0.7142857142857143,18,10,8,317.15048005750094,0.47936795491143314,0.22235016622402237,0.15898271387893134,125106.860435386,-1249.3019217217586,123857.55851366425,177,0,35.630434782608695,38,8,22,41.96101203189522,0.5668859649122807,49.89316239316239,1000.4273504273498,26.327035537561837,0
3176,4,3,3,41,0.06818181818181818,0.06818181818181818,0.9318181818181819,44,1500,1200,300,0.8,18,12,6,363.16422985951544,0.47888037350246654,0.16750418760469032,0.17626751644400865,123753.12499999999,240.60502502008762,123993.73002502008,178,0,34.34090909090909,39,5,14,42.21628978224456,0.5512820512820513,51.25,994.9999999999999,25.51282051282051,16
3177,4,5,7,39,0.10869565217391304,0.15217391304347827,0.8478260869565217,46,1250,800,450,0.64,17,8,9,349.77564204563544,0.48017310789049916,0.11766941689070154,0.17715418587408516,125534.75874789964,404.0223902403231,125938.78113813997,179,0,32.82608695652174,38,8,16,40.702736318407965,0.5712719298245614,49.46581196581196,1002.136752136751,26.372019793072397,15
3178,4,2,2,39,0.04878048780487805,0.04878048780487805,0.9512195121951219,41,1500,1200,300,0.8,18,12,6,368.41628042178525,0.47703252032520327,0.1635779868191296,0.18679654499137302,125579.3734996567,1053.0971364882987,126632.470636145,180,0,34.41463414634146,35,6,18,40.18956889915318,0.5773809523809523,49.421296296296276,1002.3148148148118,28.63756613756605,0
3179,4,5,5,39,0.11363636363636363,0.11363636363636363,0.8863636363636364,44,1200,600,600,0.5,18,6,12,334.0120007937383,0.4774048625792812,0.17552932092494,0.17498474139943607,126921.7443795145,-319.60816547279853,126602.13621404169,181,0,31.59090909090909,36,8,18,39.67134182685142,0.5891203703703703,48.08558558558558,1007.6576576576564,27.990490490490455,0
3180,4,0,3,36,0.0,0.07692307692307693,0.9230769230769231,39,1200,700,500,0.5833333333333334,17,7,10,365.2551127571381,0.47565227170490326,0.18187609491957346,0.18969701017386856,126567.38281250012,1445.8767361111252,128013.25954861124,182,1,35.58974358974359,33,6,19,39.24905106970324,0.5918560606060606,48.43750000000001,1006.2500000000009,30.49242424242427,0
3181,4,1,1,36,0.02702702702702703,0.02702702702702703,0.972972972972973,37,800,400,400,0.5,12,4,8,364.6754578434336,0.47028278278278274,0.176868286423977,0.18996885771615804,126690.72780000503,1840.1998329969479,128530.92763300198,183,0,37.567567567567565,33,4,20,39.13661493203488,0.5931186868686869,48.31495098039217,1006.7401960784331,30.507278669043426,0
3182,4,2,0,38,0.05263157894736842,0.0,1.0,38,1150,600,550,0.5217391304347826,17,6,11,351.528441277051,0.47138750592697964,0.17728613569321516,0.18562015824442432,127242.10778061242,1345.8439625850535,128587.95174319748,184,0,37.10526315789474,34,4,23,38.90117994100294,0.5965073529411764,47.76785714285715,1008.9285714285729,29.674369747899203,0
3183,4,1,3,36,0.02564102564102564,0.07692307692307693,0.9230769230769231,39,1300,700,600,0.5384615384615384,19,7,12,342.2583240981358,0.471097615834458,0.17796333976340817,0.18280990485315118,127705.4548852239,941.6509934413739,128647.10587866527,185,0,37.12820512820513,35,4,19,38.66046891102713,0.5991071428571428,47.309027777777786,1010.7638888888899,28.878968253968285,0
3184,4,0,0,36,0.0,0.0,1.0,36,1350,1200,150,0.8888888888888888,15,12,3,359.758535747218,0.46946097883597887,0.1770321308561753,0.19166363535614106,127601.78330017348,1981.1661437608493,129582.94944393434,186,1,38.0,32,4,20,38.32453344997085,0.6048177083333333,47.411616161616166,1010.3535353535357,31.57354797979799,0
3185,4,3,2,37,0.07692307692307693,0.05128205128205128,0.9487179487179487,39,1550,1100,450,0.7096774193548387,20,11,9,337.5963400992976,0.4700292397660819,0.17531697747609498,0.18465956420579022,128657.3200113378,887.9999001819772,129545.31991151978,187,0,36.0,34,5,16,37.80655949307672,0.610906862745098,46.36904761904761,1014.523809523809,29.838935574229676,0
3186,4,1,0,38,0.02631578947368421,0.0,1.0,38,1550,1400,150,0.9032258064516129,17,14,3,384.0920224902584,0.4694908724513988,0.17307865747600326,0.1934668202062521,125306.56027729712,2158.9743250241163,127465.53460232123,188,0,36.26315789473684,33,5,15,40.07955936352508,0.5789141414141414,49.69362745098039,1001.2254901960778,30.340166369578114,14
3187,4,0,3,35,0.0,0.07894736842105263,0.9210526315789473,38,1600,1200,400,0.75,20,12,8,334.9607154848753,0.4695649596965386,-0.03922651933701671,0.16005250660708142,123088.50439558328,677.74134289124,123766.24573847452,189,1,37.26315789473684,37,1,19,43.60911602209944,0.5478603603603603,51.91885964912281,992.3245614035089,26.819582740635376,16
3188,4,7,5,37,0.16666666666666666,0.11904761904761904,0.8809523809523809,42,650,400,250,0.6153846153846154,9,4,5,303.57686984742537,0.4781987998451413,0.04333410888785494,0.15031951458574142,124593.82642606927,-829.0834940243219,123764.74293204494,190,0,33.142857142857146,40,2,17,42.82942284201956,0.5583333333333333,50.40650406504066,998.3739837398384,24.95934959349596,0
3189,4,4,2,39,0.0975609756097561,0.04878048780487805,0.9512195121951219,41,900,600,300,0.6666666666666666,12,6,6,297.7747857761179,0.4772357723577236,0.07198703522132033,0.14907369619511426,125052.08875868095,-752.5282118055165,124299.56054687544,191,0,33.8780487804878,39,2,21,42.50199611192111,0.5646367521367521,49.947916666666686,1000.2083333333366,25.646367521367605,0
3190,4,6,6,39,0.13333333333333333,0.13333333333333333,0.8666666666666667,45,1550,1100,450,0.7096774193548387,20,11,9,326.9298312469198,0.48036616161616164,0.18099995674927616,0.1593705382302345,123936.38077639545,-270.3993818449294,123665.98139455053,192,0,31.488888888888887,42,3,18,42.92749286363048,0.5486111111111112,51.06589147286821,995.7364341085255,23.708010335917272,16
3191,4,3,2,40,0.07142857142857142,0.047619047619047616,0.9523809523809523,42,900,500,400,0.5555555555555556,13,5,8,332.9965768135288,0.4793844367015099,0.2166268821153141,0.1639692004815984,124359.79618671928,-117.72036795392657,124242.07581876536,193,0,34.04761904761905,38,4,18,42.33745715509855,0.5592105263157895,50.64102564102564,997.4358974358976,26.248313090418357,0
3192,4,5,2,43,0.1111111111111111,0.044444444444444446,0.9555555555555556,45,1150,600,550,0.5217391304347826,17,6,11,318.5919002895645,0.47935606060606056,0.24170623779649358,0.16100358933708592,125443.10031467029,-1003.6815475273187,124439.41876714297,194,0,31.933333333333334,39,6,15,41.57838983050846,0.5686431623931624,49.55729166666667,1001.7708333333346,25.686431623931657,0
3193,4,2,3,42,0.044444444444444446,0.06666666666666667,0.9333333333333333,45,1250,900,350,0.72,16,9,7,327.48590020509585,0.4793771043771044,0.2227745045527585,0.1611534464108891,124333.15669743936,-626.6134861362441,123706.54321130313,195,0,32.888888888888886,38,7,14,42.502454918764485,0.5589364035087719,50.66773504273503,997.3290598290583,26.245501574448905,16
3194,4,3,6,39,0.06666666666666667,0.13333333333333333,0.8666666666666667,45,1100,600,500,0.5454545454545454,16,6,10,326.46125762006085,0.4799242424242424,0.249536839105031,0.16281298114569756,124893.18522171074,-845.4427368690303,124047.7424848417,196,0,33.37777777777778,38,7,18,41.94879400028502,0.5646929824561404,50.1068376068376,999.5726495726485,26.30454340980654,0
3195,4,4,3,40,0.09302325581395349,0.06976744186046512,0.9302325581395349,43,1500,900,600,0.6,21,9,12,325.0818852730207,0.479812661498708,0.24787211523636055,0.16465018196042197,125535.48216713352,-438.0921005931621,125097.39006654036,197,0,34.627906976744185,36,7,15,41.32065400606811,0.5749421296296297,49.4650900900901,1002.139639639641,27.83721221221225,0
3196,4,3,1,42,0.06976744186046512,0.023255813953488372,0.9767441860465116,43,1500,1200,300,0.8,18,12,6,318.6438092332334,0.48151993355481726,0.2397278358891033,0.16360859263320734,126098.89581409673,-563.8734995383118,125535.02231455842,198,0,34.883720930232556,37,6,19,40.902474526928664,0.5788288288288288,48.90350877192983,1004.3859649122815,27.14556661925085,0
3197,4,2,3,41,0.045454545454545456,0.06818181818181818,0.9318181818181819,44,1000,700,300,0.7,13,7,6,313.2514532066624,0.48244802677942217,0.23243241938131987,0.16210203018330469,126419.60612763888,-879.7749333406507,125539.83119429823,199,0,34.88636363636363,38,6,12,40.70877155706645,0.5803179824561404,48.5844017094017,1005.6623931623924,26.464799820062957,0
3198,4,2,6,37,0.046511627906976744,0.13953488372093023,0.8604651162790697,43,1650,1400,250,0.8484848484848485,19,14,5,323.9426815926322,0.48244278331487633,0.23346068720385227,0.16778804168544348,126457.07242853518,-407.03137022935425,126050.04105830583,200,0,36.16279069767442,37,6,13,40.40151804208001,0.5824887387387387,48.54714912280699,1005.8114035087676,27.18409198672345,0
3199,4,4,2,39,0.0975609756097561,0.04878048780487805,0.9512195121951219,41,1350,1000,350,0.7407407407407407,17,10,7,344.01830268943087,0.48107215447154467,0.2449126193977087,0.1784133106787905,126509.15745027413,504.2931241426385,127013.45057441677,201,0,35.68292682926829,35,6,15,39.84315078999848,0.5869047619047619,48.49537037037036,1006.0185185185167,28.74338624338619,0
3200,4,2,4,37,0.04878048780487805,0.0975609756097561,0.9024390243902439,41,1050,600,450,0.5714285714285714,15,6,9,344.303138779343,0.48079268292682925,0.2639503357681754,0.1796241929384413,126751.58900454504,528.1939879068209,127279.78299245186,202,0,36.63414634146341,36,5,17,39.58682807723851,0.5873842592592593,48.2545045045045,1006.9819819819816,27.97172172172171,0
3201,4,0,0,37,0.0,0.0,1.0,37,1600,1400,200,0.875,18,14,4,376.435885457438,0.4797922922922923,0.2730069265245145,0.19406927773582935,126265.81471278438,2106.1967528823566,128372.01146566674,203,1,40.513513513513516,32,5,18,39.27894681742045,0.5911458333333333,48.73737373737374,1005.0505050505049,31.407828282828277,0
3202,4,0,0,37,0.0,0.0,1.0,37,1650,1400,250,0.8484848484848485,19,14,5,377.8522561630865,0.47954204204204204,0.2761744795643102,0.19555511503177284,126424.48992768592,2153.9557506887036,128578.44567837463,204,2,41.513513513513516,32,5,18,39.079566854990574,0.5927734375,48.57954545454545,1005.6818181818179,31.42755681818181,0
3203,4,1,2,36,0.02631578947368421,0.05263157894736842,0.9473684210526316,38,1550,900,650,0.5806451612903226,22,9,13,368.99954730647374,0.47777382645803695,0.2760934250519922,0.193683553069288,126999.35308835529,1772.540759563613,128771.8938479189,205,0,41.39473684210526,33,5,19,38.71010638297873,0.5962752525252526,48.00857843137254,1007.9656862745086,30.544414735591168,0
3204,4,3,1,38,0.07692307692307693,0.02564102564102564,0.9743589743589743,39,1500,1300,200,0.8666666666666667,17,13,4,410.18988661727565,0.48071300044984255,0.2823046096465933,0.20524152694888198,125029.7636763037,2495.0762382158596,127524.83991451956,206,0,40.23076923076923,34,5,18,39.714270126572224,0.5738357843137255,49.97023809523809,1000.1190476190463,29.41526610644254,16
3205,4,7,9,36,0.15555555555555556,0.2,0.8,45,1500,1000,500,0.6666666666666666,20,10,10,355.7229842943855,0.4813341750841751,0.23037665953383435,0.1845098057097302,126514.97938368063,4.953009849776919,126519.93239353041,207,0,32.266666666666666,39,6,14,39.542779733554205,0.579594017094017,48.489583333333336,1006.0416666666673,25.795940170940188,0
3206,4,3,1,38,0.07692307692307693,0.02564102564102564,0.9743589743589743,39,1250,700,550,0.56,18,7,11,390.6330152867545,0.48242802519118305,0.27564102564102577,0.20241892610313678,126474.91349480994,2081.0553633218324,128555.96885813178,208,0,35.1025641025641,33,6,18,38.7061403508772,0.5909090909090908,48.5294117647059,1005.8823529411786,30.48128342245996,0
3207,4,2,3,37,0.05,0.075,0.925,40,1750,1400,350,0.8,21,14,7,391.12497215415465,0.4835737179487179,0.19144776119403017,0.19212150391736338,124257.05959467121,2036.7579629891213,126293.81755766034,209,0,34.0,34,6,16,40.995024875621894,0.5658700980392157,50.74404761904762,997.0238095238096,29.324229691876752,16
3208,4,6,3,40,0.13953488372093023,0.06976744186046512,0.9302325581395349,43,1550,1000,550,0.6451612903225806,21,10,11,358.95338715451237,0.4842884828349945,0.2284147081081369,0.1827667481246184,125753.446769976,434.56841520043866,126188.01518517644,210,0,32.116279069767444,35,8,18,40.24684591122393,0.5791666666666666,49.24768518518518,1003.0092592592594,28.65740740740741,0
3209,4,2,3,39,0.047619047619047616,0.07142857142857142,0.9285714285714286,42,1150,800,350,0.6956521739130435,15,8,7,364.8353161963462,0.4824332171893147,0.2429361786208255,0.1870751302198287,126043.83680555563,797.0486111111155,126840.88541666674,211,0,33.30952380952381,34,8,20,39.799446749654194,0.5842524509803921,48.958333333333336,1004.1666666666673,29.534313725490215,0
3210,4,3,2,40,0.07142857142857142,0.047619047619047616,0.9523809523809523,42,750,400,350,0.5333333333333333,11,4,7,349.1997323989912,0.4815500387146729,0.2421925600518149,0.18169130691898286,126642.2636763039,444.68891723356586,127086.95259353747,212,0,33.73809523809524,34,8,19,39.57594125763849,0.5903799019607843,48.36309523809524,1006.5476190476195,29.604341736694693,0
3211,4,2,6,36,0.047619047619047616,0.14285714285714285,0.8571428571428572,42,1050,600,450,0.5714285714285714,15,6,9,419.962647148451,0.4807031552458381,0.2502155683459444,0.20388955770350065,123764.33020858695,2046.2995555539012,125810.62976414085,213,0,34.595238095238095,36,6,16,40.791694960012066,0.556712962962963,51.23873873873874,995.045045045045,27.640140140140137,16
3212,4,5,5,36,0.12195121951219512,0.12195121951219512,0.8780487804878049,41,850,600,250,0.7058823529411765,11,6,5,400.636840323843,0.48351117886178857,0.24911613902377283,0.19821244428036944,124558.47139322528,1781.1638813353711,126339.63527456066,214,0,31.75609756097561,32,9,18,40.44370309469601,0.5735677083333333,50.4419191919192,998.232323232324,31.194760101010125,0
3213,4,6,9,33,0.14285714285714285,0.21428571428571427,0.7857142857142857,42,1200,700,500,0.5833333333333334,17,7,10,386.4647174717752,0.48326800232288036,0.2398290120111195,0.19480587331658722,125337.23695513768,1288.4651440008108,126625.70209913849,215,0,30.404761904761905,33,9,15,39.98834801941829,0.579229797979798,49.66299019607845,1001.3480392156882,30.343879976232977,0
3214,4,3,2,34,0.08333333333333333,0.05555555555555555,0.9444444444444444,36,1100,800,300,0.7272727272727273,14,8,6,417.4913910902725,0.4783068783068783,0.2729438430937181,0.20979379108762233,125208.42013888892,3254.687500000009,128463.10763888893,216,0,32.97222222222222,29,7,22,39.34568415209549,0.5883620689655172,49.79166666666667,1000.8333333333337,34.511494252873575,0
3215,4,2,1,35,0.05555555555555555,0.027777777777777776,0.9722222222222222,36,1400,1000,400,0.7142857142857143,18,10,8,394.9620276981698,0.47709986772486773,0.22318957049736632,0.20169538295448242,125875.18246329045,2743.183460515651,128618.3659238061,140,0,27.25,30,6,21,39.217787302437706,0.5923611111111111,49.1263440860215,1003.4946236559131,33.44982078853044,0
3216,4,4,5,34,0.10256410256410256,0.1282051282051282,0.8717948717948718,39,800,600,200,0.75,10,6,4,368.58052355069697,0.4780982905982906,0.2232365559213807,0.19331672357659024,126968.47366397551,1559.6212995002068,128528.09496347573,141,0,26.025641025641026,33,6,20,38.75243190661478,0.595959595959596,48.03921568627452,1007.843137254903,30.540701128936455,0
3217,4,2,0,36,0.05555555555555555,0.0,1.0,36,750,500,250,0.6666666666666666,10,5,5,383.48211768350143,0.47736441798941803,0.22028807647590742,0.20125661511782963,126993.56291029196,2539.952087402353,129533.51499769432,142,0,26.194444444444443,31,5,22,38.3511228092839,0.6011424731182795,48.01432291666667,1007.942708333334,32.51428091397852,0
3218,4,1,1,36,0.02702702702702703,0.02702702702702703,0.972972972972973,37,1500,1200,300,0.8,18,12,6,372.7696815800958,0.476758008008008,0.22332492368593404,0.19802751029693322,127486.19927300356,2104.6361287434997,129590.83540174706,143,0,26.45945945945946,31,6,17,38.114577961148356,0.6061827956989247,47.52604166666667,1009.895833333334,32.57728494623658,0
3219,4,2,6,32,0.05263157894736842,0.15789473684210525,0.8421052631578947,38,1600,1000,600,0.625,22,10,12,415.6852311601377,0.47604018492176386,0.1554843822228087,0.21597205295608202,126583.26478165494,3118.121800589542,129701.38658224448,144,0,26.5,32,6,17,37.96397950648263,0.5944010416666667,48.42171717171717,1006.3131313131314,31.447285353535356,16
3220,4,3,1,34,0.08571428571428572,0.02857142857142857,0.9714285714285714,35,950,600,350,0.631578947368421,13,6,7,389.05567782664014,0.47577030812324933,0.15204174481439536,0.1965203761996287,125423.53524102112,2786.146627301024,128209.68186832215,145,0,27.37142857142857,31,4,21,39.83396702630097,0.585013440860215,49.57682291666667,1001.6927083333339,32.31266801075271,15
3221,4,1,0,35,0.02857142857142857,0.0,1.0,35,1350,800,550,0.5925925925925926,19,8,11,380.4804097897779,0.47741596638655465,0.16969314916102718,0.19401731022039992,125815.12663099518,2574.038187662785,128389.16481865796,146,0,28.285714285714285,31,4,22,39.64322409690678,0.5890456989247312,49.18619791666668,1003.2552083333347,32.363071236559186,0
3222,4,5,4,36,0.125,0.1,0.9,40,1350,1100,250,0.8148148148148148,16,11,5,336.6554424502737,0.47749732905982906,0.1658121128699246,0.1778764937746356,127267.1320408951,569.2422183943418,127836.37425928944,147,0,25.625,35,5,19,39.25068823124569,0.5946428571428571,47.74305555555556,1009.027777777778,28.829365079365086,0
3223,4,1,1,36,0.02702702702702703,0.02702702702702703,0.972972972972973,37,1100,700,400,0.6363636363636364,15,7,8,361.0212052537904,0.47484984984984985,0.18922982115164544,0.18933451119157405,126964.73095857579,1767.3920390776632,128732.12299765345,148,0,28.37837837837838,32,5,20,38.94674475904119,0.5983072916666667,48.0429292929293,1007.8282828282839,31.494633838383873,0
3224,4,2,2,36,0.05263157894736842,0.05263157894736842,0.9473684210526316,38,1000,600,400,0.6,14,6,8,353.3070288306413,0.47518077287814126,0.2043169004641896,0.18801225556171594,127555.8247579058,1413.2738910515409,128969.09864895734,149,0,28.42105263157895,33,5,20,38.534589955113425,0.6019570707070707,47.457107843137265,1010.1715686274524,30.611259655377346,0
3225,4,0,1,35,0.0,0.027777777777777776,0.9722222222222222,36,1200,700,500,0.5833333333333334,17,7,10,384.9032124161044,0.47341269841269845,0.08433823137943897,0.18551801485275066,123457.17120181413,2314.358932911407,125771.53013472553,150,1,29.055555555555557,34,2,17,41.98460709151894,0.5575980392156863,51.54761904761905,993.8095238095243,29.229691876750714,16
3226,4,3,3,35,0.07894736842105263,0.07894736842105263,0.9210526315789473,38,850,600,250,0.7058823529411765,11,6,5,379.6436071005921,0.47436581318160265,0.07305910931174142,0.18503925061141624,123929.99574983172,1830.0310718650169,125760.02682169674,151,0,28.342105263157894,33,5,22,41.621923076923096,0.564709595959596,51.072303921568626,995.7107843137248,30.173054070112872,16
3227,4,5,5,35,0.125,0.125,0.875,40,1450,1000,450,0.6896551724137931,19,10,9,353.9711513206861,0.47438568376068374,0.11446899501069185,0.1792857492068312,125536.28826530611,891.8479953255834,126428.1362606317,152,0,25.125,34,6,16,40.59604419101925,0.5790441176470589,49.464285714285715,1002.1428571428571,29.474789915966387,0
3228,4,3,2,36,0.07894736842105263,0.05263157894736842,0.9473684210526316,38,1250,900,350,0.72,16,9,7,360.1398478749479,0.4736693930772878,0.1426068224930077,0.18343152799355597,125767.10467428378,1458.7491890138272,127225.85386329761,153,0,27.07894736842105,33,5,20,40.202988189778075,0.5836489898989898,49.234068627450974,1003.0637254901948,30.395870469399842,0
3229,4,3,4,35,0.07692307692307693,0.10256410256410256,0.8974358974358975,39,950,600,350,0.631578947368421,13,6,7,374.6665675863239,0.47514619883040937,0.16761607226235853,0.18028963191182582,123387.90691607031,1446.1688329906642,124834.07574906097,154,0,26.666666666666668,37,2,16,42.311256115954826,0.5509572072072072,51.61732456140351,993.5307017543857,26.852181128496913,16
3230,4,5,2,38,0.125,0.05,0.95,40,1400,1000,400,0.7142857142857143,18,10,8,366.50517442888287,0.47852564102564105,0.1980478447303089,0.1810462015489833,124493.75684806432,1128.1722698755339,125621.92911793986,155,0,26.525,36,4,19,41.36270029338749,0.5642361111111112,50.50675675675676,997.9729729729734,27.72147147147148,0
3231,4,4,0,42,0.09523809523809523,0.0,1.0,42,1200,700,500,0.5833333333333334,17,7,10,354.0836824830392,0.4812838753387534,0.1961848092404619,0.16888432067680167,123011.444468557,775.6248744169159,123787.06934297392,156,0,26.166666666666668,35,7,17,43.215129506475314,0.5508928571428571,51.99652777777777,992.0138888888881,28.343253968253947,16
3232,4,9,5,46,0.17647058823529413,0.09803921568627451,0.9019607843137255,51,1300,900,400,0.6923076923076923,17,9,8,303.71981229419004,0.487140522875817,0.23063813671653,0.15203263779389767,125047.35296860675,-2588.1837930281176,122459.16917557863,157,0,22.372549019607842,43,8,16,42.35821814050366,0.5586240310077519,49.95265151515152,1000.1893939393958,23.26021846370688,0
3233,4,5,7,44,0.09803921568627451,0.13725490196078433,0.8627450980392157,51,1700,900,800,0.5294117647058824,25,9,16,348.3986596436519,0.4854248366013072,0.283570715499569,0.1714014820770779,124322.62559341404,-1135.5239261127215,123187.10166730131,158,0,23.19607843137255,42,9,14,41.991959774582206,0.5525793650793651,50.67829457364342,997.2868217054279,23.744924326319712,16
3234,4,5,3,46,0.10204081632653061,0.061224489795918366,0.9387755102040817,49,1100,500,600,0.45454545454545453,17,5,12,359.4547792985754,0.4814342403628118,0.3581178387870565,0.18053688566701145,125187.0357243958,-792.8230040707185,124394.21272032509,159,0,24.653061224489797,38,11,18,40.81994413010213,0.5677083333333333,49.8130341880342,1000.7478632478657,26.33547008547015,0
3235,4,5,4,47,0.09803921568627451,0.0784313725490196,0.9215686274509804,51,1850,1500,350,0.8108108108108109,22,15,7,336.94323444844235,0.48423202614379085,0.3303230005695219,0.17277302021718044,126043.83680555587,-1706.0763888888546,124337.760416667,160,0,23.50980392156863,40,11,16,40.499654218533905,0.5731770833333334,48.95833333333335,1004.1666666666692,25.104166666666732,0
3236,4,1,9,39,0.020833333333333332,0.1875,0.8125,48,1400,900,500,0.6428571428571429,19,9,10,358.65222672478,0.4800162529550827,0.36014376996805075,0.1828308582489516,125802.56615713362,-576.125904010504,125226.44025312312,161,0,25.958333333333332,38,10,17,40.20367412140574,0.5740131578947368,49.198717948717956,1003.2051282051295,26.400134952766567,0
3237,4,1,1,39,0.025,0.025,0.975,40,1400,1000,400,0.7142857142857143,18,10,8,407.0065463621421,0.47578792735042735,0.32719669488109626,0.20399661444938882,125100.82677549428,2183.3710905885055,127284.19786608279,162,0,28.6,30,10,20,39.71992700076134,0.584375,49.899193548387096,1000.4032258064517,33.34677419354839,0
3238,4,1,1,39,0.025,0.025,0.975,40,1650,1200,450,0.7272727272727273,21,12,9,397.60374479709225,0.47644230769230766,0.3142931392931396,0.20131305394463295,125521.37586805549,1981.553819444439,127502.92968749993,163,0,28.95,31,9,18,39.51836451836453,0.586021505376344,49.479166666666664,1002.0833333333328,32.32526881720428,0
3239,4,5,3,41,0.11363636363636363,0.06818181818181818,0.9318181818181819,44,1250,1000,250,0.8,15,10,5,375.18641039286047,0.4782527307963354,0.3401362853114729,0.1963919243818305,126887.86175679401,721.3202749913802,127609.18203178539,164,0,27.181818181818183,35,9,18,38.66898812942754,0.5907738095238095,48.11921296296294,1007.5231481481449,28.78637566137557,0
3240,4,2,2,41,0.046511627906976744,0.046511627906976744,0.9534883720930233,43,800,400,400,0.5,12,4,8,377.2252383232527,0.47805924695459584,0.3403441157739855,0.19874702854941526,127152.04081632651,993.1558800539178,128145.19669638043,165,0,27.74418604651163,34,9,20,38.34567791942082,0.5955882352941176,47.857142857142854,1008.5714285714284,29.663865546218485,0
3241,4,1,3,39,0.023809523809523808,0.07142857142857142,0.9285714285714286,42,1350,700,650,0.5185185185185185,20,7,13,386.1104279947803,0.4770252613240418,0.3474819982250976,0.20433484447813666,127332.20663265312,1432.8585600907068,128765.06519274383,166,0,28.928571428571427,34,8,20,37.93617795077454,0.5974264705882353,47.67857142857143,1009.2857142857148,29.684873949579845,0
3242,4,0,1,38,0.0,0.02564102564102564,0.9743589743589743,39,1450,1100,350,0.7586206896551724,18,11,7,392.06099595962894,0.4758209626630679,0.3235824304125532,0.2075586491192901,127346.7710565251,2185.540378532839,129532.31143505794,167,1,29.076923076923077,32,7,20,37.771036610791434,0.6022135416666667,47.66414141414143,1009.3434343434365,31.54198232323239,0
3243,4,2,0,40,0.05,0.0,1.0,40,750,600,150,0.8,9,6,3,380.20681492451655,0.4757211538461539,0.318644735247789,0.20388868379285485,127865.50132461078,1723.0669994713664,129588.56832408215,168,0,28.975,33,7,22,37.5372339351347,0.6051136363636364,47.15073529411765,1011.3970588235298,30.648395721925148,0
3244,4,3,1,42,0.06976744186046512,0.023255813953488372,0.9767441860465116,43,1800,1300,500,0.7222222222222222,23,13,10,366.38075023512306,0.47455241786637137,0.3341970147355702,0.20226982550716413,129024.94454089503,854.7553157973389,129879.69985669237,169,0,27.88372093023256,35,8,19,36.701127819548866,0.6125,46.00694444444444,1015.972222222222,29.02777777777777,0
3245,4,2,1,43,0.045454545454545456,0.022727272727272728,0.9772727272727273,44,1450,1000,450,0.6896551724137931,19,10,9,334.2700112988166,0.4752136187455955,0.1928395109345471,0.17469499260117752,126822.83676674702,266.36016486777305,127089.19693161479,170,0,28.09090909090909,38,6,15,39.766298967614205,0.5844298245614035,48.18376068376068,1007.2649572649572,26.506972559604137,16
3246,4,2,5,40,0.044444444444444446,0.1111111111111111,0.8888888888888888,45,1350,900,450,0.6666666666666666,18,9,9,325.49789206446616,0.4751893939393939,0.21797173217786026,0.17269026096228093,127433.60595703128,-703.8406197066298,126729.76533732464,171,0,28.4,39,6,11,39.36184617765397,0.5889423076923077,47.578125,1009.6875000000002,25.889423076923084,0
3247,4,5,4,41,0.1111111111111111,0.08888888888888889,0.9111111111111111,45,1500,1200,300,0.8,18,12,6,316.80887046362943,0.4757996632996633,0.22443797996009907,0.17173831591364458,128298.92223750749,-870.7526728468404,127428.16956466065,172,0,24.6,40,5,16,38.69850703848598,0.59609375,46.72256097560976,1013.1097560975613,25.327743902439032,0
3248,4,2,1,42,0.046511627906976744,0.023255813953488372,0.9767441860465116,43,900,500,400,0.5555555555555556,13,5,8,312.4671559045024,0.4747600590623846,0.1604615837503678,0.15962820302933076,125890.80909387612,-729.4884823848129,125161.3206114913,173,0,25.0,40,3,19,41.27130801687763,0.5716145833333333,49.11077235772358,1003.5569105691067,25.088922764227668,16
3249,4,2,6,38,0.045454545454545456,0.13636363636363635,0.8636363636363636,44,1750,1400,350,0.8,21,14,7,307.7903713522951,0.4755549682875264,0.1759548579200827,0.15890722095077775,126324.62902372913,-1023.6061537444778,125301.02286998465,174,0,25.363636363636363,40,4,15,40.9434391427416,0.5760416666666667,48.67886178861788,1005.2845528455274,25.132113821138184,0
3250,4,1,4,35,0.02564102564102564,0.10256410256410256,0.8974358974358975,39,1300,1000,300,0.7692307692307693,16,10,6,346.58292615643956,0.47351551956815113,0.1905090793979689,0.17686448293550236,125846.02127465283,923.2164597029271,126769.23773435576,175,0,26.897435897435898,36,3,21,40.46156004489338,0.578125,49.155405405405396,1003.3783783783767,27.871621621621575,0
3251,4,6,2,39,0.14634146341463414,0.04878048780487805,0.9512195121951219,41,800,200,600,0.25,14,2,12,310.6402247901561,0.4773628048780488,0.15962960997343845,0.16040603581860874,126331.65283203128,-275.0925301092898,126056.56030192199,176,0,24.5609756097561,39,2,16,40.86461247539114,0.577724358974359,48.671875,1005.3125000000002,25.777243589743595,16
3252,4,1,2,38,0.025,0.05,0.95,40,1200,900,300,0.75,15,9,6,319.79271837736843,0.47828525641025643,0.1876765049368303,0.16614051927172813,126580.82133693103,95.92498995542923,126676.74632688645,177,0,26.025,38,2,17,40.37893265385568,0.5819627192982456,48.424145299145295,1006.3034188034181,26.481668915879425,0
3253,4,2,2,38,0.05,0.05,0.95,40,1150,700,450,0.6086956521739131,16,7,9,321.3997423762416,0.47755074786324786,0.2199815786535675,0.16943952280541477,127177.1914439778,177.00358974506617,127354.19503372288,178,0,26.325,36,4,20,39.727540843288324,0.591724537037037,47.83220720720721,1008.6711711711715,28.018643643643653,0
3254,4,1,1,38,0.02564102564102564,0.02564102564102564,0.9743589743589743,39,1300,1000,300,0.7692307692307693,16,10,6,333.1453581348375,0.47663630229419707,0.23575629263702713,0.17627594192571472,127325.5315500684,683.581961591203,128009.1135116596,179,0,27.512820512820515,35,4,15,39.27943425076454,0.5952380952380952,47.685185185185176,1009.2592592592576,28.83597883597879,0
3255,4,1,4,35,0.02564102564102564,0.10256410256410256,0.8974358974358975,39,1350,900,450,0.6666666666666666,18,9,9,354.92326901634243,0.47666441745389115,0.21812897120454267,0.17560986093069453,124561.78824253613,1075.4652131805,125637.25345571664,180,0,27.46153846153846,37,2,18,41.58108157586409,0.5630630630630631,50.43859649122807,998.2456140350873,26.979611190137497,16
3256,4,3,1,37,0.07894736842105263,0.02631578947368421,0.9736842105263158,38,1200,900,300,0.75,15,9,6,354.83529680980223,0.4763809862494073,0.2218209800044968,0.17870938197298947,125301.7169345373,1292.2943838488554,126594.01131838615,181,0,25.57894736842105,37,1,19,40.81688296280074,0.5706644144144144,49.69846491228069,1001.2061403508751,27.059625414888515,0
3257,4,3,0,40,0.075,0.0,1.0,40,1450,1000,450,0.6896551724137931,19,10,9,378.9443724062235,0.4794738247863248,0.2695149759645019,0.183107545761268,123564.19593725965,1458.3477670897614,125022.5437043494,182,0,25.175,33,7,15,42.02090780229262,0.5609217171717171,51.439950980392155,994.2401960784309,30.128490790255483,16
3258,4,6,2,44,0.13043478260869565,0.043478260869565216,0.9565217391304348,46,900,500,400,0.5555555555555556,13,5,8,390.43942060756115,0.4833635265700483,0.341578586203662,0.18597079379614892,122953.26735096595,1242.6337247129902,124195.90107567894,183,0,22.76086956521739,36,10,19,42.37443700087053,0.5483217592592593,52.05518018018019,991.7792792792802,27.54942442442445,16
3259,4,5,4,45,0.10204081632653061,0.08163265306122448,0.9183673469387755,49,1300,800,500,0.6153846153846154,18,8,10,363.1631783342182,0.4847115929705215,0.32846226758367925,0.17759422165472047,124069.71976954449,-780.2715695546881,123289.4481999898,184,0,21.73469387755102,37,12,20,41.88678553085333,0.5579954954954955,50.93201754385965,996.2719298245615,26.9262683736368,0
3260,4,4,9,40,0.08163265306122448,0.1836734693877551,0.8163265306122449,49,1050,700,350,0.6666666666666666,14,7,7,372.80154854766784,0.4847115929705215,0.34126535989890017,0.18493880741678403,124671.26904432125,-504.4715681748323,124166.79747614641,185,0,21.3265306122449,37,12,14,41.021171863563154,0.5641891891891893,50.32894736842105,998.684210526315,26.991465149359865,0
3261,4,8,7,41,0.16666666666666666,0.14583333333333334,0.8541666666666666,48,1050,700,350,0.6666666666666666,14,7,7,388.80787672876795,0.48441193853427894,0.3606716705157813,0.1971356096294573,125579.3734996571,166.115565235649,125745.48906489275,186,0,21.9375,35,13,15,39.67859892224789,0.5773809523809523,49.4212962962963,1002.3148148148151,28.637566137566147,0
3262,4,3,4,40,0.06818181818181818,0.09090909090909091,0.9090909090909091,44,1400,800,600,0.5714285714285714,20,8,12,421.9483525560005,0.483681289640592,0.39786922856323415,0.2117758514253521,125157.87810236224,1762.0320949393176,126919.91019730156,187,0,24.727272727272727,32,12,21,39.286803364879056,0.5797526041666667,49.84217171717173,1000.6313131313151,31.269728535353597,0
3263,4,2,3,39,0.047619047619047616,0.07142857142857142,0.9285714285714286,42,1400,900,500,0.6428571428571429,19,9,10,415.38741777702774,0.4831470189701897,0.3503648732220157,0.21098173594215805,125651.88937717023,2038.842773437506,127690.73215060773,188,0,23.404761904761905,31,11,19,38.93722943722942,0.5873655913978495,49.348958333333336,1002.6041666666674,32.34206989247314,0
3264,4,4,3,40,0.09302325581395349,0.06976744186046512,0.9302325581395349,43,1250,1000,250,0.8,15,10,5,390.73765879239994,0.4835502030269472,0.23300877122394814,0.19951092471908735,125869.56259645044,1481.2822506751368,127350.84484712558,189,0,23.13953488372093,35,8,16,39.32958477508651,0.5803571428571428,49.131944444444436,1003.4722222222208,28.670634920634882,16
3265,4,2,2,40,0.047619047619047616,0.047619047619047616,0.9523809523809523,42,1350,700,650,0.5185185185185185,20,7,13,418.627955117809,0.4840543941153697,0.30952380952380953,0.2017025601931262,123442.38281250003,1984.8379629629635,125427.22077546299,190,0,24.428571428571427,37,5,13,41.162211740041926,0.5515202702702703,51.5625,993.7500000000002,26.858108108108116,16
3266,4,2,3,39,0.047619047619047616,0.07142857142857142,0.9285714285714286,42,1500,1100,400,0.7333333333333333,19,11,8,417.5522521298689,0.4839455090979481,0.31755821271239815,0.20339991681004332,123905.9133579562,1947.4386349645947,125853.3519929208,191,0,24.571428571428573,37,5,16,40.703469162995596,0.5563063063063063,51.09649122807017,995.6140350877185,26.908487434803202,0
3267,4,6,7,38,0.13333333333333333,0.15555555555555556,0.8444444444444444,45,1300,1100,200,0.8461538461538461,15,11,4,377.06947441883574,0.48569023569023567,0.2694910095808536,0.18940633423339057,125191.95960535905,455.6528210602979,125647.61242641935,192,0,22.68888888888889,37,8,14,40.37414174062306,0.5695382882882882,49.808114035087705,1000.7675438596467,27.047771455666126,0
3268,4,0,1,37,0.0,0.02631578947368421,0.9736842105263158,38,1450,900,550,0.6206896551724138,20,9,11,416.417473882204,0.4817300853485064,0.27560302565949746,0.20549141627581421,124450.83597232915,2764.7005476251443,127215.5365199543,91,1,22.5,35,3,14,40.16222499323358,0.5657738095238095,50.549768518518505,997.8009259259239,28.508597883597826,0
3269,4,2,1,38,0.05128205128205128,0.02564102564102564,0.9743589743589743,39,1200,1000,200,0.8333333333333334,14,10,4,410.97939620938223,0.4829622132253711,0.19868448970931496,0.1957697487704487,122956.65182443126,2452.910661973634,125409.5624864049,77,0,20.53846153846154,32,7,19,41.86160619562912,0.5569661458333333,52.05176767676768,991.7929292929299,30.99352904040406,16
3270,4,7,6,39,0.15555555555555556,0.13333333333333333,0.8666666666666667,45,1050,700,350,0.6666666666666666,14,7,7,359.0852191915521,0.48354377104377105,0.1958714043993235,0.1777381612581299,124578.0593727172,-45.00961633308296,124533.0497563841,78,0,18.244444444444444,36,9,15,41.46033088926491,0.5651041666666667,50.42229729729729,998.3108108108098,27.73085585585583,0
3271,4,2,3,38,0.04878048780487805,0.07317073170731707,0.926829268292683,41,1250,700,550,0.56,18,7,11,377.4060573994011,0.48450203252032525,0.1885189871576709,0.18669910273120807,124553.97002551018,1201.4845521541909,125755.45457766436,79,0,19.682926829268293,34,7,16,41.02812562114888,0.5689338235294117,50.44642857142857,998.2142857142854,29.359243697478984,0
3272,4,4,7,35,0.09523809523809523,0.16666666666666666,0.8333333333333334,42,1400,1000,400,0.7142857142857143,18,10,8,374.490617350571,0.4854578010065815,0.2114669474113191,0.18899757431135927,125387.2041524946,992.063492063525,126379.26764455812,80,0,18.476190476190474,34,8,11,40.23634058401681,0.5775122549019608,49.613095238095255,1001.5476190476212,29.45728291316533,0
3273,4,4,3,36,0.10256410256410256,0.07692307692307693,0.9230769230769231,39,1050,400,650,0.38095238095238093,17,4,13,377.3950665150613,0.48538011695906436,0.19849317857870075,0.19222020033763415,125767.10467428416,1692.7769667916475,127459.8816410758,81,0,17.05128205128205,33,6,14,39.770286092445545,0.5836489898989898,49.234068627450995,1003.063725490198,30.395870469399938,0
3274,4,2,6,32,0.05263157894736842,0.15789473684210525,0.8421052631578947,38,850,500,350,0.5882352941176471,12,5,7,385.64458763419094,0.4848121147463253,0.15912957576422815,0.19162339872600445,124739.7189670137,2021.0394965277574,126760.75846354145,82,0,17.86842105263158,35,3,16,40.62934480361489,0.56875,50.26041666666666,998.9583333333318,28.54166666666662,15
3275,4,1,0,33,0.030303030303030304,0.0,1.0,33,1100,800,300,0.7272727272727273,14,8,6,413.4832048326147,0.484375,0.18004681470234707,0.20418397434517793,124479.70920138892,3694.0538194444475,128173.76302083337,83,0,20.393939393939394,31,2,17,40.205288796102984,0.575268817204301,50.520833333333336,997.916666666667,32.190860215053775,0
3276,4,1,2,32,0.029411764705882353,0.058823529411764705,0.9411764705882353,34,1300,1000,300,0.7692307692307693,16,10,6,406.9032003415806,0.48353015448603687,0.1511699438096883,0.1918537579000802,122518.75007971129,3354.0310379680723,125872.78111767936,84,0,20.764705882352942,32,2,17,42.42257577689921,0.5524088541666667,52.49368686868687,990.0252525252528,30.93828914141415,15
3277,4,8,4,36,0.2,0.1,0.9,40,850,600,250,0.7058823529411765,11,6,5,357.42749686191416,0.4875,0.22178091709124592,0.17821846783484335,124884.2860510972,944.9560135586788,125829.24206465587,85,0,18.15,35,5,16,41.18419021151765,0.5702380952380952,50.115740740740726,999.5370370370354,28.55820105820101,0
3278,4,1,1,36,0.02702702702702703,0.02702702702702703,0.972972972972973,37,950,600,350,0.631578947368421,13,6,7,370.617032475593,0.4857982982982983,0.23170190057607276,0.18449397330927853,124816.24405276802,1851.8051951172413,126668.04924788525,86,0,20.37837837837838,33,4,18,40.92521053061892,0.5738636363636364,50.183823529411754,999.2647058823518,30.28074866310157,0
3279,4,4,5,35,0.1,0.125,0.875,40,850,400,450,0.47058823529411764,13,4,9,345.56621638681986,0.4893162393162393,0.20935955056179734,0.17514460853318306,125563.69714308894,678.1143474555508,126241.8114905445,87,0,19.475,36,4,18,40.778323970037434,0.5752314814814814,49.43693693693693,1002.2522522522515,27.84034034034032,0
3280,4,4,3,36,0.10256410256410256,0.07692307692307693,0.9230769230769231,39,1500,1100,400,0.7333333333333333,19,11,8,381.009989073584,0.48717948717948717,0.18256982108765096,0.18647612256591742,124104.61844403735,1959.716986267281,126064.33543030462,88,0,18.82051282051282,35,4,20,41.40591725713401,0.562202380952381,50.89699074074075,996.4120370370382,28.468915343915377,15
3281,4,6,4,38,0.14285714285714285,0.09523809523809523,0.9047619047619048,42,1350,1000,350,0.7407407407407407,17,10,7,349.87939275527606,0.4870547812620984,0.20657472357626916,0.17632328175342316,125327.59530895711,382.7820666589902,125710.3773756161,89,0,17.61904761904762,34,8,14,40.91417984385526,0.5768995098039216,49.67261904761906,1001.3095238095254,29.450280112044865,0
3282,4,4,1,41,0.09523809523809523,0.023809523809523808,0.9761904761904762,42,1050,800,250,0.7619047619047619,13,8,5,347.6484551032004,0.4872967479674797,0.24391729496592385,0.17851439605831781,126101.95500042866,367.82996827846085,126469.78496870711,90,0,18.214285714285715,35,7,18,40.171026350157504,0.5827380952380952,48.90046296296296,1004.398148148148,28.697089947089943,0
3283,4,3,4,40,0.06818181818181818,0.09090909090909091,0.9090909090909091,44,1400,1000,400,0.7142857142857143,18,10,8,357.5330169984156,0.486797480620155,0.23198430122986746,0.17853756526527056,124946.58690371821,138.37745647863522,125084.96436019684,91,0,17.454545454545453,38,6,19,41.11700327705352,0.5652412280701755,50.0534188034188,999.7863247863239,26.310166441745366,16
3284,4,3,3,40,0.06976744186046512,0.06976744186046512,0.9302325581395349,43,1000,500,500,0.5,15,5,10,351.8524902955355,0.4864110372831303,0.2677934291935349,0.1779665495258316,125479.06172642231,230.03548395200917,125709.09721037433,92,0,17.558139534883722,36,7,19,40.70824435202877,0.5743634259259259,49.52139639639639,1001.914414414414,27.830955955955943,0
3285,4,1,3,38,0.024390243902439025,0.07317073170731707,0.926829268292683,41,1300,900,400,0.6923076923076923,17,9,8,398.8278521427831,0.48490853658536587,0.17396834157740138,0.19523595820427245,124113.09840265746,1755.9794028384158,125869.07780549588,93,0,19.121951219512194,33,8,15,40.95321916123476,0.5666035353535354,50.88848039215685,996.4460784313711,30.195335710041547,16
3286,4,5,3,40,0.11627906976744186,0.06976744186046512,0.9302325581395349,43,1150,700,450,0.6086956521739131,16,7,9,378.02809984576567,0.4849575489110373,0.21471365071184723,0.19220865358355113,125695.40895061719,903.2793209876438,126598.68827160483,94,0,18.697674418604652,35,8,18,39.82860110803325,0.5785714285714285,49.30555555555555,1002.7777777777769,28.650793650793627,0
3287,4,2,2,40,0.047619047619047616,0.047619047619047616,0.9523809523809523,42,800,400,400,0.5,12,4,8,375.9266254209652,0.48473190089043744,0.23833407454991717,0.19235466798088685,125956.68463059419,1070.0942804784047,127026.77891107259,95,0,19.976190476190474,35,7,20,39.61107748184022,0.58125,49.04513888888889,1003.8194444444448,28.680555555555564,0
3288,4,2,4,38,0.047619047619047616,0.09523809523809523,0.9047619047619048,42,1450,900,550,0.6206896551724138,20,9,11,367.9703091628445,0.48350996902826177,0.23719357565511423,0.1907576142592661,126492.52409297059,909.1287802736947,127401.65287324428,96,0,20.523809523809526,34,8,15,39.25788954635108,0.5888480392156863,48.511904761904766,1005.9523809523815,29.586834733893575,0
3289,4,2,4,36,0.05,0.1,0.9,40,900,600,300,0.6666666666666666,12,6,6,376.1440156125564,0.4819043803418803,0.23307158509861226,0.1957951168720874,126659.88592128028,1528.4716214917325,128188.357542772,97,0,21.45,33,7,17,38.87975813651488,0.5928030303030303,48.345588235294116,1006.6176470588235,30.503565062388592,0
3290,4,3,2,37,0.07692307692307693,0.05128205128205128,0.9487179487179487,39,1400,1000,400,0.7142857142857143,18,10,8,397.5425423519699,0.4804880791722897,0.23365348198071345,0.19892195059822834,125031.56764934704,2388.1539053417396,127419.72155468877,98,0,22.435897435897434,32,7,20,40.02861591549889,0.5784505208333333,49.968434343434346,1000.1262626262629,31.253945707070717,15
3291,4,6,4,39,0.13953488372093023,0.09302325581395349,0.9069767441860466,43,1600,1200,400,0.75,20,12,8,355.7384311080114,0.4839885566629753,0.2090115296651136,0.17750927784968043,124915.55480734109,743.8474532672424,125659.40226060833,99,0,21.0,36,7,20,41.194003229319236,0.5685763888888888,50.08445945945946,999.6621621621618,27.768393393393385,16
3292,4,6,6,39,0.13333333333333333,0.13333333333333333,0.8666666666666667,45,1000,600,400,0.6,14,6,8,329.9612752666901,0.48108164983164986,0.24382864208306088,0.17010264618079196,126264.14497730073,-662.4431667573775,125601.70181054335,100,0,20.444444444444443,37,8,17,40.448396246999806,0.5805180180180181,48.7390350877193,1005.043859649123,27.163347558084403,0
3293,4,5,2,42,0.11363636363636363,0.045454545454545456,0.9545454545454546,44,1350,1100,250,0.8148148148148148,16,11,5,334.7390587682564,0.4825691508104299,0.2595899634620922,0.17431873502843762,126677.74128818445,-319.2024228609146,126358.53886532354,101,0,20.181818181818183,37,7,15,39.90340104563775,0.584740990990991,48.327850877192965,1006.688596491225,27.207799905168244,0
3294,4,2,3,41,0.045454545454545456,0.06818181818181818,0.9318181818181819,44,1250,800,450,0.64,17,8,9,357.71081909186057,0.48237094785059903,0.20854968844863375,0.1769890922289296,124561.78824253641,338.92375538629693,124900.7119979227,102,0,21.136363636363637,37,7,19,41.511515084944335,0.5630630630630631,50.43859649122808,998.2456140350897,26.97961119013756,16
3295,4,2,2,41,0.046511627906976744,0.046511627906976744,0.9534883720930233,43,1250,900,350,0.72,16,9,7,375.194744124093,0.48468069398301955,0.17179828858486745,0.17871282725955226,122954.04295535374,1703.4644247582744,124657.50738011202,103,0,22.3953488372093,35,8,20,42.75160948379819,0.550297619047619,52.05439814814813,991.7824074074045,28.33664021164013,16
3296,4,11,14,38,0.21153846153846154,0.2692307692307692,0.7307692307692308,52,1250,600,650,0.48,19,6,13,318.36102090524963,0.48684169180492715,0.2398729925638945,0.15996017009565816,125203.33465529776,-2373.2785904518432,122830.05606484592,104,0,19.25,40,12,18,41.831251692391014,0.5645833333333333,49.796747967479675,1000.8130081300812,25.020325203252032,0
3297,4,6,6,38,0.13636363636363635,0.13636363636363635,0.8636363636363636,44,1200,1000,200,0.8333333333333334,14,10,4,339.57106319267376,0.48545410500352365,0.22736728581212962,0.17128788797348027,125366.25888980238,-285.8492360603332,125080.40965374206,105,0,17.65909090909091,36,8,15,41.13230443419919,0.5732060185185186,49.634009009009034,1001.4639639639674,27.81844344344354,0
3298,4,4,5,37,0.09523809523809523,0.11904761904761904,0.8809523809523809,42,1350,1000,350,0.7407407407407407,17,10,7,349.7132187360878,0.48387291908633373,0.23438273438273494,0.17706532443374567,125521.37586805571,379.2968750000256,125900.67274305574,106,0,18.761904761904763,35,7,18,40.71812196812197,0.5767857142857142,49.47916666666668,1002.0833333333346,28.63095238095242,0
3299,4,4,4,37,0.0975609756097561,0.0975609756097561,0.9024390243902439,41,1000,600,400,0.6,14,6,8,344.09420734307,0.484349593495935,0.21116083609227387,0.17581855461825321,125898.59992551853,464.1957893947059,126362.79571491324,107,0,18.682926829268293,35,6,21,40.46978914388962,0.580654761904762,49.10300925925925,1003.5879629629616,28.673941798941758,0
3300,4,1,0,38,0.02631578947368421,0.0,1.0,38,1350,800,550,0.5925925925925926,19,8,11,366.33987002674314,0.48364153627311524,0.21155986643345548,0.18655153381361847,125758.72359963268,1614.0868916437116,127372.8104912764,108,0,20.05263157894737,32,6,24,40.05617447129908,0.5859375,49.24242424242424,1003.030303030303,31.34469696969697,0
3301,4,4,5,37,0.09523809523809523,0.11904761904761904,0.8809523809523809,42,1250,800,450,0.64,17,8,9,335.8168203527751,0.48359465737514523,0.2288227060390915,0.1767995205225828,127122.02558106575,138.58854664454978,127260.6141277103,109,0,19.047619047619047,34,8,17,39.42052296068938,0.595281862745098,47.88690476190476,1008.4523809523808,29.66036414565826,0
3302,4,1,2,36,0.02631578947368421,0.05263157894736842,0.9473684210526316,38,1450,1100,350,0.7586206896551724,18,11,7,360.4991088755876,0.48008534850640117,0.23102274301775472,0.18832360127705092,126805.71697084507,1542.6695936639453,128348.38656450901,110,0,19.789473684210527,32,6,19,39.12341732480882,0.5966796875,48.20075757575759,1007.1969696969718,31.47490530303037,0
3303,4,2,3,35,0.05263157894736842,0.07894736842105263,0.9210526315789473,38,850,400,450,0.47058823529411764,13,4,9,358.5682910254118,0.4810929350403035,0.1726713174504675,0.17890065001428312,124910.73022959197,1478.4723100672945,126389.20253965927,111,0,19.736842105263158,34,4,16,41.12827994124885,0.5726102941176471,50.08928571428572,999.6428571428582,29.401260504201712,16
3304,4,4,2,37,0.10256410256410256,0.05128205128205128,0.9487179487179487,39,1200,700,500,0.5833333333333334,17,7,10,334.825961335737,0.4797570850202429,0.21475113460316897,0.17216036893810466,126156.94400058869,648.1240108351888,126805.06801142388,112,0,19.564102564102566,36,3,17,40.43642342039381,0.5813078703703703,48.845720720720735,1004.6171171171193,27.90603103103109,0
3305,4,3,5,35,0.075,0.125,0.875,40,1200,700,500,0.5833333333333334,17,7,10,327.0654720906013,0.47920673076923076,0.22277305891320887,0.17055322147688778,126732.93856042257,289.99367593876315,127022.93223636133,113,0,19.65,37,3,18,40.039906167193,0.5853040540540541,48.27302631578948,1006.9078947368432,27.213726884779547,0
3306,4,3,1,37,0.07894736842105263,0.02631578947368421,0.9736842105263158,38,1150,800,350,0.6956521739130435,15,8,7,341.79592191827226,0.4796408250355619,0.2302193486011237,0.1795562412489838,127033.66796339166,1083.9179312414287,128117.5858946331,114,0,19.5,35,3,20,39.360409491006486,0.5922619047619048,47.97453703703704,1008.1018518518521,28.80291005291006,0
3307,4,3,2,38,0.075,0.05,0.95,40,1550,1000,550,0.6451612903225806,21,10,11,324.4087512550787,0.4798611111111111,0.23377144130095728,0.17357221506365314,127774.2332704327,290.2292874863175,128064.46255791902,115,0,19.45,36,4,19,39.041267542882586,0.5978009259259259,47.240990990990994,1011.0360360360369,28.084334334334358,0
3308,4,1,4,35,0.02564102564102564,0.10256410256410256,0.8974358974358975,39,1200,900,300,0.75,15,9,6,398.71152073222373,0.4785762483130904,0.22530824693886253,0.20136607055467778,125417.01388888895,2225.574222871526,127642.58811176047,116,0,20.82051282051282,34,5,17,39.59893233499722,0.5778186274509804,49.583333333333336,1001.6666666666672,29.460784313725505,13
3309,4,0,0,35,0.0,0.0,1.0,35,1300,1000,300,0.7692307692307693,16,10,6,420.0727708929534,0.4793417366946779,0.24124513618677068,0.21225778721797856,125437.20959431733,3538.551241473016,128975.76083579035,117,1,23.085714285714285,30,5,17,39.04300281765733,0.5878472222222222,49.56317204301076,1001.7473118279576,33.391577060931915,0
3310,4,2,2,35,0.05405405405405406,0.05405405405405406,0.9459459459459459,37,1050,500,550,0.47619047619047616,16,5,11,428.3228022643967,0.4802302302302302,0.20366552638136892,0.20687817939328942,123545.9201388888,3183.5069444444343,126729.42708333324,118,0,22.783783783783782,34,3,16,40.8127270187203,0.5585171568627452,51.45833333333333,994.166666666666,29.240196078431353,16
3311,4,10,9,36,0.2222222222222222,0.2,0.8,45,1250,900,350,0.72,16,9,7,362.9193789661784,0.48455387205387207,0.21394019044983947,0.18585637483932163,125991.5418836808,154.85026041668993,126146.39214409748,119,0,18.8,39,6,17,39.90151829563533,0.5742521367521367,49.01041666666668,1003.9583333333353,25.74252136752142,0
3312,4,5,4,37,0.12195121951219512,0.0975609756097561,0.9024390243902439,41,1050,800,250,0.7619047619047619,13,8,5,379.757252218607,0.48343495934959346,0.24375964945159856,0.19545698122663882,126197.70828827845,1384.9315392517146,127582.63982753016,120,0,20.097560975609756,33,8,20,39.265840346383705,0.5880681818181819,48.80514705882352,1004.7794117647051,30.44786096256682,0
3313,4,0,3,34,0.0,0.08108108108108109,0.9189189189189189,37,750,600,150,0.8,9,6,3,447.13650793650856,0.48170045045045046,0.09258172458172509,0.2161571516267648,123583.58083677664,4062.566962831735,127646.14779960838,121,1,22.216216216216218,32,5,16,40.305555555555564,0.5634765625,51.42045454545453,994.31818181818,31.072443181818127,16
3314,4,6,5,35,0.15,0.125,0.875,40,1250,1000,250,0.8,15,10,5,398.3831575469486,0.4815438034188034,0.141617665074115,0.1996317811575038,125091.92866025062,1991.689719078532,127083.61837932916,122,0,21.175,33,7,16,39.94484768671647,0.5767045454545454,49.9080882352941,1000.3676470588215,30.31417112299459,0
3315,4,4,3,36,0.10256410256410256,0.07692307692307693,0.9230769230769231,39,1100,700,400,0.6363636363636364,15,7,8,392.29760036547935,0.48425551057130006,0.1767261192644074,0.19941597392144988,125685.46095521505,2061.2209467119737,127746.68190192702,123,0,21.94871794871795,34,5,18,39.48118247655229,0.5805759803921569,49.31547619047617,1002.7380952380922,29.49229691876742,0
3316,4,3,2,37,0.07692307692307693,0.05128205128205128,0.9487179487179487,39,1150,800,350,0.6956521739130435,15,8,7,359.26078490623894,0.483974358974359,0.17160372343433639,0.1736554796124613,123578.62515389349,1079.3907740843292,124658.01592797782,124,0,22.41025641025641,37,2,18,42.49512939273637,0.552927927927928,51.425438596491226,994.298245614035,26.872925557136078,16
3317,4,15,13,39,0.28846153846153844,0.25,0.75,52,1350,900,450,0.6666666666666666,18,9,9,286.38186040790686,0.4874622926093514,0.2329728645163076,0.14948326403826817,126772.54400992456,-3080.340861023967,123692.20314890059,125,0,17.115384615384617,45,7,12,41.02356538945854,0.5736111111111111,48.23369565217392,1007.0652173913059,22.37922705314013,0
3318,4,2,1,40,0.04878048780487805,0.024390243902439025,0.975609756097561,41,850,400,450,0.47058823529411764,13,4,9,348.94775812005145,0.4836128048780488,0.24428678955207173,0.17656060983948088,125493.90798130164,558.16356955983,126052.07155086147,126,0,22.48780487804878,37,4,20,40.76566717735462,0.5726351351351351,49.5065789473684,1001.9736842105239,27.08036984352767,0
3319,4,1,2,39,0.024390243902439025,0.04878048780487805,0.9512195121951219,41,1450,1000,450,0.6896551724137931,19,10,9,347.9255313668727,0.48340955284552845,0.23759260269063942,0.17770878282376446,125882.96402449024,559.5794296515182,126442.54345414176,127,0,21.75609756097561,38,3,23,40.389784946236546,0.5748355263157895,49.11858974358973,1003.5256410256392,26.408569500674716,0
3320,4,4,3,40,0.09302325581395349,0.06976744186046512,0.9302325581395349,43,1300,900,400,0.6923076923076923,17,9,8,326.3809588623085,0.48265042451088963,0.22306446084535647,0.1709105398684303,126903.55994091959,-316.01342775222724,126587.54651316736,128,0,19.930232558139537,38,5,18,39.88221468207683,0.5852521929824561,48.10363247863247,1007.5854700854691,26.515407107512345,0
3321,4,6,6,40,0.13043478260869565,0.13043478260869565,0.8695652173913043,46,750,400,350,0.5333333333333333,11,4,7,309.81477862088275,0.48143115942028986,0.25109492557126045,0.1666572528756421,127990.23321311738,-1269.2070214291866,126721.02619168819,129,0,18.891304347826086,40,6,19,39.18997522680862,0.59296875,47.027439024390254,1011.8902439024405,25.29725609756101,0
3322,4,0,3,37,0.0,0.075,0.925,40,1450,900,550,0.6206896551724138,20,9,11,360.13172883482895,0.4798076923076923,0.18639995498537054,0.18079833573029885,125168.97598612121,1205.1271112654451,126374.10309738666,130,1,21.675,36,4,16,40.82170455398005,0.5711805555555556,49.83108108108108,1000.6756756756754,27.796546546546537,16
3323,4,1,3,35,0.02631578947368421,0.07894736842105263,0.9210526315789473,38,1100,700,400,0.6363636363636364,15,7,8,381.8413917498815,0.4797889995258416,0.19254814016712807,0.19119376480825406,125059.5308956916,1950.5810657596362,127010.11196145123,131,0,23.57894736842105,34,4,17,40.392168531302055,0.5741421568627452,49.94047619047619,1000.2380952380952,29.418767507002798,0
3324,4,1,0,36,0.027777777777777776,0.0,1.0,36,950,400,550,0.42105263157894735,15,4,11,391.4313407437625,0.4798445767195767,0.1770171749036098,0.1964593651294695,125157.87810236224,2598.14320605043,127756.02130841267,132,0,22.333333333333332,32,4,18,40.05021030494216,0.5797526041666667,49.84217171717173,1000.6313131313151,31.269728535353597,0
3325,4,0,0,36,0.0,0.0,1.0,36,1500,1100,400,0.7333333333333333,19,11,8,426.8906381164598,0.4797453703703704,0.11617749825296997,0.20568367109247618,123442.38281250012,3342.404195043888,126784.787007544,133,1,23.333333333333332,33,3,16,40.956935709294214,0.5596590909090908,51.56250000000001,993.7500000000009,30.11363636363639,16
3326,4,6,3,39,0.14285714285714285,0.07142857142857142,0.9285714285714286,42,1000,600,400,0.6,14,6,8,392.9521839465025,0.48286875725900114,0.15946139958964767,0.19767696452181435,125253.50677958365,1464.344126643534,126717.85090622719,134,0,20.857142857142858,36,6,14,39.91286046424419,0.5720486111111112,49.74662162162162,1001.0135135135135,27.80593093093093,0
3327,4,3,4,38,0.07142857142857142,0.09523809523809523,0.9047619047619048,42,1200,800,400,0.6666666666666666,16,8,8,370.75221203817404,0.48336478900503294,0.17572027112283073,0.17940344024707497,123624.30156085148,937.4244176609143,124561.7259785124,135,0,21.547619047619047,36,6,16,42.16184463820632,0.5552662037037037,51.37950450450451,994.4819819819827,27.62449949949952,16
3328,4,10,6,42,0.20833333333333334,0.125,0.875,48,1250,800,450,0.64,17,8,9,325.32050096109987,0.4874963061465721,0.250814919876581,0.15951659703055943,124182.88734764708,-911.0263689037519,123271.86097874332,136,0,18.3125,41,7,12,42.71206579078331,0.5525914634146342,50.818452380952365,996.7261904761879,24.31039488966312,16
3329,4,2,6,38,0.045454545454545456,0.13636363636363635,0.8636363636363636,44,1300,700,600,0.5384615384615384,19,7,12,347.5628739873448,0.4862469168428471,0.16856274040476493,0.16573332745434655,123000.9431906438,-233.36810761633478,122767.57508302746,137,0,18.977272727272727,40,4,14,43.38780179626403,0.5419270833333334,52.00711382113821,991.9715447154472,24.79928861788618,16
3330,4,3,3,38,0.07317073170731707,0.07317073170731707,0.926829268292683,41,850,500,350,0.5882352941176471,12,5,7,355.11252263556895,0.486255081300813,0.19055714274470903,0.17061917948025254,123322.97059911252,558.7062376725969,123881.67683678512,138,0,20.073170731707318,38,3,13,42.864633752823494,0.5485197368421053,51.682692307692314,993.2692307692316,26.138663967611357,0
3331,4,6,7,37,0.13636363636363635,0.1590909090909091,0.8409090909090909,44,1300,800,500,0.6153846153846154,18,8,10,358.23147014679796,0.48730399929527835,0.24772080035505595,0.17824553717020855,124796.83059025726,142.8740738915684,124939.70466414883,139,0,18.727272727272727,40,4,16,41.25474640629238,0.5604166666666667,50.20325203252033,999.1869918699199,24.979674796747997,0
3332,4,3,3,37,0.075,0.075,0.925,40,1150,800,350,0.6956521739130435,15,8,7,370.15453982228377,0.4877537393162393,0.23285259925422253,0.1848340139156398,124945.1814500615,1249.8052285318508,126194.98667859336,140,0,20.275,37,3,19,40.80299042187614,0.5670045045045045,50.05482456140351,999.7807017543855,27.021100047415825,0
3333,4,8,8,37,0.17777777777777778,0.17777777777777778,0.8222222222222222,45,1100,700,400,0.6363636363636364,15,7,8,331.26320475498414,0.48865740740740743,0.1486376276365391,0.1685324477538067,125720.28066145454,-409.54931967335074,125310.7313417812,141,0,17.444444444444443,41,4,16,40.97534787483102,0.5683434959349594,49.280753968253975,1002.8769841269853,24.460414246999644,16
3334,4,1,4,34,0.02631578947368421,0.10526315789473684,0.8947368421052632,38,700,500,200,0.7142857142857143,9,5,4,405.496493194812,0.4842490516832622,0.22672089587862287,0.2025992582961706,124969.3646223806,2565.9371877835824,127535.30181016418,142,0,21.289473684210527,33,5,17,39.894467254974046,0.5754419191919191,50.03063725490195,999.8774509803903,30.299316696375463,16
3335,4,6,0,40,0.15,0.0,1.0,40,1250,700,550,0.56,18,7,11,388.54166666666686,0.48505608974358977,0.2456250000000002,0.1942708333333333,124999.99999999988,2191.497861399446,127191.49786139933,143,0,20.425,33,7,18,40.28645833333334,0.5757575757575757,49.99999999999999,999.9999999999991,30.303030303030276,16
3336,4,5,8,37,0.1111111111111111,0.17777777777777778,0.8222222222222222,45,1250,1100,150,0.88,14,11,3,352.53023883057136,0.48463804713804715,0.24621349812189508,0.18222673563000755,126374.37120075381,-85.50226992923649,126288.86893082458,144,0,19.044444444444444,37,8,13,39.76781170483461,0.5816441441441442,48.62938596491227,1005.4824561403487,27.17520151730672,0
3337,4,2,2,37,0.05128205128205128,0.05128205128205128,0.9487179487179487,39,1000,700,300,0.7,13,7,6,389.6282777500386,0.4840587044534413,0.24619640387275243,0.19978811688884976,126043.8368055557,2022.0486111111297,128065.88541666682,145,0,20.71794871794872,32,7,20,39.17704011065008,0.5888671875,48.95833333333334,1004.1666666666678,31.380208333333368,0
3338,4,3,1,39,0.075,0.025,0.975,40,1250,800,450,0.64,17,8,9,379.57073414005856,0.4827056623931624,0.24071706841977103,0.19757883461511053,126659.88592128047,1615.277177047315,128275.16309832779,146,0,20.85,33,7,18,38.79352325298272,0.5928030303030303,48.34558823529413,1006.6176470588251,30.503565062388642,0
3339,4,1,1,39,0.025,0.025,0.975,40,1400,1200,200,0.8571428571428571,16,12,4,391.603941754089,0.482144764957265,0.2340814196242169,0.19337967845382348,124479.70920138895,1783.2451761341842,126262.95437752313,147,0,21.825,33,7,19,40.75113082811412,0.5703914141414141,50.520833333333336,997.9166666666672,30.239898989899007,16
3340,4,2,2,39,0.04878048780487805,0.04878048780487805,0.9512195121951219,41,1350,1100,250,0.8148148148148148,16,11,5,376.36733440872797,0.48310467479674796,0.2530168339178658,0.18832632064760174,125031.56764934704,1213.7297055147496,126245.29735486179,148,0,22.21951219512195,32,9,21,40.558062955014094,0.5784505208333333,49.968434343434346,1000.1262626262629,31.253945707070717,0
3341,4,5,5,39,0.11363636363636363,0.11363636363636363,0.8863636363636364,44,950,600,350,0.631578947368421,13,6,7,341.257319008748,0.48412174066243835,0.24707825868406474,0.17560490730971792,126189.15741008654,-183.32407464977246,126005.83333543676,77,0,18.15909090909091,35,9,20,40.2417396229313,0.5836309523809524,48.813657407407405,1004.7453703703699,28.707010582010568,0
3342,4,3,2,40,0.07142857142857142,0.047619047619047616,0.9523809523809523,42,1150,800,350,0.6956521739130435,15,8,7,342.33888362293567,0.48191298877274485,0.23448258861810034,0.1776687710647268,126538.268456897,263.79391182266943,126802.06236871966,78,0,18.69047619047619,35,7,19,39.85546320794509,0.587202380952381,48.46643518518517,1006.1342592592569,28.746693121693053,0
3343,4,1,3,38,0.024390243902439025,0.07317073170731707,0.926829268292683,41,1050,800,250,0.7619047619047619,13,8,5,342.00262215416006,0.48056402439024387,0.22174784728332209,0.17794659509621055,126642.2636763038,462.39725056688485,127104.66092687068,79,0,19.414634146341463,34,7,20,39.757047112162425,0.5903799019607843,48.363095238095234,1006.5476190476187,29.604341736694668,0
3344,4,1,0,39,0.02564102564102564,0.0,1.0,39,1000,500,500,0.5,15,5,10,344.13935554373785,0.47947593342330186,0.19960468317053826,0.17945318552336204,126732.14994331055,922.7040816326421,127654.8540249432,80,0,19.82051282051282,34,5,21,39.610920627413876,0.5912990196078431,48.27380952380952,1006.904761904761,29.614845938375325,0
3345,4,2,2,39,0.04878048780487805,0.04878048780487805,0.9512195121951219,41,1250,700,550,0.56,18,7,11,327.9152180146734,0.4781504065040651,0.20009566995543793,0.17338343152637592,127296.330120992,148.990972900226,127445.32109389223,81,0,19.804878048780488,35,6,23,39.441282448293,0.5949404761904762,47.714120370370374,1009.143518518519,28.832671957671973,0
3346,4,0,1,38,0.0,0.02564102564102564,0.9743589743589743,39,1000,600,400,0.6,14,6,8,340.41958017376754,0.47790148448043185,0.1976542413533091,0.17869389865662047,127002.0000708617,846.7935090703045,127848.79357993201,82,1,21.384615384615383,34,5,23,39.427581591275946,0.5940563725490196,48.00595238095239,1007.9761904761906,29.64635854341737,0
3347,4,0,0,38,0.0,0.0,1.0,38,1000,600,400,0.6,14,6,8,339.9139335867142,0.4780257230915126,0.1852543352242011,0.17895655260491342,127122.02558106584,1042.1095521542027,128164.13513322004,83,2,22.473684210526315,34,4,23,39.317229370794465,0.595281862745098,47.886904761904766,1008.4523809523816,29.660364145658285,0
3348,4,0,1,37,0.0,0.02631578947368421,0.9736842105263158,38,1050,600,450,0.5714285714285714,15,6,9,341.97753239181685,0.4773885727833096,0.18312373854991426,0.1805769213096979,127242.10778061242,1102.7884070294986,128344.89618764192,84,3,23.473684210526315,34,4,24,39.142084562438534,0.5965073529411764,47.76785714285715,1008.9285714285729,29.674369747899203,0
3349,4,3,2,38,0.075,0.05,0.95,40,1000,600,400,0.6,14,6,8,352.243455507319,0.4775373931623932,0.0850562429696291,0.17731847788562108,125281.6900515381,1469.798004878854,126751.48805641696,85,0,21.375,36,4,17,40.9024653168354,0.572337962962963,49.71846846846847,1001.1261261261267,27.809059059059074,16
3350,4,3,6,35,0.07317073170731707,0.14634146341463414,0.8536585365853658,41,1050,1000,50,0.9523809523809523,11,10,1,366.8120605033163,0.4786585365853659,0.12831580025458345,0.17520793835502244,123072.96095521543,1019.0581758330327,124092.01913104847,86,0,19.536585365853657,34,7,18,42.83518296340732,0.5536151960784313,51.93452380952381,992.2619047619048,29.18417366946779,16
3351,4,4,2,37,0.10256410256410256,0.05128205128205128,0.9487179487179487,39,1300,700,600,0.5384615384615384,19,7,12,357.3641300373997,0.48242802519118305,0.19220963867235352,0.17467424299958909,124049.43310657617,1069.3523242630608,125118.78543083923,87,0,20.23076923076923,34,5,21,42.05231238049713,0.5637254901960784,50.95238095238096,996.1904761904779,29.29971988795523,0
3352,4,5,4,38,0.11904761904761904,0.09523809523809523,0.9047619047619048,42,1350,1100,250,0.8148148148148148,16,11,5,325.28287061612775,0.48423586914440575,0.19053099700912934,0.16296296697588886,125082.25036790181,-258.949189526899,124823.30117837491,88,0,19.261904761904763,37,5,22,41.78301636888451,0.5684121621621622,49.91776315789475,1000.3289473684223,27.035917496443847,0
3353,4,3,3,38,0.07317073170731707,0.07317073170731707,0.926829268292683,41,1100,800,300,0.7272727272727273,14,8,6,331.452058581116,0.48231707317073175,0.20421754824835703,0.16707889483578714,125338.06610664728,108.71200592485687,125446.77811257214,89,0,20.048780487804876,36,5,18,41.36466299295247,0.5729166666666667,49.66216216216217,1001.3513513513522,27.81531531531534,0
3354,4,4,5,37,0.09523809523809523,0.11904761904761904,0.8809523809523809,42,1200,800,400,0.6666666666666666,16,8,8,318.7111718717173,0.48312282229965153,0.20155722497642858,0.16289296782170362,125909.76902074658,-374.2299930601241,125535.53902768645,90,0,20.095238095238095,38,4,20,41.09515825704349,0.575109649122807,49.09188034188034,1003.6324786324785,26.41138101664417,0
3355,4,5,1,41,0.11904761904761904,0.023809523809523808,0.9761904761904762,42,1250,700,550,0.56,18,7,11,345.83483424892734,0.4865466511807975,0.15323865516275958,0.1723646709855471,124866.48866106017,677.7066668493158,125544.19532790949,91,0,20.404761904761905,38,4,20,41.492294673080345,0.5644188596491229,50.13354700854702,999.4658119658136,26.3017318938372,16
3356,4,3,3,41,0.06818181818181818,0.06818181818181818,0.9318181818181819,44,1150,800,350,0.6956521739130435,15,8,7,331.2850821674699,0.48631298449612403,0.18619226623179208,0.1684075170400016,125686.91673483068,-472.28855321115253,125214.62818161953,92,0,20.34090909090909,40,4,16,41.00917198743288,0.56953125,49.314024390243915,1002.7439024390261,25.068597560975654,0
3357,4,5,3,43,0.10869565217391304,0.06521739130434782,0.9347826086956522,46,1000,500,500,0.5,15,5,10,313.4363852556481,0.48542673107890494,0.2218590704647676,0.16348300669808988,126742.1392746914,-1253.868272210832,125488.27100248057,93,0,19.934782608695652,41,5,16,40.37356321839083,0.578760162601626,48.26388888888889,1006.9444444444448,24.55962059620597,0
3358,4,0,3,40,0.0,0.06976744186046512,0.9302325581395349,43,1100,600,500,0.5454545454545454,16,6,10,338.35193661577864,0.48477297895902544,0.22596866293888662,0.17543622440386403,126500.20089122644,-39.682409233701605,126460.51848199274,94,1,21.813953488372093,38,5,16,39.994866893231375,0.581140350877193,48.5042735042735,1005.9829059829052,26.47323436797119,0
3359,4,2,4,38,0.047619047619047616,0.09523809523809523,0.9047619047619048,42,1700,1100,600,0.6470588235294118,23,11,12,344.0557024288761,0.4814169570267131,0.24253207749073846,0.18052399870489505,126984.30879720926,337.935112133814,127322.24390934307,95,0,22.857142857142858,38,4,19,39.354109250229676,0.5860745614035088,48.023504273504265,1007.9059829059815,26.52384165542057,0
3360,4,5,4,39,0.11627906976744186,0.09302325581395349,0.9069767441860466,43,1400,1000,400,0.7142857142857143,18,10,8,346.8420581711289,0.48124307862679955,0.20066549492273267,0.1779710860051858,126072.1088487137,430.61614467432685,126502.72499338802,96,0,22.023255813953487,36,7,19,40.22202287508411,0.5804398148148149,48.93018018018019,1004.2792792792802,27.896646646646673,16
3361,4,3,5,37,0.07142857142857142,0.11904761904761904,0.8809523809523809,42,1750,1400,350,0.8,21,14,7,334.95447442681973,0.47704945799457993,0.20179000747520082,0.17505270426253056,126822.83676674686,95.97532690479477,126918.81209365165,97,0,22.11904761904762,38,4,17,39.749063074529765,0.5844298245614035,48.183760683760674,1007.2649572649559,26.506972559604105,0
3362,4,1,3,35,0.02631578947368421,0.07894736842105263,0.9210526315789473,38,1350,800,550,0.5925925925925926,19,8,11,376.4943611519876,0.4763217164532954,0.05291575395180925,0.1895263233658647,125281.69005153808,2129.4393744389486,127411.12942597704,98,0,23.473684210526315,36,2,14,40.29550993625797,0.572337962962963,49.71846846846847,1001.1261261261266,27.80905905905907,16
3363,4,2,2,35,0.05405405405405406,0.05405405405405406,0.9459459459459459,37,600,300,300,0.5,9,3,6,366.2566093220708,0.47844719719719725,0.08680562929075641,0.18677619533201675,125817.77459469621,1816.318303100414,127634.09289779663,99,0,24.18918918918919,36,1,17,39.99724061810154,0.5778356481481481,49.183558558558566,1003.265765765767,27.868493493493528,0
3364,4,1,1,35,0.027777777777777776,0.027777777777777776,0.9722222222222222,36,1200,900,300,0.75,15,9,6,366.62283179193406,0.4776951058201058,0.11423382912487057,0.18759408968327104,125956.68463059417,2035.7192804784036,127992.40391107257,100,0,25.72222222222222,35,1,18,39.84456070563821,0.58125,49.04513888888889,1003.8194444444447,28.68055555555556,0
3365,4,1,2,34,0.027777777777777776,0.05555555555555555,0.9444444444444444,36,1100,800,300,0.7272727272727273,14,8,6,369.0302235724229,0.47531415343915345,0.12643723524613915,0.19074842523211036,126372.79620181402,2127.1063879834305,128499.90258979745,101,0,25.77777777777778,34,2,17,39.35467479674798,0.5876225490196079,48.63095238095238,1005.4761904761901,29.57282913165265,0
3366,4,1,3,32,0.02857142857142857,0.08571428571428572,0.9142857142857143,35,1300,1000,300,0.7692307692307693,16,10,6,379.724398939955,0.4728991596638656,0.1350541823937661,0.19750959395147888,126629.0477971213,2616.827812620144,129245.87560974144,102,0,26.314285714285713,33,2,19,38.82145683672226,0.5924873737373737,48.37622549019608,1006.4950980392157,30.499851455733808,0
3367,4,2,0,34,0.058823529411764705,0.0,1.0,34,1200,900,300,0.75,15,9,6,381.5321506715088,0.4729092394533571,0.12625466122304618,0.2000913026714839,126964.73095857569,2888.22537241098,129852.95633098666,103,0,26.0,32,2,21,38.42995698655307,0.5983072916666667,48.042929292929294,1007.8282828282831,31.494633838383848,0
3368,4,2,1,35,0.05555555555555555,0.027777777777777776,0.9722222222222222,36,1150,900,250,0.782608695652174,14,9,5,362.625914560644,0.47311507936507935,0.1422756837555046,0.19416135113821378,127803.53597474538,2069.038592388411,129872.5745671338,104,0,25.5,33,3,19,38.045262190441576,0.6044823232323233,47.212009803921575,1011.1519607843144,30.640968508615586,0
3369,4,1,5,31,0.027777777777777776,0.1388888888888889,0.8611111111111112,36,1300,1000,300,0.7692307692307693,16,10,6,360.258035544549,0.4725859788359788,0.14165421931559763,0.1937883126704457,127989.47707912826,2021.8475165801665,130011.32459570843,105,0,26.22222222222222,33,3,20,37.91467340842113,0.6063762626262627,47.02818627450981,1011.8872549019611,30.663250148544275,0
3370,4,4,1,34,0.11428571428571428,0.02857142857142857,0.9714285714285714,35,1150,900,250,0.782608695652174,14,9,5,362.80129268931796,0.47468487394957987,0.12276635514018697,0.19685465678375752,128336.36435376483,2312.1197773186295,130648.48413108346,106,0,24.37142857142857,32,3,24,37.49532710280375,0.6123046875,46.685606060606055,1013.2575757575751,31.66429924242422,0
3371,4,1,2,33,0.02857142857142857,0.05714285714285714,0.9428571428571428,35,1150,700,450,0.6086956521739131,16,7,9,363.14093724702764,0.47380952380952385,0.11992743312464427,0.19814864184566078,128560.3509845934,2337.1052698704184,130897.45625446382,107,0,25.057142857142857,32,3,19,37.25773987383798,0.6145833333333333,46.464646464646464,1014.1414141414141,31.69191919191919,0
3372,4,3,4,32,0.08333333333333333,0.1111111111111111,0.8888888888888888,36,800,500,300,0.625,11,5,6,358.26789152052373,0.473478835978836,0.1363161279948546,0.19805049043254544,129076.82742214527,2048.816560938096,131125.64398308337,108,0,25.22222222222222,33,3,21,36.854297314680835,0.6174242424242424,45.955882352941174,1016.1764705882348,30.79322638146166,0
3373,4,0,2,30,0.0,0.0625,0.9375,32,950,600,350,0.631578947368421,13,6,7,379.82522801042245,0.4690860215053763,0.10467046183450912,0.20835592205075615,128771.51701185446,3382.13416205513,132153.6511739096,109,1,24.59375,31,1,21,36.618692537951674,0.6192876344086021,46.25651041666667,1014.973958333334,32.74109543010755,0
3374,4,1,1,30,0.03225806451612903,0.03225806451612903,0.967741935483871,31,700,400,300,0.5714285714285714,10,4,6,385.5458089449869,0.46917562724014333,0.09324596774193528,0.21160188583957437,128791.76783443181,3731.0252630361983,132522.793097468,110,0,25.322580645161292,30,1,23,36.45281603107344,0.6222222222222222,46.23655913978495,1015.053763440861,33.8351254480287,0
3375,4,0,1,29,0.0,0.03333333333333333,0.9666666666666667,30,1200,900,300,0.75,15,9,6,395.7199209449929,0.46803160919540227,0.09332238642583457,0.21711119986982058,128778.1250000001,4192.013888888902,132970.138888889,111,1,26.933333333333334,29,1,23,36.20860700602079,0.625,46.25000000000001,1015.0000000000008,35.00000000000003,0
3376,4,0,1,28,0.0,0.034482758620689655,0.9655172413793104,29,1150,800,350,0.6956521739130435,15,8,7,405.68575391083374,0.4671079638752052,0.08663396539522106,0.2227016201538495,128800.00092895378,4650.465096115752,133450.46602506953,112,2,27.24137931034483,28,1,23,35.93329794762915,0.6283482142857143,46.22844827586208,1015.0862068965531,36.25307881773404,0
3377,4,0,0,28,0.0,0.0,1.0,28,1050,700,350,0.6666666666666666,14,7,7,416.62185180078745,0.46660052910052907,0.08300966945826738,0.2280762416602452,128690.63986325811,5123.066537851773,133813.70640110987,113,3,27.75,28,0,23,35.76801897479467,0.6272321428571428,46.33620689655173,1014.6551724137938,36.237684729064064,0
3378,4,1,1,28,0.034482758620689655,0.034482758620689655,0.9655172413793104,29,850,600,250,0.7058823529411765,11,6,5,403.69854293048877,0.46623563218390807,0.08030425131837515,0.22327001047788272,129095.50781250009,4623.133680555571,133718.64149305565,114,0,27.75862068965517,29,0,24,35.68103389367228,0.6282327586206897,45.93750000000001,1016.2500000000007,35.043103448275886,0
3379,4,0,0,28,0.0,0.0,1.0,28,900,600,300,0.6666666666666666,12,6,6,405.1330287557104,0.4644510582010582,0.060597189695549725,0.2246646795827123,129201.38888888896,4868.7500000000055,134070.13888888896,115,1,28.25,28,0,24,35.53620218579233,0.6324404761904762,45.833333333333336,1016.6666666666673,36.30952380952383,0
3380,4,1,1,28,0.034482758620689655,0.034482758620689655,0.9655172413793104,29,800,500,300,0.625,11,5,6,440.1146362637494,0.46623563218390807,0.08399707586971372,0.22321204005027942,125590.97463348754,5254.885223765417,130845.85985725296,116,0,28.24137931034483,29,0,17,38.380877326682366,0.5923132183908046,49.409722222222214,1002.3611111111102,34.564176245210696,16
3381,4,1,0,29,0.034482758620689655,0.0,1.0,29,1250,900,350,0.72,16,9,7,434.8054962384661,0.4654146141215107,0.09754144081008054,0.22352154614732228,126148.45920138885,5170.008680555551,131318.4678819444,117,0,28.93103448275862,29,0,20,37.93420779759436,0.5980603448275862,48.854166666666664,1004.5833333333329,34.640804597701134,0
3382,4,2,2,29,0.06451612903225806,0.06451612903225806,0.935483870967742,31,700,600,100,0.8571428571428571,8,6,2,413.26992958058725,0.467741935483871,0.08942499395213455,0.21567001588233883,126763.9923095703,4277.549235026042,131041.54154459634,118,0,28.0,31,0,16,37.837794155676235,0.5987903225806452,48.2421875,1007.0312499999999,32.484879032258064,0
3383,4,2,0,31,0.06451612903225806,0.0,1.0,31,1000,700,300,0.7,13,7,6,413.08960027940293,0.46550179211469533,0.10955663383244074,0.21749686975961774,127124.83935885965,4302.789815266932,131427.62917412657,119,0,28.64516129032258,31,0,19,37.46946955024746,0.602486559139785,47.884114583333336,1008.4635416666672,32.531081989247326,0
3384,4,2,1,32,0.06060606060606061,0.030303030303030304,0.9696969696969697,33,1000,600,400,0.6,14,6,8,398.7552540913713,0.465988005050505,0.10013366823836978,0.21367067251701272,127834.51677239523,3594.9370434448256,131429.45381584007,120,0,27.848484848484848,33,0,16,37.10009694619485,0.6047979797979798,47.181372549019606,1011.2745098039215,30.64468211527035,0
3385,4,1,1,32,0.030303030303030304,0.030303030303030304,0.9696969696969697,33,1150,900,250,0.782608695652174,14,9,5,388.798977829667,0.4639362373737374,0.07119058951519719,0.21045515520577526,128240.42986685032,3372.325066288873,131612.7549331392,121,0,27.333333333333332,32,1,20,36.935147095487416,0.611328125,46.78030303030303,1012.8787878787879,31.65246212121212,0
3386,4,0,1,31,0.0,0.03125,0.96875,32,950,700,250,0.7368421052631579,12,7,5,408.17930501441015,0.461945564516129,0.1316433897876641,0.20285896113530233,124747.60228548109,3783.8779206203435,128531.48020610143,122,1,29.09375,32,0,16,40.05835018537243,0.5755208333333333,50.25252525252525,998.9898989898991,31.218434343434346,16
3387,4,6,3,34,0.16216216216216217,0.08108108108108109,0.9189189189189189,37,750,500,250,0.6666666666666666,10,5,5,365.1103144486184,0.4706894394394394,0.14149651835241372,0.18746695517653278,126098.89581409673,1808.0015004616896,127906.89731455842,123,0,25.972972972972972,37,0,16,39.735716885007264,0.5788288288288288,48.90350877192983,1004.3859649122815,27.14556661925085,0
3388,4,2,2,34,0.05555555555555555,0.05555555555555555,0.9444444444444444,36,650,600,50,0.9230769230769231,7,6,1,370.0388606245854,0.47132936507936507,0.15854509217737944,0.1901351749292225,126128.66244623001,2134.501308741178,128263.16375497119,124,0,27.555555555555557,36,0,18,39.58123131539612,0.5810185185185186,48.873873873873876,1004.5045045045046,27.902902902902905,0
3389,4,3,7,30,0.08108108108108109,0.1891891891891892,0.8108108108108107,37,950,800,150,0.8421052631578947,11,8,3,366.59190658438814,0.4728165665665666,0.15957077146878862,0.19051984816712958,126594.96792282215,1881.7381309633467,128476.7060537855,125,0,27.08108108108108,37,0,16,39.1870051572601,0.5838963963963963,48.41008771929823,1006.359649122805,27.198909435751485,0
3390,4,0,0,30,0.0,0.0,1.0,30,1000,600,400,0.6,14,6,8,423.1554186761556,0.468845785440613,0.15359424563284652,0.2152121730567686,125706.64103147756,4638.689263209609,130345.33029468717,126,1,30.133333333333333,30,0,17,38.68560961443953,0.590625,49.29435483870967,1002.8225806451607,33.42741935483869,0
3391,4,2,2,30,0.0625,0.0625,0.9375,32,1450,1300,150,0.896551724137931,16,13,3,451.55428497090844,0.4723622311827957,0.07401744354371709,0.2160205679071357,123139.16138195287,5578.204519246743,128717.36590119962,127,0,29.1875,28,4,20,40.66330100366725,0.5699404761904762,51.86781609195403,992.5287356321853,35.44745484400662,16
3392,4,6,3,33,0.16666666666666666,0.08333333333333333,0.9166666666666666,36,1300,1000,300,0.7692307692307693,16,10,6,385.0456983198926,0.47490079365079363,0.127842303861746,0.192668791938842,125031.56764934705,2434.033638497971,127465.60128784503,128,0,26.63888888888889,32,4,18,40.34107646340951,0.5784505208333333,49.968434343434346,1000.126262626263,31.25394570707072,0
3393,4,4,1,36,0.10810810810810811,0.02702702702702703,0.972972972972973,37,900,600,300,0.6666666666666666,12,6,6,378.27129201762307,0.4734734734734735,0.14232472080882852,0.19195156133400473,125613.49601114952,2103.195886197609,127716.69189734713,129,0,26.81081081081081,33,4,20,39.90729421352893,0.5820707070707071,49.38725490196078,1002.4509803921565,30.37730243612595,0
3394,4,1,3,34,0.02702702702702703,0.08108108108108109,0.9189189189189189,37,1050,700,350,0.6666666666666666,14,7,7,378.2973051181444,0.4727227227227227,0.14805076403707562,0.1922502205265002,125674.92821270647,2108.497332756608,127783.42554546308,130,0,27.783783783783782,33,4,21,39.843049784078865,0.5827020202020202,49.32598039215685,1002.696078431371,30.384729649435485,0
3395,4,1,0,35,0.02857142857142857,0.0,1.0,35,1000,800,200,0.8,12,8,4,373.32177162170444,0.47209383753501405,0.12465122767857184,0.19114074707031237,125982.31449442492,2406.3881680122663,128388.7026624372,131,0,28.257142857142856,33,2,22,39.64996337890623,0.5858585858585859,49.01960784313724,1003.9215686274486,30.42186571598329,0
3396,4,2,2,35,0.05405405405405406,0.05405405405405406,0.9459459459459459,37,750,300,450,0.4,12,3,9,358.7902310903785,0.4726288788788789,0.13387683579659693,0.1870051659829359,126713.00482520985,1692.6776566786461,128405.68248188849,132,0,27.675675675675677,35,2,16,39.26181649231711,0.5889880952380953,48.29282407407406,1006.8287037037021,28.766534391534346,0
3397,4,2,2,35,0.05405405405405406,0.05405405405405406,0.9459459459459459,37,1500,1000,500,0.6666666666666666,20,10,10,421.6325921430943,0.4719094094094094,0.15968860687304787,0.2026257545748155,123332.61792482939,3332.817552807849,126665.43547763723,133,0,28.594594594594593,32,5,17,41.20270327528494,0.5608723958333333,51.672979797979814,993.3080808080832,31.0408775252526,16
3398,4,6,3,38,0.14634146341463414,0.07317073170731707,0.926829268292683,41,1250,900,350,0.72,16,9,7,379.6469367123842,0.474390243902439,0.2009125052661771,0.190242967733775,125091.92866025092,1322.1386209763407,126414.06728122727,134,0,26.4390243902439,33,8,17,40.41342541549267,0.5767045454545454,49.90808823529412,1000.367647058824,30.314171122994665,0
3399,4,2,1,39,0.05,0.025,0.975,40,1200,900,300,0.75,15,9,6,383.99902043256793,0.47294337606837605,0.21299495586380823,0.19346329301335882,125315.85584379162,1624.2331777369895,126940.0890215286,135,0,27.925,32,8,12,40.07224674232871,0.5813802083333333,49.68434343434345,1001.2626262626277,31.289457070707115,0
3400,4,0,3,36,0.0,0.07692307692307693,0.9230769230769231,39,1150,700,450,0.6086956521739131,16,7,9,411.80988555435414,0.471378767431399,0.18412934205082587,0.19849085175739897,123458.06749630158,2580.9360970819566,126039.00359338353,136,1,29.641025641025642,32,7,15,41.315165375005286,0.5621744791666667,51.546717171717184,993.8131313131328,31.0566603535354,16
3401,4,9,8,37,0.2,0.17777777777777778,0.8222222222222222,45,950,600,350,0.631578947368421,13,6,7,355.7710292932007,0.479040404040404,0.2766630236794172,0.1814551236361642,125823.72100069246,-46.09274996602383,125777.62825072644,137,0,26.377777777777776,37,8,18,40.25409836065572,0.5760135135135135,49.17763157894736,1003.2894736842101,27.115931721194865,0
3402,4,5,5,37,0.11904761904761904,0.11904761904761904,0.8809523809523809,42,1000,600,400,0.6,14,6,8,349.1691924911962,0.4800982384823848,0.1778808588376417,0.17629581049117904,125405.42079260961,423.4876742107534,125828.90846682037,138,0,25.785714285714285,35,7,17,40.85153300978352,0.575595238095238,49.5949074074074,1001.6203703703693,28.61772486772484,16
3403,4,2,3,36,0.05128205128205128,0.07692307692307693,0.9230769230769231,39,1800,1400,400,0.7777777777777778,22,14,8,370.27633257989237,0.4773672964462438,0.07083796623875482,0.17545472546282603,122731.73862033436,1440.3992703912868,124172.13789072564,139,0,28.28205128205128,31,8,21,43.106110381077535,0.5571236559139785,52.27864583333334,990.885416666668,31.964045698924775,16
3404,4,7,6,37,0.16279069767441862,0.13953488372093023,0.8604651162790697,43,1200,700,500,0.5833333333333334,17,7,10,313.96461657513316,0.47812846068660025,0.1097218905877324,0.15519622959874013,124521.85451921546,-780.9087381299819,123740.94578108548,140,0,26.11627906976744,36,7,18,42.64451464891498,0.564525462962963,50.478603603603624,998.0855855855881,27.72459959959967,0
3405,4,3,1,39,0.075,0.025,0.975,40,1600,1200,400,0.75,20,12,8,323.974081459339,0.477457264957265,0.14743948968641973,0.16049442535141634,124613.39462868498,74.30201247167838,124687.69664115665,141,0,28.8,34,6,21,42.30008743690633,0.569546568627451,50.38690476190477,998.4523809523823,29.36624649859948,0
3406,4,6,2,43,0.13333333333333333,0.044444444444444446,0.9555555555555556,45,1400,1200,200,0.8571428571428571,16,12,4,301.24374311560194,0.48055555555555557,0.20114147966960894,0.1548712365509024,126151.14239763682,-1391.3882678591906,124759.75412977763,142,0,25.466666666666665,38,7,20,41.28580417597218,0.5775767543859649,48.85149572649573,1004.5940170940174,26.43668466036888,0
3407,4,1,2,42,0.022727272727272728,0.045454545454545456,0.9545454545454546,44,900,500,400,0.5555555555555556,13,5,8,309.58807582974043,0.4803889182522903,0.20671727639656057,0.15970702820096955,126291.6970245651,-980.3193049784725,125311.37771958663,143,0,26.977272727272727,37,7,11,40.93203428966218,0.5807995495495495,48.711622807017534,1005.1535087719286,27.166311047889963,0
3408,4,1,7,36,0.023255813953488372,0.16279069767441862,0.8372093023255813,43,1450,1100,350,0.7586206896551724,18,11,7,372.3370630414727,0.4795819490586932,0.1336699191670807,0.18743354985496574,125281.69005153811,1124.87054044317,126406.56059198128,144,0,28.441860465116278,36,7,16,40.399559430071236,0.572337962962963,49.71846846846847,1001.1261261261269,27.80905905905908,16
3409,4,5,4,37,0.12195121951219512,0.0975609756097561,0.9024390243902439,41,1200,800,400,0.6666666666666666,16,8,8,353.8709287636623,0.4767530487804878,0.20103573136571717,0.1824551149171398,126270.10192202356,736.6636484457672,127006.76557046933,145,0,29.097560975609756,36,5,16,39.84150326797386,0.5824652777777778,48.73310810810812,1005.0675675675691,27.918543543543585,0
3410,4,3,1,39,0.075,0.025,0.975,40,1400,700,700,0.5,21,7,14,349.0702154992596,0.4768429487179487,0.20704898780896985,0.18198465287340468,126723.24087178432,847.0617999756978,127570.30267176002,146,0,29.75,36,4,18,39.495954964023426,0.5870949074074074,48.28265765765768,1006.8693693693725,27.96859359359368,0
3411,4,3,1,41,0.07142857142857142,0.023809523809523808,0.9761904761904762,42,1350,900,450,0.6666666666666666,18,9,9,338.0438525813111,0.4766865079365079,0.22836004801206733,0.17934326522154062,127432.89531085141,216.65297053811486,127649.54828138952,147,0,29.261904761904763,36,6,19,39.04588631124993,0.5943287037037037,47.57882882882883,1009.6846846846848,28.0467967967968,0
3412,4,0,2,39,0.0,0.04878048780487805,0.9512195121951219,41,1450,900,550,0.6206896551724138,20,9,11,344.8557166093392,0.47583841463414633,0.22509969913439853,0.18295718077629244,127432.89531085164,589.1924864053485,128022.08779725699,148,1,30.829268292682926,36,5,19,38.8739404416685,0.5943287037037037,47.57882882882884,1009.6846846846868,28.046796796796855,0
3413,4,0,0,39,0.0,0.0,1.0,39,1200,800,400,0.6666666666666666,16,8,8,353.7909576770737,0.47309379217273956,0.21631124359856324,0.1874705183997228,127383.9444551612,1213.4575402949295,128597.40199545612,149,2,32.15384615384615,35,4,19,38.698597416494685,0.5958333333333333,47.62731481481482,1009.4907407407409,28.842592592592595,0
3414,4,0,2,37,0.0,0.05128205128205128,0.9487179487179487,39,1200,800,400,0.6666666666666666,16,8,8,349.58464924511765,0.47303756185335133,0.22036078054802943,0.18625139388522527,127603.50722343962,1121.6454630305925,128725.15268647022,150,3,33.15384615384615,36,3,19,38.579748105216204,0.5960648148148149,47.409909909909906,1010.3603603603601,28.06556556556556,0
3415,4,2,0,39,0.05128205128205128,0.0,1.0,39,1200,800,400,0.6666666666666666,16,8,8,348.6137081554025,0.47233468286099867,0.22651854894845558,0.18785012043769514,128059.03031409778,1128.6266841165361,129187.65699821431,151,0,32.48717948717949,36,3,22,38.138119344310915,0.6006944444444444,46.95945945945945,1012.1621621621613,28.115615615615592,0
3416,4,2,4,37,0.04878048780487805,0.0975609756097561,0.9024390243902439,41,1150,700,450,0.6086956521739131,16,7,9,338.1110107457444,0.47273882113821136,0.24264495182878165,0.18514798446020844,128701.77636584776,503.18313916940315,129204.95950501716,152,0,31.853658536585368,35,6,22,37.74820824303261,0.6092261904761904,46.325231481481474,1014.6990740740729,28.99140211640208,0
3417,4,1,1,37,0.02631578947368421,0.02631578947368421,0.9736842105263158,38,1750,1300,450,0.7428571428571429,22,13,9,360.19709059467897,0.4719505689900427,0.24105314046537685,0.19632876993283077,128517.04422577842,1658.2930843906051,130175.33731016902,153,0,33.86842105263158,33,5,23,37.37662154540328,0.6117424242424243,46.507352941176464,1013.970588235293,30.726381461675544,0
3418,4,0,1,36,0.0,0.02702702702702703,0.972972972972973,37,1150,700,450,0.6086956521739131,16,7,9,357.17973982556333,0.47081456456456455,0.21785540524213998,0.19514037666905504,128610.25694744794,1787.3956230776446,130397.65257052558,154,1,34.2972972972973,33,4,23,37.35791450203375,0.6126893939393939,46.41544117647058,1014.3382352941163,30.737522281639887,0
3419,4,1,0,37,0.02702702702702703,0.0,1.0,37,650,400,250,0.6153846153846154,9,4,5,353.0556131312338,0.471534034034034,0.20792931995249742,0.19394646546280764,128827.88470780461,1696.6815647827655,130524.56627258737,155,0,34.189189189189186,33,4,25,37.240463544181566,0.6148989898989898,46.20098039215686,1015.1960784313718,30.76351752822339,0
3420,4,1,1,37,0.02631578947368421,0.02631578947368421,0.9736842105263158,38,1150,800,350,0.6956521739130435,15,8,7,344.3817803676152,0.4703799193930773,0.21675900277008253,0.19159804023767335,129329.78777675758,1308.8458287040244,130638.63360546161,156,0,34.26315789473684,32,6,26,36.94968553459118,0.6223958333333333,45.70707070707071,1017.1717171717181,31.78661616161619,0
3421,4,0,0,37,0.0,0.0,1.0,37,1300,600,700,0.46153846153846156,20,6,14,346.56358212196403,0.46871871871871873,0.2081561915172565,0.19299367548958732,129366.91496107337,1566.7722913954358,130933.68725246881,157,1,35.189189189189186,31,6,26,36.856441187764005,0.6253360215053764,45.670572916666686,1017.3177083333353,32.816700268817264,0
3422,4,0,0,37,0.0,0.0,1.0,37,1300,1000,300,0.7692307692307693,16,10,6,343.46830944638043,0.4674674674674675,0.21023776411253126,0.1924997856626174,129618.91842987994,1503.9981570758546,131122.9165869558,158,2,36.189189189189186,32,5,24,36.67906592271134,0.6253255208333333,45.42297979797982,1018.3080808080836,31.82212752525261,0
3423,4,1,1,37,0.02631578947368421,0.02631578947368421,0.9736842105263158,38,750,400,350,0.5333333333333333,11,4,7,335.6530824855359,0.4677275960170697,0.20335207546010325,0.18976030702895175,129958.9445153064,1124.2240646258806,131083.16857993227,159,0,36.21052631578947,34,4,25,36.53312901342675,0.6240808823529411,45.08928571428573,1019.6428571428594,29.989495798319393,0
3424,4,0,0,37,0.0,0.0,1.0,37,1150,700,450,0.6086956521739131,16,7,9,341.9638405667313,0.46878128128128127,0.1971344917118627,0.19282123810125493,129856.32216275025,1481.2333297289897,131337.55549247924,160,1,35.054054054054056,33,4,25,36.47636868261792,0.6253156565656566,45.189950980392176,1019.2401960784342,30.88606654783134,0
3425,4,0,1,36,0.0,0.02702702702702703,0.972972972972973,37,1250,900,350,0.72,16,9,7,341.69286242603545,0.4683746246246246,0.1903456340956342,0.19313074832775948,129950.01922337587,1480.5988081507458,131430.61803152662,161,2,36.054054054054056,33,4,25,36.38822115384616,0.6262626262626263,45.09803921568629,1019.607843137257,30.897207367795666,0
3426,4,0,0,36,0.0,0.0,1.0,36,1100,700,400,0.6363636363636364,15,7,8,351.4021189555199,0.46734457671957674,0.1866485013623982,0.19840704254873198,129908.37191358028,1930.0154320987724,131838.38734567905,162,3,37.138888888888886,32,4,25,36.18301544050864,0.6282552083333333,45.13888888888889,1019.4444444444447,31.857638888888896,0
3427,4,1,0,37,0.02702702702702703,0.0,1.0,37,1050,700,350,0.6666666666666666,14,7,7,342.0241566014159,0.46656031031031026,0.1809156094870379,0.194874228761272,130262.58680555565,1510.5902777777865,131773.17708333343,163,0,37.108108108108105,33,4,26,36.06292517006802,0.6294191919191919,44.79166666666667,1020.8333333333342,30.93434343434346,0
3428,4,2,2,37,0.05128205128205128,0.05128205128205128,0.9487179487179487,39,1500,1300,200,0.8666666666666667,17,13,4,357.3596141742056,0.46699280251911834,0.10335472851655014,0.191818360179294,127903.57320011331,1619.2920918367254,129522.86529195005,164,0,36.15384615384615,34,5,18,38.0759385665529,0.6032475490196079,47.113095238095234,1011.5476190476186,29.751400560224077,15
3429,4,0,0,37,0.0,0.0,1.0,37,950,600,350,0.631578947368421,13,6,7,374.4308378571726,0.46621621621621623,0.12936532037655613,0.20074906367041215,127857.0506198349,2174.72451790636,130031.77513774126,165,1,38.945945945945944,32,5,19,37.69194756554307,0.607421875,47.15909090909092,1011.363636363638,31.605113636363686,0
3430,4,0,1,36,0.0,0.02702702702702703,0.972972972972973,37,950,600,350,0.631578947368421,13,6,7,374.754465627066,0.46602852852852855,0.1359731824848105,0.20143052527454772,127958.47750865034,2190.6021722414234,130149.07968089177,166,2,39.945945945945944,33,4,19,37.57973998708011,0.6060606060606061,47.058823529411754,1011.7647058823514,30.659536541889437,0
3431,4,2,0,38,0.05263157894736842,0.0,1.0,38,1100,900,200,0.8181818181818182,13,9,4,351.73611111111126,0.4667051920341394,0.17500000000000004,0.1758680555555556,124999.99999999997,1358.9791186082264,126358.9791186082,167,0,36.21052631578947,35,3,20,41.20659722222223,0.5714285714285714,50.0,999.9999999999998,28.571428571428566,16
3432,4,4,2,40,0.09523809523809523,0.047619047619047616,0.9523809523809523,42,800,500,300,0.625,11,5,6,328.35284961568874,0.4701292102206736,0.18973252889409342,0.1680476055096334,125965.39849175364,-127.78049045136922,125837.61800130227,168,0,33.666666666666664,39,3,16,40.79599892774376,0.5739850427350428,49.03645833333334,1003.8541666666681,25.739850427350465,0
3433,4,1,0,41,0.024390243902439025,0.0,1.0,41,1400,1000,400,0.7142857142857143,18,10,8,341.2646438186714,0.4686737804878049,0.20075497415092003,0.17545828656939755,126153.96684556775,410.40212643552195,126564.36897200327,169,0,34.36585365853659,37,4,18,40.27777777777777,0.5793918918918919,48.84868421052631,1004.6052631578937,27.15149359886199,0
3434,4,0,1,40,0.0,0.024390243902439025,0.975609756097561,41,1550,900,650,0.5806451612903226,22,9,13,346.1326967950174,0.4685467479674797,0.21024714773268371,0.17879947588245138,126346.81013629178,546.5524247845324,126893.36256107631,170,1,35.36585365853659,37,4,15,39.95698822118007,0.5813626126126126,48.65679824561403,1005.3728070175426,27.17223802750115,0
3435,4,2,3,39,0.047619047619047616,0.07142857142857142,0.9285714285714286,42,1350,900,450,0.6666666666666666,18,9,9,336.7508886602779,0.4699961285327139,0.20801127580249235,0.17575935085890232,126769.0355851412,137.91707758052888,126906.95266272173,171,0,34.92857142857143,38,4,17,39.75904413324847,0.5838815789473684,48.23717948717948,1007.0512820512809,26.501349527665287,0
3436,4,4,2,41,0.09302325581395349,0.046511627906976744,0.9534883720930233,43,1000,800,200,0.8,12,8,4,323.05270440310113,0.4691768180140273,0.2115616490954515,0.17114040068458666,127373.97057183213,-370.2988672417295,127003.67170459041,172,0,32.093023255813954,40,3,14,39.48454646129065,0.58671875,47.637195121951216,1009.4512195121943,25.236280487804855,0
3437,4,0,1,40,0.0,0.024390243902439025,0.975609756097561,41,1050,800,250,0.7619047619047619,13,8,5,331.64589916690596,0.46750508130081303,0.21025217031831311,0.17470632188256646,127145.88355613986,233.48217546934023,127379.3657316092,173,1,34.65853658536585,38,3,19,39.5012358757062,0.5877192982456141,47.86324786324786,1008.5470085470077,26.540710751237047,0
3438,4,0,1,39,0.0,0.025,0.975,40,1150,900,250,0.782608695652174,14,9,5,339.3814730704526,0.46638621794871793,0.21488910632746294,0.17878755952474348,127147.30133310234,630.2876846721915,127777.58901777453,174,2,36.3,37,3,19,39.304740160904544,0.589527027027027,47.86184210526315,1008.5526315789461,27.25817923186341,0
3439,4,2,3,38,0.04878048780487805,0.07317073170731707,0.926829268292683,41,1100,700,400,0.6363636363636364,15,7,8,386.46925394584775,0.466895325203252,0.20376616552822924,0.19243226866023352,124826.44917052465,1693.7049407296163,126520.15411125426,175,0,35.90243902439025,35,6,17,40.518589298123686,0.5696428571428571,50.17361111111111,999.3055555555552,28.55158730158729,16
3440,4,3,2,39,0.07317073170731707,0.04878048780487805,0.9512195121951219,41,1650,1300,350,0.7878787878787878,20,13,7,371.0820930697024,0.4698678861788618,0.19826835188939107,0.1869674541145017,125318.4896503129,1100.8100512259914,126419.29970153888,176,0,35.75609756097561,35,6,15,40.39284957423035,0.574702380952381,49.68171296296296,1001.2731481481479,28.607804232804227,0
3441,4,2,2,39,0.04878048780487805,0.04878048780487805,0.9512195121951219,41,1550,1000,550,0.6451612903225806,21,10,11,365.99814583943476,0.4684959349593496,0.19116814652732583,0.18570064095579042,125608.37733892743,994.4866415894976,126602.86398051692,177,0,36.609756097560975,35,6,17,40.2201679944579,0.5776785714285715,49.39236111111111,1002.4305555555552,28.640873015873005,0
3442,4,3,0,42,0.07142857142857142,0.0,1.0,42,900,600,300,0.6666666666666666,12,6,6,354.54336051286054,0.47182297715834304,0.21732036332647486,0.18253007616516015,126209.04989996909,549.3161357340596,126758.36603570315,178,0,36.04761904761905,37,5,20,39.88751273097628,0.579954954954955,48.7938596491228,1004.8245614035077,27.157420578473182,0
3443,4,3,5,40,0.06666666666666667,0.1111111111111111,0.8888888888888888,45,1100,700,400,0.6363636363636364,15,7,8,354.82730425971033,0.4724957912457912,0.1454828433160671,0.17953554298589353,125493.90798130215,138.71335410897836,125632.62133541112,179,0,34.577777777777776,37,8,15,40.61838841467862,0.5726351351351351,49.50657894736843,1001.9736842105281,27.080369843527784,14
3444,4,3,3,40,0.06976744186046512,0.06976744186046512,0.9302325581395349,43,1250,900,350,0.72,16,9,7,351.54887093157527,0.4745293466223699,0.19651229810334492,0.18013505347497996,126014.78273158851,260.07091799552836,126274.85364958404,180,0,36.04651162790697,35,8,18,40.162944284342,0.5818452380952381,48.98726851851851,1004.0509259259247,28.687169312169278,0
3445,4,1,1,40,0.024390243902439025,0.024390243902439025,0.975609756097561,41,1600,900,700,0.5625,23,9,14,368.0450460421209,0.47258638211382115,0.213879671710963,0.18817391044154738,125924.32149943289,1069.1645408163051,126993.48604024919,181,0,38.09756097560975,34,7,19,39.84229826434194,0.5830269607843137,49.07738095238094,1003.6904761904743,29.520308123249244,0
3446,4,3,3,40,0.06976744186046512,0.06976744186046512,0.9302325581395349,43,1150,700,450,0.6086956521739131,16,7,9,350.09771710384024,0.47420634920634924,0.20050824136522905,0.1825203316982759,126723.24087178384,273.103466642306,126996.34433842615,182,0,37.02325581395349,36,7,17,39.47009096670768,0.5870949074074074,48.28265765765765,1006.8693693693684,27.968593593593567,0
3447,4,3,1,42,0.06976744186046512,0.023255813953488372,0.9767441860465116,43,1000,800,200,0.8,12,8,4,351.23453573462217,0.4722683647102252,0.2188259866575224,0.18452180539297738,127035.24470416353,323.8330391201923,127359.07774328372,183,0,36.81395348837209,36,7,20,39.12091338993149,0.5902777777777778,47.97297297297297,1008.1081081081073,28.00300300300298,0
3448,4,1,3,40,0.023255813953488372,0.06976744186046512,0.9302325581395349,43,1300,1000,300,0.7692307692307693,16,10,6,362.89657519627286,0.4733527131782946,0.18272821605544554,0.1791401115014813,124464.85969387728,616.7377897408942,125081.59748361817,184,0,37.72093023255814,34,9,17,41.48274079376442,0.5680147058823529,50.53571428571427,997.8571428571407,29.348739495798256,16
3449,4,6,4,42,0.13043478260869565,0.08695652173913043,0.9130434782608696,46,1350,900,450,0.6666666666666666,18,9,9,336.25633081290215,0.4750100644122383,0.2239790635597645,0.17196036046152544,125933.75485726376,-729.6475740573286,125204.10728320644,185,0,35.108695652173914,37,9,17,40.63023450586263,0.5771396396396397,49.06798245614035,1003.7280701754385,27.127785680417254,0
3450,4,2,1,43,0.045454545454545456,0.022727272727272728,0.9772727272727273,44,1650,1100,550,0.6666666666666666,22,11,11,325.90273885020963,0.471513830162086,0.18714752079444041,0.15697676716964273,123429.11193522184,-735.5380933601274,122693.57384186171,186,0,37.36363636363637,38,6,14,43.47964376590329,0.5496162280701755,51.575854700854705,993.6965811965822,26.149910031489004,16
3451,4,4,5,42,0.0851063829787234,0.10638297872340426,0.8936170212765957,47,1350,800,550,0.5925925925925926,19,8,11,310.2319764852245,0.47542784458834414,0.20522788539760572,0.15285677912625528,124386.43852956741,-1678.8455831324582,122707.59294643496,187,0,35.87234042553192,38,9,15,42.87757488129663,0.559484649122807,50.61431623931623,997.542735042734,26.251124606387737,0
3452,4,5,4,43,0.10638297872340426,0.0851063829787234,0.9148936170212766,47,1550,1100,450,0.7096774193548387,20,11,9,295.35806644232736,0.4785306814677768,0.21225657709693024,0.14832749316839713,125182.35812717008,-2005.2761501736222,123177.08197699646,188,0,34.57446808510638,39,8,21,42.42837254085563,0.5659722222222222,49.81770833333333,1000.7291666666662,25.65972222222221,0
3453,4,3,5,41,0.06521739130434782,0.10869565217391304,0.8913043478260869,46,1000,500,500,0.5,15,5,10,305.64331362059863,0.4807367149758454,0.23945956971402294,0.15470203121681572,125507.99370160354,-1527.8641838337323,123980.1295177698,189,0,35.369565217391305,38,8,12,41.83592778192414,0.5709978070175439,49.49252136752137,1002.029914529915,26.369208277103027,0
3454,4,2,0,43,0.046511627906976744,0.0,1.0,43,900,700,200,0.7777777777777778,11,7,4,327.7792087875598,0.48008951642672576,0.2566744831443748,0.16480433706946623,125231.58864883405,-390.3377914951992,124841.25085733885,190,0,38.41860465116279,35,8,14,41.5664508171446,0.5738095238095238,49.76851851851852,1000.9259259259262,28.597883597883605,0
3455,4,2,1,44,0.044444444444444446,0.022222222222222223,0.9777777777777777,45,1450,900,550,0.6206896551724138,20,9,11,311.5519853059704,0.480976430976431,0.2545171907069381,0.15879605089494853,125796.22005088117,-1161.5875798322409,124634.63247104893,191,0,37.666666666666664,37,8,17,41.39147721062411,0.5757319819819819,49.20504385964913,1003.1798245614045,27.11296823138931,0
3456,4,3,7,40,0.06382978723404255,0.14893617021276595,0.851063829787234,47,1150,800,350,0.6956521739130435,15,8,7,301.30920163561007,0.4816720629047178,0.2559141443635198,0.1559860773078723,126436.39458550369,-1780.71017795137,124655.68440755231,192,0,36.87234042553192,39,8,12,40.99182202658378,0.5787927350427351,48.56770833333334,1005.7291666666684,25.787927350427395,0
3457,4,2,3,39,0.047619047619047616,0.07142857142857142,0.9285714285714286,42,1300,800,500,0.6153846153846154,18,8,10,329.58322584915675,0.4780536198219125,0.255649926752588,0.16935777484575665,126131.0191213348,-85.86636766976534,126045.15275366504,193,0,39.61904761904762,35,7,21,40.59475458002073,0.5830357142857143,48.87152777777777,1004.5138888888882,28.70039682539681,0
3458,4,2,2,39,0.04878048780487805,0.04878048780487805,0.9512195121951219,41,1100,700,400,0.6363636363636364,15,7,8,324.36827169947304,0.4771595528455284,0.24057947290882287,0.1689890646266485,126694.89590942288,19.16088385682258,126714.0567932797,194,0,36.48780487804878,36,5,15,40.146812080536904,0.5868055555555556,48.31081081081081,1006.7567567567563,27.965465465465453,0
3459,4,3,2,40,0.07142857142857142,0.047619047619047616,0.9523809523809523,42,1200,1000,200,0.8333333333333334,14,10,4,325.3904243863427,0.4775333914053426,0.26664441719315124,0.17200276138009815,127285.5725439557,-116.49870633273747,127169.07383762296,195,0,36.095238095238095,37,5,18,39.515986634792974,0.5909346846846847,47.724780701754376,1009.1008771929814,27.27299668089139,0
3460,4,2,6,36,0.047619047619047616,0.14285714285714285,0.8571428571428572,42,1100,800,300,0.7272727272727273,14,8,6,319.60616955104854,0.4765534262485482,0.25221865583311387,0.17010581398462202,127562.34039560237,-246.05780143891712,127316.28259416345,196,0,36.57142857142857,37,5,15,39.37902510944681,0.59375,47.450657894736835,1010.1973684210516,27.30263157894734,0
3461,4,2,1,37,0.05263157894736842,0.02631578947368421,0.9736842105263158,38,800,500,300,0.625,11,5,6,363.1020224677842,0.4762624466571835,0.29893726540869303,0.19146013753570312,127184.708480512,1636.204975249867,128820.91345576187,197,0,40.78947368421053,33,5,20,38.66822075082008,0.5981691919191919,47.824754901960766,1008.7009803921544,30.56669637551983,0
3462,4,1,1,37,0.02631578947368421,0.02631578947368421,0.9736842105263158,38,950,600,350,0.631578947368421,13,6,7,351.72205339345845,0.47362494073020384,0.27531700538474935,0.1869680389091539,127512.49999999974,1369.791666666639,128882.29166666638,198,0,39.31578947368421,34,4,17,38.6190181518152,0.5992647058823529,47.499999999999986,1009.999999999998,29.705882352941117,0
3463,4,2,0,39,0.05128205128205128,0.0,1.0,39,750,400,350,0.5333333333333333,11,4,7,340.6194681818039,0.47376855600539813,0.2662864084079335,0.1827301124886914,127880.99500868047,911.7513020833288,128792.7463107638,199,0,39.23076923076923,35,4,19,38.52235667696533,0.6008928571428571,47.135416666666664,1011.4583333333327,28.898809523809504,0
3464,4,1,1,39,0.025,0.025,0.975,40,1300,1000,300,0.7692307692307693,16,10,6,351.7535242729885,0.47294337606837605,0.3022994890024442,0.19144408860371487,128458.27880245111,1037.1304581608688,129495.40926061198,200,0,39.225,36,4,17,37.65066096423018,0.6047453703703703,46.56531531531532,1013.7387387387389,28.159409409409413,0
3465,4,2,1,40,0.04878048780487805,0.024390243902439025,0.975609756097561,41,1250,800,450,0.64,17,8,9,368.3855765677134,0.4715955284552846,0.24633628501890126,0.19495461411617168,127332.20663265295,1564.926396508191,128897.13302916114,201,0,39.0,34,7,20,38.38341393410397,0.5974264705882353,47.67857142857142,1009.2857142857133,29.684873949579803,11
3466,4,1,3,38,0.024390243902439025,0.07317073170731707,0.926829268292683,41,1250,800,450,0.64,17,8,9,369.46606818641567,0.47052845528455284,0.2581861973963995,0.19677054967658442,127588.49511584768,1227.9239272547732,128816.41904310245,202,0,39.926829268292686,35,6,21,38.09297074884484,0.5979166666666667,47.424768518518505,1010.300925925924,28.865740740740687,0
3467,4,2,1,39,0.05,0.025,0.975,40,1250,600,650,0.48,19,6,13,372.33793391306,0.4739049145299145,0.24355622926438691,0.20003723911088242,127939.53517500417,1527.3484385716615,129466.88361357583,203,0,37.175,35,5,23,37.66028391107043,0.6014880952380952,47.07754629629629,1011.689814814814,28.905423280423257,0
3468,4,0,0,39,0.0,0.0,1.0,39,850,600,250,0.7058823529411765,11,6,5,383.4509861252042,0.47331871345029236,0.2543879506798876,0.20551521306836626,127843.36911848054,2004.3331916099548,129847.70231009049,204,1,39.02564102564103,34,5,23,37.477928193054744,0.6026348039215687,47.17261904761904,1011.3095238095223,29.744397759103595,0
3469,4,0,1,38,0.0,0.02564102564102564,0.9743589743589743,39,1100,600,500,0.5454545454545454,16,6,10,386.01384083044996,0.4723065677013045,0.257616892911011,0.20766567386448231,127993.9058956914,2081.4838435373886,130075.38973922878,205,2,40.02564102564103,34,5,23,37.25857843137254,0.6041666666666667,47.02380952380951,1011.9047619047602,29.761904761904713,0
3470,4,0,2,36,0.0,0.05263157894736842,0.9473684210526316,38,1100,500,600,0.45454545454545453,17,5,12,388.56908483047727,0.47110597439544805,0.2480888775542731,0.20869471667375333,127927.48169273834,2341.7328972029914,130269.21458994133,206,3,41.078947368421055,33,5,23,37.26213910761154,0.6057449494949495,47.08946078431372,1011.6421568627449,30.655822935234692,0
3471,4,1,3,34,0.02702702702702703,0.08108108108108109,0.9189189189189189,37,1300,900,400,0.6923076923076923,17,9,8,387.49011397090953,0.4679366866866867,0.23691578566230365,0.21031590851164067,128348.7456100417,2547.1419603157424,130895.88757035744,207,0,41.21621621621622,30,7,25,36.85723128620064,0.6177083333333333,46.6733870967742,1013.3064516129039,33.776881720430126,0
3472,4,1,1,34,0.02857142857142857,0.02857142857142857,0.9714285714285714,35,1250,700,550,0.56,18,7,11,389.8036821554982,0.4657212885154061,0.20822078455133575,0.2140552301182975,128813.37046682111,3042.3852237654464,131855.75569058655,141,0,36.885714285714286,29,6,24,36.32265585807452,0.6253591954022988,46.215277777777786,1015.1388888888898,35.004789272030685,0
3473,4,0,0,34,0.0,0.0,1.0,34,850,600,250,0.7058823529411765,11,6,5,402.36716796582004,0.4635323826500297,0.22243558236210514,0.22007084221585277,128654.19649639993,3553.2449382349273,132207.44143463485,142,1,38.8235294117647,28,6,24,36.16697351649907,0.6268601190476191,46.37212643678162,1014.5114942528747,36.232553366174095,0
3474,4,4,5,33,0.10526315789473684,0.13157894736842105,0.868421052631579,38,1100,700,400,0.6363636363636364,15,7,8,356.2480483316857,0.467549786628734,0.19055076006416627,0.20014855139405843,129714.32978162232,1644.4177491377204,131358.74753076004,143,0,35.63157894736842,30,8,21,36.25670712934865,0.6315972222222221,45.32930107526883,1018.682795698926,33.9560931899642,0
3475,4,2,2,33,0.05714285714285714,0.05714285714285714,0.9428571428571428,35,1350,1100,250,0.8148148148148148,16,11,5,376.3708858526726,0.46274509803921565,0.20533374922021186,0.21021690941527313,129483.95061728396,2746.7978395061755,132230.74845679014,144,0,37.25714285714286,29,6,22,35.97900745997088,0.632183908045977,45.55555555555556,1017.7777777777778,35.09578544061303,0
3476,4,0,0,33,0.0,0.0,1.0,33,1200,900,300,0.75,15,9,6,390.4669116087471,0.46117424242424243,0.20584320824399893,0.21753707325739888,129384.04439572603,3504.037645329636,132888.08204105566,145,1,38.42424242424242,28,5,26,35.72235559949159,0.6343005952380952,45.65373563218391,1017.3850574712646,36.335180623973734,0
3477,4,0,0,33,0.0,0.0,1.0,33,1100,900,200,0.8181818181818182,13,9,4,392.62720359338334,0.4600299873737374,0.2137120570651474,0.21975958646624924,129566.82892390015,3574.292343770646,133141.1212676708,146,2,39.42424242424242,28,5,23,35.48076018440118,0.6361607142857143,45.474137931034484,1018.1034482758622,36.36083743842365,0
3478,4,1,0,34,0.029411764705882353,0.0,1.0,34,1250,800,450,0.64,17,8,9,383.3646400225707,0.46048722519310753,0.20652348132713594,0.2164535736742821,129908.37191358018,3160.4552469135733,133068.82716049376,147,0,39.23529411764706,29,5,24,35.36841507720255,0.6364942528735632,45.138888888888886,1019.4444444444439,35.153256704980826,0
3479,4,0,0,34,0.0,0.0,1.0,34,1000,600,400,0.6,14,6,8,384.53652059900276,0.4602458407605467,0.20662666015397924,0.21755992407044242,129988.3137682102,3197.0507789917942,133185.36454720199,148,1,40.23529411764706,30,4,24,35.257128421422614,0.634375,45.060483870967744,1019.758064516129,33.99193548387097,0
3480,4,0,0,34,0.0,0.0,1.0,34,1100,500,600,0.45454545454545453,17,5,12,382.04384452880737,0.45961452762923355,0.20682786948771525,0.21671993871252973,130091.13228407914,3140.1032633830528,133231.2355474622,149,2,41.23529411764706,30,4,24,35.21601888449713,0.6354166666666667,44.95967741935484,1020.1612903225811,34.00537634408604,0
3481,4,1,0,35,0.02857142857142857,0.0,1.0,35,800,400,400,0.5,12,4,8,368.66470455063114,0.46001400560224087,0.19333370932265503,0.21079631978030436,130399.83171826214,2614.8759972250955,133014.70771548722,150,0,41.02857142857143,30,5,25,35.243672413036784,0.6385416666666667,44.65725806451612,1021.3709677419348,34.04569892473116,0
3482,4,0,1,34,0.0,0.02857142857142857,0.9714285714285714,35,1600,1200,400,0.75,20,12,8,368.7542730197463,0.4595238095238095,0.1906144804119585,0.21209449065773103,130628.37600708008,2633.954366048177,133262.33037312826,151,1,42.02857142857143,31,4,21,35.009473315501204,0.6381048387096775,44.43359375,1022.265625,32.97631048387097,0
3483,4,0,1,33,0.0,0.029411764705882353,0.9705882352941176,34,1050,600,450,0.5714285714285714,15,6,9,373.79227334150244,0.4579248366013072,0.19146853796102214,0.21448623805399555,130537.14889365809,2958.7555280957185,133495.9044217538,152,5,44.23529411764706,30,4,22,34.973310973738464,0.6399305555555556,44.522849462365585,1021.9086021505365,34.06362007168455,0
3484,4,0,0,33,0.0,0.0,1.0,33,1250,1000,250,0.8,15,10,5,379.1794659735347,0.45726799242424243,0.18264163372858988,0.21802819293478254,130617.2839506173,3305.4783950617243,133922.76234567902,153,6,45.03030303030303,29,4,23,34.754302536231855,0.6436781609195402,44.44444444444444,1022.2222222222224,35.249042145593876,0
3485,4,0,0,33,0.0,0.0,1.0,33,1350,1000,350,0.7407407407407407,17,10,7,379.480183854535,0.4561631944444444,0.17225876245830096,0.21960962407355533,130865.85889274685,3332.2000385802407,134198.0589313271,154,7,46.03030303030303,29,4,23,34.49433849147096,0.6461925287356323,44.201388888888886,1023.194444444444,35.282567049808414,0
3486,4,0,1,32,0.0,0.030303030303030304,0.9696969696969697,33,950,500,450,0.5263157894736842,14,5,9,377.2938810686584,0.4549794823232323,0.16710837185413463,0.2199638239431901,131150.23389274688,3296.4361496913493,134446.67004243823,155,8,47.03030303030303,29,4,24,34.26200564971751,0.649066091954023,43.92361111111111,1024.3055555555552,35.32088122605363,0
3487,4,0,1,31,0.0,0.03125,0.96875,32,900,500,400,0.5555555555555556,13,5,8,390.1005981188297,0.453103998655914,0.18620193657030604,0.22674199528505548,131033.74991742638,3823.268843308238,134857.01876073462,156,9,49.125,28,4,24,34.05223828234634,0.6510416666666667,44.037356321839084,1023.850574712644,36.566091954023,0
3488,4,1,1,31,0.03125,0.03125,0.96875,32,600,500,100,0.8333333333333334,7,5,2,390.3895073694924,0.4525999663978495,0.18932379349046036,0.22734447782105732,131107.31272294885,3836.583845289997,134943.89656823885,157,0,49.8125,28,4,25,33.97019968200523,0.6517857142857143,43.96551724137931,1024.1379310344826,36.57635467980295,0
3489,4,0,0,31,0.0,0.0,1.0,31,1050,800,250,0.7619047619047619,13,8,5,392.28513146946403,0.4503584229390681,0.16965117857304435,0.22888649651205226,131180.89617188537,4092.063020214034,135272.9591920994,158,1,49.67741935483871,28,3,25,33.84700794763909,0.6525297619047619,43.89367816091954,1024.425287356322,36.586617405582935,0
3490,4,0,0,31,0.0,0.0,1.0,31,950,800,150,0.8421052631578947,11,8,3,410.8325934020897,0.4505824372759857,0.10423886963476381,0.21613366870283876,127092.01388888907,4242.708333333356,131334.72222222242,159,2,50.67741935483871,30,1,22,37.56026170798897,0.6048611111111111,47.91666666666668,1008.3333333333348,33.611111111111164,16
3491,4,3,0,34,0.08823529411764706,0.0,1.0,34,1250,900,350,0.72,16,9,7,420.68591236147785,0.454006981580511,0.21621954221018935,0.20519170011100688,123960.50347222242,3629.6875000000236,127590.19097222245,160,0,47.11764705882353,34,0,19,40.56834030683404,0.5628063725490196,51.04166666666668,995.833333333335,29.28921568627456,15
3492,4,4,4,34,0.10526315789473684,0.10526315789473684,0.8947368421052632,38,1500,1300,200,0.8666666666666667,17,13,4,389.4136836059384,0.46184506875296344,0.20243276245342656,0.195404299146741,125148.85381235824,2151.2755102040787,127300.12932256232,161,0,43.05263157894737,34,4,18,40.110053539559786,0.5750612745098039,49.851190476190474,1000.5952380952378,29.429271708683466,0
3493,4,4,0,38,0.10526315789473684,0.0,1.0,38,1250,700,550,0.56,18,7,11,392.95960125262224,0.46177098150782364,0.21884158109170548,0.1907797272894603,123764.33020858724,2206.418603172976,125970.74881176022,162,0,41.0,36,2,19,41.46342613550627,0.556712962962963,51.23873873873875,995.0450450450473,27.640140140140204,16
3494,4,6,0,44,0.13636363636363635,0.0,1.0,44,950,500,450,0.5263157894736842,14,5,9,349.70251524807827,0.4704567477096547,0.2192200879426056,0.17509438799385266,125057.8770683301,-22.388995054216792,125035.48807327588,163,0,36.27272727272727,35,9,22,41.19754300701998,0.5720238095238095,49.94212962962964,1000.2314814814831,28.578042328042375,0
3495,4,3,6,41,0.06382978723404255,0.1276595744680851,0.8723404255319149,47,1400,1000,400,0.7142857142857143,18,10,8,339.1730744192844,0.4716890225100216,0.25501857139789985,0.17415570816036857,126100.38406227194,-838.2861692084751,125262.09789306347,164,0,34.8936170212766,36,11,16,40.38545987965768,0.5807291666666667,48.90202702702704,1004.3918918918936,27.899774774774823,0
3496,4,2,1,42,0.046511627906976744,0.023255813953488372,0.9767441860465116,43,1650,1300,350,0.7878787878787878,20,13,7,370.2395908295429,0.4667543373938723,0.26078801210075575,0.18790609108121967,125620.13660620086,701.9095954062253,126322.04620160708,165,0,38.95348837209303,36,7,18,40.10170935370328,0.5758101851851851,49.380630630630634,1002.477477477478,27.846596596596612,0
3497,4,5,4,43,0.10638297872340426,0.0851063829787234,0.9148936170212766,47,1350,1000,350,0.7407407407407407,17,10,7,343.99312091225363,0.4695305272895467,0.2700980746306394,0.17930260904187384,126715.24581780995,-680.7387447351949,126034.50707307475,166,0,36.53191489361702,38,9,17,39.631968024900935,0.5833333333333333,48.29059829059829,1006.837606837607,26.4957264957265,0
3498,4,1,2,42,0.022727272727272728,0.045454545454545456,0.9545454545454546,44,1050,500,550,0.47619047619047616,16,5,11,369.87576691798216,0.4646427942212826,0.29250376695128133,0.1912786108918705,126392.74691358005,549.9228395061498,126942.6697530862,167,0,39.90909090909091,35,9,18,39.312845303867405,0.5857142857142856,48.6111111111111,1005.5555555555538,28.73015873015868,0
3499,4,4,1,45,0.08695652173913043,0.021739130434782608,0.9782608695652174,46,950,700,250,0.7368421052631579,12,7,5,347.02129865199026,0.4679649758454106,0.27889400827082333,0.18310451337341005,127212.0819160998,-365.152588813297,126846.9293272865,168,0,38.0,34,12,23,39.04565927149713,0.5962009803921569,47.79761904761905,1008.8095238095241,29.670868347338942,0
3500,4,2,5,42,0.0425531914893617,0.10638297872340426,0.8936170212765957,47,1700,1300,400,0.7647058823529411,21,13,8,356.57068225061636,0.46956907184705515,0.25129404106950193,0.17961869325157087,125309.8764938924,-85.8140743818928,125224.0624195105,169,0,38.08510638297872,36,11,15,40.76500581111987,0.5726273148148149,49.69031531531531,1001.2387387387375,27.812187187187153,16
3501,4,4,2,44,0.08695652173913043,0.043478260869565216,0.9565217391304348,46,1400,1000,400,0.7142857142857143,18,10,8,354.0149417243597,0.4684078099838969,0.30796224770435376,0.1819121183674195,126131.01912133477,-267.403732737537,125863.61538859723,170,0,38.43478260869565,35,11,18,39.98120463187002,0.5830357142857143,48.87152777777777,1004.513888888888,28.7003968253968,0
3502,4,2,4,42,0.043478260869565216,0.08695652173913043,0.9130434782608696,46,1250,900,350,0.72,16,9,7,354.48891067208854,0.4713466183574879,0.10761000509492269,0.17853492792867284,125301.71693453749,301.5005952686207,125603.2175298061,171,0,37.108695652173914,37,9,14,40.82555306100099,0.5706644144144144,49.6984649122807,1001.2061403508767,27.059625414888558,16
3503,4,2,1,43,0.045454545454545456,0.022727272727272728,0.9772727272727273,44,1250,1000,250,0.8,15,10,5,354.0555516606657,0.469025281888654,0.15633392217128028,0.1798149786899549,125648.36109335705,97.29996043342342,125745.66105379046,172,0,39.54545454545455,36,8,17,40.47816279156837,0.576099537037037,49.352477477477485,1002.5900900900915,27.849724724724766,0
3504,4,3,2,44,0.06521739130434782,0.043478260869565216,0.9565217391304348,46,850,500,350,0.5882352941176471,12,5,7,337.97006847484164,0.4701590177133655,0.18451119549809603,0.1748180201907936,126401.93527094867,-655.3644577995506,125746.57081314913,173,0,38.630434782608695,37,9,14,40.105472867371766,0.5819256756756757,48.60197368421052,1005.5921052631572,27.17816500711236,0
3505,4,0,4,40,0.0,0.09090909090909091,0.9090909090909091,44,1150,800,350,0.6956521739130435,15,8,7,349.75210414673796,0.468199436222692,0.20510555312280387,0.1805805109148604,126326.69990514191,36.60582034740315,126363.30572548932,174,1,41.27272727272727,36,8,14,39.88672006273103,0.5830439814814814,48.676801801801815,1005.2927927927951,27.924799799799864,0
3506,4,2,3,39,0.047619047619047616,0.07142857142857142,0.9285714285714286,42,800,400,400,0.5,12,4,8,347.7450193366865,0.46893147502903604,0.20561173144198963,0.18154604249433687,126779.94030770654,417.41855876148566,127197.35886646803,175,0,41.285714285714285,36,6,16,39.4710481195721,0.5876736111111112,48.22635135135136,1007.0945945945961,27.97484984984989,0
3507,4,3,0,42,0.07142857142857142,0.0,1.0,42,900,400,500,0.4444444444444444,14,4,10,349.947641302236,0.46920973674022454,0.22246949030868546,0.1842316947596435,127120.40323685229,497.0970548251582,127617.50029167745,176,0,38.833333333333336,36,6,20,39.06593150939885,0.5911458333333333,47.888513513513544,1008.4459459459506,28.012387387387516,0
3508,4,2,4,40,0.045454545454545456,0.09090909090909091,0.9090909090909091,44,1600,1200,400,0.75,20,12,8,332.8236393136334,0.47141472868217055,0.21819623294253265,0.17768124310987485,127685.20801373418,-300.66887647009764,127384.53913726409,177,0,38.02272727272727,38,6,19,38.91957364341086,0.5932017543859649,47.32905982905986,1010.6837606837651,26.596941070625395,0
3509,4,0,0,40,0.0,0.0,1.0,40,700,300,400,0.42857142857142855,11,3,8,358.62156823501334,0.46768162393162394,0.2203327826292183,0.18922535300270912,127212.0819161,1124.1992630385712,128336.28117913856,178,1,41.175,34,6,21,38.753097710644305,0.5962009803921569,47.79761904761906,1008.8095238095257,29.670868347338992,0
3510,4,1,1,40,0.024390243902439025,0.024390243902439025,0.975609756097561,41,1200,800,400,0.6666666666666666,16,8,8,354.51530919550515,0.4674034552845528,0.23385693254481477,0.1890820503717752,127646.96830257641,850.5608871313539,128497.52918970777,179,0,41.146341463414636,35,6,20,38.410667926545266,0.5985119047619047,47.36689814814815,1010.5324074074083,28.87235449735452,0
3511,4,0,0,40,0.0,0.0,1.0,40,1350,800,550,0.5925925925925926,19,8,11,357.87702460382894,0.4673878205128205,0.058204611596149425,0.18567208698087184,126524.89271365982,1170.374456957449,127695.26717061727,180,1,41.5,36,4,14,39.4783971345422,0.5850694444444444,48.47972972972974,1006.0810810810829,27.946696696696748,16
3512,4,1,3,38,0.024390243902439025,0.07317073170731707,0.926829268292683,41,950,800,150,0.8421052631578947,11,8,3,356.2388267292223,0.46704776422764227,0.07956882528242071,0.18677644360914353,126953.84787867434,845.1779634118332,127799.02584208616,181,0,41.46341463414634,37,4,15,39.07842363906721,0.5875563063063063,48.053728070175445,1007.7850877192993,27.237434803224307,0
3513,4,0,1,37,0.0,0.02631578947368421,0.9736842105263158,38,1100,700,400,0.6363636363636364,15,7,8,375.74959900295664,0.46442330488383116,0.10003732736095561,0.1962247905904327,126792.09183673459,1928.415532879806,128720.5073696144,182,1,45.1578947368421,34,4,16,38.75344759653271,0.5919117647058824,48.21428571428571,1007.1428571428563,29.621848739495775,0
3514,4,4,2,39,0.0975609756097561,0.04878048780487805,0.9512195121951219,41,650,400,250,0.6153846153846154,9,4,5,354.1282645844627,0.4663363821138211,0.12237010393918868,0.18928740898902638,127734.70320001685,847.6023710667009,128582.30557108356,183,0,42.609756097560975,35,6,16,38.33056636897945,0.5994047619047619,47.280092592592574,1010.8796296296273,28.882275132275065,0
3515,4,4,2,41,0.09302325581395349,0.046511627906976744,0.9534883720930233,43,950,500,450,0.5263157894736842,14,5,9,342.18109774788115,0.4696151716500554,0.1409510617458789,0.1858351055300652,128372.6732433446,185.99685028182748,128558.67009362642,184,0,41.53488372093023,36,7,16,37.98060895655073,0.6038773148148149,46.64977477477477,1013.4009009009001,28.150025025025002,0
3516,4,1,5,37,0.023809523809523808,0.11904761904761904,0.8809523809523809,42,1400,1000,400,0.7142857142857143,18,10,8,342.6720986982262,0.46883468834688347,-0.04115279662179694,0.17255132922628033,125293.9760597012,249.08978866986948,125543.06584837107,185,0,43.5,38,4,15,41.12932629032831,0.5688048245614035,49.70619658119658,1001.1752136752136,26.346716149347728,16
3517,4,4,3,38,0.0975609756097561,0.07317073170731707,0.926829268292683,41,1300,1000,300,0.7692307692307693,16,10,6,356.6029695833226,0.46702235772357725,0.009503300407283755,0.18037878364360282,125481.2315088756,848.2435714807311,126329.47508035634,186,0,44.707317073170735,38,3,13,40.58701215611002,0.5707236842105263,49.51923076923076,1001.9230769230759,26.366396761133576,16
3518,4,5,1,42,0.11627906976744186,0.023255813953488372,0.9767441860465116,43,1200,600,600,0.5,18,6,12,395.835103934356,0.46929217423403474,0.24488002636124828,0.1924634565893774,123827.54857915155,1569.9271541018798,125397.47573325344,187,0,43.116279069767444,38,5,17,41.32585515958209,0.5537280701754386,51.1752136752137,995.2991452991487,26.19208277103023,16
3519,4,3,1,44,0.06666666666666667,0.022222222222222223,0.9777777777777777,45,1250,800,450,0.64,17,8,9,389.5591271098604,0.47079124579124576,0.2754594954466558,0.19304451760173694,124626.34802578726,710.0089487910168,125336.35697457827,188,0,40.955555555555556,38,7,20,40.64952029388689,0.5619517543859649,50.37393162393163,998.5042735042746,26.276428250112488,0
3520,4,1,1,44,0.022222222222222223,0.022222222222222223,0.9777777777777777,45,1100,700,400,0.6363636363636364,15,7,8,380.87133970231594,0.47154882154882155,0.2583188566928405,0.18972376080498574,124843.79882812526,509.884982638919,125353.68381076418,165,0,37.75555555555555,39,6,21,40.64041762212494,0.5625,50.156250000000014,999.375000000002,25.625000000000053,0
3521,4,3,6,41,0.06382978723404255,0.1276595744680851,0.8723404255319149,47,1950,1200,750,0.6153846153846154,27,12,15,372.63898026132665,0.47355843354918287,0.27396508479342496,0.18897831961144693,125588.29740119808,-39.88801598226041,125548.40938521583,166,0,37.02127659574468,38,9,19,40.07452213458395,0.5718201754385965,49.412393162393165,1002.3504273504277,26.377642825011254,0
3522,4,2,4,39,0.046511627906976744,0.09302325581395349,0.9069767441860466,43,1350,1000,350,0.7407407407407407,17,10,7,381.5962124293096,0.47314507198228134,0.24731044256909174,0.1940228629394093,125695.40895061716,992.9783950617175,126688.38734567887,167,0,37.2093023255814,38,5,21,39.73915050784857,0.5729166666666667,49.30555555555555,1002.7777777777767,26.38888888888886,0
3523,4,4,3,40,0.09302325581395349,0.06976744186046512,0.9302325581395349,43,1100,800,300,0.7272727272727273,14,8,6,356.2342755022711,0.4753137689184201,0.21932334716428703,0.18494423197452084,126552.40929705235,418.87243323257474,126971.28173028493,168,0,34.325581395348834,34,9,19,39.49139256980597,0.5894607843137255,48.45238095238096,1006.1904761904777,29.59383753501405,0
3524,4,1,0,41,0.024390243902439025,0.0,1.0,41,1300,1000,300,0.7692307692307693,16,10,6,375.73832346447057,0.4741615853658536,0.23479323578869282,0.19415991367602764,126361.0078850376,1295.7346508009837,127656.74253583858,169,0,35.73170731707317,32,9,20,39.19821884549375,0.5921223958333333,48.64267676767679,1005.4292929292959,31.419665404040497,0
3525,4,0,1,40,0.0,0.024390243902439025,0.975609756097561,41,850,400,450,0.47058823529411764,13,4,9,340.44189691645056,0.474390243902439,0.17648310581348903,0.16628589325743948,124019.78635204064,585.0918026377794,124604.87815467842,170,1,36.73170731707317,34,7,20,42.50453169196449,0.5634191176470589,50.98214285714285,996.0714285714271,29.296218487394913,16
3526,4,5,0,45,0.1111111111111111,0.0,1.0,45,1150,900,250,0.782608695652174,14,9,5,307.2880889106026,0.4779671717171717,0.20833689002703126,0.1548335467349552,125320.71827744896,-1294.2287775563964,124026.48949989257,171,0,34.06666666666667,38,7,18,41.98743597951344,0.569078947368421,49.679487179487175,1001.2820512820506,26.349527665317122,0
3527,4,2,5,42,0.0425531914893617,0.10638297872340426,0.8936170212765957,47,1450,1000,450,0.6896551724137931,19,10,9,317.43977736167574,0.47932084489670057,0.1307500758183746,0.1580761189730064,124830.4838670303,-1334.132525813116,123496.35134121719,172,0,33.57446808510638,42,5,14,42.23896215133003,0.5577876984126984,50.16957364341086,999.3217054263571,23.793373938722787,15
3528,4,5,5,42,0.10638297872340426,0.10638297872340426,0.8936170212765957,47,1200,800,400,0.6666666666666666,16,8,8,318.9110088748988,0.47997610237434474,0.1819617421331341,0.16185814890411093,125620.80858095539,-1387.5132190712463,124233.29536188414,173,0,33.723404255319146,41,6,15,41.38741134751772,0.5673272357723578,49.37996031746031,1002.4801587301575,24.45073557878433,0
3529,4,3,4,41,0.06666666666666667,0.08888888888888889,0.9111111111111111,45,1150,700,450,0.6086956521739131,16,7,9,340.35872794819795,0.47962962962962963,0.2221760893133118,0.17386086877269008,125886.98459201369,-430.6532118055808,125456.33138020811,174,0,35.71111111111111,39,6,18,40.575479205591314,0.5731837606837606,49.11458333333332,1003.5416666666649,25.731837606837562,0
3530,4,1,2,40,0.023809523809523808,0.047619047619047616,0.9523809523809523,42,2100,1800,300,0.8571428571428571,24,18,6,371.90533222638834,0.47983207510646536,0.2318378939492145,0.17624061286470194,122735.13394746438,804.018243594159,123539.15219105853,175,0,37.642857142857146,37,5,19,43.06220261148612,0.5442004504504505,52.2752192982456,990.8991228070156,26.781057373162582,15
3531,4,8,4,44,0.16666666666666666,0.08333333333333333,0.9166666666666666,48,1350,800,550,0.5925925925925926,19,8,11,322.0286269651267,0.48129986702127664,0.24842702494779645,0.15881509359109408,124425.0048692866,-1567.6156365420254,122857.38923274456,176,0,33.375,37,11,17,42.54348005275304,0.5616554054054055,50.575657894736835,997.6973684210517,26.964793741109506,0
3532,4,6,6,44,0.12,0.12,0.88,50,1350,1000,350,0.7407407407407407,17,10,7,309.6957628044707,0.4834098639455782,0.2733499791926761,0.15601654465810127,125312.69531249997,-2236.9123191751305,123075.78299332484,177,0,32.66,39,11,11,41.93542793730061,0.5673076923076923,49.6875,1001.2499999999998,25.673076923076916,0
3533,4,3,5,42,0.06382978723404255,0.10638297872340426,0.8936170212765957,47,1200,700,500,0.5833333333333334,17,7,10,365.3155751175941,0.48144079555966696,0.21974788048764848,0.17990226436362428,124364.23637902942,222.7232295953259,124586.95960862475,178,0,33.8936170212766,35,12,17,41.52693973853175,0.5648809523809524,50.63657407407407,997.4537037037031,28.498677248677232,16
3534,4,7,9,40,0.14285714285714285,0.1836734693877551,0.8163265306122449,49,1600,1200,400,0.75,20,12,8,339.9477588227455,0.48318806689342403,0.25376287298653266,0.17188012852626675,125463.39163237312,-1264.9375214334686,124198.45411093965,179,0,33.10204081632653,35,14,17,41.02260474430067,0.5761904761904761,49.53703703703704,1001.851851851852,28.624338624338627,0
3535,4,2,0,42,0.047619047619047616,0.0,1.0,42,1400,900,500,0.6428571428571429,19,9,10,346.16661928087746,0.4799167634533488,0.17386714921209356,0.16873237308056896,123932.46920907407,208.6025417935602,124141.07175086763,180,0,38.904761904761905,36,6,18,42.45268792882453,0.5584490740740741,51.06981981981983,995.7207207207218,27.65890890890894,15
3536,4,7,5,44,0.14285714285714285,0.10204081632653061,0.8979591836734694,49,1450,1100,350,0.7586206896551724,18,11,7,304.0669703377145,0.48159367913832196,0.20053358802426424,0.15399905030522243,125533.51379874995,-2161.3028988857736,123372.21089986418,181,0,34.204081632653065,42,7,13,41.849174885579835,0.5649801587301587,49.467054263565885,1002.1317829457355,23.860280546327036,0
3537,4,4,3,45,0.08333333333333333,0.0625,0.9375,48,1100,600,500,0.5454545454545454,16,6,10,308.8230658950291,0.4821217494089835,0.2242453094602168,0.15711587182349546,125720.28066145456,-1834.9354961892022,123885.34516526535,182,0,33.1875,41,7,16,41.537965344412584,0.5683434959349594,49.280753968253975,1002.8769841269855,24.460414246999644,0
3538,4,4,6,43,0.08163265306122448,0.12244897959183673,0.8775510204081632,49,1350,900,450,0.6666666666666666,18,9,9,308.5474866400668,0.4844281462585034,0.24371345144305323,0.15905837631365702,126262.86355988253,-2008.382158524095,124254.48140135844,183,0,33.16326530612245,42,7,20,40.98775549556501,0.5724206349206349,48.740310077519396,1005.038759689925,23.929494278331546,0
3539,4,2,3,42,0.044444444444444446,0.06666666666666667,0.9333333333333333,45,950,600,350,0.631578947368421,13,6,7,364.4313649716285,0.4838383838383838,0.21345237264885686,0.17753491266049073,123908.64257812516,568.5791529111241,124477.22173103629,184,0,34.666666666666664,39,6,17,42.02282555625304,0.5528846153846154,51.09375000000001,995.6250000000013,25.528846153846185,16
3540,4,2,6,38,0.045454545454545456,0.13636363636363635,0.8636363636363636,44,950,500,450,0.5263157894736842,14,5,9,355.5240162017497,0.48426488724453837,0.12809808738207473,0.1683120417170153,122693.03521050335,350.7459852430458,123043.7811957464,185,0,36.02272727272727,39,5,17,43.51200802579469,0.5403311965811965,52.31770833333333,990.7291666666656,25.403311965811938,16
3541,4,9,9,38,0.19148936170212766,0.19148936170212766,0.8085106382978724,47,1250,800,450,0.64,17,8,9,322.7028287404503,0.4876079247610237,0.2076074424793679,0.15910237670424093,124413.08372598437,-1356.4040249299212,123056.67970105445,186,0,33.829787234042556,38,9,13,42.53899835796388,0.5597587719298245,50.587606837606835,997.6495726495726,26.253936122357175,0
3542,4,5,5,38,0.11627906976744186,0.11627906976744186,0.8837209302325582,43,1000,500,500,0.5,15,5,10,329.44055745355854,0.4855574012550757,0.1995732541080193,0.16262801000534724,124465.66234731347,-399.19256249493503,124066.46978481853,151,0,33.13953488372093,36,7,13,42.316518075461744,0.5639467592592593,50.534909909909906,997.8603603603599,27.71834334334333,0
3543,4,7,7,38,0.15555555555555556,0.15555555555555556,0.8444444444444444,45,1250,700,550,0.56,18,7,11,316.3030163779167,0.4893097643097643,0.09099866029515757,0.15575594537207077,124361.61261944713,-1132.8093613693877,123228.80325807774,152,0,32.51111111111111,43,2,12,42.75184736858763,0.5515988372093024,50.63920454545454,997.4431818181803,23.196353065539075,16
3544,4,2,3,37,0.05,0.075,0.925,40,1300,900,400,0.6923076923076923,17,9,8,343.1086833082969,0.4866853632478632,0.09595978552278872,0.1677760079627616,124066.91875091294,513.6874269486226,124580.60617786157,153,0,36.675,38,2,19,42.38918677390528,0.5561951754385965,50.93482905982905,996.260683760682,26.217386414754788,0
3545,4,7,7,37,0.1590909090909091,0.1590909090909091,0.8409090909090909,44,1000,700,300,0.7,13,7,6,325.2934080238268,0.48639006342494717,0.16911089504672416,0.1644050467579878,125446.82716836708,-635.0991914407911,124811.72797692628,154,0,33.97727272727273,41,3,14,41.40671420083185,0.5655487804878049,49.553571428571416,1001.7857142857121,24.433797909407613,0
3546,4,2,3,36,0.05128205128205128,0.07692307692307693,0.9230769230769231,39,1000,700,300,0.7,13,7,6,353.14406363731996,0.48293409806567705,0.2052922551962857,0.1786291817039259,125481.23150887569,1062.5904010519334,126543.82190992762,155,0,38.23076923076923,38,1,16,40.67365109831518,0.5707236842105263,49.51923076923077,1001.9230769230766,26.366396761133593,0
3547,4,6,4,38,0.14285714285714285,0.09523809523809523,0.9047619047619048,42,850,800,50,0.9411764705882353,9,8,1,337.2115817209938,0.4809088269454123,0.23378327709036384,0.17562659981746395,126682.45278108264,145.01647945518096,126827.46926053782,156,0,35.642857142857146,40,2,17,39.83633656369879,0.5796875,48.323170731707314,1006.7073170731703,25.167682926829258,0
3548,4,0,3,35,0.0,0.07894736842105263,0.9210526315789473,38,1600,1200,400,0.75,20,12,8,381.59186350363916,0.4782183499288763,0.1237718983952183,0.18717449754633675,124197.72002551009,2056.465053178708,126254.1850786888,157,1,39.94736842105263,34,4,15,41.29443847286915,0.5652573529411764,50.80357142857142,996.7857142857133,29.317226890756274,16
3549,4,5,2,38,0.125,0.05,0.95,40,1150,800,350,0.6956521739130435,15,8,7,349.8546114936545,0.4792467948717949,0.1730172994832624,0.17756019107847856,125620.13660620085,794.9226339549765,126415.05924015582,158,0,38.075,36,4,17,40.612596420280084,0.5758101851851851,49.380630630630634,1002.4774774774779,27.84659659659661,0
3550,4,3,2,39,0.07317073170731707,0.04878048780487805,0.9512195121951219,41,1000,800,200,0.8,12,8,4,369.3989035785387,0.48003048780487806,0.18875587793746473,0.1777280066060068,123381.49877751355,1167.885569999959,124549.3843475135,159,0,38.02439024390244,33,8,19,42.44878397269851,0.5590277777777778,51.62377450980393,993.5049019607851,30.106209150326823,16
3551,4,3,1,41,0.07142857142857142,0.023809523809523808,0.9761904761904762,42,550,200,350,0.36363636363636365,9,2,7,351.746739068764,0.4831470189701897,0.20362506358790644,0.17250813877335977,124191.12761488356,336.7648319616153,124527.89244684517,160,0,35.92857142857143,35,7,17,42.04501470815917,0.5630952380952381,50.8101851851852,996.7592592592606,28.478835978836017,0
3552,4,3,0,44,0.06818181818181818,0.0,1.0,44,1200,800,400,0.6666666666666666,16,8,8,330.55555555555554,0.48359319943622264,0.21685606060606077,0.165277777777778,125000.00000000022,-536.1111111110831,124463.88888888914,161,0,35.06818181818182,38,6,22,41.73611111111113,0.5657894736842105,50.000000000000014,1000.0000000000017,26.315789473684255,0
3553,4,3,6,41,0.06382978723404255,0.1276595744680851,0.8723404255319149,47,1300,800,500,0.6153846153846154,18,8,10,315.493139864017,0.48377274128893005,0.22545476487562244,0.1609748718282917,125839.82051234404,-1459.679981327234,124380.1405310168,162,0,33.765957446808514,40,7,16,41.247805462709735,0.57109375,49.16158536585367,1003.3536585365871,25.08384146341468,0
3554,4,4,1,44,0.08888888888888889,0.022222222222222223,0.9777777777777777,45,1450,1000,450,0.6896551724137931,19,10,9,320.33639103691706,0.48095538720538716,0.24777559580090713,0.16514079641419466,126264.14497730063,-910.2694050121029,125353.87557228853,163,0,35.577777777777776,37,8,20,40.69023201687396,0.5805180180180181,48.739035087719294,1005.0438596491222,27.163347558084382,0
3555,4,0,3,41,0.0,0.06818181818181818,0.9318181818181819,44,850,600,250,0.7058823529411765,11,6,5,325.9740409966958,0.4794749823819591,0.24950587348323539,0.1678399519800066,126213.51662050556,-571.5339917620429,125641.98262874351,164,1,37.31818181818182,36,8,21,40.60060144196645,0.5818865740740741,48.78941441441441,1004.8423423423417,27.91228728728727,0
3556,4,1,3,39,0.023809523809523808,0.07142857142857142,0.9285714285714286,42,1300,800,500,0.6153846153846154,18,8,10,350.76392968087004,0.47758178474641894,0.09202291120299888,0.175263530199012,124971.84843204684,662.959708018818,125634.80814006567,165,0,38.45238095238095,36,6,18,41.260042422194694,0.5691550925925926,50.02815315315315,999.8873873873868,27.774649649649632,16
3557,4,4,4,39,0.09302325581395349,0.09302325581395349,0.9069767441860466,43,1200,900,300,0.75,15,9,6,339.69427423345036,0.47965116279069764,0.14449459261212239,0.1732304687547686,125817.77459469602,-52.08130427725081,125765.69329041877,166,0,38.325581395348834,36,7,15,40.66346765443184,0.5778356481481481,49.18355855855856,1003.2657657657655,27.86849349349349,0
3558,4,0,1,38,0.0,0.02564102564102564,0.9743589743589743,39,1050,900,150,0.8571428571428571,12,9,3,369.56965829970284,0.4789417453891138,0.15320585581652568,0.18605192512116467,125284.25232438017,1460.251664370986,126744.50398875115,167,1,42.92307692307692,32,7,16,40.46616849539665,0.5810546875,49.71590909090909,1001.1363636363637,31.285511363636367,0
3559,4,5,2,41,0.11627906976744186,0.046511627906976744,0.9534883720930233,43,1150,900,250,0.782608695652174,14,9,5,376.838418968793,0.4810354374307863,0.18794766816480046,0.18406345893239293,124019.78635204078,1014.3160208298142,125034.1023728706,168,0,39.55813953488372,34,9,17,41.59819329907175,0.5634191176470589,50.982142857142854,996.0714285714283,29.296218487394952,16
3560,4,3,3,41,0.06818181818181818,0.06818181818181818,0.9318181818181819,44,1500,900,600,0.6,21,9,12,355.3909741572359,0.48400061663143057,0.19471412332176086,0.17733590093275886,124915.554807341,78.77214207449319,124994.3269494155,169,0,39.0,36,8,18,41.202686718485964,0.5685763888888888,50.08445945945945,999.6621621621612,27.768393393393367,0
3561,4,4,6,39,0.08888888888888889,0.13333333333333333,0.8666666666666667,45,1400,1000,400,0.7142857142857143,18,10,8,354.66854607178595,0.48373316498316493,0.12385951756030478,0.1785392624336453,125281.690051538,113.6765988961863,125395.36665043418,150,0,34.84444444444444,36,9,17,40.84176977877763,0.572337962962963,49.718468468468465,1001.1261261261259,27.809059059059052,16
3562,4,3,1,41,0.07142857142857142,0.023809523809523808,0.9761904761904762,42,850,700,150,0.8235294117647058,10,7,3,352.17652702792395,0.4793239450251645,0.18385372853679116,0.17868780905617132,125608.37733892727,447.2644193672605,126055.64175829453,151,0,37.976190476190474,35,7,19,40.56654832005543,0.5776785714285715,49.3923611111111,1002.4305555555538,28.640873015872966,0
3563,4,6,3,44,0.1276595744680851,0.06382978723404255,0.9361702127659575,47,1300,800,500,0.6153846153846154,18,8,10,377.1423108357058,0.48132516188714153,0.15612015802552492,0.1863538153747756,124505.6979709202,264.1080126350396,124769.80598355524,152,0,34.808510638297875,39,8,16,41.08489458302891,0.5590277777777778,50.49479166666667,998.0208333333339,25.590277777777793,16
3564,4,5,3,46,0.10204081632653061,0.061224489795918366,0.9387755102040817,49,1200,800,400,0.6666666666666666,16,8,8,363.34885030284136,0.48166454081632654,0.2119650245106557,0.1854658914154507,125856.16188180314,-650.1445546492421,125206.0173271539,153,0,33.775510204081634,38,11,17,40.030522430437244,0.5745614035087719,49.145299145299155,1003.4188034188054,26.405757984705406,0
3565,4,5,7,44,0.09803921568627451,0.13725490196078433,0.8627450980392157,51,1600,900,700,0.5625,23,9,14,346.7172385766799,0.48194444444444445,0.23561848229779914,0.1814636975927299,126882.03125,-1401.4226751406252,125480.60857485938,154,0,33.19607843137255,39,12,18,39.39205955334987,0.5833333333333333,48.125,1007.5,25.833333333333332,0
3566,4,1,2,43,0.022222222222222223,0.044444444444444446,0.9555555555555556,45,1700,1400,300,0.8235294117647058,20,14,6,377.88305800907006,0.48095538720538716,0.239614670930554,0.19489716913687116,126283.03748582776,544.0440759637324,126827.08156179149,155,0,37.86666666666667,34,11,19,39.22480161080185,0.586703431372549,48.7202380952381,1005.1190476190485,29.562324929972014,0
3567,4,1,2,42,0.022727272727272728,0.045454545454545456,0.9545454545454546,44,1250,900,350,0.72,16,9,7,370.778718178327,0.4813028541226216,0.24128948991002108,0.19325368900139422,126713.00482521018,596.4971011231314,127309.50192633331,156,0,37.95454545454545,35,9,20,38.960057669463936,0.5889880952380953,48.29282407407408,1006.8287037037048,28.766534391534424,0
3568,4,2,4,40,0.045454545454545456,0.09090909090909091,0.9090909090909091,44,1650,1300,350,0.7878787878787878,20,13,7,357.36469547150375,0.4808073467230444,0.16357839609818536,0.17589768777103856,124342.97091412725,95.19848736990684,124438.16940149716,157,0,38.54545454545455,37,7,14,41.74728818528291,0.5608108108108107,50.657894736842096,997.3684210526301,26.955903271692705,16
3569,4,3,2,41,0.06976744186046512,0.046511627906976744,0.9534883720930233,43,1250,900,350,0.72,16,9,7,353.2222731804653,0.48066629752676265,0.2001539175063327,0.17731058663613464,125164.52778739609,243.91110726377156,125408.43889465986,158,0,37.76744186046512,37,6,17,40.99915990941633,0.5692567567567568,49.83552631578947,1000.6578947368419,27.044807965860592,0
3570,4,0,1,40,0.0,0.024390243902439025,0.975609756097561,41,950,600,350,0.631578947368421,13,6,7,369.79166666666714,0.48003048780487806,0.2063008130081312,0.18489583333333334,124999.99999999983,1044.7916666666522,126044.79166666648,159,1,40.073170731707314,35,6,18,40.75520833333335,0.5714285714285714,49.99999999999999,999.9999999999986,28.571428571428534,0
3571,4,4,2,42,0.09090909090909091,0.045454545454545456,0.9545454545454546,44,1100,800,300,0.7272727272727273,14,8,6,355.8645869687777,0.4813028541226216,0.24750353273669368,0.1836413510293427,126305.47417534738,202.54991319446782,126508.02408854185,160,0,38.09090909090909,35,9,18,39.75496545768568,0.5848214285714286,48.69791666666668,1005.2083333333346,28.72023809523813,0
3572,4,3,2,43,0.06666666666666667,0.044444444444444446,0.9555555555555556,45,1350,900,450,0.6666666666666666,18,9,9,346.5333367002516,0.4814604377104377,0.25694894224207454,0.18243421694007972,127120.40323685187,-187.2670944804409,126933.13614237143,161,0,37.644444444444446,36,9,21,39.15201005025126,0.5911458333333333,47.88851351351352,1008.4459459459472,28.01238738738742,0
3573,4,2,3,42,0.044444444444444446,0.06666666666666667,0.9333333333333333,45,1150,400,750,0.34782608695652173,19,4,15,337.2836543815974,0.4815867003367003,0.24399802125939618,0.17902277655332174,127451.59718615361,-402.53190885654976,127049.06527729706,162,0,38.2,37,8,19,39.04592880153473,0.5926238738738738,47.56030701754387,1009.758771929826,27.290777619725027,0
3574,4,4,7,39,0.08695652173913043,0.15217391304347827,0.8478260869565217,46,1200,600,600,0.5,18,6,12,333.75869760905016,0.48043478260869565,0.254900030429412,0.17975607017569503,128039.08420138925,-653.1684027777397,127385.91579861152,163,0,37.69565217391305,39,7,21,38.53437628653768,0.5950854700854701,46.979166666666686,1012.0833333333363,25.950854700854777,0
3575,4,2,0,41,0.04878048780487805,0.0,1.0,41,750,400,350,0.5333333333333333,11,4,7,360.1059689800385,0.47761686991869917,0.2560403330941856,0.1929028725308765,127822.4682382758,1005.9267564728964,128828.3949947487,164,0,38.80487804878049,35,6,23,38.08956640341841,0.600297619047619,47.19328703703703,1011.2268518518512,28.892195767195748,0
3576,4,0,2,39,0.0,0.04878048780487805,0.9512195121951219,41,1650,1300,350,0.7878787878787878,20,13,7,364.25158246853846,0.47670223577235776,0.2589392781647917,0.19640840568864598,128085.94419795959,1131.1015732167423,129217.04577117633,165,1,39.80487804878049,35,6,23,37.714860126534035,0.6029761904761906,46.932870370370374,1012.2685185185189,28.921957671957685,0
3577,4,0,1,38,0.0,0.02564102564102564,0.9743589743589743,39,900,500,400,0.5555555555555556,13,5,8,360.9998092223077,0.47565227170490326,0.0984722284085342,0.17987497707066513,124855.3659363211,1496.2018550668681,126351.56779138798,166,2,41.53846153846154,35,4,17,41.12490349353408,0.5699404761904762,50.144675925925924,999.4212962962958,28.554894179894166,16
3578,4,4,6,36,0.09523809523809523,0.14285714285714285,0.8571428571428572,42,1450,1100,350,0.7586206896551724,18,11,7,339.7028077187143,0.4781020131629888,0.1416658863676561,0.17372287719872123,125933.75485726376,156.0937468087253,126089.84860407248,167,0,39.42857142857143,37,5,16,40.543751365523256,0.5771396396396397,49.06798245614035,1003.7280701754385,27.127785680417254,0
3579,4,2,0,38,0.05263157894736842,0.0,1.0,38,1050,400,650,0.38095238095238093,17,4,13,368.62729539495604,0.47721076339497387,0.16293146702003036,0.18733593359761092,125674.92821270684,1665.4417772010952,127340.36998990794,168,0,43.28947368421053,33,5,18,40.08545180477469,0.5827020202020202,49.32598039215687,1002.6960784313742,30.38472964943558,0
3580,4,4,6,36,0.09523809523809523,0.14285714285714285,0.8571428571428572,42,1400,1000,400,0.7142857142857143,18,10,8,330.1920834396851,0.4784286682152536,0.14384254820496478,0.1720231483654303,126694.89590942295,-32.72901425927259,126662.16689516368,169,0,40.07142857142857,36,6,17,40.00023303504849,0.5868055555555556,48.310810810810814,1006.7567567567569,27.96546546546547,0
3581,4,2,1,37,0.05263157894736842,0.02631578947368421,0.9736842105263158,38,950,500,450,0.5263157894736842,14,5,9,358.9973245374058,0.476558795637743,0.1559009661356554,0.1849359033005319,126234.09162649239,1463.540231864118,127697.6318583565,170,0,43.68421052631579,32,6,20,39.74981153411233,0.5908203125,48.768939393939405,1004.924242424244,31.403882575757624,0
3582,4,4,3,38,0.0975609756097561,0.07317073170731707,0.926829268292683,41,1050,700,350,0.6666666666666666,14,7,7,330.7087516535689,0.47616869918699184,0.16232388163615719,0.17536610581605347,127413.15593117703,227.32914844820962,127640.48507962523,171,0,40.51219512195122,35,6,16,39.25123715082733,0.5961309523809524,47.598379629629626,1009.6064814814806,28.845899470899447,0
3583,4,2,2,38,0.05,0.05,0.95,40,1000,600,400,0.6,14,6,8,335.2248803211453,0.4757478632478633,0.17421065032987793,0.17873045126670117,127632.76643990936,557.1357709750679,128189.90221088444,172,0,39.225,34,6,19,38.9125333804587,0.6004901960784313,47.38095238095239,1010.4761904761909,29.719887955182088,0
3584,4,1,1,38,0.02564102564102564,0.02564102564102564,0.9743589743589743,39,1700,1200,500,0.7058823529411765,22,12,10,341.7489391191798,0.47351551956815113,0.1726133345757812,0.1835483079003793,127927.48169273835,943.8162305363257,128871.29792327467,173,0,37.53846153846154,33,6,20,38.446269937411685,0.6057449494949495,47.08946078431372,1011.642156862745,30.655822935234696,0
3585,4,0,6,32,0.0,0.15789473684210525,0.8421052631578947,38,1200,800,400,0.6666666666666666,16,8,8,349.9965769619278,0.47369902797534374,0.17631547061036823,0.1876882228503435,127865.50132461055,1350.497555026894,129215.99887963745,174,1,39.18421052631579,33,5,20,38.30109758067774,0.6051136363636364,47.15073529411764,1011.3970588235279,30.648395721925088,0
3586,4,0,0,32,0.0,0.0,1.0,32,1450,900,550,0.6206896551724138,20,9,11,391.39569089020904,0.46917002688172044,0.16285611065235384,0.20697824526988773,127302.17013888879,3565.104166666658,130867.27430555545,175,2,43.15625,29,3,23,37.83374621524913,0.6099137931034483,47.70833333333333,1009.1666666666658,34.79885057471262,0
3587,4,0,2,30,0.0,0.0625,0.9375,32,1600,1300,300,0.8125,19,13,6,392.6878520565416,0.4675949260752688,0.16488402061855667,0.20928967939277207,127617.73003472216,3622.7864583333226,131240.51649305547,176,3,44.15625,29,3,20,37.47637457044674,0.6131465517241379,47.39583333333333,1010.4166666666661,34.84195402298848,0
3588,4,0,2,28,0.0,0.06666666666666667,0.9333333333333333,30,850,600,250,0.7058823529411765,11,6,5,403.305836734007,0.46518199233716473,0.1265453166477053,0.21485201847829835,127599.58382877528,4292.33138459506,131891.91521337035,177,4,41.7,28,2,20,37.22684395145998,0.6160714285714286,47.41379310344828,1010.3448275862071,36.08374384236454,0
3589,4,2,0,30,0.06666666666666667,0.0,1.0,30,950,600,350,0.631578947368421,13,6,7,401.07346180479084,0.46573275862068964,0.13531695308431524,0.21540490042467847,127926.41293846621,4261.577858699971,132187.9907971662,178,0,41.86666666666667,28,2,22,36.94698906405341,0.6194196428571428,47.09051724137932,1011.6379310344835,36.12992610837441,0
3590,4,0,1,29,0.0,0.03333333333333333,0.9666666666666667,30,800,400,400,0.5,12,4,8,399.90399248956396,0.46499042145593866,0.1313085438546695,0.21575218461573245,128108.16529594392,4246.193354472184,132354.3586504161,179,1,42.86666666666667,28,2,22,36.78978616709246,0.6212797619047619,46.910919540229884,1012.35632183908,36.15558292282429,0
3591,4,1,1,29,0.03333333333333333,0.03333333333333333,0.9666666666666667,30,1200,700,500,0.5833333333333334,17,7,10,391.3500523916756,0.46393678160919544,0.1022666100014169,0.21365352048204495,128581.32524524395,4064.0668351169556,132645.3920803609,180,0,41.06666666666667,28,2,21,36.52104877933608,0.6261160714285714,46.443965517241395,1014.224137931036,36.22229064039414,0
3592,4,0,2,27,0.0,0.06896551724137931,0.9310344827586207,29,900,700,200,0.7777777777777778,11,7,4,390.93501818773365,0.46248973727422005,0.03661304451700209,0.19019647514077387,123853.21706962622,3883.7119335447373,127736.92900317095,181,1,42.724137931034484,28,1,20,41.42098489222479,0.5773809523809523,51.14942528735633,995.4022988505757,35.550082101806275,16
3593,4,6,4,29,0.18181818181818182,0.12121212121212122,0.8787878787878788,33,1100,1000,100,0.9090909090909091,12,10,2,349.15729566369646,0.4709201388888889,0.06606641006842584,0.17671634556040175,125505.56065707606,2164.236429956156,127669.79708703222,182,0,37.96969696969697,32,1,16,40.74838289650539,0.5833333333333333,49.49494949494951,1002.020202020204,31.313131313131375,0
3594,4,5,3,31,0.14705882352941177,0.08823529411764706,0.9117647058823529,34,1350,1200,150,0.8888888888888888,15,12,3,342.6131545675453,0.4687871360665478,0.08182848697473877,0.17633931288758986,126197.70828827866,1847.3989871684112,128045.10727544708,183,0,37.705882352941174,33,1,21,40.198880961092826,0.5880681818181819,48.805147058823536,1004.7794117647069,30.447860962566875,0
3595,4,3,4,30,0.08823529411764706,0.11764705882352941,0.8823529411764706,34,750,500,250,0.6666666666666666,10,5,5,334.2075382730722,0.46657754010695185,0.08689997635374813,0.17427418980971932,126732.14994331081,1670.9679705215613,128403.11791383238,184,0,36.61764705882353,34,0,19,39.8609304800189,0.5912990196078431,48.27380952380953,1006.9047619047631,29.614845938375385,0
3596,4,3,1,32,0.09090909090909091,0.030303030303030304,0.9696969696969697,33,850,500,350,0.5882352941176471,12,5,7,383.5325161005492,0.4657512626262626,0.09486028299720517,0.18793584367692734,124155.07846408426,3350.8616198758255,127505.94008396009,185,0,38.303030303030305,31,2,21,41.29050169845832,0.5719086021505376,50.84635416666667,996.6145833333339,32.14885752688174,16
3597,4,3,0,35,0.08571428571428572,0.0,1.0,35,1300,900,400,0.6923076923076923,17,9,8,357.20571309989424,0.4686974789915966,0.11264512287897332,0.1783550838009764,124942.13632758934,1926.0089806241635,126868.1453082135,186,0,37.0,35,0,22,41.12979470556458,0.5708333333333333,50.05787037037038,999.76851851852,28.564814814814856,0
3598,4,7,2,40,0.16666666666666666,0.047619047619047616,0.9523809523809523,42,900,600,300,0.6666666666666666,12,6,6,354.32794307069435,0.47488385598141697,0.13849371935534083,0.17561910962592797,124634.27690782017,1350.5716466278811,125984.84855444805,187,0,31.666666666666668,36,6,20,41.52076049772565,0.5656828703703703,50.365990990991,998.5360360360376,27.737112112112154,16
3599,4,6,5,41,0.13043478260869565,0.10869565217391304,0.8913043478260869,46,1400,1100,300,0.7857142857142857,17,11,6,320.8548087493578,0.474194847020934,0.18215971775890183,0.16495340441061834,126151.1423976367,-1095.7622709301193,125055.38012670657,188,0,29.73913043478261,38,8,19,40.79327519585946,0.5775767543859649,48.85149572649572,1004.5940170940163,26.43668466036885,0
3600,4,3,2,42,0.06818181818181818,0.045454545454545456,0.9545454545454546,44,900,600,300,0.6666666666666666,12,6,6,343.2153096532734,0.47109540169133196,0.21131398013751013,0.1769610998645558,126270.10192202317,-132.4335737764991,126137.66834824668,189,0,31.954545454545453,36,8,19,40.10924369747899,0.5824652777777778,48.7331081081081,1005.0675675675659,27.918543543543496,0
3601,4,1,2,41,0.023255813953488372,0.046511627906976744,0.9534883720930233,43,1150,800,350,0.6956521739130435,15,8,7,365.2469566723909,0.4703073089700997,0.1425324163998114,0.18018307550764937,124437.57101696286,717.4477264426571,125155.01874340551,190,0,33.51162790697674,36,7,17,41.45245485327317,0.5636574074074074,50.56306306306306,997.7477477477473,27.715215215215203,15
3602,4,1,1,41,0.023809523809523808,0.023809523809523808,0.9761904761904762,42,1050,800,250,0.7619047619047619,13,8,5,362.7308380387251,0.4701655052264808,0.19144724135711044,0.18087634373211933,124887.4127505884,660.1031775018164,125547.51592809022,191,0,35.19047619047619,36,6,19,41.04842646837914,0.568287037037037,50.11261261261261,999.5495495495493,27.765265265265256,0
3603,4,3,4,40,0.06818181818181818,0.09090909090909091,0.9090909090909091,44,1200,700,500,0.5833333333333334,17,7,10,384.75022335859694,0.47316552149400987,0.19912150059371658,0.1819808124513907,122653.65905855634,790.0318355245847,123443.69089408092,192,0,34.31818181818182,37,7,16,42.82940373404176,0.5433558558558558,52.35745614035087,990.5701754385954,26.77216690374582,16
3604,4,9,9,40,0.1836734693877551,0.1836734693877551,0.8163265306122449,49,1150,700,450,0.6086956521739131,16,7,9,347.4033819091901,0.4827097505668934,0.2624207745051963,0.17287780941647013,124801.66603678484,-1121.1694759210945,123680.49656086374,193,0,30.571428571428573,41,8,17,41.5202210749272,0.5589430894308943,50.19841269841269,999.2063492063471,24.370886566008465,0
3605,4,3,2,41,0.06976744186046512,0.046511627906976744,0.9534883720930233,43,1150,800,350,0.6956521739130435,15,8,7,377.35227174930105,0.47939737910668145,0.2883269870241576,0.1871565965253245,124662.39043097153,808.3272461650843,125470.7176771366,194,0,35.13953488372093,36,7,19,40.91677943166441,0.5659722222222222,50.33783783783784,998.6486486486488,27.740240240240244,0
3606,4,2,1,42,0.046511627906976744,0.023255813953488372,0.9767441860465116,43,1450,1200,250,0.8275862068965517,17,12,5,381.7403372321248,0.48075858250276854,0.32703574776109967,0.19237974694184518,125327.59530895672,969.8893124025622,126297.48462135928,195,0,35.81395348837209,34,9,19,40.11661316529943,0.5768995098039216,49.67261904761904,1001.3095238095221,29.45028011204477,0
3607,4,1,2,41,0.023255813953488372,0.046511627906976744,0.9534883720930233,43,1750,1400,350,0.8,21,14,7,409.7532353029818,0.4810585086747878,0.33775083672091544,0.19545977841942497,123016.50995110068,1548.4063141188012,124564.91626521948,196,0,36.51162790697674,33,10,16,41.82918982911262,0.555239898989899,51.99142156862746,992.0343137254914,30.061645870469437,15
3608,4,10,9,42,0.19607843137254902,0.17647058823529413,0.8235294117647058,51,1000,700,300,0.7,13,7,6,345.59298630347354,0.48387254901960786,0.3319803277280249,0.1739395791042289,125274.27309364411,-1486.412577555811,123787.8605160883,197,0,31.058823529411764,37,14,18,41.07657904344652,0.5703828828828829,49.72587719298245,1001.0964912280695,27.05666192508296,0
3609,4,7,3,46,0.14285714285714285,0.061224489795918366,0.9387755102040817,49,1150,600,550,0.5217391304347826,17,6,11,354.2095658468906,0.48579223356009066,0.34474238125743595,0.18200168936372466,126128.66244622988,-864.80424681439,125263.8581994155,198,0,29.46938775510204,36,13,22,39.97874626307923,0.5810185185185186,48.87387387387387,1004.5045045045034,27.902902902902873,0
3610,4,3,3,46,0.061224489795918366,0.061224489795918366,0.9387755102040817,49,1400,1100,300,0.7857142857142857,17,11,6,372.5510809581779,0.4850659013605442,0.3724425673076097,0.1803812231738687,123649.5008680558,-298.6912905303716,123350.80957752542,199,0,30.408163265306122,39,10,15,42.09083926825862,0.5502136752136753,51.35416666666668,994.5833333333353,25.502136752136803,16
3611,4,2,3,45,0.041666666666666664,0.0625,0.9375,48,1500,1100,400,0.7333333333333333,19,11,8,380.6638816930772,0.4852799940898345,0.38199812130971544,0.18497047772410097,123800.96616124264,-174.68873274160927,123626.27742850104,200,0,31.895833333333332,38,10,19,41.73107890499194,0.553453947368421,51.20192307692308,995.1923076923081,26.18927125506074,0
3612,4,5,9,41,0.1,0.18,0.8200000000000001,50,1300,700,600,0.5384615384615384,19,7,12,348.39124164620455,0.48664115646258504,0.3492102521358609,0.17397810287826623,124947.9220920141,-1293.5394708456397,123654.38262116845,201,0,30.62,39,11,18,41.34411682989512,0.5635683760683761,50.05208333333334,999.7916666666683,25.635683760683804,0
3613,4,3,3,41,0.06818181818181818,0.06818181818181818,0.9318181818181819,44,1050,700,350,0.6666666666666666,14,7,7,383.7031647696831,0.483824436222692,0.36476534014250217,0.19086832839336365,124785.63120254244,776.1283220396235,125561.75952458207,154,0,30.295454545454547,33,11,20,40.630110593237674,0.5735479797979798,50.21446078431374,999.1421568627463,30.27703505644686,0
3614,4,3,1,43,0.06818181818181818,0.022727272727272728,0.9772727272727273,44,1700,1000,700,0.5882352941176471,24,10,14,360.3332805941875,0.48576242071881603,0.28145274759634153,0.1738869731664069,123508.74789977366,177.6395735281277,123686.38747330179,155,0,29.795454545454547,38,6,15,42.54129048437946,0.5504385964912281,51.4957264957265,994.017094017095,26.158344579397237,16
3615,4,7,3,47,0.14,0.06,0.94,50,1200,700,500,0.5833333333333334,17,7,10,329.98672878270287,0.48704081632653057,0.3149466040153779,0.16541733020991606,125106.86043538617,-1713.9588583899333,123392.90157699624,156,0,24.66,38,12,17,41.63996867435568,0.5668859649122807,49.8931623931624,1000.4273504273513,26.327035537561876,0
3616,4,1,3,45,0.020833333333333332,0.0625,0.9375,48,1550,1000,550,0.6451612903225806,21,10,11,379.99730638713805,0.4863881501182033,0.3828351985365328,0.18212042126125205,123216.87492010022,-232.08826429978944,122984.78665580043,157,0,26.520833333333332,38,10,18,42.35759890957351,0.5474232456140351,51.78952991452992,992.8418803418815,26.127417903733726,15
3617,4,5,1,49,0.1,0.02,0.98,50,1100,800,300,0.7272727272727273,14,8,6,371.82193874069316,0.48669217687074834,0.4160196303644148,0.1832701341904076,124401.75916883687,-744.464949118015,123657.29421971885,158,0,25.94,39,11,17,41.32568044968848,0.5579594017094017,50.598958333333336,997.6041666666672,25.57959401709403,0
3618,4,5,3,51,0.09259259259259259,0.05555555555555555,0.9444444444444444,54,1550,1000,550,0.6451612903225806,21,10,11,351.12869844078534,0.4851866410435593,0.4326275186684341,0.17801816042413848,125576.32065876032,-1972.6999683796932,123603.62069038063,159,0,24.925925925925927,37,17,18,40.62591164351094,0.5734797297297297,49.42434210526316,1002.3026315789468,27.08926031294451,0
3619,4,0,5,46,0.0,0.09803921568627451,0.9019607843137255,51,1400,1200,200,0.8571428571428571,16,12,4,379.41199318850465,0.4836437908496732,0.31990049054613534,0.18997732817460167,125059.53089569161,31.46063928225871,125090.99153497387,160,1,26.784313725490197,34,17,16,40.45291795604221,0.5741421568627452,49.94047619047619,1000.2380952380953,29.4187675070028,16
3620,4,4,3,47,0.08,0.06,0.94,50,1250,800,450,0.64,17,8,9,341.56613444005495,0.48477040816326533,0.3452469531751121,0.17012830785688388,124839.79495397788,-1451.5491243341248,123388.24582964375,161,0,27.06,38,12,22,41.62657686551207,0.5641447368421053,50.16025641025642,999.3589743589762,26.298920377867795,15
3621,4,3,4,46,0.06,0.08,0.92,50,1100,800,300,0.7272727272727273,14,8,6,327.03274541995296,0.485374149659864,0.3409764204840551,0.16631506815414107,125704.1137695314,-1778.1277126735977,123925.9860568578,162,0,27.06,39,11,17,41.09806187458884,0.5713141025641026,49.29687500000001,1002.8125000000011,25.713141025641054,0
3622,4,3,4,45,0.061224489795918366,0.08163265306122448,0.9183673469387755,49,1750,1100,650,0.6285714285714286,24,11,13,344.74234747669846,0.48455215419501135,0.3811958123856132,0.17772262975092318,126264.14497730052,-1093.822009837183,125170.32296746333,163,0,28.244897959183675,37,12,21,40.07700560040731,0.5805180180180181,48.73903508771929,1005.0438596491213,27.163347558084357,0
3623,4,1,3,43,0.021739130434782608,0.06521739130434782,0.9347826086956522,46,1500,1000,500,0.6666666666666666,20,10,10,345.60805569318717,0.4816425120772947,0.3676733780760628,0.18005454649749958,126694.89590942295,-442.6446716987206,126252.25123772422,158,0,25.934782608695652,36,10,17,39.61222967934378,0.5868055555555556,48.310810810810814,1006.7567567567569,27.96546546546547,0
3624,4,1,2,42,0.022727272727272728,0.045454545454545456,0.9545454545454546,44,1250,1100,150,0.88,14,11,3,344.7808750985638,0.4812477977448908,0.33875850837265675,0.1808645699011018,126975.33543381326,-44.26654663925166,126931.06888717401,159,0,24.818181818181817,35,9,18,39.345046700352185,0.5916666666666667,48.0324074074074,1007.8703703703688,28.79629629629625,0
3625,4,2,2,42,0.045454545454545456,0.045454545454545456,0.9545454545454546,44,1750,1300,450,0.7428571428571429,22,13,9,338.14284190035806,0.4815781360112756,0.3228689275893677,0.17995797098209282,127559.26354595323,-173.34962277093445,127385.91392318229,160,0,25.40909090909091,35,9,18,38.91403146959975,0.5976190476190476,47.453703703703695,1010.1851851851841,28.862433862433832,0
3626,4,0,0,42,0.0,0.0,1.0,42,1500,1000,500,0.6666666666666666,20,10,10,401.4052866596975,0.4811628919860627,0.17251640879500707,0.19975710087108822,124803.00560273138,1619.3172479912696,126422.32285072266,161,1,26.19047619047619,36,6,17,40.16985048273791,0.5674189814814814,50.19707207207209,999.2117117117141,27.755880880880948,16
3627,4,7,4,45,0.14285714285714285,0.08163265306122448,0.9183673469387755,49,1300,800,500,0.6153846153846154,18,8,10,354.4945331281858,0.48508361678004536,0.16367202891121124,0.18108167190651878,125886.98459201395,-535.7839337437039,125351.20065827025,162,0,23.306122448979593,39,10,14,40.22083246834128,0.5731837606837606,49.114583333333336,1003.5416666666672,25.73183760683762,16
3628,4,2,4,43,0.0425531914893617,0.0851063829787234,0.9148936170212766,47,1850,1300,550,0.7027027027027027,24,13,11,352.8439658906271,0.4836378353376503,0.24064339211584485,0.17376635851562994,124365.64426143498,-543.1761202615885,123822.46814117339,163,0,24.872340425531913,40,7,16,41.83647478349464,0.5559895833333333,50.635162601626014,997.4593495934957,24.936483739837392,16
3629,4,4,5,42,0.0851063829787234,0.10638297872340426,0.8936170212765957,47,800,600,200,0.75,10,6,4,337.657468435615,0.48500616712920136,0.23969224568078662,0.16957006269006575,125182.35812717033,-943.0209201517785,124239.33720701856,164,0,24.51063829787234,39,8,20,41.3701164081746,0.5659722222222222,49.81770833333334,1000.7291666666682,25.65972222222226,0
3630,4,2,8,36,0.045454545454545456,0.18181818181818182,0.8181818181818181,44,1400,900,500,0.6428571428571429,19,9,10,338.09092668985505,0.48389050387596905,0.21557559829570305,0.1703888710006487,125329.16378116341,-325.4693751923711,125003.69440597104,165,0,24.272727272727273,37,7,18,41.2076580522704,0.5709459459459459,49.671052631578945,1001.315789473684,27.062588904694163,0
3631,4,2,0,38,0.05263157894736842,0.0,1.0,38,1350,800,550,0.5925925925925926,19,8,11,366.17830823979773,0.48309329065908013,0.22063090217507075,0.18295845395039007,124970.23986677986,1552.2782029478183,126522.51806972767,166,0,27.44736842105263,34,4,21,40.87639401516052,0.5732230392156863,50.02976190476189,999.8809523809508,29.408263305322084,0
3632,4,5,6,37,0.11627906976744186,0.13953488372093023,0.8604651162790697,43,1400,1100,300,0.7857142857142857,17,11,6,347.76055823765705,0.483296419342931,0.26784180121463486,0.18078942928249028,126607.70052596962,210.4247591541407,126818.12528512375,167,0,25.13953488372093,38,5,16,39.64769108280255,0.5822368421052632,48.39743589743589,1006.4102564102552,26.484480431848823,0
3633,4,2,2,37,0.05128205128205128,0.05128205128205128,0.9487179487179487,39,1050,700,350,0.6666666666666666,14,7,7,360.9643617405939,0.48220310391363025,0.2544241818922819,0.18727384481942275,126524.8927136593,1334.1954285366087,127859.0881421959,168,0,26.923076923076923,36,3,17,39.40074434743675,0.5850694444444444,48.47972972972971,1006.0810810810785,27.946696696696627,0
3634,4,1,1,37,0.02631578947368421,0.02631578947368421,0.9736842105263158,38,1000,700,300,0.7,13,7,6,373.5519927158827,0.4792259364627786,0.26504991917271603,0.19386790881666655,126538.26845689716,1853.7244673782402,128391.9929242754,169,0,28.394736842105264,35,3,18,39.07034874803482,0.587202380952381,48.466435185185176,1006.1342592592581,28.746693121693088,0
3635,4,2,0,39,0.05128205128205128,0.0,1.0,39,1150,700,450,0.6086956521739131,16,7,9,389.635948647618,0.47818263607737294,0.2903330704194167,0.19050010892982508,124060.91022083495,1973.3549575807074,126034.26517841566,170,0,28.512820512820515,30,9,20,41.236620795107015,0.5736111111111111,50.940860215053775,996.2365591397863,33.20788530465954,16
3636,4,3,2,40,0.07142857142857142,0.047619047619047616,0.9523809523809523,42,1600,1100,500,0.6875,21,11,10,359.8311597645834,0.47968689508323653,0.28027094199600966,0.18018048625757846,125061.28201893502,600.1892301038038,125661.47124903882,171,0,27.404761904761905,33,9,19,40.94074164828881,0.5763888888888888,49.93872549019608,1000.2450980392156,30.310457516339866,0
3637,4,2,2,40,0.047619047619047616,0.047619047619047616,0.9523809523809523,42,1450,900,550,0.6206896551724138,20,9,11,342.5702894060433,0.4805579752226094,0.2558272982706087,0.17413817427079686,125685.46095521549,211.2209467120316,125896.68190192751,172,0,27.452380952380953,34,8,16,40.72776920337172,0.5805759803921569,49.3154761904762,1002.7380952380959,29.492296918767526,0
3638,4,2,0,42,0.047619047619047616,0.0,1.0,42,1500,1100,400,0.7333333333333333,19,11,8,342.95812284691084,0.48133226867982964,0.26306888068880663,0.1753616062104018,125927.6406035667,237.58144718794676,126165.22205075464,173,0,28.38095238095238,35,7,18,40.4683656211562,0.5809523809523809,49.07407407407408,1003.7037037037051,28.677248677248716,0
3639,4,1,3,40,0.023255813953488372,0.06976744186046512,0.9302325581395349,43,850,500,350,0.5882352941176471,12,5,7,334.41769063870964,0.481266149870801,0.185752039469252,0.16290844009734076,123907.31295428787,-199.25745073094276,123708.05550355693,174,0,28.697674418604652,38,5,17,42.77126479951353,0.5545504385964912,51.09508547008546,995.6196581196562,26.20051731893832,16
3640,4,2,2,40,0.047619047619047616,0.047619047619047616,0.9523809523809523,42,1400,1000,400,0.7142857142857143,18,10,8,330.49289484915334,0.4819250871080139,0.2086021852282014,0.16260250426578327,124325.23739956164,-182.2670635279024,124142.97033603373,175,0,29.714285714285715,36,6,14,42.43568390545016,0.5625,50.67567567567567,997.2972972972966,27.702702702702684,0
3641,4,2,3,39,0.047619047619047616,0.07142857142857142,0.9285714285714286,42,1050,700,350,0.6666666666666666,14,7,7,354.13143970223365,0.4829534456058846,0.2163774494218451,0.1651130584783157,122037.44058909858,383.77130522582695,122421.21189432441,176,0,30.30952380952381,35,7,18,44.23258072703137,0.5407738095238095,52.980324074074055,988.0787037037007,28.230820105820023,16
3642,4,13,13,39,0.25,0.25,0.75,52,1200,700,500,0.5833333333333334,17,7,10,285.20161365245315,0.48824786324786323,0.22417525058219745,0.14075734908926923,124456.08540124258,-3282.732783210535,121173.35261803205,177,0,23.48076923076923,43,9,14,43.429996678371445,0.5525678294573644,50.54450757575758,997.82196969697,23.205162085976045,0
3643,4,4,2,41,0.09302325581395349,0.046511627906976744,0.9534883720930233,43,700,400,300,0.5714285714285714,10,4,6,347.7350811451704,0.48530361757105944,0.17721042638509776,0.16522190550467256,122847.88547092032,-46.23232054204988,122801.65315037826,178,0,27.023255813953487,39,4,17,43.54324279359742,0.5419337606837606,52.16145833333334,991.3541666666681,25.419337606837644,16
3644,4,8,9,40,0.16326530612244897,0.1836734693877551,0.8163265306122449,49,1700,1200,500,0.7058823529411765,22,12,10,316.9700227433594,0.48621740362811794,0.24513307160186626,0.1574529432167182,124727.33139841557,-1882.9546908462708,122844.3767075693,179,0,24.510204081632654,41,8,18,42.35721438739366,0.558180894308943,50.27281746031745,998.9087301587278,24.36362756484702,0
3645,4,3,2,41,0.06976744186046512,0.046511627906976744,0.9534883720930233,43,1500,1100,400,0.7333333333333333,19,11,8,347.86034696789983,0.48502676264304173,0.2437452774746034,0.17206663591090784,124549.95536076633,65.19813732653674,124615.15349809286,170,0,23.46511627906977,36,7,20,41.76961116125152,0.5648148148148149,50.45045045045046,998.1981981981995,27.727727727727764,0
3646,4,4,5,40,0.08888888888888889,0.1111111111111111,0.8888888888888888,45,1300,1000,300,0.7692307692307693,16,10,6,341.0448697171936,0.48571127946127945,0.2692217481348407,0.17356260626864708,125733.05357722576,-422.25417985554475,125310.79939737021,171,0,22.444444444444443,36,9,19,40.71693240512015,0.5769675925925926,49.26801801801801,1002.9279279279269,27.85910910910908,0
3647,4,4,6,38,0.09090909090909091,0.13636363636363635,0.8636363636363636,44,1300,700,600,0.5384615384615384,19,7,12,336.358472341086,0.4849145525017618,0.2721323978035388,0.1752357076182577,126694.89590942263,-276.6360532830505,126418.25985613959,172,0,21.90909090909091,36,8,17,39.84503169276659,0.5868055555555556,48.31081081081079,1006.7567567567542,27.965465465465392,0
3648,4,1,3,36,0.02564102564102564,0.07692307692307693,0.9230769230769231,39,1400,1000,400,0.7142857142857143,18,10,8,358.11779490441734,0.4829059829059829,0.24130745173757218,0.18543045695776358,126444.09789804395,1256.3763035851491,127700.4742016291,173,0,21.923076923076923,33,6,18,39.555536940010555,0.5905934343434344,48.56004901960784,1005.759803921568,30.477569815805094,0
3649,4,2,0,38,0.05263157894736842,0.0,1.0,38,1450,1000,450,0.6896551724137931,19,10,9,350.46305583733255,0.4796111901375059,0.18560567274216666,0.18381429663305016,126968.47366397553,1299.5518550557613,128268.02551903129,86,0,17.710526315789473,33,5,21,39.20892104409857,0.595959595959596,48.03921568627452,1007.8431372549031,30.54070112893646,0
3650,4,3,7,34,0.07317073170731707,0.17073170731707318,0.8292682926829268,41,1100,800,300,0.7272727272727273,14,8,6,330.16993106970034,0.4795985772357723,0.19264057511456723,0.1774070969336239,127945.07345183034,248.7232164597232,128193.79666829006,87,0,17.341463414634145,36,5,17,38.721152419115484,0.599537037037037,47.07207207207208,1011.7117117117127,28.10310310310313,0
3651,4,1,5,30,0.02857142857142857,0.14285714285714285,0.8571428571428572,35,750,400,350,0.5333333333333333,11,4,7,388.07608606315705,0.47888655462184876,0.12128544423440468,0.19626410088662566,125473.93322428862,2855.5602121135366,128329.49343640215,88,0,17.62857142857143,32,3,18,39.8062381852552,0.5830078125,49.52651515151517,1001.8939393939418,31.30918560606068,16
3652,4,4,1,33,0.11764705882352941,0.029411764705882353,0.9705882352941176,34,1000,700,300,0.7,13,7,6,383.13807993108287,0.4791109625668449,0.06471819497029618,0.18630454726419846,123830.87158203132,3193.843239748351,127024.71482177968,89,0,16.764705882352942,31,3,18,41.63832199546486,0.5685483870967742,51.17187500000001,995.3125000000006,32.106854838709694,16
3653,4,6,5,34,0.15384615384615385,0.1282051282051282,0.8717948717948718,39,1150,800,350,0.6956521739130435,15,8,7,363.206188828047,0.4843117408906883,0.03110281365794476,0.1760086349084932,123686.06913506842,1600.5620209174554,125286.63115598587,90,0,13.692307692307692,33,6,20,42.285096094616215,0.5621843434343434,51.31740196078432,994.7303921568641,30.14334521687467,16
3654,4,1,2,33,0.02857142857142857,0.05714285714285714,0.9428571428571428,35,850,700,150,0.8235294117647058,10,7,3,369.5945921238835,0.4828081232492997,0.033325476402009224,0.17920220254425112,123709.15794625555,2144.447154627089,125853.60510088265,91,0,14.628571428571428,32,3,21,42.10215974954519,0.5647786458333333,51.294191919191924,994.8232323232329,31.088226010101028,0
3655,4,7,10,30,0.175,0.25,0.75,40,1450,1000,450,0.6896551724137931,19,10,9,317.15466844669805,0.4824519230769231,0.05794036061026375,0.1599080531119367,125347.46334876558,-41.88348127740437,125305.57986748818,92,0,13.425,35,5,14,41.71289875173372,0.575,49.652777777777786,1001.38888888889,28.611111111111143,0
3656,4,5,4,31,0.14285714285714285,0.11428571428571428,0.8857142857142857,35,850,600,250,0.7058823529411765,11,6,5,352.37278643429073,0.484593837535014,0.06604958923460091,0.1770155056558141,125195.3887939452,1823.089599609361,127018.47839355456,93,0,15.114285714285714,31,4,24,40.98848555815768,0.5826612903225806,49.80468749999999,1000.7812499999991,32.28326612903223,0
3657,4,4,2,33,0.11428571428571428,0.05714285714285714,0.9428571428571428,35,900,600,300,0.6666666666666666,12,6,6,327.8243008731414,0.4813375350140056,0.055365636924363804,0.16872764864148673,126197.70828827842,1274.1350982794938,127471.84338655791,94,0,14.685714285714285,33,2,22,40.57036935398626,0.5880681818181819,48.80514705882352,1004.7794117647048,30.447860962566814,0
3658,4,2,5,30,0.05714285714285714,0.14285714285714285,0.8571428571428572,35,1200,800,400,0.6666666666666666,16,8,8,334.4806988069047,0.47717086834733896,0.08091701309770216,0.17397656613686566,126629.0477971213,1470.9944792868114,128100.0422764081,95,0,15.571428571428571,33,2,16,39.95989589674905,0.5924873737373737,48.37622549019608,1006.4950980392157,30.499851455733808,0
3659,4,4,2,32,0.11764705882352941,0.058823529411764705,0.9411764705882353,34,1050,800,250,0.7619047619047619,13,8,5,372.3147876532822,0.478888146167558,0.06179937593898077,0.18398856982089373,124510.28450595916,2471.404027297183,126981.68853325634,96,0,16.529411764705884,33,1,19,41.20057711198429,0.5707070707070707,50.49019607843137,998.0392156862739,30.243612596553756,16
3660,4,3,4,31,0.08571428571428572,0.11428571428571428,0.8857142857142857,35,1150,600,550,0.5217391304347826,17,6,11,423.5637589514576,0.4802871148459384,0.18689083736714207,0.19656487145967802,121835.75857426332,3563.2719264176567,125399.03050068098,97,0,16.485714285714284,34,1,17,42.73031472326058,0.5407475490196079,53.184523809523824,987.2619047619071,29.037114845938444,16
3661,4,8,5,34,0.20512820512820512,0.1282051282051282,0.8717948717948718,39,1200,900,300,0.75,15,9,6,377.0504435324464,0.48563315339631125,0.20784639824509643,0.18378271760394543,123931.69052479856,1550.578602550852,125482.26912734941,98,0,14.692307692307692,35,4,18,41.684707853849446,0.5604166666666667,51.070601851851855,995.7175925925928,28.44907407407408,0
3662,4,4,3,35,0.10526315789473684,0.07894736842105263,0.9210526315789473,38,1100,1000,100,0.9090909090909091,12,10,2,420.3299910072475,0.48398233760075865,0.19121149982394003,0.20114096179838356,123151.41677856455,3054.998433933351,126206.4152124979,99,0,15.657894736842104,31,7,15,41.42520989111899,0.561491935483871,51.85546875000001,992.5781250000008,32.01864919354841,15
3663,4,5,2,38,0.125,0.05,0.95,40,1200,700,500,0.5833333333333334,17,7,10,379.37580236066236,0.48512286324786325,0.21993002700712005,0.1877518399775185,124571.44637879661,1454.5275795601856,126025.9739583568,100,0,15.55,33,7,18,40.96079875603569,0.5713383838383839,50.42892156862745,998.2843137254902,30.25103980986334,0
3664,4,4,5,37,0.09523809523809523,0.11904761904761904,0.8809523809523809,42,1150,800,350,0.6956521739130435,15,8,7,354.06878718497455,0.4845383275261324,0.21880199667221278,0.17881961436820987,125417.01388888895,481.9858948481414,125898.99978373709,101,0,15.666666666666666,34,8,18,40.71686078757625,0.5778186274509804,49.583333333333336,1001.6666666666672,29.460784313725505,0
3665,4,3,3,37,0.075,0.075,0.925,40,1150,700,450,0.6086956521739131,16,7,9,351.98286994624806,0.4822916666666666,0.1991694352159472,0.17957092178613662,125834.72222222216,858.3333333333292,126693.05555555549,102,0,15.675,34,6,21,40.33776301218163,0.5821078431372548,49.166666666666664,1003.3333333333328,29.50980392156861,0
3666,4,3,2,38,0.075,0.05,0.95,40,650,300,350,0.46153846153846156,10,3,7,338.24998178225286,0.4811298076923077,0.18731884057970993,0.17567176473207327,126567.38281250003,562.4565972222233,127129.83940972225,103,0,15.45,35,5,18,39.9283988957902,0.5875,48.4375,1006.2500000000002,28.750000000000007,0
3667,4,3,2,39,0.07317073170731707,0.04878048780487805,0.9512195121951219,41,1000,700,300,0.7,13,7,6,325.9466507989728,0.4820121951219512,0.16825346681336306,0.17171636497385914,127148.79575521489,89.82989535144793,127238.62565056633,104,0,15.512195121951219,36,5,21,39.64195325294028,0.5914351851851851,47.86036036036037,1008.5585585585603,28.015515515515563,0
3668,4,3,11,31,0.07142857142857142,0.2619047619047619,0.7380952380952381,42,1250,900,350,0.72,16,9,7,316.9825047622489,0.48251790553619817,0.1526951058201056,0.16905733587319954,127645.42936288101,-307.72641582024414,127337.70294706077,105,0,15.738095238095237,37,5,13,39.360441984953674,0.5945945945945945,47.36842105263158,1010.5263157894747,27.31152204836418,0
3669,4,1,2,30,0.03125,0.0625,0.9375,32,950,700,250,0.7368421052631579,12,7,5,397.9372758934991,0.47943968413978494,0.16434016733508483,0.20422174889892777,126078.70611496913,3634.2833719135742,129712.9894868827,106,0,20.21875,29,3,22,38.932345687548946,0.5973419540229885,48.92361111111111,1004.3055555555555,34.63122605363985,0
3670,4,0,0,30,0.0,0.0,1.0,30,850,600,250,0.7058823529411765,11,6,5,420.0159575833329,0.47804118773946364,0.14948237202423464,0.21499278356298526,125971.70871730089,4582.025573061173,130553.73429036206,107,1,20.833333333333332,28,2,22,38.48903916797861,0.5993303571428572,49.0301724137931,1003.8793103448281,35.85283251231529,0
3671,4,1,2,29,0.03225806451612903,0.06451612903225806,0.935483870967742,31,1000,800,200,0.8,12,8,4,416.68662196062854,0.4788082437275986,0.038264985924079786,0.20765075703799754,124861.14969135808,4488.181829024832,129349.33152038291,108,0,21.129032258064516,29,2,16,39.72751065406709,0.5847701149425287,50.13888888888889,999.4444444444448,34.46360153256706,16
3672,4,5,6,28,0.14705882352941177,0.17647058823529413,0.8235294117647058,34,900,500,400,0.5555555555555556,13,5,8,376.65902601750827,0.4764928698752228,0.054812508072269894,0.1937171076092556,126166.92648260288,2704.3823289119573,128871.30881151484,109,0,19.647058823529413,33,1,18,39.37545742864111,0.5877525252525253,48.83578431372549,1004.6568627450984,30.444147355912072,0
3673,4,2,1,29,0.06666666666666667,0.03333333333333333,0.9666666666666667,30,800,400,400,0.5,12,4,8,411.549012035529,0.4766283524904214,0.0991698948533477,0.2106711231581307,125974.11265432113,4368.90432098767,130343.0169753088,110,0,22.133333333333333,29,1,20,38.699040767386094,0.5962643678160919,49.027777777777786,1003.8888888888899,34.61685823754793,0
3674,4,0,0,29,0.0,0.0,1.0,29,950,600,350,0.631578947368421,13,6,7,421.7386768438613,0.4757286535303777,0.08441292449524518,0.21587458865260523,125971.70871730096,4825.428350838975,130797.13706813994,111,1,22.93103448275862,28,1,20,38.445804112399244,0.5993303571428572,49.03017241379312,1003.8793103448287,35.85283251231531,0
3675,4,4,3,30,0.12121212121212122,0.09090909090909091,0.9090909090909091,33,950,700,250,0.7368421052631579,12,7,5,383.5446042645838,0.48003472222222227,0.07607855644557837,0.1873730429930672,124027.43678821245,3084.9899080127666,127112.42669622521,112,0,21.03030303030303,30,3,19,41.42322223721495,0.5732638888888889,50.97446236559139,996.1021505376339,33.20340501792113,15
3676,4,7,6,31,0.1891891891891892,0.16216216216216217,0.8378378378378378,37,1000,600,400,0.6,14,6,8,333.7527613496046,0.4796984484484485,0.05778346925479072,0.16941121177366006,125625.78125000003,985.5902777777787,126611.37152777781,113,0,17.675675675675677,34,3,20,41.01032141867552,0.5799632352941176,49.375,1002.5000000000002,29.485294117647065,0
3677,4,1,3,29,0.03125,0.09375,0.90625,32,1350,1000,350,0.7407407407407407,17,10,7,378.85283449711454,0.477570564516129,0.0857025065963064,0.1755320590151666,121765.9844292534,2910.3054470486013,124676.28987630199,114,0,20.5625,31,1,19,43.90721196130166,0.5470430107526882,53.25520833333333,986.979166666666,31.83803763440858,16
3678,4,7,3,33,0.19444444444444445,0.08333333333333333,0.9166666666666666,36,1300,1000,300,0.7692307692307693,16,10,6,352.1895127101702,0.48331679894179896,0.15579541487257131,0.170499407477098,123643.7452444486,1509.206077460546,125152.95132190915,115,0,18.97222222222222,35,1,20,42.60311202917103,0.5574404761904762,51.359953703703695,994.5601851851841,28.41600529100526,0
3679,4,3,1,35,0.08333333333333333,0.027777777777777776,0.9722222222222222,36,1350,1100,250,0.8148148148148148,16,11,5,350.69828789649415,0.48353174603174603,0.1798653042266607,0.17199394392736955,124191.12761488349,1510.7231652949345,125701.85078017843,116,0,19.833333333333332,35,1,17,42.07114104350519,0.5630952380952381,50.81018518518519,996.7592592592599,28.478835978836,0
3680,4,4,2,37,0.10256410256410256,0.05128205128205128,0.9487179487179487,39,900,600,300,0.6666666666666666,12,6,6,333.5778667425848,0.48585807467386416,0.18898352601927737,0.16713701462354572,125086.82062596471,553.1157568158684,125639.93638278058,117,0,19.128205128205128,35,4,22,41.57085213467548,0.5723214285714286,49.91319444444446,1000.3472222222239,28.581349206349255,0
3681,4,4,4,37,0.0975609756097561,0.0975609756097561,0.9024390243902439,41,950,400,550,0.42105263157894735,15,4,11,316.5499373110365,0.48490853658536587,0.18751898793341137,0.1616831735270565,125882.96402449063,-230.35112590399387,125652.61289858664,118,0,18.926829268292682,38,3,18,41.176940274672624,0.5748355263157895,49.11858974358975,1003.5256410256424,26.408569500674798,0
3682,4,4,5,36,0.0975609756097561,0.12195121951219512,0.8780487804878049,41,950,600,350,0.631578947368421,13,6,7,336.27817856821383,0.4825457317073171,0.22511740645356815,0.17464769919187864,126567.38281249985,312.47252013476646,126879.85533263462,119,0,19.585365853658537,37,4,15,39.97800207039338,0.5836148648648649,48.43749999999999,1006.2499999999989,27.195945945945915,0
3683,4,3,6,33,0.07692307692307693,0.15384615384615385,0.8461538461538461,39,1000,700,300,0.7,13,7,6,343.99247328460825,0.4813034188034188,0.2123476344604367,0.1787160896087943,126581.54776398021,908.6199375050707,127490.16770148528,120,0,20.615384615384617,36,3,16,39.76937854371828,0.5856481481481481,48.42342342342342,1006.3063063063065,27.95295295295296,0
3684,4,3,0,36,0.08333333333333333,0.0,1.0,36,1200,1000,200,0.8333333333333334,14,10,4,360.9846270165413,0.4790674603174603,0.20582764830369182,0.18754782127663353,126582.35721371903,1938.857001133808,128521.21421485284,121,0,21.166666666666668,34,2,20,39.34106234472967,0.5897671568627452,48.42261904761906,1006.3095238095256,29.59733893557428,0
3685,4,2,1,37,0.05263157894736842,0.02631578947368421,0.9736842105263158,38,1450,1200,250,0.8275862068965517,17,12,5,344.4992892697972,0.4770477714556662,0.19265041474988154,0.18202089720327855,127267.13204089525,1169.7112583459475,128436.8432992412,122,0,21.0,35,3,22,39.05282174810735,0.5946428571428571,47.743055555555564,1009.0277777777793,28.82936507936512,0
3686,4,1,2,36,0.02631578947368421,0.05263157894736842,0.9473684210526316,38,1450,1100,350,0.7586206896551724,18,11,7,346.33397554585963,0.4754326695116169,0.20266685157159148,0.18445084030139172,127588.49511584803,1237.6461494770374,128826.14126532506,123,0,21.842105263157894,35,3,21,38.67723011417879,0.5979166666666667,47.424768518518526,1010.3009259259269,28.86574074074077,0
3687,4,1,0,37,0.02702702702702703,0.0,1.0,37,850,500,350,0.5882352941176471,12,5,7,350.3582544706324,0.47500625625625625,0.19562773498833952,0.18632397847441876,127530.03532503879,1536.2401138117505,129066.27543885054,124,0,22.81081081081081,35,2,22,38.63548470264696,0.5973214285714286,47.4826388888889,1010.0694444444462,28.859126984127034,0
3688,4,1,1,37,0.02631578947368421,0.02631578947368421,0.9736842105263158,38,1200,700,500,0.5833333333333334,17,7,10,366.9520884647566,0.47401019440493125,0.20617958133257996,0.18152762606353867,124553.97002551006,1661.209185641832,126215.17921115189,125,0,23.18421052631579,34,4,15,41.289008149473254,0.5689338235294117,50.44642857142856,998.2142857142845,29.359243697478956,16
3689,4,6,6,37,0.13953488372093023,0.13953488372093023,0.8604651162790697,43,1350,1000,350,0.7407407407407407,17,10,7,339.41261638078424,0.47796696197858984,0.23924809677755787,0.1743986485090203,126128.66244622988,-19.555522324596893,126109.10692390529,126,0,21.11627906976744,36,7,17,40.350336322869964,0.5810185185185186,48.87387387387387,1004.5045045045034,27.902902902902873,0
3690,4,1,2,36,0.02631578947368421,0.05263157894736842,0.9473684210526316,38,1450,1200,250,0.8275862068965517,17,12,5,418.4026551797187,0.4745436225699384,0.272003538257408,0.19915966386554626,122925.34722222236,2795.1396497849387,125720.4868720073,127,0,24.42105263157895,32,6,19,41.71043417366946,0.556640625,52.08333333333334,991.6666666666679,30.98958333333337,14
3691,4,12,10,38,0.25,0.20833333333333334,0.7916666666666666,48,1400,900,500,0.6428571428571429,19,9,10,323.10088552049666,0.48187241430260047,0.2255602576386666,0.16502917986373167,125882.96402449052,-1426.3580703484524,124456.60595414207,128,0,18.3125,38,10,16,41.012589162142035,0.5748355263157895,49.118589743589745,1003.5256410256414,26.408569500674776,0
3692,4,5,2,41,0.11627906976744186,0.046511627906976744,0.9534883720930233,43,1450,1200,250,0.8275862068965517,17,12,5,344.2993416415597,0.4796050203026947,0.25809101635295106,0.17667331180585122,126073.72448979577,81.42006802719976,126155.14455782298,129,0,20.348837209302324,34,9,20,40.284198672356595,0.5845588235294117,48.92857142857142,1004.2857142857131,29.537815126050386,0
3693,4,5,3,43,0.10869565217391304,0.06521739130434782,0.9347826086956522,46,1300,900,400,0.6923076923076923,17,9,8,320.353432265272,0.4794585346215781,0.25696621509799766,0.16841908574494974,127064.37467538068,-1058.8982908202745,126005.4763845604,130,0,19.73913043478261,37,9,22,39.869381004168915,0.5886824324324325,47.94407894736841,1008.2236842105247,27.24928876244661,0
3694,4,1,2,42,0.022727272727272728,0.045454545454545456,0.9545454545454546,44,1600,1100,500,0.6875,21,11,10,336.5771821285251,0.4773277836504581,0.270649768238193,0.1765610904804334,126975.33543381338,-252.599879972572,126722.7355538408,131,0,21.545454545454547,35,9,24,39.551753177155106,0.5916666666666667,48.032407407407405,1007.8703703703698,28.79629629629628,0
3695,4,0,0,42,0.0,0.0,1.0,42,1300,900,400,0.6923076923076923,17,9,8,348.66357646473836,0.47658972125435545,0.26966747769667543,0.18231645028881346,126844.99351211068,445.2458189158046,127290.23933102649,132,1,23.023809523809526,33,9,24,39.38108272506087,0.5946969696969697,48.161764705882355,1007.3529411764703,30.52584670231728,0
3696,4,0,3,39,0.0,0.07142857142857142,0.9285714285714286,42,850,400,450,0.47058823529411764,13,4,9,351.6078794480603,0.47681958962446763,0.19644826825501993,0.1697378612926574,123524.11920013811,314.72014678987136,123838.83934692798,133,2,24.023809523809526,37,5,19,42.74211339069049,0.5523648648648649,51.48026315789472,994.0789473684179,26.866998577524807,16
3697,4,9,8,40,0.1875,0.16666666666666666,0.8333333333333334,48,1450,900,550,0.6206896551724138,20,9,11,297.91839975843874,0.48244496158392436,0.2126337458506551,0.1509735428075227,125557.791420663,-2109.2705569554823,123448.52086370751,134,0,20.5625,42,6,15,41.97827032775787,0.5652281746031746,49.44282945736435,1002.2286821705441,23.86258767072724,0
3698,4,5,4,41,0.1111111111111111,0.08888888888888889,0.9111111111111111,45,1400,1200,200,0.8571428571428571,16,12,4,309.8478227032719,0.4821127946127946,0.21354863514032996,0.1582085172460172,125869.56259645091,-1199.9180169752835,124669.64457947563,135,0,21.022222222222222,41,4,20,41.35885236447518,0.5698678861788617,49.13194444444446,1003.4722222222246,24.47493224932255,0
3699,4,1,0,42,0.023809523809523808,0.0,1.0,42,1350,700,650,0.5185185185185185,20,7,13,326.30293066473445,0.4836309523809524,0.2170298455982307,0.16612429029720868,125748.98184673823,-193.54773906056485,125555.43410767766,136,0,22.833333333333332,38,4,22,41.07016048856695,0.5734649122807017,49.25213675213675,1002.9914529914528,26.394511920827703,0
3700,4,1,2,41,0.023255813953488372,0.046511627906976744,0.9534883720930233,43,1000,700,300,0.7,13,7,6,317.06449483775964,0.4841500553709856,0.21375761946917637,0.16268327805911856,126069.98833550338,-605.536566840282,125464.4517686631,137,0,23.27906976744186,39,4,24,40.97182605538848,0.5750534188034189,48.932291666666664,1004.2708333333326,25.75053418803417,0
3701,4,3,5,39,0.06818181818181818,0.11363636363636363,0.8863636363636364,44,1800,1400,400,0.7777777777777778,22,14,8,336.6104279961156,0.48456219168428466,0.22978795162409016,0.1650961140694427,124194.01177300338,-154.70377604167118,124039.30799696171,138,0,22.681818181818183,39,5,13,42.41920524610723,0.5558226495726496,50.807291666666664,996.7708333333326,25.558226495726476,15
3702,4,4,2,41,0.09302325581395349,0.046511627906976744,0.9534883720930233,43,1350,900,450,0.6666666666666666,18,9,9,330.83403757233697,0.4848191214470284,0.29336989419768766,0.15221074707140753,121461.80194867622,-485.1271920807691,120976.67475659546,139,0,23.046511627906977,37,6,15,45.41064145346684,0.5309684684684685,53.563596491228054,985.7456140350853,26.6417733522996,16
3703,4,13,12,42,0.24074074074074073,0.2222222222222222,0.7777777777777778,54,1300,800,500,0.6153846153846154,18,8,10,290.91212877925847,0.49074802003261125,0.27206915017226896,0.14212175389540221,124028.16442350605,-2816.3770160976615,121211.7874074084,140,0,18.27777777777778,45,9,17,43.729255706101675,0.5456018518518518,50.97373188405797,996.1050724637678,22.135668276972616,16
3704,4,6,5,43,0.125,0.10416666666666667,0.8958333333333334,48,1400,1000,400,0.7142857142857143,18,10,8,317.9578974624941,0.4892693557919621,0.30755131341964903,0.15602046104100073,124213.63900662634,-1701.0585010575692,122512.58050556877,141,0,19.1875,40,8,16,42.86369660515854,0.5544270833333333,50.78760162601626,996.8495934959349,24.92123983739837,0
3705,4,3,7,39,0.06521739130434782,0.15217391304347827,0.8478260869565217,46,1700,1300,400,0.7647058823529411,21,13,8,323.2263745285401,0.48894927536231886,0.29040714924672506,0.15946917312166858,124441.68174532348,-1155.4332738449402,123286.24847147854,83,0,17.608695652173914,40,6,17,42.49635024105385,0.5567708333333333,50.55894308943089,997.7642276422758,24.944105691056897,0
3706,4,7,4,42,0.15217391304347827,0.08695652173913043,0.9130434782608696,46,1450,1200,250,0.8275862068965517,17,12,5,329.0280588029008,0.4873389694041868,0.3034530305697354,0.16585700107003365,125338.06610664718,-947.0532049284852,124391.0129017187,84,0,17.695652173913043,36,10,18,41.42534487929224,0.5729166666666667,49.66216216216216,1001.3513513513512,27.815315315315313,0
3707,4,4,4,42,0.08695652173913043,0.08695652173913043,0.9130434782608696,46,950,800,150,0.8421052631578947,11,8,3,330.0113622017423,0.4882246376811594,0.3077381533952124,0.16726088403163455,125563.69714308894,-912.5106525444503,124651.18649054448,85,0,18.5,36,10,20,41.16807116104866,0.5752314814814814,49.43693693693693,1002.2522522522515,27.84034034034032,0
3708,4,2,1,43,0.045454545454545456,0.022727272727272728,0.9772727272727273,44,1050,500,550,0.47619047619047616,16,5,11,336.52734065771966,0.4877224277660324,0.3042442958501359,0.17114654303580737,125704.81957886908,-339.37827185297124,125365.44130701611,86,0,18.818181818181817,36,8,23,40.859301890323785,0.5766782407407407,49.29617117117115,1002.8153153153127,27.855980980980906,0
3709,4,2,3,42,0.044444444444444446,0.06666666666666667,0.9333333333333333,45,1050,500,550,0.47619047619047616,16,5,11,322.83269390856594,0.48834175084175085,0.2882899485525614,0.16624160430095858,126218.23157793171,-849.612580626844,125368.61899730487,87,0,18.977777777777778,35,10,25,40.67467173462335,0.5839285714285714,48.7847222222222,1004.8611111111079,28.71031746031737,0
3710,4,2,3,41,0.045454545454545456,0.06818181818181818,0.9318181818181819,44,1300,600,700,0.46153846153846156,20,6,14,324.15982008528476,0.4873260218463707,0.2705076184599944,0.16823410841799258,126538.26845689704,-596.2755326217748,125941.99292427527,88,0,18.363636363636363,35,9,19,40.31272767360711,0.587202380952381,48.46643518518517,1006.1342592592572,28.746693121693063,0
3711,4,0,5,36,0.0,0.12195121951219512,0.8780487804878049,41,1300,1000,300,0.7692307692307693,16,10,6,371.6252733375016,0.4867123983739838,0.14723405170559656,0.18009532477125068,123687.6731301938,993.093067097557,124680.76619729135,89,1,20.390243902439025,37,4,16,42.074055702527914,0.5540540540540541,51.315789473684205,994.7368421052623,26.884779516358442,16
3712,4,1,0,37,0.02702702702702703,0.0,1.0,37,1300,800,500,0.6153846153846154,18,8,10,384.978973458959,0.4864552052052052,0.17687360766676474,0.18698659146678903,123782.73986678013,2130.750425170081,125913.4902919502,90,0,22.513513513513512,34,3,18,41.642740359692155,0.560968137254902,51.2202380952381,995.1190476190484,29.26820728291319,0
3713,4,4,4,37,0.0975609756097561,0.0975609756097561,0.9024390243902439,41,900,500,400,0.5555555555555556,13,5,8,388.12995639564576,0.4886686991869919,0.11923611686075897,0.18168735438290426,122209.04231234995,1397.602871363308,123606.64518371326,91,0,21.21951219512195,35,6,15,43.21240099106481,0.5425595238095238,52.80671296296296,988.773148148148,28.250661375661373,16
3714,4,4,3,38,0.0975609756097561,0.07317073170731707,0.926829268292683,41,1000,500,500,0.5,15,5,10,364.1996348428092,0.48910060975609754,0.12708090266904315,0.17279358416450466,122785.79413450601,901.0969306549905,123686.891065161,92,0,20.073170731707318,36,5,18,43.200109836003485,0.5465856481481481,52.22409909909909,991.1036036036026,27.530655655655625,16
3715,4,9,8,39,0.19148936170212766,0.1702127659574468,0.8297872340425532,47,950,500,450,0.5263157894736842,14,5,9,321.6064285571508,0.49090348442799875,0.16786631575609623,0.1593780750087502,124628.25299390561,-1383.6712714593662,123244.58172244625,93,0,17.4468085106383,41,6,17,42.34382762046695,0.5571646341463414,50.372023809523796,998.5119047619024,24.353948896631767,0
3716,4,10,9,40,0.20408163265306123,0.1836734693877551,0.8163265306122449,49,1000,500,500,0.5,15,5,10,300.32987140897797,0.49142573696145125,0.20499188017832548,0.15248348849457402,125635.96946468732,-2251.8922686873875,123384.07719599994,94,0,17.20408163265306,40,9,14,41.83751478290253,0.5690104166666667,49.364837398374,1002.5406504065065,25.063516260162665,0
3717,4,2,5,37,0.047619047619047616,0.11904761904761904,0.8809523809523809,42,700,400,300,0.5714285714285714,10,4,6,367.84727777455555,0.4901035617499032,0.20049257354809802,0.17520989590916752,122953.26735096569,678.790892662026,123632.05824362772,89,0,18.214285714285715,36,6,17,42.934597479277855,0.5483217592592593,52.05518018018017,991.7792792792781,27.54942442442439,16
3718,4,5,7,35,0.11904761904761904,0.16666666666666666,0.8333333333333334,42,1650,1100,550,0.6666666666666666,22,11,11,356.6973561346478,0.49052700348432055,0.22452952968712325,0.17308405398747548,123742.21515273924,427.70419744536196,124169.9193501846,90,0,18.0,37,5,18,42.38850929395341,0.5546171171171171,51.2609649122807,994.9561403508767,26.890706495969642,0
3719,4,4,3,36,0.10256410256410256,0.07692307692307693,0.9230769230769231,39,1400,1000,400,0.7142857142857143,18,10,8,392.2644108345562,0.48729194781826357,0.259073355409855,0.1887292331534567,123381.49877751338,2018.8717390318807,125400.37051654526,91,0,19.641025641025642,33,6,15,41.880859134081646,0.5590277777777778,51.623774509803916,993.5049019607836,30.106209150326777,16
3720,4,4,4,36,0.1,0.1,0.9,40,1850,1700,150,0.918918918918919,20,17,3,338.9249408912971,0.4872596153846154,0.22536784890743333,0.1680233770657075,124643.8943352764,448.984904008941,125092.87923928535,92,0,19.675,37,3,19,41.89531404414187,0.5639076576576576,50.356359649122815,998.5745614035102,26.98850165955433,16
3721,4,4,2,38,0.1,0.05,0.95,40,1650,1500,150,0.9090909090909091,18,15,3,364.8256587702951,0.48663194444444446,0.21192873303167392,0.17759134490800751,123876.4101939781,1168.9691192629539,125045.37931324105,93,0,17.425,36,4,18,42.04656862745099,0.5578703703703703,51.126126126126145,995.4954954954982,27.652652652652726,15
3722,4,9,8,39,0.19148936170212766,0.1702127659574468,0.8297872340425532,47,1250,900,350,0.72,16,9,7,324.8333874679775,0.4879548257786001,0.25362762486035395,0.1656601133365438,125819.79210955247,-1215.7608632919014,124604.03124626057,94,0,15.319148936170214,41,6,17,41.03412686640956,0.569359756097561,49.181547619047635,1003.2738095238121,24.47009291521493,0
3723,4,4,1,42,0.09302325581395349,0.023255813953488372,0.9767441860465116,43,1300,1000,300,0.7692307692307693,16,10,6,340.9721502344194,0.4844269102990033,0.2635897803418499,0.17509324598464945,126103.61571711986,0.36139455778322827,126103.97711167764,95,0,15.651162790697674,34,9,22,40.336958239500596,0.5848651960784313,48.898809523809504,1004.4047619047593,29.54131652661057,0
3724,4,1,5,38,0.023255813953488372,0.11627906976744186,0.8837209302325582,43,1400,1100,300,0.7857142857142857,17,11,6,337.879868038229,0.4829272794389074,0.2656347395257881,0.17535460852873527,126538.2684568969,-49.053310399566726,126489.21514649733,96,0,15.581395348837209,35,8,14,39.967622416503694,0.587202380952381,48.46643518518516,1006.134259259256,28.74669312169303,0
3725,4,1,5,34,0.02564102564102564,0.1282051282051282,0.8717948717948718,39,1350,1000,350,0.7407407407407407,17,10,7,346.72273145914653,0.4808535762483131,0.23221259976226882,0.18053493948390037,126672.22222222216,984.027777777769,127656.24999999993,97,0,15.58974358974359,34,5,17,39.607477924944796,0.5906862745098039,48.33333333333333,1006.6666666666661,29.607843137254886,0
3726,4,1,4,31,0.02857142857142857,0.11428571428571428,0.8857142857142857,35,1150,800,350,0.6956521739130435,15,8,7,374.1390093050258,0.4802871148459384,0.2151870153424762,0.1929177697278219,126272.75466918935,2448.7126668294122,128721.46733601876,98,0,15.714285714285714,31,4,19,39.32949540095868,0.59375,48.73046874999999,1005.0781249999992,32.42187499999997,0
3727,4,1,1,31,0.03125,0.03125,0.96875,32,1050,700,350,0.6666666666666666,14,7,7,384.95674275421857,0.4783686155913978,0.18475393963675213,0.20017750623219369,126618.10613943804,3348.4987426291973,129966.60488206723,65,0,13.3125,30,2,20,38.70108840811966,0.6,48.387096774193544,1006.4516129032254,33.54838709677418,0
3728,4,0,1,30,0.0,0.03225806451612903,0.967741935483871,31,1000,600,400,0.6,14,6,8,387.76288929110393,0.4771057347670251,0.1653317265273624,0.20281108550152283,126854.94936192033,3637.9283370909725,130492.8776990113,66,1,14.064516129032258,30,1,22,38.38614631976874,0.6024305555555556,48.1518817204301,1007.3924731182785,33.57974910394262,0
3729,4,3,3,30,0.09090909090909091,0.09090909090909091,0.9090909090909091,33,800,500,300,0.625,11,5,6,364.4235281482427,0.4779040404040404,0.14383588397509528,0.19390930942208928,127551.95617675758,2696.8080829148576,130248.76425967243,67,0,13.787878787878787,31,2,19,38.257819884850036,0.6068548387096775,47.460937499999986,1010.1562499999982,32.58568548387091,0
3730,4,2,1,31,0.0625,0.03125,0.96875,32,1000,500,500,0.5,15,5,10,368.4362873884706,0.4747353830645162,0.16018792888334388,0.1983221520093076,128016.72222541059,3033.2011720742703,131049.92339748486,68,0,14.65625,32,0,22,37.6798710750676,0.6090494791666667,47.00126262626262,1011.9949494949487,31.624842171717148,0
3731,4,1,2,30,0.03125,0.0625,0.9375,32,1000,500,500,0.5,15,5,10,406.6983312705999,0.4738113239247312,0.046272712524334736,0.20738654152481634,125815.12663099507,4120.019465083443,129935.14609607852,69,0,15.46875,31,1,17,38.98564243997404,0.5890456989247312,49.18619791666667,1003.2552083333339,32.36307123655916,15
3732,4,1,3,28,0.03225806451612903,0.0967741935483871,0.9032258064516129,31,1500,900,600,0.6,21,9,12,398.6699999174937,0.4729390681003584,0.06965174129353247,0.20546838457286226,126253.1250000001,3866.874355740032,130119.99935574013,70,0,16.548387096774192,29,2,19,38.73341625207297,0.5991379310344828,48.75000000000001,1005.0000000000008,34.65517241379313,0
3733,4,5,3,30,0.15151515151515152,0.09090909090909091,0.9090909090909091,33,1050,800,250,0.7619047619047619,13,8,5,366.42073284146574,0.469854797979798,0.08442126552362805,0.1950587014946487,127569.89282024806,2748.8507231405147,130318.74354338857,71,0,15.303030303030303,32,1,18,38.188976377952756,0.6044921875,47.44318181818183,1010.2272727272737,31.569602272727302,0
3734,4,0,2,28,0.0,0.06666666666666667,0.9333333333333333,30,1150,800,350,0.6956521739130435,15,8,7,415.5560378646883,0.4675766283524904,0.00571242195508348,0.20005975066514012,123407.8800154322,4503.686804917877,127911.56682035007,72,1,16.6,29,1,18,41.27469480943062,0.569683908045977,51.59722222222223,993.6111111111119,34.26245210727972,16
3735,4,5,2,31,0.15151515151515152,0.06060606060606061,0.9393939393939394,33,1350,900,450,0.6666666666666666,18,9,9,379.83867997319373,0.47028882575757575,0.056252462766791744,0.19006330916409778,125031.56764934705,2898.3651221814166,127929.93277152847,73,0,15.848484848484848,32,1,20,40.47126835837226,0.5784505208333333,49.968434343434346,1000.126262626263,31.25394570707072,0
3736,4,0,0,31,0.0,0.0,1.0,31,1250,1100,150,0.88,14,11,3,396.7003977239205,0.46769713261648743,0.07195929680282087,0.19787128490092554,124899.21387226859,3709.5135637068024,128608.7274359754,74,1,17.806451612903224,30,1,20,40.187295504459684,0.5822916666666667,50.10080645161291,999.5967741935494,33.319892473118315,0
3737,4,3,3,31,0.08823529411764706,0.08823529411764706,0.9117647058823529,34,1500,1300,200,0.8666666666666667,17,13,4,366.49949708193986,0.4712381164587047,0.08305152892354317,0.18778801623466765,126013.07377270766,2436.745632689355,128449.81940539702,75,0,17.147058823529413,33,1,21,39.78942898409212,0.5861742424242424,48.9889705882353,1004.0441176470592,30.425579322638157,0
3738,4,3,2,32,0.08823529411764706,0.058823529411764705,0.9411764705882353,34,1200,800,400,0.6666666666666666,16,8,8,352.01062217388824,0.4741161616161616,0.06429257295537072,0.18301954488671934,126612.3086734696,2113.7755102041024,128726.0841836737,76,0,16.970588235294116,34,0,20,39.5360184528034,0.5900735294117647,48.39285714285715,1006.4285714285732,29.600840336134503,0
3739,4,2,0,34,0.058823529411764705,0.0,1.0,34,650,400,250,0.6153846153846154,9,4,5,353.2295672937937,0.470068330362448,0.08539908518358885,0.1847360073201537,126852.04790249448,2161.578798185956,129013.62670068044,77,0,17.91176470588235,34,0,22,39.25884345702355,0.5925245098039216,48.15476190476191,1007.3809523809537,29.628851540616285,0
3740,4,2,2,34,0.05555555555555555,0.05555555555555555,0.9444444444444444,36,900,600,300,0.6666666666666666,12,6,6,338.80865987426574,0.4713955026455026,0.0963281720768161,0.17983573548520188,127452.38803854892,1436.848072562373,128889.23611111128,78,0,17.86111111111111,34,2,18,39.00662186591211,0.5986519607843137,47.55952380952382,1009.7619047619062,29.69887955182077,0
3741,4,2,4,32,0.05555555555555555,0.1111111111111111,0.8888888888888888,36,1350,1000,350,0.7407407407407407,17,10,7,385.91478041282835,0.46947751322751324,0.06463857708367216,0.19818029700899387,126105.37413494814,2860.3468348123597,128965.7209697605,79,0,18.194444444444443,33,3,18,39.206625183016094,0.5871212121212122,48.89705882352941,1004.4117647058828,30.436720142602507,16
3742,4,4,1,35,0.1111111111111111,0.027777777777777776,0.9722222222222222,36,1400,1200,200,0.8571428571428571,16,12,4,372.30179130083036,0.46858465608465605,0.1273727555015527,0.19616157121676248,127153.80652873879,2267.9179882737194,129421.72451701251,80,0,18.666666666666668,33,3,18,38.46800324017822,0.5978535353535354,47.855392156862735,1008.5784313725477,30.562982768865083,0
3743,4,3,2,36,0.07894736842105263,0.05263157894736842,0.9473684210526316,38,1400,1000,400,0.7142857142857143,18,10,8,349.8561228606569,0.468142484589853,0.12856729830986247,0.18754863813229566,127851.72994898826,1345.942108196151,129197.6720571844,81,0,18.42105263157895,35,3,17,38.318741893644614,0.6005952380952381,47.16435185185185,1011.3425925925919,28.895502645502628,0
3744,4,2,3,35,0.05263157894736842,0.07894736842105263,0.9210526315789473,38,1350,1000,350,0.7407407407407407,17,10,7,350.9168353548512,0.4671645329540066,0.1413549294758485,0.19032998616458266,128320.37278163564,1405.9558256172631,129726.3286072529,82,0,18.57894736842105,35,3,19,37.81271418779985,0.6053571428571429,46.70138888888888,1013.1944444444432,28.948412698412664,0
3745,4,2,2,35,0.05405405405405406,0.05405405405405406,0.9459459459459459,37,1200,800,400,0.6666666666666666,16,8,8,352.765122754516,0.4673736236236236,0.1346312897491233,0.19398670096539455,128868.76594387765,1692.0812074830048,130560.84715136065,83,0,18.513513513513512,34,3,18,37.20614960722242,0.6130514705882353,46.16071428571429,1015.3571428571436,29.863445378151283,0
3746,4,1,3,33,0.027777777777777776,0.08333333333333333,0.9166666666666666,36,850,500,350,0.5882352941176471,12,5,7,359.84444210910755,0.46793981481481484,0.13611345749031267,0.1981415874922376,128921.21006644092,2078.3161824779086,130999.52624891883,84,0,19.833333333333332,33,3,19,36.972944571819305,0.6158459595959596,46.10906862745099,1015.5637254901972,30.774658348187792,0
3747,4,1,3,31,0.029411764705882353,0.08823529411764706,0.9117647058823529,34,1150,900,250,0.782608695652174,14,9,5,365.9352056973566,0.467654486036839,0.10958112732910141,0.20161525990613272,128944.78242016125,2637.0870957045254,131581.86951586578,85,0,19.852941176470587,32,2,20,36.79424622907343,0.6184895833333333,46.08585858585859,1015.656565656566,31.73926767676769,0
3748,4,1,2,30,0.03125,0.0625,0.9375,32,750,300,450,0.4,12,3,9,410.10388349474147,0.46589381720430106,0.039994786761738066,0.20389981043588046,124764.89559847956,4002.4449803894017,128767.34057886896,86,0,18.40625,30,2,19,39.99226422709539,0.5809027777777778,50.23521505376344,999.0591397849461,33.30197132616487,16
3749,4,1,1,30,0.03225806451612903,0.03225806451612903,0.967741935483871,31,800,500,300,0.625,11,5,6,407.4729724215254,0.46644265232974913,0.04094609775880853,0.2032445671293685,124899.21387226846,3978.610785929009,128877.82465819747,87,0,19.35483870967742,30,1,20,39.91808973152257,0.5822916666666667,50.100806451612904,999.5967741935483,33.31989247311828,0
3750,4,6,6,30,0.16666666666666666,0.16666666666666666,0.8333333333333334,36,1150,700,450,0.6086956521739131,16,7,9,352.17955068161257,0.4736276455026455,0.028830340109203156,0.18190558443463076,126342.87308673446,1699.1159028647573,128041.98898959921,88,0,16.72222222222222,34,2,13,39.809058614564826,0.5873161764705883,48.66071428571427,1005.357142857141,29.569327731092383,0
3751,4,1,2,29,0.03225806451612903,0.06451612903225806,0.935483870967742,31,800,500,300,0.625,11,5,6,443.4605874243015,0.466084229390681,0.13498880414246717,0.21075807299237423,122858.71198982539,4696.599317840208,127555.3113076656,89,0,20.193548387096776,30,1,16,41.15939081706435,0.5611111111111111,52.1505376344086,991.3978494623655,33.04659498207885,14
3752,4,16,13,32,0.35555555555555557,0.28888888888888886,0.7111111111111111,45,1150,1000,150,0.8695652173913043,13,10,3,328.9412615359062,0.4811026936026936,0.15962127541074933,0.16203402883065005,124375.78124999999,383.2905176899055,124759.0717676899,90,0,14.511111111111111,39,6,12,42.42202729044834,0.5576923076923077,50.625,997.4999999999999,25.576923076923073,16
3753,4,7,4,35,0.1794871794871795,0.10256410256410256,0.8974358974358975,39,1100,700,400,0.6363636363636364,15,7,8,376.7268465522192,0.4748931623931624,0.2062343702144236,0.18616135231058933,124508.58577942809,1581.1453778720781,126089.73115730016,91,0,16.58974358974359,35,4,17,41.09225810816036,0.5663690476190476,50.491898148148145,998.0324074074069,28.51521164021163,0
3754,4,7,4,38,0.16666666666666666,0.09523809523809523,0.9047619047619048,42,1100,500,600,0.45454545454545453,17,5,12,351.1540265074723,0.4755250677506775,0.21847038772901572,0.17877624733471545,125748.98184673846,432.42011609207,126181.40196283053,92,0,16.071428571428573,38,4,15,40.447024570373536,0.5734649122807017,49.252136752136764,1002.9914529914547,26.394511920827757,0
3755,4,4,2,40,0.09523809523809523,0.047619047619047616,0.9523809523809523,42,1100,800,300,0.7272727272727273,14,8,6,352.69463911833566,0.4761178861788618,0.2388427898631973,0.18097415372021433,126072.10884871389,493.6819502481599,126565.79079896206,93,0,16.976190476190474,36,6,19,40.075082230694456,0.5804398148148149,48.930180180180194,1004.2792792792818,27.896646646646715,0
3756,4,1,4,37,0.024390243902439025,0.0975609756097561,0.9024390243902439,41,850,400,450,0.47058823529411764,13,4,9,350.58602718763194,0.47550813008130083,0.22603151626104956,0.18073518139492886,126264.14497730075,653.288992767013,126917.43397006777,94,0,18.048780487804876,37,4,21,39.930176740126576,0.5805180180180181,48.7390350877193,1005.0438596491231,27.163347558084407,0
3757,4,2,4,35,0.05128205128205128,0.10256410256410256,0.8974358974358975,39,1200,600,600,0.5,18,6,12,367.3779711370576,0.4748369320737742,0.22634775401369245,0.1906636837668327,126538.26845689748,1497.4744673782836,128035.74292427576,95,0,18.512820512820515,35,4,20,39.22564611373135,0.587202380952381,48.4664351851852,1006.1342592592608,28.746693121693166,0
3758,4,0,0,35,0.0,0.0,1.0,35,1300,1000,300,0.7692307692307693,16,10,6,392.0125755415209,0.4717086834733894,0.2143949068162052,0.20213393925217102,126272.75466918947,2900.1015557183164,129172.85622490778,96,1,20.17142857142857,31,4,20,38.88038713995769,0.59375,48.73046875,1005.0781250000001,32.42187500000001,0
3759,4,2,3,34,0.05405405405405406,0.08108108108108109,0.9189189189189189,37,1050,600,450,0.5714285714285714,15,6,9,371.05008268585857,0.4728478478478479,0.21159615542594268,0.1947598551430238,126999.35308835533,2024.624092896948,129023.97718125228,97,0,20.027027027027028,33,4,22,38.65843465045593,0.5962752525252526,48.00857843137254,1007.9656862745089,30.54441473559118,0
3760,4,1,0,35,0.02857142857142857,0.0,1.0,35,1100,700,400,0.6363636363636364,15,7,8,370.90564839975104,0.47079831932773114,0.18654176424668245,0.19617264062761391,127308.35383326115,2443.8775050461245,129752.23133830728,58,0,18.6,33,2,23,38.34433819064968,0.5994318181818181,47.702205882352935,1009.1911764705874,30.581550802139013,0
3761,4,2,1,36,0.05405405405405406,0.02702702702702703,0.972972972972973,37,1150,500,650,0.43478260869565216,18,5,13,359.69398461317684,0.47128378378378377,0.20325733301610827,0.1940927380266164,128115.23604948961,1816.455948859707,129931.69199834931,59,0,18.54054054054054,35,2,21,37.80022198086964,0.6032738095238095,46.90393518518517,1012.3842592592571,28.925264550264487,0
3762,4,3,4,35,0.07692307692307693,0.10256410256410256,0.8974358974358975,39,1000,600,400,0.6,14,6,8,339.13311209422335,0.47154745838956363,0.19531345847135362,0.18722707282786716,129024.9445408949,951.3328939471699,129976.27743484206,60,0,18.17948717948718,35,4,19,37.3931989063568,0.6125,46.006944444444436,1015.9722222222208,29.027777777777736,0
3763,4,0,1,34,0.0,0.02857142857142857,0.9714285714285714,35,1350,1100,250,0.8148148148148148,16,11,5,372.79377568218274,0.4689425770308124,0.20688238315356955,0.20331358018297183,128540.34423828116,2583.808051215262,131124.15228949641,61,1,19.571428571428573,31,4,19,37.03347029618216,0.6169354838709677,46.48437499999999,1014.0624999999993,32.711693548387075,0
3764,4,1,1,34,0.02857142857142857,0.02857142857142857,0.9714285714285714,35,850,500,350,0.5882352941176471,12,5,7,374.09533339285514,0.46771708683473384,0.21218729955099414,0.2052127462207816,128771.51701185445,2634.564717610686,131406.08172946514,62,0,20.314285714285713,31,4,21,36.764084883472314,0.6192876344086021,46.25651041666667,1014.9739583333339,32.74109543010755,0
3765,4,0,0,34,0.0,0.0,1.0,34,1650,1300,350,0.7878787878787878,20,13,7,384.35963334941454,0.46769162210338683,0.21714063108687198,0.21058891377272002,128723.56088854224,3095.2281333102396,131818.78902185248,63,1,21.558823529411764,30,4,21,36.55270419426047,0.6215277777777778,46.30376344086023,1014.7849462365608,33.82616487455203,0
3766,4,0,2,32,0.0,0.058823529411764705,0.9411764705882353,34,1150,900,250,0.782608695652174,14,9,5,385.16988428188785,0.4672831253713607,0.21365206764932188,0.21181627345769846,128870.65463595935,3127.419026692732,131998.07366265208,64,2,22.558823529411764,31,3,22,36.38165769000599,0.6202956989247312,46.15885416666668,1015.3645833333346,32.75369623655918,0
3767,4,0,1,31,0.0,0.03125,0.96875,32,1100,900,200,0.8181818181818182,13,9,4,396.5425443746119,0.4653057795698925,0.1912496579559444,0.21775578188084463,128813.3704668212,3815.996334876573,132629.36680169776,65,3,22.25,29,3,22,36.15163383043736,0.6253591954022988,46.21527777777779,1015.1388888888906,35.00478927203071,0
3768,4,1,0,32,0.03125,0.0,1.0,32,900,600,300,0.6666666666666666,12,6,6,395.37041092580637,0.4646967405913978,0.16044676297485294,0.2035667487659316,126212.6040582726,3588.2525004897784,129800.85655876237,66,0,22.40625,30,2,21,38.85823524166223,0.5958333333333333,48.79032258064516,1004.838709677419,33.49462365591397,15
3769,4,3,1,34,0.08571428571428572,0.02857142857142857,0.9714285714285714,35,1400,1000,400,0.7142857142857143,18,10,8,371.0358584089971,0.4640756302521008,0.1747854281899679,0.19684252655709766,127432.05925905901,2456.3726992022275,129888.43195826124,67,0,21.4,33,2,17,38.2139569931626,0.6006944444444444,47.5796568627451,1009.6813725490194,30.596405228758165,0
3770,4,1,1,34,0.02857142857142857,0.02857142857142857,0.9714285714285714,35,1000,500,500,0.5,15,5,10,363.1053233705414,0.46404061624649856,0.1695588948133786,0.1945678654840072,127834.51677239542,2283.478710111521,130117.99548250694,68,0,21.885714285714286,33,2,19,38.00139360155116,0.6047979797979798,47.18137254901962,1011.2745098039231,30.6446821152704,0
3771,4,1,3,32,0.02857142857142857,0.08571428571428572,0.9142857142857143,35,1000,500,500,0.5,15,5,10,381.91110942919966,0.4643557422969187,0.09624171224565203,0.18587561065868122,123868.99156874769,2508.4860690599917,126377.47763780768,69,0,21.485714285714284,33,2,15,41.62909331527763,0.5640782828282829,51.133578431372555,995.4656862745105,30.16562685680335,15
3772,4,4,0,36,0.1111111111111111,0.0,1.0,36,850,500,350,0.5882352941176471,12,5,7,367.75631824664407,0.4682539682539682,0.13897134611420325,0.17418335284265488,122712.76559796711,1844.6057405805434,124557.37133854766,70,0,21.444444444444443,33,3,17,43.1883889919604,0.5520833333333333,52.29779411764706,990.8088235294117,30.024509803921568,15
3773,4,10,5,41,0.21739130434782608,0.10869565217391304,0.8913043478260869,46,950,800,150,0.8421052631578947,11,8,3,341.89893431057953,0.47788848631239933,0.16178560454754987,0.16399559052524404,123251.76977531548,-4.013795734061375,123247.75597958142,71,0,17.565217391304348,37,9,14,43.26689487632511,0.5495495495495495,51.75438596491228,992.9824561403508,26.83736367946894,16
3774,4,4,4,41,0.08888888888888889,0.08888888888888889,0.9111111111111111,45,1300,900,400,0.6923076923076923,17,9,8,340.6472300896129,0.4767887205387205,0.17571013853672968,0.16497656295477156,123660.40662751971,-575.0850021160632,123085.32162540365,72,0,18.444444444444443,37,8,16,42.87277679785399,0.5537725225225225,51.34320175438595,994.6271929824537,26.881816026552805,0
3775,4,8,7,42,0.16326530612244897,0.14285714285714285,0.8571428571428572,49,1450,1100,350,0.7586206896551724,18,11,7,312.87320273111305,0.48379039115646255,0.19267183479260108,0.15718450543582999,125198.49143361038,-1951.3158739886217,123247.17555962176,73,0,16.020408163265305,41,8,14,41.973549431667976,0.5630081300813008,49.8015873015873,1000.7936507936499,24.40960123886951,0
3776,4,4,8,38,0.08695652173913043,0.17391304347826086,0.8260869565217391,46,1200,800,400,0.6666666666666666,16,8,8,331.2870955580438,0.48194444444444445,0.21214328801447757,0.1667110679580488,125267.23669552182,-900.1161973117249,124367.12049821009,74,0,17.73913043478261,38,8,14,41.441880113838494,0.5685307017543859,49.732905982905976,1001.068376068375,26.343904633378287,0
3777,4,6,4,40,0.13636363636363635,0.09090909090909091,0.9090909090909091,44,1650,1200,450,0.7272727272727273,21,12,9,341.1573272126136,0.4832408386187456,0.198379179875243,0.17173774852322388,125281.690051538,-251.84669466764632,125029.84335687035,75,0,18.681818181818183,36,8,17,41.17993063367077,0.572337962962963,49.718468468468465,1001.1261261261259,27.809059059059052,0
3778,4,6,5,41,0.13043478260869565,0.10869565217391304,0.8913043478260869,46,1700,1100,600,0.6470588235294118,23,11,12,333.4027944429769,0.4830314009661836,0.21191545868015216,0.17073493511611176,125990.20113092616,-798.9029741033112,125191.29815682284,76,0,18.630434782608695,38,8,20,40.64373381575681,0.5759320175438596,49.01175213675213,1003.9529914529904,26.41981556455238,0
3779,4,2,2,41,0.046511627906976744,0.046511627906976744,0.9534883720930233,43,950,600,350,0.631578947368421,13,6,7,348.1675093528276,0.48271963824289404,0.22726727228138688,0.17816103205345005,125959.03969848204,170.9690264588674,126130.00872494091,77,0,20.46511627906977,36,7,22,40.30527821404532,0.5792824074074074,49.04279279279278,1003.828828828827,27.884134134134083,0
3780,4,0,1,40,0.0,0.024390243902439025,0.975609756097561,41,1100,700,400,0.6363636363636364,15,7,8,347.69583658133433,0.4826219512195122,0.20980643184628356,0.17816414246891785,126015.56793279738,563.0176629331702,126578.58559573055,78,1,21.463414634146343,36,5,23,40.258851129056374,0.5798611111111112,48.98648648648647,1004.0540540540517,27.890390390390323,0
3781,4,6,7,39,0.13043478260869565,0.15217391304347827,0.8478260869565217,46,1050,700,350,0.6666666666666666,14,7,7,314.15061071663166,0.48393719806763286,0.22602947600763335,0.16715216794179819,127550.26989051438,-1176.8416773895726,126373.4282131248,79,0,19.434782608695652,38,8,16,39.529129208531636,0.5918311403508771,47.46260683760684,1010.1495726495734,26.582883490778247,0
3782,4,1,0,40,0.025,0.0,1.0,40,1450,1200,250,0.8275862068965517,17,12,5,359.04616414360896,0.4811698717948718,0.24218860789411534,0.1877780371435859,126852.0479024943,1109.148242630387,127961.19614512469,80,0,21.525,34,6,23,39.112355235169005,0.5925245098039216,48.154761904761905,1007.3809523809522,29.62885154061624,0
3783,4,0,4,36,0.0,0.1,0.9,40,1150,800,350,0.6956521739130435,15,8,7,356.070546633642,0.4810363247863248,0.23791769984649913,0.18718568959902615,127062.00573979587,1048.6075680272077,128110.61330782308,81,1,22.525,34,6,23,38.97154327547527,0.5946691176470589,47.94642857142857,1008.2142857142853,29.653361344537803,0
3784,4,2,2,36,0.05263157894736842,0.05263157894736842,0.9473684210526316,38,1200,700,500,0.5833333333333334,17,7,10,358.62567262779606,0.48048541963015645,0.21555499937429645,0.18941029411557914,127251.20722694091,1527.1134999760325,128778.32072691695,82,0,22.526315789473685,32,6,25,38.71282275893714,0.6012369791666667,47.75883838383837,1008.9646464646447,31.530145202020147,0
3785,4,0,0,36,0.0,0.0,1.0,36,1300,1100,200,0.8461538461538461,15,11,4,366.22584807492217,0.4795634920634921,0.1882795698924733,0.19360506975311345,127289.0302870007,2123.3066134982437,129412.33690049895,69,1,21.583333333333332,31,5,25,38.482258064516124,0.6041666666666667,47.72135416666666,1009.114583333332,32.55208333333329,0
3786,4,0,2,34,0.0,0.05555555555555555,0.9444444444444444,36,1350,1000,350,0.7407407407407407,17,10,7,357.4386742604907,0.4786871693121693,0.09030581039755403,0.18070879171796603,125459.98121215394,1771.7151329454093,127231.69634509935,70,2,22.583333333333332,33,3,17,40.58804791029562,0.5804924242424243,49.54044117647059,1001.8382352941173,30.35873440285204,16
3787,4,3,2,35,0.08108108108108109,0.05405405405405406,0.9459459459459459,37,1050,800,250,0.7619047619047619,13,8,5,359.11382826806596,0.4793230730730731,0.12902824591733952,0.18624208802541942,126509.15745027439,1686.237568587113,128195.3950188615,71,0,21.64864864864865,35,2,17,39.46349133302654,0.5869047619047619,48.495370370370374,1006.0185185185189,28.743386243386254,0
3788,4,4,3,36,0.10256410256410256,0.07692307692307693,0.9230769230769231,39,1150,900,250,0.782608695652174,14,9,5,342.6717519781352,0.4800101214574899,0.134440629064285,0.18163378356146756,127396.24361582415,931.0187990535586,128327.26241487771,72,0,19.897435897435898,37,2,16,38.966615075486025,0.5920608108108107,47.61513157894737,1009.5394736842109,27.284850640113806,0
3789,4,1,2,35,0.02702702702702703,0.05405405405405406,0.9459459459459459,37,1150,800,350,0.6956521739130435,15,8,7,358.2129977394885,0.47897897897897895,0.13355990226114134,0.1889942184199385,127208.7459276407,1713.5652434842355,128922.31117112494,73,0,21.405405405405407,35,2,22,38.766827290806184,0.594047619047619,47.80092592592593,1008.7962962962971,28.822751322751344,0
3790,4,1,0,36,0.027777777777777776,0.0,1.0,36,1100,800,300,0.7272727272727273,14,8,6,358.3720098613321,0.4785714285714286,0.13224056243313442,0.1901725920942981,127442.37075617281,1934.3557098765405,129376.72646604935,74,0,21.805555555555557,35,1,19,38.523039889958724,0.5964285714285714,47.56944444444444,1009.7222222222221,28.849206349206344,0
3791,4,2,0,38,0.05263157894736842,0.0,1.0,38,1150,700,450,0.6086956521739131,16,7,9,354.1657970707697,0.47646989094357517,0.1696422886395761,0.19184367487463855,128268.64216887743,1493.3892279678862,129762.03139684531,75,0,21.605263157894736,33,5,21,37.78328897491735,0.6092171717171717,46.75245098039216,1012.990196078432,30.696672608437332,0
3792,4,0,1,37,0.0,0.02631578947368421,0.9736842105263158,38,1300,1100,200,0.8461538461538461,15,11,4,378.8483673635038,0.4761587245139877,0.07192330949225179,0.1864383998612971,124335.3765458891,1989.7312405032683,126325.10778639237,76,1,22.605263157894736,35,3,18,41.21951278480521,0.5645833333333333,50.66550925925926,997.3379629629633,28.49537037037038,15
3793,4,3,1,39,0.075,0.025,0.975,40,1050,300,750,0.2857142857142857,18,3,15,367.02818135496165,0.4781784188034188,0.10874985124360403,0.18390803863600144,125089.30165816333,1187.5746098014954,126276.87626796482,77,0,22.3,34,6,21,40.731732714506734,0.5744485294117647,49.91071428571429,1000.3571428571433,29.42226890756304,0
3794,4,3,2,40,0.07142857142857142,0.047619047619047616,0.9523809523809523,42,1100,500,600,0.45454545454545453,17,5,12,345.8549429881916,0.4791424699961286,0.12957164138266553,0.17722708583440694,126017.01754145657,316.7216834684742,126333.73922492506,78,0,21.88095238095238,38,4,21,40.30356636163725,0.5762061403508771,48.98504273504273,1004.0598290598284,26.4226270805218,0
3795,4,1,4,37,0.024390243902439025,0.0975609756097561,0.9024390243902439,41,1450,1200,250,0.8275862068965517,17,12,5,346.4253835178734,0.4798018292682927,0.039184237740750305,0.1637498947837232,122626.5067737189,318.5617587772781,122945.06853249617,79,0,22.585365853658537,37,4,17,43.8068517288461,0.5430743243243243,52.38486842105264,990.4605263157899,26.769203413940268,16
3796,4,5,4,38,0.11904761904761904,0.09523809523809523,0.9047619047619048,42,1200,900,300,0.75,15,9,6,350.14057352003437,0.4845988192024777,0.1187714776632307,0.16981817815721653,123721.23602892822,264.32860159178654,123985.56463052,80,0,21.642857142857142,38,4,17,42.57342676116838,0.5526315789473684,51.28205128205128,994.8717948717939,26.18083670715247,0
3797,4,4,2,40,0.09523809523809523,0.047619047619047616,0.9523809523809523,42,1000,500,500,0.5,15,5,10,354.5478837720404,0.4841511807975223,0.16423761695175743,0.175022217164571,124465.6623473135,426.26971561157325,124891.93206292507,81,0,22.38095238095238,36,6,16,41.69017793326559,0.5639467592592593,50.534909909909906,997.8603603603601,27.718343343343335,0
3798,4,3,9,34,0.06976744186046512,0.20930232558139536,0.7906976744186046,43,1000,500,500,0.5,15,5,10,336.44270410498564,0.48546511627906974,0.17613720268253985,0.16978274360745527,125384.06649161283,-161.94460912960722,125222.12188248322,82,0,22.046511627906977,37,6,14,41.1922487409678,0.571509009009009,49.61622807017544,1001.5350877192985,27.068515884305366,0
3799,4,2,0,36,0.05555555555555555,0.0,1.0,36,1150,700,450,0.6086956521739131,16,7,9,380.45706407702994,0.4795634920634921,0.19751880331106308,0.19211749772903144,125410.69031540172,2342.6766082542863,127753.36692365601,83,0,24.0,32,4,17,40.062607672591284,0.5823567708333333,49.58964646464648,1001.641414141416,31.30129419191925,0
3800,4,2,1,37,0.05263157894736842,0.02631578947368421,0.9736842105263158,38,850,500,350,0.5882352941176471,12,5,7,364.069774402385,0.4800408961593172,0.2011884550084888,0.18627647680588053,125954.19501133794,1571.2230725623651,127525.41808390031,84,0,23.68421052631579,34,4,19,39.91120137571158,0.5833333333333333,49.04761904761905,1003.8095238095243,29.52380952380954,0
3801,4,3,3,37,0.075,0.075,0.925,40,900,200,700,0.2222222222222222,16,2,14,374.60084736013073,0.4799412393162393,0.08966416353775508,0.18590439567748174,124687.69531250058,1346.739477040875,126034.43478954145,85,0,22.825,39,1,16,40.959185092476716,0.5608974358974359,50.31250000000003,998.7500000000048,25.608974358974482,16
3802,4,7,6,38,0.1590909090909091,0.13636363636363635,0.8636363636363636,44,1050,800,250,0.7619047619047619,13,8,5,339.2830796019177,0.4819194855532065,0.13014312915658643,0.1741888143223771,126094.86669847669,-235.51274146503977,125859.35395701166,86,0,21.318181818181817,40,4,16,40.38837734830854,0.5736979166666667,48.907520325203265,1004.3699186991892,25.109247967479728,0
3803,4,5,5,38,0.11627906976744186,0.11627906976744186,0.8837209302325582,43,1350,1000,350,0.7407407407407407,17,10,7,350.13925983530606,0.4810585086747878,0.16503628600892428,0.18091778029605876,126357.83420138898,248.56770833333997,126606.40190972232,87,0,22.58139534883721,39,4,16,39.84493714601463,0.5779914529914529,48.645833333333336,1005.4166666666674,25.77991452991455,0
3804,4,3,2,39,0.07317073170731707,0.04878048780487805,0.9512195121951219,41,850,600,250,0.7058823529411765,11,6,5,359.5674817976568,0.48102134146341463,0.17624987376320322,0.18680452901556138,126580.82133693104,902.869434399875,127483.69077133092,88,0,23.78048780487805,38,3,19,39.378295643557344,0.5819627192982456,48.424145299145295,1006.3034188034183,26.48166891587943,0
3805,4,1,2,38,0.025,0.05,0.95,40,1250,900,350,0.72,16,9,7,364.78578660933096,0.48178418803418804,0.1634180176259381,0.191257624913084,126953.84787867423,1262.1918523007073,128216.03973097494,89,0,23.85,37,3,21,38.86308617125449,0.5875563063063063,48.05372807017544,1007.7850877192985,27.237434803224286,0
3806,4,1,1,38,0.02564102564102564,0.02564102564102564,0.9743589743589743,39,800,700,100,0.875,9,7,2,367.21085449537645,0.482399910031489,0.16504996176614584,0.19304984029930153,127063.62771132623,1531.8286614317014,128595.45637275794,90,0,25.128205128205128,36,3,23,38.68908001042481,0.5905671296296297,47.94481981981982,1008.220720720721,28.00613113113114,0
3807,4,1,2,37,0.02564102564102564,0.05128205128205128,0.9487179487179487,39,950,700,250,0.7368421052631579,12,7,5,358.9732246704191,0.4821749887539361,0.15117462986315489,0.18986156102510587,127308.35383326112,1340.0675718020682,128648.42140506319,91,0,25.307692307692307,33,6,24,38.64539060918843,0.5994318181818181,47.702205882352935,1009.1911764705872,30.581550802139006,0
3808,4,1,2,36,0.02631578947368421,0.05263157894736842,0.9473684210526316,38,1250,600,650,0.48,19,6,13,364.2904249228808,0.4812559269796112,0.14494448064808818,0.1931161210112412,127401.12727076108,1682.2021578238964,129083.32942858497,92,0,26.526315789473685,33,5,17,38.41597879744276,0.6003787878787878,47.61029411764705,1009.5588235294103,30.592691622103345,0
3809,4,3,5,34,0.07692307692307693,0.1282051282051282,0.8717948717948718,39,900,700,200,0.7777777777777778,11,7,4,354.1655455424043,0.4825123706702654,0.08240452465526471,0.1767338411992393,124917.77668369122,1048.3145054247548,125966.09118911598,93,0,25.512820512820515,37,2,20,41.23101074914994,0.566722972972973,50.08223684210527,999.6710526315796,27.018136557610262,15
3810,4,5,2,37,0.1282051282051282,0.05128205128205128,0.9487179487179487,39,1000,700,300,0.7,13,7,6,336.9229287098149,0.4837494376968061,0.1348135822078793,0.17218624045119674,125906.24188452198,684.1399517158925,126590.38183623787,94,0,24.53846153846154,37,2,20,40.641843293637784,0.5768581081081081,49.095394736842096,1003.6184210526301,27.124822190611624,0
3811,4,5,6,36,0.11904761904761904,0.14285714285714285,0.8571428571428572,42,1400,1100,300,0.7857142857142857,17,11,6,311.08529192280855,0.48325590398761126,0.16378788114136578,0.1637694006762489,127119.65610812929,-485.28104801479105,126634.3750601145,95,0,23.476190476190474,37,5,18,40.046459896343,0.5892454954954955,47.889254385964904,1008.4429824561392,27.255215742057818,0
3812,4,2,0,38,0.05263157894736842,0.0,1.0,38,1650,1300,350,0.7878787878787878,20,13,7,342.7694497133011,0.4775811996206733,0.1798546377767547,0.17873884128699746,126732.14994331058,1087.9818594104208,127820.13180272099,96,0,26.394736842105264,34,4,20,39.64540474501456,0.5912990196078431,48.27380952380952,1006.9047619047612,29.614845938375332,0
3813,4,3,2,39,0.07317073170731707,0.04878048780487805,0.9512195121951219,41,1250,700,550,0.56,18,7,11,325.34067683403657,0.4773882113821138,0.19857642020732147,0.17411296465970116,127783.97108966218,114.66472857033159,127898.63581823252,97,0,25.390243902439025,37,4,18,39.007767595705474,0.5960022522522522,47.23135964912281,1011.0745614035086,27.326339497392123,0
3814,4,2,5,36,0.04878048780487805,0.12195121951219512,0.8780487804878049,41,1200,900,300,0.75,15,9,6,321.6103993228701,0.47746443089430896,0.18921015094073534,0.17404115111371213,128230.06071950332,48.53217543716454,128278.59289494049,98,0,25.317073170731707,36,5,21,38.647061003632054,0.6024305555555556,46.79054054054054,1012.8378378378382,28.134384384384393,0
3815,4,4,2,38,0.1,0.05,0.95,40,1350,1000,350,0.7407407407407407,17,10,7,323.3981931418479,0.48002136752136754,0.04834500318268642,0.16879021974280503,126769.03558514139,199.3754109138751,126968.41099605526,99,0,25.575,38,2,18,40.09521536176533,0.5838815789473684,48.23717948717949,1007.0512820512824,26.501349527665326,16
3816,4,1,2,37,0.02564102564102564,0.05128205128205128,0.9487179487179487,39,1300,1000,300,0.7692307692307693,16,10,6,392.27133399310014,0.48020692757534866,0.06297593048381711,0.19560676182712128,124887.41275058847,2320.6205180672487,127208.03326865572,100,0,27.153846153846153,36,3,15,40.3102467327625,0.568287037037037,50.112612612612615,999.54954954955,27.765265265265278,16
3817,4,2,3,36,0.05128205128205128,0.07692307692307693,0.9230769230769231,39,1400,1000,400,0.7142857142857143,18,10,8,382.6786769622878,0.4803756185335133,0.11926371423364346,0.194530100101174,125686.24630896037,1819.4892899738306,127505.7355989342,101,0,27.923076923076923,37,2,15,39.721500820120276,0.5746058558558558,49.31469298245614,1002.7412280701748,27.101114272166885,0
3818,4,3,5,34,0.07692307692307693,0.1282051282051282,0.8717948717948718,39,1500,1300,200,0.8666666666666667,17,13,4,377.04889815457165,0.47961650922177235,0.13960113960113962,0.19480859737986184,126355.00365230077,1728.910949481455,128083.91460178223,102,0,26.025641025641026,36,3,17,39.171473640979684,0.5833333333333333,48.64864864864864,1005.4054054054039,27.927927927927886,0
3819,4,2,2,34,0.05555555555555555,0.05555555555555555,0.9444444444444444,36,1050,700,350,0.6666666666666666,14,7,7,374.6354630234547,0.4795634920634921,0.14302894093525764,0.1947827923985412,126612.3086734692,2286.6921768707234,128899.00085033993,103,0,27.416666666666668,34,2,19,38.966761296427734,0.5900735294117647,48.39285714285713,1006.42857142857,29.60084033613441,0
3820,4,4,2,36,0.10526315789473684,0.05263157894736842,0.9473684210526316,38,1100,700,400,0.6363636363636364,15,7,8,347.8839601840491,0.4803224276908487,0.1457986249618699,0.18534530230233306,127603.5072234397,1278.242685252826,128881.74990869252,104,0,26.342105263157894,36,2,16,38.62270582553128,0.5960648148148149,47.40990990990991,1010.3603603603607,28.065565565565574,0
3821,4,1,0,37,0.02702702702702703,0.0,1.0,37,950,600,350,0.631578947368421,13,6,7,351.923101449294,0.47854104104104106,0.15133088089203017,0.18829354021524225,127774.23327043276,1593.3408915672628,129367.57416200002,105,0,27.72972972972973,36,1,17,38.34581755402093,0.5978009259259259,47.240990990991,1011.0360360360373,28.084334334334372,0
3822,4,0,2,35,0.0,0.05405405405405406,0.9459459459459459,37,950,300,650,0.3157894736842105,16,3,13,423.97368202447865,0.47854104104104106,0.11852861887576127,0.21228160834620757,125057.87706832985,3438.8086045724094,128496.68567290225,106,1,28.72972972972973,35,2,14,39.34033402761706,0.5720238095238095,49.942129629629626,1000.231481481481,28.57804232804231,16
3823,4,11,8,38,0.2391304347826087,0.17391304347826086,0.8260869565217391,46,1050,600,450,0.5714285714285714,15,6,9,329.61854371378183,0.48026368760064414,0.12623878536921995,0.17479771257549043,127415.40310650901,151.74389184139758,127567.1469983504,107,0,23.717391304347824,38,8,15,39.27645502645503,0.5904605263157895,47.596153846153854,1009.6153846153858,26.568825910931206,16
3824,4,1,3,36,0.02564102564102564,0.07692307692307693,0.9230769230769231,39,850,500,350,0.5882352941176471,12,5,7,390.2660503023375,0.4773672964462438,0.13839438268688475,0.1936518544024653,124681.91557623888,1931.8237472136511,126613.73932345254,108,0,28.794871794871796,35,4,19,40.574057441959276,0.5681547619047619,50.31828703703704,998.7268518518521,28.535052910052915,16
3825,4,3,1,38,0.07692307692307693,0.02564102564102564,0.9743589743589743,39,1050,800,250,0.7619047619047619,13,8,5,390.2777777777776,0.4801788124156545,0.1482905982905982,0.19513888888888897,125000.00000000013,1957.3496709962428,126957.34967099638,109,0,29.0,34,5,22,40.24305555555556,0.5735294117647058,50.00000000000001,1000.000000000001,29.411764705882383,0
3826,4,7,7,38,0.15555555555555556,0.15555555555555556,0.8444444444444444,45,950,800,150,0.8421052631578947,11,8,3,341.3228481851859,0.4820917508417508,0.18959218839747316,0.17866598878244355,126887.86175679413,-329.37416945304756,126558.48758734108,110,0,25.933333333333334,35,10,14,39.52194619950221,0.5907738095238095,48.11921296296295,1007.5231481481458,28.786375661375594,0
3827,4,4,3,39,0.09523809523809523,0.07142857142857142,0.9285714285714286,42,1150,800,350,0.6956521739130435,15,8,7,365.0861095729228,0.4793360433604336,0.24395013662422094,0.19404144787201394,127506.12381708504,910.1429382205972,128416.26675530564,111,0,28.30952380952381,32,10,15,38.288119348251875,0.6038411458333333,47.506313131313135,1009.9747474747479,31.561710858585872,0
3828,4,1,3,37,0.025,0.075,0.925,40,1600,1100,500,0.6875,21,11,10,374.69518703182376,0.4773504273504274,0.2325654079133912,0.1995374026204475,127584.84098646369,1561.0851711697003,129145.9261576334,112,0,29.75,31,9,16,37.96464858014348,0.6071908602150538,47.428385416666664,1010.2864583333328,32.589885752688154,0
3829,4,0,2,35,0.0,0.05405405405405406,0.9459459459459459,37,650,300,350,0.46153846153846156,10,3,7,404.34396557612206,0.47541291291291293,0.24123296850569576,0.21272008623787275,127092.01388888886,2877.777777777773,129969.79166666663,113,1,32.810810810810814,29,8,20,37.72382920110192,0.6077586206896552,47.916666666666664,1008.333333333333,34.77011494252873,0
3830,4,1,1,35,0.027777777777777776,0.027777777777777776,0.9722222222222222,36,1200,900,300,0.75,15,9,6,393.42922938256186,0.4732969576719577,0.11999827240229122,0.19135903355832454,123841.98022959182,2614.0554138321963,126456.03564342401,114,0,31.27777777777778,34,2,17,41.37064944384644,0.5615808823529411,51.160714285714285,995.3571428571427,29.275210084033606,16
3831,4,6,4,37,0.14634146341463414,0.0975609756097561,0.9024390243902439,41,1100,900,200,0.8181818181818182,13,9,4,394.6866035977534,0.47591463414634144,0.023908223271955853,0.1922476876640924,123902.8809263544,1915.9143409163805,125818.79526727078,115,0,28.146341463414632,35,6,17,41.275769200961015,0.5601190476190476,51.099537037037024,995.6018518518501,28.445767195767147,16
3832,4,1,4,34,0.02631578947368421,0.10526315789473684,0.8947368421052632,38,1150,900,250,0.782608695652174,14,9,5,390.5438192334084,0.4771070412517781,0.08978634705575805,0.1843220829092255,122561.03421760866,2062.8301403395444,124623.8643579482,116,0,29.263157894736842,33,5,15,42.78310643564357,0.5505050505050505,52.450980392156865,990.1960784313728,30.005941770647663,16
3833,4,8,3,39,0.19047619047619047,0.07142857142857142,0.9285714285714286,42,1200,800,400,0.6666666666666666,16,8,8,354.57061280292083,0.47971109175377463,0.10407754386502899,0.17250832373288824,123854.13385062812,852.3279214822896,124706.4617721104,117,0,27.071428571428573,38,4,17,42.32496153983757,0.5540021929824561,51.148504273504265,995.4059829059819,26.194894286999524,15
3834,4,5,4,40,0.11363636363636363,0.09090909090909091,0.9090909090909091,44,950,600,350,0.631578947368421,13,6,7,336.44346168719755,0.4810826286116984,0.12346975544534766,0.1668641214275819,124661.68755425325,-411.6324027989151,124250.05515145433,118,0,26.681818181818183,39,5,16,41.93884513751261,0.5606303418803419,50.33854166666666,998.6458333333316,25.606303418803375,0
3835,4,3,3,40,0.06976744186046512,0.06976744186046512,0.9302325581395349,43,1050,700,350,0.6666666666666666,14,7,7,346.13789224976875,0.4802279438907346,0.15860454918597022,0.17329691839200828,125054.83057286857,57.70153586921157,125112.53210873778,119,0,27.13953488372093,37,6,20,41.289830446539526,0.5681306306306306,49.94517543859649,1000.219298245614,27.032954006638217,0
3836,4,5,5,40,0.1111111111111111,0.1111111111111111,0.8888888888888888,45,1300,1000,300,0.7692307692307693,16,10,6,337.1478044081659,0.4802609427609428,0.1247628303021886,0.1689962167816297,125104.18836805562,-522.6801756309596,124581.50819242466,120,0,26.466666666666665,39,6,18,41.463626266833245,0.5651709401709402,49.895833333333336,1000.4166666666672,25.651709401709414,16
3837,4,4,2,42,0.09090909090909091,0.045454545454545456,0.9545454545454546,44,1500,900,600,0.6,21,9,12,357.5906238185257,0.4800475687103594,0.11037944664031629,0.17694888872259215,124566.34898244588,549.9409239969015,125116.28990644278,121,0,27.772727272727273,35,9,17,41.509782608695666,0.5669642857142857,50.43402777777777,998.263888888888,28.52182539682537,16
3838,4,4,6,40,0.08695652173913043,0.13043478260869565,0.8695652173913043,46,1400,1100,300,0.7857142857142857,17,11,6,389.5988666602206,0.4817632850241546,0.10916819008434087,0.19339815130288543,124698.64675909888,788.6015942939628,125487.24835339283,122,0,27.043478260869566,37,9,15,40.573311194057155,0.5644707207207207,50.301535087719294,998.7938596491222,26.994428639165463,16
3839,4,4,1,43,0.09090909090909091,0.022727272727272728,0.9772727272727273,44,950,400,550,0.42105263157894735,15,4,11,380.68455773534674,0.4810055496828753,0.03429959022613471,0.18845458684584504,124583.68055555537,715.7475136580294,125299.4280692134,123,0,26.34090909090909,39,5,17,40.915414579855316,0.5598290598290598,50.41666666666666,998.3333333333318,25.598290598290557,16
3840,4,4,8,39,0.0851063829787234,0.1702127659574468,0.8297872340425532,47,1400,800,600,0.5714285714285714,20,8,12,351.39786332203704,0.48253931544865863,0.07463021625801303,0.17832158742837628,125615.07100820018,-569.0487115567096,125046.02229664347,124,0,25.5531914893617,38,9,17,40.57915023624285,0.5720942982456141,49.38568376068377,1002.4572649572663,26.38045434098069,0
3841,4,5,4,40,0.11363636363636363,0.09090909090909091,0.9090909090909091,44,1150,700,450,0.6086956521739131,16,7,9,372.95728103931634,0.4804219520789288,0.14723705492655048,0.19296894377103566,126413.28605584364,630.8121180285815,127044.09817387222,125,0,27.636363636363637,33,11,14,39.214192867007874,0.5902777777777778,48.590686274509785,1005.6372549019585,30.473856209150256,0
3842,4,4,2,42,0.09090909090909091,0.045454545454545456,0.9545454545454546,44,1350,1000,350,0.7407407407407407,17,10,7,363.7904557908131,0.47993745595489784,0.16487763936743582,0.19196942513269036,127215.61418685109,457.78246347557695,127673.39665032667,126,0,27.704545454545453,33,11,18,38.61910835762879,0.5984848484848485,47.79411764705882,1008.8235294117637,30.57040998217466,0
3843,4,0,3,39,0.0,0.07142857142857142,0.9285714285714286,42,1600,1200,400,0.75,20,12,8,379.0288476240656,0.4795538133952768,0.16340794248901735,0.19925050028135355,127061.12320081203,1231.9662209246258,128293.08942173666,127,1,29.023809523809526,33,9,20,38.39377962805398,0.5969065656565656,47.94730392156862,1008.2107843137242,30.551841948900734,0
3844,4,2,3,38,0.04878048780487805,0.07317073170731707,0.926829268292683,41,1200,800,400,0.6666666666666666,16,8,8,375.6304666136522,0.47761686991869917,0.14850557068892867,0.19922288906445001,127420.45932345923,1372.6088274904823,128793.06815094971,128,0,29.73170731707317,31,10,17,38.109900266529095,0.605510752688172,47.591145833333336,1009.635416666667,32.56888440860216,0
3845,4,0,1,37,0.0,0.02631578947368421,0.9736842105263158,38,1300,600,700,0.46153846153846156,20,6,14,390.73819787619306,0.475343764817449,0.1448002318252617,0.20645185509603958,127267.1320408951,2345.625964506175,129612.75800540128,129,1,32.39473684210526,29,9,24,37.88641316815784,0.6095545977011494,47.74305555555556,1009.027777777778,34.794061302682,0
3846,4,1,1,37,0.02631578947368421,0.02631578947368421,0.9736842105263158,38,1200,900,300,0.75,15,9,6,393.0687093825455,0.47343231389284024,0.15938062631506633,0.21022388946330278,127758.10426311736,2443.5426311728506,130201.64689429021,130,0,33.13157894736842,29,9,19,37.32240577918212,0.6145833333333333,47.25694444444445,1010.9722222222229,34.861111111111136,0
3847,4,2,2,37,0.05128205128205128,0.05128205128205128,0.9487179487179487,39,850,600,250,0.7058823529411765,11,6,5,380.7689428569595,0.4727564102564103,0.16028444585172164,0.20527723729334285,128078.62175835509,1953.6722819010515,130032.29404025614,131,0,33.12820512820513,31,8,21,37.304369265071614,0.612231182795699,46.94010416666667,1012.2395833333338,32.652889784946254,0
3848,4,1,1,37,0.02631578947368421,0.02631578947368421,0.9736842105263158,38,1200,1000,200,0.8333333333333334,14,10,4,371.7807992964034,0.47220246562351825,0.14660881788446423,0.2027611249944251,128540.34423828125,1957.7833387586802,130498.12757703994,132,0,33.89473684210526,31,7,16,37.059150830337266,0.6169354838709677,46.484375,1014.0625,32.711693548387096,0
3849,4,0,2,35,0.0,0.05405405405405406,0.9459459459459459,37,1250,800,450,0.64,17,8,9,382.06287035269435,0.46984484484484484,0.13540365110109454,0.20915102308139868,128689.46419022429,2433.493214533469,131122.95740475776,133,1,35.62162162162162,30,7,17,36.645858171060176,0.6211805555555556,46.33736559139785,1014.6505376344085,33.821684587813614,0
3850,4,0,1,34,0.0,0.02857142857142857,0.9714285714285714,35,1200,600,600,0.5,18,6,12,405.96829306637494,0.46908263305322134,0.14136276197225928,0.22082546704574205,128435.64467317339,3428.159887369525,131863.80456054292,134,2,38.142857142857146,28,7,17,36.299905504370415,0.6246279761904762,46.587643678160916,1013.6494252873557,36.20176518883413,0
3851,4,0,3,31,0.0,0.08823529411764706,0.9117647058823529,34,1300,1100,200,0.8461538461538461,15,11,4,461.7703850948996,0.4666889483065954,0.14032987048030265,0.23410684639694904,125575.37323292377,4829.6065778174125,130404.97981074118,135,3,38.6764705882353,28,6,18,37.854489201070336,0.5952380952380952,49.42528735632184,1002.2988505747126,35.79638752052545,16
3852,4,3,2,32,0.08823529411764706,0.058823529411764705,0.9411764705882353,34,700,300,400,0.42857142857142855,11,3,8,450.91300775556454,0.4690470885323827,0.1567239508415983,0.2320260973682608,126188.15491230688,4579.97609492669,130768.13100723358,136,0,38.94117647058823,28,6,21,37.488381238381244,0.6015625,48.8146551724138,1004.7413793103457,35.8836206896552,0
3853,4,3,4,31,0.08571428571428572,0.11428571428571428,0.8857142857142857,35,1350,1100,250,0.8148148148148148,16,11,5,431.6194846892035,0.4719887955182073,0.1268580881484107,0.22589954848019358,126882.03125000003,3952.9513888888887,130834.98263888892,137,0,37.8,29,6,19,37.25358422939068,0.6056034482758621,48.125,1007.5000000000002,34.74137931034483,0
3854,4,4,2,33,0.11428571428571428,0.05714285714285714,0.9428571428571428,35,700,400,300,0.5714285714285714,10,4,6,428.6271989548671,0.4702380952380953,0.14055159932328798,0.22588466754791325,127162.04668209876,3901.0223765432083,131063.06905864197,138,0,38.628571428571426,29,6,21,37.03926833746443,0.6084770114942528,47.84722222222222,1008.6111111111111,34.779693486590034,0
3855,4,0,2,31,0.0,0.06060606060606061,0.9393939393939394,33,600,300,300,0.5,9,3,6,436.7016120082996,0.46796085858585856,0.14526214526214543,0.21511597924853293,124375.7812500001,4266.801697530878,128642.58294753099,139,1,41.96969696969697,29,4,18,39.734753550543026,0.5797413793103448,50.62500000000001,997.5000000000008,34.39655172413796,16
3856,4,3,0,34,0.08823529411764706,0.0,1.0,34,1150,600,550,0.5217391304347826,17,6,11,431.67634884790755,0.46811868686868685,0.19196125755209525,0.21900967412977518,125605.57036940694,4044.190802404909,129649.76117181184,140,0,40.38235294117647,30,4,19,38.57714311254133,0.5895833333333333,49.395161290322584,1002.4193548387103,33.41397849462368,0
3857,4,2,2,34,0.05555555555555555,0.05555555555555555,0.9444444444444444,36,1350,1000,350,0.7407407407407407,17,10,7,410.2062374871371,0.4695767195767196,0.14586671597025358,0.19821341302758458,123564.19593725976,2963.528907082343,126527.72484434211,141,0,39.083333333333336,33,3,20,41.24386273059699,0.5609217171717171,51.43995098039216,994.2401960784318,30.128490790255512,16
3858,4,5,1,38,0.1282051282051282,0.02564102564102564,0.9743589743589743,39,1350,900,450,0.6666666666666666,18,9,9,381.70766441887343,0.47365609536662173,0.20182616583644863,0.19212383922598733,125275.88735402231,1780.975466166834,127056.86282018916,142,0,35.794871794871796,33,6,17,40.171048067898965,0.5785984848484849,49.72426470588234,1001.1029411764691,30.336452762923308,0
3859,4,3,1,40,0.07317073170731707,0.024390243902439025,0.975609756097561,41,1200,600,600,0.5,18,6,12,368.50682640112973,0.4730436991869919,0.21968275626812184,0.18923262899247278,126103.61571712,1096.355248594511,127199.97096571451,143,0,34.97560975609756,34,7,22,39.645559243016855,0.5848651960784313,48.89880952380951,1004.4047619047604,29.5413165266106,0
3860,4,1,4,37,0.024390243902439025,0.0975609756097561,0.9024390243902439,41,1200,800,400,0.6666666666666666,16,8,8,357.99488546984253,0.47233231707317075,0.1601788498789043,0.17429226288513922,123882.71620008672,673.7341779159524,124556.45037800267,144,0,34.78048780487805,39,2,19,42.21000749886645,0.5526175213675213,51.119791666666664,995.5208333333327,25.5261752136752,16
3861,4,3,1,39,0.075,0.025,0.975,40,1450,1200,250,0.8275862068965517,17,12,5,347.3912415437565,0.47350427350427354,0.19045304777594718,0.17199550050331175,124589.15393438366,656.2605876928455,125245.4145220765,145,0,35.4,37,3,18,41.740687351272186,0.5633445945945945,50.411184210526315,998.3552631578947,26.9825746799431,0
3862,4,3,4,38,0.07142857142857142,0.09523809523809523,0.9047619047619048,42,1300,700,600,0.5384615384615384,19,7,12,330.915867974651,0.4728513356562137,0.20953077059003045,0.166921997385058,125366.25888980202,-100.83425548943379,125265.42463431259,146,0,34.595238095238095,36,6,14,41.34900108699727,0.5732060185185186,49.63400900900901,1001.4639639639645,27.818443443443456,0
3863,4,6,3,41,0.13636363636363635,0.06818181818181818,0.9318181818181819,44,1150,800,350,0.6956521739130435,15,8,7,364.8578999510207,0.4767221634954193,0.26359546751251717,0.1817111967297055,124835.5804189754,772.5847635368712,125608.16518251227,147,0,33.18181818181818,37,7,18,41.049027137736786,0.5658783783783784,50.16447368421054,999.3421052631606,27.00924608819353,16
3864,4,3,3,41,0.06818181818181818,0.06818181818181818,0.9318181818181819,44,350,200,150,0.5714285714285714,5,2,3,355.8779550850932,0.4768432875264271,0.264539728632631,0.17926973930093892,125309.87649389284,119.22093246483976,125429.09742635768,148,0,33.81818181818182,36,8,16,40.78234544295729,0.5726273148148149,49.69031531531533,1001.2387387387412,27.812187187187256,0
3865,4,3,5,39,0.06818181818181818,0.11363636363636363,0.8863636363636364,44,1250,1000,250,0.8,15,10,5,359.3555950565808,0.47754800916138124,0.28728936383028625,0.18300630561286269,125761.2907459826,238.6046942212603,125999.89544020385,149,0,34.45454545454545,36,8,20,40.22865910706934,0.5772569444444444,49.23986486486487,1003.0405405405415,27.862237237237267,0
3866,4,5,5,39,0.11363636363636363,0.11363636363636363,0.8863636363636364,44,950,700,250,0.7368421052631579,12,7,5,344.76550544603447,0.48058712121212116,0.27051571616788994,0.17905563347358575,126567.38281250004,-71.83533829437314,126495.54747420567,150,0,32.81818181818182,35,9,16,39.76449275362318,0.5875,48.4375,1006.2500000000003,28.75000000000001,0
3867,4,2,2,39,0.04878048780487805,0.04878048780487805,0.9512195121951219,41,1000,600,400,0.6,14,6,8,342.25916570185046,0.47794715447154473,0.12245507305876457,0.17444730401148897,125796.22005088093,655.1224896121753,126451.3425404931,151,0,35.31707317073171,37,4,19,40.62135661456623,0.5757319819819819,49.205043859649116,1003.1798245614027,27.112968231389264,16
3868,4,1,3,37,0.025,0.075,0.925,40,1150,700,450,0.6086956521739131,16,7,9,345.22392307303465,0.4769898504273504,0.15977121327945887,0.1769006974582973,126016.31180988357,700.7691068405409,126717.08091672411,152,0,37.075,37,3,20,40.32013304939754,0.5779842342342343,48.985745614035075,1004.0570175438577,27.136676149833992,0
3869,4,5,4,38,0.11904761904761904,0.09523809523809523,0.9047619047619048,42,1450,900,550,0.6206896551724138,20,9,11,343.11792457979516,0.47610578784359275,0.20593988879320535,0.18101592275534742,127205.59030314069,333.88135860014336,127539.47166174084,153,0,35.214285714285715,36,6,19,39.15075909801298,0.5920138888888888,47.80405405405404,1008.7837837837815,28.021771771771707,0
3870,4,3,2,39,0.07317073170731707,0.04878048780487805,0.9512195121951219,41,1200,800,400,0.6666666666666666,16,8,8,350.7244409219934,0.47776930894308944,0.21181089591221558,0.185845599861581,127383.94445516105,735.3325402949126,128119.27699545596,154,0,36.170731707317074,35,6,15,38.775987923259194,0.5958333333333333,47.62731481481481,1009.4907407407397,28.842592592592563,0
3871,4,1,3,37,0.025,0.075,0.925,40,800,600,200,0.75,10,6,4,356.98610349718524,0.4775373931623932,0.2121091445427732,0.18850200792141078,127242.10778061215,1084.7328514739133,128326.84063208607,155,0,38.05,34,6,23,38.76352015732546,0.5965073529411764,47.76785714285714,1008.9285714285706,29.674369747899135,0
3872,4,4,4,37,0.0975609756097561,0.0975609756097561,0.9024390243902439,41,1100,700,400,0.6363636363636364,15,7,8,332.8051722055501,0.4765752032520325,0.18450094764305192,0.17884643703789188,127950.32035097312,316.50567963216406,128266.82603060528,156,0,36.8780487804878,37,4,17,38.64914110761893,0.5976914414414414,47.06688596491227,1011.7324561403489,27.344120436225644,0
3873,4,0,0,37,0.0,0.0,1.0,37,2050,1600,450,0.7804878048780488,25,16,9,369.1172565025296,0.4730980980980981,0.20763922839921345,0.19552532744767456,127370.19903702918,2002.9076857458804,129373.10672277506,157,1,41.83783783783784,33,4,18,38.32592266601915,0.6000631313131313,47.640931372549026,1009.4362745098051,30.58897801544864,0
3874,4,0,0,37,0.0,0.0,1.0,37,1600,1000,600,0.625,22,10,12,370.1878848953281,0.47250375375375375,0.20707930354817838,0.1966936401948678,127493.9344993513,2039.3419898596776,129533.27648921097,158,2,42.83783783783784,33,4,19,38.171818751769614,0.6013257575757576,47.51838235294118,1009.926470588236,30.60383244206776,0
3875,4,0,3,34,0.0,0.08108108108108109,0.9189189189189189,37,1500,1200,300,0.8,18,12,6,372.31142842671505,0.47269144144144143,0.20376136505168718,0.19858214998749632,127648.68830497879,2105.013095924632,129753.70140090342,159,3,43.83783783783784,33,4,19,37.95931360659713,0.6029040404040404,47.36519607843137,1010.539215686274,30.622400475341635,0
3876,4,4,2,36,0.10526315789473684,0.05263157894736842,0.9473684210526316,38,900,600,300,0.6666666666666666,12,6,6,404.59580848865585,0.4732841394025604,0.16253365359235605,0.21119477542575368,126773.92612998662,2962.784911190285,129736.71104117691,160,0,40.31578947368421,32,6,17,38.045908559010364,0.5963541666666667,48.232323232323225,1007.070707070706,31.470959595959563,16
3877,4,0,1,35,0.0,0.027777777777777776,0.9722222222222222,36,1150,600,550,0.5217391304347826,17,6,11,414.30883379709303,0.4710648148148148,0.18178584133760212,0.21687562975858993,126888.8021736616,3314.2303300959493,130203.03250375755,161,1,43.111111111111114,30,6,18,37.68259738527213,0.6027777777777779,48.118279569892465,1007.5268817204294,33.58422939068098,0
3878,4,3,1,37,0.07894736842105263,0.02631578947368421,0.9736842105263158,38,1450,1200,250,0.8275862068965517,17,12,5,389.1351251839849,0.47101706970128027,0.17156395299131222,0.20747824162874298,127633.67776566168,2333.3494350066326,129967.02720066831,162,0,41.473684210526315,32,6,18,37.54972093798158,0.6051432291666667,47.380050505050505,1010.4797979797981,31.577493686868692,0
3879,4,1,0,38,0.02631578947368421,0.0,1.0,38,1350,1000,350,0.7407407407407407,17,10,7,391.1556946543946,0.4716097676623992,0.16984750371061175,0.21038400919196784,127984.77993317023,2412.395099989814,130397.17503316003,163,0,42.44736842105263,32,6,19,37.1378733050495,0.6087239583333333,47.03282828282829,1011.868686868688,31.6208964646465,0
3880,4,3,3,38,0.07317073170731707,0.07317073170731707,0.926829268292683,41,900,500,400,0.5555555555555556,13,5,8,363.7230939314825,0.47284044715447154,0.16231974363539226,0.19932025547445267,128731.13854595351,1164.4975994513197,129895.63614540483,164,0,40.26829268292683,35,6,15,37.06850669099757,0.6095238095238096,46.296296296296305,1014.814814814816,28.99470899470903,0
3881,4,0,2,36,0.0,0.05263157894736842,0.9473684210526316,38,1000,500,500,0.5,15,5,10,448.6104609403195,0.46968349928876246,0.10559148343448443,0.22687852183310628,125473.93322428841,3821.8034370075716,129295.73666129599,165,1,43.81578947368421,32,6,15,38.29001260239445,0.5830078125,49.526515151515156,1001.8939393939401,31.309185606060627,16
3882,4,1,2,35,0.02702702702702703,0.05405405405405406,0.9459459459459459,37,1050,700,350,0.6666666666666666,14,7,7,448.56265825026196,0.4694069069069069,0.10896524513438721,0.22877271389323384,125822.05419089894,3887.8150188756354,129709.86920977458,166,0,41.45945945945946,32,5,16,37.92841261850828,0.5865885416666667,49.179292929292934,1003.2828282828287,31.3525883838384,0
3883,4,3,4,34,0.07894736842105263,0.10526315789473684,0.8947368421052632,38,1250,1000,250,0.8,15,10,5,427.6568007442683,0.4721728307254623,0.12400174439205136,0.22139551802605434,126436.39458550354,3214.667386359656,129651.0619718632,167,0,40.94736842105263,31,7,17,37.81503538753666,0.5954301075268817,48.567708333333336,1005.7291666666673,32.442876344086045,0
3884,4,1,4,31,0.02857142857142857,0.11428571428571428,0.8857142857142857,35,900,600,300,0.6666666666666666,12,6,6,425.7449626744896,0.46908263305322134,0.09413409323081856,0.2213707173828023,126615.03170913695,3781.1423898071776,130396.17409894413,168,0,39.65714285714286,32,3,18,37.67798895997993,0.5947265625,48.39015151515152,1006.439393939395,31.451231060606094,0
3885,4,1,1,31,0.03125,0.03125,0.96875,32,1100,700,400,0.6363636363636364,15,7,8,443.99562070944654,0.4645287298387097,0.12276200496757306,0.2309860921235719,126637.27092978386,4845.27874228394,131482.5496720678,169,0,41.0625,29,3,19,37.19570741916195,0.6030890804597702,48.36805555555555,1006.527777777777,34.707854406130245,0
3886,4,1,4,28,0.03125,0.125,0.875,32,1000,700,300,0.7,13,7,6,434.7380643398676,0.46442372311827956,0.1255165289256197,0.22871002515271277,127092.01388888877,4650.347222222203,131742.36111111098,170,0,41.34375,29,3,20,36.95764462809916,0.6077586206896552,47.91666666666666,1008.3333333333323,34.7701149425287,0
3887,4,1,1,28,0.034482758620689655,0.034482758620689655,0.9655172413793104,29,900,600,300,0.6666666666666666,12,6,6,433.6087710965586,0.46069376026272574,0.06644322637315137,0.22995991203739743,127418.19273104104,5249.929193090228,132668.12192413126,144,0,36.172413793103445,28,1,17,36.648818841610925,0.6142113095238095,47.593390804597696,1009.6264367816088,36.0580870279146,0
3888,4,0,1,27,0.0,0.03571428571428571,0.9642857142857143,28,750,300,450,0.4,12,3,9,449.4724312739649,0.458967151675485,0.07167080928508196,0.2377786293993781,127317.18794288539,5845.113201530594,133162.30114441598,145,2,38.464285714285715,27,1,17,36.352968642485,0.6165123456790124,47.69345238095237,1009.2261904761897,37.378747795414434,0
3889,4,0,0,27,0.0,0.0,1.0,27,400,300,100,0.75,5,3,2,455.5971719552225,0.45661206077872746,0.06180767923887176,0.24106840651999636,127325.53155006857,6201.830418381339,133527.3619684499,146,3,39.925925925925924,26,1,17,36.18979357798165,0.6201923076923077,47.68518518518518,1009.2592592592591,38.817663817663814,0
3890,4,1,0,28,0.03571428571428571,0.0,1.0,28,850,600,250,0.7058823529411765,11,6,5,441.3466812425925,0.45877425044091713,0.061058551455902554,0.23632393215472133,127805.74876434938,5681.328612174025,133487.0773765234,147,0,39.464285714285715,27,1,18,36.05301079224922,0.6215277777777778,47.20982142857142,1011.1607142857134,37.450396825396794,0
3891,4,1,0,29,0.034482758620689655,0.0,1.0,29,750,700,50,0.9333333333333333,8,7,1,425.3948522110825,0.45792282430213466,0.06515964602462554,0.23013110615778362,128217.2786406725,5108.594059651213,133325.87270032373,148,0,39.06896551724138,28,1,19,36.03229772544569,0.6223958333333333,46.80316091954023,1012.7873563218393,36.17097701149426,0
3892,4,1,1,29,0.03333333333333333,0.03333333333333333,0.9666666666666667,30,700,400,300,0.5714285714285714,10,4,6,413.76436493619144,0.4582854406130268,0.06593221112175551,0.22680991857379976,128742.88435570986,4653.843557098766,133396.72791280862,149,0,38.733333333333334,29,1,18,35.78688814378906,0.6246408045977012,46.28472222222222,1014.861111111111,34.995210727969344,0
3893,4,0,0,29,0.0,0.0,1.0,29,550,500,50,0.9090909090909091,6,5,1,422.17536454028226,0.4569991789819376,0.07245286705089415,0.23069334935405497,128617.75829039494,5059.849798520271,133677.6080889152,150,1,40.758620689655174,28,1,18,35.70201841359774,0.6264880952380952,46.40804597701149,1014.3678160919533,36.22742200328405,0
3894,4,1,0,30,0.03333333333333333,0.0,1.0,30,700,600,100,0.8571428571428571,8,6,2,439.66854798116276,0.458764367816092,0.08794845001741547,0.21577579508613992,124219.97070312501,5314.867735066555,129534.83843819157,151,0,40.36666666666667,27,3,14,39.82388540578196,0.5844907407407407,50.78125,996.8750000000001,36.9212962962963,16
3895,4,4,0,34,0.11764705882352941,0.0,1.0,34,1250,1000,250,0.8,15,10,5,398.25989024942345,0.46518493761140817,0.12257700173998032,0.20356679270839223,125913.11984592007,3229.229058159718,129142.34890407979,152,0,36.5,31,3,18,39.095744680851084,0.5900537634408602,49.088541666666664,1003.6458333333327,32.37567204301073,0
3896,4,1,1,34,0.02857142857142857,0.02857142857142857,0.9714285714285714,35,950,800,150,0.8421052631578947,11,8,3,390.1352288816672,0.46565126050420164,0.134670094892807,0.2018094020531221,126403.65812513547,2862.971835666212,129266.62996080167,153,0,36.42857142857143,31,4,15,38.79227092235316,0.5950940860215054,48.60026041666666,1005.598958333332,32.43867607526877,0
3897,4,2,3,33,0.05555555555555555,0.08333333333333333,0.9166666666666666,36,900,600,300,0.6666666666666666,12,6,6,373.2980866990353,0.46615410052910056,0.12953802268141668,0.19623339185594443,127060.18717796645,2286.264953831231,129346.45213179768,154,0,36.0,32,4,17,38.53918806094761,0.5992838541666667,47.94823232323232,1008.2070707070701,31.50647095959594,0
3898,4,3,2,34,0.08333333333333333,0.05555555555555555,0.9444444444444444,36,1050,700,350,0.6666666666666666,14,7,7,364.1510103252936,0.464566798941799,0.12328536394750289,0.1942295751062335,127648.68830497879,2096.6797625912995,129745.36806757009,155,0,35.861111111111114,33,3,16,38.165474169294185,0.6029040404040404,47.36519607843137,1010.539215686274,30.622400475341635,0
3899,4,1,0,35,0.02857142857142857,0.0,1.0,35,550,400,150,0.7272727272727273,7,4,3,374.38465927132313,0.46197478991596636,0.14298568215089125,0.19945579517237877,127601.78330017348,2554.4300326497378,130156.21333282322,156,0,37.82857142857143,32,3,17,37.955094559693414,0.6048177083333333,47.411616161616166,1010.3535353535357,31.57354797979799,0
3900,4,1,0,36,0.027777777777777776,0.0,1.0,36,1050,800,250,0.7619047619047619,13,8,5,363.0488787933301,0.46319444444444446,0.1421988105809855,0.19544052419004707,128020.4804041715,2095.5383746635944,130116.01877883509,157,0,37.75,33,3,18,37.81232340356826,0.6066919191919191,46.997549019607845,1012.0098039215688,30.666963755199056,0
3901,4,1,2,35,0.02702702702702703,0.05405405405405406,0.9459459459459459,37,1250,900,350,0.72,16,9,7,355.9739704398927,0.46509009009009006,0.035842133524252695,0.18535196391870298,126672.2222222224,1904.4706362937532,128576.69285851615,158,0,37.7027027027027,34,3,19,39.37465507726267,0.5906862745098039,48.33333333333334,1006.6666666666681,29.607843137254946,16
3902,4,1,3,33,0.027777777777777776,0.08333333333333333,0.9166666666666666,36,1350,1000,350,0.7407407407407407,17,10,7,393.68270203059365,0.46545965608465606,0.06606443478727408,0.18158505031299768,121571.45691609984,2422.289540816334,123993.74645691617,159,0,38.22222222222222,34,2,17,43.746227667793335,0.5379901960784313,53.452380952380956,986.1904761904767,29.005602240896373,16
3903,4,13,9,37,0.2826086956521739,0.1956521739130435,0.8043478260869565,46,1250,900,350,0.72,16,9,7,314.23595705502584,0.4810386473429951,0.13235621049957147,0.15546325123687707,124557.68364800338,-1294.2350149695376,123263.44863303384,160,0,30.108695652173914,39,7,16,42.600720894639814,0.5595619658119658,50.44270833333333,998.2291666666658,25.595619658119638,0
3904,4,6,2,41,0.13953488372093023,0.046511627906976744,0.9534883720930233,43,850,700,150,0.8235294117647058,10,7,3,328.7769109605011,0.4784745293466224,0.17809728869251096,0.16395680089255624,124890.3749230533,-387.7856648199384,124502.58925823336,161,0,32.093023255813954,37,6,22,41.893831358783096,0.5664414414414414,50.10964912280702,999.5614035087723,27.015173067804657,0
3905,4,3,2,42,0.06818181818181818,0.045454545454545456,0.9545454545454546,44,1500,1000,500,0.6666666666666666,20,10,10,323.3991051247914,0.47993745595489784,0.2109089914788267,0.16417756902587266,125631.27747239535,-674.1433662280677,124957.13410616729,162,0,32.11363636363637,37,7,17,41.264150169528605,0.5740427927927928,49.36951754385965,1002.5219298245613,27.09518729255571,0
3906,4,0,1,41,0.0,0.023809523809523808,0.9761904761904762,42,1000,700,300,0.7,13,7,6,340.5167001381036,0.47732771970576854,0.21844564033147407,0.17192716003472275,125405.42079260964,140.5280135459475,125545.94880615559,163,1,34.595238095238095,35,7,18,41.06819582466683,0.575595238095238,49.594907407407405,1001.6203703703695,28.617724867724842,0
3907,4,4,3,42,0.08888888888888889,0.06666666666666667,0.9333333333333333,45,850,500,350,0.5882352941176471,12,5,7,316.90737960972024,0.4779882154882155,0.23743807501769298,0.16474986290968907,126607.70052596979,-973.7961713734073,125633.90435459638,164,0,32.75555555555555,38,7,18,40.42396496815287,0.5822368421052632,48.3974358974359,1006.4102564102567,26.484480431848862,0
3908,4,2,2,42,0.045454545454545456,0.045454545454545456,0.9545454545454546,44,1250,1000,250,0.8,15,10,5,316.7034205267594,0.4751365398167724,0.23340402969247132,0.16573325502593433,126876.64936262678,-763.546232376375,126113.1031302504,165,0,33.75,38,6,22,40.15354365500176,0.5849780701754386,48.130341880341874,1007.4786324786312,26.512595591542926,0
3909,4,1,1,42,0.023255813953488372,0.023255813953488372,0.9767441860465116,43,1450,1300,150,0.896551724137931,16,13,3,322.42357638181244,0.47471391657438167,0.23917891943679215,0.16997928037974652,127177.19144397782,-398.83239169989065,126778.35905227793,166,0,34.23255813953488,36,7,23,39.70172304715122,0.591724537037037,47.83220720720721,1008.6711711711716,28.018643643643657,0
3910,4,0,2,40,0.0,0.047619047619047616,0.9523809523809523,42,800,500,300,0.625,11,5,6,322.03842474489795,0.47488385598141697,0.22978316326530646,0.17013350741239922,127262.39753266795,-203.32359386411127,127059.07393880383,167,1,35.61904761904762,36,6,24,39.624255952380985,0.5925925925925926,47.74774774774776,1009.0090090090102,28.02802802802806,0
3911,4,2,1,41,0.047619047619047616,0.023809523809523808,0.9761904761904762,42,1600,1300,300,0.8125,19,13,6,319.280285666603,0.4747507742934572,0.22765320899441432,0.17070751187784977,127745.77100326688,-242.65874827529092,127503.11225499159,168,0,35.904761904761905,36,6,16,39.19994615870187,0.5975115740740741,47.26914414414415,1010.9234234234243,28.081206206206232,0
3912,4,0,3,38,0.0,0.07317073170731707,0.926829268292683,41,1000,500,500,0.5,15,5,10,326.7139784126259,0.4740599593495935,0.2231098647884877,0.1745586113233172,127717.31190650108,145.40621702784009,127862.71812352892,169,1,37.53658536585366,36,5,16,39.041146761735,0.5972222222222222,47.2972972972973,1010.8108108108107,28.078078078078075,0
3913,4,2,0,40,0.05,0.0,1.0,40,1050,600,450,0.5714285714285714,15,6,9,326.8245185393738,0.47351762820512816,0.2046626210889657,0.17523647767176814,127859.63909433087,357.5329975245571,128217.17209185542,170,0,35.825,36,4,18,38.89298704672828,0.5986689814814814,47.156531531531535,1011.3738738738742,28.09371871871873,0
3914,4,0,2,38,0.0,0.05,0.95,40,1150,1000,150,0.8695652173913043,13,10,3,323.25601577066254,0.47256944444444443,0.19682040725492378,0.17406242143384928,128030.53634293082,277.3282150393681,128307.86455797018,171,1,36.825,36,4,20,38.80883498386558,0.6004050925925926,46.987612612612615,1012.04954954955,28.1124874874875,0
3915,4,0,0,38,0.0,0.0,1.0,38,1400,1000,400,0.7142857142857143,18,10,8,341.2176845456594,0.4706910858226648,0.19892809827773128,0.1831844326123503,127910.26341735251,1129.048782578875,129039.31219993139,172,2,39.39473684210526,35,3,21,38.47730739893211,0.6011904761904762,47.10648148148148,1011.5740740740738,28.902116402116395,0
3916,4,1,1,38,0.02564102564102564,0.02564102564102564,0.9743589743589743,39,900,600,300,0.6666666666666666,12,6,6,384.6178472485983,0.47025416104363477,0.2577347273848114,0.19258397810385686,125059.53089569144,2015.9810143192935,127075.51191001073,173,0,39.35897435897436,34,5,17,40.32274061731335,0.5741421568627452,49.94047619047618,1000.2380952380938,29.41876750700276,16
3917,4,5,4,39,0.11627906976744186,0.09302325581395349,0.9069767441860466,43,1000,600,400,0.6,14,6,8,358.6099651196997,0.4737679955703211,0.2186882171901432,0.18025285030906507,125219.39442905525,798.4377649952096,126017.83219405045,174,0,36.46511627906977,37,6,19,40.80758837277243,0.5698198198198199,49.78070175438597,1000.8771929824574,27.05073494547182,16
3918,4,1,2,38,0.025,0.05,0.95,40,950,700,250,0.7368421052631579,12,7,5,366.716079006325,0.47200854700854705,0.24508324661810676,0.18451002718590462,125260.55230034702,1187.0117187499754,126447.56401909699,175,0,39.2,35,5,16,40.56213146028442,0.5741071428571429,49.73958333333332,1001.0416666666649,28.601190476190425,0
3919,4,1,1,38,0.02564102564102564,0.02564102564102564,0.9743589743589743,39,1150,900,250,0.782608695652174,14,9,5,369.9749584199624,0.47196918578497526,0.23425811661105822,0.1869873438500889,125446.82716836724,1482.4369331065657,126929.2641014738,176,0,40.76923076923077,34,5,17,40.28768072885721,0.578125,49.55357142857142,1001.7857142857133,29.464285714285687,0
3920,4,2,1,39,0.05,0.025,0.975,40,1100,700,400,0.6363636363636364,15,7,8,360.1595229592472,0.47170138888888885,0.24495389048991356,0.18454718615897633,126014.78273158865,1077.0848068844325,127091.86753847309,177,0,40.7,35,5,20,39.9468059558117,0.5818452380952381,48.98726851851852,1004.050925925926,28.687169312169313,0
3921,4,3,2,40,0.07142857142857142,0.047619047619047616,0.9523809523809523,42,1500,1000,500,0.6666666666666666,20,10,10,340.2231855696825,0.47349254742547425,0.237179487179487,0.17774276704060993,126808.29478126779,228.62775040822427,127036.92253167601,178,0,39.30952380952381,36,6,19,39.63131708407872,0.587962962962963,48.1981981981982,1007.2072072072075,27.977977977977986,0
3922,4,1,1,40,0.024390243902439025,0.024390243902439025,0.975609756097561,41,1350,900,450,0.6666666666666666,18,9,9,349.7813480662354,0.4731961382113821,0.24370072784118624,0.18322481445635652,126917.01630015433,678.641010802472,127595.6573109568,179,0,39.8780487804878,35,6,21,39.2789455547898,0.5910714285714286,48.09027777777778,1007.6388888888889,28.78968253968254,0
3923,4,2,3,39,0.047619047619047616,0.07142857142857142,0.9285714285714286,42,900,700,200,0.7777777777777778,11,7,4,340.6131168367834,0.47557346109175375,0.23990729034976832,0.1798564588904511,127242.10778061219,268.3073113504585,127510.41509196266,180,0,39.73809523809524,34,8,23,39.17649950835791,0.5965073529411764,47.76785714285714,1008.928571428571,29.674369747899146,0
3924,4,1,3,37,0.025,0.075,0.925,40,850,600,250,0.7058823529411765,11,6,5,391.59663297926903,0.4734909188034188,0.20817897661495732,0.1955266887673367,124942.13632758909,1934.2820815311654,126876.41840912026,181,0,41.35,35,5,18,40.270220730107276,0.5708333333333333,50.05787037037037,999.768518518518,28.5648148148148,16
3925,4,5,3,39,0.11904761904761904,0.07142857142857142,0.9285714285714286,42,1650,1200,450,0.7272727272727273,21,12,9,363.39986727092764,0.47433943089430897,0.23187582033159226,0.1856829846261765,125898.59992551872,750.3336923439649,126648.93361786268,182,0,40.11904761904762,35,7,18,39.98541594587321,0.580654761904762,49.10300925925926,1003.5879629629633,28.673941798941808,0
3926,4,1,0,40,0.025,0.0,1.0,40,950,600,350,0.631578947368421,13,6,7,379.38654215439755,0.4711939102564102,0.25054659826554304,0.1935225931849255,125828.57442149661,1547.5335507977818,127376.1079722944,183,0,42.9,33,7,19,39.656747485851575,0.584280303030303,49.172794117647065,1003.3088235294124,30.403297682709468,0
3927,4,4,1,43,0.09090909090909091,0.022727272727272728,0.9772727272727273,44,1250,1000,250,0.8,15,10,5,378.4480578162071,0.47394732205778717,0.21290868094701199,0.18795264685497012,124718.62698847531,828.1808756146138,125546.80786408993,184,0,39.90909090909091,36,8,18,40.830984592258545,0.5665509259259259,50.28153153153155,998.8738738738767,27.746496496496576,16
3928,4,1,3,41,0.022727272727272728,0.06818181818181818,0.9318181818181819,44,1050,800,250,0.7619047619047619,13,8,5,380.53294908608666,0.4734077695560253,0.22838886274689796,0.1904107068673971,125031.56764934717,716.9943933444845,125748.56204269166,185,0,40.84090909090909,32,12,19,40.4539094390439,0.5784505208333333,49.96843434343435,1000.126262626264,31.25394570707075,0
3929,4,6,5,42,0.1276595744680851,0.10638297872340426,0.8936170212765957,47,1250,800,450,0.64,17,8,9,339.8267822601345,0.4760831020659883,0.22075367864747442,0.1748362047080075,126181.50686990228,-824.0289079332094,125357.47796196907,186,0,38.59574468085106,37,10,18,40.285546036596465,0.5796734234234234,48.82127192982456,1004.7149122807017,27.154457088667613,0
3930,4,3,4,41,0.06666666666666667,0.08888888888888889,0.9111111111111111,45,1150,800,350,0.6956521739130435,15,8,7,360.7876883100357,0.4753577441077441,0.2751812219537457,0.1869770899882243,126480.04979263118,126.48895640432511,126606.5387490355,187,0,41.15555555555556,35,10,17,39.451372109078356,0.5866071428571429,48.52430555555556,1005.9027777777778,28.740079365079367,0
3931,4,3,1,43,0.06818181818181818,0.022727272727272728,0.9772727272727273,44,1300,900,400,0.6923076923076923,17,9,8,362.7764972088453,0.473033386187456,0.2762514880020046,0.19003202074008466,126917.01630015433,408.5021219135838,127325.51842206791,188,0,40.70454545454545,35,9,20,38.951585113714685,0.5910714285714286,48.09027777777778,1007.6388888888889,28.78968253968254,0
3932,4,0,1,42,0.0,0.023255813953488372,0.9767441860465116,43,1300,800,500,0.6153846153846154,18,8,10,366.473040129206,0.47141472868217055,0.284337580931872,0.19294348350756435,127122.90833153088,717.5443005360854,127840.45263206697,189,1,42.46511627906977,33,10,20,38.64673208571311,0.5975378787878788,47.88602941176469,1008.455882352939,30.559269162210274,0
3933,4,0,3,39,0.0,0.07142857142857142,0.9285714285714286,42,1250,900,350,0.72,16,9,7,364.14928516111087,0.4704195702671312,0.2764292737744065,0.1922844356224555,127242.10778061207,867.0245181405674,128109.13229875264,190,2,43.833333333333336,34,8,20,38.58284169124875,0.5965073529411764,47.76785714285713,1008.9285714285701,29.67436974789912,0
3934,4,1,0,40,0.025,0.0,1.0,40,1100,500,600,0.45454545454545453,17,5,12,376.1169604311912,0.4702190170940171,0.28161580790395213,0.19943177822332903,127410.50020406065,1584.2500127537776,128994.75021681443,191,0,45.5,32,8,19,38.107856011338995,0.6028645833333333,47.60101010101009,1009.5959595959583,31.549873737373698,0
3935,4,1,0,41,0.024390243902439025,0.0,1.0,41,1400,900,500,0.6428571428571429,19,9,10,366.5021569162987,0.47002032520325204,0.2851234447342119,0.1959909519227459,127753.08956916087,1164.3565759637002,128917.44614512457,192,0,45.36585365853659,34,7,20,37.998999057936864,0.6017156862745099,47.26190476190475,1010.9523809523799,29.733893557422938,0
3936,4,0,2,39,0.0,0.04878048780487805,0.9512195121951219,41,1200,900,300,0.75,15,9,6,370.5938678465797,0.47019817073170733,0.29437075352276443,0.19892205275378297,127903.57320011318,1280.0559807256016,129183.62918083879,193,1,46.36585365853659,34,7,20,37.74126162174887,0.6032475490196079,47.11309523809523,1011.5476190476176,29.751400560224045,0
3937,4,1,0,40,0.025,0.0,1.0,40,900,500,400,0.5555555555555556,13,5,8,378.9269763226992,0.46989850427350427,0.30300266634347395,0.20288945370789027,127803.53597474514,1685.6414900518866,129489.17746479703,194,0,48.25,33,7,21,37.63319092635238,0.6044823232323233,47.21200980392156,1011.1519607843125,30.64096850861553,0
3938,4,1,3,38,0.024390243902439025,0.07317073170731707,0.926829268292683,41,1300,1100,200,0.8461538461538461,15,11,4,370.40464801621135,0.4690802845528455,0.1843021404748606,0.18355258962669743,124626.34802578717,1205.9905074353483,125832.33853322252,195,0,48.048780487804876,38,3,18,41.127666024680785,0.5619517543859649,50.373931623931625,998.5042735042739,26.27642825011247,16
3939,4,5,2,41,0.11627906976744186,0.046511627906976744,0.9534883720930233,43,1500,1000,500,0.6666666666666666,20,10,10,343.8717199584656,0.47386028054632706,0.21027475153692698,0.17588922724131362,125941.8080032554,62.12452598916545,126003.93252924456,196,0,44.44186046511628,40,3,22,40.430841011103254,0.5721354166666667,49.0599593495935,1003.7601626016265,25.09400406504066,0
3940,4,2,3,40,0.046511627906976744,0.06976744186046512,0.9302325581395349,43,1150,800,350,0.6956521739130435,15,8,7,334.97835128336243,0.4739294942783315,0.20817431309771006,0.17295267448852367,126326.6999051415,-136.4928229866331,126190.20708215487,197,0,44.46511627906977,36,7,17,40.258018744632395,0.5830439814814814,48.676801801801794,1005.2927927927917,27.92479979979977,0
3941,4,4,3,41,0.09090909090909091,0.06818181818181818,0.9318181818181819,44,1750,1400,350,0.8,21,14,7,356.6505728897772,0.4754008104298802,0.26066425476420885,0.17882178376213623,125115.76753257867,692.8067456845961,125808.57427826326,198,0,42.70454545454545,35,9,19,40.96386703686566,0.5726190476190476,49.884259259259245,1000.4629629629612,28.584656084656036,16
3942,4,2,2,41,0.046511627906976744,0.046511627906976744,0.9534883720930233,43,1550,1000,550,0.6451612903225806,21,10,11,352.7475305879102,0.476375046142488,0.2892361260370553,0.17835178882996167,125463.39163237289,251.380315500661,125714.77194787355,199,0,44.395348837209305,35,8,18,40.702017868145404,0.5761904761904761,49.537037037037024,1001.8518518518499,28.62433862433857,0
3943,4,2,0,43,0.046511627906976744,0.0,1.0,43,1350,900,450,0.6666666666666666,18,9,9,349.48666111581065,0.4736295681063123,0.27745242536096737,0.17895885030714814,125987.30223043975,206.17631990096928,126193.47855034072,190,0,40.72093023255814,36,7,21,40.243036081510596,0.5795717592592593,49.01463963963963,1003.9414414414401,27.887262262262226,0
3944,4,2,4,41,0.044444444444444446,0.08888888888888889,0.9111111111111111,45,1100,800,300,0.7272727272727273,14,8,6,331.5050006259075,0.4758627946127946,0.16422775569040482,0.16149463791959343,123908.64257812497,-698.9452158027982,123209.69736232217,191,0,39.86666666666667,39,6,17,42.84238334379578,0.5528846153846154,51.09375,995.6249999999998,25.52884615384615,16
3945,4,6,5,42,0.1276595744680851,0.10638297872340426,0.8936170212765957,47,1400,1000,400,0.7142857142857143,18,10,8,316.36725624036336,0.4796099290780142,0.2273046404970367,0.1590556971266636,125228.76310603814,-1476.322261364761,123752.44084467337,192,0,38.48936170212766,40,7,15,41.85492605002199,0.56484375,49.771341463414636,1000.914634146342,25.02286585365855,0
3946,4,1,1,42,0.023255813953488372,0.023255813953488372,0.9767441860465116,43,1450,1200,250,0.8275862068965517,17,12,5,337.9707837527868,0.4781515319306017,0.23277817652205313,0.16875729011008112,124943.70003449393,-154.53595487379752,124789.16407962014,193,0,42.395348837209305,36,7,20,41.60893970113389,0.5688657407407407,50.056306306306304,999.7747747747746,27.771521521521517,0
3947,4,1,1,42,0.023255813953488372,0.023255813953488372,0.9767441860465116,43,2300,1900,400,0.8260869565217391,27,19,8,338.3553083031072,0.47849760059062385,0.2345833420551351,0.17009626584830423,125225.32667802944,-125.86919689959848,125099.45748112984,194,0,43.25581395348837,36,7,17,41.30827145214521,0.5717592592592593,49.77477477477478,1000.9009009009014,27.802802802802816,0
3948,4,1,1,42,0.023255813953488372,0.023255813953488372,0.9767441860465116,43,1000,600,400,0.6,14,6,8,340.75420125669694,0.47902823920265786,0.23856689380350504,0.1720015814969957,125394.45484335689,-54.262539566591386,125340.19230379029,195,0,44.23255813953488,36,7,18,41.073570197136654,0.5734953703703703,49.60585585585586,1001.5765765765767,27.821571571571575,0
3949,4,3,2,43,0.06666666666666667,0.044444444444444446,0.9555555555555556,45,2050,1600,450,0.7804878048780488,25,16,9,338.7468242198837,0.47897727272727275,0.26460006224712074,0.17465715806831106,126270.10192202347,-441.9265126613006,125828.17540936217,196,0,43.08888888888889,36,9,18,40.22152194211016,0.5824652777777778,48.73310810810811,1005.0675675675684,27.918543543543567,0
3950,4,7,8,42,0.14,0.16,0.84,50,1050,800,250,0.7619047619047619,13,8,5,302.99178803723214,0.4805697278911565,0.25716113059624535,0.16085445746072988,127459.90125868047,-2270.806709898254,125189.09454878222,197,0,39.58,39,11,16,39.90311876762258,0.5892094017094017,47.55208333333333,1009.791666666666,25.892094017094,0
3951,4,0,0,42,0.0,0.0,1.0,42,1350,1000,350,0.7407407407407407,17,10,7,349.58111795129844,0.4789367982965544,0.2488649743968887,0.1816860621988373,126596.50051708288,451.14923589682314,127047.6497529797,198,1,43.976190476190474,35,7,21,39.61340329691394,0.5877976190476191,48.40856481481484,1006.3657407407441,28.753306878306972,0
3952,4,2,2,42,0.045454545454545456,0.045454545454545456,0.9545454545454546,44,1100,600,500,0.5454545454545454,16,6,10,336.2261701425681,0.4801246476391825,0.24877403670586262,0.1770113970061753,127121.19187510741,-249.76999206958808,126871.42188303782,199,0,42.93181818181818,35,9,23,39.411057232487856,0.5931547619047619,47.887731481481495,1008.4490740740761,28.812830687830743,0
3953,4,1,0,43,0.023255813953488372,0.0,1.0,43,1150,700,450,0.6086956521739131,16,7,9,343.7733786840794,0.47985880398671094,0.24351077146057043,0.18112239205295536,127152.04081632661,142.29733560091614,127294.33815192753,200,0,44.13953488372093,34,9,24,39.18914266603714,0.5955882352941176,47.85714285714286,1008.5714285714292,29.663865546218506,0
3954,4,2,2,43,0.044444444444444446,0.044444444444444446,0.9555555555555556,45,1400,1000,400,0.7142857142857143,18,10,8,332.92157452786597,0.4794402356902357,0.23943275049188806,0.17825300045830147,127802.6987079988,-490.3448634444949,127312.35384455431,201,0,43.13333333333333,36,9,20,38.79700783309202,0.5980902777777778,47.21283783783785,1011.1486486486508,28.087462462462522,0
3955,4,1,0,44,0.022727272727272728,0.0,1.0,44,1500,1300,200,0.8666666666666667,17,13,4,341.02970946232057,0.47847295630725867,0.2559094030254476,0.18281703075348196,127851.72994898827,-79.75233624829292,127771.97761273998,202,0,45.02272727272727,35,9,21,38.54190508888381,0.6005952380952381,47.16435185185185,1011.342592592592,28.89550264550263,0
3956,4,0,1,43,0.0,0.022727272727272728,0.9772727272727273,44,1900,1400,500,0.7368421052631579,24,14,10,343.35335408893394,0.477393851303735,0.2511032417577006,0.18477015188844134,128005.79415060394,-9.756247114507232,127996.03790348943,203,1,46.02272727272727,37,7,21,38.325635677393734,0.5982545045045045,47.01206140350877,1011.9517543859641,27.35004741583687,0
3957,4,1,2,42,0.022727272727272728,0.045454545454545456,0.9545454545454546,44,1100,800,300,0.7272727272727273,14,8,6,337.2638121076249,0.47706351303735023,0.23754193367468734,0.1827907211998785,128291.05748724693,-146.1883485665603,128144.86913868037,204,0,43.36363636363637,35,9,22,38.18845443466999,0.6050595238095238,46.73032407407406,1013.0787037037024,28.945105820105784,0
3958,4,0,2,40,0.0,0.047619047619047616,0.9523809523809523,42,1250,900,350,0.72,16,9,7,337.8592626876919,0.47694057297715836,0.20139557135789588,0.1839222673636725,128466.99948827576,280.7531453617802,128747.75263363754,184,1,40.714285714285715,35,7,17,37.99389675381512,0.606845238095238,46.556712962962955,1013.7731481481471,28.96494708994706,0
3959,4,0,1,39,0.0,0.025,0.975,40,1450,900,550,0.6206896551724138,20,9,11,344.18878850604665,0.4757612179487179,0.18195667488552303,0.18755316133755578,128506.39349489778,846.0919784580265,129352.48547335582,185,2,41.9,34,6,18,37.793285977065466,0.609375,46.51785714285713,1013.9285714285701,29.82142857142853,0
3960,4,0,1,38,0.0,0.02564102564102564,0.9743589743589743,39,1450,800,650,0.5517241379310345,21,8,13,329.2079592124874,0.47525865946918583,0.06574207856403325,0.16583501220159944,125309.8764938927,450.60174194466504,125760.47823583736,186,3,42.205128205128204,36,3,16,41.44992126869869,0.5726273148148149,49.690315315315324,1001.2387387387402,27.812187187187227,16
3961,4,3,1,40,0.07317073170731707,0.024390243902439025,0.975609756097561,41,1050,500,550,0.47619047619047616,16,5,11,314.255319148936,0.476270325203252,0.07941878567721838,0.16124454148471595,126070.65892322295,-276.3249689531883,125794.33395426975,187,0,40.80487804878049,38,3,20,41.041666666666664,0.5767543859649122,48.931623931623925,1004.2735042735036,26.42825011246062,0
3962,4,1,1,40,0.024390243902439025,0.024390243902439025,0.975609756097561,41,1700,1400,300,0.8235294117647058,20,14,6,312.2996856017829,0.4758892276422764,0.08354669182050967,0.1615035516969216,126392.7469135799,-305.5169753086793,126087.22993827122,188,0,41.36585365853659,38,3,15,40.76024401473295,0.5800438596491229,48.61111111111109,1005.5555555555527,26.46198830409349,0
3963,4,1,4,37,0.024390243902439025,0.0975609756097561,0.9024390243902439,41,1400,900,500,0.6428571428571429,19,9,10,311.27232249867956,0.47505081300813007,0.09572284025568245,0.16192692160464117,126634.58256857652,-316.43187504570443,126318.15069353081,189,0,42.21951219512195,38,3,17,40.53820365849345,0.5825109649122807,48.37072649572647,1006.5170940170904,26.487291947818168,0
3964,4,3,4,36,0.075,0.1,0.9,40,1200,1000,200,0.8333333333333334,14,10,4,310.8034240817125,0.4758680555555555,0.08280620577027764,0.1622927487316953,126788.1478555897,-118.76190270088756,126669.38595288881,190,0,42.35,37,3,18,40.392737252767176,0.5858671171171171,48.21820175438594,1007.1271929824522,27.2196538643906,0
3965,4,1,1,36,0.02702702702702703,0.02702702702702703,0.972972972972973,37,1250,900,350,0.72,16,9,7,324.53308985850225,0.4739114114114114,0.08012981926025442,0.16854783053941502,126567.38281249948,815.06076388883,127382.44357638831,191,0,45.567567567567565,35,2,19,40.273464458247076,0.5875,48.43749999999997,1006.2499999999957,28.749999999999876,0
3966,4,3,2,37,0.07692307692307693,0.05128205128205128,0.9487179487179487,39,1150,800,350,0.6956521739130435,15,8,7,364.4685142713355,0.47584907782276203,0.0856588206745934,0.18174283891417833,124887.41275058838,1486.8826913907048,126374.29544197909,192,0,43.76923076923077,36,3,20,41.00500413098992,0.568287037037037,50.11261261261261,999.5495495495492,27.765265265265256,16
3967,4,4,1,40,0.0975609756097561,0.024390243902439025,0.975609756097561,41,1000,600,400,0.6,14,6,8,329.096944091718,0.4768038617886179,0.12734574182888458,0.16863381342079056,126015.56793279755,94.36911573734102,126109.93704853489,193,0,41.90243902439025,36,5,24,40.725708464184216,0.5798611111111112,48.98648648648648,1004.0540540540532,27.890390390390365,0
3968,4,3,6,37,0.06976744186046512,0.13953488372093023,0.8604651162790697,43,1250,800,450,0.64,17,8,9,310.9691787454981,0.47688261351052047,0.14667142773932662,0.16215956663372547,126732.93856042228,-717.9892647722473,126014.94929565003,194,0,40.604651162790695,37,6,18,40.44509328832263,0.5853040540540541,48.273026315789465,1006.9078947368408,27.213726884779483,0
3969,4,3,0,40,0.075,0.0,1.0,40,1650,1300,350,0.7878787878787878,20,13,7,317.7519204798743,0.47522702991452986,0.1589644772117964,0.16693164273097638,127035.2447041638,73.13859467577646,127108.38329883957,195,0,42.875,36,4,23,39.964765787905876,0.5902777777777778,47.97297297297298,1008.1081081081095,28.00300300300304,0
3970,4,3,2,41,0.06976744186046512,0.046511627906976744,0.9534883720930233,43,1300,1100,200,0.8461538461538461,15,11,4,296.28537579507025,0.47434477667035807,0.15840777908174242,0.15894646403149934,127880.99500868093,-1022.1462673610722,126858.84874131986,196,0,40.81395348837209,39,4,18,39.64340885684863,0.593482905982906,47.135416666666686,1011.4583333333363,25.934829059829138,0
3971,4,1,1,41,0.023809523809523808,0.023809523809523808,0.9761904761904762,42,1150,900,250,0.782608695652174,14,9,5,306.7139215999273,0.4725125822686798,0.1644041208501128,0.16495670366115397,127982.3229988499,-549.2079635108068,127433.11503533908,197,0,42.73809523809524,38,4,20,39.27647555696334,0.596217105263158,47.03525641025643,1011.858974358978,26.627867746288896,0
3972,4,1,3,39,0.023809523809523808,0.07142857142857142,0.9285714285714286,42,1150,700,450,0.6086956521739131,16,7,9,300.9758852329588,0.4740006775067751,0.14778680167352287,0.16296701130175245,128252.72715547176,-679.8043821681376,127572.92277330362,198,0,41.26190476190476,38,4,21,39.14649474387371,0.5989583333333333,46.768162393162406,1012.9273504273522,26.655982905982953,0
3973,4,0,2,37,0.0,0.05128205128205128,0.9487179487179487,39,1100,700,400,0.6363636363636364,15,7,8,346.3520073671298,0.47222222222222227,0.17812278427019024,0.16838977883617742,123824.05072955124,777.3417061018627,124601.3924356531,132,1,38.1025641025641,37,2,17,42.56075336932173,0.5554617117117118,51.17872807017543,995.2850877192968,26.8995969653864,16
3974,4,7,10,34,0.1590909090909091,0.22727272727272727,0.7727272727272727,44,1350,900,450,0.6666666666666666,18,9,9,302.0505218614413,0.4767331747709655,0.17687541386812966,0.15197411073761505,125260.55230034713,-1232.7715318655835,124027.78076848155,133,0,34.27272727272727,39,5,12,42.18045438779049,0.5667735042735043,49.73958333333333,1001.0416666666658,25.66773504273502,0
3975,4,4,1,37,0.10526315789473684,0.02631578947368421,0.9736842105263158,38,1200,1000,200,0.8333333333333334,14,10,4,344.14485583892684,0.4746177098150783,0.22261227150773544,0.17158196019142696,124880.98072562361,995.4294217687111,125876.41014739232,134,0,39.44736842105263,34,4,20,41.51952318564395,0.5723039215686274,50.11904761904762,999.5238095238097,29.397759103641462,0
3976,4,2,1,38,0.05128205128205128,0.02564102564102564,0.9743589743589743,39,1150,800,350,0.6956521739130435,15,8,7,333.25629128909486,0.47525865946918583,0.21865139972380487,0.1679459955681592,125327.59530895697,553.2986111111175,125880.89392006809,135,0,39.15384615384615,34,5,16,41.33030158918878,0.5768995098039216,49.67261904761905,1001.3095238095242,29.45028011204483,0
3977,4,2,2,38,0.05,0.05,0.95,40,1150,600,550,0.5217391304347826,17,6,11,332.0281698881582,0.4750267094017094,0.24470360973359484,0.16965328586330095,125898.59992551859,360.37634495026,126258.97627046885,136,0,39.125,35,5,18,40.77252239264983,0.580654761904762,49.10300925925925,1003.587962962962,28.673941798941772,0
3978,4,5,1,42,0.11627906976744186,0.023255813953488372,0.9767441860465116,43,650,400,250,0.6153846153846154,9,4,5,314.9764411571197,0.4754983388704319,0.26034571653415184,0.1645032083539147,126795.93474915957,-612.4535439038925,126183.48120525568,137,0,37.18604651162791,38,5,18,40.27969308015985,0.5841557017543859,48.21047008547007,1007.1581196581169,26.504161043634657,0
3979,4,0,0,42,0.0,0.0,1.0,42,800,400,400,0.5,12,4,8,323.19870860003243,0.4751500193573364,0.26877119830724716,0.16842284576421665,126705.33842143734,-209.7996498922795,126495.53877154506,138,1,39.07142857142857,37,5,18,40.165541276410366,0.5850225225225225,48.300438596491226,1006.7982456140348,27.210763394973913,0
3980,4,4,2,44,0.08695652173913043,0.043478260869565216,0.9565217391304348,46,1600,1200,400,0.75,20,12,8,296.683208175341,0.47618760064412236,0.2686608590748354,0.15857645737346138,127733.27637525613,-1620.1472312718208,126113.1291439843,139,0,36.58695652173913,40,6,17,39.78377065111759,0.5903645833333333,47.28150406504065,1010.8739837398374,25.271849593495936,0
3981,4,0,3,41,0.0,0.06818181818181818,0.9318181818181819,44,1550,1200,350,0.7741935483870968,19,12,7,314.0279155608238,0.47492732558139533,0.2806587448084916,0.16719864693373593,127577.25180802103,-787.4363083497644,126789.81549967127,140,1,39.25,38,6,17,39.50467956852794,0.5921052631578947,47.43589743589744,1010.2564102564102,26.585695006747635,0
3982,4,1,1,41,0.023809523809523808,0.023809523809523808,0.9761904761904762,42,1100,700,400,0.6363636363636364,15,7,8,312.92016050007544,0.4760331978319783,0.2514781882318602,0.16739194340374325,127766.20513048815,-403.87571681640566,127362.32941367174,141,0,37.523809523809526,38,4,18,39.339841135651135,0.5940241228070176,47.24893162393163,1011.0042735042748,26.605375618533547,0
3983,4,3,4,40,0.06818181818181818,0.09090909090909091,0.9090909090909091,44,1450,1000,450,0.6896551724137931,19,10,9,310.41699714282754,0.47533474277660326,0.27342786683107234,0.16895851320995542,128461.13281250028,-824.1368811180233,127636.99593138225,142,0,36.56818181818182,39,5,13,38.695369228661455,0.5993589743589743,46.562500000000014,1013.7500000000022,25.993589743589798,0
3984,4,0,2,38,0.0,0.05,0.95,40,1100,900,200,0.8181818181818182,13,9,4,342.7500303026404,0.4745592948717949,0.28808026271846887,0.1840360742503657,127916.59216226354,768.6831679652576,128685.27533022879,143,1,40.7,36,4,21,38.43208467846676,0.5992476851851851,47.10022522522522,1011.5990990990985,28.099974974974955,0
3985,4,0,2,36,0.0,0.05263157894736842,0.9473684210526316,38,1300,800,500,0.6153846153846154,18,8,10,365.95774396536325,0.4741287339971551,0.20143673948101437,0.17997100011447328,124306.5200617285,1498.1867283950733,125804.70679012357,144,2,40.8421052631579,38,0,15,41.57091457753019,0.5586622807017544,50.69444444444445,997.2222222222231,26.242690058479553,16
3986,4,3,2,37,0.07692307692307693,0.05128205128205128,0.9487179487179487,39,800,500,300,0.625,11,5,6,360.66096278021223,0.47621457489878544,0.21113310414279196,0.18021783351000853,124973.9596896704,1214.6457248264123,126188.60541449682,145,0,38.64102564102564,39,0,18,41.01045681841857,0.5638354700854701,50.02604166666668,999.8958333333355,25.63835470085476,0
3987,4,5,2,40,0.11904761904761904,0.047619047619047616,0.9523809523809523,42,850,800,50,0.9411764705882353,9,8,1,331.8634965509668,0.48158633372048004,0.22618034878774984,0.17072452524974238,126177.97592957849,-25.216293362830612,126152.75963621566,146,0,35.5,38,4,19,40.48919785906706,0.5778508771929824,48.824786324786324,1004.7008547008546,26.43949617633828,0
3988,4,0,1,39,0.0,0.025,0.975,40,1300,800,500,0.6153846153846154,18,8,10,339.94816678444016,0.47920673076923076,0.22427636479727608,0.17408680780781385,125990.2011309263,566.0275814522593,126556.22871237856,147,1,38.1,38,2,19,40.47945266219715,0.5759320175438596,49.011752136752136,1003.9529914529916,26.419815564552408,0
3989,4,1,1,39,0.025,0.025,0.975,40,1150,1000,150,0.8695652173913043,13,10,3,340.8069925446896,0.479553952991453,0.21975754997873254,0.17532543533316503,126177.97592957836,600.4673003871562,126778.44322996552,148,0,38.525,38,2,20,40.26455940734439,0.5778508771929824,48.82478632478632,1004.7008547008536,26.439496176338253,0
3990,4,4,6,37,0.09302325581395349,0.13953488372093023,0.8604651162790697,43,1200,900,300,0.75,15,9,6,380.53887959391113,0.48045865633074936,0.16956310445080436,0.19353322882019725,125705.64994533356,1272.1240417894528,126977.77398712302,149,0,35.651162790697676,33,10,20,39.755056214102396,0.5830176767676767,49.2953431372549,1002.8186274509807,30.388443256090323,16
3991,4,0,1,36,0.0,0.02702702702702703,0.972972972972973,37,1150,1000,150,0.8695652173913043,13,10,3,405.5245850241176,0.4752252252252252,0.24302934725469938,0.2052400394673995,125504.5403550988,2779.0353292288055,128283.5756843276,150,1,41.62162162162162,30,7,20,39.337413369103515,0.5885416666666667,49.49596774193548,1002.0161290322576,33.400537634408586,0
3992,4,3,1,38,0.07692307692307693,0.02564102564102564,0.9743589743589743,39,750,400,350,0.5333333333333333,11,4,7,381.4760255644279,0.4759896536212325,0.23767135670910045,0.19610633211851516,126148.45920138895,1827.9911785322097,127976.45037992115,151,0,40.282051282051285,29,10,23,39.27355523296006,0.5980603448275862,48.85416666666667,1004.5833333333339,34.64080459770117,0
3993,4,1,6,33,0.02564102564102564,0.15384615384615385,0.8461538461538461,39,1100,600,500,0.5454545454545454,16,6,10,369.97029435592754,0.47601776878092666,0.23506927854753967,0.1921458625525946,126567.38281250001,1565.2343750000014,128132.61718750001,152,0,40.87179487179487,31,8,20,39.130434782608695,0.5967741935483871,48.4375,1006.2500000000001,32.45967741935484,0
3994,4,6,3,36,0.15384615384615385,0.07692307692307693,0.9230769230769231,39,900,500,400,0.5555555555555556,13,5,8,347.7008830168259,0.47674876293297347,0.20357634112792344,0.18450988463739604,127442.3707561729,1063.4500385802592,128505.82079475315,153,0,37.743589743589745,32,7,16,38.79241173773499,0.6031901041666667,47.56944444444445,1009.7222222222227,31.55381944444446,0
3995,4,1,2,35,0.02702702702702703,0.05405405405405406,0.9459459459459459,37,1000,600,400,0.6,14,6,8,379.27397852831257,0.47491241241241244,0.20537531077832316,0.18722062787690494,124463.95975219335,2041.188239720403,126505.14799191375,154,0,40.75675675675676,32,5,18,41.07511915306425,0.5725911458333333,50.536616161616145,997.8535353535328,31.1829229797979,16
3996,4,1,1,35,0.027777777777777776,0.027777777777777776,0.9722222222222222,36,800,300,500,0.375,13,3,10,378.1833580864117,0.47539682539682543,0.20058025818229286,0.18747822709532577,124642.18351576054,2227.519904242617,126869.70342000315,155,0,41.888888888888886,31,5,20,40.91703068631286,0.5769489247311828,50.358072916666664,998.5677083333326,32.21186155913976,0
3997,4,6,0,41,0.14634146341463414,0.0,1.0,41,1250,900,350,0.72,16,9,7,364.1167273196178,0.47802337398373984,0.2693920500054967,0.17726435032205848,123880.72197567398,903.3016859427105,124784.0236616167,156,0,37.53658536585366,38,3,20,42.059723116548604,0.5542763157894737,51.121794871794876,995.5128205128211,26.197705802968976,16
3998,4,3,4,40,0.06818181818181818,0.09090909090909091,0.9090909090909091,44,1650,1200,450,0.7272727272727273,21,12,9,346.25537708738597,0.480157681465821,0.2751593977310136,0.17210762360301038,124753.41120585208,-160.58938352785964,124592.82182232423,157,0,35.90909090909091,37,7,18,41.59886858376321,0.5650337837837838,50.2467105263158,999.0131578947392,27.000355618776734,0
3999,4,3,1,42,0.06976744186046512,0.023255813953488372,0.9767441860465116,43,1150,800,350,0.6956521739130435,15,8,7,346.838308669474,0.4797203765227021,0.2885430639823867,0.17475237089689089,125318.4896503128,93.5375277358454,125412.02717804864,158,0,34.83720930232558,35,8,18,40.999715832466386,0.574702380952381,49.681712962962955,1001.2731481481471,28.607804232804202,0
4000,4,6,5,43,0.125,0.10416666666666667,0.8958333333333334,48,1700,1300,400,0.7647058823529411,21,13,8,305.50421595431277,0.4808843085106383,0.28160731100349823,0.15971296353054557,126835.96073765599,-1848.1227396518425,124987.83799800415,159,0,31.895833333333332,40,8,13,40.477241390906656,0.58125,48.17073170731707,1007.3170731707303,25.182926829268258,0
4001,4,0,2,41,0.0,0.046511627906976744,0.9534883720930233,43,900,500,400,0.5555555555555556,13,5,8,338.69773985857245,0.47877445551864156,0.3043141711125419,0.17439122520242586,126213.51662050556,-50.35343620648723,126163.16318429908,160,1,36.30232558139535,36,7,20,40.28096865777577,0.5818865740740741,48.78941441441441,1004.8423423423417,27.91228728728727,0
4002,4,4,5,40,0.08888888888888889,0.1111111111111111,0.8888888888888888,45,1350,700,650,0.5185185185185185,20,7,13,317.23861922058416,0.47878787878787876,0.27514843087362184,0.166233036471586,126930.47337278089,-946.5503780407842,125983.9229947401,161,0,34.93333333333333,38,7,14,40.08495016963527,0.5855263157894737,48.076923076923066,1007.6923076923063,26.518218623481744,0
4003,4,1,2,39,0.024390243902439025,0.04878048780487805,0.9512195121951219,41,1400,1200,200,0.8571428571428571,16,12,4,340.9933601670033,0.47721036585365856,0.28238145735494635,0.1770965515706048,126567.38281249988,431.7274305555418,126999.11024305543,162,0,36.97560975609756,35,6,15,39.85938578329882,0.5875,48.43749999999999,1006.2499999999991,28.749999999999975,0
4004,4,2,3,38,0.04878048780487805,0.07317073170731707,0.926829268292683,41,900,500,400,0.5555555555555556,13,5,8,354.3751149685341,0.47830284552845526,0.17177740722946044,0.17596416813454813,124710.81559713639,1110.8871313442971,125821.70272848068,163,0,36.926829268292686,35,6,17,41.44022788721514,0.5684523809523809,50.28935185185185,998.8425925925918,28.538359788359767,16
4005,4,6,4,40,0.13636363636363635,0.09090909090909091,0.9090909090909091,44,950,300,650,0.3157894736842105,16,3,13,328.43575131640614,0.4815781360112756,0.173927914327499,0.16787684158798816,125913.11984592034,-529.1259765624761,125383.99386935787,164,0,33.79545454545455,39,5,16,40.84771233350632,0.5734508547008548,49.08854166666668,1003.6458333333351,25.73450854700859,0
4006,4,0,1,39,0.0,0.025,0.975,40,1200,800,400,0.6666666666666666,16,8,8,387.6751696872486,0.4771501068376069,0.1634938704028024,0.18416183185642135,122839.28011670493,1566.8010947144717,124406.0812114194,165,1,38.05,35,5,19,42.56239054290719,0.5491071428571428,52.17013888888887,991.3194444444418,28.323412698412625,15
4007,4,6,5,40,0.13333333333333333,0.1111111111111111,0.8888888888888888,45,1200,900,300,0.75,15,9,6,356.6669059597718,0.4811026936026936,0.20977948681430814,0.17856233013879066,125053.42451055601,322.8032373164633,125376.22774787247,166,0,34.48888888888889,38,7,17,41.02800327565333,0.5663377192982456,49.9465811965812,1000.213675213676,26.32141250562305,16
4008,4,5,6,39,0.1111111111111111,0.13333333333333333,0.8666666666666667,45,1500,1000,500,0.6666666666666666,20,10,10,350.9061452501794,0.4794191919191919,0.22232376732324788,0.1786819287474342,125756.3490125869,-174.26486545137882,125582.08414713552,167,0,34.86666666666667,39,6,19,40.445637310901105,0.5718482905982907,49.24479166666667,1003.0208333333342,25.718482905982928,0
4009,4,0,1,38,0.0,0.02564102564102564,0.9743589743589743,39,700,500,200,0.7142857142857143,9,5,4,381.8599032708871,0.47913855150697254,0.24303153425209145,0.19175115572849902,125178.63520408148,1760.1403061224316,126938.77551020391,168,1,40.35897435897436,34,5,21,40.26811206281227,0.5753676470588236,49.82142857142856,1000.7142857142844,29.43277310924366,0
4010,4,1,2,37,0.02564102564102564,0.05128205128205128,0.9487179487179487,39,1600,1100,500,0.6875,21,11,10,381.5738926486858,0.4793915879442195,0.2583472670181304,0.1934058159066399,125566.11571712034,1782.5503117914002,127348.66602891174,169,0,41.23076923076923,34,5,20,39.87359939818663,0.5793504901960784,49.43452380952382,1002.2619047619061,29.47829131652665,0
4011,4,3,3,37,0.075,0.075,0.925,40,1450,1200,250,0.8275862068965517,17,12,5,365.2693226521417,0.4797008547008547,0.24124780095501386,0.1880215568994661,126202.37252576274,1222.2921143511007,127424.66464011384,170,0,40.475,32,8,23,39.624958113428825,0.5904947916666667,48.80050505050505,1004.7979797979802,31.399936868686883,0
4012,4,5,4,38,0.11904761904761904,0.09523809523809523,0.9047619047619048,42,1150,700,450,0.6086956521739131,16,7,9,327.99362248029524,0.48100561362756483,0.20178653229500676,0.1750635887223679,127676.20991941015,-21.47879964062821,127654.73111976952,171,0,34.595238095238095,35,7,17,39.05080928386013,0.5988095238095238,47.33796296296296,1010.6481481481482,28.875661375661377,0
4013,4,2,2,38,0.05,0.05,0.95,40,1200,700,500,0.5833333333333334,17,7,10,344.2236156871083,0.4817975427350427,0.21953608247422718,0.18345983912994207,127617.73003472203,785.8072916666415,128403.53732638867,172,0,37.125,33,7,18,38.70060137457044,0.6025883838383839,47.39583333333332,1010.416666666665,30.61868686868682,0
4014,4,2,2,38,0.05,0.05,0.95,40,1050,700,350,0.6666666666666666,14,7,7,341.93334762748725,0.480715811965812,0.22397034596375653,0.18367570089370325,127933.68055555546,748.9583333333233,128682.63888888879,173,0,37.8,34,6,22,38.43526908292149,0.6035539215686274,47.08333333333333,1011.6666666666658,29.754901960784288,0
4015,4,3,3,38,0.07317073170731707,0.07317073170731707,0.926829268292683,41,1200,900,300,0.75,15,9,6,334.0563484155461,0.4794715447154472,0.23048307975154403,0.1820318566510047,128506.39349489778,385.8489229024706,128892.24241780025,174,0,37.58536585365854,34,7,18,38.05012523971663,0.609375,46.51785714285713,1013.9285714285701,29.82142857142853,0
4016,4,0,0,38,0.0,0.0,1.0,38,1450,1000,450,0.6896551724137931,19,10,9,357.41818831477417,0.47863323850165956,0.2266594948613332,0.19348337417540926,128243.42727661147,1567.3066880968013,129810.73396470827,175,1,40.18421052631579,31,7,23,37.72670544628699,0.6139112903225806,46.77734375000001,1012.8906250000011,32.67389112903229,0
4017,4,3,2,39,0.07317073170731707,0.04878048780487805,0.9512195121951219,41,900,400,500,0.4444444444444444,14,4,10,331.68049074532735,0.47812499999999997,0.2294705448811345,0.18365032619867733,129140.8801020408,366.7020975056753,129507.58219954648,176,0,38.170731707317074,34,7,22,37.464618958382154,0.6158088235294117,45.892857142857146,1016.4285714285713,29.894957983193276,0
4018,4,0,1,38,0.0,0.02564102564102564,0.9743589743589743,39,1050,600,450,0.5714285714285714,15,6,9,351.99050828933963,0.47787336932073776,0.24097653372619132,0.19346245230038164,128848.62075617304,1270.6983024691547,130119.3190586422,177,1,40.92307692307692,32,7,22,37.246352029183754,0.6175130208333333,46.180555555555564,1015.2777777777794,31.727430555555607,0
4019,4,1,0,39,0.02564102564102564,0.0,1.0,39,1200,800,400,0.6666666666666666,16,8,8,339.9954491062351,0.477929599640126,0.21715458157974465,0.18884084582888505,129263.69214965419,989.8134131103743,130253.50556276456,178,0,38.07692307692308,33,6,23,37.128424519964675,0.6193181818181819,45.77205882352943,1016.911764705884,30.815508021390425,0
4020,4,0,3,36,0.0,0.07692307692307693,0.9230769230769231,39,1200,900,300,0.75,15,9,6,367.9814362758774,0.47762033288349076,0.14709987883183562,0.187655787966903,125817.77459469617,1459.7210808781902,127277.49567557436,179,1,39.07692307692308,36,3,16,39.95397912223595,0.5778356481481481,49.183558558558566,1003.2657657657667,27.868493493493517,16
4021,4,1,1,36,0.02702702702702703,0.02702702702702703,0.972972972972973,37,1000,700,300,0.7,13,7,6,379.8605460284253,0.47669544544544545,0.1556251242935318,0.1935129964229448,125775.00708616764,2155.3925736961273,127930.39965986376,180,0,40.83783783783784,34,3,18,39.70028285465623,0.5814950980392157,49.22619047619047,1003.0952380952368,29.50280112044814,0
4022,4,2,0,38,0.05263157894736842,0.0,1.0,38,1400,900,500,0.6428571428571429,19,9,10,361.4836170446641,0.4769885016595543,0.15060781467104478,0.18698420778789185,126402.72285997716,1538.7896825396642,127941.51254251682,181,0,39.89473684210526,34,4,16,39.51353537745156,0.5879289215686274,48.60119047619047,1005.5952380952368,29.576330532212847,0
4023,4,3,1,40,0.07317073170731707,0.024390243902439025,0.975609756097561,41,1200,800,400,0.6666666666666666,16,8,8,335.41630708930427,0.4770071138211382,0.15302717082681805,0.1773495925719612,127296.33012099171,343.20157380722685,127639.53169479893,182,0,37.90243902439025,35,6,19,39.25204056275568,0.5949404761904762,47.71412037037036,1009.1435185185167,28.832671957671906,0
4024,4,2,2,40,0.047619047619047616,0.047619047619047616,0.9523809523809523,42,1250,1000,250,0.8,15,10,5,330.24428073215574,0.47770276809910955,0.16577861763809953,0.17698099948824347,127839.40882050236,43.64672303015425,127883.05554353251,183,0,37.904761904761905,37,5,18,38.82718475550255,0.5965653153153153,47.176535087719294,1011.2938596491219,27.332266477003294,0
4025,4,1,1,40,0.024390243902439025,0.024390243902439025,0.975609756097561,41,1400,900,500,0.6428571428571429,19,9,10,335.64912872455966,0.47779471544715446,0.16071486772774124,0.17984064295623792,127831.16731596473,381.2839866894019,128212.45130265414,184,0,38.21951219512195,36,5,20,38.69896065330363,0.5983796296296297,47.18468468468469,1011.2612612612622,28.09059059059062,0
4026,4,1,1,40,0.024390243902439025,0.024390243902439025,0.975609756097561,41,1450,1100,350,0.7586206896551724,18,11,7,334.23440910494895,0.4771341463414634,0.16307570552780493,0.1806224830906414,128174.66695011339,368.8440508903804,128543.51100100376,185,0,37.8780487804878,34,7,22,38.38393486950387,0.6060049019607843,46.845238095238095,1012.6190476190477,29.78291316526611,0
4027,4,1,3,38,0.024390243902439025,0.07317073170731707,0.926829268292683,41,1550,1000,550,0.6451612903225806,21,10,11,335.4755523854291,0.47693089430894314,0.12172674567113773,0.1782602808712454,127496.31461620623,422.83523863191454,127919.14985483815,186,0,38.09756097560975,38,3,15,39.04580556437109,0.591282894736842,47.51602564102563,1009.9358974358958,26.577260458839362,15
4028,4,1,4,35,0.02564102564102564,0.10256410256410256,0.8974358974358975,39,1200,700,500,0.5833333333333334,17,7,10,347.00274954230997,0.4738529014844804,0.15856634265370628,0.18513690097459498,127660.40322416998,1059.7021852933826,128720.10540946336,187,0,40.53846153846154,36,3,17,38.586704182453005,0.5966435185185186,47.353603603603595,1010.5855855855845,28.07182182182179,0
4029,4,0,1,34,0.0,0.02857142857142857,0.9714285714285714,35,1250,900,350,0.72,16,9,7,374.21994066138245,0.47251400560224094,0.1769626769626773,0.19780196863530203,127283.05785123962,2526.371671258032,129809.42952249765,188,1,44.31428571428572,32,3,20,38.28672422422424,0.6015625,47.72727272727273,1009.0909090909087,31.534090909090896,0
4030,4,0,1,33,0.0,0.029411764705882353,0.9705882352941176,34,1300,900,400,0.6923076923076923,17,9,8,377.3524558922571,0.47077391562685683,0.1187877006619924,0.18948773860396123,125178.6352040816,2647.293083900223,127825.92828798182,189,2,46.11764705882353,34,0,21,40.38087873740979,0.5753676470588236,49.82142857142857,1000.7142857142853,29.432773109243687,14
4031,4,2,3,32,0.05714285714285714,0.08571428571428572,0.9142857142857143,35,800,300,500,0.375,13,3,10,353.18074449794165,0.47296918767507007,0.0335965197732373,0.16940083897972008,123250.21435657606,1720.4329648526204,124970.64732142868,190,0,45.371428571428574,34,1,15,42.988450625424605,0.555453431372549,51.75595238095239,992.9761904761913,29.205182072829157,16
4032,4,4,1,35,0.1111111111111111,0.027777777777777776,0.9722222222222222,36,1150,700,450,0.6086956521739131,16,7,9,383.32928036826894,0.4783564814814815,0.07344814635978336,0.17680956339480725,121571.4569160997,2588.1271258503343,124159.58404195005,191,0,42.75,34,2,16,44.00148881377756,0.5379901960784313,53.45238095238095,986.1904761904757,29.005602240896344,14
4033,4,7,5,37,0.16666666666666666,0.11904761904761904,0.8809523809523809,42,1250,800,450,0.64,17,8,9,330.98236805304117,0.48501016260162605,0.11921588423355223,0.15875933925256022,123251.76977531538,-225.74443038989733,123026.02534492548,192,0,37.26190476190476,37,5,15,43.537893845700815,0.5495495495495495,51.754385964912274,992.98245614035,26.83736367946892,0
4034,4,3,0,40,0.075,0.0,1.0,40,900,400,500,0.4444444444444444,14,4,10,349.0257460671368,0.48442841880341886,0.13611434899172403,0.16737237984963474,123241.18448055975,602.8692719049959,123844.05375246475,193,0,40.0,35,5,20,43.10100730465866,0.5532738095238094,51.76504629629629,992.9398148148141,28.369708994708976,0
4035,4,8,6,42,0.16666666666666666,0.125,0.875,48,1500,900,600,0.6,21,9,12,321.89948764042106,0.4895279255319149,0.19016869996187613,0.15492520295060974,123395.33473943968,-1429.7983495696446,121965.53638987005,194,0,34.166666666666664,43,5,13,43.614182234083124,0.5416666666666667,51.60984848484848,993.5606060606046,23.106060606060574,16
4036,4,10,6,46,0.19230769230769232,0.11538461538461539,0.8846153846153846,52,1100,400,700,0.36363636363636365,18,4,14,306.6441679560525,0.4912094645550528,0.27054039150813414,0.15358989547842428,125072.68498174663,-2685.3896770137817,122387.29530473285,195,0,31.596153846153847,42,10,15,42.25899286383156,0.5602678571428572,49.92732558139534,1000.2906976744165,23.816445182724202,0
4037,4,3,1,48,0.061224489795918366,0.02040816326530612,0.9795918367346939,49,1200,800,400,0.6666666666666666,16,8,8,321.93451604718234,0.49261267006802717,0.29003630006434555,0.16154385715680955,125148.85381235792,-1742.0528628118234,123406.8009495461,196,0,34.04081632653061,41,8,19,41.79803688280785,0.5625,49.85119047619046,1000.5952380952351,24.40476190476183,0
4038,4,4,9,43,0.07692307692307693,0.17307692307692307,0.8269230769230769,52,1500,1000,500,0.6666666666666666,20,10,10,322.48826396531973,0.49344048516842637,0.33275610645278886,0.1659634724309328,126193.31065759639,-2251.261337868481,123942.04931972791,197,0,32.88461538461539,41,11,15,40.708925750394954,0.5731707317073171,48.80952380952381,1004.7619047619048,24.506387921022068,0
4039,4,3,2,44,0.06521739130434782,0.043478260869565216,0.9565217391304348,46,1300,800,500,0.6153846153846154,18,8,10,345.62272115669384,0.4910929951690821,0.32374752649196425,0.17780284845500816,126177.9759295785,-478.0049218350527,125699.97100774346,198,0,34.93478260869565,38,8,18,40.143600241032175,0.5778508771929824,48.824786324786324,1004.7008547008547,26.43949617633828,0
4040,4,2,5,41,0.043478260869565216,0.10869565217391304,0.8913043478260869,46,1550,1300,250,0.8387096774193549,18,13,5,344.9831048351957,0.49038848631239934,0.31518391096538845,0.17875706835571636,126473.33311646206,-473.7673725253908,125999.56574393668,199,0,35.45652173913044,38,8,17,39.855726677288004,0.5808662280701755,48.5309829059829,1005.8760683760679,26.470422852001786,0
4041,4,0,1,40,0.0,0.024390243902439025,0.975609756097561,41,1150,1000,150,0.8695652173913043,13,10,3,367.8978212594849,0.48851626016260163,0.29621766956124573,0.18852255857124525,126017.01754145659,1072.2772390240289,127089.29478048062,200,1,40.073170731707314,38,3,18,39.75025714691071,0.5762061403508771,48.98504273504273,1004.0598290598285,26.422627080521803,0
4042,4,2,1,41,0.047619047619047616,0.023809523809523808,0.9761904761904762,42,1250,1000,250,0.8,15,10,5,360.1603439004296,0.48802264808362367,0.30254435375713706,0.18771928289933143,126713.0048252103,727.4112931751599,127440.41611838546,201,0,39.857142857142854,35,7,20,39.22732976970534,0.5889880952380953,48.29282407407409,1006.8287037037057,28.76653439153445,0
4043,4,1,0,42,0.023809523809523808,0.0,1.0,42,1300,800,500,0.6153846153846154,18,8,10,376.6235295040402,0.48738143631436315,0.214307732109142,0.18975947313566977,125318.48965031281,1104.6925904492298,126423.18224076203,202,0,40.5,35,7,16,40.254137286633515,0.574702380952381,49.681712962962955,1001.2731481481472,28.607804232804206,15
4044,4,5,2,45,0.10638297872340426,0.0425531914893617,0.9574468085106383,47,1050,700,350,0.6666666666666666,14,7,7,378.5443149395244,0.48820536540240517,0.08470806917383089,0.19106055580805914,125390.93017578124,652.7924797989527,126043.72265558019,203,0,37.08510638297872,39,8,14,40.130980239209585,0.5681089743589743,49.609375,1001.5624999999999,25.68108974358974,16
4045,4,1,6,40,0.021739130434782608,0.13043478260869565,0.8695652173913043,46,950,600,350,0.631578947368421,13,6,7,376.5111665319563,0.48807367149758457,0.08926150230498009,0.1906335485282854,125521.37586805565,252.03993055556498,125773.41579861121,204,0,37.67391304347826,39,7,15,40.04677754677754,0.5694444444444444,49.47916666666667,1002.0833333333342,25.694444444444464,0
4046,4,2,0,42,0.047619047619047616,0.0,1.0,42,1350,1100,250,0.8148148148148148,16,11,5,382.767803927367,0.48738143631436315,0.1374197754514217,0.19546383385654836,125874.27112501017,1236.123665895631,127110.3947909058,205,0,40.80952380952381,36,6,17,39.524651180189274,0.5784143518518519,49.127252252252255,1003.4909909909912,27.874749749749757,0
4047,4,2,2,42,0.045454545454545456,0.045454545454545456,0.9545454545454546,44,1700,1300,400,0.7647058823529411,21,13,8,367.53299400927875,0.48632399577167024,0.14822045962985575,0.1914769793964426,126694.8959094231,513.1391526662012,127208.0350620893,206,0,39.90909090909091,36,8,16,39.06040268456377,0.5868055555555556,48.31081081081082,1006.7567567567581,27.965465465465503,0
4048,4,1,2,41,0.023255813953488372,0.046511627906976744,0.9534883720930233,43,1250,900,350,0.72,16,9,7,366.9146367107103,0.4864110372831303,0.14553017796092393,0.19182065607114607,126836.6524252295,707.6448492411596,127544.29727447066,207,0,37.04651162790697,36,7,17,38.93003540152786,0.5882523148148149,48.17004504504506,1007.3198198198216,27.981106106106157,0
4049,4,5,11,35,0.10869565217391304,0.2391304347826087,0.7608695652173914,46,1250,700,550,0.56,18,7,11,347.02303394364867,0.48516505636070856,0.18487921658074047,0.18635823697113507,127922.58795975683,-321.069478435349,127601.51848132147,208,0,34.23913043478261,37,9,20,38.31788785316858,0.5974099099099099,47.094298245614034,1011.6228070175437,27.3411569464201,0
4050,4,0,1,34,0.0,0.02857142857142857,0.9714285714285714,35,1200,800,400,0.6666666666666666,16,8,8,377.67422526943915,0.479796918767507,0.15732340911603226,0.20030683602867524,127420.45932345925,2624.6846516927135,130045.14397515196,209,1,39.542857142857144,31,4,20,38.058313988479064,0.605510752688172,47.591145833333336,1009.6354166666671,32.568884408602166,0
4051,4,0,0,34,0.0,0.0,1.0,34,1200,1000,200,0.8333333333333334,14,10,4,373.61603479296224,0.4798165478312537,0.036409643904418365,0.1872467054999564,125097.67532348653,2581.09927707251,127678.77460055905,210,2,41.38235294117647,31,3,19,40.55829428608617,0.5816532258064516,49.902343750000014,1000.3906250000016,32.2706653225807,16
4052,4,3,2,35,0.08108108108108109,0.05405405405405406,0.9459459459459459,37,1000,600,400,0.6,14,6,8,395.21666516330646,0.48104354354354356,0.018732570564778284,0.183784610661143,121923.92290249438,2517.606867576134,124441.52977007051,211,0,38.945945945945944,34,3,16,43.337150433944046,0.5416666666666667,53.095238095238095,987.619047619048,29.04761904761906,16
4053,4,14,10,39,0.2857142857142857,0.20408163265306123,0.7959183673469388,49,1300,900,400,0.6923076923076923,17,9,8,306.3665268191071,0.48522534013605445,0.0911864212170459,0.15220879638449022,124733.66914736174,-2089.681311387927,122643.9878359738,212,0,29.979591836734695,42,7,17,42.615473534452086,0.5567956349206349,50.26647286821704,998.9341085271302,23.78414544112215,0
4054,4,8,0,47,0.1702127659574468,0.0,1.0,47,1050,600,450,0.5714285714285714,15,6,9,319.60983403934944,0.4864515880357694,0.18158688982564652,0.1621903230281893,125615.07100820018,-1369.869538129631,124245.20147007055,213,0,31.78723404255319,38,9,18,41.37580375857046,0.5720942982456141,49.38568376068377,1002.4572649572663,26.38045434098069,0
4055,4,3,6,44,0.06,0.12,0.88,50,1200,900,300,0.75,15,9,6,308.4348609302814,0.4865561224489796,0.2235373304338819,0.15987951969960962,126488.78173828125,-2195.8290119604485,124292.9527263208,214,0,30.82,39,11,16,40.7589701770736,0.5793269230769231,48.515625,1005.9375,25.79326923076923,0
4056,4,2,1,45,0.043478260869565216,0.021739130434782608,0.9782608695652174,46,900,500,400,0.5555555555555556,13,5,8,338.35537951213604,0.4865136876006441,0.21046223834383837,0.17374248422522537,126101.9550004283,-666.5450317215807,125435.4099687067,215,0,29.695652173913043,35,11,24,40.404375048014124,0.5827380952380952,48.90046296296294,1004.3981481481451,28.69708994708986,0
4057,4,6,9,42,0.11764705882352941,0.17647058823529413,0.8235294117647058,51,1200,600,600,0.5,18,6,12,298.9053034328833,0.48532679738562096,0.23488983222154824,0.15930667270873447,127617.73003472218,-2567.0053155006945,125050.72471922149,216,0,27.529411764705884,39,12,16,39.84536082474225,0.5908119658119658,47.39583333333333,1010.4166666666662,25.908119658119645,0
4058,4,4,7,39,0.08695652173913043,0.15217391304347827,0.8478260869565217,46,1050,400,650,0.38095238095238093,17,4,13,350.53457165880366,0.48341384863124,0.22555394318245225,0.17392766326255285,124679.69263642332,-186.73903887245945,124492.95359755086,217,0,30.0,38,8,19,41.5683836114677,0.5625,50.32051282051282,998.717948717948,26.282051282051263,16
4059,4,4,3,40,0.09302325581395349,0.06976744186046512,0.9302325581395349,43,1400,1200,200,0.8571428571428571,16,12,4,351.92766023967727,0.48221207087486156,0.27628492160110363,0.1786123165024861,125620.13660620082,242.66197870668316,125862.7985849075,218,0,30.674418604651162,36,7,17,40.56064180334008,0.5758101851851851,49.380630630630634,1002.4774774774777,27.8465965965966,0
4060,4,2,2,40,0.047619047619047616,0.047619047619047616,0.9523809523809523,42,1150,800,350,0.6956521739130435,15,8,7,355.5626822084706,0.48135646535036775,0.26755982446856863,0.18132272099572191,125817.77459469592,547.2210808781604,126364.99567557409,219,0,31.952380952380953,36,6,20,40.26546189246828,0.5778356481481481,49.18355855855855,1003.2657657657647,27.868493493493464,0
4061,4,3,3,40,0.06976744186046512,0.06976744186046512,0.9302325581395349,43,1050,600,450,0.5714285714285714,15,6,9,343.9003811920796,0.4834579180509413,0.18090080651994755,0.16506124814290743,123278.99119200127,-54.6477805070391,123224.34341149422,220,0,29.837209302325583,37,6,14,43.1888548452394,0.5498310810810811,51.72697368421052,993.0921052631569,26.84032716927451,16
4062,4,8,6,42,0.16666666666666666,0.125,0.875,48,1500,1300,200,0.8666666666666667,17,13,4,298.38333863116713,0.4865174349881796,0.21040922323673428,0.14883715445780368,124900.81333459279,-2144.4570810620407,122756.35625353076,221,0,27.3125,41,7,19,42.64258303559611,0.5599593495934959,50.099206349206334,999.6031746031721,24.38056523422371,0
4063,4,2,2,42,0.045454545454545456,0.045454545454545456,0.9545454545454546,44,1450,800,650,0.5517241379310345,21,8,13,316.64841525552083,0.48728197674418605,0.20961972159576958,0.15751574358881024,124786.41610051873,-897.3158192709421,123889.1002812478,222,0,26.613636363636363,38,6,21,42.304230824066146,0.5635964912280702,50.21367521367522,999.1452991452998,26.29329734592894,0
4064,4,5,5,42,0.10638297872340426,0.10638297872340426,0.8936170212765957,47,1550,1300,250,0.8387096774193549,18,13,5,294.2451196019412,0.48728029602220163,0.22038817798642096,0.15033250656026442,125894.45153061222,-1991.0517820430866,123903.39974856914,223,0,25.404255319148938,41,6,17,41.72474298141558,0.5701219512195121,49.107142857142854,1003.5714285714284,24.477351916376303,0
4065,4,3,7,38,0.06666666666666667,0.15555555555555556,0.8444444444444444,45,950,900,50,0.9473684210526315,10,9,1,306.83789271649187,0.4856271043771044,0.2474959984339189,0.15824045039131118,126279.2982313369,-1250.4566702983234,125028.84156103857,224,0,26.511111111111113,39,6,16,41.01385722181916,0.577190170940171,48.723958333333336,1005.1041666666674,25.771901709401728,0
4066,4,2,3,37,0.05,0.075,0.925,40,850,600,250,0.7058823529411765,11,6,5,355.1783610988019,0.48575053418803416,0.18447653429602817,0.17568643932922906,124549.95536076638,894.5872432293162,125444.5426039957,225,0,29.6,36,4,17,41.586990448255115,0.5648148148148149,50.45045045045046,998.1981981982,27.72772772772778,16
4067,4,6,5,38,0.13953488372093023,0.11627906976744186,0.8837209302325582,43,1100,600,500,0.5454545454545454,16,6,10,334.0976346696807,0.4852574750830565,0.19564910403056124,0.16998235754169627,125722.19397189365,-198.49085126825457,125523.70312062539,226,0,26.790697674418606,38,5,20,40.902311707680845,0.5731907894736843,49.27884615384616,1002.8846153846166,26.39170040485833,0
4068,4,0,1,37,0.0,0.02631578947368421,0.9736842105263158,38,1050,700,350,0.6666666666666666,14,7,7,365.449939133246,0.4858493361782836,0.19997164802309442,0.1838051171699725,125245.21818531328,1554.1714725105644,126799.38965782385,227,1,30.710526315789473,33,5,20,40.60969637610185,0.5782828282828283,49.75490196078431,1000.9803921568622,30.332739156268552,0
4069,4,2,1,38,0.05128205128205128,0.02564102564102564,0.9743589743589743,39,1050,600,450,0.5714285714285714,15,6,9,364.0550325051602,0.4859424201529465,0.22693585484283196,0.18572977082042885,125834.72222222196,1362.1527777777446,127196.87499999971,228,0,30.794871794871796,34,5,22,40.034952934662236,0.5821078431372548,49.16666666666665,1003.3333333333312,29.509803921568565,0
4070,4,1,2,37,0.02564102564102564,0.05128205128205128,0.9487179487179487,39,1350,1000,350,0.7407407407407407,17,10,7,357.34523253118715,0.4821749887539361,0.23545509071824844,0.18516980231161523,126474.91349480972,1239.2150855440245,127714.12858035375,229,0,31.46153846153846,33,6,18,39.543230181936316,0.5909090909090908,48.529411764705884,1005.8823529411767,30.4812834224599,0
4071,4,1,1,37,0.02631578947368421,0.02631578947368421,0.9736842105263158,38,1050,600,450,0.5714285714285714,15,6,9,360.8995672320165,0.4809003082029398,0.22715743356199902,0.18828645993304616,126752.42282115037,1548.9789083525357,128301.4017295029,230,0,32.23684210526316,33,5,19,39.16816254918663,0.59375,48.253676470588225,1006.9852941176458,30.514705882352903,0
4072,4,0,4,33,0.0,0.10810810810810811,0.8918918918918919,37,1300,700,600,0.5384615384615384,19,7,12,374.8101752599823,0.4791666666666667,0.23271842554691036,0.19564698677183381,126773.92612998675,2103.2314942352814,128877.15762422203,231,1,34.0,32,5,19,38.79581452691406,0.5963541666666667,48.23232323232323,1007.0707070707072,31.4709595959596,0
4073,4,3,2,34,0.08333333333333333,0.05555555555555555,0.9444444444444444,36,1150,900,250,0.782608695652174,14,9,5,380.29388665637265,0.4795634920634921,0.15187854602709194,0.19384095617491093,125797.8376706076,2497.45688718916,128295.29455779675,134,0,28.194444444444443,33,3,18,39.66579118820751,0.5839646464646464,49.203431372549026,1003.186274509805,30.399584076054698,16
4074,4,1,2,33,0.02857142857142857,0.05714285714285714,0.9428571428571428,35,950,500,450,0.5263157894736842,14,5,9,444.62267346781186,0.4778711484593838,0.08692958417729102,0.22120439231863356,124791.75347222234,4365.575139369493,129157.32861159183,135,0,29.457142857142856,29,6,17,39.102029469001955,0.584051724137931,50.20833333333334,999.1666666666677,34.454022988505784,16
4075,4,3,2,34,0.08333333333333333,0.05555555555555555,0.9444444444444444,36,1300,1000,300,0.7692307692307693,16,10,6,367.64064770188685,0.47938161375661376,0.04202681851078083,0.18075480062539276,124296.3362198432,2127.124333189142,126423.46055303235,136,0,28.944444444444443,33,3,17,41.539546720740645,0.5684974747474747,50.70465686274509,997.1813725490185,30.217617349970258,16
4076,4,3,4,33,0.08108108108108109,0.10810810810810811,0.8918918918918919,37,1400,1100,300,0.7857142857142857,17,11,6,351.5787925873875,0.4792605105105105,0.0507761030947711,0.177052553632331,125297.79620181401,1412.395745675715,126710.19194748973,137,0,27.18918918918919,34,3,15,40.90244748315498,0.576593137254902,49.70238095238095,1001.1904761904758,29.446778711484583,0
4077,4,3,0,36,0.08333333333333333,0.0,1.0,36,700,400,300,0.5714285714285714,10,4,6,353.8656116608001,0.4782903439153439,0.07842671731560635,0.18000989810571147,125715.30612244905,1697.2647392290382,127412.57086167809,138,0,28.38888888888889,34,2,18,40.41379787907565,0.5808823529411764,49.28571428571429,1002.8571428571435,29.495798319327747,0
4078,4,5,6,35,0.12195121951219512,0.14634146341463414,0.8536585365853658,41,1200,1100,100,0.9166666666666666,13,11,2,318.2821378638892,0.47962398373983745,0.10176636395266137,0.16679639229118454,126934.51063368063,-119.80251736110083,126814.70811631954,139,0,25.804878048780488,39,2,17,40.05452759975193,0.5838675213675213,48.07291666666667,1007.708333333334,25.83867521367523,0
4079,4,1,3,33,0.027777777777777776,0.08333333333333333,0.9166666666666666,36,900,700,200,0.7777777777777778,11,7,4,354.27377243672476,0.47635582010582006,0.12027172769360206,0.18338877632018716,126432.65306122463,1758.3545918367463,128191.00765306137,140,0,29.77777777777778,34,2,19,39.66397372159089,0.5882352941176471,48.57142857142858,1005.7142857142869,29.579831932773146,0
4080,4,0,0,33,0.0,0.0,1.0,33,1350,1000,350,0.7407407407407407,17,10,7,383.2401006682188,0.4744318181818182,0.1043570924700199,0.18036404737742046,122439.71669550177,2784.7618704344577,125224.47856593624,141,1,29.87878787878788,33,0,17,43.091154862142986,0.5492424242424243,52.57352941176471,989.7058823529414,29.99108734402853,16
4081,4,4,3,34,0.10810810810810811,0.08108108108108109,0.9189189189189189,37,800,400,400,0.5,12,4,8,354.46757593286833,0.4781969469469469,0.12615592767759432,0.17144887712720994,123605.88263936996,1362.8555180440267,124968.73815741399,142,0,27.54054054054054,37,0,15,42.58589241739258,0.5532094594594594,51.39802631578948,994.4078947368433,26.87588904694171,0
4082,4,5,5,34,0.1282051282051282,0.1282051282051282,0.8717948717948718,39,1250,800,450,0.64,17,8,9,353.28269471496554,0.480038236617184,0.16391425529752257,0.17510692407123354,124635.68250868049,1006.3259548611016,125642.00846354158,143,0,26.46153846153846,39,0,15,41.545396063704,0.5603632478632479,50.36458333333333,998.5416666666661,25.603632478632463,0
4083,4,4,2,36,0.10526315789473684,0.05263157894736842,0.9473684210526316,38,850,300,550,0.35294117647058826,14,3,11,359.31799880365685,0.4784257942152679,0.17573883830760995,0.18066174730546652,125231.58864883402,1401.1878161436907,126632.77646497771,144,0,27.105263157894736,35,3,15,40.777251002158486,0.5738095238095238,49.76851851851852,1000.925925925926,28.597883597883598,0
4084,4,1,2,35,0.02702702702702703,0.05405405405405406,0.9459459459459459,37,1400,1100,300,0.7857142857142857,17,11,6,369.0971522806718,0.4781969469469469,0.1864892956242996,0.1870106636394579,125550.37300936633,1868.0570291066374,127418.43003847297,145,0,28.37837837837838,35,2,16,40.20251087500479,0.5770833333333334,49.450231481481474,1002.1990740740732,28.634259259259235,0
4085,4,2,3,34,0.05405405405405406,0.08108108108108109,0.9189189189189189,37,1350,1000,350,0.7407407407407407,17,10,7,356.9153423666949,0.4771021021021021,0.17831109117416166,0.18301403725611357,126043.83680555537,1597.3958333333092,127641.23263888869,146,0,25.91891891891892,36,1,19,39.99827109266941,0.580150462962963,48.95833333333332,1004.1666666666652,27.893518518518476,0
4086,4,2,1,35,0.05555555555555555,0.027777777777777776,0.9722222222222222,36,750,400,350,0.5333333333333333,11,4,7,366.97682240408864,0.47597552910052915,0.19379182822117347,0.18910740349760805,126247.30909475706,2065.967265732126,128313.27636048918,147,0,27.083333333333332,35,1,21,39.535706744980615,0.5842261904761905,48.75578703703702,1004.9768518518492,28.713624338624264,0
4087,4,1,0,36,0.027777777777777776,0.0,1.0,36,750,600,150,0.8,9,6,3,366.228128836103,0.4769179894179894,0.1945211609768578,0.18966164717435793,126450.9454839674,2061.97863082986,128512.92411479726,148,0,27.916666666666668,35,1,16,39.34455312619869,0.5863095238095238,48.55324074074072,1005.787037037034,28.7367724867724,0
4088,4,2,5,33,0.05263157894736842,0.13157894736842105,0.868421052631579,38,1400,1000,400,0.7142857142857143,18,10,8,370.07628686917883,0.4771070412517781,0.04159053311737315,0.1863853599229164,125301.71693453765,1703.8304135128074,127005.54734805046,149,0,27.394736842105264,37,1,14,40.43539864198881,0.5706644144144144,49.698464912280706,1001.2061403508781,27.059625414888597,16
4089,4,4,3,34,0.10810810810810811,0.08108108108108109,0.9189189189189189,37,1250,800,450,0.64,17,8,9,369.81223237222986,0.4744119119119119,0.06385836200754857,0.18936680365298278,125987.3022304399,1918.3290976787605,127905.63132811866,150,0,28.243243243243242,36,1,19,39.7328939988783,0.5795717592592593,49.01463963963964,1003.9414414414415,27.887262262262265,0
4090,4,1,0,35,0.02857142857142857,0.0,1.0,35,1000,700,300,0.7,13,7,6,389.22497290524234,0.4724089635854342,0.092965573326105,0.19914714633112868,125954.1950113377,2804.9036281178924,128759.0986394556,151,0,30.6,34,1,20,39.27992567994938,0.5833333333333333,49.04761904761904,1003.8095238095224,29.523809523809483,0
4091,4,0,1,34,0.0,0.02857142857142857,0.9714285714285714,35,950,600,350,0.631578947368421,13,6,7,405.29025858320836,0.4720588235294118,0.044857178991490665,0.20066562771555582,124589.98324469442,3109.285619282916,127699.26886397734,152,1,31.6,32,3,18,40.29472829981874,0.5738932291666667,50.410353535353536,998.3585858585858,31.198705808080806,15
4092,4,6,5,35,0.15,0.125,0.875,40,1450,1200,250,0.8275862068965517,17,12,5,356.04686552413415,0.475801282051282,0.08992890995260616,0.18323387469656688,126193.31065759654,988.1672222378545,127181.47787983439,153,0,28.45,34,6,19,39.86596563981043,0.5857843137254901,48.80952380952382,1004.7619047619062,29.551820728291357,0
4093,4,2,3,34,0.05405405405405406,0.08108108108108109,0.9189189189189189,37,1150,700,450,0.6086956521739131,16,7,9,371.9410376982907,0.47444319319319317,0.09512453630100692,0.19116039379377286,126138.94628099189,1983.2501147842268,128122.19639577612,154,0,30.81081081081081,32,5,21,39.52284439416791,0.58984375,48.863636363636374,1004.5454545454559,31.392045454545496,0
4094,4,1,1,34,0.02857142857142857,0.02857142857142857,0.9714285714285714,35,1400,1000,400,0.7142857142857143,18,10,8,367.38822760923216,0.4725840336134454,0.10443201376936351,0.19058264307228914,126519.74288337924,2296.372819100092,128816.11570247932,155,0,32.65714285714286,32,3,20,39.244477911646605,0.59375,48.484848484848484,1006.060606060606,31.439393939393938,0
4095,4,0,1,33,0.0,0.029411764705882353,0.9705882352941176,34,1050,700,350,0.6666666666666666,14,7,7,381.06664153077577,0.470068330362448,0.1123891109841999,0.19743392393194106,126469.13528442371,2838.6337280273297,129307.76901245104,156,1,34.588235294117645,31,3,20,38.952669902912625,0.595766129032258,48.53515624999999,1005.8593749999991,32.447076612903196,0
4096,4,2,1,34,0.05714285714285714,0.02857142857142857,0.9714285714285714,35,650,500,150,0.7692307692307693,8,5,3,361.2078642204077,0.4708683473389356,0.09855857733319473,0.18973792407899567,127030.23626730099,2176.8640667051104,129207.1003340061,157,0,33.57142857142857,33,2,22,38.874706216062904,0.5965909090909092,47.97794117647059,1008.0882352941172,30.548128342245978,0
4097,4,2,3,33,0.05555555555555555,0.08333333333333333,0.9166666666666666,36,1350,1200,150,0.8888888888888888,15,12,3,355.9702307167158,0.46941137566137564,0.12125137384204754,0.19035889164019829,127753.08956916096,1895.2593537414912,129648.34892290246,158,0,33.30555555555556,34,2,19,38.26518095462396,0.6017156862745099,47.26190476190476,1010.9523809523806,29.73389355742296,0
4098,4,0,2,31,0.0,0.06060606060606061,0.9393939393939394,33,750,500,250,0.6666666666666666,10,5,5,427.8659873344343,0.4669744318181818,0.07667489087113255,0.21128639993112797,124479.70920138896,4052.1267361111168,128531.83593750009,159,1,33.60606060606061,33,0,17,39.84646833681279,0.5703914141414141,50.520833333333336,997.9166666666673,30.23989898989901,16
4099,4,4,1,34,0.11428571428571428,0.02857142857142857,0.9714285714285714,35,1050,800,250,0.7619047619047619,13,8,5,357.9137064513447,0.4692927170868348,0.03204515848892764,0.17575165585446625,124243.57208448119,1931.6729080578498,126175.24499253904,160,0,31.885714285714286,32,3,19,41.83684777102329,0.5703125,50.75757575757576,996.969696969697,31.15530303030303,16
4100,4,6,3,37,0.15,0.075,0.925,40,900,700,200,0.7777777777777778,11,7,4,357.6388888888888,0.47532051282051285,0.07583333333333342,0.17881944444444448,125000.00000000001,1297.1260904499547,126297.12609044996,161,0,28.675,35,5,19,41.059027777777764,0.5714285714285714,50.0,1000.0000000000001,28.571428571428573,16
4101,4,1,2,36,0.02631578947368421,0.05263157894736842,0.9473684210526316,38,1300,900,400,0.6923076923076923,17,9,8,388.76911888620515,0.47242472735893787,0.10675858922529047,0.18202459422033912,122218.03429705197,1924.6208900226538,124142.65518707462,162,0,31.07894736842105,34,4,17,43.18715386467614,0.5447303921568627,52.79761904761904,988.8095238095223,29.082633053221244,16
4102,4,12,8,40,0.25,0.16666666666666666,0.8333333333333334,48,1050,800,250,0.7619047619047619,13,8,5,321.32398780090466,0.4821217494089835,0.19183351130094284,0.16117831525203377,125133.58267815395,-1485.9268940427455,123647.65578411121,163,0,25.3125,38,10,17,41.829062110695865,0.5671600877192983,49.86645299145299,1000.5341880341878,26.329847053531257,0
4103,4,4,5,39,0.09090909090909091,0.11363636363636363,0.8863636363636364,44,1250,700,550,0.56,18,7,11,348.9204807353106,0.4818424066243834,0.22366862697051393,0.1773280799353429,125676.58875091314,-29.772847171484386,125646.81590374166,164,0,27.863636363636363,36,8,16,40.57773659778378,0.5763888888888888,49.32432432432433,1002.7027027027033,27.85285285285287,0
4104,4,2,1,40,0.04878048780487805,0.024390243902439025,0.975609756097561,41,1250,700,550,0.56,18,7,11,358.7548900015531,0.4797510162601626,0.23446032822307705,0.18305156806494774,125840.52861636224,829.1810003000606,126669.7096166623,165,0,29.658536585365855,35,6,19,40.161903525973806,0.5800595238095239,49.160879629629626,1003.3564814814808,28.667328042328023,0
4105,4,5,3,42,0.1111111111111111,0.06666666666666667,0.9333333333333333,45,1250,900,350,0.72,16,9,7,325.94665079897345,0.4803240740740741,0.237933601310109,0.17171636497385895,127148.7957552144,-710.7628740673215,126438.03288114708,166,0,27.644444444444446,36,9,20,39.6419532529403,0.5914351851851851,47.860360360360346,1008.5585585585563,28.015515515515453,0
4106,4,2,2,42,0.045454545454545456,0.045454545454545456,0.9545454545454546,44,1200,1000,200,0.8333333333333334,14,10,4,326.8737550491448,0.48118173009161386,0.23124908799066168,0.17320734456492345,127383.94445516115,-472.3063485939614,126911.63810656719,167,0,28.818181818181817,35,9,14,39.37791408698312,0.5958333333333333,47.62731481481482,1009.4907407407405,28.842592592592588,0
4107,4,2,5,39,0.045454545454545456,0.11363636363636363,0.8863636363636364,44,1500,1000,500,0.6666666666666666,20,10,10,320.03069450710206,0.48021273784355184,0.22705005971538994,0.17171539414950995,127888.1140430974,-614.3756087167953,127273.7384343806,168,0,26.795454545454547,36,8,17,39.03571030950789,0.5989583333333333,47.12837837837839,1011.4864864864885,28.0968468468469,0
4108,4,0,0,39,0.0,0.0,1.0,39,1200,700,500,0.5833333333333334,17,7,10,352.9067153716865,0.4786887089518668,0.21180321555790926,0.18624337224701298,127219.3605882054,1179.313335373959,128398.67392357935,169,1,27.94871794871795,32,7,21,38.88975803087194,0.6009114583333333,47.79040404040405,1008.8383838383847,31.526199494949523,0
4109,4,1,3,37,0.025,0.075,0.925,40,1300,1000,300,0.7692307692307693,16,10,6,343.43934495227285,0.47751068376068373,0.2082645881353875,0.1827611698154674,127555.82475790581,761.5377799404297,128317.36253784623,170,0,28.225,33,7,18,38.783791297666696,0.6019570707070707,47.457107843137265,1010.1715686274525,30.61125965537735,0
4110,4,0,1,36,0.0,0.02702702702702703,0.972972972972973,37,1500,1000,500,0.6666666666666666,20,10,10,345.0170446728391,0.4781031031031031,0.15252882679519275,0.17020328595775927,124437.57101696297,1215.0349063687277,125652.6059233317,171,1,27.89189189189189,36,1,15,41.95706358164034,0.5636574074074074,50.56306306306307,997.7477477477482,27.715215215215228,16
4111,4,6,8,34,0.14285714285714285,0.19047619047619047,0.8095238095238095,42,750,400,350,0.5333333333333333,11,4,7,328.88503755565506,0.480316008517228,0.13658302966090408,0.1665764342178588,125535.48216713352,111.31959662367325,125646.80176375719,172,0,25.238095238095237,36,6,17,41.22537176461776,0.5749421296296297,49.4650900900901,1002.139639639641,27.83721221221225,16
4112,4,4,3,35,0.10526315789473684,0.07894736842105263,0.9210526315789473,38,800,500,300,0.625,11,5,6,335.0843602031125,0.4816559981033665,0.14337955393582402,0.17169510898864176,126013.95266439873,845.0609410430459,126859.01360544178,173,0,26.289473684210527,34,4,19,40.57707888704453,0.5839460784313726,48.98809523809522,1004.0476190476161,29.530812324929883,0
4113,4,0,0,35,0.0,0.0,1.0,35,1100,600,500,0.5454545454545454,16,6,10,354.63522787578154,0.4797619047619048,0.14448545093748266,0.18055222474072316,125749.81901380733,1919.0631442599583,127668.88215806728,174,1,29.02857142857143,31,4,20,40.35886992081008,0.5883736559139785,49.25130208333332,1002.9947916666652,32.354670698924686,0
4114,4,3,4,34,0.07894736842105263,0.10526315789473684,0.8947368421052632,38,1150,900,250,0.782608695652174,14,9,5,329.72858194325613,0.48082622095779987,0.13777968697471143,0.17143452839780327,126612.30867346907,749.5393990929331,127361.848072562,175,0,27.657894736842106,34,4,15,40.096650500749156,0.5900735294117647,48.392857142857125,1006.4285714285688,29.60084033613438,0
4115,4,2,1,35,0.05555555555555555,0.027777777777777776,0.9722222222222222,36,650,400,250,0.6153846153846154,9,4,5,345.99963394207873,0.47972883597883603,0.1694402631432239,0.1800462847118961,126646.80262218125,1563.94946944187,128210.75209162312,176,0,28.416666666666668,32,4,17,39.65180214082621,0.5950520833333333,48.35858585858585,1006.5656565656552,31.455176767676726,0
4116,4,0,0,35,0.0,0.0,1.0,35,900,700,200,0.7777777777777778,11,7,4,358.75681347683553,0.47923669467787117,0.16856034004805043,0.18662114186917472,126632.9023573133,2086.083306206588,128718.9856635199,177,1,29.97142857142857,31,4,18,39.34508408796895,0.5974462365591398,48.37239583333333,1006.5104166666661,32.46807795698923,0
4117,4,3,6,32,0.07894736842105263,0.15789473684210525,0.8421052631578947,38,1000,700,300,0.7,13,7,6,333.34150246707856,0.4812855618776672,0.1656244571825607,0.17719732499565768,127512.50000000009,901.041666666682,128413.54166666677,178,0,28.526315789473685,34,4,15,39.08312706270629,0.5992647058823529,47.50000000000001,1010.0000000000007,29.705882352941195,0
4118,4,4,2,34,0.1111111111111111,0.05555555555555555,0.9444444444444444,36,1150,800,350,0.6956521739130435,15,8,7,353.14996906508435,0.4782738095238095,0.17251260889500242,0.18740147993453754,127442.37075617291,1801.2538580247028,129243.62461419762,179,0,28.47222222222222,32,4,17,38.65486015589178,0.6031901041666667,47.56944444444445,1009.7222222222229,31.553819444444464,0
4119,4,2,2,34,0.05555555555555555,0.05555555555555555,0.9444444444444444,36,1250,900,350,0.72,16,9,7,382.7084424430821,0.478505291005291,0.18600306433661462,0.19240548051405976,125227.96842787006,2510.545951937462,127738.51437980752,180,0,29.416666666666668,31,5,17,40.19570378561208,0.582997311827957,49.77213541666667,1000.9114583333338,32.28746639784948,16
4120,4,4,4,34,0.10526315789473684,0.10526315789473684,0.8947368421052632,38,1150,800,350,0.6956521739130435,15,8,7,363.6753559112553,0.48078176861071603,0.16958778782894757,0.18620178222656258,125982.31449442511,1563.3326124567416,127545.64710688185,181,0,28.289473684210527,33,5,19,39.89206949869792,0.5858585858585859,49.01960784313725,1003.92156862745,30.421865715983333,0
4121,4,2,0,36,0.05555555555555555,0.0,1.0,36,1350,1000,350,0.7407407407407407,17,10,7,377.8061958230582,0.47726521164021163,0.18533284353976676,0.19388018552117425,126076.52664184573,2326.4985826280395,128403.02522447378,182,0,29.77777777777778,31,5,23,39.440041704481615,0.591733870967742,48.92578125,1004.2968750000002,32.39667338709678,0
4122,4,1,0,37,0.02702702702702703,0.0,1.0,37,1300,900,400,0.6923076923076923,17,9,8,368.569472863703,0.4773210710710711,0.17727477760104238,0.19134398236161884,126551.50183973573,1928.6040646362665,128480.105904372,183,0,29.945945945945947,32,5,17,39.18203873342538,0.5940755208333333,48.45328282828283,1006.1868686868686,31.443339646464644,0
4123,4,3,3,37,0.075,0.075,0.925,40,1300,1100,200,0.8461538461538461,15,11,4,353.44122114773324,0.4780849358974359,0.17682473776223717,0.18050748080044945,125878.73191751307,925.6030865151349,126804.33500402821,184,0,28.625,37,3,18,40.25577287296036,0.5765765765765766,49.122807017543856,1003.5087719298244,27.121858700806065,15
4124,4,4,1,40,0.0975609756097561,0.024390243902439025,0.975609756097561,41,1150,800,350,0.6956521739130435,15,8,7,347.95590713614166,0.47703252032520327,0.24009188271000292,0.17048901563128785,124151.66355272762,471.8178910818527,124623.48144380948,185,0,28.0,37,4,18,42.18045164484541,0.5588400900900901,50.849780701754376,996.6008771929813,26.93515884305355,14
4125,4,4,4,40,0.09090909090909091,0.09090909090909091,0.9090909090909091,44,1900,1700,200,0.8947368421052632,21,17,4,337.393518934599,0.47863812544045103,0.2715684419638631,0.16975663439588995,125260.5523003473,-344.6917861745882,124915.86051417272,186,0,26.954545454545453,39,5,14,41.295959070412756,0.5667735042735043,49.739583333333336,1001.0416666666674,25.667735042735064,0
4126,4,7,6,41,0.14893617021276595,0.1276595744680851,0.8723404255319149,47,1350,900,450,0.6666666666666666,18,9,9,316.5900261875551,0.4814986123959297,0.263431309837149,0.16462356820465116,126617.30092789422,-1380.4036704380885,125236.89725745613,187,0,24.0,41,6,15,40.42210859208149,0.577489837398374,48.38789682539682,1006.448412698412,24.547522260936876,0
4127,4,5,4,42,0.10869565217391304,0.08695652173913043,0.9130434782608696,46,1350,1000,350,0.7407407407407407,17,10,7,328.5194370191678,0.47788848631239933,0.2813149608371124,0.171961018933898,126887.15071220817,-863.020936611826,126024.12977559635,188,0,25.152173913043477,40,6,17,39.84516844865847,0.5817708333333333,48.11991869918698,1007.5203252032506,25.188008130081265,0
4128,4,2,2,42,0.045454545454545456,0.045454545454545456,0.9545454545454546,44,1350,1000,350,0.7407407407407407,17,10,7,346.46493839183387,0.4773498062015504,0.3085365853658535,0.18130767863679212,126876.64936262697,-8.337899043026027,126868.31146358394,189,0,27.09090909090909,38,6,19,39.40394132202189,0.5849780701754386,48.13034188034188,1007.4786324786328,26.51259559154297,0
4129,4,1,4,39,0.023255813953488372,0.09302325581395349,0.9069767441860466,43,1800,1200,600,0.6666666666666666,24,12,12,350.30493644188675,0.47600590623846434,0.30089453217838025,0.1845420850740252,127147.30133310272,308.24809083776825,127455.54942394048,190,0,27.209302325581394,37,6,20,39.02931796767413,0.589527027027027,47.86184210526317,1008.5526315789492,27.258179231863494,0
4130,4,2,2,39,0.04878048780487805,0.04878048780487805,0.9512195121951219,41,1450,1100,350,0.7586206896551724,18,11,7,352.3918307557393,0.47809959349593495,0.2733776132404173,0.18616926907850423,127262.39753266812,769.245850580347,128031.64338324848,191,0,27.78048780487805,36,5,22,38.85858444940476,0.5925925925925926,47.747747747747766,1009.0090090090117,28.028028028028103,0
4131,4,1,2,38,0.025,0.05,0.95,40,1100,800,300,0.7272727272727273,14,8,6,348.1405752351722,0.4779513888888889,0.2568080481551662,0.18535128192491013,127575.06397867488,882.8112318399737,128457.87521051486,192,0,28.45,36,4,19,38.64535726228959,0.595775462962963,47.438063063063076,1010.2477477477498,28.062437437437495,0
4132,4,4,2,40,0.09523809523809523,0.047619047619047616,0.9523809523809523,42,1400,1100,300,0.7857142857142857,17,11,6,338.7136306127961,0.4780173248161053,0.2830355855020512,0.1841805177285106,128422.23087873166,300.94017451790967,128723.17105324956,193,0,27.952380952380953,37,5,17,38.01790350497621,0.6024774774774775,46.600877192982445,1013.5964912280681,27.39449976292076,0
4133,4,1,3,38,0.024390243902439025,0.07317073170731707,0.926829268292683,41,1500,1200,300,0.8,18,12,6,358.79137549666314,0.47807418699186993,0.13120072857671383,0.18738649843806332,126795.9347491599,974.7146232244811,127770.64937238439,194,0,28.829268292682926,38,3,16,39.17647890810084,0.5841557017543859,48.210470085470085,1007.1581196581196,26.504161043634728,16
4134,4,0,1,37,0.0,0.02631578947368421,0.9736842105263158,38,2050,1600,450,0.7804878048780488,25,16,9,374.2544948651273,0.47606981981981983,0.15349212977251647,0.19478703422154486,126654.74597318683,1880.2215952932206,128534.96756848005,195,1,31.86842105263158,35,3,16,38.93260607105899,0.5883928571428572,48.35069444444445,1006.5972222222231,28.75992063492066,0
4135,4,1,0,38,0.02631578947368421,0.0,1.0,38,950,700,250,0.7368421052631579,12,7,5,379.49685118633005,0.4770329540066382,0.15831842576028654,0.18773339806474187,124553.97002551005,1887.627009715904,126441.59703522595,196,0,32.68421052631579,34,4,17,40.975949115484,0.5689338235294117,50.44642857142856,998.2142857142844,29.359243697478952,15
4136,4,3,2,39,0.07317073170731707,0.04878048780487805,0.9512195121951219,41,1450,900,550,0.6206896551724138,20,9,11,351.87099545856177,0.4766260162601626,0.1642356522087396,0.17768609969673613,125411.5223554361,625.7354426361819,126037.25779807229,197,0,31.21951219512195,37,4,15,40.77757252326219,0.5717905405405406,49.58881578947368,1001.6447368421037,27.07147937411091,0
4137,4,1,0,40,0.025,0.0,1.0,40,1300,800,500,0.6153846153846154,18,8,10,350.80493000492174,0.4761084401709402,0.14701443569553851,0.1782089044425001,125658.76038781145,816.3425284702743,126475.10291628171,198,0,32.225,37,3,17,40.548902741324,0.5743243243243243,49.34210526315788,1002.6315789473668,27.098150782361266,0
4138,4,4,2,42,0.09090909090909091,0.045454545454545456,0.9545454545454546,44,1450,1000,450,0.6896551724137931,19,10,9,334.2486927740552,0.4784068886539817,0.18920133538777661,0.1747401393869426,126835.96073765602,-320.4600617629432,126515.50067589307,199,0,30.204545454545453,40,4,17,39.753371334409486,0.58125,48.17073170731707,1007.3170731707305,25.18292682926826,0
4139,4,2,2,42,0.045454545454545456,0.045454545454545456,0.9545454545454546,44,1450,900,550,0.6206896551724138,20,9,11,331.5958401724513,0.4772837385482734,0.2134486741421635,0.17526148351588122,127280.60766171721,-358.3396005915203,126922.26806112568,200,0,30.931818181818183,38,6,19,39.364522675136755,0.5890899122807017,47.729700854700845,1009.0811965811947,26.554768331084073,0
4140,4,1,4,39,0.023255813953488372,0.09302325581395349,0.9069767441860466,43,1150,800,350,0.6956521739130435,15,8,7,343.8282766039001,0.47582133628645257,0.23749603468330416,0.18318783165313113,127604.23657909605,174.78895006936972,127779.02552916542,201,0,31.74418604651163,38,5,18,38.72440167776955,0.5923793859649122,47.40918803418802,1010.3632478632454,26.588506522716983,0
4141,4,4,4,39,0.09302325581395349,0.09302325581395349,0.9069767441860466,43,1650,1400,250,0.8484848484848485,19,14,5,343.15103007386153,0.4752214839424142,0.25569719677751523,0.18749224610768817,128613.70991940991,230.20969036368612,128843.9196097736,202,0,31.13953488372093,35,8,16,37.710139966529745,0.6083333333333334,46.412037037037024,1014.3518518518499,28.981481481481428,0
4142,4,1,0,40,0.025,0.0,1.0,40,1500,1100,400,0.7333333333333333,19,11,8,361.9761435397109,0.4749332264957265,0.20230635838150324,0.18225224922109995,125289.51930084013,1333.2449202674838,126622.76422110762,203,0,31.425,35,5,17,40.650770712909434,0.5744047619047619,49.710648148148145,1001.1574074074069,28.60449735449734,16
4143,4,3,4,39,0.06976744186046512,0.09302325581395349,0.9069767441860466,43,1200,1000,200,0.8333333333333334,14,10,4,338.80510590450444,0.47600590623846434,0.20033105391932104,0.17350709939997963,125991.54188368065,-62.684461805544885,125928.8574218751,204,0,30.162790697674417,39,4,20,40.50676143044892,0.5742521367521367,49.01041666666667,1003.9583333333342,25.742521367521388,0
4144,4,4,4,39,0.09302325581395349,0.09302325581395349,0.9069767441860466,43,1400,1100,300,0.7857142857142857,17,11,6,333.9380390258259,0.47780546327057954,0.19584536657040097,0.17378408153384808,126650.14716066472,-141.3179415781849,126508.82921908655,205,0,29.58139534883721,37,6,18,39.951888162672475,0.5844594594594594,48.35526315789473,1006.5789473684204,27.204836415362713,0
4145,4,1,3,37,0.025,0.075,0.925,40,1700,1300,400,0.7647058823529411,21,13,8,360.14306864842695,0.4766292735042735,0.20755867464334976,0.18677586829905338,126509.15745027467,1112.2792352538088,127621.43668552848,206,0,32.7,35,5,19,39.437605460960256,0.5869047619047619,48.49537037037039,1006.0185185185211,28.74338624338632,0
4146,4,3,2,38,0.075,0.05,0.95,40,1050,800,250,0.7619047619047619,13,8,5,332.6388888888889,0.47389155982905984,0.11645833333333333,0.16631944444444444,125000.0,315.9722222222222,125315.97222222222,207,0,31.975,39,1,16,41.68402777777778,0.5641025641025641,50.0,1000.0,25.641025641025642,16
4147,4,4,3,39,0.09523809523809523,0.07142857142857142,0.9285714285714286,42,850,400,450,0.47058823529411764,13,4,9,346.118559469824,0.47529519938056525,0.2066435205970103,0.16737830641838544,123597.70507812453,759.1905381944005,124356.89561631893,208,0,29.5,39,3,18,42.80195893567988,0.5496794871794872,51.40624999999998,994.3749999999961,25.496794871794773,16
4148,4,9,6,42,0.1875,0.125,0.875,48,950,400,550,0.42105263157894735,15,4,11,300.5384226443302,0.47990543735224583,0.23813096701011527,0.1519061621191763,125450.21526522284,-2057.882984676344,123392.3322805465,209,0,26.020833333333332,43,5,12,42.023210290827755,0.5627422480620154,49.55018939393938,1001.7992424242391,23.2976568005637,0
4149,4,6,6,42,0.125,0.125,0.875,48,1450,1300,150,0.896551724137931,16,13,3,379.27425859977825,0.48370087174940896,0.3090808993973111,0.18806771857464868,124653.01890432098,468.64309724453676,125121.66200156552,210,0,26.729166666666668,38,10,18,40.87853500231803,0.5622258771929824,50.34722222222222,998.6111111111111,26.279239766081872,16
4150,4,2,5,39,0.045454545454545456,0.11363636363636363,0.8863636363636364,44,1250,700,550,0.56,18,7,11,375.48651809281955,0.4829435341789993,0.30698370993168655,0.18905462057641978,125289.51930084027,609.8695773319722,125899.38887817225,211,0,28.863636363636363,35,9,17,40.3126204238921,0.5744047619047619,49.71064814814815,1001.1574074074081,28.604497354497372,0
4151,4,5,4,40,0.11363636363636363,0.09090909090909091,0.9090909090909091,44,1700,1200,500,0.7058823529411765,22,12,10,360.5039490403541,0.4825911733615222,0.2865260675923502,0.1847236714663362,126014.78273158865,285.76536243998896,126300.54809402864,212,0,27.045454545454547,35,9,21,39.93816042267049,0.5818452380952381,48.98726851851852,1004.050925925926,28.687169312169313,0
4152,4,4,4,40,0.09090909090909091,0.09090909090909091,0.9090909090909091,44,1550,1100,450,0.7096774193548387,20,11,9,355.73152765727684,0.4822498238195913,0.29579214770375106,0.18502995798918412,126629.04779712137,209.19562169080442,126838.24341881217,213,0,27.772727272727273,33,11,20,39.42517452006982,0.5924873737373737,48.376225490196084,1006.4950980392163,30.499851455733825,0
4153,4,3,2,41,0.06976744186046512,0.046511627906976744,0.9534883720930233,43,1700,1200,500,0.7058823529411765,22,12,10,378.0280998457656,0.4825350682908822,0.20685434516523848,0.19220865358355108,125695.4089506172,912.294032877301,126607.7029834945,214,0,27.3953488372093,35,8,20,39.82860110803324,0.5785714285714285,49.30555555555555,1002.777777777777,28.65079365079363,15
4154,4,2,4,39,0.046511627906976744,0.09302325581395349,0.9069767441860466,43,1550,1000,550,0.6451612903225806,21,10,11,359.68826137777296,0.4826042820228867,0.21203496876169314,0.1858238347823206,126351.67363514045,490.88952165835815,126842.56315679882,215,0,27.162790697674417,33,10,19,39.61126686169349,0.5896464646464646,48.65196078431374,1005.3921568627461,30.46642899584079,0
4155,4,0,1,38,0.0,0.02564102564102564,0.9743589743589743,39,1050,700,350,0.6666666666666666,14,7,7,374.8313514241287,0.4804318488529015,0.23161651099969038,0.19296688051634442,126207.32837253156,1661.2926907009642,127868.62106323252,216,1,30.358974358974358,31,8,23,39.379643427929665,0.5930779569892473,48.79557291666667,1004.8177083333342,32.41347446236562,0
4156,4,4,5,37,0.09523809523809523,0.11904761904761904,0.8809523809523809,42,1350,1000,350,0.7407407407407407,17,10,7,388.802058558798,0.4805458768873403,0.22108293600382756,0.1969945596875734,125550.37300936632,1731.712967149173,127282.08597651549,217,0,28.952380952380953,35,7,16,39.70880490433845,0.5770833333333334,49.450231481481474,1002.1990740740731,28.63425925925923,16
4157,4,4,3,38,0.0975609756097561,0.07317073170731707,0.926829268292683,41,1150,800,350,0.6956521739130435,15,8,7,382.83227388721485,0.48206300813008135,0.22665957377253787,0.19822741146955025,126444.09789804397,1483.3120138903619,127927.40991193433,218,0,28.5609756097561,33,8,19,38.9341162016165,0.5905934343434344,48.56004901960784,1005.7598039215682,30.477569815805097,0
4158,4,1,2,37,0.02564102564102564,0.05128205128205128,0.9487179487179487,39,1200,800,400,0.6666666666666666,16,8,8,394.8292176673486,0.480038236617184,0.2246777163904241,0.20418310970797152,126392.74691358008,2180.7098765431874,128573.45679012327,219,0,29.512820512820515,32,7,20,38.685543278084715,0.5924479166666667,48.6111111111111,1005.5555555555541,31.423611111111065,0
4159,4,4,2,39,0.0975609756097561,0.04878048780487805,0.9512195121951219,41,950,600,350,0.631578947368421,13,6,7,370.27641625035375,0.4808434959349594,0.23530665403741446,0.19659005605044527,127462.99500192217,1241.2372111153634,128704.23221303754,220,0,28.365853658536587,33,8,19,38.20135517799355,0.601010101010101,47.54901960784313,1009.803921568626,30.60011883541291,0
4160,4,1,0,40,0.025,0.0,1.0,40,1450,1100,350,0.7586206896551724,18,11,7,360.58131487889284,0.4777777777777778,0.21676470588235297,0.19398361876396109,127993.9058956914,1230.4421768707216,129224.34807256212,221,0,28.9,34,6,21,37.90196078431372,0.6041666666666667,47.02380952380951,1011.9047619047602,29.761904761904713,0
4161,4,0,2,38,0.0,0.05,0.95,40,1650,1200,450,0.7272727272727273,21,12,9,376.0579349606975,0.4780582264957265,0.24670408406973965,0.18459021965773006,124227.38803854845,1429.1702097505276,125656.55824829898,222,1,29.9,34,6,16,41.40146087094975,0.5655637254901961,50.773809523809504,996.9047619047594,29.320728291316453,16
4162,4,8,6,40,0.17391304347826086,0.13043478260869565,0.8695652173913043,46,1300,1000,300,0.7692307692307693,16,10,6,335.01572013767,0.4828804347826087,0.263616842751067,0.1715664989737973,125991.54188368062,-755.775448200104,125235.76643548052,223,0,26.630434782608695,39,7,20,40.601871065919624,0.5742521367521367,49.01041666666667,1003.9583333333339,25.742521367521384,0
4163,4,4,0,44,0.09090909090909091,0.0,1.0,44,1050,700,350,0.6666666666666666,14,7,7,344.2608927102962,0.4814239781536293,0.2900564912647765,0.17828528949061243,126450.94548396785,-93.55522333674668,126357.3902606311,224,0,27.636363636363637,35,9,19,39.89691215957039,0.5863095238095238,48.55324074074075,1005.7870370370379,28.73677248677251,0
4164,4,0,3,41,0.0,0.06818181818181818,0.9318181818181819,44,1450,1000,450,0.6896551724137931,19,10,9,341.1635799057357,0.48090644820295986,0.28519865696698354,0.1771235669063191,126553.21865361999,-164.93017510752225,126388.28847851246,225,1,28.636363636363637,36,8,19,39.86966051109867,0.5853587962962963,48.451576576576585,1006.193693693695,27.94982482482486,0
4165,4,3,3,41,0.06818181818181818,0.06818181818181818,0.9318181818181819,44,1450,1000,450,0.6896551724137931,19,10,9,343.30323094271193,0.4778343023255814,0.28722750139742836,0.17947676217314798,126836.65242522952,-91.31348409217526,126745.33894113735,226,0,29.136363636363637,36,8,21,39.52464132662568,0.5882523148148149,48.17004504504506,1007.3198198198218,27.98110610610616,0
4166,4,0,2,39,0.0,0.04878048780487805,0.9512195121951219,41,1200,800,400,0.6666666666666666,16,8,8,364.76593050048876,0.47797256097560975,0.17367640327997202,0.17827179122692408,124044.62528406794,934.3063925411989,124978.93167660914,227,1,30.658536585365855,36,5,19,41.87297460245685,0.5596064814814814,50.95720720720721,996.1711711711719,27.671421421421442,16
4167,4,5,3,41,0.11363636363636363,0.06818181818181818,0.9318181818181819,44,1100,700,400,0.6363636363636364,15,7,8,343.0626823006926,0.48002554615926707,0.21895398821843637,0.1733529129147743,125438.98122499196,-182.31837952728074,125256.66284546469,228,0,27.886363636363637,37,7,18,40.969789842381765,0.572072072072072,49.56140350877191,1001.7543859649095,27.074442863916474,0
4168,4,2,2,41,0.046511627906976744,0.046511627906976744,0.9534883720930233,43,1250,1000,250,0.8,15,10,5,345.04048307361916,0.4801587301587302,0.2220775058126816,0.17504773009206548,125603.79756271136,67.67899738378202,125671.47656009515,229,0,29.13953488372093,37,6,20,40.75010938525485,0.5737612612612613,49.39692982456139,1002.4122807017525,27.092223802750066,0
4169,4,3,2,42,0.06818181818181818,0.045454545454545456,0.9545454545454546,44,1400,900,500,0.6428571428571429,19,9,10,333.5159122688846,0.48044397463002114,0.21858236377887064,0.17267423840425536,126439.93391617952,-363.7456159601832,126076.18830021934,219,0,24.09090909090909,36,8,18,40.17840480722575,0.5842013888888888,48.56418918918918,1005.7432432432417,27.937312312312272,0
4170,4,1,6,37,0.023255813953488372,0.13953488372093023,0.8604651162790697,43,1050,500,550,0.47619047619047616,16,5,11,363.1215384938205,0.48244278331487633,0.12487133970792219,0.18086468962040475,124839.79495397776,812.909393581182,125652.70434755895,220,0,25.0,38,5,18,41.08803720333545,0.5641447368421053,50.160256410256416,999.3589743589753,26.29892037786777,16
4171,4,5,6,36,0.11904761904761904,0.14285714285714285,0.8571428571428572,42,1300,1000,300,0.7692307692307693,16,10,6,347.16745237192924,0.48275987224157957,0.13632412784955195,0.17827460716141,126103.61571712019,379.0308344738329,126482.64655159402,221,0,21.952380952380953,34,8,19,40.18139346529178,0.5848651960784313,48.898809523809526,1004.4047619047619,29.541316526610643,0
4172,4,1,1,36,0.02702702702702703,0.02702702702702703,0.972972972972973,37,950,600,350,0.631578947368421,13,6,7,371.6737215257241,0.48132507507507505,0.13440888703257525,0.18991059748671513,125898.59992551872,1958.6402338391645,127857.24015935788,222,0,24.10810810810811,35,2,20,39.77782743243762,0.580654761904762,49.10300925925926,1003.5879629629633,28.673941798941808,0
4173,4,4,2,38,0.1,0.05,0.95,40,1750,1400,350,0.8,21,14,7,351.0699110658851,0.4813701923076923,0.08350104094378907,0.17626889959788847,125173.67139274676,1090.2027606309812,126263.87415337775,223,0,22.95,35,5,19,41.04354614850797,0.5732142857142857,49.82638888888888,1000.6944444444432,28.591269841269806,16
4174,4,1,1,38,0.02564102564102564,0.02564102564102564,0.9743589743589743,39,1400,1000,400,0.7142857142857143,18,10,8,344.1835626814795,0.4797570850202429,0.10063382310573332,0.17444383302193447,125563.69714308919,843.3921252333579,126407.08926832254,224,0,24.205128205128204,36,3,17,40.81296816479402,0.5752314814814814,49.436936936936945,1002.2522522522535,27.840340340340376,0
4175,4,2,5,35,0.05,0.125,0.875,40,1200,1000,200,0.8333333333333334,14,10,4,370.8509095324278,0.4811565170940171,0.09829069254521405,0.17925778505543985,123578.62515389333,1244.0470266206357,124822.67218051397,225,0,24.45,37,3,15,42.20702837817968,0.552927927927928,51.42543859649122,994.2982456140337,26.872925557136046,16
4176,4,5,6,34,0.125,0.15,0.85,40,1000,800,200,0.8,12,8,4,342.25523546425484,0.483079594017094,0.12940792905581655,0.16953573291601465,124609.68017578125,529.6630859375,125139.34326171875,226,0,24.3,39,1,13,41.84761345852896,0.5600961538461539,50.390625,998.4375,25.60096153846154,0
4177,4,3,1,36,0.08108108108108109,0.02702702702702703,0.972972972972973,37,1050,600,450,0.5714285714285714,15,6,9,397.88389805367814,0.4820758258258258,0.12168157509772426,0.19435950908640678,124023.37970934102,2970.479786521325,126993.85949586234,227,0,26.675675675675677,32,5,20,41.07037224827819,0.5680338541666667,50.978535353535364,996.0858585858598,31.12768308080812,16
4178,4,4,1,39,0.1,0.025,0.975,40,1000,500,500,0.5,15,5,10,371.1113749064614,0.48334668803418807,0.15299785867237659,0.18635377643152432,125178.63520408174,1294.873209652712,126473.50841373445,228,0,25.55,34,6,21,40.5370172099294,0.5753676470588236,49.82142857142858,1000.7142857142867,29.432773109243726,0
4179,4,6,9,36,0.13333333333333333,0.2,0.8,45,400,100,300,0.25,7,1,6,324.9723458955664,0.4867003367003367,0.15765107743740692,0.16832136244494814,126457.07242853568,-772.05050288237,125685.02192565332,229,0,23.244444444444444,37,8,13,40.37562683963806,0.5824887387387387,48.547149122807014,1005.8114035087717,27.18409198672356,0
4180,4,4,6,34,0.1,0.15,0.85,40,1250,1000,250,0.8,15,10,5,347.8209855869842,0.4844684829059829,0.13756481161424117,0.17872932705206848,126131.0191213349,774.2030767746933,126905.2221981096,230,0,25.4,35,5,18,40.13675250604909,0.5830357142857143,48.87152777777778,1004.513888888889,28.70039682539683,0
4181,4,4,4,34,0.10526315789473684,0.10526315789473684,0.8947368421052632,38,850,400,450,0.47058823529411764,13,4,9,402.1986702483329,0.4831377430061641,0.1314419216486935,0.20141396250636892,125065.11264377195,2776.411720558482,127841.52436433043,231,0,26.105263157894736,31,7,20,39.87731059619892,0.5813172043010753,49.93489583333335,1000.2604166666687,32.266465053763504,14
4182,4,3,4,33,0.08108108108108109,0.10810810810810811,0.8918918918918919,37,1250,1000,250,0.8,15,10,5,387.2420261002638,0.48148148148148145,0.15291750503018142,0.1984116360534341,126012.1416182023,2359.439406693209,128371.58102489551,121,0,20.45945945945946,32,5,18,39.26973298122066,0.5885416666666667,48.989898989899,1004.0404040404046,31.376262626262644,0
4183,4,2,1,34,0.05714285714285714,0.02857142857142857,0.9714285714285714,35,1000,500,500,0.5,15,5,10,387.6533071681048,0.47965686274509806,0.14008001882795962,0.18964490061150127,124086.27188871037,2620.4947199265407,126706.76660863691,122,0,22.114285714285714,32,3,20,41.259557301567185,0.5686848958333333,50.91540404040404,996.3383838383841,31.135574494949502,16
4184,4,7,8,33,0.17073170731707318,0.1951219512195122,0.8048780487804879,41,850,400,450,0.47058823529411764,13,4,9,329.7544717540035,0.48246951219512196,0.1257651178983028,0.1678815065524181,125748.98184673848,93.25781649501985,125842.2396632335,123,0,18.682926829268293,38,3,18,40.983613833262325,0.5734649122807017,49.252136752136764,1002.9914529914548,26.394511920827757,0
4185,4,6,7,32,0.15384615384615385,0.1794871794871795,0.8205128205128205,39,1250,800,450,0.64,17,8,9,322.43260701301364,0.48127530364372473,0.09996208988144506,0.16659018029005718,126355.003652301,348.53992914566396,126703.54358144668,124,0,17.512820512820515,36,3,16,40.54426149940265,0.5833333333333333,48.64864864864865,1005.4054054054059,27.92792792792794,0
4186,4,2,0,34,0.058823529411764705,0.0,1.0,34,850,700,150,0.8235294117647058,10,7,3,365.37206510619524,0.478888146167558,0.11939806759708294,0.18620147897810924,125790.38690248449,2392.058686613617,128182.4455890981,125,0,20.61764705882353,32,2,21,40.04772393538911,0.5862630208333333,49.21085858585859,1003.1565656565662,31.348642676767692,0
4187,4,2,2,34,0.05555555555555555,0.05555555555555555,0.9444444444444444,36,1200,1000,200,0.8333333333333334,14,10,4,343.62842853781035,0.4794973544973545,0.12194007076805691,0.17774827531285273,126402.72285997731,1487.1138038548725,127889.83666383217,126,0,20.416666666666668,34,2,20,39.96241269089619,0.5879289215686274,48.601190476190474,1005.595238095238,29.576330532212882,0
4188,4,3,4,33,0.08108108108108109,0.10810810810810811,0.8918918918918919,37,750,400,350,0.5333333333333333,11,4,7,351.70971125559936,0.47882257257257255,0.08695109157216363,0.1778270596161485,125463.3916323729,1658.3779062036074,127121.76953857651,127,0,19.864864864864863,35,2,17,40.728011398644476,0.5761904761904761,49.537037037037024,1001.85185185185,28.624338624338574,16
4189,4,4,3,34,0.10810810810810811,0.08108108108108109,0.9189189189189189,37,1050,600,450,0.5714285714285714,15,6,9,346.76051750859165,0.4763513513513513,0.11873959267324241,0.17845480291295793,126193.31065759613,1353.1111338568064,127546.42179145293,128,0,20.405405405405407,34,3,21,40.09922985781991,0.5857843137254901,48.809523809523796,1004.7619047619028,29.551820728291258,0
4190,4,5,2,37,0.1282051282051282,0.05128205128205128,0.9487179487179487,39,1000,600,400,0.6,14,6,8,373.26045277277734,0.47922289698605486,0.12477998192283946,0.18457558169222657,124537.46570644715,2170.6995709806506,126708.1652774278,129,0,19.76923076923077,35,4,16,41.148732220160795,0.5666666666666667,50.46296296296296,998.1481481481479,28.518518518518512,16
4191,4,4,5,36,0.0975609756097561,0.12195121951219512,0.8780487804878049,41,550,100,450,0.18181818181818182,10,1,9,360.46902251313963,0.4801067073170732,0.15544273914216178,0.1817870559145502,125356.61363352183,837.4351964065838,126194.04882992842,130,0,19.658536585365855,37,4,17,40.619069126610455,0.5712274774774775,49.64364035087719,1001.4254385964911,27.065552394499758,0
4192,4,4,4,36,0.1,0.1,0.9,40,1000,700,300,0.7,13,7,6,350.251843889038,0.4806891025641025,0.1399289617486339,0.17864015449190088,125823.72100069266,813.9980570945086,126637.71905778717,131,0,19.575,37,3,18,40.392531876138435,0.5760135135135135,49.17763157894738,1003.2894736842117,27.115931721194908,0
4193,4,2,2,36,0.05263157894736842,0.05263157894736842,0.9473684210526316,38,800,500,300,0.625,11,5,6,361.5907445853171,0.4799668089141773,0.15688679474412837,0.18436873965091327,125811.49798525369,1498.4546467763955,127309.9526320301,132,0,21.263157894736842,35,3,20,40.120750653745574,0.5797619047619047,49.18981481481481,1003.2407407407401,28.664021164021147,0
4194,4,2,3,35,0.05263157894736842,0.07894736842105263,0.9210526315789473,38,850,300,550,0.35294117647058826,14,3,11,352.24152290303374,0.47983345187292553,0.1464184852374839,0.18143093516362296,126228.4938485198,1293.226385506997,127521.7202340268,133,0,20.81578947368421,33,5,22,39.92530487804878,0.5883838383838385,48.77450980392157,1004.9019607843138,30.45157456922163,0
4195,4,3,3,35,0.07894736842105263,0.07894736842105263,0.9210526315789473,38,1350,1000,350,0.7407407407407407,17,10,7,350.2715425619858,0.48044096728307256,0.04326655041932059,0.17442815200309014,124831.13814828356,1347.0448000488252,126178.18294833238,134,0,20.31578947368421,36,2,17,41.41804710389903,0.5677083333333333,50.168918918918926,999.3243243243255,27.75900900900904,15
4196,4,2,2,35,0.05405405405405406,0.05405405405405406,0.9459459459459459,37,950,600,350,0.631578947368421,13,6,7,343.6990769000207,0.4786661661661662,0.06731362847037414,0.17266555660884617,125197.14974687547,1206.0289597029696,126403.17870657844,135,0,21.54054054054054,36,1,19,41.203677656502,0.5714699074074074,49.80292792792794,1000.7882882882901,27.799674674674726,0
4197,4,0,1,34,0.0,0.02857142857142857,0.9714285714285714,35,1200,1000,200,0.8333333333333334,14,10,4,368.909434215064,0.47895658263305324,0.029154073049052043,0.1745755983625687,122675.05388480755,2088.3413521107946,124763.39523691835,136,1,23.457142857142856,32,3,20,43.19929475741354,0.5540364583333333,52.33585858585858,990.6565656565647,30.958017676767646,16
4198,4,7,6,35,0.17073170731707318,0.14634146341463414,0.8536585365853658,41,1200,900,300,0.75,15,9,6,320.94993600319356,0.48282520325203254,0.08588292242868345,0.1591825521519196,124662.39043097162,-184.52329204528684,124477.86713892633,137,0,20.75609756097561,36,5,15,42.324932341001364,0.5659722222222222,50.337837837837846,998.6486486486494,27.74024024024026,0
4199,4,7,9,33,0.16666666666666666,0.21428571428571427,0.7857142857142857,42,800,500,300,0.625,11,5,6,308.8945258162177,0.48255420054200543,0.09697398311259642,0.15528589058000822,125225.32667802945,-663.2598815031215,124562.06679652633,138,0,20.69047619047619,36,6,14,42.04545454545453,0.5717592592592593,49.77477477477478,1000.9009009009015,27.80280280280282,0
4200,4,5,2,36,0.13157894736842105,0.05263157894736842,0.9473684210526316,38,650,400,250,0.6153846153846154,9,4,5,337.31695630836884,0.4846046704599336,0.11407377318710199,0.1690312040727571,125091.92866025073,839.125726883872,125931.0543871346,139,0,22.68421052631579,33,5,21,41.47206398791293,0.5767045454545454,49.90808823529411,1000.3676470588225,30.314171122994622,0
4201,4,3,3,36,0.07692307692307693,0.07692307692307693,0.9230769230769231,39,1400,900,500,0.6428571428571429,19,9,10,387.20701318073714,0.48540823211875844,0.24073189705144715,0.18053447687187077,122037.440589099,1995.4534820823656,124032.89407118136,140,0,21.974358974358974,35,4,18,43.41554898285891,0.5407738095238095,52.980324074074076,988.0787037037043,28.230820105820122,16
4202,4,11,11,36,0.23404255319148937,0.23404255319148937,0.7659574468085106,47,1200,900,300,0.75,15,9,6,342.01924163024285,0.48571924144310824,0.31165151030084814,0.17059337021678866,124898.39463943435,-819.9652774590032,124078.42936197534,141,0,17.404255319148938,40,7,17,41.554620780805216,0.5614583333333334,50.10162601626017,999.5934959349606,24.989837398374014,0
4203,4,6,4,38,0.14285714285714285,0.09523809523809523,0.9047619047619048,42,900,400,500,0.4444444444444444,14,4,10,357.9861111111109,0.48577235772357724,0.26309523809523805,0.17899305555555564,125000.00000000013,549.6527777777917,125549.65277777793,142,0,18.69047619047619,37,5,20,41.05034722222222,0.5675675675675675,50.00000000000001,1000.000000000001,27.027027027027053,0
4204,4,2,0,40,0.05,0.0,1.0,40,1350,1100,250,0.8148148148148148,16,11,5,374.3146424771453,0.48564369658119655,0.28963762941806515,0.18755909008559643,125089.30165816324,1364.5514455782306,126453.85310374147,143,0,20.45,34,6,22,40.549506128763525,0.5744485294117647,49.910714285714285,1000.3571428571427,29.42226890756302,0
4205,4,3,2,41,0.06976744186046512,0.046511627906976744,0.9534883720930233,43,1000,700,300,0.7,13,7,6,353.7063635582497,0.4864802510151347,0.2044075742255722,0.1688447358117681,123046.9050365243,953.3963095041792,124000.30134602849,144,0,19.953488372093023,33,10,20,43.18747941370223,0.5555555555555556,51.96078431372548,992.1568627450971,30.065359477124154,16
4206,4,9,13,37,0.18,0.26,0.74,50,1400,1000,400,0.7142857142857143,18,10,8,300.85974603556474,0.49085034013605444,0.22731660437800305,0.15091331128136395,125133.58267815407,-2436.331908989884,122697.25076916418,145,0,17.86,38,12,20,42.340941448656345,0.5671600877192983,49.866452991452995,1000.5341880341887,26.32984705353128,0
4207,4,5,3,39,0.11904761904761904,0.07142857142857142,0.9285714285714286,42,1150,600,550,0.5217391304347826,17,6,11,341.464217048413,0.4856997677119628,0.2680437597180152,0.1716700743264322,125227.96842786988,152.17403835718602,125380.14246622707,146,0,20.333333333333332,31,11,19,41.227749230302216,0.582997311827957,49.77213541666666,1000.9114583333323,32.28746639784943,0
4208,4,0,0,39,0.0,0.0,1.0,39,1300,900,400,0.6923076923076923,17,9,8,350.9860651438057,0.48425551057130006,0.25726429005117524,0.176318882136947,125195.3887939452,988.3673773871392,126183.75617133234,147,1,22.256410256410255,31,8,24,41.02318067482001,0.5826612903225806,49.80468749999999,1000.7812499999991,32.28326612903223,0
4209,4,3,2,40,0.07142857142857142,0.047619047619047616,0.9523809523809523,42,1450,1000,450,0.6896551724137931,19,10,9,324.6040960853154,0.4856634727061557,0.2513756936575733,0.1665704801139108,126074.60359296882,-212.26819077625743,125862.33540219256,148,0,21.595238095238095,33,9,24,40.77778625177956,0.5868055555555556,48.92769607843136,1004.2892156862727,30.433006535947655,0
4210,4,2,2,40,0.047619047619047616,0.047619047619047616,0.9523809523809523,42,1350,1000,350,0.7407407407407407,17,10,7,330.0248798544073,0.48525212930700734,0.2639572570779194,0.1716589194581538,126629.0477971214,-41.8527429353943,126587.195054186,149,0,22.047619047619047,33,9,17,40.072014895085026,0.5924873737373737,48.376225490196084,1006.4950980392165,30.499851455733832,0
4211,4,0,5,35,0.0,0.125,0.875,40,1500,1200,300,0.8,18,12,6,390.31766742497626,0.483480235042735,0.28604185802388193,0.18649598391509353,123086.80428398972,1634.4560698700193,124721.26035385975,150,1,24.1,31,9,16,42.23759458513758,0.5608198924731183,51.920572916666664,992.3177083333327,32.010248655913955,16
4212,4,7,6,36,0.16666666666666666,0.14285714285714285,0.8571428571428572,42,1750,1200,550,0.6857142857142857,23,12,11,353.05145912229875,0.48403019744483156,0.2542572850035536,0.173419704994091,124257.05959467114,373.82723922901437,124630.88683390015,151,0,22.19047619047619,34,8,13,41.94402985074624,0.5658700980392157,50.74404761904761,997.0238095238091,29.324229691876738,0
4213,4,2,0,38,0.05263157894736842,0.0,1.0,38,1000,700,300,0.7,13,7,6,398.2073174456918,0.48085585585585583,0.32505419524503365,0.19361294718879507,123826.69103725869,2261.7388932246567,126088.42993048334,152,0,25.473684210526315,30,8,18,41.267724510465904,0.5711805555555556,51.17607526881721,995.2956989247316,33.17652329749105,0
4214,4,7,1,44,0.15555555555555556,0.022222222222222223,0.9777777777777777,45,1650,1100,550,0.6666666666666666,22,11,11,336.17663624133274,0.4858585858585858,0.2674904383642249,0.1620800548346508,123469.6252693134,-539.4923904385792,122930.13287887482,153,0,22.355555555555554,37,8,18,43.182277875845834,0.5518018018018018,51.53508771929823,993.8596491228052,26.861071597913654,16
4215,4,6,9,41,0.12,0.18,0.8200000000000001,50,1550,1200,350,0.7741935483870968,19,12,7,300.266920785068,0.48795918367346935,0.2528334492005173,0.14915577826269572,124727.33139841554,-2508.727795311107,122218.60360310444,154,0,20.52,41,9,15,42.77433624656538,0.558180894308943,50.27281746031745,998.9087301587276,24.363627564847015,0
4216,4,7,13,35,0.14583333333333334,0.2708333333333333,0.7291666666666667,48,1400,900,500,0.6428571428571429,19,9,10,323.73234821155876,0.48835512706855794,0.3005519165453667,0.16370440195051394,125469.18945312512,-1476.0152165611466,123993.17423656397,155,0,19.729166666666668,39,9,15,41.42276634088863,0.5689102564102564,49.53125000000001,1001.8750000000009,25.689102564102587,0
4217,4,6,6,35,0.14634146341463414,0.14634146341463414,0.8536585365853658,41,1400,1000,400,0.7142857142857143,18,10,8,350.60626896822396,0.4849847560975609,0.2582820431794002,0.17694364372103566,125387.20415249416,592.3079648525837,125979.51211734675,156,0,20.073170731707318,34,7,19,40.83437339038788,0.5775122549019608,49.61309523809523,1001.5476190476177,29.457282913165226,0
4218,4,3,2,36,0.07894736842105263,0.05263157894736842,0.9473684210526316,38,1050,600,450,0.5714285714285714,15,6,9,361.9062473397858,0.4863086770981508,0.24276962246887046,0.18344902882396028,125568.82747933871,1488.828627180881,127057.65610651959,157,0,20.92105263157895,32,6,21,40.363599143361036,0.583984375,49.43181818181817,1002.2727272727262,31.321022727272695,0
4219,4,1,1,36,0.02702702702702703,0.02702702702702703,0.972972972972973,37,1000,700,300,0.7,13,7,6,365.3044879108441,0.4834834834834835,0.2394668081979261,0.1860242853822913,125758.7235996326,1788.0452249770287,127546.76882460964,158,0,21.756756756756758,32,5,22,40.08213746223563,0.5859375,49.242424242424235,1003.0303030303023,31.344696969696948,0
4220,4,2,1,37,0.05263157894736842,0.02631578947368421,0.9736842105263158,38,1550,1100,450,0.7096774193548387,20,11,9,348.4519201505427,0.4834637268847795,0.23237441429661088,0.18097019078786275,126567.38281250025,1220.8523444674297,127788.23515696768,159,0,21.68421052631579,33,5,20,39.6717563837129,0.5918560606060606,48.437500000000014,1006.2500000000019,30.492424242424303,0
4221,4,0,0,37,0.0,0.0,1.0,37,1700,1300,400,0.7647058823529411,21,13,8,354.4391733630912,0.48148148148148145,0.2256726252211576,0.18472535741158802,126710.35640495905,1582.222796143295,128292.57920110234,160,1,23.10810810810811,32,5,23,39.37405944319036,0.595703125,48.29545454545457,1006.8181818181848,31.463068181818276,0
4222,4,2,2,37,0.05128205128205128,0.05128205128205128,0.9487179487179487,39,1200,900,300,0.75,15,9,6,339.75312426244994,0.48071300044984255,0.21904053326558626,0.17980193430068991,127332.2066326532,852.3030045351645,128184.50963718836,161,0,22.871794871794872,34,5,19,39.10587206102069,0.5974264705882353,47.67857142857144,1009.2857142857154,29.684873949579863,0
4223,4,1,4,34,0.02631578947368421,0.10526315789473684,0.8947368421052632,38,1050,800,250,0.7619047619047619,13,8,5,349.30058721003536,0.4809447605500237,0.23707210487982522,0.18516977074879498,127401.12727076143,1300.257713379495,128701.38498414092,162,0,24.289473684210527,33,5,20,38.79430687059967,0.6003787878787878,47.61029411764707,1009.5588235294133,30.592691622103434,0
4224,4,1,2,33,0.02857142857142857,0.05714285714285714,0.9428571428571428,35,800,500,300,0.625,11,5,6,363.7085411215619,0.48060224089635856,0.21582224842477626,0.1928998651064699,127420.45932345913,2268.7818739149197,129689.24119737405,163,0,25.428571428571427,31,4,22,38.410820221820984,0.605510752688172,47.59114583333333,1009.6354166666661,32.56888440860213,0
4225,4,2,0,35,0.05714285714285714,0.0,1.0,35,1300,900,400,0.6923076923076923,17,9,8,348.7719727009053,0.4783263305322129,0.17823723375813216,0.1877372304363838,128016.72222541059,1929.7289498520481,129946.45117526264,164,0,24.714285714285715,32,3,25,38.177375753794976,0.6090494791666667,47.00126262626262,1011.9949494949487,31.624842171717148,0
4226,4,1,2,34,0.027777777777777776,0.05555555555555555,0.9444444444444444,36,1000,700,300,0.7,13,7,6,339.5791291099902,0.47764550264550265,0.1817373309524799,0.18454987605727063,128400.34060618804,1520.4789370982405,129920.81954328628,165,0,25.0,32,4,17,38.018302811345045,0.6129557291666667,46.62247474747474,1013.5101010101001,31.67219065656563,0
4227,4,1,1,34,0.02857142857142857,0.02857142857142857,0.9714285714285714,35,1750,1300,450,0.7428571428571429,22,13,9,339.39730149122386,0.47587535014005605,0.15788238640403907,0.18578996694710292,128688.43102744601,1735.3012447709184,130423.73227221693,127,0,21.65714285714286,32,3,21,37.72917703666831,0.6158854166666667,46.33838383838383,1014.6464646464633,31.707702020201978,0
4228,4,3,0,37,0.08108108108108109,0.0,1.0,37,1150,800,350,0.6956521739130435,15,8,7,320.81909598979166,0.4749436936936937,0.14618424736468572,0.17875437147028525,129388.34372597079,903.0705972070843,130291.41432317787,128,0,20.83783783783784,33,4,25,37.48946037099493,0.6205808080808081,45.64950980392157,1017.4019607843138,30.83036244800951,0
4229,4,0,3,34,0.0,0.08108108108108109,0.9189189189189189,37,1200,900,300,0.75,15,9,6,320.0280430845069,0.4734734734734735,0.13221742623596056,0.179306339176613,129606.62853529908,895.5511401864858,130502.17967548556,129,1,21.83783783783784,33,4,15,37.28825670959202,0.622790404040404,45.43504901960785,1018.2598039215699,30.856357694593026,0
4230,4,2,1,35,0.05555555555555555,0.027777777777777776,0.9722222222222222,36,1150,900,250,0.782608695652174,14,9,5,329.4809562447503,0.472255291005291,0.1440602104335369,0.18511506650297016,129715.36705438247,1347.748635343365,131063.11568972583,130,0,23.13888888888889,32,4,19,36.93733473805983,0.6263020833333333,45.328282828282845,1018.6868686868709,31.833964646464715,0
4231,4,0,5,30,0.0,0.14285714285714285,0.8571428571428572,35,1500,1000,500,0.6666666666666666,20,10,10,379.31492697898307,0.4715336134453782,0.04010647737355799,0.19699904272134286,126567.38281250001,2733.797292686972,129301.18010518698,131,1,24.34285714285714,33,2,18,38.89535886818495,0.5918560606060606,48.4375,1006.2500000000001,30.492424242424246,15
4232,4,2,2,30,0.0625,0.0625,0.9375,32,900,500,400,0.5555555555555556,13,5,8,379.87350623298164,0.4703461021505377,0.05081002067450591,0.1990413720201117,126927.95011732339,3243.313090006546,130171.26320732993,132,0,24.5,31,1,21,38.50963195072577,0.6004704301075269,48.07942708333335,1007.6822916666687,32.50588037634415,0
4233,4,2,1,31,0.0625,0.03125,0.96875,32,1050,800,250,0.7619047619047619,13,8,5,362.98502956130926,0.46948504704301075,0.028776427742683852,0.19298662606628372,127519.07560560456,2857.609049479188,130376.68465508375,133,0,22.71875,31,1,18,38.32788126853165,0.606518817204301,47.49348958333334,1010.0260416666681,32.58148521505381,0
4234,4,2,2,31,0.06060606060606061,0.06060606060606061,0.9393939393939394,33,600,300,300,0.5,9,3,6,358.599740197604,0.4685921717171717,0.04698595639449166,0.19287371261366465,127984.77993317031,2579.0617666564963,130563.84169982681,134,0,22.96969696969697,32,1,20,37.96143207719826,0.6087239583333333,47.0328282828283,1011.8686868686887,31.62089646464652,0
4235,4,1,2,30,0.03125,0.0625,0.9375,32,800,600,200,0.75,10,6,4,367.0414871950688,0.46685987903225806,0.05817835746380462,0.19710029459831713,127920.90730537701,2990.4560121416253,130911.36331751864,135,0,24.15625,32,0,21,37.813332085205545,0.6080729166666667,47.0959595959596,1011.6161616161617,31.613005050505052,0
4236,4,2,1,31,0.0625,0.03125,0.96875,32,1000,700,300,0.7,13,7,6,363.8061514032609,0.46543178763440857,0.06137173968906584,0.19759269200080784,128375.34798516154,2940.9435496793726,131316.29153484092,136,0,24.34375,31,1,17,37.430002355561264,0.615255376344086,46.64713541666666,1013.4114583333322,32.69069220430104,0
4237,4,1,2,30,0.03125,0.0625,0.9375,32,750,400,350,0.5333333333333333,11,4,7,364.8316445329175,0.464864751344086,0.06319801026957661,0.1993014383528347,128606.37240939648,2983.934868706572,131590.30727810305,137,0,25.3125,31,1,18,37.16784338896021,0.6176075268817205,46.41927083333332,1014.3229166666649,32.72009408602145,0
4238,4,0,0,30,0.0,0.0,1.0,30,1050,600,450,0.5714285714285714,15,6,9,374.4226856620508,0.4628831417624521,0.03094796360102503,0.20444237235932178,128587.20119377926,3629.193042548226,132216.39423632747,138,1,24.2,30,0,18,36.9442419825073,0.6201388888888889,46.43817204301073,1014.2473118279539,33.808243727598466,0
4239,4,1,3,28,0.03225806451612903,0.0967741935483871,0.9032258064516129,31,1100,800,300,0.7272727272727273,14,8,6,411.45273266248716,0.46379928315412183,-0.015480291709543348,0.2074527414333239,125347.46334876535,4313.7104401921715,129661.17378895752,139,0,24.387096774193548,29,2,17,39.35217290799814,0.5897988505747127,49.65277777777777,1001.3888888888882,34.530651340996144,16
4240,4,1,1,28,0.034482758620689655,0.034482758620689655,0.9655172413793104,29,1250,1100,150,0.88,14,11,3,410.80837034315203,0.46346469622331693,0.041074905367608494,0.20863324659785407,125647.38778240191,4523.399722552521,130170.78750495444,140,0,26.413793103448278,28,1,19,39.05667813126972,0.5959821428571428,49.35344827586207,1002.5862068965519,35.80665024630542,0
4241,4,4,3,29,0.125,0.09375,0.90625,32,1050,800,250,0.7619047619047619,13,8,5,373.48001005459815,0.4694220430107527,0.06563025074318207,0.19537625678109694,126862.35427856437,3076.1106703016344,129938.464948866,141,0,24.71875,31,1,20,38.73823294989443,0.5997983870967742,48.14453124999999,1007.4218749999993,32.49747983870966,0
4242,4,7,4,32,0.19444444444444445,0.1111111111111111,0.8888888888888888,36,700,600,100,0.8571428571428571,8,6,2,331.6426711706252,0.4696924603174603,0.05085841956726256,0.1789523652052661,128114.3990929704,1297.847995195786,129412.24708816619,142,0,21.38888888888889,34,2,21,38.5110438225149,0.6053921568627452,46.9047619047619,1012.3809523809514,29.77591036414563,0
4243,4,1,0,33,0.030303030303030304,0.0,1.0,33,1250,900,350,0.72,16,9,7,357.16729123071445,0.4663036616161616,0.0656728303256704,0.19082516736572863,127716.42261081278,2523.225741916237,130239.64835272901,143,0,24.272727272727273,31,2,22,38.27249452531237,0.6085349462365591,47.298177083333336,1010.8072916666672,32.606686827957006,0
4244,4,1,1,33,0.029411764705882353,0.029411764705882353,0.9705882352941176,34,700,500,200,0.7142857142857143,9,5,4,347.373809278338,0.46583481877599525,0.07684181180579008,0.18743224783268608,128112.5730155087,2100.590500969299,130213.16351647799,144,0,24.529411764705884,32,2,23,38.11476261744409,0.6100260416666667,46.90656565656566,1012.3737373737379,31.63667929292931,0
4245,4,1,2,32,0.029411764705882353,0.058823529411764705,0.9411764705882353,34,950,800,150,0.8421052631578947,11,8,3,341.7254873567211,0.4654263220439691,0.07208191026223609,0.18556757520467132,128368.35048719514,1973.3474262830268,130341.69791347817,145,0,24.88235294117647,32,2,16,37.99656325276185,0.6126302083333333,46.6540404040404,1013.3838383838381,31.66824494949494,0
4246,4,1,0,33,0.030303030303030304,0.0,1.0,33,900,700,200,0.7777777777777778,11,7,4,341.083652681896,0.46381786616161613,0.07236375703274645,0.18671309488771917,128688.43102744625,2178.7040225487235,130867.13504999498,146,0,24.939393939393938,32,1,17,37.68640077982412,0.6158854166666667,46.33838383838384,1014.6464646464651,31.707702020202035,0
4247,4,0,3,30,0.0,0.09090909090909091,0.9090909090909091,33,700,500,200,0.7142857142857143,9,5,4,388.5583737476859,0.4639756944444444,0.027937878405168037,0.19398519567050285,124936.87665799401,3196.3536883991333,128133.23034639315,147,1,25.939393939393938,32,1,19,40.351624989475454,0.5774739583333333,50.06313131313131,999.7474747474741,31.242108585858567,16
4248,4,5,4,31,0.14285714285714285,0.11428571428571428,0.8857142857142857,35,1000,800,200,0.8,12,8,4,355.6799524092799,0.46705182072829127,0.08365156794425088,0.18320198553744324,126228.49384851982,1984.2712512519893,128212.76509977182,148,0,24.97142857142857,33,2,22,39.83892276422763,0.5883838383838385,48.77450980392157,1004.9019607843139,30.451574569221634,0
4249,4,4,3,32,0.11428571428571428,0.08571428571428572,0.9142857142857143,35,650,400,250,0.6153846153846154,9,4,5,346.380092978378,0.47139355742296923,0.0994323557237462,0.18035653117150027,126672.22222222229,1775.3472222222279,128447.56944444453,149,0,25.62857142857143,34,1,19,39.61610099337746,0.5906862745098039,48.333333333333336,1006.6666666666673,29.60784313725492,0
4250,4,5,2,35,0.13513513513513514,0.05405405405405406,0.9459459459459459,37,1450,1200,250,0.8275862068965517,17,12,5,332.35849349859393,0.46996996996997,0.1403869497361705,0.17687956897900795,127559.26354595348,1079.7753772290919,128639.03892318257,150,0,25.10810810810811,35,2,17,39.06011304613504,0.5976190476190476,47.45370370370371,1010.1851851851861,28.86243386243389,0
4251,4,1,1,35,0.027777777777777776,0.027777777777777776,0.9722222222222222,36,850,600,250,0.7058823529411765,11,6,5,340.1491139212933,0.4681712962962963,0.138751375137514,0.18081610792658218,127512.49999999999,1474.6527777777771,128987.15277777777,151,0,26.583333333333332,34,2,18,38.91123487348736,0.5992647058823529,47.5,1009.9999999999999,29.705882352941174,0
4252,4,2,1,36,0.05405405405405406,0.02702702702702703,0.972972972972973,37,950,500,450,0.5263157894736842,14,5,9,331.87004822293045,0.4714401901901902,0.13756515609638442,0.17842607389697768,127968.81028163576,1093.8030478394971,129062.61332947525,152,0,26.16216216216216,35,2,21,38.65391214824982,0.6017857142857144,47.04861111111111,1011.8055555555552,28.908730158730148,0
4253,4,0,2,34,0.0,0.05555555555555555,0.9444444444444444,36,1200,600,600,0.5,18,6,12,331.87004822293045,0.4708333333333334,0.1202051399374664,0.17842607389697768,127968.81028163576,1293.8030478394971,129262.61332947525,153,1,26.61111111111111,35,1,21,38.65391214824982,0.6017857142857144,47.04861111111111,1011.8055555555552,28.908730158730148,0
4254,4,2,2,34,0.05555555555555555,0.05555555555555555,0.9444444444444444,36,1100,700,400,0.6363636363636364,15,7,8,318.4332580918089,0.47000661375661373,0.08430398538312245,0.17309249168901106,128408.33875868046,978.0176986882609,129386.35645736872,79,0,22.805555555555557,35,1,15,38.54594895512162,0.60625,46.61458333333333,1013.5416666666658,28.95833333333331,0
4255,4,2,2,34,0.05555555555555555,0.05555555555555555,0.9444444444444444,36,1050,900,150,0.8571428571428571,12,9,3,361.0795578691165,0.4696924603174603,0.013406214039125786,0.18699531334223038,126450.94548396788,1934.2117037465846,128385.15718771446,80,0,23.583333333333332,35,1,18,39.47401227464517,0.5863095238095238,48.55324074074075,1005.7870370370381,28.736772486772516,16
4256,4,0,1,33,0.0,0.029411764705882353,0.9705882352941176,34,1200,1000,200,0.8333333333333334,14,10,4,376.9517322334294,0.4680072786690434,0.026958991350746198,0.19445019545777284,126290.07623269898,2721.05259996155,129011.12883266053,81,1,25.61764705882353,33,1,18,39.240937169795956,0.5890151515151515,48.713235294117645,1005.1470588235296,30.4590017825312,0
4257,4,3,4,32,0.08333333333333333,0.1111111111111111,0.8888888888888888,36,900,700,200,0.7777777777777778,11,7,4,359.55282763555607,0.4685185185185185,0.07864200442924374,0.1904215131493987,127362.2466695008,1961.2292711201735,129323.47594062098,82,0,24.944444444444443,34,2,18,38.57545111451821,0.5977328431372548,47.648809523809504,1009.4047619047593,29.688375350139978,0
4258,4,1,0,33,0.030303030303030304,0.0,1.0,33,1000,500,500,0.5,15,5,10,370.4539345107926,0.4664220328282828,0.0898635955239726,0.18227905796220709,124328.86027286401,2939.244974351181,127268.1052472152,83,0,25.78787878787879,30,3,20,41.43559074573226,0.5763888888888888,50.672043010752695,997.3118279569901,33.24372759856634,16
4259,4,2,0,35,0.05714285714285714,0.0,1.0,35,1000,300,700,0.3,17,3,14,348.9583333333333,0.4684523809523809,0.09333333333333327,0.17447916666666657,124999.99999999988,1723.9583333333187,126723.9583333332,84,0,25.257142857142856,32,3,23,41.276041666666664,0.578125,49.99999999999999,999.9999999999991,31.24999999999997,0
4260,4,2,5,32,0.05405405405405406,0.13513513513513514,0.8648648648648649,37,850,600,250,0.7058823529411765,11,6,5,328.0742231916941,0.47028278278278274,0.07628062897161114,0.16604935277236854,125506.4643565759,835.0871598639337,126341.55151643984,85,0,24.83783783783784,34,3,17,41.27559304581995,0.5787377450980392,49.49404761904761,1002.0238095238091,29.471288515406147,0
4261,4,6,2,36,0.15789473684210525,0.05263157894736842,0.9473684210526316,38,1100,600,500,0.5454545454545454,16,6,10,319.73785574519945,0.4715208629682314,0.10713636198305032,0.16464792785170926,126218.23157793195,471.3493441357869,126689.58092206773,86,0,24.605263157894736,35,3,21,40.75241879751211,0.5839285714285714,48.784722222222214,1004.86111111111,28.710317460317427,0
4262,4,2,4,34,0.05263157894736842,0.10526315789473684,0.8947368421052632,38,1400,800,600,0.5714285714285714,20,8,12,319.73217768518873,0.47206910858226653,0.1185027786858448,0.16605445357198512,126567.38281250001,493.53298611111137,127060.91579861112,87,0,25.55263157894737,35,3,17,40.39423740510696,0.5875,48.4375,1006.2500000000001,28.750000000000004,0
4263,4,7,6,35,0.17073170731707318,0.14634146341463414,0.8536585365853658,41,1300,1000,300,0.7692307692307693,16,10,6,290.5535764899898,0.4741615853658536,0.10488114398910553,0.15470014748250807,127577.25180802103,-786.3946416830981,126790.85716633793,88,0,22.853658536585368,38,3,16,40.09755710659899,0.5921052631578947,47.43589743589744,1010.2564102564102,26.585695006747635,0
4264,4,2,3,34,0.05405405405405406,0.08108108108108109,0.9189189189189189,37,1100,700,400,0.6363636363636364,15,7,8,367.51934310318,0.4738488488488488,0.08761347749375736,0.1805780390585767,124269.08961326179,1919.8121320684832,126188.90174533028,89,0,26.10810810810811,36,1,13,41.5709001581206,0.5619212962962963,50.731981981981974,997.072072072071,27.696446446446416,16
4265,4,3,1,36,0.08108108108108109,0.02702702702702703,0.972972972972973,37,600,200,400,0.3333333333333333,10,2,8,430.7656918513451,0.47434934934934936,0.2477364998064171,0.20396366828232038,122699.48535495349,3864.876579369523,126564.36193432301,90,0,26.56756756756757,31,6,20,41.64161409734088,0.5567876344086021,52.31119791666668,990.7552083333346,31.959845430107567,16
4266,4,8,3,41,0.18181818181818182,0.06818181818181818,0.9318181818181819,44,1250,900,350,0.72,16,9,7,318.08507358591237,0.48031183932346727,0.13339137744686003,0.1553486456158294,124015.10560941824,-749.5871236559858,123265.51848576225,91,0,23.113636363636363,37,7,19,43.06610523998239,0.5574324324324325,50.98684210526316,996.0526315789471,26.920341394025595,14
4267,4,8,7,42,0.16326530612244897,0.14285714285714285,0.8571428571428572,49,1200,800,400,0.6666666666666666,16,8,8,360.4628770504721,0.484109268707483,0.1583126974639233,0.17581760737767915,123960.50347222213,155.32279162818713,124115.82626385032,92,0,21.448979591836736,36,13,20,42.067642956764324,0.5587384259259259,51.041666666666664,995.8333333333326,27.662037037037017,16
4268,4,3,7,38,0.06666666666666667,0.15555555555555556,0.8444444444444444,45,1250,900,350,0.72,16,9,7,347.36312105630185,0.48282828282828283,0.2260466398506329,0.17216706508698842,124634.27690781976,-341.32971654088783,124292.94719127887,93,0,24.08888888888889,36,9,12,41.69462614187437,0.5656828703703703,50.36599099099098,998.5360360360343,27.73711211211206,0
4269,4,3,3,38,0.07317073170731707,0.07317073170731707,0.926829268292683,41,950,900,50,0.9473684210526315,10,9,1,360.5643811133664,0.4811229674796748,0.2154037688868773,0.17780692020579025,124421.9660922495,772.4258401920267,125194.39193244152,94,0,25.5609756097561,35,6,14,41.58546017014695,0.5654761904761905,50.578703703703695,997.6851851851839,28.505291005290967,0
4270,4,4,5,37,0.09523809523809523,0.11904761904761904,0.8809523809523809,42,1150,700,450,0.6086956521739131,16,7,9,352.24345550731925,0.48378823073945026,0.22068669987680156,0.1773184778856211,125281.69005153808,427.2706750168666,125708.96072655496,95,0,24.761904761904763,36,6,12,40.90246531683539,0.572337962962963,49.71846846846847,1001.1261261261266,27.80905905905907,0
4271,4,2,1,38,0.05128205128205128,0.02564102564102564,0.9743589743589743,39,800,500,300,0.625,11,5,6,386.0693799062895,0.48206252811515965,0.23430518371314957,0.18777929525284945,123841.98022959167,1822.6964027941185,125664.67663238579,96,0,26.871794871794872,34,5,18,41.55379141251048,0.5615808823529411,51.16071428571428,995.3571428571415,29.275210084033574,16
4272,4,9,8,39,0.19148936170212766,0.1702127659574468,0.8297872340425532,47,950,600,350,0.631578947368421,13,6,7,322.2310762122075,0.48693339500462535,0.21636542304762174,0.16470538033446272,125913.11984592032,-1279.873567265423,124633.24627865489,97,0,22.106382978723403,39,8,13,41.00339474139424,0.5734508547008548,49.08854166666668,1003.6458333333348,25.734508547008584,0
4273,4,3,3,39,0.07142857142857142,0.07142857142857142,0.9285714285714286,42,1050,800,250,0.7619047619047619,13,8,5,349.91161155258175,0.48501016260162605,0.23594667028530725,0.1777415918272523,125655.61933106577,393.6720521541938,126049.29138321997,98,0,25.238095238095237,34,8,14,40.57453692709569,0.5802696078431373,49.345238095238095,1002.6190476190477,29.488795518207287,0
4274,4,1,0,40,0.025,0.0,1.0,40,1200,1000,200,0.8333333333333334,14,10,4,367.98529124934976,0.4840811965811966,0.25375771702154504,0.18638795511461945,125537.19207542588,1239.168037700225,126776.3601131261,99,0,27.1,32,8,15,40.24400487169796,0.5836588541666667,49.463383838383834,1002.1464646464639,31.317077020201996,0
4275,4,1,5,36,0.024390243902439025,0.12195121951219512,0.8780487804878049,41,1400,900,500,0.6428571428571429,19,9,10,360.29974354359587,0.4836382113821138,0.24427753614775294,0.18461136953425134,126013.07377270752,880.4956326893421,126893.56940539686,100,0,27.414634146341463,33,8,17,39.94504963586803,0.5861742424242424,48.98897058823529,1004.0441176470581,30.425579322638125,0
4276,4,3,3,36,0.07692307692307693,0.07692307692307693,0.9230769230769231,39,900,400,500,0.4444444444444444,14,4,10,360.6919071025806,0.4830184435447593,0.22063038200844232,0.186281084597928,126338.19792005743,1313.836864103303,127652.03478416073,101,0,27.256410256410255,31,8,14,39.59992768639643,0.5944220430107527,48.66536458333333,1005.338541666666,32.43027553763439,0
4277,4,2,3,35,0.05263157894736842,0.07894736842105263,0.9210526315789473,38,1200,1000,200,0.8333333333333334,14,10,4,369.9516578975063,0.4827821242294927,0.23601918735097827,0.19158119419010688,126449.06790163623,1756.0084619609502,128205.07636359718,102,0,28.44736842105263,30,8,16,39.252862042852705,0.5982638888888889,48.555107526881734,1005.7795698924747,33.52598566308249,0
4278,4,1,2,34,0.027777777777777776,0.05555555555555555,0.9444444444444444,36,800,400,400,0.5,12,4,8,382.626239839689,0.4798941798941799,0.22224140312111618,0.19804121534518873,126427.66444830252,2474.9083719135892,128902.57282021611,103,0,28.72222222222222,29,7,17,38.95626179625282,0.600933908045977,48.57638888888889,1005.6944444444448,34.67911877394637,0
4279,4,3,3,34,0.08108108108108109,0.08108108108108109,0.9189189189189189,37,1050,900,150,0.8571428571428571,12,9,3,372.9254197577545,0.47935435435435436,0.23550118236494577,0.19734298639612274,127329.2997203435,2096.8665091340167,129426.16622947752,104,0,26.81081081081081,30,7,17,38.27185155591068,0.6072916666666667,47.68145161290323,1009.2741935483879,33.6424731182796,0
4280,4,1,3,32,0.02857142857142857,0.08571428571428572,0.9142857142857143,35,1050,600,450,0.5714285714285714,15,6,9,413.169457380097,0.4792016806722689,0.2545022703457911,0.2096604318467241,125613.49601114949,3379.9319973087177,128993.4280084582,105,0,28.142857142857142,33,2,17,39.032701711491434,0.5820707070707071,49.38725490196078,1002.4509803921562,30.377302436125944,14
4281,4,1,1,32,0.030303030303030304,0.030303030303030304,0.9696969696969697,33,1400,1100,300,0.7857142857142857,17,11,6,425.7521526512013,0.47881155303030304,0.25795739792104366,0.21658805017962718,125717.17156304269,4104.871283637176,129822.04284667986,106,0,27.939393939393938,31,2,18,38.60956028737125,0.5880376344086021,49.28385416666668,1002.8645833333346,32.35047043010757,0
4282,4,4,3,33,0.1111111111111111,0.08333333333333333,0.9166666666666666,36,1000,800,200,0.8,12,8,4,397.57759059302407,0.47961309523809526,0.2543441938178783,0.20818039192469365,126901.11340679514,2891.4554928726097,129792.56889966775,107,0,26.36111111111111,32,4,21,38.09132205513785,0.59765625,48.1060606060606,1007.5757575757568,31.4867424242424,0
4283,4,1,4,30,0.029411764705882353,0.11764705882352941,0.8823529411764706,34,1000,600,400,0.6,14,6,8,404.9305520595617,0.47749554367201424,0.2580069499462674,0.21249644575889784,126990.3877073938,3484.45756012254,130474.84526751634,108,0,27.647058823529413,30,4,22,37.81393074632171,0.6038194444444445,48.01747311827956,1007.9301075268808,33.59767025089602,0
4284,4,3,2,31,0.09090909090909091,0.06060606060606061,0.9393939393939394,33,800,300,500,0.375,13,3,10,385.17221106981157,0.4736032196969697,0.18619497273573615,0.2055436376887093,127668.66337510115,3234.924919065785,130903.58829416694,80,0,23.12121212121212,30,3,19,37.61387817528927,0.6107638888888889,47.34543010752688,1010.6182795698924,33.68727598566308,0
4285,4,1,0,32,0.03125,0.0,1.0,32,1250,800,450,0.64,17,8,9,394.96378451788155,0.47418934811827956,0.19342586436170217,0.21094656673114096,127702.6245808762,3687.582379465805,131390.206960342,81,0,24.8125,30,2,21,37.33156028368793,0.6111111111111112,47.311827956989234,1010.7526881720414,33.69175627240138,0
4286,4,0,1,31,0.0,0.03125,0.96875,32,1050,800,250,0.7619047619047619,13,8,5,399.41260588062215,0.4734332997311828,0.1941934626627695,0.21440651011822826,127906.48666030742,3817.4926292056734,131723.97928951308,82,1,25.8125,30,2,21,37.009478253166805,0.6131944444444444,47.11021505376343,1011.5591397849452,33.7186379928315,0
4287,4,1,1,31,0.03125,0.03125,0.96875,32,650,400,250,0.6153846153846154,9,4,5,398.2580059101532,0.47353830645161293,0.19097406694116104,0.21433055943513515,128008.47867166712,3796.080291074096,131804.55896274123,83,0,26.65625,30,2,23,36.933855757736744,0.6142361111111111,47.00940860215053,1011.9623655913969,33.73207885304656,0
4288,4,1,0,32,0.03125,0.0,1.0,32,800,500,300,0.625,11,5,6,387.7716471810321,0.47173219086021506,0.15809956843403228,0.21106228581464218,128461.1328124999,3562.7892765782035,132023.9220890781,84,0,25.125,29,3,20,36.73491231675571,0.6217672413793103,46.56249999999999,1013.7499999999992,34.956896551724114,0
4289,4,0,0,32,0.0,0.0,1.0,32,950,700,250,0.7368421052631579,12,7,5,387.9344299003383,0.4713751680107527,0.15893798794685665,0.2115242175281829,128531.54176311722,3572.362075617272,132103.9038387345,85,1,26.125,29,3,20,36.658648358672316,0.6224856321839081,46.49305555555555,1014.0277777777771,34.96647509578542,0
4290,4,1,1,32,0.030303030303030304,0.030303030303030304,0.9696969696969697,33,1150,900,250,0.782608695652174,14,9,5,378.01707021313393,0.47111742424242425,0.15299902144793598,0.20818491126315133,128928.23592322793,3147.4148022892523,132075.6507255172,86,0,26.303030303030305,30,3,21,36.50437841891653,0.6236111111111111,46.102150537634394,1015.5913978494608,33.853046594982025,0
4291,4,1,0,33,0.030303030303030304,0.0,1.0,33,1000,800,200,0.8,12,8,4,376.1929534858757,0.4692629419191919,0.1599916637610066,0.20807570748403104,129098.92265363042,3113.221000982764,132212.14365461317,87,0,27.181818181818183,30,3,22,36.37636115152317,0.6253472222222223,45.93413978494623,1016.2634408602146,33.87544802867382,0
4292,4,0,3,30,0.0,0.09090909090909091,0.9090909090909091,33,950,500,450,0.5263157894736842,14,5,9,400.87478246575716,0.4685527146464647,0.0768058658417825,0.20273686417245293,125473.93322428851,3459.8671372819335,128933.80036157045,88,1,28.181818181818183,32,1,18,39.48566477630751,0.5830078125,49.52651515151516,1001.8939393939409,31.30918560606065,16
4293,4,2,0,32,0.0625,0.0,1.0,32,850,600,250,0.7058823529411765,11,6,5,407.06500766805874,0.47078713037634407,0.04945452155625696,0.1925964290011563,122667.23632812509,3676.38306000346,126343.61938812854,89,0,29.59375,31,1,18,42.26253066947076,0.5564516129032258,52.34375000000001,990.6250000000007,31.955645161290345,16
4294,4,6,2,36,0.15789473684210525,0.05263157894736842,0.9473684210526316,38,1250,700,550,0.56,18,7,11,362.3605404514682,0.47448435277382645,0.08203652036947728,0.178815696578827,124450.8359723294,1432.7778045696182,125883.61377689902,90,0,25.763157894736842,35,3,17,41.51067644898117,0.5657738095238095,50.54976851851852,997.8009259259261,28.50859788359789,0
4295,4,5,1,40,0.12195121951219512,0.024390243902439025,0.975609756097561,41,1250,700,550,0.56,18,7,11,369.59267795688066,0.47553353658536585,0.11252734240086792,0.18706687420138385,125507.27036157795,1161.480190698094,126668.75055227605,91,0,24.75609756097561,36,5,17,40.23469693564095,0.5746527777777778,49.49324324324325,1002.0270270270283,27.83408408408412,15
4296,4,1,1,40,0.024390243902439025,0.024390243902439025,0.975609756097561,41,1500,1000,500,0.6666666666666666,20,10,10,371.54103816056636,0.4767276422764228,0.2459755039874778,0.17424216844822366,122288.15427059299,1023.8829024932888,123312.03717308628,92,0,25.70731707317073,33,8,16,43.53949840994509,0.5476641414141414,52.72671568627451,989.0931372549015,29.972519310754592,16
4297,4,6,5,41,0.13043478260869565,0.10869565217391304,0.8913043478260869,46,1000,600,400,0.6,14,6,8,364.2550844346969,0.4814512882447665,0.3185521270594087,0.17905598582968266,124288.29663935037,-122.75608108991906,124165.54055826046,93,0,23.5,37,9,15,41.63230335019426,0.5602477477477478,50.7127192982456,997.1491228070158,26.94997629208151,0
4298,4,4,4,41,0.08888888888888889,0.08888888888888889,0.9111111111111111,45,1050,300,750,0.2857142857142857,18,3,15,381.9391367945351,0.4798611111111111,0.3411481815449351,0.1899419294641882,124774.87622757905,531.2817040013084,125306.15793158035,94,0,24.77777777777778,36,9,17,40.68534903817251,0.5671296296296297,50.22522522522523,999.0990990991002,27.752752752752784,0
4299,4,4,4,41,0.08888888888888889,0.08888888888888889,0.9111111111111111,45,1650,1200,450,0.7272727272727273,21,12,9,377.953257301106,0.47893518518518513,0.34210668207202,0.1909623725593156,125434.40453800165,481.87126016079435,125916.27579816245,95,0,25.488888888888887,35,10,15,40.10073656845754,0.5758928571428572,49.56597222222223,1001.736111111112,28.621031746031772,0
4300,4,5,4,42,0.10869565217391304,0.08695652173913043,0.9130434782608696,46,1300,1000,300,0.7692307692307693,16,10,6,362.9998911677877,0.48196457326892106,0.31539904458106327,0.18640475239090826,126103.61571711999,-41.92644360987498,126061.68927351011,96,0,25.17391304347826,34,12,18,39.783839042313616,0.5848651960784313,48.89880952380951,1004.4047619047603,29.541316526610597,0
4301,4,7,5,44,0.14285714285714285,0.10204081632653061,0.8979591836734694,49,1600,1300,300,0.8125,19,13,6,335.6419310928387,0.4816468253968254,0.33611619751094013,0.1777859388746067,127368.57133925786,-1249.9533510311278,126118.61798822673,97,0,24.448979591836736,37,12,15,39.17236946918675,0.5917792792792793,47.6425438596491,1009.4298245614004,27.28188715030812,0
4302,4,3,2,45,0.06382978723404255,0.0425531914893617,0.9574468085106383,47,1450,1100,350,0.7586206896551724,18,11,7,383.4593496752395,0.482327320382362,0.2954059727125271,0.19703095616953561,126128.66244623008,805.742940781801,126934.40538701188,98,0,25.595744680851062,36,11,19,39.24420777279521,0.5810185185185186,48.873873873873876,1004.5045045045051,27.90290290290292,16
4303,4,1,3,43,0.021739130434782608,0.06521739130434782,0.9347826086956522,46,1700,1400,300,0.8235294117647058,20,14,6,388.9758615030883,0.48158212560386476,0.3503291154020165,0.2022267175249044,126609.88004474089,649.6374330411703,127259.51747778205,99,0,27.043478260869566,36,10,19,38.60845361978293,0.5859375,48.39527027027028,1006.4189189189206,27.956081081081127,0
4304,4,2,2,43,0.044444444444444446,0.044444444444444446,0.9555555555555556,45,1100,600,500,0.5454545454545454,16,6,10,387.4638434030536,0.47935606060606056,0.3437165806892333,0.2032999943639825,126984.30879720929,840.3656676893672,127824.67446489866,100,0,27.77777777777778,38,7,21,38.26032612536216,0.5860745614035088,48.023504273504265,1007.9059829059818,26.523841655420572,0
4305,4,2,0,45,0.044444444444444446,0.0,1.0,45,1500,1100,400,0.7333333333333333,19,11,8,376.2767173567497,0.47815656565656567,0.3312997111187468,0.20068857784006003,127646.96830257635,606.2534139777242,128253.22171655408,101,0,27.68888888888889,35,10,19,37.86090272210133,0.5985119047619047,47.36689814814815,1010.5324074074078,28.87235449735451,0
4306,4,0,3,42,0.0,0.06666666666666667,0.9333333333333333,45,1550,800,750,0.5161290322580645,23,8,15,368.45084214819997,0.47824074074074074,0.29484826923316976,0.18687070917157428,125591.91528944495,308.1850550891987,125900.10034453415,102,1,28.68888888888889,36,9,20,40.17572931880313,0.5755208333333333,49.40878378378379,1002.3648648648657,27.84346846846849,16
4307,4,1,0,43,0.023255813953488372,0.0,1.0,43,1550,1100,450,0.7096774193548387,20,11,9,369.3674842913506,0.4779438907345884,0.2714883929783516,0.1882337271205582,125789.5310851394,692.5125294213335,126482.04361456074,103,0,27.3953488372093,36,7,21,39.94840779823379,0.5775462962962963,49.21171171171172,1003.1531531531549,27.865365365365413,0
4308,4,4,3,44,0.0851063829787234,0.06382978723404255,0.9361702127659575,47,1300,1000,300,0.7692307692307693,16,10,6,310.2858378601154,0.4814986123959297,0.19240294772209676,0.15401460679238452,124695.30785246876,-1561.5175034483086,123133.79034902045,104,0,25.97872340425532,40,7,16,42.55719203635869,0.559375,50.30487804878049,998.780487804878,24.96951219512195,15
4309,4,5,5,44,0.10204081632653061,0.10204081632653061,0.8979591836734694,49,1300,900,400,0.6923076923076923,17,9,8,289.21707861850047,0.4835600907029478,0.20880652966568736,0.14708145192249944,125703.50644680315,-2528.508016172231,123174.99843063092,105,0,24.73469387755102,42,7,16,42.04673559442137,0.5667162698412698,49.29748062015504,1002.8100775193805,23.876430417128105,0
4310,4,2,1,45,0.043478260869565216,0.021739130434782608,0.9782608695652174,46,1250,800,450,0.64,17,8,9,304.85168255570335,0.4835446859903381,0.23050702063298578,0.15532919063552514,125782.47070312512,-1531.0004340277626,124251.47026909735,106,0,26.130434782608695,39,7,19,41.573641398407744,0.5721153846153846,49.21875000000001,1003.1250000000009,25.721153846153868,0
4311,4,1,5,41,0.021739130434782608,0.10869565217391304,0.8913043478260869,46,1200,900,300,0.75,15,9,6,328.9648093587447,0.48413848631239936,0.10360348910607531,0.1591780216147476,123622.99934085988,-649.2675165066738,122973.7318243532,107,0,26.934782608695652,42,4,15,43.202117639416656,0.5453869047619048,51.38081395348837,994.4767441860462,23.678017718715385,16
4312,4,5,8,38,0.10869565217391304,0.17391304347826086,0.8260869565217391,46,1350,900,450,0.6666666666666666,18,9,9,329.84766173610274,0.4870269726247987,0.16931808619475563,0.1626375939358773,124416.33333539878,-990.9324229219424,123425.40091247683,108,0,26.08695652173913,40,6,16,42.357432684798475,0.5565104166666667,50.58434959349593,997.6626016260152,24.94156504065038,0
4313,4,9,8,39,0.19148936170212766,0.1702127659574468,0.8297872340425532,47,1550,1400,150,0.9032258064516129,17,14,3,315.19800178537565,0.48620104841196427,0.20944076500498388,0.15920731485877643,125421.98252275454,-1493.4483457734893,123928.53417698105,109,0,25.595744680851062,41,6,15,41.68513337294907,0.5652947154471545,49.57837301587302,1001.6865079365084,24.431378242353862,0
4314,4,5,3,41,0.11363636363636363,0.06818181818181818,0.9318181818181819,44,1200,700,500,0.5833333333333334,17,7,10,348.1200247251129,0.4826902748414376,0.27009707044873266,0.1767726359318431,125641.84746877055,-52.311390532546284,125589.536078238,110,0,28.045454545454547,38,6,21,40.6336583546462,0.5723684210526316,49.35897435897436,1002.5641025641025,26.383265856950068,0
4315,4,5,4,42,0.10869565217391304,0.08695652173913043,0.9130434782608696,46,1650,1100,550,0.6666666666666666,22,11,11,327.30588189062166,0.48250805152979065,0.27236626624636795,0.17102570142475795,126815.75701177258,-896.5652039498982,125919.19180782269,111,0,27.0,37,9,16,39.94892590173454,0.5861486486486487,48.1907894736842,1007.236842105261,27.22261735419624,0
4316,4,1,1,42,0.023255813953488372,0.023255813953488372,0.9767441860465116,43,1050,500,550,0.47619047619047616,16,5,11,350.2966190792248,0.481750645994832,0.2891214286893229,0.1821283897721871,126612.30867346922,270.37273242628123,126882.6814058955,112,0,28.069767441860463,34,9,17,39.57914399495307,0.5900735294117647,48.39285714285713,1006.4285714285701,29.600840336134414,0
4317,4,1,1,42,0.023255813953488372,0.023255813953488372,0.9767441860465116,43,1150,800,350,0.6956521739130435,15,8,7,358.0498613498377,0.48062015503875966,0.30949685672835936,0.18753304619214275,126912.0181405896,488.16609977324345,127400.18424036284,113,0,29.0,34,9,18,39.07579158790169,0.5931372549019608,48.095238095238095,1007.6190476190479,29.635854341736703,0
4318,4,2,3,41,0.045454545454545456,0.06818181818181818,0.9318181818181819,44,1200,900,300,0.75,15,9,6,352.6437048675135,0.47992644467935164,0.3172025510598149,0.18708509236339002,127432.05925905916,187.8778012430588,127619.93706030221,114,0,28.795454545454547,33,11,16,38.678212363960014,0.6006944444444444,47.579656862745104,1009.6813725490208,30.596405228758208,0
4319,4,4,4,41,0.08888888888888889,0.08888888888888889,0.9111111111111111,45,1700,1300,400,0.7647058823529411,21,13,8,345.290162025954,0.48091329966329965,0.2974419334588829,0.18520108690482978,127873.46938775503,-169.30980725624232,127704.15958049879,115,0,28.733333333333334,34,11,16,38.41194876020088,0.6029411764705883,47.14285714285714,1011.4285714285709,29.74789915966385,0
4320,4,3,3,41,0.06818181818181818,0.06818181818181818,0.9318181818181819,44,1350,900,450,0.6666666666666666,18,9,9,355.379934220169,0.47965116279069764,0.3165309267004184,0.19160824129625287,128082.49831795455,303.58996539791315,128386.08828335247,116,0,30.318181818181817,33,11,18,37.94289749798223,0.6073232323232323,46.936274509803916,1012.2549019607836,30.674390968508593,0
4321,4,1,2,40,0.023809523809523808,0.047619047619047616,0.9523809523809523,42,1150,700,450,0.6086956521739131,16,7,9,369.0790482428929,0.4788279132791328,0.3263478186337532,0.19963121260314493,128210.45769585518,1063.9587402343955,129274.41643608957,117,0,30.142857142857142,31,11,20,37.465179566298104,0.6135752688172043,46.80989583333334,1012.7604166666679,32.66969086021509,0
4322,4,0,0,40,0.0,0.0,1.0,40,1250,800,450,0.64,17,8,9,379.27621934947786,0.4792467948717949,0.24725781147862502,0.18513617114257558,123992.92204115141,1595.9769354926418,125588.89897664405,118,1,32.2,31,9,20,41.5654824160021,0.570228494623656,51.00911458333334,995.9635416666679,32.12785618279574,15
4323,4,3,2,41,0.06976744186046512,0.046511627906976744,0.9534883720930233,43,1200,700,500,0.5833333333333334,17,7,10,351.17117364919807,0.48221207087486156,0.2469076944838824,0.17534857590875053,124943.70003449413,175.32515623734326,125119.02519073148,119,0,30.88372093023256,36,7,21,41.279004280243306,0.5688657407407407,50.05630630630632,999.7747747747762,27.771521521521564,0
4324,4,3,3,41,0.06818181818181818,0.06818181818181818,0.9318181818181819,44,1500,1100,400,0.7333333333333333,19,11,8,314.4177843911243,0.48306465821000705,0.15298258172273949,0.15011676172057442,123054.50439453124,-840.1636295026015,122214.34076502864,120,0,28.863636363636363,39,5,18,44.15409011373578,0.5440705128205128,51.953125,992.1874999999999,25.440705128205124,16
4325,4,10,8,43,0.19607843137254902,0.1568627450980392,0.8431372549019608,51,1750,1300,450,0.7428571428571429,22,13,9,339.2623440240682,0.4876470588235294,0.13737576955618214,0.1674337907847925,124454.960514298,-578.6658615993038,123876.29465269869,121,0,25.431372549019606,41,10,14,42.08258765824881,0.5553861788617886,50.5456349206349,997.8174603174577,24.33701122725507,14
4326,4,9,7,45,0.17307692307692307,0.1346153846153846,0.8653846153846154,52,1400,800,600,0.5714285714285714,20,8,12,330.86348695830225,0.48768225238813473,0.19301025745109368,0.1668540839553281,125355.94408916659,-2102.4773058087344,123253.46678335786,122,0,25.71153846153846,40,12,15,41.36095325079493,0.5661458333333333,49.644308943089435,1001.422764227643,25.035569105691074,0
4327,4,4,5,44,0.08163265306122448,0.10204081632653061,0.8979591836734694,49,1950,1500,450,0.7692307692307693,24,15,9,332.959183031846,0.48772321428571425,0.2039247935127937,0.16954330901182693,125756.3490125869,-1425.6537543402676,124330.69525824663,123,0,27.693877551020407,39,10,18,40.895666735901976,0.5718482905982907,49.24479166666667,1003.0208333333342,25.718482905982928,0
4328,4,3,5,42,0.06382978723404255,0.10638297872340426,0.8936170212765957,47,1050,500,550,0.47619047619047616,16,5,11,334.5328076307228,0.4868177613320999,0.20729231040875806,0.17153703540213647,126043.83680555546,-966.5120442708429,125077.32476128462,124,0,27.25531914893617,37,10,21,40.56016597510373,0.5782657657657657,48.95833333333333,1004.1666666666658,27.13963963963962,0
4329,4,0,0,42,0.0,0.0,1.0,42,1450,1100,350,0.7586206896551724,18,11,7,351.9578729241791,0.48476819589624465,0.2009359274335718,0.1801006015640716,125959.03969848207,466.45513756997974,126425.49483605205,125,1,29.666666666666668,36,6,22,40.21015630842869,0.5792824074074074,49.04279279279278,1003.8288288288272,27.88413413413409,0
4330,4,1,1,42,0.023255813953488372,0.023255813953488372,0.9767441860465116,43,1250,600,650,0.48,19,6,13,347.34707461084014,0.48474990771502396,0.19714948900773988,0.17933877010127067,126326.69990514162,175.8704650596548,126502.57037020127,126,0,29.953488372093023,36,7,15,39.94716403420337,0.5830439814814814,48.6768018018018,1005.2927927927926,27.924799799799796,0
4331,4,1,4,39,0.023255813953488372,0.09302325581395349,0.9069767441860466,43,950,500,450,0.5263157894736842,14,5,9,392.2577904865008,0.4845191952750092,0.1983819496628243,0.18807853415077114,123235.43836805575,1165.1056567547455,124400.5440248105,127,0,30.930232558139537,39,4,12,42.033850888236124,0.545940170940171,51.77083333333334,992.9166666666683,25.459401709401753,16
4332,4,9,8,40,0.1875,0.16666666666666666,0.8333333333333334,48,950,600,350,0.631578947368421,13,6,7,350.4528132954663,0.4879395685579196,0.21770037062775138,0.17449882295230962,124826.44917052433,-842.3369984568253,123984.1121720675,128,0,27.020833333333332,41,7,15,41.41837502895528,0.5591971544715447,50.17361111111109,999.3055555555526,24.37330623306226,0
4333,4,5,8,37,0.1111111111111111,0.17777777777777778,0.8222222222222222,45,1250,800,450,0.64,17,8,9,362.70847961207454,0.48501683501683507,0.22362058993637945,0.18198576937007466,125144.71778817303,78.57175390089452,125223.28954207392,129,0,25.31111111111111,35,10,18,40.78236456525931,0.5729166666666667,49.855324074074076,1000.5787037037039,28.58796296296297,0
4334,4,5,3,39,0.11904761904761904,0.07142857142857142,0.9285714285714286,42,600,200,400,0.3333333333333333,10,2,8,362.05101784693625,0.4864982578397212,0.23208168025574527,0.1841667747067898,125713.73523584184,702.9571598953602,126416.6923957372,130,0,26.0,37,5,15,40.21020118084411,0.5748873873873874,49.28728070175439,1002.8508771929828,27.10407776197251,0
4335,4,2,4,37,0.04878048780487805,0.0975609756097561,0.9024390243902439,41,1050,800,250,0.7619047619047619,13,8,5,367.0208892186935,0.48640752032520324,0.1862800379110534,0.17979601633291648,124143.62865244126,1102.1183287963925,125245.74698123765,131,0,27.5609756097561,33,8,18,41.71380554189212,0.5669191919191919,50.857843137254896,996.5686274509794,30.199049316696346,16
4336,4,1,1,37,0.02631578947368421,0.02631578947368421,0.9736842105263158,38,800,300,500,0.375,13,3,10,369.38966119736267,0.4846046704599336,0.2184191133692741,0.18227700736175306,124449.13765138402,1594.0449586697346,126043.18261005376,132,0,30.0,33,5,16,41.337099811676076,0.5700757575757576,50.55147058823529,997.7941176470583,30.23618538324419,0
4337,4,3,3,37,0.075,0.075,0.925,40,1200,700,500,0.5833333333333334,17,7,10,357.4927988260969,0.4861778846153846,0.23053446798089894,0.1796703808007839,125214.55277117,955.0931432622431,126169.64591443224,133,0,29.175,33,7,19,40.840552426431586,0.5779671717171717,49.78553921568629,1000.8578431372571,30.32902554961385,0
4338,4,3,4,36,0.075,0.1,0.9,40,1150,700,450,0.6086956521739131,16,7,9,356.69941656323203,0.4863782051282051,0.23513323554577714,0.1811395361206583,125644.21023464545,963.4432970492323,126607.65353169468,134,0,29.65,33,7,16,40.41618282198591,0.5823863636363636,49.35661764705883,1002.5735294117658,30.381016042780782,0
4339,4,5,4,37,0.12195121951219512,0.0975609756097561,0.9024390243902439,41,1550,1100,450,0.7096774193548387,20,11,9,365.7995244562232,0.48526422764227645,0.21097305312675774,0.17624886178345298,123442.38281249999,1032.4654279604006,124474.84824046039,135,0,29.634146341463413,35,6,18,42.47466806429071,0.5553571428571429,51.5625,993.7499999999999,28.39285714285714,16
4340,4,5,2,40,0.11904761904761904,0.047619047619047616,0.9523809523809523,42,650,100,550,0.15384615384615385,12,1,11,342.2350065031982,0.48563927603561746,0.2377892165324873,0.16922136144479177,124534.42555642132,124.00798803478972,124658.43354445611,124,0,25.023809523809526,37,5,20,41.926082060859045,0.5627815315315315,50.46600877192983,998.1359649122817,26.976647700331938,0
4341,4,2,2,40,0.047619047619047616,0.047619047619047616,0.9523809523809523,42,1350,700,650,0.5185185185185185,20,7,13,346.52162858790285,0.48515534262485477,0.2570368281128399,0.17291941367465305,124917.7766836912,257.34228320253135,125175.11896689373,125,0,25.976190476190474,37,5,22,41.42204581185331,0.566722972972973,50.08223684210527,999.6710526315795,27.01813655761026,0
4342,4,1,2,39,0.024390243902439025,0.04878048780487805,0.9512195121951219,41,1250,1000,250,0.8,15,10,5,341.04658924555787,0.48584857723577235,0.24281993166672322,0.1719542593329001,125347.46334876544,349.9461239141979,125697.40947267963,126,0,25.658536585365855,35,6,18,41.114771151178935,0.575,49.65277777777778,1001.3888888888889,28.61111111111111,0
4343,4,2,2,39,0.04878048780487805,0.04878048780487805,0.9512195121951219,41,1150,900,250,0.782608695652174,14,9,5,331.39103065122833,0.48516260162601627,0.22433221751138022,0.16922782086722613,125874.27112501017,142.72088811785366,126016.99201312802,127,0,24.097560975609756,36,5,21,40.81355440840909,0.5784143518518519,49.127252252252255,1003.4909909909911,27.874749749749753,0
4344,4,3,0,42,0.07142857142857142,0.0,1.0,42,1400,1200,200,0.8571428571428571,16,12,4,325.935802820518,0.4831833139759969,0.2377256525238587,0.16963875985218704,126654.7459731867,-143.508469230775,126511.23750395593,128,0,22.571428571428573,35,7,17,40.14854260089687,0.5883928571428572,48.35069444444444,1006.5972222222221,28.75992063492063,0
4345,4,2,4,40,0.045454545454545456,0.09090909090909091,0.9090909090909091,44,1550,1100,450,0.7096774193548387,20,11,9,310.19452208300214,0.4819965644820296,0.23454397313712883,0.16419439768683344,127340.9020684248,-899.9099482533227,126440.99212017148,129,0,22.5,37,7,13,39.84281640412818,0.5914977477477478,47.66995614035087,1009.3201754385957,27.278923660502585,0
4346,4,1,2,39,0.024390243902439025,0.04878048780487805,0.9512195121951219,41,1950,1700,250,0.8717948717948718,22,17,5,330.11955842319225,0.48310467479674796,0.24725350652939948,0.17392866287072675,127152.04081632658,195.07511337869337,127347.11592970528,130,0,24.585365853658537,34,7,22,39.53341399118666,0.5955882352941176,47.85714285714286,1008.571428571429,29.6638655462185,0
4347,4,1,1,39,0.025,0.025,0.975,40,900,700,200,0.7777777777777778,11,7,4,330.5498360214724,0.4813434829059829,0.23095069591884854,0.17493143007428488,127332.20663265312,417.9280045351506,127750.13463718827,131,0,24.75,34,6,15,39.33809074467248,0.5974264705882353,47.67857142857143,1009.2857142857148,29.684873949579845,0
4348,4,0,0,39,0.0,0.0,1.0,39,1600,1100,500,0.6875,21,11,10,341.8563881952364,0.4800663517768781,0.2391834218955744,0.18108495624206813,127370.1990370289,908.463241301406,128278.6622783303,132,1,26.17948717948718,33,6,17,39.0138753996196,0.6000631313131313,47.64093137254901,1009.4362745098028,30.58897801544857,0
4349,4,2,0,41,0.04878048780487805,0.0,1.0,41,1000,100,900,0.1,19,1,18,324.06921076345964,0.48041158536585366,0.2284011584110348,0.1742320443108342,127968.81028163576,94.15027006171937,128062.96055169747,133,0,25.853658536585368,35,6,20,38.85123541523678,0.6017857142857144,47.04861111111111,1011.8055555555552,28.908730158730148,0
4350,4,1,4,38,0.023809523809523808,0.09523809523809523,0.9047619047619048,42,950,600,350,0.631578947368421,13,6,7,313.90340769011306,0.4800014518002323,0.21956319210654462,0.1701129551554374,128287.09621783961,-346.048666910135,127941.04755092948,134,0,26.214285714285715,36,6,21,38.78413554172225,0.6030092592592593,46.73423423423424,1013.0630630630643,28.140640640640676,0
4351,4,2,3,37,0.05,0.075,0.925,40,1100,700,400,0.6363636363636364,15,7,8,318.7314368249124,0.4794337606837607,0.19503195982193833,0.17376515980230617,128525.67361379042,193.034523962641,128718.70813775307,135,0,26.225,35,5,16,38.41896377886846,0.6074404761904761,46.4988425925926,1014.0046296296307,28.971560846560877,0
4352,4,1,6,32,0.02631578947368421,0.15789473684210525,0.8421052631578947,38,1150,900,250,0.782608695652174,14,9,5,337.71965924523636,0.475358582266477,0.2078540160846989,0.1837905935050393,128454.92118415996,1076.3504421376422,129531.2716262976,136,0,28.31578947368421,33,5,17,38.009751773049636,0.6111111111111112,46.568627450980394,1013.7254901960786,30.718954248366018,0
4353,4,0,1,31,0.0,0.03125,0.96875,32,850,700,150,0.8235294117647058,10,7,3,411.57912905179404,0.47208921370967744,0.11994172341540099,0.19891254616705661,123571.81125217001,3771.915690104148,127343.72694227415,137,1,29.03125,31,1,15,41.201763576043305,0.5658602150537635,51.43229166666666,994.2708333333322,32.073252688172005,16
4354,4,5,4,32,0.1388888888888889,0.1111111111111111,0.8888888888888888,36,1200,900,300,0.75,15,9,6,371.7764837150849,0.47627314814814814,0.11503154371057045,0.1846047787376974,124710.81559713642,2072.909700788744,126783.72529792516,138,0,26.555555555555557,35,1,16,41.005697180378526,0.5684523809523809,50.28935185185185,998.842592592592,28.538359788359774,0
4355,4,6,3,35,0.15789473684210525,0.07894736842105263,0.9210526315789473,38,950,700,250,0.7368421052631579,12,7,5,366.15781868919373,0.4737138454243717,0.17664143636683716,0.18709218891302276,125898.59992551857,1620.421140903622,127519.0210664222,139,0,25.789473684210527,35,3,20,39.91621977472802,0.580654761904762,49.10300925925925,1003.5879629629619,28.67394179894177,0
4356,4,2,1,36,0.05405405405405406,0.02702702702702703,0.972972972972973,37,1150,800,350,0.6956521739130435,15,8,7,370.73529187316035,0.4723786286286286,0.1686262223174977,0.19024268734505642,126074.60359296908,1948.1447166606501,128022.74830962974,140,0,26.91891891891892,33,4,22,39.6195596908684,0.5868055555555556,48.927696078431374,1004.2892156862748,30.433006535947722,0
4357,4,4,5,35,0.1,0.125,0.875,40,1050,600,450,0.5714285714285714,15,6,9,351.0092610423486,0.4772702991452991,0.16558577405857733,0.17120655793698242,123960.5034722223,702.2569444444536,124662.76041666676,141,0,23.875,38,2,16,42.30299860529986,0.5550986842105263,51.04166666666667,995.833333333334,26.206140350877213,16
4358,4,3,5,33,0.07894736842105263,0.13157894736842105,0.868421052631579,38,1200,700,500,0.5833333333333334,17,7,10,361.9512562066065,0.4800557136083452,0.18106489030750939,0.1788534383274988,124507.06587603857,1413.0977800861574,125920.16365612473,142,0,23.18421052631579,37,1,16,41.4624990844503,0.5625,50.49342105263157,998.0263157894719,26.97368421052627,0
4359,4,3,2,34,0.08333333333333333,0.05555555555555555,0.9444444444444444,36,550,300,250,0.5454545454545454,8,3,5,365.51112001090155,0.47966269841269843,0.18411071053026884,0.1822627360234138,124887.4127505886,1929.5476219462896,126816.96037253489,143,0,23.944444444444443,36,0,19,40.9789507285564,0.568287037037037,50.11261261261262,999.549549549551,27.765265265265306,0
4360,4,12,12,34,0.2608695652173913,0.2608695652173913,0.7391304347826086,46,1650,1400,250,0.8484848484848485,19,14,5,312.9120614737333,0.479609500805153,0.19283081639975252,0.16617999121294275,127474.24529384753,-1183.7260688765587,126290.51922497098,105,0,16.26086956521739,43,3,12,39.638034508627165,0.5833333333333333,47.53787878787879,1009.8484848484845,23.484848484848477,0
4361,4,3,1,36,0.08108108108108109,0.02702702702702703,0.972972972972973,37,800,500,300,0.625,11,5,6,361.2428904696587,0.4739114114114114,0.232302401454465,0.18888664967243854,126843.36917368771,1764.25306344256,128607.62223713027,106,0,20.675675675675677,37,0,18,39.06595823809006,0.5864301801801801,48.16337719298244,1007.3464912280673,27.22558084400182,0
4362,4,2,1,37,0.05263157894736842,0.02631578947368421,0.9736842105263158,38,1350,800,550,0.5925925925925926,19,8,11,353.6923794591498,0.4752400426742532,0.22571873016236088,0.18696329512708512,127285.5725439557,1404.2308691135543,128689.80341306925,107,0,21.026315789473685,37,1,22,38.801998442536835,0.5909346846846847,47.724780701754376,1009.1008771929814,27.27299668089139,0
4363,4,2,2,37,0.05128205128205128,0.05128205128205128,0.9487179487179487,39,850,400,450,0.47058823529411764,13,4,9,345.3183000770844,0.4758771929824561,0.22230851117221828,0.1848871891256621,127801.98703342005,1026.4729817708287,128828.46001519088,108,0,20.94871794871795,39,0,19,38.484362659249356,0.5926816239316239,47.213541666666664,1011.1458333333326,25.92681623931622,0
4364,4,1,3,35,0.02631578947368421,0.07894736842105263,0.9210526315789473,38,1050,600,450,0.5714285714285714,15,6,9,355.3085309711395,0.4728988857278331,0.21567269997497696,0.19032231158131524,127820.2174761672,1483.1227399737252,129303.34021614093,109,0,22.157894736842106,38,0,20,38.21315372424722,0.5945723684210527,47.19551282051283,1011.2179487179504,26.61099865047238,0
4365,4,1,1,35,0.027777777777777776,0.027777777777777776,0.9722222222222222,36,1000,600,400,0.6,14,6,8,365.1707515428051,0.4711309523809524,0.20583030123016766,0.1953815856585999,127774.23327043276,2131.882558233931,129906.11582866669,110,0,23.36111111111111,36,0,21,38.01097126308755,0.5978009259259259,47.240990990991,1011.0360360360373,28.084334334334372,0
4366,4,2,0,37,0.05405405405405406,0.0,1.0,37,1100,800,300,0.7272727272727273,14,8,6,358.71195263576396,0.4714089089089089,0.20101609182271352,0.195467031388279,128506.3934948979,1820.9632602127701,130327.35675511067,111,0,21.35135135135135,34,3,19,37.425149700598794,0.609375,46.51785714285714,1013.928571428571,29.82142857142856,0
4367,4,0,3,34,0.0,0.08108108108108109,0.9189189189189189,37,1100,700,400,0.6363636363636364,15,7,8,357.3023781208243,0.47118993993993996,0.19443544880039254,0.19508041990484631,128584.36113522376,1788.6996045524677,130373.06073977624,112,1,22.35135135135135,35,2,19,37.38124786032182,0.6080357142857142,46.44097222222222,1014.2361111111111,28.9781746031746,0
4368,4,1,3,32,0.02857142857142857,0.08571428571428572,0.9142857142857143,35,1150,700,450,0.6086956521739131,16,7,9,401.8368905290565,0.4714635854341737,0.0442983069819507,0.20210614050747117,125245.21818531326,3264.6194856278466,128509.83767094111,113,0,21.857142857142858,33,2,14,39.69913075416258,0.5782828282828283,49.75490196078431,1000.9803921568621,30.33273915626855,16
4369,4,1,1,32,0.030303030303030304,0.030303030303030304,0.9696969696969697,33,1200,700,500,0.5833333333333334,17,7,10,406.4833644920102,0.469894255050505,0.08446382983594902,0.20651851551062397,125663.75760445364,3616.0453971533475,129279.80300160698,114,0,22.90909090909091,32,1,16,39.148092179826214,0.5849609375,49.33712121212121,1002.6515151515152,31.33285984848485,0
4370,4,1,2,31,0.030303030303030304,0.06060606060606061,0.9393939393939394,33,1150,700,450,0.6086956521739131,16,7,9,404.44473515864803,0.47013099747474746,0.09014264959904805,0.20643046308964508,125853.72546487594,3580.175332874182,129433.90079775012,115,0,23.78787878787879,32,1,17,39.0021391720146,0.5869140625,49.147727272727266,1003.4090909090901,31.356534090909065,0
4371,4,1,1,31,0.03125,0.03125,0.96875,32,850,700,150,0.8235294117647058,10,7,3,404.2008680157379,0.470724126344086,0.1196626572428996,0.20709587330693366,126011.15120781769,3786.763339572447,129797.91454739013,116,0,25.125,31,1,18,38.84507521722214,0.5910618279569892,48.99088541666665,1004.0364583333314,32.388272849462304,0
4372,4,1,1,31,0.03125,0.03125,0.96875,32,900,700,200,0.7777777777777778,11,7,4,409.8156863300812,0.47190020161290325,0.074911145167601,0.20284421349856266,124577.18107435446,3810.7365926106827,128387.91766696515,117,0,25.75,31,1,17,40.19512738576582,0.5762768817204301,50.423177083333336,998.3072916666673,32.2034610215054,16
4373,4,4,0,35,0.11428571428571428,0.0,1.0,35,600,200,400,0.3333333333333333,10,2,8,378.3286126028221,0.4748949579831933,0.10217631731868715,0.1807675458712296,123086.80428398997,2466.1543104383927,125552.95859442836,118,0,24.37142857142857,31,4,21,42.535018370292605,0.5608198924731183,51.92057291666668,992.3177083333348,32.010248655914026,15
4374,4,7,1,41,0.16666666666666666,0.023809523809523808,0.9761904761904762,42,1550,1200,350,0.7741935483870968,19,12,7,350.3919787767584,0.47937233836624077,0.22246956596550094,0.17239285355816533,124325.23739956188,832.685308005186,125157.92270756706,119,0,21.142857142857142,36,6,17,41.939551339957845,0.5625,50.675675675675684,997.2972972972985,27.702702702702737,16
4375,4,3,5,39,0.06818181818181818,0.11363636363636363,0.8863636363636364,44,1100,800,300,0.7272727272727273,14,8,6,335.85484932906843,0.48028981677237487,0.24425869638635578,0.16826839405471608,125084.47372626007,-394.3022837026207,124690.17144255745,120,0,21.09090909090909,36,8,21,41.51633269541068,0.5703125,49.91554054054054,1000.337837837838,27.78716216216217,0
4376,4,4,1,42,0.09302325581395349,0.023255813953488372,0.9767441860465116,43,750,300,450,0.4,12,3,9,335.1189469870791,0.48221207087486156,0.1528648096089955,0.16537865605110705,124452.35553247132,-218.08700311454325,124234.26852935678,121,0,20.813953488372093,37,6,17,42.18864468864467,0.5619369369369369,50.548245614035075,997.8070175438579,26.96775723091508,16
4377,4,4,3,43,0.08695652173913043,0.06521739130434782,0.9347826086956522,46,1100,700,400,0.6363636363636364,15,7,8,312.5741192654747,0.48325281803542675,0.17088244635798944,0.15782430939961664,125406.83455615032,-1359.0115347348137,124047.8230214155,122,0,20.217391304347824,40,6,12,41.766436688311664,0.5666666666666667,49.59349593495934,1001.6260162601617,25.040650406504042,0
4378,4,4,5,42,0.0851063829787234,0.10638297872340426,0.8936170212765957,47,2000,1300,700,0.65,27,13,14,301.47552555913285,0.4835222016651249,0.1742738589211612,0.15458638651010853,126043.83680555562,-1798.5598849890907,124245.27692056652,123,0,20.638297872340427,40,7,15,41.39004149377592,0.5731770833333334,48.958333333333336,1004.1666666666672,25.10416666666668,0
4379,4,3,3,42,0.06666666666666667,0.06666666666666667,0.9333333333333333,45,1350,1100,250,0.8148148148148148,16,11,5,319.8241750209556,0.48091329966329965,0.2100997211588449,0.16453099244513475,126177.97592957834,-929.0465885017336,125248.92934107661,124,0,22.333333333333332,38,7,20,40.79159577484759,0.5778508771929824,48.82478632478632,1004.7008547008535,26.43949617633825,0
4380,4,0,2,40,0.0,0.047619047619047616,0.9523809523809523,42,1700,1400,300,0.8235294117647058,20,14,6,352.8894721868308,0.480316008517228,0.10468692160938509,0.1717212882600709,123861.73016660378,341.9001165280997,124203.63028313188,125,1,24.30952380952381,41,1,14,42.35889641884259,0.5492886178861789,51.14087301587302,995.4365079365087,24.27893921796363,16
4381,4,6,8,38,0.13043478260869565,0.17391304347826086,0.8260869565217391,46,1400,1000,400,0.7142857142857143,18,10,8,348.871936724801,0.4831219806763285,0.0908826445357771,0.17233277424359414,124493.03643664617,294.61262562223806,124787.6490622684,126,0,22.543478260869566,38,8,13,41.80338471969454,0.5605811403508771,50.50747863247863,997.9700854700852,26.2623706702654,15
4382,4,2,3,37,0.05,0.075,0.925,40,950,600,350,0.631578947368421,13,6,7,375.2567574643951,0.4806757478632479,0.16968134414832003,0.1863329008583273,124710.81559713643,1359.7152563443005,126070.53085348073,127,0,26.15,35,5,15,40.918791039011204,0.5684523809523809,50.28935185185185,998.8425925925922,28.538359788359777,0
4383,4,1,2,36,0.02631578947368421,0.05263157894736842,0.9473684210526316,38,1600,1100,500,0.6875,21,11,10,356.87068762770133,0.4780701754385965,0.09585390295034402,0.16907415366799933,122724.57086173251,1181.8789384001846,123906.4498001327,128,0,27.473684210526315,35,3,18,43.4456887824631,0.5479166666666666,52.28587962962962,990.85648148148,28.310185185185144,16
4384,4,4,4,36,0.1,0.1,0.9,40,1300,1000,300,0.7692307692307693,16,10,6,332.6337189251145,0.4785924145299145,0.11852657004830935,0.1616318775058653,123800.9661612424,236.2392561558223,124037.20541739822,129,0,25.875,38,2,16,42.9260601180891,0.553453947368421,51.201923076923066,995.1923076923059,26.18927125506068,0
4385,4,3,1,38,0.07692307692307693,0.02564102564102564,0.9743589743589743,39,1400,900,500,0.6428571428571429,19,9,10,339.8713328545755,0.4767206477732793,0.15481876443718812,0.1674405042506021,124381.3978674619,654.8370235740078,125036.23489103591,130,0,26.846153846153847,36,3,17,42.14363663731464,0.5630787037037037,50.61936936936936,997.5225225225213,27.708958958958924,0
4386,4,4,4,38,0.09523809523809523,0.09523809523809523,0.9047619047619048,42,1450,1000,450,0.6896551724137931,19,10,9,313.9901588498723,0.47850125822686795,0.15920623369422615,0.158878029351758,125495.2813042534,-519.1433376736219,124976.13796657977,131,0,25.61904761904762,39,3,13,41.639918390685104,0.5691773504273504,49.50520833333333,1001.979166666666,25.691773504273485,0
4387,4,3,2,39,0.07317073170731707,0.04878048780487805,0.9512195121951219,41,1300,800,500,0.6153846153846154,18,8,10,326.67474980437834,0.47807418699186993,0.18126563060557088,0.16566824338727992,125588.29740119806,5.305126378849309,125593.6025275769,132,0,27.024390243902438,38,3,15,41.226328785617866,0.5718201754385965,49.412393162393165,1002.3504273504275,26.37764282501125,0
4388,4,5,5,39,0.11363636363636363,0.11363636363636363,0.8863636363636364,44,1150,500,650,0.43478260869565216,18,5,13,316.55682465084055,0.47873722692036647,0.2199526075056486,0.164046044523247,126477.92009551189,-791.6855639109467,125686.23453160095,133,0,26.068181818181817,40,4,13,40.56585505489325,0.5776041666666667,48.52642276422764,1005.8943089430891,25.147357723577226,0
4389,4,1,2,38,0.025,0.05,0.95,40,1400,900,500,0.6428571428571429,19,9,10,335.8935964848841,0.4777644230769231,0.21859519912711445,0.1730446774471029,126236.59593576861,480.41284337487537,126717.00877914348,134,0,28.85,37,3,19,40.32767321331153,0.5802364864864865,48.76644736842105,1004.934210526315,27.160384068278784,0
4390,4,2,1,39,0.05,0.025,0.975,40,1500,1100,400,0.7333333333333333,19,11,8,330.2364967402784,0.4760416666666667,0.2157121080139368,0.17232340829901804,126760.54170514006,372.1914435210847,127132.73314866114,135,0,28.675,37,3,17,39.93176538908245,0.5855855855855856,48.24561403508772,1007.0175438596493,27.216690374585117,0
4391,4,1,3,37,0.025,0.075,0.925,40,1450,1100,350,0.7586206896551724,18,11,7,329.2304335080796,0.4758680555555555,0.22359645305189946,0.17261591068869117,126953.84787867403,359.41407452291566,127313.26195319694,136,0,29.625,37,3,18,39.758890037355386,0.5875563063063063,48.05372807017543,1007.7850877192968,27.23743480322424,0
4392,4,0,5,32,0.0,0.13513513513513514,0.8648648648648649,37,1150,800,350,0.6956521739130435,15,8,7,404.4483402138132,0.47500625625625625,0.16710491080790768,0.19894678484856798,124316.41333616778,2661.4710064831584,126977.88434265094,137,1,30.486486486486488,34,3,15,40.60100075603836,0.5664828431372548,50.68452380952381,997.2619047619046,29.331232492997195,16
4393,4,4,1,35,0.1111111111111111,0.027777777777777776,0.9722222222222222,36,1200,800,400,0.6666666666666666,16,8,8,406.5123455517978,0.4770337301587302,0.23730078634203777,0.2043388308934115,125221.05724224563,2982.6554297874586,128203.71267203309,138,0,31.52777777777778,32,4,18,39.607249484882885,0.5804036458333333,49.7790404040404,1000.883838383838,31.277619949494937,0
4394,4,3,1,37,0.07894736842105263,0.02631578947368421,0.9736842105263158,38,1600,1100,500,0.6875,21,11,10,362.8518148088836,0.478944404931247,0.14060777148531067,0.18106841793172362,124917.77668369109,1465.328394313629,126383.10507800472,139,0,28.710526315789473,37,1,19,41.013925450623375,0.566722972972973,50.08223684210526,999.6710526315785,27.01813655761023,15
4395,4,3,3,37,0.075,0.075,0.925,40,1300,1000,300,0.7692307692307693,16,10,6,340.9291921824863,0.47982104700854705,0.14684095248792528,0.17314846537368353,125648.36109335677,567.5200041006768,126215.88109745744,140,0,28.175,36,4,21,40.80717173986298,0.576099537037037,49.35247747747747,1002.5900900900892,27.8497247247247,0
4396,4,5,2,40,0.11904761904761904,0.047619047619047616,0.9523809523809523,42,1100,900,200,0.8181818181818182,13,9,4,329.85696049281137,0.47824719318621756,0.21412506672056186,0.1727097213657229,126898.60251471576,-27.701138316653157,126870.90137639911,141,0,27.61904761904762,37,5,18,39.79973791127072,0.5869932432432432,48.10855263157893,1007.5657894736818,27.231507823613022,0
4397,4,5,4,41,0.1111111111111111,0.08888888888888889,0.9111111111111111,45,1400,700,700,0.5,21,7,14,307.8700902996463,0.4765151515151515,0.2251155314446458,0.16529335916087776,127913.11905115984,-1123.728016547897,126789.39103461194,142,0,26.288888888888888,40,5,16,39.3177365883062,0.5921875,47.10365853658536,1011.5853658536571,25.289634146341427,0
4398,4,0,1,40,0.0,0.024390243902439025,0.975609756097561,41,1550,900,650,0.5806451612903226,22,9,13,331.36338347927204,0.47586382113821135,0.226100333211934,0.17679280638186642,127660.40322417038,260.39662973787205,127920.79985390826,143,1,28.926829268292682,36,5,17,38.98182713022805,0.5966435185185186,47.35360360360362,1010.5855855855878,28.07182182182188,0
4399,4,0,2,38,0.0,0.05,0.95,40,1150,800,350,0.6956521739130435,15,8,7,329.5254977457208,0.47650908119658114,0.21800033411293063,0.17643467169104524,127802.69870799866,422.84958099993435,128225.54828899859,144,2,29.7,36,4,17,38.88285629431638,0.5980902777777778,47.212837837837846,1011.1486486486496,28.087462462462486,0
4400,4,2,3,37,0.05,0.075,0.925,40,1450,1100,350,0.7586206896551724,18,11,7,325.4288109461052,0.475801282051282,0.21830231551612211,0.1767105211964692,128366.66690712539,354.8423553401208,128721.50926246551,103,0,26.775,37,3,19,38.4111483805814,0.6019144144144144,46.65570175438597,1013.3771929824571,27.38857278330965,0
4401,4,1,0,38,0.02631578947368421,0.0,1.0,38,1400,1000,400,0.7142857142857143,18,10,8,336.2488673727104,0.4740546467520152,0.20451033329925994,0.18224064000701753,128291.05748724709,1027.5445548268208,129318.60204207391,104,0,27.526315789473685,35,3,20,38.21415990707949,0.6050595238095238,46.730324074074076,1013.0787037037037,28.94510582010582,0
4402,4,0,1,37,0.0,0.02631578947368421,0.9736842105263158,38,1000,700,300,0.7,13,7,6,334.40498807836474,0.4734026789947843,0.20358529344599208,0.18190800531616874,128437.66744898829,990.0393304183744,129427.70677940667,105,1,28.526315789473685,35,3,14,38.111345817157634,0.6065476190476191,46.585648148148145,1013.657407407407,28.9616402116402,0
4403,4,1,2,36,0.02631578947368421,0.05263157894736842,0.9473684210526316,38,1400,1000,400,0.7142857142857143,18,10,8,403.49205153903176,0.47341749644381226,0.23021049168595353,0.20161337084846173,124972.58922216437,2581.8747975397764,127554.46401970414,106,0,28.394736842105264,37,1,16,39.94121705596373,0.5672860360360361,50.027412280701746,999.8903508771918,27.0240635372214,15
4404,4,6,5,37,0.14285714285714285,0.11904761904761904,0.8809523809523809,42,1400,800,600,0.5714285714285714,20,8,12,361.3538179326044,0.47458139759969026,0.20690380152933296,0.18716536261410419,126457.07242853587,743.7299217067005,127200.80235024258,107,0,25.547619047619047,37,5,14,39.46080435335589,0.5824887387387387,48.54714912280703,1005.8114035087733,27.184091986723605,0
4405,4,4,5,36,0.0975609756097561,0.12195121951219512,0.8780487804878049,41,1250,800,450,0.64,17,8,9,367.2588188173363,0.47372967479674793,0.22738591022273869,0.19173354446488292,126779.94030770662,1112.2102254281676,127892.15053313479,108,0,26.804878048780488,36,5,16,38.979742070148,0.5876736111111112,48.22635135135137,1007.0945945945967,27.97484984984991,0
4406,4,3,0,39,0.07692307692307693,0.0,1.0,39,1300,800,500,0.6153846153846154,18,8,10,372.2022161250211,0.47087269455690506,0.21868309242822082,0.19537731952452295,127002.00007086174,1654.0851757369742,128656.08524659871,109,0,27.923076923076923,34,5,19,38.62667808354003,0.5940563725490196,48.00595238095239,1007.976190476191,29.646358543417385,0
4407,4,2,2,39,0.04878048780487805,0.04878048780487805,0.9512195121951219,41,1350,700,650,0.5185185185185185,20,7,13,368.09846818403213,0.47154471544715443,0.16304771098081972,0.18580407355441445,125394.45484335693,1211.128616895995,126605.58346025292,110,0,27.51219512195122,36,5,15,40.38888576568473,0.5734953703703703,49.60585585585586,1001.576576576577,27.821571571571585,15
4408,4,1,3,37,0.025,0.075,0.925,40,800,500,300,0.625,11,5,6,364.494645425968,0.4706597222222222,0.177167321729365,0.1853697782706025,125704.81957886962,1163.7467281470872,126868.5663070167,111,0,28.425,36,4,16,40.158150851581496,0.5766782407407407,49.29617117117118,1002.815315315317,27.855980980981027,0
4409,4,4,6,35,0.0975609756097561,0.14634146341463414,0.8536585365853658,41,1000,800,200,0.8,12,8,4,351.5572622949043,0.4722560975609756,0.18704859966174903,0.1819685784293939,126429.50234687589,689.8984812936676,127119.40082816956,112,0,27.853658536585368,37,4,16,39.735517517080964,0.5822072072072072,48.57456140350877,1005.7017543859644,27.181128496917957,0
4410,4,3,4,34,0.07894736842105263,0.10526315789473684,0.8947368421052632,38,900,800,100,0.8888888888888888,10,8,2,356.3266202440741,0.474765884305358,0.13935468633613723,0.18466515542881629,126480.04979263121,1413.6417341821027,127893.69152681332,86,0,24.657894736842106,35,3,17,39.563557128063515,0.5866071428571429,48.52430555555556,1005.902777777778,28.740079365079374,0
4411,4,0,0,34,0.0,0.0,1.0,34,600,200,400,0.3333333333333333,10,2,8,380.1369336751758,0.4699754901960784,0.14883983137877266,0.1944847984842829,125951.55897070866,2775.7678837466724,128727.32685445533,87,2,28.08823529411765,33,1,19,39.51071806454239,0.5855429292929293,49.050245098039234,1003.7990196078454,30.41815210932865,0
4412,4,2,4,32,0.05555555555555555,0.1111111111111111,0.8888888888888888,36,1250,1000,250,0.8,15,10,5,360.2378370282761,0.4706183862433862,0.14907473122519255,0.1872970894364729,126612.30867346955,1922.1426346274013,128534.45130809695,88,0,27.47222222222222,34,2,19,39.32901585048498,0.5900735294117647,48.39285714285715,1006.4285714285728,29.600840336134496,0
4413,4,1,0,33,0.030303030303030304,0.0,1.0,33,1300,1100,200,0.8461538461538461,15,11,4,391.68146200352766,0.46977588383838387,0.16556776556776565,0.20456827201872277,126796.7753940158,3332.7892727322,130129.564666748,89,0,27.515151515151516,31,2,20,38.34747360482656,0.5991263440860215,48.209635416666664,1007.1614583333329,32.48907930107526,0
4414,4,3,3,33,0.08333333333333333,0.08333333333333333,0.9166666666666666,36,950,700,250,0.7368421052631579,12,7,5,364.0138970106412,0.47027116402116403,0.1650334720706883,0.19460470748157996,127741.5856431421,2100.2858028096534,129841.87144595175,90,0,26.13888888888889,33,3,20,38.073680648159375,0.6038510101010102,47.27328431372549,1010.9068627450984,30.63354129530601,0
4415,4,2,0,35,0.05714285714285714,0.0,1.0,35,950,800,150,0.8421052631578947,11,8,3,361.26906940283334,0.46908263305322134,0.15053242981606973,0.1953879312529457,128206.57920030734,2263.414311803121,130469.99351211046,91,0,25.257142857142856,33,2,23,37.66688851242336,0.6085858585858586,46.81372549019606,1012.7450980392139,30.689245395127692,0
4416,4,1,1,35,0.027777777777777776,0.027777777777777776,0.9722222222222222,36,900,700,200,0.7777777777777778,11,7,4,352.77717085053615,0.4677579365079365,0.159130616182952,0.19296322528807855,128657.32001133761,1877.4730725623322,130534.79308389995,92,0,25.52777777777778,34,2,20,37.42152663693971,0.610906862745098,46.369047619047606,1014.5238095238074,29.838935574229627,0
4417,4,2,1,36,0.05405405405405406,0.02702702702702703,0.972972972972973,37,1000,400,600,0.4,16,4,12,370.3483362214483,0.4682182182182182,0.14077909653130938,0.1933053913295033,126771.27707315239,1989.9063089420406,128761.18338209443,93,0,25.594594594594593,35,2,18,38.91087710224879,0.5895833333333333,48.2349537037037,1007.0601851851848,28.773148148148135,16
4418,4,3,1,38,0.07692307692307693,0.02564102564102564,0.9743589743589743,39,1250,1000,250,0.8,15,10,5,357.7522023628703,0.46814552406657667,0.1469811182132097,0.1899810082541719,127471.58893014835,1321.4587887945822,128793.04771894294,94,0,25.128205128205128,35,4,16,38.508715377268366,0.5967261904761905,47.54050925925926,1009.8379629629633,28.852513227513235,0
4419,4,2,2,38,0.05,0.05,0.95,40,1500,1200,300,0.8,18,12,6,389.0150299977497,0.468616452991453,0.08594091903719936,0.19709519812524573,125548.84676054167,1825.5495195251183,127374.39628006678,95,0,25.45,37,3,17,39.705051057622164,0.5731981981981982,49.45175438596491,1002.19298245614,27.08629682313892,16
4420,4,3,3,38,0.07317073170731707,0.07317073170731707,0.926829268292683,41,1200,700,500,0.5833333333333334,17,7,10,387.34663715295017,0.47164634146341466,0.08777228654673408,0.19932164535416452,126189.1574100864,1578.7107256143909,127767.86813570079,96,0,25.195121951219512,35,6,20,39.08403889720847,0.5836309523809524,48.8136574074074,1004.7453703703687,28.707010582010536,0
4421,4,2,6,34,0.05,0.15,0.85,40,1000,600,400,0.6,14,6,8,401.73145052376873,0.47128739316239315,0.09288305122004847,0.19799310600570122,124397.65721183427,2112.4863302252866,126510.14354205957,97,0,23.55,37,3,12,40.58401113797903,0.5613738738738738,50.60307017543859,997.5877192982445,26.961830251303905,16
4422,4,4,7,31,0.10526315789473684,0.18421052631578946,0.8157894736842105,38,1200,900,300,0.75,15,9,6,397.8785368349113,0.47205429113323855,0.0764225163139598,0.19756569464242138,124710.81559713642,2323.9513674554105,127034.76696459182,98,0,22.236842105263158,35,3,14,40.3539011201236,0.5684523809523809,50.28935185185185,998.842592592592,28.538359788359774,0
4423,4,10,10,31,0.24390243902439024,0.24390243902439024,0.7560975609756098,41,900,400,500,0.4444444444444444,14,4,10,367.3888112668489,0.4784806910569106,0.0836459455600409,0.18789427772738443,125936.57687057146,1053.5378542990943,126990.11472487055,99,0,20.29268292682927,38,3,15,39.84610608479689,0.5753837719298245,49.06517094017095,1003.7393162393179,26.41419253261363,0
4424,4,3,4,30,0.08823529411764706,0.11764705882352941,0.8823529411764706,34,700,300,400,0.42857142857142855,11,3,8,402.00906735957244,0.4728721033868093,0.07369631332987181,0.20253696976883195,125315.85584379165,3275.622066625879,128591.47791041752,100,0,22.11764705882353,32,2,15,39.62142707019756,0.5813802083333333,49.68434343434345,1001.2626262626279,31.289457070707122,0
4425,4,1,1,30,0.03225806451612903,0.03225806451612903,0.967741935483871,31,900,400,500,0.4444444444444444,14,4,10,432.986111111111,0.4689964157706093,0.09973118279569881,0.21649305555555556,125000.00000000001,4624.652777777777,129624.6527777778,101,0,24.838709677419356,29,2,18,39.175347222222214,0.5862068965517242,50.0,1000.0000000000001,34.48275862068966,0
4426,4,2,2,30,0.0625,0.0625,0.9375,32,600,200,400,0.3333333333333333,10,2,8,418.665986529506,0.4725092405913978,0.09283618376928238,0.21189103391564584,125504.5403550987,4108.896440339903,129613.4367954386,102,0,22.15625,30,2,18,39.00821596244132,0.5885416666666667,49.49596774193547,1002.0161290322568,33.40053763440856,0
4427,4,5,4,31,0.14285714285714285,0.11428571428571428,0.8857142857142857,35,1100,700,400,0.6363636363636364,15,7,8,383.11170024354186,0.470343137254902,0.07800681125649778,0.19904825625430447,126583.26478165502,2700.2621616049173,129283.52694325993,103,0,20.857142857142858,32,3,17,38.783458803847765,0.5944010416666667,48.42171717171718,1006.313131313132,31.447285353535374,0
4428,4,2,1,32,0.06060606060606061,0.030303030303030304,0.9696969696969697,33,1100,800,300,0.7272727272727273,14,8,6,402.13513014424655,0.47017045454545453,0.10205273634134926,0.195997381725434,123929.07133200673,3376.8159817875485,127305.88731379427,104,0,22.818181818181817,32,1,20,41.06301251162399,0.5670572916666667,51.07323232323231,995.707070707069,31.115845959595905,16
4429,4,5,5,32,0.13513513513513514,0.13513513513513514,0.8648648648648649,37,800,500,300,0.625,11,5,6,365.2777777777779,0.47660160160160164,0.08873873873873861,0.1826388888888887,124999.99999999977,1741.1630509641582,126741.16305096392,105,0,20.64864864864865,33,4,19,40.86805555555555,0.5757575757575757,49.999999999999986,999.9999999999982,30.303030303030248,0
4430,4,5,3,34,0.13513513513513514,0.08108108108108109,0.9189189189189189,37,1250,900,350,0.72,16,9,7,361.7290727477839,0.4763513513513513,0.10102826319042535,0.1831491410438778,125521.37586805539,1680.9461805555352,127202.32204861092,106,0,21.135135135135137,33,4,18,40.417099792099776,0.5811237373737373,49.47916666666666,1002.083333333332,30.366161616161577,0
4431,4,4,1,37,0.10526315789473684,0.02631578947368421,0.9736842105263158,38,1150,1000,150,0.8695652173913043,13,10,3,356.34243091210806,0.47408428165007116,0.12516545447102323,0.18301101944447426,126109.22071668843,1390.8684624566072,127500.08917914504,107,0,21.473684210526315,31,7,23,39.94522945294271,0.5920698924731183,48.89322916666667,1004.4270833333339,32.400873655914,0
4432,4,1,4,34,0.02631578947368421,0.10526315789473684,0.8947368421052632,38,850,300,550,0.35294117647058826,14,3,11,391.5582446083623,0.4758771929824561,0.07321657284127103,0.18997348111558948,123736.31813823977,2089.9951049022193,125826.313243142,108,0,22.44736842105263,36,2,16,41.52754197321261,0.5564236111111112,51.2668918918919,994.932432432434,27.637012012012054,16
4433,4,6,5,35,0.15,0.125,0.875,40,1000,800,200,0.8,12,8,4,353.07955682245114,0.476161858974359,0.11426919518963974,0.17752511670933457,125231.58864883387,843.9514808852763,126075.54012971914,109,0,21.2,35,5,17,40.93335646006784,0.5738095238095238,49.76851851851851,1000.9259259259247,28.597883597883563,0
4434,4,1,0,36,0.027777777777777776,0.0,1.0,36,1100,800,300,0.7272727272727273,14,8,6,392.0252957897837,0.4750496031746032,0.11863711001642074,0.1955680067276441,124905.32096533495,2593.2090794306387,127498.53004476559,110,0,23.916666666666668,32,4,19,40.29777693570798,0.5771484375,50.094696969696955,999.6212121212102,31.23816287878782,0
4435,4,3,9,30,0.07692307692307693,0.23076923076923078,0.7692307692307692,39,800,600,200,0.75,10,6,4,365.4905828174943,0.4766925326135853,0.09535113748763613,0.18605789487839203,125745.15483276639,1391.7698553250464,127136.92468809144,111,0,23.0,34,5,17,40.091493570722086,0.5811887254901961,49.25595238095238,1002.9761904761901,29.499299719887944,0
4436,4,3,2,31,0.09090909090909091,0.06060606060606061,0.9393939393939394,33,950,600,350,0.631578947368421,13,6,7,392.7547076894667,0.4749447601010101,0.05892489387635025,0.19802527569517855,125347.46334876532,3246.161265432084,128593.6246141974,112,0,23.272727272727273,29,4,18,39.82027276930191,0.5897988505747127,49.65277777777777,1001.388888888888,34.53065134099614,0
4437,4,6,5,32,0.16216216216216217,0.13513513513513514,0.8648648648648649,37,800,300,500,0.375,13,3,10,352.1040143849683,0.47484984984984985,0.04892349977095756,0.18222927060274663,126424.4899276859,1504.8430963677142,127929.33302405362,113,0,21.594594594594593,32,5,18,39.72693032015065,0.5927734375,48.57954545454545,1005.6818181818178,31.427556818181806,0
4438,4,4,3,33,0.1111111111111111,0.08333333333333333,0.9166666666666666,36,600,200,400,0.3333333333333333,10,2,8,361.7401592016768,0.4744708994708995,0.07516678168852087,0.18787150203699987,126567.38281250001,1956.9010416666672,128524.28385416669,114,0,23.083333333333332,31,5,20,39.33747412008281,0.5967741935483871,48.4375,1006.2500000000001,32.45967741935484,0
4439,4,1,2,32,0.029411764705882353,0.058823529411764705,0.9411764705882353,34,1000,800,200,0.8,12,8,4,409.26369520067664,0.47406045751633985,0.07987659191222973,0.20202442118494365,124463.95975219362,3440.8844202759883,127904.84417246962,115,0,24.294117647058822,32,2,16,40.32698553291999,0.5725911458333333,50.53661616161616,997.8535353535351,31.182922979797972,16
4440,4,4,1,35,0.1111111111111111,0.027777777777777776,0.9722222222222222,36,1200,900,300,0.75,15,9,6,380.21110117394926,0.47500000000000003,0.11095611223237967,0.19327206428413862,125685.46095521552,2357.4015022675876,128042.8624574831,116,0,23.444444444444443,34,2,18,39.784172305987575,0.5805759803921569,49.3154761904762,1002.7380952380961,29.492296918767533,0
4441,4,1,1,35,0.027777777777777776,0.027777777777777776,0.9722222222222222,36,1050,600,450,0.5714285714285714,15,6,9,382.37817192224225,0.4752314814814815,0.08786544603488644,0.18511412007480701,123643.74524444867,2255.7338552383376,125899.47909968701,117,0,24.22222222222222,35,1,17,41.85250106675977,0.5574404761904762,51.3599537037037,994.5601851851847,28.416005291005277,16
4442,4,2,2,35,0.05405405405405406,0.05405405405405406,0.9459459459459459,37,850,400,450,0.47058823529411764,13,4,9,371.7638601049977,0.47750875875875876,0.08727719353991126,0.18169188433639824,124044.62528406779,1823.061744176604,125867.6870282444,118,0,23.756756756756758,36,1,19,41.69869620920944,0.5596064814814814,50.957207207207205,996.1711711711707,27.67142142142141,0
4443,4,3,3,35,0.07894736842105263,0.07894736842105263,0.9210526315789473,38,850,500,350,0.5882352941176471,12,5,7,365.4540780577824,0.477759009009009,0.12349244489626199,0.18176951742699304,124780.79793782697,1520.3302939365944,126301.12823176356,119,0,23.736842105263158,37,1,16,41.09096063798657,0.5653153153153153,50.219298245614034,999.1228070175433,27.003319108582254,0
4444,4,4,5,34,0.10256410256410256,0.1282051282051282,0.8717948717948718,39,1500,1300,200,0.8666666666666667,17,13,4,363.50212204969694,0.4772829509671615,0.12991770134627312,0.17975013191264838,124537.46570644726,1343.5936247240488,125881.0593311713,120,0,23.46153846153846,35,4,18,41.39223871366729,0.5666666666666667,50.46296296296297,998.1481481481487,28.518518518518533,16
4445,4,4,3,35,0.10526315789473684,0.07894736842105263,0.9210526315789473,38,1350,900,450,0.6666666666666666,18,9,9,355.59998922647344,0.4763661688003793,0.153281277940037,0.1719577165865151,123596.30534250491,1241.6628825397277,124837.96822504465,121,0,23.710526315789473,36,2,16,42.567714231785565,0.5549768518518519,51.40765765765767,994.3693693693714,27.621371371371428,15
4446,4,3,1,37,0.07894736842105263,0.02631578947368421,0.9736842105263158,38,1000,500,500,0.5,15,5,10,345.3161327822266,0.4797741820768136,0.15894165794232373,0.1689909924146652,124100.72234396583,970.7963030598445,125071.51864702567,122,0,23.526315789473685,36,2,20,42.299107142857146,0.5601851851851851,50.900900900900915,996.3963963963984,27.677677677677732,0
4447,4,5,3,39,0.11904761904761904,0.07142857142857142,0.9285714285714286,42,1750,1500,250,0.8571428571428571,20,15,5,347.20285785871636,0.4812717770034843,0.09232019897758992,0.17172664377840108,124546.35251159729,456.3579300921664,125002.71044168946,123,0,21.571428571428573,38,4,18,41.78975346962077,0.5611293859649122,50.45405982905985,998.1837606837638,26.26799370220431,16
4448,4,2,1,40,0.04878048780487805,0.024390243902439025,0.975609756097561,41,1200,600,600,0.5,18,6,12,343.4016798637731,0.4798018292682927,0.1272307752473565,0.1711519826918277,124866.48866106031,375.8723929798009,125242.36105404011,124,0,22.609756097560975,38,3,20,41.55309103866024,0.5644188596491229,50.133547008547026,999.4658119658147,26.30173189383723,0
4449,4,7,7,40,0.14893617021276595,0.14893617021276595,0.851063829787234,47,800,600,200,0.75,10,6,4,308.8736327996939,0.48327166204131977,0.16401883128195038,0.159565892913179,126350.17108078889,-1578.1078652798828,124772.063215509,125,0,20.48936170212766,40,7,11,40.89002324876176,0.5763020833333333,48.65345528455286,1005.3861788617914,25.134654471544785,0
4450,4,1,6,35,0.024390243902439025,0.14634146341463414,0.8536585365853658,41,1250,900,350,0.72,16,9,7,342.4585731857115,0.47914126016260167,0.17625397638036722,0.17431655920588227,125741.22716845566,412.23224934594924,126153.45941780161,126,0,24.146341463414632,37,4,19,40.67305765096024,0.5751689189189189,49.25986842105263,1002.9605263157894,27.107041251778092,0
4451,4,4,1,38,0.10256410256410256,0.02564102564102564,0.9743589743589743,39,950,500,450,0.5263157894736842,14,5,9,343.1671940368245,0.47972896986054886,0.1751152073732729,0.17646275143599685,126160.08659122037,858.8005829903461,127018.88717421071,127,0,24.564102564102566,35,4,24,40.223694316436244,0.5833333333333333,48.84259259259257,1004.6296296296257,28.703703703703592,0
4452,4,2,1,39,0.05,0.025,0.975,40,1000,600,400,0.6,14,6,8,331.9451887562606,0.47999465811965814,0.1707666927636735,0.17305667245887585,126723.24087178371,413.03402219784687,127136.27489398155,128,0,24.55,36,4,18,39.92702158595235,0.5870949074074074,48.282657657657644,1006.8693693693674,27.96859359359354,0
4453,4,1,0,40,0.025,0.0,1.0,40,1000,600,400,0.6,14,6,8,333.52951917743866,0.4803285256410256,0.1389679810895028,0.1612550251939958,123588.40954644227,501.3418513234262,124089.75139776569,129,0,25.5,38,2,17,43.12457469288349,0.5512609649122807,51.41559829059828,994.3376068376057,26.166779127305414,16
4454,4,9,11,38,0.1836734693877551,0.22448979591836735,0.7755102040816326,49,400,100,300,0.25,7,1,6,281.8559421439423,0.4860048185941043,0.18959511119352102,0.14308545522184601,125630.63837059044,-2700.342365507206,122930.29600508323,130,0,21.632653061224488,42,7,13,42.30600393066564,0.5659722222222222,49.37015503875968,1002.519379844959,23.869509043927593,0
4455,4,1,3,36,0.02564102564102564,0.07692307692307693,0.9230769230769231,39,1200,1000,200,0.8333333333333334,14,10,4,339.81286789525717,0.48045996401259555,0.18244713098676968,0.16850031173564814,124653.01890432095,671.7399691357991,125324.75887345675,131,0,26.871794871794872,35,4,19,41.86369958275383,0.5678571428571428,50.34722222222222,998.6111111111109,28.531746031746025,0
4456,4,4,3,37,0.1,0.075,0.925,40,1250,900,350,0.72,16,9,7,321.2060229057847,0.4790064102564102,0.16929809358752124,0.16229060877113624,125434.40453800143,58.53949652776194,125492.9440345292,132,0,25.35,35,5,17,41.52188041594454,0.5758928571428572,49.565972222222214,1001.7361111111102,28.62103174603172,0
4457,4,3,2,38,0.075,0.05,0.95,40,1450,1000,450,0.6896551724137931,19,10,9,326.1675231243442,0.480715811965812,0.19827874524276368,0.16665872675375282,125898.59992551856,212.80690050581586,126111.40682602438,133,0,25.975,35,5,20,40.91956425633337,0.580654761904762,49.10300925925925,1003.5879629629618,28.673941798941765,0
4458,4,2,5,35,0.05,0.125,0.875,40,1450,1100,350,0.7586206896551724,18,11,7,321.4569152345776,0.4810363247863248,0.20324585635359105,0.1662391475927389,126392.74691358031,126.04823066701732,126518.79514424733,134,0,26.175,35,5,19,40.53004143646408,0.5857142857142856,48.611111111111114,1005.5555555555561,28.730158730158745,0
4459,4,1,1,35,0.027777777777777776,0.027777777777777776,0.9722222222222222,36,1150,900,250,0.782608695652174,14,9,5,325.3563803247076,0.4797619047619048,0.14762948530605646,0.16910294906496853,126598.21342752807,1037.9072952710792,127636.12072279915,135,0,25.305555555555557,33,3,21,40.22111949991883,0.5921717171717171,48.40686274509805,1006.3725490196096,30.496137849079076,0
4460,4,2,1,36,0.05405405405405406,0.02702702702702703,0.972972972972973,37,1400,1000,400,0.7142857142857143,18,10,8,318.95470855702615,0.4806056056056056,0.15254177817614623,0.16817070601143047,127182.05959467147,713.0633503401732,127895.12294501165,136,0,25.243243243243242,34,3,23,39.78421653094144,0.5958946078431373,47.82738095238097,1008.6904761904784,29.667366946778778,0
4461,4,1,0,37,0.02702702702702703,0.0,1.0,37,600,400,200,0.6666666666666666,8,4,4,320.0510635457455,0.48066816816816815,0.157190209077001,0.16962706367924552,127392.2902494334,754.4075963719138,128146.6978458053,137,0,26.0,34,3,18,39.54156839622642,0.5980392156862745,47.619047619047635,1009.5238095238119,29.69187675070035,0
4462,4,0,0,37,0.0,0.0,1.0,37,850,400,450,0.47058823529411764,13,4,9,320.418245982225,0.4804491991991992,0.16007213154448774,0.17020087543313822,127482.44224773257,769.540107709766,128251.98235544233,138,1,27.0,34,3,19,39.440154819442796,0.5989583333333333,47.52976190476191,1009.8809523809537,29.70238095238099,0
4463,4,0,0,37,0.0,0.0,1.0,37,1300,800,500,0.6153846153846154,18,8,10,320.72613148997,0.4801363863863864,0.16095175906607806,0.17061825866410013,127542.56129535154,781.2464569160994,128323.80775226763,139,2,28.0,34,3,19,39.37094873305831,0.5995710784313726,47.470238095238095,1010.1190476190482,29.709383753501417,0
4464,4,2,2,37,0.05128205128205128,0.05128205128205128,0.9487179487179487,39,850,700,150,0.8235294117647058,10,7,3,305.91672663554374,0.47818263607737294,0.160339789911774,0.16566652354525677,128258.57688347127,47.28880062494454,128305.8656840962,140,0,27.512820512820515,36,3,21,39.01542523624235,0.6027199074074074,46.762387387387385,1012.95045045045,28.1375125125125,0
4465,4,2,2,37,0.05128205128205128,0.05128205128205128,0.9487179487179487,39,950,600,350,0.631578947368421,13,6,7,306.0715796187925,0.4758209626630679,0.15728052489491917,0.16682012729343862,128515.36502718925,66.98015583150067,128582.34518302075,141,0,28.153846153846153,36,3,18,38.75037020583445,0.6053240740740741,46.509009009009006,1013.9639639639631,28.165665665665642,0
4466,4,2,2,37,0.05128205128205128,0.05128205128205128,0.9487179487179487,39,1500,1100,400,0.7333333333333333,19,11,8,304.4562442683448,0.47688933873144396,0.15128005985656046,0.16701546741269568,128772.40997331786,41.1128611719752,128813.52283448984,142,0,28.871794871794872,36,3,20,38.53022486038684,0.6079282407407407,46.25563063063063,1014.9774774774771,28.19381881881881,0
4467,4,0,0,37,0.0,0.0,1.0,37,1150,700,450,0.6086956521739131,16,7,9,320.85175165030614,0.47475600600600604,0.15763174842879102,0.17510160616969578,128566.75347222191,850.1736111110725,129416.92708333298,143,1,31.10810810810811,34,3,20,38.323404546699535,0.6099877450980392,46.458333333333314,1014.1666666666641,29.828431372548945,0
4468,4,4,2,39,0.0975609756097561,0.04878048780487805,0.9512195121951219,41,1450,1100,350,0.7586206896551724,18,11,7,348.27914102957794,0.47477134146341465,0.1691978357240378,0.17934516621701072,126218.23157793233,1381.0715663580477,127599.30314429037,144,0,28.975609756097562,35,6,18,40.0354181064271,0.5839285714285714,48.784722222222236,1004.8611111111129,28.710317460317512,16
4469,4,3,4,38,0.07142857142857142,0.09523809523809523,0.9047619047619048,42,1300,1000,300,0.7692307692307693,16,10,6,339.48020052318026,0.475791231126597,0.1686692124562612,0.17698498384126873,126723.24087178418,204.00624442012582,126927.24711620431,145,0,28.476190476190474,36,6,19,39.73735227230363,0.5870949074074074,48.28265765765767,1006.8693693693713,27.968593593593646,0
4470,4,0,0,38,0.0,0.0,1.0,38,950,600,350,0.631578947368421,13,6,7,350.22791119587805,0.47639580369843526,0.1439906276677545,0.1817630586284043,126538.26845689747,1263.4466896005054,127801.71514649797,146,1,28.57894736842105,35,3,19,39.65702768511065,0.587202380952381,48.4664351851852,1006.1342592592607,28.746693121693163,0
4471,4,1,3,36,0.02564102564102564,0.07692307692307693,0.9230769230769231,39,1350,1000,350,0.7407407407407407,17,10,7,398.9604710531197,0.4773110661268556,0.16052308798981874,0.19135878602956113,123250.21435657585,2353.172052482242,125603.38640905809,147,0,28.82051282051282,34,5,13,41.851996163529535,0.555453431372549,51.75595238095237,992.9761904761895,29.205182072829103,16
4472,4,4,3,37,0.1,0.075,0.925,40,1200,600,600,0.5,18,6,12,378.32051762252047,0.4796340811965812,0.18073057813911464,0.18613369467028,124325.23739956165,1408.9984496355041,125734.23584919715,148,0,27.325,36,4,13,41.24322493224931,0.5625,50.67567567567567,997.2972972972967,27.702702702702688,0
4473,4,4,4,37,0.0975609756097561,0.0975609756097561,0.9024390243902439,41,1100,800,300,0.7272727272727273,14,8,6,365.1751714163423,0.48180894308943084,0.1732233800217895,0.1823537488854922,124946.586903718,925.4782580904025,125872.0651618084,149,0,26.78048780487805,38,3,17,40.92599024007978,0.5652412280701755,50.053418803418786,999.7863247863222,26.31016644174532,0
4474,4,3,4,36,0.075,0.1,0.9,40,1250,800,450,0.64,17,8,9,361.019967456294,0.4806356837606838,0.1723834026713389,0.1821854355108169,125384.06649161261,1053.241735142177,126437.30822675479,150,0,27.075,37,3,13,40.576873950806515,0.571509009009009,49.61622807017543,1001.5350877192966,27.068515884305313,0
4475,4,4,4,36,0.1,0.1,0.9,40,800,500,300,0.625,11,5,6,363.4834983688186,0.47940705128205124,0.20255079746558846,0.18588424268537232,125933.75485726378,1154.9683556478885,127088.72321291166,151,0,27.175,37,3,18,39.947017697181536,0.5771396396396397,49.06798245614035,1003.7280701754387,27.12778568041726,0
4476,4,1,3,34,0.02702702702702703,0.08108108108108109,0.9189189189189189,37,1250,700,550,0.56,18,7,11,381.82641324115116,0.47685185185185186,0.2124728606723072,0.1941399087043034,125695.40895061716,2198.765432098755,127894.17438271591,152,0,30.054054054054053,35,2,19,39.73337950138505,0.5785714285714285,49.30555555555555,1002.7777777777767,28.65079365079362,0
4477,4,2,3,33,0.05555555555555555,0.08333333333333333,0.9166666666666666,36,1350,1200,150,0.8888888888888888,15,12,3,383.97318936288985,0.47380952380952385,0.20369516195161919,0.19633346097611928,125927.64060356657,2470.567558299045,128398.20816186562,153,0,30.25,35,1,21,39.43919126691268,0.5809523809523809,49.074074074074076,1003.703703703704,28.677248677248688,0
4478,4,2,1,34,0.05714285714285714,0.02857142857142857,0.9714285714285714,35,950,700,250,0.7368421052631579,12,7,5,375.9207063823293,0.47517507002801124,0.16635663775385767,0.19391834174514871,126290.07623269896,2495.0645169711506,128785.14074967011,154,0,29.114285714285714,33,2,19,39.26684548484108,0.5890151515151515,48.713235294117645,1005.1470588235295,30.459001782531196,0
4479,4,0,0,34,0.0,0.0,1.0,34,1050,600,450,0.5714285714285714,15,6,9,385.7045196544797,0.47458036244800955,0.17525064324372286,0.1982341833573024,126138.94628099167,2930.472337006419,129069.41861799809,155,1,30.970588235294116,32,2,22,39.17719331322273,0.58984375,48.86363636363636,1004.545454545454,31.39204545454544,0
4480,4,0,1,33,0.0,0.029411764705882353,0.9705882352941176,34,1550,1200,350,0.7741935483870968,19,12,7,423.23967293528955,0.47459893048128343,0.05922141583906293,0.20368409260010828,123392.29968782526,3919.9908354785275,127312.29052330379,156,2,31.970588235294116,30,4,16,41.10017586580085,0.5666666666666667,51.612903225806456,993.5483870967748,33.11827956989249,16
4481,4,6,4,35,0.15384615384615385,0.10256410256410256,0.8974358974358975,39,1200,1000,200,0.8333333333333334,14,10,4,378.02376543914625,0.4811347278452542,0.08472952105420584,0.18928222152680046,125059.53089569185,1665.500781911821,126725.03167760366,157,0,28.23076923076923,34,5,17,40.48763191303659,0.5741421568627452,49.940476190476204,1000.2380952380971,29.418767507002855,0
4482,4,4,3,36,0.10256410256410256,0.07692307692307693,0.9230769230769231,39,1400,900,500,0.6428571428571429,19,9,10,366.42050099565785,0.4770580296896086,0.11998154130133831,0.18683134721355102,125811.49798525403,1419.9824245542165,127231.48040980824,158,0,28.974358974358974,35,4,15,39.9996154437779,0.5797619047619047,49.18981481481483,1003.2407407407429,28.664021164021225,0
4483,4,2,1,37,0.05263157894736842,0.02631578947368421,0.9736842105263158,38,1550,1000,550,0.6451612903225806,21,10,11,364.1288047174152,0.4784850640113798,0.19819266095529886,0.17562746334983814,123486.75063775503,1491.8248806724268,124978.57551842746,159,0,29.68421052631579,34,4,17,42.46990657563781,0.5579044117647058,51.51785714285714,993.9285714285709,29.233193277310907,15
4484,4,6,3,40,0.13953488372093023,0.06976744186046512,0.9302325581395349,43,1550,1000,550,0.6451612903225806,21,10,11,341.16093696513275,0.4815660760428202,0.15846479102293087,0.1637114563289061,123269.91705246929,-188.11689027460756,123081.80016219468,160,0,27.069767441860463,38,5,14,43.266317016317025,0.5479714912280702,51.73611111111112,993.0555555555568,26.133040935672547,15
4485,4,7,4,43,0.14893617021276595,0.0851063829787234,0.9148936170212766,47,1050,700,350,0.6666666666666666,14,7,7,404.9298856812724,0.48384983040394697,0.2893260927623955,0.19750661770984537,123960.50347222236,1729.918981481494,125690.42245370385,161,0,25.19148936170213,34,13,18,40.96059972105995,0.5628063725490196,51.04166666666667,995.8333333333345,29.289215686274545,16
4486,4,6,9,40,0.12244897959183673,0.1836734693877551,0.8163265306122449,49,1200,800,400,0.6666666666666666,16,8,8,374.49306008187926,0.4856505102040816,0.29899904502528885,0.18921409427954838,125434.40453800153,-392.1163676697555,125042.28817033177,162,0,24.612244897959183,35,14,14,40.18739168110918,0.5758928571428572,49.56597222222222,1001.7361111111111,28.621031746031747,0
4487,4,2,4,38,0.047619047619047616,0.09523809523809523,0.9047619047619048,42,1700,1400,300,0.8235294117647058,20,14,6,416.273437763557,0.48037650019357336,0.2812771466044388,0.20621886134217085,124613.39462868475,1974.6492346938714,126588.04386337863,163,0,28.476190476190474,34,8,20,39.99617463534836,0.569546568627451,50.38690476190476,998.4523809523805,29.366246498599427,0
4488,4,2,1,39,0.05,0.025,0.975,40,950,600,350,0.631578947368421,13,6,7,415.250168439853,0.47960737179487184,0.2697090980085908,0.20811265780322177,125097.6753234863,2390.563712260619,127488.23903574691,164,0,27.95,31,9,22,39.517034361577515,0.5816532258064516,49.90234375,1000.3906249999998,32.27066532258064,0
4489,4,3,5,37,0.07142857142857142,0.11904761904761904,0.8809523809523809,42,950,500,450,0.5263157894736842,14,5,9,388.38975024247884,0.47972319008904374,0.26113873977390445,0.1997684061201941,126170.6574105958,1407.8072692603273,127578.46467985613,165,0,27.071428571428573,32,10,21,39.07696577437058,0.5901692708333333,48.832070707070706,1004.6717171717166,31.395991161616145,0
4490,4,1,2,36,0.02631578947368421,0.05263157894736842,0.9473684210526316,38,1150,800,350,0.6956521739130435,15,8,7,407.94833458093206,0.47764046941678523,0.2669826391088026,0.21056215281786017,126313.91860691998,2705.9105460168903,129019.82915293687,166,0,29.394736842105264,30,8,19,38.4373467932433,0.596875,48.68951612903226,1005.2419354838718,33.50806451612906,0
4491,4,3,4,35,0.07692307692307693,0.10256410256410256,0.8974358974358975,39,1550,1200,350,0.7741935483870968,19,12,7,398.4968275747014,0.4777327935222672,0.2505236920955638,0.20829536879174942,126829.56271701404,2308.235677083353,129137.7983940974,167,0,29.307692307692307,31,8,20,38.14201999310582,0.5994623655913979,48.17708333333334,1007.2916666666679,32.493279569892515,0
4492,4,1,1,35,0.027777777777777776,0.027777777777777776,0.9722222222222222,36,950,700,250,0.7368421052631579,12,7,5,428.9510809348346,0.4751653439153439,0.20109278059785662,0.2081363619314344,123740.56218753182,3415.729581165174,127156.29176869699,168,0,31.02777777777778,32,4,18,40.593009729272396,0.5651041666666667,51.262626262626256,994.9494949494945,31.092171717171702,15
4493,4,8,8,35,0.18604651162790697,0.18604651162790697,0.813953488372093,43,900,600,300,0.6666666666666666,12,6,6,346.528280406878,0.48138150609080843,0.1533821027377782,0.17644031010611044,125753.4467699758,122.58320349253961,125876.02997346834,169,0,25.093023255813954,35,8,17,40.55840833910304,0.5791666666666666,49.247685185185176,1003.0092592592575,28.65740740740736,0
4494,4,5,5,35,0.125,0.125,0.875,40,1400,1000,400,0.7142857142857143,18,10,8,369.51255108575674,0.4816639957264957,0.18740402769037146,0.18831155987019485,125790.38690248446,1296.225353280282,127086.61225576475,170,0,27.5,32,8,19,39.943885043003995,0.5862630208333333,49.21085858585859,1003.1565656565659,31.348642676767685,0
4495,4,4,3,36,0.10256410256410256,0.07692307692307693,0.9230769230769231,39,1100,700,400,0.6363636363636364,15,7,8,365.5478818084727,0.4829622132253711,0.19643928398645394,0.18700808625336932,125948.76320018369,1408.0607208448153,127356.82392102851,171,0,28.82051282051282,32,7,22,39.87971698113207,0.587890625,49.053030303030305,1003.7878787878791,31.36837121212122,0
4496,4,6,6,36,0.14285714285714285,0.14285714285714285,0.8571428571428572,42,1550,1200,350,0.7741935483870968,19,12,7,330.07743455938044,0.4817194154084398,0.1978811708169501,0.174652623140643,127325.53155006858,10.622250847415728,127336.153800916,172,0,26.88095238095238,35,7,15,39.356842507645254,0.5952380952380952,47.68518518518518,1009.2592592592592,28.835978835978835,0
4497,4,5,6,35,0.12195121951219512,0.14634146341463414,0.8536585365853658,41,1150,900,250,0.782608695652174,14,9,5,336.0792007925884,0.47903963414634143,0.21196879107100197,0.17825439036409912,127422.33737244911,364.7994614512631,127787.13683390037,173,0,28.341463414634145,34,7,16,39.1062866014228,0.5983455882352942,47.58928571428572,1009.6428571428582,29.695378151260538,0
4498,4,3,2,36,0.07894736842105263,0.05263157894736842,0.9473684210526316,38,1050,800,250,0.7619047619047619,13,8,5,366.43671880336046,0.47518077287814126,0.24271422357546713,0.19277757815307187,127092.01388888867,1714.2361111110781,128806.24999999975,174,0,31.289473684210527,31,7,21,38.679407713498605,0.6021505376344086,47.91666666666665,1008.3333333333316,32.52688172043005,0
4499,4,1,1,36,0.02702702702702703,0.02702702702702703,0.972972972972973,37,1350,1000,350,0.7407407407407407,17,10,7,366.8836186882198,0.4743180680680681,0.22777284053879843,0.19474212614148803,127453.32717895486,1952.1075778537047,129405.43475680856,175,0,31.0,31,6,20,38.2969320868257,0.6058467741935484,47.558593749999986,1009.7656249999983,32.5730846774193,0
4500,4,0,1,35,0.0,0.027777777777777776,0.9722222222222222,36,1350,1200,150,0.8888888888888888,15,12,3,364.9615749028309,0.4719080687830688,0.20326233215952327,0.19483024376862254,127683.5208468966,2119.915771484357,129803.43661838096,176,1,32.02777777777778,31,5,20,38.10927166537834,0.6081989247311828,47.33072916666666,1010.6770833333325,32.602486559139756,0
4501,4,1,1,35,0.027777777777777776,0.027777777777777776,0.9722222222222222,36,1650,1200,450,0.7272727272727273,21,12,9,354.41391871033727,0.46999007936507936,0.09815827357132512,0.17886528482963804,125387.20415249428,2074.3670197571128,127461.5711722514,177,0,32.94444444444444,34,2,19,40.73903482705337,0.5775122549019608,49.613095238095234,1001.5476190476186,29.45728291316525,16
4502,4,1,0,36,0.027777777777777776,0.0,1.0,36,1000,600,400,0.6,14,6,8,350.751237016266,0.4722883597883598,0.08960147796252294,0.17791116961909362,125595.94671201796,1610.5867346938505,127206.53344671181,178,0,33.44444444444444,34,2,21,40.61510292953284,0.579656862745098,49.40476190476189,1002.3809523809509,29.48179271708679,0
4503,4,0,1,35,0.0,0.027777777777777776,0.9722222222222222,36,1300,1000,300,0.7692307692307693,16,10,6,351.9958074941043,0.47144510582010585,0.09758278527748954,0.1793502447708054,125782.47070312488,1654.9804687499861,127437.45117187487,179,1,34.44444444444444,35,1,21,40.39135514018692,0.5794642857142858,49.21874999999999,1003.1249999999991,28.66071428571426,0
4504,4,2,1,36,0.05405405405405406,0.02702702702702703,0.972972972972973,37,1550,1100,450,0.7096774193548387,20,11,9,341.6957191858397,0.47200325325325326,0.10963119531262144,0.17758782297195871,126596.50051708215,1251.767725480071,127848.26824256222,180,0,33.513513513513516,35,2,17,39.81179317615488,0.5877976190476191,48.408564814814795,1006.365740740738,28.7533068783068,0
4505,4,1,2,35,0.02702702702702703,0.05405405405405406,0.9459459459459459,37,1100,700,400,0.6363636363636364,15,7,8,344.66180544528606,0.4700638138138138,0.1197092464698104,0.18031254453295453,126865.0132395906,1345.1049021994595,128210.11814179005,181,0,34.32432432432432,36,1,18,39.46130486623445,0.5885416666666667,48.14189189189187,1007.4324324324297,27.984234234234158,0
4506,4,2,3,34,0.05405405405405406,0.08108108108108109,0.9189189189189189,37,650,500,150,0.7692307692307693,8,5,3,335.76221346846717,0.47291041041041043,0.11651538250547011,0.17716369843909038,127212.08191609984,1143.0078520329555,128355.08976813279,182,0,34.45945945945946,34,3,21,39.329616080560136,0.5962009803921569,47.79761904761905,1008.8095238095243,29.67086834733895,0
4507,4,3,2,35,0.08108108108108109,0.05405405405405406,0.9459459459459459,37,1550,1300,250,0.8387096774193549,18,13,5,339.2117786863006,0.47269144144144143,0.1391093337955458,0.18105117674136806,127676.20991941047,1261.854852537765,128938.06477194824,183,0,34.75675675675676,35,2,17,38.76736906397926,0.5988095238095238,47.33796296296298,1010.6481481481508,28.87566137566145,0
4508,4,0,2,33,0.0,0.05714285714285714,0.9428571428571428,35,1350,1100,250,0.8148148148148148,16,11,5,384.5662610996999,0.4707633053221289,0.10531089628834,0.18943449157874098,124375.78124999991,2567.0031721536216,126942.78442215353,184,1,37.68571428571428,34,1,13,41.03487886382623,0.5670955882352942,50.62499999999999,997.4999999999993,29.338235294117627,16
4509,4,3,1,35,0.08333333333333333,0.027777777777777776,0.9722222222222222,36,1200,800,400,0.6666666666666666,16,8,8,374.75439911024984,0.47098214285714285,0.13720084946500033,0.18765309236428565,125061.28201893491,2176.5781189926784,127237.8601379276,185,0,37.416666666666664,33,3,17,40.56756922322959,0.5763888888888888,49.93872549019607,1000.2450980392148,30.31045751633984,0
4510,4,3,1,37,0.07894736842105263,0.02631578947368421,0.9736842105263158,38,1200,900,300,0.75,15,9,6,394.9188773548634,0.47369902797534374,0.05613347093223253,0.19292014123657142,124025.34484863302,2722.004624029096,126747.34947266211,186,0,36.26315789473684,31,7,21,41.1421568627451,0.5705645161290323,50.976562500000014,996.0937500000016,32.132056451612954,16
4511,4,2,1,38,0.05128205128205128,0.02564102564102564,0.9743589743589743,39,1500,1300,200,0.8666666666666667,17,13,4,385.55106025822,0.47537112010796223,0.07061982024045799,0.19103620203771973,124621.49908172649,1809.590220385697,126431.08930211219,187,0,36.256410256410255,32,7,20,40.754615579160365,0.57421875,50.37878787878789,998.4848484848495,31.202651515151548,0
4512,4,7,6,39,0.15555555555555556,0.13333333333333333,0.8666666666666667,45,1200,800,400,0.6666666666666666,16,8,8,341.79217280324605,0.477483164983165,0.1275807634460724,0.17794293725615742,126666.55411746232,-332.62796384722515,126333.9261536151,188,0,32.22222222222222,36,9,16,39.73738673229667,0.5865162037037037,48.33896396396398,1006.6441441441463,27.962337337337395,0
4513,4,3,1,41,0.07142857142857142,0.023809523809523808,0.9761904761904762,42,1450,1100,350,0.7586206896551724,18,11,7,363.24644964784983,0.47495644599303133,0.16686365506173306,0.18979800188529417,126814.13286055844,812.9567053537158,127627.08956591216,189,0,34.95238095238095,33,9,19,39.04558036257453,0.5943813131313131,48.192401960784316,1007.2303921568628,30.522133095662507,0
4514,4,1,3,39,0.023809523809523808,0.07142857142857142,0.9285714285714286,42,1400,1000,400,0.7142857142857143,18,10,8,366.71394833961017,0.4725246806039489,0.047287095634295895,0.1851052131970769,125394.4548433569,819.0399462561697,126213.49478961308,190,0,35.476190476190474,36,6,16,40.4235533318342,0.5734953703703703,49.60585585585586,1001.5765765765768,27.821571571571578,16
4515,4,0,3,36,0.0,0.07692307692307693,0.9230769230769231,39,1250,800,450,0.64,17,8,9,386.6189120666116,0.4709289248762933,0.05398904014948114,0.19402233663330576,125153.23320657924,1877.3213727893203,127030.55457936856,191,1,38.97435897435897,33,6,18,40.17541845274546,0.5773358585858586,49.8468137254902,1000.6127450980396,30.32159833630423,0
4516,4,1,0,37,0.02702702702702703,0.0,1.0,37,1100,900,200,0.8181818181818182,13,9,4,392.4192567270003,0.4707207207207207,0.14312156984570779,0.18966930741805027,123575.51020408167,2334.0086800651666,125909.51888414683,192,0,41.432432432432435,34,3,20,41.67414990421455,0.5588235294117647,51.42857142857143,994.2857142857147,29.243697478991606,16
4517,4,4,3,38,0.0975609756097561,0.07317073170731707,0.926829268292683,41,1350,800,550,0.5925925925925926,19,8,11,369.51652725344803,0.4736280487804878,0.17248429969329604,0.18381481717416248,124786.41610051898,1022.1286251735308,125808.54472569251,193,0,38.292682926829265,38,3,18,40.98365768463074,0.5635964912280702,50.21367521367523,999.1452991453018,26.293297345928995,0
4518,4,4,1,41,0.09523809523809523,0.023809523809523808,0.9761904761904762,42,1050,700,350,0.6666666666666666,14,7,7,353.65313510349904,0.47442411924119243,0.20902109804852964,0.1795125407297511,125625.78125000023,485.77290616556377,126111.5541561658,194,0,37.976190476190474,39,3,19,40.511568301468564,0.5705128205128205,49.375000000000014,1002.5000000000018,25.70512820512825,0
4519,4,1,0,42,0.023809523809523808,0.0,1.0,42,1450,1100,350,0.7586206896551724,18,11,7,354.16056886072914,0.47413375919473477,0.20677731673582378,0.18160148318177805,126043.83680555545,530.7291666666579,126574.5659722221,195,0,37.88095238095238,35,7,21,40.067427385892124,0.5821428571428571,48.95833333333333,1004.1666666666657,28.690476190476165,0
4520,4,2,3,41,0.045454545454545456,0.06818181818181818,0.9318181818181819,44,900,400,500,0.4444444444444444,14,4,10,337.4800471904625,0.47587429527836506,0.22064589913952748,0.17574613234575362,126677.7412881848,-249.75797841644157,126427.98330976836,196,0,37.11363636363637,37,7,19,39.83441800094396,0.584740990990991,48.32785087719298,1006.6885964912278,27.20779990516832,0
4521,4,1,1,41,0.023809523809523808,0.023809523809523808,0.9761904761904762,42,1550,1100,450,0.7096774193548387,20,11,9,337.4850190891612,0.4775575880758807,0.2109368344833471,0.1763122669820942,126808.29478126757,159.17995698399835,126967.47473825156,197,0,38.92857142857143,36,6,20,39.7002646094216,0.587962962962963,48.19819819819819,1007.2072072072057,27.977977977977936,0
4522,4,3,4,40,0.06818181818181818,0.09090909090909091,0.9090909090909091,44,1350,1000,350,0.7407407407407407,17,10,7,333.7424797855293,0.4782747533474278,0.07922063753396946,0.17205194430338372,126264.14497730075,87.0854581513139,126351.23043545206,198,0,38.02272727272727,37,7,18,40.35338933740638,0.5805180180180181,48.7390350877193,1005.0438596491231,27.163347558084407,16
4523,4,4,2,42,0.09090909090909091,0.045454545454545456,0.9545454545454546,44,900,500,400,0.5555555555555556,13,5,8,327.16344511986904,0.47752598661028894,0.1416228399699475,0.17211642112827874,127092.0138888887,-481.3226184980197,126610.69127039069,199,0,38.5,37,7,19,39.66942148760332,0.5889639639639639,47.91666666666666,1008.3333333333318,27.25225225225221,0
4524,4,0,1,41,0.0,0.023809523809523808,0.9761904761904762,42,950,600,350,0.631578947368421,13,6,7,337.63373201289915,0.476880081300813,0.1448867112480121,0.17725275866553994,127006.864867401,176.3603552877009,127183.2252226887,200,1,40.61904761904762,36,6,20,39.49279410121774,0.5899884259259259,48.00112612612612,1007.995495495494,27.999874874874834,0
4525,4,0,2,39,0.0,0.04878048780487805,0.9512195121951219,41,950,500,450,0.5263157894736842,14,5,9,384.30546921260174,0.47616869918699184,0.16285786959839443,0.19082601837196483,124710.81559713629,1756.2957895802215,126467.11138671651,201,2,40.8780487804878,35,6,18,40.69283507145616,0.5684523809523809,50.28935185185184,998.842592592591,28.53835978835974,16
4526,4,3,2,40,0.07142857142857142,0.047619047619047616,0.9523809523809523,42,1050,500,550,0.47619047619047616,16,5,11,371.5965223845709,0.4769526713124274,0.19735792155762133,0.18748832117747466,125376.44039619762,918.2247460133651,126294.66514221099,202,0,40.642857142857146,35,7,17,40.31995165453216,0.5752976190476191,49.62384259259259,1001.5046296296289,28.61441798941797,0
4527,4,3,5,38,0.06976744186046512,0.11627906976744186,0.8837209302325582,43,1300,1000,300,0.7692307692307693,16,10,6,361.4697452863631,0.4752906976744186,0.22254372693777746,0.1858892858300806,126163.40880102056,524.3942693461295,126687.80307036669,203,0,40.18604651162791,34,9,20,39.76058577240588,0.5854779411764706,48.83928571428572,1004.6428571428584,29.54831932773113,0
4528,4,3,5,36,0.07317073170731707,0.12195121951219512,0.8780487804878049,41,1400,1200,200,0.8571428571428571,16,12,4,355.5740531457194,0.4763719512195122,0.2195893606538888,0.1856485113565134,126783.27596357164,816.1686610918798,127599.44462466352,204,0,38.34146341463415,33,8,18,39.27050377220735,0.5940656565656566,48.22303921568627,1007.1078431372543,30.51841948900771,0
4529,4,4,1,39,0.1,0.025,0.975,40,1250,1000,250,0.8,15,10,5,346.16146464285737,0.4739049145299145,0.21496724493509634,0.1842097451937427,127555.82475790568,831.3576809400297,128387.1824388457,205,0,34.9,33,7,19,38.715046099720965,0.6019570707070707,47.45710784313726,1010.1715686274515,30.611259655377317,0
4530,4,2,2,39,0.04878048780487805,0.04878048780487805,0.9512195121951219,41,1150,800,350,0.6956521739130435,15,8,7,338.63303346153873,0.47324695121951216,0.21949211612544217,0.18258698056585027,128084.27047902472,474.7130102040544,128558.98348922878,206,0,35.0,34,7,21,38.364890822846846,0.6050857843137255,46.934523809523796,1012.261904761903,29.77240896358538,0
4531,4,1,4,36,0.025,0.1,0.9,40,1350,900,450,0.6666666666666666,18,9,9,358.86554366498973,0.470446047008547,0.16568942210206217,0.179069670101974,124915.55480734125,965.5918699656805,125881.14667730693,207,0,36.55,36,4,16,41.115851826818385,0.5685763888888888,50.08445945945947,999.6621621621632,27.768393393393424,16
4532,4,4,2,38,0.1,0.05,0.95,40,1500,1200,300,0.8,18,12,6,349.2523287089209,0.47159455128205124,0.1828213946869064,0.17869512352388503,125954.19501133809,798.0162508758283,126752.21126221391,208,0,35.125,34,6,18,40.2830487033523,0.5833333333333333,49.04761904761906,1003.8095238095257,29.52380952380958,0
4533,4,4,2,40,0.09523809523809523,0.047619047619047616,0.9523809523809523,42,1450,800,650,0.5517241379310345,21,8,13,325.1502057436164,0.47562185443283006,0.17705241565787655,0.17070850036556645,127009.10526556261,-140.59265831792555,126868.51260724469,209,0,32.5,37,5,18,39.805082671597965,0.5881193693693694,47.99890350877194,1008.0043859649134,27.243361782835496,0
4534,4,1,1,40,0.024390243902439025,0.024390243902439025,0.975609756097561,41,1250,600,650,0.48,19,6,13,321.7838246409674,0.4743140243902439,0.16137824235385168,0.170642937309604,127415.40310650902,0.043145956623334314,127415.44625246564,210,0,31.24390243902439,38,3,17,39.474206349206355,0.5904605263157895,47.596153846153854,1009.6153846153859,26.568825910931206,0
4535,4,0,0,40,0.0,0.0,1.0,40,1050,800,250,0.7619047619047619,13,8,5,328.8266269214237,0.4739850427350427,0.1589343906148164,0.17417594519209595,127368.57133925824,376.4355378578035,127745.00687711604,211,1,32.725,37,3,17,39.34435875153886,0.5917792792792793,47.64254385964912,1009.4298245614036,27.281887150308204,0
4536,4,0,6,34,0.0,0.15,0.85,40,1500,1100,400,0.7333333333333333,19,11,8,325.8363602114859,0.4735309829059829,0.15023799449968211,0.1732540466501345,127523.29082657624,310.3449850244851,127833.63581160072,212,2,33.725,38,2,17,39.26160002820675,0.5915570175438596,47.489316239316246,1010.0427350427364,26.580071974808853,0
4537,4,0,0,34,0.0,0.0,1.0,34,750,400,350,0.5333333333333333,11,4,7,363.26469775337404,0.4700311942959002,0.1521241432598337,0.1902396398043464,126906.72607891176,2420.146698385209,129326.87277729697,213,3,38.76470588235294,33,1,18,38.94987026676395,0.5953282828282829,48.10049019607842,1007.5980392156847,30.533273915626808,0
4538,4,1,2,33,0.02857142857142857,0.05714285714285714,0.9428571428571428,35,700,500,200,0.7142857142857143,9,5,4,355.14334505162003,0.4688725490196079,0.1528301886792458,0.18822597287735832,127392.29024943287,2048.504818594078,129440.79506802696,214,0,38.628571428571426,34,1,18,38.65590605345911,0.5980392156862745,47.619047619047606,1009.5238095238076,29.691876750700224,0
4539,4,3,0,36,0.08333333333333333,0.0,1.0,36,1250,1000,250,0.8,15,10,5,345.64514217006194,0.4679232804232804,0.15146319158664845,0.18664837677183357,128144.53125000003,1658.5069444444453,129803.03819444447,215,0,37.333333333333336,35,1,21,38.12585733882031,0.6035714285714286,46.875,1012.5000000000002,28.928571428571434,0
4540,4,1,1,36,0.02702702702702703,0.02702702702702703,0.972972972972973,37,1000,700,300,0.7,13,7,6,341.95516353447084,0.46721721721721726,0.15608543446801626,0.18611126856936536,128458.27880245095,1385.3943470497425,129843.6731495007,216,0,37.2972972972973,36,1,19,37.898985410649495,0.6047453703703703,46.56531531531531,1013.7387387387375,28.159409409409378,0
4541,4,1,0,37,0.02702702702702703,0.0,1.0,37,1250,800,450,0.64,17,8,9,369.3384991386869,0.4679366866866867,0.16553211565680415,0.18747435209444752,125625.78125000012,1913.5346917863956,127539.31594178651,217,0,37.891891891891895,34,3,16,40.118453865336654,0.5799632352941176,49.37500000000001,1002.5000000000009,29.485294117647086,15
4542,4,2,2,37,0.05128205128205128,0.05128205128205128,0.9487179487179487,39,1250,800,450,0.64,17,8,9,352.06172100702594,0.46828609986504727,0.17223964701504446,0.18129299298831553,126218.23157793209,1088.0160108024688,127306.24758873456,218,0,36.8974358974359,35,4,20,39.940393918451974,0.5839285714285714,48.78472222222222,1004.8611111111111,28.71031746031746,0
4543,4,1,2,36,0.02631578947368421,0.05263157894736842,0.9473684210526316,38,1450,1100,350,0.7586206896551724,18,11,7,359.1423148626493,0.46981685633001424,0.178348715390372,0.18482689862443655,126193.31065759636,1464.2715419501155,127657.58219954648,219,0,37.36842105263158,34,4,21,39.788210900473956,0.5857843137254901,48.80952380952381,1004.7619047619046,29.55182072829131,0
4544,4,2,1,37,0.05263157894736842,0.02631578947368421,0.9736842105263158,38,950,500,450,0.5263157894736842,14,5,9,343.37646197730135,0.47040955429113324,0.15075235508013618,0.1789713506734898,126713.00482521,1102.0526566786598,127815.05748188865,220,0,36.31578947368421,35,3,17,39.649792121699804,0.5889880952380953,48.29282407407407,1006.8287037037032,28.76653439153438,0
4545,4,1,1,37,0.02631578947368421,0.02631578947368421,0.9736842105263158,38,1350,900,450,0.6666666666666666,18,9,9,339.07984489337576,0.47116524419156,0.14386791027183277,0.17774643043266833,126946.17419249388,1008.9778109996482,127955.15200349354,221,0,36.94736842105263,35,3,18,39.51861050495772,0.5913690476190476,48.06134259259259,1007.7546296296287,28.79298941798939,0
4546,4,2,3,36,0.05128205128205128,0.07692307692307693,0.9230769230769231,39,1050,600,450,0.5714285714285714,15,6,9,336.7202477664315,0.47244714349977507,0.17596663795838796,0.17912672741681324,127542.56129535151,789.4000170155514,128331.96131236706,222,0,36.64102564102564,34,5,15,38.96704969554113,0.5995710784313726,47.470238095238095,1010.1190476190479,29.70938375350141,0
4547,4,0,2,34,0.0,0.05555555555555555,0.9444444444444444,36,1300,900,400,0.6923076923076923,17,9,8,363.92532969687,0.47045304232804236,0.18565741338497932,0.19161126298451814,127124.83935885975,2052.7898152669472,129177.6291741267,223,1,40.138888888888886,31,5,20,38.708978911125435,0.602486559139785,47.88411458333334,1008.463541666668,32.531081989247355,0
4548,4,1,1,34,0.02857142857142857,0.02857142857142857,0.9714285714285714,35,950,600,350,0.631578947368421,13,6,7,369.7640576056664,0.46918767507002807,0.17954614681693593,0.1948531944011884,127159.78725864275,2403.8237802058234,129563.61103884858,224,0,40.25714285714286,30,5,21,38.52584177327648,0.6055555555555556,47.84946236559141,1008.6021505376356,33.62007168458785,0
4549,4,3,2,35,0.08108108108108109,0.05405405405405406,0.9459459459459459,37,1200,800,400,0.6666666666666666,16,8,8,346.50806956130776,0.4683433433433433,0.15869338281252543,0.18668037485367522,128051.4874837803,1474.1747464917378,129525.66223027205,225,0,37.891891891891895,33,4,20,38.19911107075108,0.6070075757575757,46.966911764705884,1012.1323529411767,30.67067736185384,0
4550,4,2,4,33,0.05405405405405406,0.10810810810810811,0.8918918918918919,37,550,300,250,0.5454545454545454,8,3,5,375.34967953087465,0.47169044044044045,0.07449481974196792,0.19287506623140688,126131.01912133492,2352.5865410672723,128483.60566240219,226,0,38.729729729729726,35,2,16,39.44542862080884,0.5830357142857143,48.87152777777778,1004.5138888888891,28.700396825396833,16
4551,4,1,2,32,0.029411764705882353,0.058823529411764705,0.9411764705882353,34,850,600,250,0.7058823529411765,11,6,5,392.3468290672371,0.46776589423648246,0.1190448017275807,0.20133720505811634,126075.53597847157,3093.0673528211355,129168.6033312927,227,0,42.61764705882353,32,2,17,39.07598902019947,0.5891927083333333,48.926767676767675,1004.2929292929291,31.384154040404034,0
4552,4,1,0,33,0.030303030303030304,0.0,1.0,33,1250,1000,250,0.8,15,10,5,382.97401678587,0.46527777777777773,0.1488875452986389,0.19882214591313338,126551.50183973573,3093.187397969599,129644.68923770533,228,0,44.42424242424242,32,1,18,38.819697159827676,0.5940755208333333,48.45328282828283,1006.1868686868686,31.443339646464644,0
4553,4,1,0,34,0.029411764705882353,0.0,1.0,34,1100,800,300,0.7272727272727273,14,8,6,373.07442713433943,0.46628045157456927,0.14695455114213063,0.1951146973059814,126852.04790249429,2665.051020408164,129517.09892290246,229,0,44.088235294117645,34,0,19,38.759060111872714,0.5925245098039216,48.154761904761905,1007.3809523809521,29.62885154061624,0
4554,4,3,2,35,0.08108108108108109,0.05405405405405406,0.9459459459459459,37,1300,800,500,0.6153846153846154,18,8,10,344.1424442496981,0.4692192192192192,0.1296345386849176,0.18335190081996994,127603.50722343972,1382.9833315113306,128986.49055495106,230,0,41.432432432432435,36,1,16,38.7172128102244,0.5960648148148149,47.40990990990991,1010.3603603603609,28.06556556556558,0
4555,4,2,1,36,0.05405405405405406,0.02702702702702703,0.972972972972973,37,800,400,400,0.5,12,4,8,346.08455783058633,0.46765515515515516,0.1417594064652885,0.18490803518377041,127717.31190650113,1440.1978836945063,129157.50979019563,231,0,42.37837837837838,36,1,18,38.55164698455139,0.5972222222222222,47.2972972972973,1010.8108108108111,28.078078078078086,0
4556,4,3,3,36,0.07692307692307693,0.07692307692307693,0.9230769230769231,39,1250,900,350,0.72,16,9,7,335.45765175722573,0.46558704453441296,0.15592118221134776,0.18228307320352957,128394.44739006233,814.8933040566149,129209.34069411895,232,0,41.07692307692308,37,2,14,38.12874157019728,0.6021959459459459,46.62828947368421,1013.4868421052632,27.39153627311522,0
4557,4,2,1,37,0.05263157894736842,0.02631578947368421,0.9736842105263158,38,1250,800,450,0.64,17,8,9,332.00608176635,0.46713489805595065,0.14524061235098573,0.18186667494204167,128715.2666813776,946.8502708790181,129662.11695225662,233,0,41.73684210526316,36,2,15,37.8893389560907,0.607349537037037,46.31193693693695,1014.7522522522545,28.187562562562626,0
4558,4,0,1,36,0.0,0.02702702702702703,0.972972972972973,37,1350,1000,350,0.7407407407407407,17,10,7,338.08903732771785,0.46552802802802806,0.15014740893335143,0.1847264540611048,128613.70991941026,1296.5770747599618,129910.28699417022,234,1,43.86486486486486,35,2,16,37.83850600943254,0.6083333333333334,46.412037037037045,1014.3518518518528,28.981481481481506,0
4559,4,0,4,32,0.0,0.1111111111111111,0.8888888888888888,36,1250,900,350,0.72,16,9,7,345.0180795776805,0.4643353174603175,0.13537510756473448,0.18871913184602054,128657.32001133813,1677.8202947846125,130335.14030612275,235,2,43.19444444444444,34,2,16,37.61832120785417,0.610906862745098,46.369047619047635,1014.5238095238117,29.838935574229755,0
4560,4,0,2,30,0.0,0.0625,0.9375,32,1200,800,400,0.6666666666666666,16,8,8,381.54931661251425,0.4612945228494623,0.13364772288691595,0.20552895620437103,128045.67337036136,3371.147833930123,131416.82120429148,236,3,45.875,31,1,20,37.31841524079076,0.6118951612903225,46.97265625,1012.1093750000002,32.64868951612904,0
4561,4,0,0,30,0.0,0.0,1.0,30,850,800,50,0.9411764705882353,9,8,1,418.99906697829476,0.4599616858237548,0.08614791056570437,0.20453657653515,123995.08342978402,4551.935812867729,128547.01924265175,237,4,46.96666666666667,29,1,18,40.574158648259186,0.5757902298850575,51.00694444444445,995.9722222222229,34.34386973180079,16
4562,4,4,2,32,0.11764705882352941,0.058823529411764705,0.9411764705882353,34,1150,700,450,0.6086956521739131,16,7,9,388.2252169156436,0.4640708556149733,0.11054996885289681,0.19589073922232117,125379.07483930227,2939.1194536909693,128318.19429299324,238,0,42.3235294117647,32,2,14,39.90087619768029,0.58203125,49.62121212121213,1001.5151515151528,31.297348484848523,0
4563,4,2,0,34,0.058823529411764705,0.0,1.0,34,1000,600,400,0.6,14,6,8,391.9401834750469,0.46319815805109926,0.13837411616629014,0.19974116470232547,125790.38690248471,3060.461464391422,128850.84836687613,239,0,43.26470588235294,32,2,16,39.38142437591777,0.5862630208333333,49.2108585858586,1003.1565656565679,31.348642676767746,0
4564,4,3,3,34,0.08108108108108109,0.08108108108108109,0.9189189189189189,37,1250,900,350,0.72,16,9,7,371.50774493581184,0.4657157157157157,0.13493389382764187,0.1941523798580546,126822.06809807254,2023.33118145483,128845.39927952738,240,0,40.67567567567568,34,3,17,38.82938383957769,0.592218137254902,48.18452380952381,1007.2619047619046,29.625350140056018,0
4565,4,3,0,37,0.08108108108108109,0.0,1.0,37,1500,1100,400,0.7333333333333333,19,11,8,370.6078736880663,0.46546546546546547,0.16553684742680264,0.19571614009453805,127246.52364775559,2031.9997024545016,129278.52335021009,241,0,41.4054054054054,33,4,20,38.41539637232277,0.598800505050505,47.76348039215686,1008.9460784313718,30.574123588829448,0
4566,4,1,1,37,0.02631578947368421,0.02631578947368421,0.9736842105263158,38,950,600,350,0.631578947368421,13,6,7,365.21190463824485,0.46781650071123754,0.17506340967299838,0.19457334806433033,127602.69451530608,1720.404620181405,129323.09913548749,242,0,41.28947368421053,34,4,16,38.18585287302149,0.6001838235294117,47.410714285714285,1010.3571428571425,29.716386554621838,0
4567,4,1,4,34,0.02631578947368421,0.10526315789473684,0.8947368421052632,38,1550,1000,550,0.6451612903225806,21,10,11,365.65534550877607,0.4656087008060692,0.1788829418178215,0.1961242307728889,127873.46938775505,1751.5235260770887,129624.99291383213,243,0,42.23684210526316,34,4,19,37.897000549278076,0.6029411764705883,47.14285714285714,1011.428571428571,29.747899159663852,0
4568,4,0,0,34,0.0,0.0,1.0,34,900,500,400,0.5555555555555556,13,5,8,374.23839004116064,0.46336527035056446,0.16052498181738062,0.20016879018434033,127761.29548324166,2762.636306244283,130523.93178948594,244,1,45.38235294117647,32,2,19,37.79505432746348,0.6064453125,47.25378787878789,1010.9848484848496,31.59327651515155,0
4569,4,2,0,36,0.05555555555555555,0.0,1.0,36,800,500,300,0.625,11,5,6,358.35505840950356,0.4627314814814815,0.17113369095631503,0.1946826172456989,128385.7160572562,2001.534155328792,130387.25021258499,245,0,43.80555555555556,34,2,17,37.55751008261874,0.6081495098039216,46.63690476190476,1013.4523809523806,29.807422969187666,0
4570,4,0,1,35,0.0,0.027777777777777776,0.9722222222222222,36,1250,900,350,0.72,16,9,7,357.64900016136755,0.46259920634920637,0.16212453209166444,0.19518333327192136,128566.75347222229,1996.3541666666717,130563.10763888896,246,1,44.80555555555556,34,2,18,37.39044097507532,0.6099877450980392,46.458333333333336,1014.1666666666672,29.828431372549034,0
4571,4,2,1,36,0.05405405405405406,0.02702702702702703,0.972972972972973,37,1500,1000,500,0.6666666666666666,20,10,10,350.37624294544446,0.4618993993993994,0.15042091271599434,0.19429955290611023,129201.38888888896,1653.8194444444493,130855.20833333342,247,0,44.027027027027025,35,2,20,36.92793715846993,0.6142857142857143,45.833333333333336,1016.6666666666673,29.047619047619065,0
4572,4,0,3,33,0.0,0.08333333333333333,0.9166666666666666,36,800,500,300,0.625,11,5,6,350.2116417228224,0.4615740740740741,0.14265459559301763,0.19450636174228547,129261.91184807269,1853.805272108862,131115.71712018157,248,1,45.166666666666664,34,2,20,36.87051237024897,0.6170343137254901,45.77380952380953,1016.9047619047628,29.9089635854342,0
4573,4,0,0,33,0.0,0.0,1.0,33,650,400,250,0.6153846153846154,9,4,5,367.954804022926,0.4604245580808081,0.1360999352048582,0.20272797558633002,128944.78242016125,2889.170429037859,131833.95284919912,249,2,48.515151515151516,32,1,20,36.74296577158959,0.6184895833333333,46.08585858585859,1015.656565656566,31.73926767676769,0
4574,4,0,0,33,0.0,0.0,1.0,33,950,500,450,0.5263157894736842,14,5,9,366.9749643293321,0.4594775883838384,0.14157479366226866,0.20284440336005938,129073.05377002346,2873.315860626465,131946.36963064992,250,3,49.515151515151516,32,1,21,36.63694913850232,0.6197916666666667,45.95959595959596,1016.161616161616,31.7550505050505,0
4575,4,0,0,33,0.0,0.0,1.0,33,750,400,350,0.5333333333333333,11,4,7,366.9749643293321,0.4594775883838384,0.14157479366226866,0.20284440336005938,129073.05377002346,2873.315860626465,131946.36963064992,251,4,50.515151515151516,32,1,21,36.63694913850232,0.6197916666666667,45.95959595959596,1016.161616161616,31.7550505050505,0
4576,4,0,1,32,0.0,0.030303030303030304,0.9696969696969697,33,1150,800,350,0.6956521739130435,15,8,7,368.11954034374514,0.4586095328282828,0.13872488701744912,0.2043050763878828,129233.48263251192,2914.674044740329,132148.15667725226,252,5,51.515151515151516,32,1,21,36.444234032865616,0.6214192708333333,45.801767676767675,1016.7929292929288,31.774779040404024,0
4577,4,0,0,32,0.0,0.0,1.0,32,1200,700,500,0.5833333333333334,17,7,10,374.4101962013024,0.45568716397849457,0.13884311404070204,0.20850084553961318,129366.91496107304,3287.258402506504,132654.17336357955,253,6,53.3125,31,1,21,36.148219847263114,0.6253360215053764,45.670572916666664,1017.3177083333326,32.81670026881718,0
4578,4,0,1,31,0.0,0.03125,0.96875,32,950,800,150,0.8421052631578947,11,8,3,372.78071174369785,0.4555821572580645,0.14115276356192452,0.2081181459277672,129466.28146701383,3252.5065104166615,132718.7879774305,254,7,54.3125,31,1,18,36.08836574547935,0.6263440860215054,45.572916666666664,1017.7083333333328,32.8293010752688,0
4579,4,0,1,30,0.0,0.03225806451612903,0.967741935483871,31,1000,700,300,0.7,13,7,6,398.46179794231716,0.4542562724014337,-0.021449518223711994,0.20238495014220603,125651.88937717021,3813.4955512152833,129465.3849283855,255,8,51.12903225806452,31,0,18,39.36147186147185,0.5873655913978495,49.348958333333336,1002.6041666666673,32.34206989247314,16
4580,4,2,0,32,0.0625,0.0,1.0,32,1100,700,400,0.6363636363636364,15,7,8,395.4099264812703,0.4585013440860215,0.10817509441879958,0.1895899104235147,123235.43836805562,3759.8605685763932,126995.29893663201,256,0,50.21875,29,3,18,41.95560567911596,0.5678879310344828,51.770833333333336,992.9166666666672,34.23850574712645,16
4581,4,1,0,33,0.030303030303030304,0.0,1.0,33,1350,1000,350,0.7407407407407407,17,10,7,383.83631331094114,0.45991161616161613,0.10426206698995277,0.18662560079235188,123826.69103725864,2905.8361154468644,126732.5271527055,257,0,49.666666666666664,30,3,21,41.625309475579535,0.5711805555555556,51.1760752688172,995.2956989247313,33.176523297491045,0
4582,4,5,4,34,0.13157894736842105,0.10526315789473684,0.8947368421052632,38,1450,1100,350,0.7586206896551724,18,11,7,332.9063635850065,0.465134542437174,0.07405504954960529,0.1666912554732554,125059.53089569164,732.1553445779948,125791.68624026964,258,0,44.0,34,4,18,41.61583551535348,0.5741421568627452,49.94047619047619,1000.2380952380955,29.41876750700281,0
4583,4,5,2,37,0.1282051282051282,0.05128205128205128,0.9487179487179487,39,1050,600,450,0.5714285714285714,15,6,9,338.4606798495135,0.46325348627980206,0.145380920712334,0.17342861179530566,126014.78273158845,730.2098068844158,126744.99253847287,259,0,43.743589743589745,35,4,16,40.49147454370799,0.5818452380952381,48.98726851851851,1004.0509259259243,28.687169312169264,0
4584,4,2,5,34,0.05128205128205128,0.1282051282051282,0.8717948717948718,39,1200,900,300,0.75,15,9,6,333.872050256383,0.46558704453441296,0.14412116381028306,0.17229226122856087,126305.47417534693,633.9735243055203,126939.44769965245,260,0,42.48717948717949,35,4,16,40.30764248704662,0.5848214285714286,48.69791666666665,1005.208333333331,28.720238095238027,0
4585,4,1,0,35,0.02857142857142857,0.0,1.0,35,1100,700,400,0.6363636363636364,15,7,8,362.10181559273815,0.4673319327731092,0.1449272237196777,0.18524513732060893,125948.76320018337,2121.255165289229,128070.0183654726,261,0,46.05714285714286,32,3,20,39.966194968553474,0.587890625,49.05303030303029,1003.7878787878765,31.36837121212114,0
4586,4,4,2,37,0.10256410256410256,0.05128205128205128,0.9487179487179487,39,1050,800,250,0.7619047619047619,13,8,5,324.77289802609124,0.4706477732793522,0.14664123755032876,0.17085878548329117,127092.0138888886,455.24420339757796,127547.25809228618,262,0,42.23076923076923,35,4,20,39.729683195592294,0.5928571428571429,47.91666666666665,1008.333333333331,28.809523809523743,0
4587,4,0,0,37,0.0,0.0,1.0,37,1300,900,400,0.6923076923076923,17,9,8,342.5067706725257,0.46712337337337334,0.15153935402020036,0.17950498248822047,126937.59799416093,1295.3973531814684,128232.9953473424,263,1,45.486486486486484,33,4,21,39.441074830759256,0.5956439393939394,48.06985294117647,1007.7205882352943,30.536987522281645,0
4588,4,5,5,37,0.11904761904761904,0.11904761904761904,0.8809523809523809,42,1300,700,600,0.5384615384615384,19,7,12,316.74562292244804,0.4702138985675571,0.17531062619768822,0.17223509048794786,128422.23087873207,-258.85340244095084,128163.37747629112,264,0,40.95238095238095,37,5,13,38.57457089283139,0.6024774774774775,46.600877192982466,1013.5964912280714,27.394499762920848,0
4589,4,0,1,36,0.0,0.02702702702702703,0.972972972972973,37,900,300,600,0.3333333333333333,15,3,12,360.4108186954756,0.4645583083083083,0.2080091248172744,0.1922346449523215,127648.68830497876,1801.1936514801887,129449.88195645895,265,1,47.37837837837838,33,4,19,38.259964427197026,0.6029040404040404,47.36519607843137,1010.5392156862738,30.62240047534163,0
4590,4,1,0,37,0.02702702702702703,0.0,1.0,37,1100,500,600,0.45454545454545453,17,5,12,358.5275312897883,0.46499624624624625,0.19850358833409665,0.19230113041906804,127873.46938775494,1769.2318594104083,129642.70124716536,266,0,47.4054054054054,34,3,20,38.07723242310106,0.6029411764705883,47.14285714285713,1011.4285714285702,29.74789915966383,0
4591,4,0,0,37,0.0,0.0,1.0,37,1150,700,450,0.6086956521739131,16,7,9,355.2725606013431,0.46446446446446443,0.19421617911666011,0.19100816265540818,127968.81028163561,1692.7613811728165,129661.57166280843,267,1,48.4054054054054,35,2,20,38.06194234728894,0.6017857142857144,47.0486111111111,1011.805555555554,28.908730158730112,0
4592,4,0,1,36,0.0,0.02702702702702703,0.972972972972973,37,1400,1100,300,0.7857142857142857,17,11,6,389.83461786384794,0.46368243243243246,0.15638122062104975,0.1957556629488352,125178.63520408145,2524.964765998973,127703.59997008042,268,2,49.4054054054054,34,3,19,40.06860179237053,0.5753676470588236,49.82142857142856,1000.7142857142842,29.43277310924365,16
4593,4,2,4,34,0.05263157894736842,0.10526315789473684,0.8947368421052632,38,1100,600,500,0.5454545454545454,16,6,10,376.260605654149,0.46593468468468463,0.1397788162177811,0.19187783261435687,125817.77459469606,1868.0544142115098,127685.82900890757,269,0,46.13157894736842,36,2,18,39.746323942081034,0.5778356481481481,49.18355855855856,1003.2657657657659,27.868493493493496,0
4594,4,1,0,35,0.02857142857142857,0.0,1.0,35,1500,1000,500,0.6666666666666666,20,10,10,393.6426560107145,0.4638305322128851,0.13940958894549516,0.2009442685421278,125859.31492695115,2908.719002306802,128768.03392925794,270,0,47.94285714285714,33,2,21,39.267322097378276,0.5845959595959596,49.1421568627451,1003.4313725490193,30.40701128936422,0
4595,4,3,2,36,0.07894736842105263,0.05263157894736842,0.9473684210526316,38,950,600,350,0.631578947368421,13,6,7,343.14020045888213,0.46608285917496445,0.06363215731636807,0.16933708374055445,124452.35553247141,940.92124499845,125393.27677746986,271,0,45.078947368421055,37,1,13,41.98855311355311,0.5619369369369369,50.54824561403508,997.8070175438586,26.967757230915097,16
4596,4,6,6,36,0.14285714285714285,0.14285714285714285,0.8571428571428572,42,1200,700,500,0.5833333333333334,17,7,10,307.355172220037,0.4707462253193961,0.037669537669537734,0.15561877667140842,125521.37586805575,-409.08272256846,125112.29314548729,272,0,41.57142857142857,39,3,13,41.77927927927929,0.5694444444444444,49.47916666666668,1002.083333333335,25.694444444444485,15
4597,4,2,1,37,0.05263157894736842,0.02631578947368421,0.9736842105263158,38,1050,600,450,0.5714285714285714,15,6,9,353.32392898948063,0.46962422949265054,-0.0034335115405761396,0.1633714652131214,121678.07041589702,998.3547822406726,122676.42519813769,273,0,46.526315789473685,37,1,17,44.62936208046233,0.5332207207207207,53.34429824561403,986.6228070175424,26.66548127074439,16
4598,4,9,5,41,0.1956521739130435,0.10869565217391304,0.8913043478260869,46,1100,800,300,0.7272727272727273,14,8,6,353.7153328741999,0.4774154589371981,0.010493188949955545,0.1755394726499913,124687.69531250015,-67.19098664972555,124620.50432585042,274,0,39.21739130434783,39,7,17,41.48067028229732,0.5608974358974359,50.31250000000001,998.7500000000011,25.60897435897439,16
4599,4,4,4,41,0.08888888888888889,0.08888888888888889,0.9111111111111111,45,1550,1100,450,0.7096774193548387,20,11,9,359.7349834840351,0.47481060606060604,0.050209999634783564,0.18069902004726468,125191.9596053597,7.5761291936418615,125199.53573455334,275,0,40.93333333333333,37,8,21,40.80783663854499,0.5695382882882882,49.80811403508774,1000.767543859652,27.047771455666272,0
4600,4,4,5,40,0.08888888888888889,0.1111111111111111,0.8888888888888888,45,1300,800,500,0.6153846153846154,18,8,10,346.7076282371856,0.47434764309764305,0.08366094356352405,0.17880181212509935,126279.29823133702,-240.71229398707248,126038.58593734994,276,0,40.4,39,6,15,40.0120262894255,0.577190170940171,48.72395833333334,1005.1041666666683,25.771901709401753,0
4601,4,3,3,40,0.06976744186046512,0.06976744186046512,0.9302325581395349,43,1000,600,400,0.6,14,6,8,359.52341968670675,0.47344499815430047,0.08860855842369975,0.18534261332105478,126264.14497730063,478.98343721144266,126743.12841451207,277,0,42.97674418604651,37,6,22,39.70561495381484,0.5805180180180181,48.739035087719294,1005.0438596491222,27.163347558084382,0
4602,4,3,4,39,0.06976744186046512,0.09302325581395349,0.9069767441860466,43,1350,900,450,0.6666666666666666,18,9,9,338.9313621275029,0.47526762643041714,0.09820403023880586,0.17807696648588345,127039.50195312501,11.534288194444912,127051.03624131945,278,0,41.116279069767444,39,4,20,39.42662051388028,0.5849358974358974,47.96875,1008.1250000000001,25.849358974358978,0
4603,4,1,4,36,0.025,0.1,0.9,40,1300,900,400,0.6923076923076923,17,9,8,355.8977524540037,0.4746127136752137,0.0945742065265982,0.18645041504440443,126921.74437951474,1034.2327124421822,127955.97709195693,279,0,43.6,36,4,21,39.12000819549992,0.5891203703703703,48.08558558558559,1007.6576576576584,27.99049049049051,0
4604,4,0,0,36,0.0,0.0,1.0,36,1000,600,400,0.6,14,6,8,373.69664912455113,0.4716600529100529,0.08014017427071507,0.19422765079815277,126598.21342752788,2261.8656286043815,128860.07905613226,280,1,48.22222222222222,33,3,22,39.00491151160904,0.5921717171717171,48.40686274509804,1006.3725490196078,30.496137849079027,0
4605,4,1,0,37,0.02702702702702703,0.0,1.0,37,1300,800,500,0.6153846153846154,18,8,10,368.82001528827413,0.47250375375375375,0.08579045672961816,0.19331649717741406,126942.0085742629,1963.7507086167634,128905.75928287966,281,0,47.891891891891895,34,3,23,38.77362669816892,0.5934436274509804,48.06547619047618,1007.738095238094,29.639355742296885,0
4606,4,1,0,38,0.02631578947368421,0.0,1.0,38,700,300,400,0.42857142857142855,11,3,8,357.81883821696147,0.4722321005215742,0.09536136874386991,0.18936255370807722,127332.20663265295,1512.4610260770858,128844.66765873003,282,0,47.60526315789474,34,4,18,38.6500353857042,0.5974264705882353,47.67857142857142,1009.2857142857133,29.684873949579803,0
4607,4,1,2,37,0.02564102564102564,0.05128205128205128,0.9487179487179487,39,1400,1000,400,0.7142857142857143,18,10,8,367.1512643502257,0.47185672514619886,0.08276741467749926,0.18972261635437035,126361.00788503724,1792.747831073048,128153.75571611029,283,0,47.35897435897436,32,7,18,39.41406086483319,0.5921223958333333,48.64267676767677,1005.4292929292928,31.4196654040404,15
4608,4,0,2,35,0.0,0.05405405405405406,0.9459459459459459,37,1350,900,450,0.6666666666666666,18,9,9,378.4572516030922,0.4710960960960961,-0.000793246076264742,0.18234758486330832,123442.38281250023,2004.962463970542,125447.34527647078,284,1,50.62162162162162,35,2,16,42.16020265548569,0.5553571428571429,51.562500000000014,993.7500000000018,28.392857142857196,16
4609,4,4,4,35,0.10256410256410256,0.10256410256410256,0.8974358974358975,39,850,500,350,0.5882352941176471,12,5,7,359.28262697843894,0.47466824111560957,0.05364117597740292,0.17831436030619913,124690.5071245233,1161.996730683398,125852.5038552067,285,0,47.30769230769231,36,3,15,41.338745442928534,0.5662615740740741,50.30968468468469,998.7612612612623,27.743368368368397,0
4610,4,4,4,35,0.10256410256410256,0.10256410256410256,0.8974358974358975,39,1000,800,200,0.8,12,8,4,346.16947734515855,0.4728688708951867,0.12104492926710275,0.1760882113347506,125713.73523584165,904.035222755491,126617.77045859715,286,0,47.64102564102564,37,2,18,40.60837160142867,0.5748873873873874,49.287280701754376,1002.8508771929813,27.10407776197247,0
4611,4,3,1,37,0.07894736842105263,0.02631578947368421,0.9736842105263158,38,1100,700,400,0.6363636363636364,15,7,8,375.7085844219005,0.4767810573731626,0.1235246559316947,0.18188528822182493,123643.74524444883,1738.5223093780878,125382.26755382691,287,0,45.23684210526316,35,3,17,42.01833372124596,0.5574404761904762,51.35995370370371,994.5601851851859,28.416005291005312,16
4612,4,8,3,42,0.17777777777777778,0.06666666666666667,0.9333333333333333,45,1350,1100,250,0.8148148148148148,16,11,5,350.3420864346944,0.47984006734006734,0.19758189800742954,0.17842499448454258,125763.35700475915,-173.16482937452096,125590.19217538463,288,0,39.0,40,5,18,40.45254981425193,0.5703125,49.237804878048784,1003.0487804878055,25.076219512195138,0
4613,4,1,3,40,0.023255813953488372,0.06976744186046512,0.9302325581395349,43,1250,800,450,0.64,17,8,9,365.3670551944813,0.4799049464747139,0.2154866971590541,0.18577113651437704,125695.40895061722,584.9922839506055,126280.40123456782,289,0,41.7906976744186,38,5,19,40.146006463527236,0.5729166666666667,49.30555555555555,1002.7777777777771,26.38888888888887,0
4614,4,2,2,40,0.047619047619047616,0.047619047619047616,0.9523809523809523,42,1450,900,550,0.6206896551724138,20,9,11,363.8596273522718,0.4800982384823848,0.23822210944768685,0.18793850477002658,126342.87308673467,796.1431563366049,127139.01624307128,290,0,43.095238095238095,34,8,17,39.51549240181566,0.5873161764705883,48.660714285714285,1005.3571428571427,29.569327731092432,0
4615,4,5,7,38,0.1111111111111111,0.15555555555555556,0.8444444444444444,45,1300,1000,300,0.7692307692307693,16,10,6,330.24352273823325,0.483270202020202,0.2268036265432103,0.17612987879372416,127645.42936288068,-569.1847491536084,127076.24461372707,291,0,40.37777777777778,37,8,15,39.025426793981474,0.5945945945945945,47.36842105263157,1010.5263157894719,27.311522048364107,0
4616,4,1,1,38,0.02564102564102564,0.02564102564102564,0.9743589743589743,39,1600,1200,400,0.75,20,12,8,377.1413693332716,0.4790260908681961,0.2455647702666448,0.19690900719064927,126783.2759635714,1763.0436610918518,128546.31962466326,292,0,47.07692307692308,33,6,20,38.72748844000974,0.5940656565656566,48.223039215686256,1007.1078431372524,30.51841948900765,0
4617,4,0,1,37,0.0,0.02631578947368421,0.9736842105263158,38,1000,500,500,0.5,15,5,10,379.7762861867192,0.47749229492650547,0.24996319693798585,0.19903762914680595,126937.59799416056,2041.577908736981,128979.17590289755,293,1,48.86842105263158,33,5,20,38.50214337832907,0.5956439393939394,48.06985294117645,1007.7205882352914,30.536987522281557,0
4618,4,2,1,38,0.05128205128205128,0.02564102564102564,0.9743589743589743,39,950,600,350,0.631578947368421,13,6,7,366.79904353416805,0.47753598740440845,0.2383085134176839,0.19534181620773128,127586.77551903107,1559.8353097366312,129146.6108287677,294,0,48.12820512820513,33,6,17,38.16209768720685,0.6022727272727273,47.42647058823529,1010.2941176470583,30.61497326203207,0
4619,4,3,1,40,0.07317073170731707,0.024390243902439025,0.975609756097561,41,900,500,400,0.5555555555555556,13,5,8,351.4514721827327,0.47769308943089434,0.24250938540363132,0.1900782045888812,128206.57920030768,814.111159169564,129020.69035947724,295,0,46.707317073170735,33,8,20,37.91545659890288,0.6085858585858586,46.813725490196084,1012.7450980392165,30.689245395127774,0
4620,4,1,5,36,0.024390243902439025,0.12195121951219512,0.8780487804878049,41,1400,1200,200,0.8571428571428571,16,12,4,342.5148326606343,0.4758892276422764,0.2250632360851994,0.18763473223645571,128717.7154195013,617.5453514739394,129335.26077097523,296,0,47.170731707317074,34,7,18,37.62024870952602,0.6115196078431373,46.30952380952382,1014.7619047619062,29.845938375350183,0
4621,4,0,1,35,0.0,0.027777777777777776,0.9722222222222222,36,1350,1100,250,0.8148148148148148,16,11,5,389.7741754816598,0.4720899470899471,0.2358129472457977,0.2093076872626718,127920.90730537717,2772.0532343638606,130692.96053974103,297,1,53.55555555555556,32,4,20,37.238413213513056,0.6080729166666667,47.095959595959606,1011.616161616163,31.613005050505095,0
4622,4,1,2,34,0.027777777777777776,0.05555555555555555,0.9444444444444444,36,1300,1000,300,0.7692307692307693,16,10,6,397.80154357457025,0.47174272486772484,0.17423157392195732,0.19785063572002343,124779.13805032642,2895.155309407197,127674.29335973362,298,0,54.27777777777778,32,4,19,40.28471081342939,0.5758463541666667,50.22095959595959,999.116161616161,31.22238005050503,16
4623,4,3,3,34,0.08108108108108109,0.08108108108108109,0.9189189189189189,37,1600,1300,300,0.8125,19,13,6,378.32130673593105,0.4742867867867868,0.17631596683965767,0.1920339797482384,125625.78125000001,2105.381944444445,127731.16319444445,299,0,51.7027027027027,34,3,19,39.89332224993071,0.5799632352941176,49.375,1002.5000000000001,29.48529411764706,0
4624,4,6,4,36,0.15,0.1,0.9,40,1000,700,300,0.7,13,7,6,348.7866244320656,0.474372329059829,0.16517536216098505,0.18163414627968202,126677.74128818477,837.3947993613369,127515.13608754611,300,0,47.675,37,3,18,39.549862941582255,0.584740990990991,48.32785087719298,1006.6885964912276,27.207799905168315,0
4625,4,1,1,36,0.02702702702702703,0.02702702702702703,0.972972972972973,37,750,600,150,0.8,9,6,3,358.51487866109164,0.47409909909909914,0.11711609441204174,0.1709884984366839,123009.1171196532,1420.1197396720786,124429.23685932528,301,0,52.513513513513516,36,1,18,43.10766450978167,0.548900462962963,51.99887387387386,992.0045045045025,27.555680680680624,16
4626,4,10,7,39,0.21739130434782608,0.15217391304347827,0.8478260869565217,46,1300,1000,300,0.7692307692307693,16,10,6,305.94090017604026,0.4820752818035427,0.1583503872649341,0.1528835761930336,124976.32687851493,-1545.5960457182068,123430.73083279672,302,0,42.91304347826087,43,3,17,42.375876029927085,0.5578972868217054,50.02367424242423,999.9053030303003,23.253611698379075,0
4627,4,7,4,42,0.15217391304347827,0.08695652173913043,0.9130434782608696,46,1600,1200,400,0.75,20,12,8,330.43131950550753,0.4787137681159421,0.24593147892996892,0.1690145076517814,125941.80800325537,-876.9697144779537,125064.83828877742,303,0,43.76086956521739,40,6,15,40.76811447470556,0.5721354166666667,49.0599593495935,1003.7601626016262,25.094004065040657,0
4628,4,2,1,43,0.045454545454545456,0.022727272727272728,0.9772727272727273,44,1300,800,500,0.6153846153846154,18,8,10,336.8582436141281,0.4789904862579281,0.2655049032600052,0.17284820578543128,126072.10884871359,-306.2315461211823,125765.8773025924,304,0,46.56818181818182,36,8,18,40.47268632727815,0.5804398148148149,48.93018018018018,1004.2792792792793,27.896646646646648,0
4629,4,4,3,44,0.0851063829787234,0.06382978723404255,0.9361702127659575,47,1600,1200,400,0.75,20,12,8,313.90677883183815,0.4800339192106075,0.27518271369558356,0.16547146281135558,127172.82267011805,-1407.700098997559,125765.12257112049,305,0,44.212765957446805,38,9,18,39.920956466476,0.5879934210526316,47.836538461538446,1008.6538461538438,26.543522267206416,0
4630,4,2,2,44,0.043478260869565216,0.043478260869565216,0.9565217391304348,46,1750,1300,450,0.7428571428571429,22,13,9,330.95536612668604,0.4787842190016103,0.30294073206663374,0.1755436066413897,127423.91889812243,-765.6740535549507,126658.24484456748,306,0,46.0,37,9,17,39.233999420793495,0.5923423423423424,47.58771929824561,1009.649122807017,27.287814129919376,0
4631,4,1,3,42,0.022222222222222223,0.06666666666666667,0.9333333333333333,45,1850,1400,450,0.7567567567567568,23,14,9,340.9014813406263,0.4773148148148148,0.31475287997027124,0.18136929345346475,127546.62390430963,-303.83339420503034,127242.79051010459,307,0,47.68888888888889,36,9,18,38.85730211817166,0.5954861111111112,47.46621621621621,1010.1351351351344,28.05930930930929,0
4632,4,3,2,43,0.06666666666666667,0.044444444444444446,0.9555555555555556,45,1550,1200,350,0.7741935483870968,19,12,7,328.2449532077759,0.47914562289562285,0.2012367149758454,0.1670272991986472,125727.80050027047,-654.1488570082331,125073.65164326224,308,0,47.55555555555556,42,3,20,41.04327697262478,0.5669642857142857,49.27325581395349,1002.9069767441865,23.87873754152825,16
4633,4,1,2,42,0.022727272727272728,0.045454545454545456,0.9545454545454546,44,1250,800,450,0.64,17,8,9,331.48689169478183,0.4778563248766737,0.22404728887640646,0.16947390050219902,125922.23743314711,-451.6857836067466,125470.55164954036,309,0,49.38636363636363,42,2,21,40.76177029027484,0.5689484126984127,49.07945736434109,1003.6821705426362,23.897194536729433,0
4634,4,2,2,42,0.045454545454545456,0.045454545454545456,0.9545454545454546,44,1300,800,500,0.6153846153846154,18,8,10,321.8171412406078,0.477393851303735,0.2243756295480437,0.1668163249039476,126488.78173828097,-658.5136359016609,125830.26810237931,310,0,49.34090909090909,39,5,17,40.422426737081906,0.5793269230769231,48.515624999999986,1005.9374999999978,25.793269230769177,0
4635,4,0,2,40,0.0,0.047619047619047616,0.9523809523809523,42,1000,700,300,0.7,13,7,6,333.0789002347684,0.47608159117305454,0.2154334740767283,0.17205636260577956,126346.8101362917,16.691313673407848,126363.5014499651,311,1,50.285714285714285,37,5,18,40.2850865234304,0.5813626126126126,48.65679824561402,1005.3728070175418,27.17223802750113,0
4636,4,2,1,41,0.047619047619047616,0.023809523809523808,0.9761904761904762,42,1000,600,400,0.6,14,6,8,326.0389449913188,0.4762388695315525,0.2342401704611441,0.17073144309900756,126903.55994091969,-124.8994402439933,126778.66050067569,312,0,50.69047619047619,38,4,20,39.890829887251265,0.5852521929824561,48.10363247863248,1007.5854700854699,26.515407107512363,0
4637,4,3,4,40,0.06818181818181818,0.09090909090909091,0.9090909090909091,44,1400,1000,400,0.7142857142857143,18,10,8,310.62075323935903,0.47754800916138124,0.23074436386124697,0.16576691682773745,127670.36132812526,-868.4474147239281,126801.91391340134,313,0,49.25,39,5,17,39.49572253143682,0.5913461538461539,47.343750000000014,1010.625000000002,25.91346153846159,0
4638,4,3,2,41,0.06976744186046512,0.046511627906976744,0.9534883720930233,43,1300,800,500,0.6153846153846154,18,8,10,318.568503571603,0.475406053894426,0.2275330385666683,0.1721432312914288,128171.57594601542,-433.71457009273433,127737.86137592269,294,0,41.72093023255814,38,5,21,38.78367447422101,0.5981359649122807,46.84829059829062,1012.6068376068406,26.647548358074754,0
4639,4,0,0,41,0.0,0.0,1.0,41,1200,900,300,0.75,15,9,6,334.15904424663546,0.4746189024390244,0.2355099802945504,0.17980557913774076,128002.04554216399,354.6082399967787,128356.65378216078,295,1,44.48780487804878,36,5,22,38.56206877364792,0.6001157407407407,47.01576576576578,1011.9369369369385,28.109359359359402,0
4640,4,2,2,41,0.046511627906976744,0.046511627906976744,0.9534883720930233,43,1350,1000,350,0.7407407407407407,17,10,7,320.0338208793649,0.47485234403839055,0.23363593162878882,0.17482169709025852,128604.67916757993,-368.43062860689724,128236.24853897303,296,0,43.372093023255815,38,5,18,38.30555262973104,0.6025219298245614,46.42094017094018,1014.3162393162404,26.692532613585275,0
4641,4,1,3,39,0.023809523809523808,0.07142857142857142,0.9285714285714286,42,1300,1000,300,0.7692307692307693,16,10,6,356.96449560216183,0.4731537940379404,0.19781512605041973,0.18405015154530935,126270.10192202384,626.7879042351155,126896.88982625895,297,0,44.73809523809524,36,6,13,39.763772175536886,0.5824652777777778,48.733108108108134,1005.0675675675714,27.91854354354365,16
4642,4,5,3,41,0.11363636363636363,0.06818181818181818,0.9318181818181819,44,1200,800,400,0.6666666666666666,16,8,8,356.241403166404,0.47463002114164904,0.2559000028850864,0.18929454660663425,127496.31461620677,283.89320348458125,127780.20781969135,298,0,43.40909090909091,38,6,16,38.521501110758486,0.591282894736842,47.51602564102566,1009.9358974359001,26.577260458839476,0
4643,4,2,4,39,0.046511627906976744,0.09302325581395349,0.9069767441860466,43,1250,1000,250,0.8,15,10,5,368.1030362533371,0.4728451458102621,0.28180990131985606,0.19645661176300006,127673.1316967722,799.3734851108136,128472.50518188301,299,0,45.325581395348834,37,6,18,38.04055459115402,0.5948761261261262,47.34100877192983,1010.6359649122816,27.314485538169773,0
4644,4,2,1,40,0.04878048780487805,0.024390243902439025,0.975609756097561,41,1250,1100,150,0.88,14,11,3,372.18364496240645,0.4739329268292683,0.28268568988470544,0.19966315981132385,127880.99500868039,1319.0429687499814,129200.03797743037,300,0,46.926829268292686,35,6,20,37.72421043597664,0.6008928571428571,47.13541666666666,1011.458333333332,28.898809523809486,0
4645,4,0,0,40,0.0,0.0,1.0,40,1450,900,550,0.6206896551724138,20,9,11,382.1299076304476,0.4722355769230769,0.29298446876103146,0.2054220167584548,127963.79145408151,1779.758361677995,129743.5498157595,301,1,48.925,34,6,20,37.38773189002629,0.6038602941176471,47.05357142857142,1011.7857142857133,29.75840336134451,0
4646,4,1,2,39,0.024390243902439025,0.04878048780487805,0.9512195121951219,41,1550,1100,450,0.7096774193548387,20,11,9,374.6921048497876,0.47205284552845533,0.29181343915815794,0.20292730827013222,128261.74554183801,1411.732681755816,129673.47822359383,302,0,48.707317073170735,35,6,21,37.270528641072524,0.6047619047619048,46.75925925925925,1012.9629629629619,28.94179894179891,0
4647,4,0,0,39,0.0,0.0,1.0,39,900,600,300,0.6666666666666666,12,6,6,379.2903826177286,0.46971997300944673,0.27593623481781404,0.2059004934210527,128355.55555555562,1936.8055555555663,130292.36111111118,163,1,44.0,34,5,21,37.05797697368421,0.607843137254902,46.66666666666667,1013.3333333333339,29.80392156862747,0
4648,4,1,3,37,0.025,0.075,0.925,40,950,500,450,0.5263157894736842,14,5,9,372.1731218184177,0.4691239316239317,0.2724669100867181,0.20334945384143477,128613.70991941019,1573.31318587106,130187.02310528125,164,0,43.875,35,5,20,36.97417465388711,0.6083333333333334,46.41203703703704,1014.3518518518522,28.98148148148149,0
4649,4,0,1,36,0.0,0.02702702702702703,0.972972972972973,37,1250,900,350,0.72,16,9,7,399.2239269278313,0.46759259259259256,0.12615520754787535,0.2044196187822909,125985.7320066015,2659.3037337105598,128645.03574031206,165,1,46.83783783783784,35,2,19,38.99633002843747,0.581547619047619,49.0162037037037,1003.935185185185,28.68386243386243,16
4650,4,0,0,36,0.0,0.0,1.0,36,1500,1100,400,0.7333333333333333,19,11,8,405.504347778101,0.46665013227513225,0.14582098984871839,0.20853450279703814,126163.40880102043,3031.962159863948,129195.37096088438,166,2,49.0,34,2,19,38.65460955089466,0.5854779411764706,48.839285714285715,1004.6428571428573,29.548319327731097,0
4651,4,3,1,38,0.07692307692307693,0.02564102564102564,0.9743589743589743,39,950,800,150,0.8421052631578947,11,8,3,380.4992179368932,0.4686797121007647,0.1450629167712958,0.19936076470011646,126926.22369382868,1859.0657702369774,128785.28946406566,167,0,46.15384615384615,37,2,20,38.495647442872695,0.5872747747747749,48.081140350877185,1007.6754385964897,27.23447131341864,0
4652,4,1,0,39,0.02564102564102564,0.0,1.0,39,850,600,250,0.7058823529411765,11,6,5,377.3867102075518,0.467442645074224,0.16884225050380297,0.19912671122657513,127212.08191609995,1801.9544377076988,129014.03635380765,168,0,46.92307692307692,34,5,21,38.27983636220595,0.5962009803921569,47.79761904761906,1008.8095238095253,29.67086834733898,0
4653,4,0,1,38,0.0,0.02564102564102564,0.9743589743589743,39,1150,600,550,0.5217391304347826,17,6,11,376.19240841738895,0.46730206927575346,0.16903495541266467,0.1991969638013389,127354.7363281251,1781.9769965277922,129136.7133246529,169,1,47.92307692307692,35,4,15,38.16326969384245,0.5955357142857143,47.65625000000001,1009.3750000000008,28.839285714285737,0
4654,4,0,0,38,0.0,0.0,1.0,38,1250,700,550,0.56,18,7,11,377.7178951722228,0.46655701754385964,0.16740076144735383,0.20029381152506368,127413.15593117707,2025.2458151148755,129438.40174629194,170,2,49.421052631578945,35,3,15,38.06471875119417,0.5961309523809524,47.598379629629626,1009.606481481481,28.845899470899457,0
4655,4,1,3,36,0.02564102564102564,0.07692307692307693,0.9230769230769231,39,1450,1100,350,0.7586206896551724,18,11,7,362.127834854318,0.46693657219973006,0.16494327219352312,0.19389062785670388,127802.69870799866,1456.1829143332682,129258.88162233193,171,0,49.12820512820513,36,3,16,38.05871106656272,0.5980902777777778,47.212837837837846,1011.1486486486496,28.087462462462486,0
4656,4,0,2,34,0.0,0.05555555555555555,0.9444444444444444,36,1200,700,500,0.5833333333333334,17,7,10,387.24827391127263,0.46498015873015874,0.14221051485202407,0.19390922770943603,125061.28201893506,2667.1636792150784,127728.44569815014,172,1,53.666666666666664,33,3,18,40.255145797598615,0.5763888888888888,49.93872549019608,1000.2450980392159,30.310457516339877,15
4657,4,4,2,36,0.10526315789473684,0.05263157894736842,0.9473684210526316,38,1100,700,400,0.6363636363636364,15,7,8,365.37208171157346,0.46937233285917496,0.17746349288730534,0.18825522270173697,126241.8076860646,1625.0464146579156,127866.85410072251,173,0,49.78947368421053,36,2,20,39.58169916330493,0.5821759259259259,48.76126126126127,1004.9549549549562,27.91541541541545,0
4658,4,1,1,36,0.02702702702702703,0.02702702702702703,0.972972972972973,37,1200,1000,200,0.8333333333333334,14,10,4,363.15609664822875,0.4675613113113113,0.19836966388690547,0.1881502468249408,126468.25034493954,1785.5432290398535,128253.7935739794,174,0,51.75675675675676,36,1,15,39.403968875951655,0.5844907407407407,48.53603603603604,1005.8558558558559,27.94044044044044,0
4659,4,0,0,36,0.0,0.0,1.0,36,850,700,150,0.8235294117647058,10,7,3,367.39268246015513,0.4656415343915344,0.1969769643017023,0.1898596212094805,126363.65265185607,2085.0162626457363,128448.6689145018,175,1,54.166666666666664,35,1,15,39.40526553086986,0.5854166666666667,48.64004629629629,1005.4398148148143,28.726851851851837,0
4660,4,2,1,37,0.05263157894736842,0.02631578947368421,0.9736842105263158,38,900,600,300,0.6666666666666666,12,6,6,364.92585386088376,0.4654160739687056,0.23378113181638738,0.19237552605537347,127174.94956380798,1681.8854118574823,128856.83497566546,176,0,52.26315789473684,37,1,17,38.63225622350256,0.5898085585585586,47.8344298245614,1008.6622807017535,27.261142721669014,0
4661,4,2,1,38,0.05128205128205128,0.02564102564102564,0.9743589743589743,39,1150,600,550,0.5217391304347826,17,6,11,360.5522407744645,0.4653621232568601,0.23237484608332948,0.19171321058952678,127523.29082657603,1395.7616516911376,128919.05247826717,177,0,51.64102564102564,38,1,14,38.38498695437558,0.5915570175438596,47.48931623931624,1010.0427350427346,26.580071974808806,0
4662,4,0,2,36,0.0,0.05263157894736842,0.9473684210526316,38,1400,900,500,0.6428571428571429,19,9,10,366.9109148477916,0.4649419155998103,0.23177269376067988,0.1947482775120065,127451.59718615342,1752.676424476755,129204.27361063017,178,1,54.0,37,1,15,38.29801914793499,0.5926238738738738,47.560307017543856,1009.7587719298244,27.290777619724985,0
4663,4,0,0,36,0.0,0.0,1.0,36,900,500,400,0.5555555555555556,13,5,8,375.8832872602554,0.46271494708994704,0.24486268668118116,0.19989844289581016,127530.03532503842,2387.281780478373,129917.31710551679,179,2,56.77777777777778,35,1,18,37.99093331041593,0.5973214285714286,47.48263888888888,1010.0694444444432,28.85912698412695,0
4664,4,0,0,36,0.0,0.0,1.0,36,1200,900,300,0.75,15,9,6,375.56521945389886,0.46238425925925924,0.2409347685026153,0.20060006492299057,127705.45488522363,2392.3454378857887,130097.80032310942,180,3,57.77777777777778,35,1,18,37.81883373411199,0.5991071428571428,47.30902777777777,1010.7638888888878,28.87896825396822,0
4665,4,4,2,38,0.1,0.05,0.95,40,1200,1000,200,0.8333333333333334,14,10,4,360.2309280982724,0.46310096153846153,0.27218955658647137,0.19934211776375407,129117.7949585447,1303.951663278841,130421.74662182355,181,0,52.9,37,3,17,36.762663178336375,0.6095157657657657,45.91557017543858,1016.3377192982437,27.468587008060638,0
4666,4,2,1,39,0.05,0.025,0.975,40,1450,1200,250,0.8275862068965517,17,12,5,360.6311534830537,0.4635416666666667,0.2633001705514497,0.20163706261178987,129525.18332315232,1342.2173565720714,130867.4006797244,182,0,50.475,35,5,14,36.337526056471475,0.6175595238095238,45.51504629629629,1017.939814814814,29.083994708994684,0
4667,4,0,0,39,0.0,0.0,1.0,39,1350,1000,350,0.7407407407407407,17,10,7,373.7467173160069,0.46201641925326137,0.2713820967572673,0.2091269799943763,129554.63927469129,1884.1242283950544,131438.76350308635,183,1,52.76923076923077,35,4,15,35.9737380627558,0.6178571428571429,45.48611111111111,1018.0555555555551,29.087301587301575,0
4668,4,3,3,39,0.07142857142857142,0.07142857142857142,0.9285714285714286,42,1300,700,600,0.5384615384615384,19,7,12,352.9635734037551,0.4612490321331785,0.27428193499622,0.20215186476760555,130463.8422205992,813.6548147246531,131277.49703532385,184,0,49.92857142857143,36,6,20,35.579714138741906,0.625,44.594594594594604,1021.6216216216234,28.37837837837843,0
4669,4,0,2,37,0.0,0.05128205128205128,0.9487179487179487,39,1800,1100,700,0.6111111111111112,25,11,14,370.3012614282433,0.4603857399910032,0.25959769372296404,0.21166602968058854,130387.71896626301,1856.5473615917003,132244.2663278547,185,1,48.92307692307692,33,6,21,35.214182865370766,0.6306818181818181,44.669117647058826,1021.3235294117651,30.949197860962578,0
4670,4,0,1,36,0.0,0.02702702702702703,0.972972972972973,37,1250,700,550,0.56,18,7,11,373.1410747441445,0.45830205205205204,0.24698688556343318,0.21402060367855158,130520.50053884815,2340.511969441903,132861.01250829006,186,2,48.189189189189186,32,5,18,35.006847481362485,0.6344401041666667,44.53914141414142,1021.843434343435,31.932607323232343,0
4671,4,0,1,35,0.0,0.027777777777777776,0.9722222222222222,36,1150,600,550,0.5217391304347826,17,6,11,383.13065471273273,0.45719246031746036,0.24173179295503466,0.21979600717730452,130528.56445312497,2801.8988715277774,133330.46332465275,187,3,49.333333333333336,31,5,18,34.74345905538568,0.6370967741935484,44.53125,1021.8749999999998,32.963709677419345,0
4672,4,0,1,34,0.0,0.02857142857142857,0.9714285714285714,35,1300,1200,100,0.9230769230769231,14,12,2,385.80672694065555,0.45535714285714285,0.22219715850175548,0.22228468280740787,130694.93823581275,3084.597269694015,133779.53550550676,188,4,48.457142857142856,31,4,19,34.5060539496583,0.6387768817204301,44.368489583333336,1022.526041666667,32.98471102150538,0
4673,4,0,0,34,0.0,0.0,1.0,34,1400,1100,300,0.7857142857142857,17,11,6,394.3753250146634,0.4542483660130719,0.22892143973024393,0.2269000546188752,130640.18419759511,3504.2530205804132,134144.43721817553,189,5,50.76470588235294,30,4,19,34.34267902533087,0.6409722222222223,44.42204301075269,1022.3118279569894,34.077060931899645,0
4674,4,0,2,32,0.0,0.058823529411764705,0.9411764705882353,34,700,400,300,0.5714285714285714,10,4,6,393.34623764454625,0.45434120617944146,0.22859363279951195,0.22650907114020155,130674.53833174353,3480.0676017458704,134154.6059334894,190,6,51.76470588235294,30,4,19,34.334056351605994,0.6413194444444444,44.388440860215056,1022.4462365591396,34.08154121863799,0
4675,4,0,0,32,0.0,0.0,1.0,32,1100,700,400,0.6363636363636364,15,7,8,403.3175944015242,0.452116935483871,0.20858663904360775,0.23212047008519301,130652.78018904314,4138.913001543194,134791.69319058635,191,7,50.5625,29,3,19,34.101316623647136,0.6440373563218391,44.409722222222214,1022.3611111111106,35.253831417624504,0
4676,4,0,0,32,0.0,0.0,1.0,32,850,600,250,0.7058823529411765,11,6,5,401.17136521342417,0.45091985887096775,0.20673859934853467,0.23237662098211542,130901.38888888883,4102.777777777773,135004.1666666666,192,8,51.5625,29,3,20,33.90336590662324,0.646551724137931,44.166666666666664,1023.3333333333328,35.28735632183906,0
4677,4,0,0,32,0.0,0.0,1.0,32,900,500,400,0.5555555555555556,13,5,8,435.42638728672034,0.45094086021505375,0.16480809128630702,0.22327182837467988,126043.83680555549,4754.3402777777665,130798.17708333326,193,9,52.5625,30,2,16,38.02731673582296,0.5940972222222223,48.95833333333333,1004.1666666666661,33.4722222222222,16
4678,4,4,1,35,0.1111111111111111,0.027777777777777776,0.9722222222222222,36,600,400,200,0.6666666666666666,8,4,4,406.04809783571335,0.45522486772486775,0.20313195034170461,0.2160784035158027,127555.82475790555,3163.100279940399,130718.92503784594,194,0,47.611111111111114,33,3,17,37.20265174491488,0.6019570707070707,47.45710784313725,1010.1715686274504,30.611259655377285,0
4679,4,0,0,35,0.0,0.0,1.0,35,950,600,350,0.631578947368421,13,6,7,409.53933814087236,0.45570728291316526,0.19525367942700078,0.19838116702968414,123668.92708672394,3275.4769184093157,126944.40400513326,195,1,48.05714285714286,31,4,15,41.15081053366496,0.5668682795698925,51.33463541666665,994.6614583333314,32.08585349462359,16
4680,4,5,4,36,0.125,0.1,0.9,40,850,600,250,0.7058823529411765,11,6,5,366.3859733061993,0.46698717948717944,0.21475975261655678,0.18424481241378668,125238.20861677958,1191.354605400054,126429.56322217963,196,0,42.925,34,6,18,40.593531953694914,0.5759803921568627,49.76190476190474,1000.9523809523771,29.439775910364034,0
4681,4,3,0,39,0.07692307692307693,0.0,1.0,39,1100,600,500,0.5454545454545454,16,6,10,358.3044872475524,0.46679599640125957,0.2326125487415811,0.1842466202197131,126160.08659122088,1240.7450274348475,127400.83161865573,197,0,42.333333333333336,35,4,21,39.84350998463903,0.5833333333333333,48.842592592592595,1004.6296296296299,28.703703703703713,0
4682,4,1,0,40,0.025,0.0,1.0,40,1200,900,300,0.75,15,9,6,347.7124972098484,0.4692040598290598,0.2247424988804294,0.18014895737113518,126468.25034493975,794.918229039869,127263.16857397962,198,0,42.25,36,4,18,39.79231974921629,0.5844907407407407,48.536036036036045,1005.8558558558576,27.94044044044049,0
4683,4,2,2,40,0.047619047619047616,0.047619047619047616,0.9523809523809523,42,1100,800,300,0.7272727272727273,14,8,6,334.4150601930252,0.4694033101045296,0.22435674153049345,0.17534948653700974,126957.38965821086,91.2926208999811,127048.68227911084,199,0,41.19047619047619,38,4,20,39.624633379271344,0.5858004385964912,48.05021367521367,1007.7991452991445,26.52103013945117,0
4684,4,2,3,39,0.047619047619047616,0.07142857142857142,0.9285714285714286,42,1200,800,400,0.6666666666666666,16,8,8,328.0850712126522,0.47002032520325204,0.21659815005138716,0.17421685916303312,127469.34125940542,-35.84241909561763,127433.49884030981,200,0,40.714285714285715,38,4,17,39.25998906756947,0.5910087719298245,47.542735042735046,1009.8290598290604,26.57444894287001,0
4685,4,1,0,40,0.025,0.0,1.0,40,800,700,100,0.875,9,7,2,342.6705266717037,0.4672142094017094,0.22677914110429498,0.18167009293978875,127404.47108848735,731.5514416443742,128136.02253013173,201,0,43.075,36,4,19,38.95821714073249,0.5940393518518519,47.606981981981995,1009.5720720720738,28.043668668668715,0
4686,4,3,2,41,0.06976744186046512,0.046511627906976744,0.9534883720930233,43,1150,800,350,0.6956521739130435,15,8,7,321.17248471859875,0.46943060169804357,0.22100577114828712,0.17367383307148593,128200.04712988617,-360.84808347502576,127839.19904641114,202,0,41.0,37,6,22,38.68873610509601,0.6002252252252251,46.82017543859649,1012.7192982456144,27.370791844476063,0
4687,4,1,4,38,0.023809523809523808,0.09523809523809523,0.9047619047619048,42,1450,1100,350,0.7586206896551724,18,11,7,325.3505047268065,0.46843544328300424,0.22512055455093405,0.1760458210508063,128225.67389875086,-56.34245562129911,128169.33144312956,203,0,42.76190476190476,38,4,23,38.55683016877636,0.5986842105263157,46.794871794871796,1012.8205128205132,26.653171390013505,0
4688,4,3,3,38,0.07317073170731707,0.07317073170731707,0.926829268292683,41,1100,700,400,0.6363636363636364,15,7,8,318.6121142554987,0.46646341463414637,0.1918250701614288,0.17463915022002188,128740.17373666794,3.635788771983755,128743.80952543992,204,0,37.90243902439025,38,3,21,38.20380215461277,0.6038925438596492,46.28739316239315,1014.8504273504259,26.70659019343226,0
4689,4,0,0,38,0.0,0.0,1.0,38,1100,700,400,0.6363636363636364,15,7,8,341.1079443091761,0.4636676149834045,0.20084051801883152,0.18500984786137045,128320.37278163547,1154.2197145061373,129474.5924961416,205,1,41.8421052631579,35,3,23,38.06117203564085,0.6053571428571429,46.70138888888887,1013.1944444444416,28.948412698412618,0
4690,4,1,0,39,0.02564102564102564,0.0,1.0,39,1050,600,450,0.5714285714285714,15,6,9,333.63422809284543,0.46446243814664867,0.2019294800648852,0.18262724150161194,128686.69979100706,786.8575501176631,129473.55734112473,206,0,41.743589743589745,36,3,22,37.87712726600073,0.6070601851851851,46.34009009009008,1014.6396396396384,28.1844344344344,0
4691,4,1,2,38,0.025,0.05,0.95,40,1500,1100,400,0.7333333333333333,19,11,8,354.05757163668466,0.46315438034188033,0.07357423287529663,0.18614466245906974,127065.75656467021,1310.3074126966956,128376.06397736691,207,0,41.675,39,1,15,39.01842907325135,0.5852029914529915,47.942708333333336,1008.2291666666673,25.852029914529933,16
4692,4,1,4,35,0.02564102564102564,0.10256410256410256,0.8974358974358975,39,1450,900,550,0.6206896551724138,20,9,11,360.3823004329943,0.4621007647323437,0.09867745083729051,0.19025722036412462,127233.99233270429,1370.5811953740051,128604.5735280783,208,0,43.51282051282051,36,3,19,38.686190795103634,0.5923032407407407,47.7759009009009,1008.8963963963961,28.024899899899893,0
4693,4,2,0,37,0.05405405405405406,0.0,1.0,37,1250,800,450,0.64,17,8,9,385.9260294996867,0.4625563063063063,0.1723957609336011,0.1938174635236433,125183.89111159163,2502.5085614406535,127686.39967303228,209,0,45.21621621621622,33,4,17,40.16093150461263,0.5776515151515151,49.81617647058823,1000.7352941176465,30.325311942958987,16
4694,4,0,1,36,0.0,0.02702702702702703,0.972972972972973,37,1050,300,750,0.2857142857142857,18,3,15,388.8257577118867,0.46224349349349353,0.18126496540593506,0.19614099333466267,125367.91738754313,2349.255094194527,127717.17248173765,210,1,46.21621621621622,33,4,17,39.89741393375755,0.5795454545454546,49.632352941176464,1001.4705882352931,30.34759358288767,0
4695,4,2,0,38,0.05263157894736842,0.0,1.0,38,1150,700,450,0.6086956521739131,16,7,9,376.83863623251426,0.46165244191559984,0.1947305987388397,0.1925302850569754,125894.4515306122,1888.3786848072493,127782.83021541945,211,0,45.89473684210526,34,4,19,39.652530644523516,0.5827205882352942,49.107142857142854,1003.5714285714282,29.516806722689065,0
4696,4,4,5,37,0.09523809523809523,0.11904761904761904,0.8809523809523809,42,1050,600,450,0.5714285714285714,15,6,9,347.40607678525134,0.4648664343786295,0.1965112346221216,0.18216128528711928,126957.38965821087,421.15373201109105,127378.54339022197,212,0,42.42857142857143,38,4,20,39.29732499381602,0.5858004385964912,48.05021367521367,1007.7991452991446,26.521030139451174,0
4697,4,0,0,37,0.0,0.0,1.0,37,1000,700,300,0.7,13,7,6,381.32924895895707,0.4622747747747748,0.19485550884868252,0.19700410317753717,126351.67363514064,2236.317762399113,128587.99139753975,213,1,45.13513513513514,33,4,20,39.06732488217129,0.5896464646464646,48.651960784313744,1005.3921568627477,30.46642899584084,0
4698,4,0,0,37,0.0,0.0,1.0,37,1300,600,700,0.46153846153846156,20,6,14,385.30490664754313,0.46265015015015015,0.17695763053719027,0.19062707083576208,124558.47139322528,2243.0070398111106,126801.47843303639,214,2,46.13513513513514,32,5,19,40.826323889029425,0.5735677083333333,50.4419191919192,998.232323232324,31.194760101010125,14
4699,4,5,0,42,0.11904761904761904,0.0,1.0,42,1250,1000,250,0.8,15,10,5,339.8383841739409,0.4664755129694154,0.19928914505283446,0.17413455302474504,126014.78273158851,166.49436968413238,126181.27710127264,215,0,41.523809523809526,35,7,20,40.456892411143144,0.5818452380952381,48.98726851851851,1004.0509259259247,28.687169312169278,0
4700,4,3,7,38,0.06666666666666667,0.15555555555555556,0.8444444444444444,45,1200,800,400,0.6666666666666666,16,8,8,317.5006646627484,0.46976010101010096,0.19881676330552023,0.16593105689802595,126822.83676674686,-946.7330064285375,125876.10376031832,216,0,39.68888888888889,38,7,15,40.18857834818272,0.5844298245614035,48.183760683760674,1007.2649572649559,26.506972559604105,0
4701,4,3,1,40,0.07317073170731707,0.024390243902439025,0.975609756097561,41,1250,700,550,0.56,18,7,11,342.0420335020541,0.4654979674796748,0.2241142866758088,0.17802151797530646,126654.74597318696,464.2493730710144,127118.99534625797,217,0,43.829268292682926,35,6,19,39.743230424284235,0.5883928571428572,48.35069444444446,1006.5972222222241,28.75992063492069,0
4702,4,4,1,43,0.09090909090909091,0.022727272727272728,0.9772727272727273,44,1500,900,600,0.6,21,9,12,323.6891405260092,0.46516032417195213,0.2470298885961535,0.17227891690734404,127562.34039560263,-541.1376143246923,127021.20278127794,218,0,41.75,37,7,18,39.27590994609068,0.59375,47.45065789473685,1010.1973684210537,27.3026315789474,0
4703,4,1,3,41,0.022727272727272728,0.06818181818181818,0.9318181818181819,44,1350,1000,350,0.7407407407407407,17,10,7,328.43575131640677,0.46466481677237487,0.1023611831863005,0.16787684158798816,125913.11984592002,-529.1259765625066,125383.99386935752,219,0,42.72727272727273,39,5,14,40.847712333506344,0.5734508547008548,49.088541666666664,1003.6458333333323,25.73450854700852,16
4704,4,1,4,38,0.023809523809523808,0.09523809523809523,0.9047619047619048,42,1400,900,500,0.6428571428571429,19,9,10,337.99271661276276,0.46606416957026714,0.10238745416244077,0.17296385246449633,125961.27083573777,114.79842355338394,126076.06925929115,220,0,39.404761904761905,37,5,16,40.55832423083927,0.5774211711711712,49.04057017543859,1003.8377192982443,27.13074917022282,0
4705,4,1,1,38,0.02564102564102564,0.02564102564102564,0.9743589743589743,39,1400,900,500,0.6428571428571429,19,9,10,351.68216773069094,0.4630004498425551,0.14779210490531702,0.18007621740826502,125985.73200660135,1061.3870670438776,127047.11907364523,221,0,43.02564102564103,35,4,17,40.18955114902774,0.581547619047619,49.016203703703695,1003.9351851851839,28.683862433862394,0
4706,4,2,2,38,0.05,0.05,0.95,40,1500,1200,300,0.8,18,12,6,323.410576670975,0.4655448717948718,0.09766332729404237,0.16411906116299435,125615.07100820032,125.04851066552902,125740.11951886585,222,0,42.425,38,2,16,41.28055170698783,0.5720942982456141,49.385683760683776,1002.4572649572675,26.380454340980723,16
4707,4,0,2,36,0.0,0.05263157894736842,0.9473684210526316,38,1150,900,250,0.782608695652174,14,9,5,335.35661348331695,0.4647641062114746,0.09876849913049623,0.1697385180190305,125507.27036157792,817.9386311987791,126325.2089927767,223,1,43.55263157894737,36,2,16,41.09233348317972,0.5746527777777778,49.49324324324325,1002.0270270270281,27.834084084084115,0
4708,4,2,0,38,0.05263157894736842,0.0,1.0,38,1150,900,250,0.782608695652174,14,9,5,332.79496641822385,0.4640084163110479,0.12071471191166827,0.16971209821522382,125817.7745946962,774.3044142115252,126592.07900890772,224,0,43.81578947368421,36,2,19,40.83651363789427,0.5778356481481481,49.183558558558566,1003.2657657657669,27.868493493493524,0
4709,4,4,2,40,0.09523809523809523,0.047619047619047616,0.9523809523809523,42,1500,1100,400,0.7333333333333333,19,11,8,309.04522521838885,0.4695121951219512,0.04693935520522663,0.15733820902116238,125748.98184673818,-417.22580902241793,125331.75603771576,225,0,40.54761904761905,38,4,15,41.50289376509019,0.5734649122807017,49.25213675213675,1002.9914529914524,26.394511920827696,15
4710,4,6,5,41,0.13043478260869565,0.10869565217391304,0.8913043478260869,46,1450,1200,250,0.8275862068965517,17,12,5,299.7686920829862,0.47406400966183576,0.1157713702987011,0.15742017686720366,127018.74441327136,-1584.7514234421121,125433.99298982925,226,0,37.608695652173914,42,4,16,40.434850523887334,0.580109126984127,47.98934108527131,1008.0426356589142,24.00101513473605,0
4711,4,0,2,39,0.0,0.04878048780487805,0.9512195121951219,41,900,500,400,0.5555555555555556,13,5,8,326.09984333032816,0.47040142276422764,0.11577726097923557,0.1693058613277302,126553.94500146084,53.84432756225635,126607.7893290231,227,1,42.65853658536585,38,3,17,40.24784101366177,0.5816885964912281,48.45085470085469,1006.1965811965797,26.47885739990999,0
4712,4,1,0,40,0.025,0.0,1.0,40,1250,1000,250,0.8,15,10,5,319.505089239383,0.4697516025641026,0.12334591129949368,0.1673293301685192,126908.26958550338,109.56759982637945,127017.83718532976,228,0,43.475,39,1,18,40.05059185361315,0.5836004273504274,48.09895833333333,1007.6041666666658,25.83600427350425,0
4713,4,2,1,41,0.047619047619047616,0.023809523809523808,0.9761904761904762,42,1500,1100,400,0.7333333333333333,19,11,8,307.0198004662896,0.470189701897019,0.13849561040406755,0.16322551376226077,127517.50996984444,-569.9199066200533,126947.59006322439,229,0,42.357142857142854,41,1,16,39.74263742919816,0.5866361788617886,47.495039682539684,1010.0198412698414,24.63463027487418,0
4714,4,0,1,40,0.0,0.024390243902439025,0.975609756097561,41,950,500,450,0.5263157894736842,14,5,9,307.1727779924386,0.47017276422764226,0.13815003227001754,0.1633488625182904,127527.89680621652,-365.3803333002839,127162.51647291624,230,1,44.09756097560975,40,1,16,39.72817520206595,0.58828125,47.484756097560975,1010.060975609756,25.2515243902439,0
4715,4,3,2,41,0.06976744186046512,0.046511627906976744,0.9534883720930233,43,950,600,350,0.631578947368421,13,6,7,295.0668711796889,0.47072259136212624,0.1480494046956713,0.15943375407589205,128169.06003996167,-1036.3112943933531,127132.74874556831,231,0,42.7906976744186,42,1,20,39.381180223285476,0.591765873015873,46.850775193798455,1012.5968992248072,24.10944998154303,0
4716,4,1,2,40,0.023809523809523808,0.047619047619047616,0.9523809523809523,42,800,600,200,0.75,10,6,4,305.6272519681471,0.4685564266356949,0.15800992937556835,0.1659746081262431,128370.63536352084,-553.2870960883882,127817.34826743245,232,0,42.30952380952381,41,1,16,38.90877386196772,0.5952743902439024,46.65178571428574,1013.3928571428605,24.716898954703915,0
4717,4,1,1,40,0.024390243902439025,0.024390243902439025,0.975609756097561,41,1500,1000,500,0.6666666666666666,20,10,10,312.7414526290658,0.46511686991869916,0.1607482119933974,0.17019072503954935,128453.40617563986,-165.45903149577265,128287.94714414408,233,0,44.0,40,1,18,38.644319131161225,0.59765625,46.57012195121953,1013.7195121951248,25.34298780487812,0
4718,4,0,4,36,0.0,0.1,0.9,40,1400,1000,400,0.7142857142857143,18,10,8,338.2892452839807,0.46447649572649574,0.13602686749440274,0.16771090434714384,124644.56197534526,433.1829598783728,125077.74493522363,234,1,45.5,40,0,13,41.91049257073074,0.5588541666666667,50.355691056910565,998.5772357723569,24.964430894308922,16
4719,4,4,1,39,0.1,0.025,0.975,40,950,500,450,0.5263157894736842,14,5,9,341.4413780108997,0.4673477564102564,0.17415109450080113,0.1712693361045569,125133.58267815407,546.1687100376905,125679.75138819175,235,0,46.1,38,2,17,41.32585869371774,0.5671600877192983,49.866452991452995,1000.5341880341887,26.32984705353128,0
4720,4,0,1,38,0.0,0.02564102564102564,0.9743589743589743,39,1050,800,250,0.7619047619047619,13,8,5,341.7515593538993,0.467442645074224,0.15939149094571858,0.17175582661090807,125213.76652786903,758.3999926948594,125972.16652056389,236,1,45.56410256410256,38,1,17,41.235233418730445,0.5679824561403508,49.78632478632478,1000.8547008547002,26.33828160143948,0
4721,4,1,2,37,0.02564102564102564,0.05128205128205128,0.9487179487179487,39,1250,700,550,0.56,18,7,11,339.1241626445468,0.46673976608187134,0.16826479153348983,0.17242791931645268,125695.40895061733,725.2700617283979,126420.67901234573,237,0,45.53846153846154,38,1,15,40.80390120036935,0.5729166666666667,49.30555555555556,1002.7777777777782,26.3888888888889,0
4722,4,2,1,38,0.05128205128205128,0.02564102564102564,0.9743589743589743,39,1450,800,650,0.5517241379310345,21,8,13,339.39397263388514,0.46440620782726044,0.17293089424236952,0.17346392703605637,125909.76902074658,746.6033402732104,126656.37236101979,238,0,46.12820512820513,38,1,17,40.57620999219359,0.575109649122807,49.09188034188034,1003.6324786324785,26.41138101664417,0
4723,4,1,0,39,0.02564102564102564,0.0,1.0,39,900,500,400,0.5555555555555556,13,5,8,333.8972879766168,0.46353463787674315,0.16737816014873186,0.17199550332464714,126231.65155416753,629.752561363128,126861.40411553066,239,0,46.02564102564103,38,1,20,40.38291161669854,0.5783991228070176,48.771367521367516,1004.9145299145296,26.445119208277095,0
4724,4,0,1,38,0.0,0.02564102564102564,0.9743589743589743,39,1250,800,450,0.64,17,8,9,331.595479073264,0.4628598740440846,0.16580310880829074,0.17111745310465223,126305.47417534713,576.4648437499958,126881.93901909713,240,1,47.02564102564103,39,0,15,40.3648531951641,0.5774572649572649,48.697916666666664,1005.2083333333326,25.77457264957263,0
4725,4,0,2,36,0.0,0.05263157894736842,0.9473684210526316,38,950,400,550,0.42105263157894735,15,4,11,339.7424719153346,0.46091156946420103,0.16061416565014497,0.17500644528125056,126231.6515541675,977.250666593605,127208.90222076111,241,3,49.23684210526316,38,0,19,40.236063859947535,0.5783991228070176,48.771367521367516,1004.9145299145293,26.445119208277088,0
4726,4,5,2,39,0.12195121951219512,0.04878048780487805,0.9512195121951219,41,850,600,250,0.7058823529411765,11,6,5,315.9432454754383,0.4666666666666666,0.15042372881355925,0.16643438824152523,127145.88355613971,-157.05721747391226,126988.8263386658,242,0,42.80487804878049,38,3,19,39.89715748587569,0.5877192982456141,47.86324786324785,1008.5470085470065,26.540710751237015,0
4727,4,0,1,38,0.0,0.02564102564102564,0.9743589743589743,39,1350,1100,250,0.8148148148148148,16,11,5,328.79944343056485,0.4664867296446244,0.15772569720482066,0.17253055393894517,126987.00086805574,550.6510416666854,127537.65190972242,243,1,45.8974358974359,39,0,19,39.73577235772359,0.5844017094017093,48.02083333333334,1007.9166666666681,25.84401709401713,0
4728,4,1,3,36,0.02564102564102564,0.07692307692307693,0.9230769230769231,39,1150,700,450,0.6086956521739131,16,7,9,326.89564541860057,0.467695681511471,0.14478753185977555,0.1730347565312375,127340.90206842498,525.5240795244822,127866.42614794946,244,0,45.35897435897436,37,2,17,39.4213968857505,0.5914977477477478,47.669956140350884,1009.3201754385972,27.278923660502628,0
4729,4,2,3,35,0.05263157894736842,0.07894736842105263,0.9210526315789473,38,1550,1000,550,0.6451612903225806,21,10,11,333.64970242703987,0.47020211000474155,0.13292862549952722,0.17738613995661673,127518.18700034515,909.2810293401728,128427.46802968532,245,0,45.473684210526315,36,2,17,39.069526517263164,0.5951967592592593,47.49436936936938,1010.0225225225242,28.05618118118123,0
4730,4,1,3,33,0.027777777777777776,0.08333333333333333,0.9166666666666666,36,1300,1100,200,0.8461538461538461,15,11,4,346.6195545294921,0.46731150793650794,0.14343000699612096,0.18540856147061296,127763.95486379012,1657.0970239626,129421.05188775272,246,0,47.916666666666664,35,1,18,38.49038828467852,0.5997023809523809,47.2511574074074,1010.9953703703688,28.885582010581967,0
4731,4,2,0,35,0.05714285714285714,0.0,1.0,35,1000,500,500,0.5,15,5,10,355.47952902396094,0.46498599439775906,0.15143866733972788,0.1898126541769451,127692.92091836731,2078.4438775510152,129771.36479591833,247,0,49.885714285714286,34,1,20,38.339222614841,0.6011029411764706,47.32142857142857,1010.7142857142853,29.72689075630251,0
4732,4,1,0,36,0.027777777777777776,0.0,1.0,36,1350,1000,350,0.7407407407407407,17,10,7,349.70956324408536,0.46574074074074073,0.15809327846364907,0.18884316415180616,128144.53125,1762.6736111111109,129907.20486111111,248,0,49.47222222222222,35,1,21,38.02297668038409,0.6035714285714286,46.875,1012.5,28.928571428571427,0
4733,4,2,3,35,0.05263157894736842,0.07894736842105263,0.9210526315789473,38,1150,600,550,0.5217391304347826,17,6,11,371.15908146604625,0.4660532242769085,0.18136679055854055,0.19103159503704442,126197.70828827875,1976.2184316128687,128173.92671989162,249,0,47.81578947368421,33,5,17,39.48182197015897,0.5880681818181819,48.80514705882354,1004.7794117647076,30.447860962566896,15
4734,4,3,2,36,0.07894736842105263,0.05263157894736842,0.9473684210526316,38,1200,800,400,0.6666666666666666,16,8,8,355.72047141235583,0.4686907302038881,0.1598205854579795,0.1874169050874052,127152.04081632635,1446.1167800453304,128598.15759637168,250,0,44.44736842105263,34,4,18,38.887905256531326,0.5955882352941176,47.85714285714285,1008.5714285714271,29.663865546218442,0
4735,4,0,2,34,0.0,0.05555555555555555,0.9444444444444444,36,1400,800,600,0.5714285714285714,20,8,12,374.34368988477956,0.46660052910052907,0.177020708082833,0.1966289486868475,127028.36445260695,2310.4533338434985,129338.81778645045,251,1,47.611111111111114,32,4,19,38.54558074482299,0.5989583333333333,47.979797979797986,1008.0808080808087,31.50252525252527,0
4736,4,1,1,34,0.02857142857142857,0.02857142857142857,0.9714285714285714,35,1050,800,250,0.7619047619047619,13,8,5,381.67909407389584,0.4641456582633053,0.1998708844415753,0.20095884320885968,127124.83935885974,2704.1787041558355,129829.01806301558,252,0,49.65714285714286,31,4,20,38.26137830858618,0.602486559139785,47.88411458333334,1008.4635416666679,32.53108198924735,0
4737,4,0,1,33,0.0,0.029411764705882353,0.9705882352941176,34,1200,800,400,0.6666666666666666,16,8,8,450.0153983641564,0.46379233511586454,0.09395986457664351,0.22125011533887834,124295.35070889695,4669.637658750684,128964.98836764763,253,1,51.294117647058826,30,4,17,39.487015321022604,0.5760416666666667,50.70564516129032,997.1774193548383,33.239247311827945,16
4738,4,2,2,33,0.05714285714285714,0.05714285714285714,0.9428571428571428,35,1350,1200,150,0.8888888888888888,15,12,3,414.22937548215776,0.4668067226890756,0.07950942026062058,0.18829091381031093,120936.35223765443,3147.1409668426804,124083.4932044971,254,0,50.68571428571428,29,6,17,43.91120681540053,0.5438218390804598,54.09722222222223,983.611111111112,33.917624521072824,16
4739,4,12,8,37,0.26666666666666666,0.17777777777777778,0.8222222222222222,45,1250,900,350,0.72,16,9,7,331.092490617517,0.4804924242424242,0.10709964979305986,0.16065953261301305,123742.2151527391,-773.5303704558876,122968.6847822832,255,0,39.44444444444444,37,8,17,43.02540224818162,0.5546171171171171,51.26096491228069,994.9561403508754,26.890706495969606,0
4740,4,6,2,41,0.13953488372093023,0.046511627906976744,0.9534883720930233,43,1200,800,400,0.6666666666666666,16,8,8,322.9912301358156,0.4768364710225175,0.11896548633359161,0.15743872038987317,123933.20691222273,-593.9398420668246,123339.2670701559,256,0,42.13953488372093,37,6,18,43.02882850640531,0.5565878378378378,51.0690789473684,995.7236842105241,26.911450924608758,14
4741,4,4,3,42,0.08888888888888889,0.06666666666666667,0.9333333333333333,45,900,500,400,0.5555555555555556,13,5,8,312.5506591552521,0.4775673400673401,0.14933808674985172,0.15527888751868238,124733.04866133377,-1202.91767875868,123530.1309825751,257,0,41.15555555555556,38,7,18,42.46167557932266,0.5630482456140351,50.26709401709401,998.9316239316227,26.28767431399007,0
4742,4,1,2,41,0.023255813953488372,0.046511627906976744,0.9534883720930233,43,1350,1100,250,0.8148148148148148,16,11,5,327.2097257322655,0.47584440753045404,0.15733556541566873,0.161743435536256,124521.85451921524,-451.04762701889945,124070.80689219634,258,0,44.0,36,7,19,42.31402083568394,0.564525462962963,50.47860360360361,998.0855855855862,27.724599599599614,0
4743,4,5,2,44,0.10869565217391304,0.043478260869565216,0.9565217391304348,46,1000,500,500,0.5,15,5,10,306.0244051059259,0.4777173913043478,0.21847120796585018,0.15712372651014775,126097.4838944589,-1480.3860098937798,124617.09788456513,259,0,41.34782608695652,38,8,21,41.22079211431408,0.5770285087719298,48.90491452991452,1004.3803418803406,26.431061628430015,0
4744,4,3,2,45,0.06382978723404255,0.0425531914893617,0.9574468085106383,47,1500,1000,500,0.6666666666666666,20,10,10,311.5275474939096,0.4791666666666667,0.1623137770013623,0.15317171094808438,124297.86376953151,-1288.4923302497384,123009.37143928178,260,0,41.1063829787234,39,8,13,42.936840593335425,0.5568910256410257,50.703125000000014,997.187500000002,25.56891025641031,16
4745,4,1,5,41,0.021739130434782608,0.10869565217391304,0.8913043478260869,46,1750,1200,550,0.6857142857142857,23,12,11,313.2559242470448,0.47853260869565223,0.17701198630137038,0.15503513539006267,124573.01482942491,-1395.3530206735495,123177.66180875136,261,0,42.869565217391305,38,8,14,42.60933932648403,0.5614035087719298,50.42735042735042,998.2905982905968,26.2708052181736,0
4746,4,5,3,43,0.10869565217391304,0.06521739130434782,0.9347826086956522,46,1250,900,350,0.72,16,9,7,310.9454110960884,0.4745571658615137,0.2429552977829701,0.15728403803986624,125481.23150887595,-1395.7068631747893,124085.52464570117,262,0,42.69565217391305,38,8,16,41.730646193218185,0.5707236842105263,49.51923076923078,1001.9230769230786,26.366396761133647,0
4747,4,2,1,44,0.044444444444444446,0.022222222222222223,0.9777777777777777,45,1200,900,300,0.75,15,9,6,311.03025527670934,0.4756523569023569,0.26640395450931575,0.1597903437204748,126122.29953342033,-1154.4297960069234,124967.8697374134,263,0,43.644444444444446,39,6,18,41.06962304262157,0.5755876068376069,48.88020833333334,1004.4791666666682,25.755876068376107,0
4748,4,5,6,43,0.10204081632653061,0.12244897959183673,0.8775510204081632,49,2100,1700,400,0.8095238095238095,25,17,8,290.38732606045033,0.47859977324263037,0.26720424443827295,0.15339994839732768,127259.16950936933,-2409.1100099001233,124850.05949946921,264,0,40.93877551020408,43,6,19,40.42595416862196,0.5811531007751938,47.750946969696976,1008.9962121212127,23.46502818886541,0
4749,4,1,2,42,0.022727272727272728,0.045454545454545456,0.9545454545454546,44,1200,900,300,0.75,15,9,6,366.11434275242135,0.47957408386187456,0.24061815907432527,0.1822592055020226,124817.77479383674,403.5458231103602,125221.3206169471,265,0,44.20454545454545,39,5,15,41.03610705722925,0.562232905982906,50.182291666666664,999.2708333333328,25.622329059829045,16
4750,4,3,6,39,0.06666666666666667,0.13333333333333333,0.8666666666666667,45,900,500,400,0.5555555555555556,13,5,8,355.48218634789873,0.4813131313131313,0.2661525406808425,0.18066286456858943,125676.58875091294,-64.3106075881808,125612.27814332476,266,0,43.955555555555556,36,9,16,40.41325059898172,0.5763888888888888,49.324324324324316,1002.7027027027016,27.85285285285282,0
4751,4,3,2,40,0.07142857142857142,0.047619047619047616,0.9523809523809523,42,1250,900,350,0.72,16,9,7,378.38467636285714,0.48095722028648863,0.29266026021275726,0.1931801597251679,125864.58510487524,1125.046060090699,126989.63116496593,267,0,47.26190476190476,34,8,19,39.64462965159964,0.5824142156862745,49.13690476190476,1003.4523809523806,29.513305322128843,0
4752,4,5,5,40,0.1111111111111111,0.1111111111111111,0.8888888888888888,45,1350,1100,250,0.8148148148148148,16,11,5,346.16533675731307,0.481060606060606,0.26692103868574457,0.18175124943267915,127011.23078977628,-206.6229043392698,126804.60788543701,268,0,42.08888888888889,38,7,19,39.27331743508214,0.5863486842105263,47.99679487179486,1008.0128205128191,26.526653171389977,0
4753,4,1,2,39,0.024390243902439025,0.04878048780487805,0.9512195121951219,41,1600,1100,500,0.6875,21,11,10,373.607061166656,0.4809197154471545,0.27500908791912604,0.1942480993298222,126612.30867346932,1260.6505102040726,127872.95918367339,269,0,46.707317073170735,34,7,20,38.992636621717544,0.5900735294117647,48.39285714285714,1006.4285714285709,29.60084033613444,0
4754,4,1,1,39,0.025,0.025,0.975,40,1350,900,450,0.6666666666666666,18,9,9,380.9610036862189,0.480088141025641,0.27797264437689995,0.1999619818327471,126999.35308835533,1676.3602040080593,128675.71329236339,270,0,48.25,33,7,21,38.4086879432624,0.5962752525252526,48.00857843137254,1007.9656862745089,30.54441473559118,0
4755,4,3,2,40,0.07142857142857142,0.047619047619047616,0.9523809523809523,42,1700,1500,200,0.8823529411764706,19,15,4,370.17524795066566,0.4802555168408827,0.21335946116697224,0.1868523640904209,125394.45484335677,1104.7849121346628,126499.23975549144,271,0,45.904761904761905,36,6,15,40.33688441646053,0.5734953703703703,49.60585585585585,1001.5765765765757,27.821571571571546,16
4756,4,1,1,40,0.024390243902439025,0.024390243902439025,0.975609756097561,41,2150,1700,450,0.7906976744186046,26,17,9,368.57102618017535,0.4798018292682927,0.2539161938730443,0.18832524266401307,125898.59992551872,1080.5152338391626,126979.11515935788,272,0,47.853658536585364,35,6,16,39.85567312497598,0.580654761904762,49.10300925925926,1003.5879629629633,28.673941798941808,0
4757,4,2,2,40,0.047619047619047616,0.047619047619047616,0.9523809523809523,42,1600,1000,600,0.625,22,10,12,366.1997094604475,0.47869483159117304,0.2635249287179895,0.19012169692208608,126553.21865361997,868.7503804480323,127421.96903406801,273,0,47.23809523809524,36,6,17,39.23988061928746,0.5853587962962963,48.451576576576585,1006.1936936936949,27.94982482482486,0
4758,4,3,0,43,0.06976744186046512,0.0,1.0,43,1250,600,650,0.48,19,6,13,351.2200211590487,0.47706718346253235,0.286614998611864,0.18594123152088335,127347.6321549591,346.55212645078274,127694.18428140988,274,0,46.883720930232556,36,7,16,38.800717765629074,0.5934606481481481,47.66328828828829,1009.3468468468475,28.03741241241243,0
4759,4,0,1,42,0.0,0.023255813953488372,0.9767441860465116,43,1400,900,500,0.6428571428571429,19,9,10,355.3227413398098,0.47616740494647475,0.2931456548347615,0.18877573129949138,127489.75326678026,460.0017246976669,127949.75499147792,275,1,47.883720930232556,36,7,17,38.55142358013677,0.5949074074074074,47.52252252252252,1009.9099099099097,28.05305305305305,0
4760,4,1,1,42,0.023255813953488372,0.023255813953488372,0.9767441860465116,43,1250,900,350,0.72,16,9,7,349.9094746553839,0.4757290513104466,0.29077536644740265,0.1874813294991255,127831.16731596446,345.86732002270605,128177.03463598716,276,0,48.25581395348837,36,7,19,38.33843726800296,0.5983796296296297,47.184684684684676,1011.26126126126,28.090590590590555,0
4761,4,2,1,43,0.045454545454545456,0.022727272727272728,0.9772727272727273,44,1550,1200,350,0.7741935483870968,19,12,7,344.9047519458605,0.4762707011980268,0.149340223039645,0.17048149167609664,124519.69304733719,-202.82501111179272,124316.8680362254,277,0,47.84090909090909,38,6,15,41.87473239135089,0.5608552631578947,50.480769230769226,998.0769230769223,26.265182186234796,16
4762,4,1,3,41,0.022727272727272728,0.06818181818181818,0.9318181818181819,44,1550,1200,350,0.7741935483870968,19,12,7,339.2305580606525,0.4775920542635659,0.14398474320975696,0.1690730884740224,124866.48866105976,-328.2942736869237,124538.19438737283,278,0,47.93181818181818,38,6,17,41.65731337965438,0.5644188596491229,50.133547008547,999.4658119658102,26.30173189383711,0
4763,4,1,2,40,0.023809523809523808,0.047619047619047616,0.9523809523809523,42,1400,1000,400,0.7142857142857143,18,10,8,372.68078049544266,0.4783560782036392,0.15663481112538657,0.18059999374814964,123686.06913506817,935.5953605856819,124621.66449565385,279,0,48.57142857142857,33,9,19,42.04947948749539,0.5621843434343434,51.31740196078431,994.7303921568622,30.14334521687461,16
4764,4,2,1,41,0.047619047619047616,0.023809523809523808,0.9761904761904762,42,1800,1400,400,0.7777777777777778,22,14,8,366.6246286785403,0.47777535811072397,0.14979471607128625,0.1799598265272036,124227.38803854857,708.9640022675485,124936.35204081611,280,0,46.642857142857146,34,8,17,41.63656356977947,0.5655637254901961,50.77380952380951,996.9047619047604,29.320728291316485,0
4765,4,4,2,43,0.08888888888888889,0.044444444444444446,0.9555555555555556,45,1250,900,350,0.72,16,9,7,344.1279687580874,0.4808922558922559,0.19107214228617164,0.1739410460268149,125450.85626166698,-363.3752064254066,125087.48105524157,281,0,44.24444444444445,36,9,18,40.930849070743406,0.5740740740740741,49.549549549549546,1001.801801801801,27.827827827827807,0
4766,4,4,3,44,0.0851063829787234,0.06382978723404255,0.9361702127659575,47,1600,1100,500,0.6875,21,11,10,330.919728181991,0.48040009250693805,0.19778982863302308,0.17026907813377865,126185.22872534693,-1045.7673890106373,125139.46133633629,282,0,43.12765957446808,36,11,22,40.50544534110439,0.5815972222222222,48.817567567567565,1004.7297297297293,27.90915915915915,0
4767,4,5,5,44,0.10204081632653061,0.10204081632653061,0.8979591836734694,49,1350,1100,250,0.8148148148148148,16,11,5,312.82016255720237,0.47980442176870747,0.2197672457412716,0.164570607258354,127092.01388888863,-1845.3646213781703,125246.64926751045,283,0,41.755102040816325,37,12,19,40.03099173553718,0.5889639639639639,47.91666666666665,1008.3333333333312,27.252252252252195,0
4768,4,1,2,43,0.022222222222222223,0.044444444444444446,0.9555555555555556,45,1000,700,300,0.7,13,7,6,337.82311454596106,0.4806397306397306,0.22840797354071674,0.1763286694459749,126771.27707315219,-434.74646883576673,126336.53060431642,284,0,45.8,35,10,21,39.729748496341394,0.5895833333333333,48.23495370370369,1007.0601851851832,28.773148148148092,0
4769,4,0,1,42,0.0,0.023255813953488372,0.9767441860465116,43,1200,700,500,0.5833333333333334,17,7,10,352.2240654295746,0.47967423403469917,0.2265877028263279,0.18292927269084341,126567.38281249988,316.0156249999839,126883.39843749987,285,1,48.51162790697674,33,10,22,39.576863354037265,0.5918560606060606,48.43749999999999,1006.2499999999991,30.492424242424214,0
4770,4,2,0,44,0.045454545454545456,0.0,1.0,44,1700,1400,300,0.8235294117647058,20,14,6,338.56649350423356,0.47995947850599013,0.22232502011263122,0.1787757652615813,127242.10778061223,-182.9320790816278,127059.1757015306,286,0,47.15909090909091,34,10,24,39.22812192723697,0.5965073529411764,47.767857142857146,1008.9285714285713,29.674369747899156,0
4771,4,1,3,42,0.022222222222222223,0.06666666666666667,0.9333333333333333,45,1500,1000,500,0.6666666666666666,20,10,10,329.28581561763974,0.4794612794612794,0.21735040879820589,0.17537800607519857,127590.03371229621,-597.2823368728675,126992.75137542334,287,0,47.08888888888889,37,8,20,39.10625135663124,0.5940315315315315,47.423245614035096,1010.3070175438606,27.30559506875299,0
4772,4,0,0,42,0.0,0.0,1.0,42,1600,1100,500,0.6875,21,11,10,345.9355836573758,0.47897309330236154,0.22249724972497265,0.18389207341786812,127512.49999999999,422.2222222222213,127934.7222222222,288,1,50.42857142857143,34,8,20,38.76512651265127,0.5992647058823529,47.5,1009.9999999999999,29.705882352941174,0
4773,4,0,1,41,0.0,0.023809523809523808,0.9761904761904762,42,1200,700,500,0.5833333333333334,17,7,10,342.56334272566227,0.47844076655052264,0.22017499579337074,0.18291589809691003,127692.92091836719,348.5827664398896,128041.50368480709,289,2,51.42857142857143,34,8,21,38.66558696505693,0.6011029411764706,47.32142857142856,1010.7142857142844,29.72689075630248,0
4774,4,1,0,42,0.023809523809523808,0.0,1.0,42,1550,1100,450,0.7096774193548387,20,11,9,344.80404017733815,0.4772793263646922,0.22122934144824247,0.18507895953170195,127903.5732001133,420.3337585033912,128323.90695861669,290,0,52.142857142857146,34,8,22,38.39345259111059,0.6032475490196079,47.113095238095234,1011.5476190476185,29.751400560224074,0
4775,4,1,2,41,0.023255813953488372,0.046511627906976744,0.9534883720930233,43,1250,900,350,0.72,16,9,7,335.81923265306114,0.4772748246585456,0.22036411960132862,0.18160805226911525,128203.13169795948,10.61546210561687,128213.7471600651,291,0,51.906976744186046,35,8,23,38.314761904761895,0.6041666666666667,46.817129629629626,1012.7314814814811,28.935185185185173,0
4776,4,1,2,40,0.023809523809523808,0.047619047619047616,0.9523809523809523,42,1200,800,400,0.6666666666666666,16,8,8,340.9826829844202,0.4769526713124274,0.22052487269878607,0.18482564536289256,128295.24518140573,349.29138321993753,128644.53656462567,292,0,53.357142857142854,34,8,24,38.089992166079114,0.6072303921568627,46.72619047619047,1013.0952380952368,29.796918767506966,0
4777,4,0,2,38,0.0,0.05,0.95,40,950,400,550,0.42105263157894735,15,4,11,354.3406257892431,0.4757612179487179,0.13233279613215232,0.18311463511190648,126363.65265185585,993.7747660470801,127357.42741790293,293,1,53.725,35,5,17,39.73334196692377,0.5854166666666667,48.64004629629628,1005.4398148148125,28.726851851851787,15
4778,4,1,3,36,0.02564102564102564,0.07692307692307693,0.9230769230769231,39,1700,1400,300,0.8235294117647058,20,14,6,360.8521966049085,0.47525865946918583,0.17128387086991492,0.18775417367966155,126642.26367630386,1339.8278061224528,127982.09148242632,294,0,56.0,34,5,19,39.2827222550759,0.5903799019607843,48.36309523809524,1006.5476190476192,29.604341736694682,0
4779,4,3,1,38,0.07692307692307693,0.02564102564102564,0.9743589743589743,39,1750,1400,350,0.8,21,14,7,347.96649119533305,0.47433085919928025,0.17624549679876078,0.18502837551173776,127524.87775134567,1076.4712380050132,128601.34898935069,295,0,53.38461538461539,33,6,21,38.70116476583354,0.6016414141414141,47.48774509803922,1010.0490196078434,30.60754604872253,0
4780,4,0,3,35,0.0,0.07894736842105263,0.9210526315789473,38,1100,600,500,0.5454545454545454,16,6,10,408.6310565413145,0.47323968705547653,0.18841847107038023,0.20356666255921935,124846.86065755965,3181.2237180411453,128028.0843756008,296,1,55.026315789473685,33,5,17,39.94366952789699,0.5741792929292929,50.15318627450981,999.3872549019612,30.2844622697564,16
4781,4,4,3,36,0.10256410256410256,0.07692307692307693,0.9230769230769231,39,600,300,300,0.5,9,3,6,388.4989863338549,0.4742183985605038,0.17892400843843292,0.19748503089258074,125685.46095521555,1965.8286997397126,127651.28965495525,297,0,51.43589743589744,34,5,16,39.57640785151766,0.5805759803921569,49.3154761904762,1002.7380952380963,29.49229691876754,0
4782,4,3,1,38,0.07692307692307693,0.02564102564102564,0.9743589743589743,39,1000,700,300,0.7,13,7,6,389.35656694060407,0.47272829509671616,0.19635594598991335,0.1999477708424306,126105.37413494814,2020.5013132704091,128125.87544821855,298,0,52.30769230769231,33,6,20,39.120200911013484,0.5871212121212122,48.89705882352941,1004.4117647058828,30.436720142602507,0
4783,4,3,5,36,0.07317073170731707,0.12195121951219512,0.8780487804878049,41,1100,800,300,0.7272727272727273,14,8,6,373.42967301175753,0.4730182926829268,0.20118237040317788,0.19491371235004806,126771.27707315242,1268.0313089420415,128039.30838209446,299,0,50.21951219512195,35,6,18,38.83329981228211,0.5895833333333333,48.2349537037037,1007.060185185185,28.77314814814814,0
4784,4,5,2,39,0.12195121951219512,0.04878048780487805,0.9512195121951219,41,1150,900,250,0.782608695652174,14,9,5,378.8312394516643,0.4764989837398374,0.16773144240661897,0.1891289882710136,124936.8766579939,1391.7224169390768,126328.59907493298,300,0,50.073170731707314,32,9,21,40.594741938199874,0.5774739583333333,50.0631313131313,999.7474747474732,31.24210858585854,16
4785,4,5,2,42,0.11363636363636363,0.045454545454545456,0.9545454545454546,44,1300,900,400,0.6923076923076923,17,9,8,337.1258490236701,0.47836284355179703,0.2133458552466816,0.16369272765595544,123769.49067261076,-431.5095185350216,123337.98115407574,301,0,44.63636363636363,37,7,19,42.84699265381083,0.5548986486486487,51.233552631578945,995.0657894736839,26.89366998577524,16
4786,4,10,8,44,0.19230769230769232,0.15384615384615385,0.8461538461538461,52,1450,1000,450,0.6896551724137931,19,10,9,313.45110784523774,0.484508547008547,0.2522695215621267,0.15567034518667006,124718.04112563883,-2045.9601804645288,122672.0809451743,302,0,38.51923076923077,47,5,15,42.45468338113032,0.5503102836879432,50.28211805555555,998.8715277777765,21.2525856973995,15
4787,4,6,4,46,0.12,0.08,0.92,50,1700,1400,300,0.8235294117647058,20,14,6,323.76538821752223,0.48333333333333334,0.277502286353013,0.1619814532510744,125025.40779504579,-1902.6282496911952,123122.7795453546,303,0,40.8,40,10,20,41.87963621583173,0.5627604166666667,49.974593495934954,1000.1016260162589,25.002540650406473,0
4788,4,1,1,46,0.02127659574468085,0.02127659574468085,0.9787234042553191,47,1400,1100,300,0.7857142857142857,17,11,6,329.37442500386544,0.4840040086339809,0.28398320548479195,0.16551409390361588,125208.4201388888,-1151.909722222228,124056.51041666657,304,0,43.5531914893617,39,8,21,41.550444074382476,0.5662393162393162,49.791666666666664,1000.8333333333326,25.662393162393144,0
4789,4,2,5,43,0.041666666666666664,0.10416666666666667,0.8958333333333334,48,1200,800,400,0.6666666666666666,16,8,8,315.2042290335405,0.48491060874704495,0.10377202362766114,0.1556053456450647,124467.03273721007,-1602.6249256394894,122864.40781157058,305,0,43.520833333333336,40,8,17,42.67024815833252,0.55703125,50.53353658536586,997.8658536585372,24.946646341463428,16
4790,4,5,6,42,0.10416666666666667,0.125,0.875,48,2250,1700,550,0.7555555555555555,28,17,11,308.63673911997176,0.4863696808510638,0.143380409646515,0.15524151035496092,125248.13889676238,-1868.764566011591,123379.37433075078,306,0,43.083333333333336,41,7,16,42.02841096795508,0.5635162601626016,49.75198412698413,1000.9920634920633,24.414440572977153,0
4791,4,7,3,46,0.14285714285714285,0.061224489795918366,0.9387755102040817,49,950,700,250,0.7368421052631579,12,7,5,298.1996687864859,0.48713860544217685,0.22222582870126195,0.1473422724946976,124504.46034895415,-2345.0955845301332,122159.36476442401,307,0,42.775510204081634,41,8,13,43.05583167660703,0.5558943089430894,50.49603174603173,998.0158730158711,24.34185056136271,16
4792,4,1,4,43,0.02127659574468085,0.0851063829787234,0.9148936170212766,47,1050,700,350,0.6666666666666666,14,7,7,305.92959249251516,0.48755010792476106,0.23304690374667203,0.1520367995046219,124746.06405743919,-1767.2974915724972,122978.7665658667,308,0,44.361702127659576,40,7,15,42.613597829772786,0.5598958333333333,50.254065040650396,998.983739837397,24.974593495934926,0
4793,4,9,8,44,0.17307692307692307,0.15384615384615385,0.8461538461538461,52,1100,700,400,0.6363636363636364,15,7,8,288.8290470635915,0.48573403720462544,0.28246243036433527,0.14996202840134,126555.73666838124,-3082.4315567192216,123473.30511166202,309,0,37.75,44,8,15,41.18355265175914,0.5726799242424243,48.44907407407407,1006.2037037037029,22.868265993265975,0
4794,4,2,4,42,0.043478260869565216,0.08695652173913043,0.9130434782608696,46,1500,900,600,0.6,21,9,12,323.1989961416017,0.4844907407407408,0.2843603251517268,0.16552010797733968,125992.81724048183,-1055.8495893647994,124936.96765111704,310,0,40.58695652173913,40,6,19,40.897147147147145,0.57265625,49.00914634146341,1003.9634146341461,25.099085365853654,0
4795,4,4,2,44,0.08695652173913043,0.043478260869565216,0.9565217391304348,46,1200,600,600,0.5,18,6,12,325.61108671495253,0.4839774557165861,0.27565254342976186,0.1684979196947688,126419.60612763876,-967.2542776463025,125452.35184999245,311,0,41.02173913043478,38,8,19,40.39803109175253,0.5803179824561404,48.584401709401696,1005.6623931623914,26.464799820062932,0
4796,4,1,2,43,0.022222222222222223,0.044444444444444446,0.9555555555555556,45,1200,900,300,0.75,15,9,6,328.5005543033522,0.4836700336700337,0.2746608149878491,0.17055227234999784,126553.94500146055,-685.391783548883,125868.55321791167,312,0,42.24444444444445,38,7,21,40.18745133432432,0.5816885964912281,48.45085470085468,1006.1965811965773,26.47885739990993,0
4797,4,1,0,44,0.022727272727272728,0.0,1.0,44,850,300,550,0.35294117647058826,14,3,11,328.41770542336803,0.4842208421423538,0.2576408787010511,0.1710713122279928,126688.35521449665,-478.6602153189117,126209.69499917774,313,0,43.0,38,6,22,40.05160246206092,0.5830592105263157,48.31730769230767,1006.7307692307661,26.492914979757003,0
4798,4,2,6,40,0.043478260869565216,0.13043478260869565,0.8695652173913043,46,1900,1400,500,0.7368421052631579,24,14,10,356.09483665456975,0.48396739130434785,0.1018608388672444,0.18155369887878048,125808.59510633688,283.6936373839178,126092.2887437208,314,0,42.08695652173913,39,7,13,40.26159017755165,0.5723824786324787,49.192708333333336,1003.2291666666673,25.7238247863248,15
4799,4,1,3,38,0.024390243902439025,0.07317073170731707,0.926829268292683,41,1400,1000,400,0.7142857142857143,18,10,8,367.6032759619002,0.4826219512195122,0.1702067561481908,0.1878655937956045,125906.24188452236,1056.70939616038,126962.95128068274,315,0,46.5609756097561,37,4,14,39.87205925197569,0.5768581081081081,49.09539473684212,1003.6184210526332,27.124822190611706,0
4800,4,2,5,35,0.05,0.125,0.875,40,1200,800,400,0.6666666666666666,16,8,8,398.8783464117059,0.4820646367521368,0.23483776320331362,0.2067174543031684,126480.04979263109,2090.1057663843026,128570.1555590154,316,0,48.05,35,5,14,38.493484639282,0.5866071428571429,48.52430555555555,1005.902777777777,28.740079365079342,0
4801,4,3,4,34,0.07894736842105263,0.10526315789473684,0.8947368421052632,38,1000,500,500,0.5,15,5,10,407.66040376248316,0.48008534850640117,0.2417234664070107,0.2125214389157715,126721.57343329473,2731.873558246807,129453.44699154154,317,0,50.71052631578947,33,5,17,38.022861895488475,0.5934343434343434,48.284313725490186,1006.862745098038,30.510992275698122,0
4802,4,2,3,33,0.05555555555555555,0.08333333333333333,0.9166666666666666,36,1300,800,500,0.6153846153846154,18,8,10,424.2342458047147,0.4773313492063492,0.24686654322746082,0.22378276782831713,127200.69372192488,3594.200045709794,130794.89376763467,318,0,49.111111111111114,28,8,20,37.11009827659878,0.6119791666666667,47.808908045977006,1008.7643678160913,36.02729885057469,0
4803,4,1,1,33,0.029411764705882353,0.029411764705882353,0.9705882352941176,34,800,500,300,0.625,11,5,6,418.7797958503411,0.47667855020796196,0.2153319495128727,0.2222948946553019,127454.46062888093,3875.0706004756175,131329.53122935654,319,0,50.5,28,6,18,36.9856881995826,0.6145833333333333,47.55747126436781,1009.7701149425285,36.063218390804586,0
4804,4,0,0,33,0.0,0.0,1.0,33,1000,600,400,0.6,14,6,8,416.57161929020106,0.476010101010101,0.20326128175957603,0.22191906264005237,127599.58382877517,4030.8730512617153,131630.4568800369,320,1,52.515151515151516,28,5,19,36.89176858172166,0.6160714285714286,47.41379310344827,1010.3448275862061,36.083743842364505,0
4805,4,2,1,34,0.05714285714285714,0.02857142857142857,0.9714285714285714,35,900,700,200,0.7777777777777778,11,7,4,392.04728276516107,0.4750350140056023,0.18459729570840722,0.21170553269318704,128144.53125,3047.7430555555557,131192.27430555556,321,0,50.457142857142856,30,5,21,36.951303155006855,0.615625,46.875,1012.5,33.75,0
4806,4,0,0,34,0.0,0.0,1.0,34,1050,700,350,0.6666666666666666,14,7,7,404.45312159695163,0.47402332144979203,0.1912067420628194,0.21783073888226048,128039.08420138877,3557.161458333314,131596.24565972207,322,1,52.8235294117647,29,5,21,36.7456600795938,0.6174568965517242,46.97916666666666,1012.0833333333323,34.89942528735629,0
4807,4,0,0,34,0.0,0.0,1.0,34,1150,900,250,0.782608695652174,14,9,5,402.8920780995821,0.4732991681521093,0.18422071323731082,0.21832799536837652,128285.19483024674,3537.0177469135583,131822.2125771603,323,2,53.8235294117647,29,5,21,36.532309660908524,0.6199712643678161,46.7361111111111,1013.0555555555541,34.93295019157083,0
4808,4,0,3,31,0.0,0.08823529411764706,0.9117647058823529,34,1300,900,400,0.6923076923076923,17,9,8,404.80271562619623,0.4726492869875223,0.18244000354698597,0.2199438135461171,128390.74315200603,3594.584297839489,131985.32744984553,324,3,54.8235294117647,29,5,16,36.37553675026267,0.6210488505747127,46.631944444444436,1013.472222222221,34.947318007662794,0
4809,4,1,1,31,0.03125,0.03125,0.96875,32,1150,900,250,0.782608695652174,14,9,5,411.68224515814836,0.46944304435483875,0.14607393368286803,0.22434298101012,128508.47463750174,4180.931472123146,132689.4061096249,325,0,56.375,28,4,17,36.080310330168615,0.6253720238095238,46.515804597701155,1013.9367816091961,36.21202791461415,0
4810,4,1,1,31,0.03125,0.03125,0.96875,32,750,500,250,0.6666666666666666,10,5,5,394.9163011551122,0.46864499327956993,0.07557277408421315,0.19607786059293617,124707.20291137685,3449.7814602321896,128156.98437160904,326,0,56.78125,31,1,20,40.431631034632595,0.5776209677419355,50.29296874999999,998.8281249999992,32.22026209677417,15
4811,4,5,4,32,0.1388888888888889,0.1111111111111111,0.8888888888888888,36,1050,800,250,0.7619047619047619,13,8,5,350.89628396241943,0.47625661375661377,0.07069425216633363,0.17891582290507319,125811.49798525343,1629.357424554143,127440.85540980757,327,0,51.19444444444444,35,1,19,40.388978618674045,0.5797619047619047,49.189814814814795,1003.2407407407379,28.664021164021083,0
4812,4,3,1,34,0.08571428571428572,0.02857142857142857,0.9714285714285714,35,700,500,200,0.7142857142857143,9,5,4,358.52515858805225,0.47587535014005605,0.08721376952629178,0.1846437378670986,126223.21605725602,2050.8397108843255,128274.05576814034,328,0,52.142857142857146,34,1,22,39.77288433439953,0.5860906862745099,48.77976190476189,1004.8809523809507,29.55532212885149,0
4813,4,1,2,33,0.02857142857142857,0.05714285714285714,0.9428571428571428,35,750,300,450,0.4,12,3,9,362.01327221006966,0.4755952380952381,0.09825083233340681,0.18808224892389167,126582.35721371877,2164.8986678004453,128747.25588151922,329,0,52.91428571428571,34,1,19,39.31518395835796,0.5897671568627452,48.422619047619044,1006.3095238095234,29.597338935574218,0
4814,4,2,2,33,0.05714285714285714,0.05714285714285714,0.9428571428571428,35,1200,1000,200,0.8333333333333334,14,10,4,411.61011263688147,0.4742997198879552,0.10135557872784173,0.20452543938796347,124739.71896701395,3333.0656090561297,128072.78457607007,330,0,53.542857142857144,31,4,15,39.98088286409453,0.5779569892473118,50.26041666666667,998.9583333333339,32.224462365591414,16
4815,4,1,0,34,0.029411764705882353,0.0,1.0,34,750,400,350,0.5333333333333333,11,4,7,427.93415576615007,0.47428327391562686,0.06590292223107208,0.20231790695544485,122634.99153984933,3815.5692206488907,126450.56076049822,331,0,55.85294117647059,31,3,15,41.77963827176723,0.5561155913978495,52.37630208333334,990.494791666668,31.951444892473162,16
4816,4,6,6,34,0.15,0.15,0.85,40,900,600,300,0.6666666666666666,12,6,6,379.2407495364746,0.480088141025641,0.07221405967450245,0.18559303937493019,124100.72234396599,1419.9351987304333,125520.65754269643,332,0,48.325,36,4,14,41.4540479957806,0.5601851851851851,50.90090090090092,996.3963963963997,27.67767767767777,0
4817,4,1,2,33,0.02857142857142857,0.05714285714285714,0.9428571428571428,35,700,300,400,0.42857142857142855,11,3,8,412.31377895326625,0.47398459383753505,0.0707717772182217,0.19923178610171835,123564.19593725986,3189.444114042701,126753.64005130257,333,0,54.628571428571426,33,2,17,41.191477669583826,0.5609217171717171,51.43995098039217,994.2401960784326,30.128490790255533,0
4818,4,6,6,33,0.15384615384615385,0.15384615384615385,0.8461538461538461,39,1000,700,300,0.7,13,7,6,374.3230345756528,0.47961650922177235,0.07779483804927989,0.18691552186532334,124945.18145006165,1554.6064167767727,126499.78786683842,334,0,49.0,37,2,17,40.698800906631575,0.5670045045045045,50.054824561403514,999.7807017543867,27.021100047415857,0
4819,4,3,1,35,0.08333333333333333,0.027777777777777776,0.9722222222222222,36,1400,1200,200,0.8571428571428571,16,12,4,399.3990472914297,0.47625661375661377,0.12221643986996145,0.20067423369721038,125202.62834630047,2801.1620959790644,128003.79044227953,335,0,53.5,35,1,20,39.804387841640626,0.5735119047619048,49.797453703703695,1000.8101851851842,28.59457671957669,0
4820,4,3,2,36,0.07894736842105263,0.05263157894736842,0.9473684210526316,38,1250,700,550,0.56,18,7,11,379.986570479158,0.47694404931247036,0.12022275606027466,0.1948441776286749,126043.83680555575,1981.809547539457,128025.6463530952,336,0,49.55263157894737,36,2,20,39.419087136929456,0.580150462962963,48.95833333333334,1004.1666666666682,27.89351851851856,0
4821,4,3,3,36,0.07692307692307693,0.07692307692307693,0.9230769230769231,39,1200,800,400,0.6666666666666666,16,8,8,367.900469229929,0.47584907782276203,0.12397257214330404,0.19197715394361733,126760.5417051399,1527.0525546321805,128287.59425977207,337,0,48.41025641025641,37,2,18,38.98355836236935,0.5855855855855856,48.24561403508771,1007.017543859648,27.21669037458508,0
4822,4,0,0,36,0.0,0.0,1.0,36,1200,900,300,0.75,15,9,6,385.7759882360256,0.4741732804232804,0.13046779473829506,0.2001346148915072,126522.46492346935,2561.865787981853,129084.3307114512,338,1,53.111111111111114,34,2,18,38.77918786731353,0.5891544117647058,48.482142857142854,1006.0714285714283,29.590336134453775,0
4823,4,0,1,35,0.0,0.027777777777777776,0.9722222222222222,36,1050,600,450,0.5714285714285714,15,6,9,384.8425640876786,0.4736276455026455,0.13014981273408233,0.20023654642223537,126642.2636763039,2547.4666950113424,129189.73037131525,339,2,54.111111111111114,34,2,19,38.67903607332939,0.5903799019607843,48.36309523809524,1006.5476190476195,29.604341736694693,0
4824,4,2,3,34,0.05405405405405406,0.08108108108108109,0.9189189189189189,37,950,600,350,0.631578947368421,13,6,7,379.75548118297905,0.4758508508508508,0.14272950636586978,0.19978440531800215,127092.01388888898,2252.7777777777874,129344.79166666676,340,0,53.4054054054054,35,2,21,38.34366391184571,0.5928571428571429,47.91666666666667,1008.3333333333342,28.809523809523835,0
4825,4,1,0,35,0.02857142857142857,0.0,1.0,35,1000,500,500,0.5,15,5,10,378.91717881980543,0.4771358543417367,0.12721481656246292,0.20037934652872685,127302.17013888895,2647.3958333333385,129949.56597222229,341,0,55.91428571428571,34,1,23,38.14856867602533,0.5971200980392157,47.708333333333336,1009.1666666666672,29.681372549019624,0
4826,4,1,1,35,0.027777777777777776,0.027777777777777776,0.9722222222222222,36,1000,700,300,0.7,13,7,6,396.9781802427903,0.4778769841269841,0.17495937859152622,0.20005892594500385,125327.59530895714,2951.158588435396,128278.75389739254,342,0,55.333333333333336,34,2,18,39.735168232077015,0.5768995098039216,49.67261904761906,1001.3095238095257,29.450280112044872,16
4827,4,3,1,37,0.07894736842105263,0.02631578947368421,0.9736842105263158,38,1900,1600,300,0.8421052631578947,22,16,6,366.960597304683,0.47864805595068755,0.12566700770083727,0.17740903159507806,123586.19637613626,1569.6293053937443,125155.82568153,343,0,52.473684210526315,35,3,18,42.29583769836652,0.5568452380952381,51.41782407407409,994.328703703706,28.4093915343916,15
4828,4,6,1,42,0.13953488372093023,0.023255813953488372,0.9767441860465116,43,1000,700,300,0.7,13,7,6,336.5775147160534,0.4825581395348837,0.17026741892573694,0.16895524748617766,125164.52778739638,-157.83908292114265,125006.68870447524,344,0,47.16279069767442,37,6,22,41.41555263350135,0.5692567567567568,49.83552631578949,1000.6578947368441,27.044807965860652,0
4829,4,2,5,39,0.045454545454545456,0.11363636363636363,0.8863636363636364,44,1500,800,700,0.5333333333333333,22,8,14,324.7345425503117,0.4825361169837914,0.1703045733233819,0.16472959952354554,125599.67583550385,-642.6893446180173,124956.98649088583,345,0,47.04545454545455,39,5,16,41.263227856870685,0.5702457264957265,49.401041666666686,1002.3958333333364,25.702457264957346,0
4830,4,2,0,41,0.04878048780487805,0.0,1.0,41,1550,1100,450,0.7096774193548387,20,11,9,340.6164262218159,0.4791920731707317,0.18323104018786385,0.17257395430528805,125548.84676054167,352.79989996922006,125901.64666051089,346,0,51.02439024390244,37,4,19,40.91766958424507,0.5731981981981982,49.45175438596491,1002.19298245614,27.08629682313892,0
4831,4,3,2,42,0.06818181818181818,0.045454545454545456,0.9545454545454546,44,1300,600,700,0.46153846153846156,20,6,14,327.23729070368745,0.4790785764622974,0.21262819398574684,0.16945059706735496,126446.46819526624,-522.4523510647808,125924.01584420145,347,0,48.47727272727273,38,6,15,40.32956235394095,0.580592105263158,48.55769230769231,1005.7692307692305,26.46761133603238,0
4832,4,3,2,43,0.06666666666666667,0.044444444444444446,0.9555555555555556,45,1600,1200,400,0.75,20,12,8,323.6571921272285,0.4783670033670034,0.22156099688902664,0.1701617578815558,127065.75656467004,-774.8508029513976,126290.90576171865,348,0,48.08888888888889,39,6,18,39.78469280573062,0.5852029914529915,47.94270833333333,1008.2291666666658,25.852029914529894,0
4833,4,2,4,41,0.044444444444444446,0.08888888888888889,0.9111111111111111,45,1000,400,600,0.4,16,4,12,325.7016004781001,0.47857744107744105,0.2337706305543803,0.1729512094224158,127469.34125940531,-696.6035953109086,126772.7376640944,349,0,48.75555555555555,38,7,15,39.32016151784456,0.5910087719298245,47.54273504273504,1009.8290598290594,26.57444894286998,0
4834,4,0,3,38,0.0,0.07317073170731707,0.926829268292683,41,1200,800,400,0.6666666666666666,16,8,8,348.34713122994737,0.4773882113821138,0.2391329903659385,0.18352460106032367,127150.37321030493,658.4935485253501,127808.86675883028,350,1,53.46341463414634,35,6,20,39.07552979879122,0.593452380952381,47.85879629629628,1008.5648148148125,28.8161375661375,0
4835,4,2,4,36,0.05,0.1,0.9,40,950,700,250,0.7368421052631579,12,7,5,347.20368455962165,0.4786458333333334,0.22987070887204641,0.1849828656691759,127603.5072234395,860.8815741416868,128464.3887975812,351,0,48.85,36,4,16,38.63988891365728,0.5960648148148149,47.4099099099099,1010.3603603603592,28.065565565565535,0
4836,4,2,3,35,0.05263157894736842,0.07894736842105263,0.9210526315789473,38,1200,800,400,0.6666666666666666,16,8,8,368.0278796267391,0.47798127074442864,0.24651862419749992,0.19578160242212414,127542.56129535138,1787.843679138305,129330.40497448968,352,0,52.0,34,4,18,38.176438813592604,0.5995710784313726,47.47023809523809,1010.1190476190468,29.709383753501378,0
4837,4,2,1,36,0.05405405405405406,0.02702702702702703,0.972972972972973,37,1350,900,450,0.6666666666666666,18,9,9,362.2768166089968,0.4774774774774775,0.22766295707472217,0.19489575577066265,127993.90589569148,1873.8449546485126,129867.75085033999,353,0,49.891891891891895,34,3,20,37.85906862745099,0.6041666666666667,47.02380952380952,1011.9047619047609,29.76190476190473,0
4838,4,2,0,38,0.05263157894736842,0.0,1.0,38,1300,900,400,0.6923076923076923,17,9,8,354.998680439585,0.477744191559981,0.1008383268884494,0.18178134612974733,125987.30223043989,1364.9950557286456,127352.29728616854,354,0,49.05263157894737,36,2,17,40.10469246588147,0.5795717592592593,49.01463963963964,1003.9414414414414,27.88726226226226,16
4839,4,5,3,40,0.11627906976744186,0.06976744186046512,0.9302325581395349,43,1050,900,150,0.8571428571428571,12,9,3,323.79974038014393,0.4765826873385013,0.13101231331369556,0.17112100845949016,127275.89111328125,-347.97554297857846,126927.91557030268,355,0,44.23255813953488,39,4,18,39.56602061181653,0.5873397435897436,47.734375,1009.0625,25.873397435897434,0
4840,4,3,5,38,0.06976744186046512,0.11627906976744186,0.8837209302325582,43,1200,900,300,0.75,15,9,6,326.6131500028429,0.47905131044665933,0.13865241934323547,0.17384710915079987,127565.10959201398,-267.11154513888016,127297.9980468751,356,0,44.23255813953488,39,4,15,39.1992335189386,0.5902777777777778,47.44791666666667,1010.2083333333342,25.9027777777778,0
4841,4,3,3,38,0.07317073170731707,0.07317073170731707,0.926829268292683,41,1900,1500,400,0.7894736842105263,23,15,8,336.88903013578977,0.4763719512195122,0.13432752915534762,0.1802933109043597,127783.97108966221,409.8036174592197,128193.77470712143,357,0,46.19512195121951,37,4,16,38.71586143946789,0.5960022522522522,47.23135964912281,1011.0745614035088,27.32633949739213,0
4842,4,0,1,37,0.0,0.02631578947368421,0.9736842105263158,38,1150,1000,150,0.8695652173913043,13,10,3,360.88660096395347,0.4745436225699384,0.13338548068685485,0.19098605511687877,127332.20663265313,1590.4974489795961,128922.70408163274,358,1,50.71052631578947,34,4,17,38.572629157820224,0.5974264705882353,47.67857142857143,1009.2857142857149,29.68487394957985,0
4843,4,1,2,36,0.02631578947368421,0.05263157894736842,0.9473684210526316,38,1150,700,450,0.6086956521739131,16,7,9,377.73108207955596,0.4748547889995258,0.1826497973426069,0.18747045142493463,124690.50712452314,1855.8158208194368,126546.32294534257,359,0,51.44736842105263,36,2,16,40.87810538580075,0.5662615740740741,50.30968468468468,998.7612612612609,27.74336836836836,16
4844,4,5,2,39,0.12195121951219512,0.04878048780487805,0.9512195121951219,41,1300,800,500,0.6153846153846154,18,8,10,347.2961714939712,0.47860772357723574,0.18875464560216315,0.17772478759235918,125961.27083573795,550.324278800539,126511.59511453849,360,0,47.8780487804878,37,4,18,40.324845257600586,0.5774211711711712,49.040570175438596,1003.8377192982458,27.13074917022286,0
4845,4,6,7,38,0.13333333333333333,0.15555555555555556,0.8444444444444444,45,1100,800,300,0.7272727272727273,14,8,6,320.5829964464964,0.48017676767676765,0.196852291903433,0.16854550910405441,127065.75656467024,-852.9216997657879,126212.83486490445,361,0,44.28888888888889,39,6,19,39.86218014946446,0.5852029914529915,47.942708333333336,1008.2291666666675,25.852029914529936,0
4846,4,3,1,40,0.07317073170731707,0.024390243902439025,0.975609756097561,41,1300,900,400,0.6923076923076923,17,9,8,343.2583547582357,0.4738313008130081,0.2316219973760698,0.18149603366507297,127296.33012099164,539.1084814921613,127835.4386024838,362,0,48.48780487804878,35,6,23,39.05419677333025,0.5949404761904762,47.71412037037035,1009.1435185185161,28.832671957671888,0
4847,4,0,0,40,0.0,0.0,1.0,40,900,400,500,0.4444444444444444,14,4,10,346.2950278313213,0.47397168803418804,0.22186998394863533,0.18349849530648726,127383.94445516099,822.4853180726777,128206.42977323367,363,1,49.95,35,5,17,38.8877742108079,0.5958333333333333,47.6273148148148,1009.4907407407393,28.842592592592553,0
4848,4,1,5,36,0.024390243902439025,0.12195121951219512,0.8780487804878049,41,950,600,350,0.631578947368421,13,6,7,337.9080024859448,0.4739329268292683,0.2234983243444848,0.18083863557300603,127783.97108966205,435.8452841258734,128219.81637378792,364,0,49.707317073170735,37,4,18,38.690105013917524,0.5960022522522522,47.2313596491228,1011.0745614035076,27.326339497392098,0
4849,4,0,2,34,0.0,0.05555555555555555,0.9444444444444444,36,1050,900,150,0.8571428571428571,12,9,3,374.7894120917463,0.4704199735449735,0.23367981730845,0.19659028269942488,126972.00255102018,2317.552437641693,129289.55498866187,365,1,56.583333333333336,34,2,21,38.59235963461688,0.59375,48.03571428571427,1007.8571428571411,29.64285714285709,0
4850,4,0,1,33,0.0,0.029411764705882353,0.9705882352941176,34,950,700,250,0.7368421052631579,12,7,5,403.54447363075315,0.4698269459298871,0.22555413191753804,0.1997401858829559,124577.18107435454,3279.2775506605817,127856.45862501512,366,2,58.8235294117647,31,3,18,40.35164231989914,0.5762768817204301,50.42317708333334,998.3072916666679,32.20346102150542,15
4851,4,4,2,35,0.10810810810810811,0.05405405405405406,0.9459459459459459,37,1150,800,350,0.6956521739130435,15,8,7,367.20866168921333,0.4737862862862863,0.20296473759077616,0.18670750263352986,125695.40895061752,1832.721210997814,127528.13016161534,367,0,52.24324324324324,32,5,19,40.09983841181903,0.5852864583333333,49.30555555555557,1002.7777777777798,31.336805555555618,0
4852,4,4,3,36,0.10256410256410256,0.07692307692307693,0.9230769230769231,39,1050,900,150,0.8571428571428571,12,9,3,349.6015668382695,0.47514619883040937,0.20914836836930562,0.18211647885709498,126690.727800005,1058.7376416389245,127749.46544164393,368,0,41.92307692307692,33,6,20,39.51600223169002,0.5931186868686869,48.31495098039217,1006.7401960784329,30.50727866904342,0
4853,4,2,2,36,0.05263157894736842,0.05263157894736842,0.9473684210526316,38,1250,800,450,0.64,17,8,9,359.29280362483036,0.47369902797534374,0.22733744191411542,0.18887116767243378,127060.18717796645,1530.3621760534538,128590.54935401991,369,0,42.31578947368421,32,6,22,38.89219369651428,0.5992838541666667,47.94823232323232,1008.2070707070701,31.50647095959594,0
4854,4,0,0,36,0.0,0.0,1.0,36,1100,600,500,0.5454545454545454,16,6,10,378.1828312492962,0.4710317460317461,0.23668000889481888,0.1978004410476953,126854.9493619204,2394.8727815354314,129249.82214345584,370,1,45.361111111111114,30,6,22,38.62741827885258,0.6024305555555556,48.151881720430104,1007.3924731182792,33.57974910394264,0
4855,4,1,1,36,0.02702702702702703,0.02702702702702703,0.972972972972973,37,750,400,350,0.5333333333333333,11,4,7,365.84152042959096,0.47122122122122123,0.2268093034940437,0.1927760828059599,127157.66906738271,1903.910997178805,129061.58006456151,371,0,45.108108108108105,31,6,23,38.626925725105416,0.6028225806451613,47.85156249999999,1008.5937499999992,32.53528225806449,0
4856,4,1,1,36,0.02702702702702703,0.02702702702702703,0.972972972972973,37,1050,700,350,0.6666666666666666,14,7,7,367.0842778642684,0.47112737737737737,0.2162371430664114,0.19390157254057339,127256.18362426736,1942.748853895369,129198.93247816272,372,0,45.32432432432432,31,6,24,38.49434873316987,0.6038306451612903,47.753906249999986,1008.9843749999983,32.54788306451607,0
4857,4,0,2,34,0.0,0.05555555555555555,0.9444444444444444,36,800,600,200,0.75,10,6,4,373.60716037634126,0.47124669312169315,0.23003876829286307,0.19770374681225827,127329.29972034329,2314.227620245096,129643.52734058839,373,1,47.30555555555556,30,6,19,38.25464997558485,0.6072916666666667,47.68145161290322,1009.2741935483863,33.64247311827954,0
4858,4,1,2,33,0.02857142857142857,0.05714285714285714,0.9428571428571428,35,900,700,200,0.7777777777777778,11,7,4,364.77435776875996,0.4698179271708684,0.19086884654114322,0.19465850930186682,127668.66337510105,2314.0509379696896,129982.71431307074,374,0,46.68571428571428,30,5,21,38.12923926053996,0.6107638888888889,47.34543010752687,1010.6182795698916,33.68727598566305,0
4859,4,1,0,34,0.029411764705882353,0.0,1.0,34,900,700,200,0.7777777777777778,11,7,4,375.3427569348496,0.4680072786690434,0.20818677986658574,0.20004531550923307,127617.73003472225,2780.078125000003,130397.80815972225,375,0,48.88235294117647,29,5,22,37.91451890034364,0.6131465517241379,47.395833333333336,1010.4166666666669,34.84195402298851,0
4860,4,2,3,33,0.05555555555555555,0.08333333333333333,0.9166666666666666,36,650,200,450,0.3076923076923077,11,2,9,414.1377492350129,0.46891534391534395,0.15249919403445333,0.20817184135611583,125221.05724224563,3563.463430070906,128784.52067231653,376,0,47.111111111111114,32,4,18,39.416445902190816,0.5804036458333333,49.7790404040404,1000.883838383838,31.277619949494937,16
4861,4,5,3,35,0.13157894736842105,0.07894736842105263,0.9210526315789473,38,1100,700,400,0.6363636363636364,15,7,8,380.3146421300611,0.4739361071597914,0.16595909298311762,0.19591742632447595,126234.09162649214,2007.1231570758025,128241.21478356794,377,0,45.0,32,6,20,39.21425430330442,0.5908203125,48.76893939393939,1004.9242424242419,31.40388257575756,0
4862,4,0,1,34,0.0,0.02857142857142857,0.9714285714285714,35,450,200,250,0.4444444444444444,7,2,5,409.1698431438694,0.4705182072829132,0.19315769944341388,0.2078237329952369,125651.88937717005,3282.592773437491,128934.48215060754,378,1,49.857142857142854,31,4,20,39.0930735930736,0.5873655913978495,49.34895833333333,1002.604166666666,32.3420698924731,0
4863,4,1,0,35,0.02857142857142857,0.0,1.0,35,950,800,150,0.8421052631578947,11,8,3,410.44796478204455,0.47268907563025214,0.19193949056393933,0.20946437196095571,125847.78679741736,3330.793592664908,129178.58039008226,379,0,49.97142857142857,31,4,21,38.8577082792629,0.5893817204301075,49.15364583333332,1003.3854166666652,32.367271505376294,0
4864,4,3,1,37,0.07894736842105263,0.02631578947368421,0.9736842105263158,38,800,600,200,0.75,10,6,4,376.73565056565803,0.47470661450924606,0.19712277184629312,0.19742135437718422,126932.92018990406,1964.336428969697,128897.25661887375,380,0,46.94736842105263,32,6,21,38.58356304556656,0.5979817708333333,48.07449494949495,1007.70202020202,31.490688131313124,0
4865,4,1,3,35,0.02631578947368421,0.07894736842105263,0.9210526315789473,38,850,600,250,0.7058823529411765,11,6,5,373.17242764497297,0.4732841394025604,0.19128693039559352,0.19662937678285225,127155.67926742151,1890.1987042138326,129045.87797163535,381,0,47.05263157894737,32,6,23,38.444124520113505,0.6002604166666667,47.85353535353534,1008.5858585858571,31.518308080808033,0
4866,4,2,3,34,0.05405405405405406,0.08108108108108109,0.9189189189189189,37,1250,900,350,0.72,16,9,7,368.9632460051938,0.4720658158158158,0.1772034665981641,0.1956386017942657,127410.50020406063,2001.9583460871108,129412.45855014774,382,0,42.67567567567568,32,5,19,38.288415040853764,0.6028645833333333,47.60101010101009,1009.5959595959582,31.549873737373694,0
4867,4,2,0,36,0.05555555555555555,0.0,1.0,36,1300,900,400,0.6923076923076923,17,9,8,367.6966856421513,0.47035383597883595,0.1609279151747307,0.19651399634519764,127729.38507550239,2193.1343102744495,129922.51938577683,383,0,41.111111111111114,32,4,21,37.99311974352568,0.6061197916666667,47.28535353535353,1010.8585858585849,31.589330808080778,0
4868,4,2,1,37,0.05263157894736842,0.02631578947368421,0.9736842105263158,38,950,600,350,0.631578947368421,13,6,7,347.41045648928963,0.47233582266477003,0.1499474302677961,0.18830974424992689,128295.24518140574,1314.2219387754924,129609.46712018123,384,0,39.89473684210526,34,4,23,37.92719349784566,0.6072303921568627,46.72619047619047,1013.0952380952369,29.79691876750697,0
4869,4,1,4,34,0.02631578947368421,0.10526315789473684,0.8947368421052632,38,650,300,350,0.46153846153846156,10,3,7,373.86191383218767,0.471743124703651,0.14400085332033052,0.18628376375885378,124855.365936321,1738.9219877444098,126594.28792406541,385,0,40.73684210526316,35,3,19,40.803536961976455,0.5699404761904762,50.14467592592592,999.421296296295,28.554894179894145,16
4870,4,7,4,37,0.17073170731707318,0.0975609756097561,0.9024390243902439,41,1050,800,250,0.7619047619047619,13,8,5,340.24746410115284,0.47693089430894314,0.20548985333078473,0.1760376508935859,126411.62065781992,407.96003183018945,126819.58068965012,386,0,38.292682926829265,36,5,17,40.03826054497948,0.583912037037037,48.59234234234234,1005.6306306306301,27.93418418418417,0
4871,4,4,2,39,0.0975609756097561,0.04878048780487805,0.9512195121951219,41,1300,900,400,0.6923076923076923,17,9,8,370.9717584938146,0.4773882113821138,0.17223171555887684,0.1852355046067541,124943.70003449406,1240.877744298363,126184.57777879243,387,0,39.048780487804876,36,5,19,40.784101148907396,0.5688657407407407,50.05630630630631,999.7747747747757,27.771521521521546,16
4872,4,7,6,40,0.15217391304347827,0.13043478260869565,0.8695652173913043,46,1550,800,750,0.5161290322580645,23,8,15,327.73016356198355,0.47970008051529794,0.19494609643407146,0.16997875922448835,126512.22160905277,-897.9560634989756,125614.26554555379,388,0,35.608695652173914,37,9,17,40.24965940054494,0.5830518018018018,48.49232456140351,1006.0307017543857,27.19001896633475,0
4873,4,4,4,40,0.09090909090909091,0.09090909090909091,0.9090909090909091,44,1000,600,400,0.6,14,6,8,342.82262874360487,0.4763037350246653,0.2151806359137467,0.17741428357076708,126421.84452428398,-131.94618591394263,126289.89833837004,389,0,38.09090909090909,35,9,19,39.96300398971879,0.5860119047619048,48.58217592592592,1005.6712962962952,28.733465608465576,0
4874,4,5,2,43,0.1111111111111111,0.044444444444444446,0.9555555555555556,45,900,400,500,0.4444444444444444,14,4,10,320.0346303688137,0.4802609427609428,0.2103829407167579,0.16871984603963888,127177.19144397785,-858.0072986798963,126319.18414529796,390,0,37.24444444444445,36,9,22,39.76196457147112,0.591724537037037,47.83220720720721,1008.6711711711719,28.018643643643664,0
4875,4,2,1,44,0.044444444444444446,0.022222222222222223,0.9777777777777777,45,1200,600,600,0.5,18,6,12,322.67275509175386,0.4795875420875421,0.2346373297627229,0.17150252435950064,127506.9627794129,-771.3954053170248,126735.56737409587,391,0,38.2,37,8,18,39.358172293996276,0.5931869369369369,47.50548245614035,1009.9780701754387,27.29670459933618,0
4876,4,0,1,43,0.0,0.022727272727272728,0.9772727272727273,44,1500,1000,500,0.6666666666666666,20,10,10,329.3114439075764,0.47830778717406625,0.24165120593692024,0.17515109822613162,127534.65008464166,-400.27604647581177,127134.37403816584,392,1,40.04545454545455,37,7,18,39.1622340425532,0.5934684684684685,47.47807017543861,1010.0877192982475,27.299668089141825,0
4877,4,3,2,44,0.06521739130434782,0.043478260869565216,0.9565217391304348,46,1250,800,450,0.64,17,8,9,376.4943611519874,0.48158212560386476,0.18226634714138967,0.18952632336586467,125281.69005153811,773.3273973606858,126055.0174488988,393,0,38.73913043478261,36,10,15,40.295509936257965,0.572337962962963,49.71846846846847,1001.1261261261268,27.809059059059077,15
4878,4,1,3,42,0.022222222222222223,0.06666666666666667,0.9333333333333333,45,1300,800,500,0.6153846153846154,18,8,10,391.9408781140189,0.4805976430976431,0.21037840502896588,0.18938751305175927,123564.1959372599,843.6897870806026,124407.8857243405,394,0,40.422222222222224,33,12,16,41.69786659271129,0.5609217171717171,51.43995098039217,994.2401960784329,30.12849079025554,16
4879,4,3,3,42,0.06666666666666667,0.06666666666666667,0.9333333333333333,45,1350,800,550,0.5925925925925926,19,8,11,372.10359420411936,0.48070286195286194,0.23627447291517756,0.18344272348660526,124409.48285701255,258.6431448340402,124668.1260018466,395,0,40.44444444444444,36,9,16,41.310625729013815,0.5633680555555556,50.591216216216225,997.6351351351362,27.712087087087117,0
4880,4,3,2,43,0.06666666666666667,0.044444444444444446,0.9555555555555556,45,1250,800,450,0.64,17,8,9,371.1805555555556,0.48120791245791245,0.24240740740740763,0.18559027777777787,125000.0000000001,279.5138888889019,125279.513888889,396,0,40.86666666666667,36,9,19,40.72048611111111,0.5694444444444444,50.00000000000001,1000.0000000000008,27.7777777777778,0
4881,4,3,5,41,0.06521739130434782,0.10869565217391304,0.8913043478260869,46,1600,1300,300,0.8125,19,13,6,348.6470209964377,0.481682769726248,0.24047784414502016,0.17773048464476388,125802.56615713357,-427.8620151216164,125374.70414201195,397,0,39.84782608695652,38,8,15,40.45460596379127,0.5740131578947368,49.198717948717956,1003.2051282051291,26.400134952766553,0
4882,4,2,2,41,0.046511627906976744,0.046511627906976744,0.9534883720930233,43,800,600,200,0.75,10,6,4,395.6329738716595,0.47877445551864156,0.28900644331326,0.19613294236616302,124643.11224489791,1361.8720984448944,126004.9843433428,398,0,43.0,34,9,17,40.4804482594182,0.5698529411764706,50.357142857142854,998.5714285714282,29.369747899159652,16
4883,4,5,3,43,0.10869565217391304,0.06521739130434782,0.9347826086956522,46,600,300,300,0.5,9,3,6,361.9801128728836,0.48020330112721415,0.2810691375623662,0.18462196392346078,125823.72100069253,-90.86305401661832,125732.85794667591,399,0,40.5,37,9,15,40.09836065573769,0.5760135135135135,49.17763157894737,1003.2894736842106,27.115931721194883,0
4884,4,3,5,41,0.06521739130434782,0.10869565217391304,0.8913043478260869,46,1550,1300,250,0.8387096774193549,18,13,5,363.4953589278849,0.478371578099839,0.2904274753379612,0.1874174510936667,126270.10192202333,-20.08842911658877,126250.01349290674,400,0,41.17391304347826,36,10,12,39.59967320261437,0.5824652777777778,48.733108108108105,1005.0675675675672,27.91854354354353,0
4885,4,0,1,40,0.0,0.024390243902439025,0.975609756097561,41,1350,900,450,0.6666666666666666,18,9,9,391.58761836971706,0.4763719512195122,0.2886114282137566,0.19915236054191385,125705.64994533343,1644.9552155420874,127350.60516087551,401,1,45.63414634146341,33,8,16,39.478059187746965,0.5830176767676767,49.295343137254896,1002.8186274509795,30.388443256090287,0
4886,4,3,3,40,0.06976744186046512,0.06976744186046512,0.9302325581395349,43,1300,1000,300,0.7692307692307693,16,10,6,371.42561985194374,0.4779438907345884,0.29186568302413884,0.19249016470681218,126480.04979263108,795.5861786265307,127275.63597125761,402,0,44.27906976744186,35,8,15,39.18385398688298,0.5866071428571429,48.52430555555555,1005.9027777777769,28.74007936507934,0
4887,4,1,2,39,0.024390243902439025,0.04878048780487805,0.9512195121951219,41,1350,1000,350,0.7407407407407407,17,10,7,372.7175644684087,0.47695630081300816,0.15634248392693095,0.18179489368969345,123960.50347222235,1371.0961612654405,125331.59963348779,403,0,38.170731707317074,36,5,20,41.762552301255226,0.5587384259259259,51.04166666666667,995.8333333333344,27.662037037037067,16
4888,4,6,7,38,0.13333333333333333,0.15555555555555556,0.8444444444444444,45,1200,900,300,0.75,15,9,6,328.71342358462493,0.4803030303030303,0.17113228904224664,0.1653347021434735,125246.83225848353,-761.5967172591396,124485.23554122439,404,0,35.28888888888889,37,8,14,41.52734417789463,0.5701013513513513,49.75328947368422,1000.9868421052644,27.053698435277415,0
4889,4,8,6,40,0.17391304347826086,0.13043478260869565,0.8695652173913043,46,1700,1300,400,0.7647058823529411,21,13,8,318.5584522500422,0.48151167471819645,0.22978364774065407,0.16506482267111425,126473.33311646209,-1139.6423292428426,125333.69078721925,405,0,34.76086956521739,38,8,14,40.52022481855193,0.5808662280701755,48.5309829059829,1005.8760683760681,26.470422852001793,0
4890,4,2,0,42,0.047619047619047616,0.0,1.0,42,1450,1100,350,0.7586206896551724,18,11,7,338.66871955505957,0.4773640147115757,0.2334676463616967,0.17403694613919563,126133.5104875283,143.49489795917347,126277.00538548747,406,0,38.666666666666664,34,8,22,40.364027810697614,0.585171568627451,48.86904761904761,1004.5238095238092,29.544817927170858,0
4891,4,2,1,43,0.045454545454545456,0.022727272727272728,0.9772727272727273,44,1550,1000,550,0.6451612903225806,21,10,11,326.18744486193333,0.47792239252995067,0.2488008861248303,0.17064753694355866,126865.01323959084,-523.6450978005118,126341.36814179033,407,0,37.86363636363637,36,8,20,39.92659661673747,0.5885416666666667,48.14189189189189,1007.4324324324316,27.98423423423421,0
4892,4,1,4,40,0.022727272727272728,0.09090909090909091,0.9090909090909091,44,1350,1000,350,0.7407407407407407,17,10,7,330.49345757366063,0.47635879140239606,0.26655706427976966,0.17435573574469101,127205.59030314106,-391.876927603273,126813.71337553779,408,0,38.81818181818182,36,8,22,39.46914303788047,0.5920138888888888,47.804054054054056,1008.7837837837844,28.02177177177179,0
4893,4,1,2,39,0.024390243902439025,0.04878048780487805,0.9512195121951219,41,1200,700,500,0.5833333333333334,17,7,10,366.33423267665836,0.47619410569105686,0.15427126781085732,0.18356031945032544,125089.30165816314,1207.3518473313202,126296.65350549445,409,0,40.51219512195122,34,7,17,40.74908762743465,0.5744485294117647,49.91071428571428,1000.3571428571418,29.422268907562994,15
4894,4,3,3,39,0.07142857142857142,0.07142857142857142,0.9285714285714286,42,1250,900,350,0.72,16,9,7,367.42929698669667,0.47622677119628337,0.18322790370760855,0.18787422544036778,125927.64060356669,853.9008916323926,126781.54149519908,115,0,30.357142857142858,35,7,17,39.85432041820417,0.5809523809523809,49.07407407407408,1003.703703703705,28.677248677248713,0
4895,4,4,3,40,0.09302325581395349,0.06976744186046512,0.9302325581395349,43,900,400,500,0.4444444444444444,14,4,10,404.09841502837355,0.47805924695459584,0.1452691940108315,0.20132974446072355,124851.23476473901,1810.0102618207538,126661.24502655977,116,0,30.186046511627907,34,9,18,40.052362517371456,0.5719975490196079,50.14880952380951,999.4047619047601,29.39425770308118,16
4896,4,6,5,41,0.13043478260869565,0.10869565217391304,0.8913043478260869,46,1250,800,450,0.64,17,8,9,362.92750517800096,0.4812198067632851,0.16653320053453147,0.1875521259655736,126363.65265185604,-27.56522828397007,126336.08742357207,117,0,26.869565217391305,35,11,15,39.517502206361996,0.5854166666666667,48.64004629629629,1005.4398148148141,28.72685185185183,0
4897,4,2,2,41,0.046511627906976744,0.046511627906976744,0.9534883720930233,43,1300,500,800,0.38461538461538464,21,5,16,387.3254998408663,0.47918973791066816,0.189388384654259,0.1998378680643638,126297.54178463918,1183.6517000815995,127481.19348472077,118,0,29.348837209302324,32,11,17,38.972543231587295,0.5914713541666667,48.70580808080807,1005.1767676767665,31.411773989898954,0
4898,4,0,3,38,0.0,0.07317073170731707,0.926829268292683,41,1400,1000,400,0.7142857142857143,18,10,8,394.10781202542927,0.4789126016260163,0.18811903070487035,0.20419066719627355,126469.13528442361,1768.494839138426,128237.63012356203,119,1,31.21951219512195,31,10,18,38.6247303128371,0.595766129032258,48.535156249999986,1005.8593749999983,32.44707661290317,0
4899,4,1,3,36,0.02564102564102564,0.07692307692307693,0.9230769230769231,39,950,800,150,0.8421052631578947,11,8,3,399.3354048434311,0.477929599640126,0.1928752065951136,0.20706478777317752,126501.88022189656,2303.335910373244,128805.21613226981,120,0,31.384615384615383,31,8,19,38.45942272844938,0.5961021505376345,48.50260416666666,1005.9895833333321,32.45127688172039,0
4900,4,4,4,36,0.1,0.1,0.9,40,1150,700,450,0.6086956521739131,16,7,9,373.1272628367574,0.4792467948717949,0.18510576551012559,0.19773449547323163,127387.59570651579,1509.1035630967835,128896.69926961257,121,0,29.475,31,9,19,38.20685003654501,0.6051747311827957,47.623697916666664,1009.5052083333328,32.56468413978493,0
4901,4,1,1,36,0.02702702702702703,0.02702702702702703,0.972972972972973,37,850,700,150,0.8235294117647058,10,7,3,407.6647922527823,0.476758008008008,0.21174715187250248,0.21393130000725077,126990.38770739388,2953.9020045669995,129944.28971196088,122,0,32.567567567567565,30,7,23,37.74503267102282,0.6038194444444445,48.01747311827957,1007.9301075268813,33.597670250896044,0
4902,4,1,2,35,0.02702702702702703,0.05405405405405406,0.9459459459459459,37,1200,1000,200,0.8333333333333334,14,10,4,395.80958189790454,0.47491241241241244,0.19571742181595742,0.20962834697131605,127363.21576193768,2682.3568837437715,130045.57264568146,123,0,32.75675675675676,30,7,21,37.6595095428318,0.6076388888888888,47.647849462365585,1009.4086021505367,33.64695340501789,0
4903,4,1,1,35,0.027777777777777776,0.027777777777777776,0.9722222222222222,36,1000,800,200,0.8,12,8,4,398.26242702896354,0.47675264550264546,0.1798475235517698,0.21145905401191528,127464.99098522938,2952.9033342004705,130417.89431942985,124,0,32.47222222222222,30,6,22,37.492790274635084,0.6086805555555556,47.54704301075268,1009.8118279569882,33.66039426523294,0
4904,4,0,0,35,0.0,0.0,1.0,35,1550,1100,450,0.7096774193548387,20,11,9,402.2106493782549,0.4771008403361345,0.1661266568483064,0.21436501642687206,127617.73003472216,3265.8420138888787,130883.57204861104,125,1,32.97142857142857,29,6,22,37.235824742268036,0.6131465517241379,47.39583333333333,1010.4166666666661,34.84195402298848,0
4905,4,0,2,33,0.0,0.05714285714285714,0.9428571428571428,35,800,300,500,0.375,13,3,10,402.2494383834916,0.4769607843137255,0.1689393195783193,0.21475929296527288,127687.90750385798,3272.4778163580186,130960.385320216,126,2,33.97142857142857,29,6,22,37.16260707251156,0.6138649425287357,47.326388888888886,1010.694444444444,34.851532567049794,0
4906,4,0,1,32,0.0,0.030303030303030304,0.9696969696969697,33,1150,700,450,0.6086956521739131,16,7,9,408.3563892621528,0.4751025883838384,0.15375904948648467,0.21840015851867814,127758.10426311725,3834.167631172837,131592.27189429008,127,3,35.57575757575758,29,4,22,36.93602028666942,0.6145833333333333,47.25694444444444,1010.972222222222,34.8611111111111,0
4907,4,3,5,30,0.08571428571428572,0.14285714285714285,0.8571428571428572,35,650,200,450,0.3076923076923077,11,2,9,377.7768692151826,0.47510504201680676,0.1336144158677206,0.2068879228245901,128705.44645521369,2724.971648793152,131430.41810400685,128,0,33.25714285714286,31,4,20,36.73823196030625,0.6186155913978495,46.32161458333333,1014.7135416666661,32.7326948924731,0
4908,4,0,0,30,0.0,0.0,1.0,30,1250,1000,250,0.8,15,10,5,424.18685121107245,0.4714798850574713,0.12890196078431337,0.22820178704393151,127993.90589569173,4858.66638321997,132852.5722789117,129,1,35.43333333333333,27,3,23,36.292892156862756,0.6234567901234568,47.02380952380953,1011.9047619047628,37.477954144620846,0
4909,4,1,0,31,0.03225806451612903,0.0,1.0,31,1100,800,300,0.7272727272727273,14,8,6,408.4410584654167,0.4690860215053763,0.12210349271931231,0.22278029294041024,128544.89736094583,4300.602787686604,132845.50014863245,130,0,35.25806451612903,28,3,22,36.12508264853122,0.6257440476190477,46.47988505747126,1014.0804597701139,36.21715927750407,0
4910,4,1,1,31,0.03125,0.03125,0.96875,32,950,700,250,0.7368421052631579,12,7,5,396.9180484464852,0.46870799731182794,0.11882863785558007,0.21854403390366728,128919.13580246917,3834.0663580246974,132753.20216049388,131,0,35.125,29,3,23,36.03380288110867,0.6264367816091954,46.111111111111114,1015.5555555555559,35.01915708812262,0
4911,4,1,0,32,0.03125,0.0,1.0,32,700,400,300,0.5714285714285714,10,4,6,385.8007823213356,0.46784694220430106,0.09682290194970289,0.21434049743095884,129274.43560906338,3575.4529623757826,132849.88857143917,132,0,34.09375,28,4,24,35.95295281152866,0.6331845238095238,45.76149425287357,1016.9540229885066,36.319786535303805,0
4912,4,0,1,31,0.0,0.03125,0.96875,32,800,500,300,0.625,11,5,6,386.2954165593655,0.4666288642473118,0.09349406947190064,0.21541292441523036,129420.59097965377,3598.916220768918,133019.5072004227,133,1,35.09375,28,4,24,35.79114892215006,0.6346726190476191,45.61781609195402,1017.5287356321833,36.34031198686369,0
4913,4,0,1,30,0.0,0.03225806451612903,0.967741935483871,31,850,500,350,0.5882352941176471,12,5,7,396.11492335000656,0.4646953405017921,0.10035632536517469,0.22029662336023526,129314.88106310219,4044.7108400651773,133359.59190316737,134,2,36.935483870967744,27,4,25,35.64938429651307,0.6369598765432098,45.72172619047618,1017.1130952380942,37.67085537918867,0
4914,4,0,0,30,0.0,0.0,1.0,30,1000,600,400,0.6,14,6,8,394.16572620635424,0.4615181992337165,0.081598440545809,0.22026908229178607,129504.14540816324,4209.219104308388,133713.36451247163,135,3,36.93333333333333,27,3,23,35.50560428849903,0.6388888888888888,45.535714285714285,1017.8571428571427,37.69841269841269,0
4915,4,0,2,28,0.0,0.06666666666666667,0.9333333333333333,30,700,400,300,0.5714285714285714,10,4,6,407.8211055646633,0.4610632183908046,-0.04134477825464944,0.20930025902327423,126079.9085909631,4343.487660125478,130423.39625108858,136,4,37.93333333333333,28,2,21,38.6829399141631,0.6004464285714286,48.922413793103445,1004.3103448275858,35.86822660098521,16
4916,4,4,1,31,0.125,0.03125,0.96875,32,900,700,200,0.7777777777777778,11,7,4,366.52418122537483,0.46442372311827956,-0.0551171572424477,0.19313580324977914,127157.66906738281,2921.2721082899316,130078.94117567275,137,0,34.0625,31,1,20,38.609712539805486,0.6028225806451613,47.8515625,1008.59375,32.53528225806452,0
4917,4,0,1,30,0.0,0.03225806451612903,0.967741935483871,31,1450,1200,250,0.8275862068965517,17,12,5,377.7064408168844,0.462589605734767,-0.042122100773126614,0.198706431908013,127092.0138888888,3400.6944444444384,130492.70833333324,138,1,36.16129032258065,30,1,22,38.39531680440772,0.6048611111111111,47.916666666666664,1008.3333333333326,33.611111111111086,0
4918,4,2,1,31,0.0625,0.03125,0.96875,32,1150,900,250,0.782608695652174,14,9,5,359.7831863109788,0.46072748655913975,-0.04349226804123707,0.19175257731958747,127617.73003472216,2782.9427083333235,130400.67274305549,139,0,35.3125,31,1,18,38.30756013745704,0.6075268817204301,47.39583333333333,1010.4166666666661,32.594086021505355,0
4919,4,0,3,28,0.0,0.0967741935483871,0.9032258064516129,31,800,300,500,0.375,13,3,10,370.66288542520834,0.460573476702509,-0.041602253598543415,0.19663980192896632,127431.06139438081,3246.7929818476086,130677.85437622842,140,1,37.45161290322581,30,1,18,38.224396521121754,0.6083333333333334,47.58064516129032,1009.6774193548383,33.65591397849461,0
4920,4,1,1,28,0.034482758620689655,0.034482758620689655,0.9655172413793104,29,950,800,150,0.8421052631578947,11,8,3,403.2012235836935,0.4572044334975369,-0.04666409012181305,0.2062233009794304,125939.25781249999,4355.772569444444,130295.03038194442,141,0,40.689655172413794,29,0,22,38.9446692956967,0.5959051724137931,49.0625,1003.7499999999999,34.61206896551724,16
4921,4,1,1,28,0.034482758620689655,0.034482758620689655,0.9655172413793104,29,400,0,400,0.0,8,0,8,432.4612340919739,0.4595648604269294,0.04307333548539427,0.20870701634499358,123511.4028742283,4882.778742283938,128394.18161651223,142,0,41.275862068965516,29,0,20,40.74609356806856,0.5707614942528736,51.49305555555555,994.0277777777769,34.27681992337162,16
4922,4,7,4,31,0.2,0.11428571428571428,0.8857142857142857,35,950,600,350,0.631578947368421,13,6,7,368.09327868156544,0.46943277310924375,0.07540087896424774,0.18657298694883187,125566.11571712005,2252.9255046926046,127819.04122181266,143,0,34.91428571428571,34,1,16,40.21137704398782,0.5793504901960784,49.4345238095238,1002.2619047619037,29.47829131652658,0
4923,4,4,3,32,0.11428571428571428,0.08571428571428572,0.9142857142857143,35,950,700,250,0.7368421052631579,12,7,5,368.4244637621051,0.4711834733893558,0.01711545555145677,0.18061459697270668,124174.16265679082,2227.8387978966266,126402.00145468744,144,0,35.8,33,2,21,41.647070576662955,0.5672348484848485,50.82720588235295,996.6911764705897,30.2027629233512,15
4924,4,2,1,33,0.058823529411764705,0.029411764705882353,0.9705882352941176,34,950,700,250,0.7368421052631579,12,7,5,367.39081492182373,0.47073677956030896,0.014570759391045796,0.17259439003161944,122362.54591368236,2204.9458302452904,124567.49174392765,145,0,34.970588235294116,32,2,18,43.56415900969882,0.55078125,52.651515151515156,989.3939393939401,30.918560606060627,16
4925,4,10,7,36,0.23255813953488372,0.16279069767441862,0.8372093023255813,43,1000,700,300,0.7,13,7,6,322.865344013008,0.4771133259505353,0.10504902192961674,0.15948378663016813,124492.38631105835,-416.91104486948007,124075.47526618886,146,0,28.3953488372093,40,3,14,42.45290224032587,0.5572916666666667,50.50813008130082,997.9674796747977,24.949186991869944,16
4926,4,3,1,38,0.07692307692307693,0.02564102564102564,0.9743589743589743,39,1150,700,450,0.6086956521739131,16,7,9,345.3716893782721,0.4766081871345029,0.13127822047958215,0.17077232419393887,124534.42555642132,802.1329880347888,125336.55854445611,147,0,31.94871794871795,37,2,17,41.84781116115566,0.5627815315315315,50.46600877192983,998.1359649122817,26.976647700331938,0
4927,4,7,4,41,0.15555555555555556,0.08888888888888889,0.9111111111111111,45,1350,1100,250,0.8148148148148148,16,11,5,322.90794768702125,0.47815656565656567,0.20385496697668137,0.16671218259499035,126324.6290237293,-830.9250056079343,125493.70401812137,148,0,28.533333333333335,40,5,15,40.56350249359751,0.5760416666666667,48.67886178861789,1005.2845528455288,25.13211382113822,0
4928,4,2,4,39,0.046511627906976744,0.09302325581395349,0.9069767441860466,43,1300,1100,200,0.8461538461538461,15,11,4,355.85026192334107,0.4759597637504614,0.2424374147912507,0.18450914461840173,126500.20089122634,403.02592409961585,126903.22681532595,149,0,30.72093023255814,38,5,17,39.55479148966297,0.581140350877193,48.50427350427349,1005.9829059829044,26.47323436797117,0
4929,4,3,2,40,0.07142857142857142,0.047619047619047616,0.9523809523809523,42,1650,1200,450,0.7272727272727273,21,12,9,318.50850939402835,0.4747749709639954,0.1106904604815313,0.1565684532123942,124288.29663935052,-6.745766195910733,124281.55087315461,150,0,31.476190476190474,37,5,16,42.77270727952496,0.5602477477477478,50.71271929824561,997.1491228070172,26.949976292081544,16
4930,4,3,1,42,0.06976744186046512,0.023255813953488372,0.9767441860465116,43,1650,1200,450,0.7272727272727273,21,12,9,324.15261399887413,0.4776439645625692,0.15204842306467037,0.16261091823747814,125137.09897516551,-485.2645766004822,124651.83439856503,151,0,31.558139534883722,37,6,20,41.7546803652968,0.5689752252252251,49.86293859649123,1000.5482456140357,27.04184447605502,0
4931,4,2,3,41,0.045454545454545456,0.06818181818181818,0.9318181818181819,44,1400,800,600,0.5714285714285714,20,8,12,315.47763366030597,0.47809857293868924,0.15285271468009887,0.16030089831629513,125668.62678290959,-870.8717994375113,124797.75498347207,152,0,31.727272727272727,38,6,19,41.424258568637896,0.5726425438596492,49.332264957264954,1002.6709401709397,26.386077372919466,0
4932,4,1,4,38,0.023809523809523808,0.09523809523809523,0.9047619047619048,42,1100,600,500,0.5454545454545454,16,6,10,356.4088201014255,0.47731562137049943,0.1308833900591786,0.17351188013088237,123880.72197567414,552.5291748849656,124433.25115055911,153,0,33.357142857142854,38,4,17,42.251556127924445,0.5542763157894737,51.12179487179488,995.5128205128225,26.19770580296901,14
4933,4,3,0,41,0.07317073170731707,0.0,1.0,41,1450,1100,350,0.7586206896551724,18,11,7,339.8531071849235,0.4794969512195122,0.17609402538128127,0.16837336202534917,124616.52263196383,270.288166727692,124886.81079869153,154,0,34.1219512195122,37,4,17,41.900486858481585,0.5636261261261262,50.38377192982457,998.4649122807031,26.985538169748732,0
4934,4,4,3,42,0.08888888888888889,0.06666666666666667,0.9333333333333333,45,1450,1000,450,0.6896551724137931,19,10,9,315.18484847005783,0.4813762626262626,0.1794041786337781,0.1600256577538404,125635.96946468708,-1079.7000768002724,124556.2693878868,155,0,32.0,40,5,17,41.46519682378781,0.5690104166666667,49.364837398373986,1002.5406504065045,25.06351626016261,0
4935,4,1,5,38,0.023255813953488372,0.11627906976744186,0.8837209302325582,43,1500,1400,100,0.9333333333333333,16,14,2,327.8056106698942,0.47962809154669617,0.20243255186135878,0.16713053659935134,125808.5951063367,-351.8473307291756,125456.74777560752,156,0,34.18604651162791,39,4,18,40.97110459280795,0.5723824786324787,49.19270833333333,1003.2291666666657,25.723824786324762,0
4936,4,3,2,39,0.07317073170731707,0.04878048780487805,0.9512195121951219,41,1050,800,250,0.7619047619047619,13,8,5,330.1955945534388,0.47759146341463415,0.1968787515006003,0.16988109112258024,126181.50686990202,133.13526307370583,126314.64213297573,157,0,34.34146341463415,37,4,21,40.52746098439376,0.5796734234234234,48.82127192982455,1004.7149122806997,27.15445708866756,0
4937,4,1,2,38,0.025,0.05,0.95,40,1450,1100,350,0.7586206896551724,18,11,7,332.1428404415437,0.47678952991452994,0.18904098085320764,0.1719633453903436,126439.93391617968,399.22375923219846,126839.15767541189,158,0,35.3,36,4,18,40.21292875004663,0.5842013888888888,48.564189189189186,1005.7432432432431,27.937312312312308,0
4938,4,3,2,39,0.07317073170731707,0.04878048780487805,0.9512195121951219,41,1300,700,600,0.5384615384615384,19,7,12,325.8308127577885,0.47771849593495935,0.2014781644444683,0.1711821995711487,127036.7384676052,78.49674899966885,127115.23521660487,159,0,35.048780487804876,37,4,22,39.759625842941034,0.5884009009009009,47.971491228070164,1008.1140350877175,27.246325272641013,0
4939,4,2,3,38,0.04878048780487805,0.07317073170731707,0.926829268292683,41,1250,700,550,0.56,18,7,11,322.75728296333733,0.47677845528455287,0.19321144561590686,0.17075270188414587,127319.21744379525,18.6529611656793,127337.87040496092,160,0,35.63414634146341,36,5,13,39.54799895856581,0.5931712962962963,47.69144144144145,1009.234234234235,28.034284284284308,0
4940,4,4,4,38,0.09523809523809523,0.09523809523809523,0.9047619047619048,42,1850,1400,450,0.7567567567567568,23,14,9,317.46006565756716,0.4760090011614402,0.19919731578268207,0.17036469492094575,127894.8585742728,-279.69795994921833,127615.16061432358,161,0,35.57142857142857,37,5,16,39.09383468834688,0.5971283783783784,47.12171052631579,1011.5131578947364,27.338193456614498,0
4941,4,2,1,39,0.05,0.025,0.975,40,900,600,300,0.6666666666666666,12,6,6,330.6108660496019,0.4731169871794872,0.20324047591808703,0.17761951936936501,127939.53517500422,459.6401052383287,128399.17528024255,162,0,36.825,35,5,18,38.71565515005908,0.6014880952380952,47.07754629629629,1011.6898148148143,28.905423280423268,0
4942,4,0,1,38,0.0,0.02564102564102564,0.9743589743589743,39,1300,1100,200,0.8461538461538461,15,11,4,334.4287308351153,0.473487404408457,0.20010019798155376,0.1793754101751981,127873.46938775496,752.9124149659642,128626.38180272092,163,1,38.64102564102564,34,5,18,38.686587806026346,0.6029411764705883,47.14285714285713,1011.4285714285703,29.74789915966383,0
4943,4,0,1,37,0.0,0.02631578947368421,0.9736842105263158,38,900,400,500,0.4444444444444444,14,4,10,370.560480240525,0.4731952347083926,0.155960211175318,0.18987284874535768,126013.95266439904,1768.1299603174507,127782.0826247165,164,2,40.526315789473685,34,4,18,39.68658604062919,0.5839460784313726,48.988095238095234,1004.0476190476186,29.530812324929958,16
4944,4,1,2,36,0.02631578947368421,0.05263157894736842,0.9473684210526316,38,1650,1300,350,0.7878787878787878,20,13,7,360.7874158007,0.472365457562826,0.1588606253972602,0.18648779154545347,126372.79620181394,1518.7429138321822,127891.53911564613,165,0,41.23684210526316,34,4,15,39.56187347067644,0.5876225490196079,48.63095238095237,1005.4761904761895,29.572829131652632,0
4945,4,3,1,38,0.07692307692307693,0.02564102564102564,0.9743589743589743,39,1050,800,250,0.7619047619047619,13,8,5,347.2854223618794,0.47104138551506974,0.18476734015955376,0.18204781291420116,126946.17419249388,1017.3111443329806,127963.48533682687,166,0,41.0,35,4,19,39.311880287890986,0.5913690476190476,48.06134259259259,1007.7546296296287,28.79298941798939,0
4946,4,2,3,37,0.05,0.075,0.925,40,950,600,350,0.631578947368421,13,6,7,335.73258123048845,0.4716746794871795,0.1813288236642978,0.17790155367511046,127383.94445516104,553.4718203446374,127937.41627550568,167,0,40.8,35,5,16,39.154341511885654,0.5958333333333333,47.62731481481481,1009.4907407407396,28.84259259259256,0
4947,4,1,1,37,0.02631578947368421,0.02631578947368421,0.9736842105263158,38,1050,700,350,0.6666666666666666,14,7,7,343.1952853668527,0.4719357515410147,0.17380090750522936,0.18175845250628025,127362.24666950128,1142.0245181406062,128504.27118764189,168,0,42.473684210526315,34,4,16,38.98823564099541,0.5977328431372548,47.64880952380953,1009.4047619047631,29.68837535014009,0
4948,4,0,2,35,0.0,0.05405405405405406,0.9459459459459459,37,1150,800,350,0.6956521739130435,15,8,7,352.5179724536537,0.4698761261261261,0.17919109296325697,0.1863050696523355,127277.43686322581,1573.5167964244688,128850.95365965029,169,2,44.62162162162162,33,4,22,38.83997247186462,0.5991161616161615,47.73284313725491,1009.0686274509815,30.577837195484285,0
4949,4,0,1,34,0.0,0.02857142857142857,0.9714285714285714,35,1250,800,450,0.64,17,8,9,363.30956295344464,0.46943277310924375,0.17280053108115578,0.19159694923079207,127190.50301445862,2241.905212402353,129432.40822686098,170,3,46.22857142857143,31,4,23,38.65703390559787,0.6031586021505376,47.81901041666667,1008.7239583333339,32.53948252688174,0
4950,4,2,0,36,0.05555555555555555,0.0,1.0,36,1200,1000,200,0.8333333333333334,14,10,4,393.77759800121623,0.4693452380952381,0.13227976051629042,0.1881967182420524,123097.57185570957,2494.613233024662,125592.18508873423,171,0,44.416666666666664,35,1,21,42.14048285514346,0.5517857142857143,51.90972222222221,992.3611111111086,28.35317460317453,16
4951,4,7,4,39,0.16279069767441862,0.09302325581395349,0.9069767441860466,43,1100,800,300,0.7272727272727273,14,8,6,352.4305555555555,0.47928202288667404,0.17519379844961258,0.17621527777777785,125000.00000000012,263.57060185186504,125263.57060185198,172,0,38.02325581395349,36,7,18,41.18923611111111,0.5694444444444444,50.00000000000001,1000.0000000000009,27.777777777777803,0
4952,4,5,4,40,0.11363636363636363,0.09090909090909091,0.9090909090909091,44,1000,800,200,0.8,12,8,4,330.46261851866444,0.4809945384073291,0.20884383672916762,0.16967116748738265,126097.48389445955,-465.89905672432417,125631.58483773522,173,0,36.38636363636363,38,6,14,40.60716058575329,0.5770285087719298,48.90491452991456,1004.3803418803459,26.431061628430154,0
4953,4,2,0,42,0.047619047619047616,0.0,1.0,42,1350,1100,250,0.8148148148148148,16,11,5,342.0222856263695,0.47922715834301205,0.22257819925458344,0.17549797141633894,126072.10884871386,223.894164434734,126296.0030131486,174,0,39.0,36,6,18,40.343032817522605,0.5804398148148149,48.930180180180194,1004.2792792792816,27.896646646646712,0
4954,4,2,3,41,0.045454545454545456,0.06818181818181818,0.9318181818181819,44,1050,800,250,0.7619047619047619,13,8,5,358.62177723366085,0.48059813248766736,0.06797831206209803,0.18175207413446637,125561.52664776461,572.1688139242683,126133.69546168887,175,0,38.18181818181818,38,6,17,40.453443129730296,0.571546052631579,49.43910256410256,1002.2435897435896,26.37483130904183,15
4955,4,3,2,42,0.06818181818181818,0.045454545454545456,0.9545454545454546,44,1000,500,500,0.5,15,5,10,348.12429949966247,0.47891340732910503,0.13585814534353569,0.18019165208865137,126429.50234687587,4.485500545446655,126433.98784742132,176,0,38.81818181818182,37,7,18,39.82183093472887,0.5822072072072072,48.57456140350877,1005.7017543859641,27.18112849691795,0
4956,4,1,2,41,0.023255813953488372,0.046511627906976744,0.9534883720930233,43,1150,700,450,0.6086956521739131,16,7,9,355.96135596011806,0.4766749723145072,0.15600612665746127,0.1858355170082508,126779.94030770639,425.7518920948031,127205.6921998012,177,0,40.02325581395349,36,7,19,39.26418241455143,0.5876736111111112,48.226351351351354,1007.0945945945949,27.97484984984986,0
4957,4,0,4,37,0.0,0.0975609756097561,0.9024390243902439,41,1100,600,500,0.5454545454545454,16,6,10,353.0165756017266,0.4745426829268293,0.04992400161903454,0.1737260897749905,124335.37654588927,1024.1402355300731,125359.51678141934,178,1,42.75609756097561,35,6,17,41.86358844918959,0.5645833333333333,50.665509259259274,997.3379629629648,28.49537037037042,16
4958,4,4,0,41,0.0975609756097561,0.0,1.0,41,1050,600,450,0.5714285714285714,15,6,9,334.2681357486005,0.4771341463414634,0.0325447660746736,0.1623239528864685,123774.38659690261,74.76669223463841,123849.15328913725,179,0,42.97560975609756,38,3,16,42.91299835373272,0.5531798245614035,51.22863247863248,995.08547008547,26.186459739091315,15
4959,4,8,2,47,0.16326530612244897,0.04081632653061224,0.9591836734693877,49,1100,800,300,0.7272727272727273,14,8,6,311.2134523901499,0.48201884920634924,0.1537053359549796,0.15877160876175458,125834.72222222235,-1961.530357403745,123873.19186481861,180,0,36.795918367346935,44,5,14,41.360395902547054,0.5653409090909092,49.16666666666667,1003.3333333333344,22.803030303030326,0
4960,4,1,2,46,0.020833333333333332,0.041666666666666664,0.9583333333333334,48,1350,800,550,0.5925925925925926,19,8,11,314.9060612908585,0.48230644208037826,0.14162554950966877,0.16129080881326296,125997.35189471871,-1664.5340363511727,124332.81785836753,181,0,37.979166666666664,44,4,15,41.10063328107228,0.5669981060606061,49.004629629629626,1003.9814814814808,22.817760942760927,0
4961,4,4,5,45,0.08,0.1,0.9,50,1000,500,500,0.5,15,5,10,343.89534338568774,0.48228741496598637,0.04571925082062167,0.17581776736371946,125922.23743314712,-1200.350478394128,124721.88695475299,182,0,37.16,42,8,16,40.450416747119775,0.5689484126984127,49.07945736434109,1003.6821705426363,23.897194536729437,14
4962,4,6,3,48,0.11764705882352941,0.058823529411764705,0.9411764705882353,51,1150,800,350,0.6956521739130435,15,8,7,381.2919152328611,0.4831699346405229,0.2360086195322968,0.18764091568027214,124335.37654588908,-256.2735771798049,124079.10296870928,183,0,36.529411764705884,35,16,18,41.15858670844453,0.5645833333333333,50.66550925925926,997.3379629629632,28.495370370370377,16
4963,4,3,5,46,0.058823529411764705,0.09803921568627451,0.9019607843137255,51,1450,1100,350,0.7586206896551724,18,11,7,364.3863593514398,0.4823039215686275,0.25252779497366196,0.18308244330690868,125202.62834630045,-1073.8024048354077,124128.82594146504,184,0,36.8235294117647,35,16,21,40.68041420916695,0.5735119047619048,49.797453703703695,1000.8101851851841,28.59457671957669,0
4964,4,0,6,40,0.0,0.13043478260869565,0.8695652173913043,46,1600,1100,500,0.6875,21,11,10,386.9288465392881,0.4806461352657005,0.2555776914979111,0.19376710554855367,125065.11264377179,478.2599555121588,125543.37259928395,185,1,41.15217391304348,31,15,21,40.259155601839794,0.5813172043010753,49.934895833333336,1000.2604166666674,32.26646505376347,0
4965,4,4,4,40,0.09090909090909091,0.09090909090909091,0.9090909090909091,44,1200,800,400,0.6666666666666666,16,8,8,352.354839010517,0.4822167899929528,0.2745055617704797,0.17304359083446938,124248.81714034635,229.38884635684985,124478.2059867032,186,0,41.0,35,9,19,41.96995201609784,0.5636904761904762,50.75231481481482,996.9907407407406,28.485449735449734,16
4966,4,5,4,41,0.1111111111111111,0.08888888888888889,0.9111111111111111,45,1100,600,500,0.5454545454545454,16,6,10,328.2692189580284,0.48299663299663304,0.27593221163789394,0.16554846917413998,125356.61363352188,-767.592559937725,124589.02107358415,187,0,38.6,37,8,17,41.42521168655788,0.5712274774774775,49.64364035087719,1001.4254385964915,27.065552394499772,0
4967,4,6,4,43,0.1276595744680851,0.0851063829787234,0.9148936170212766,47,1400,1000,400,0.7142857142857143,18,10,8,326.52776643065124,0.4834836571076164,0.3203874038100274,0.169241001651683,126484.6455159277,-1136.0930767159487,125348.55243921175,188,0,37.53191489361702,37,10,19,40.30820797907126,0.5827702702702703,48.519736842105246,1005.9210526315767,27.1870554765291,0
4968,4,3,2,44,0.06521739130434782,0.043478260869565216,0.9565217391304348,46,650,300,350,0.46153846153846156,10,3,7,336.26566464647965,0.4805756843800322,0.33366426256314496,0.17445978211101307,126524.89271365936,-690.8045714633766,125834.08814219598,189,0,39.19565217391305,36,10,21,40.02196664428029,0.5850694444444444,48.47972972972972,1006.081081081079,27.946696696696637,0
4969,4,1,1,44,0.022222222222222223,0.022222222222222223,0.9777777777777777,45,1400,900,500,0.6428571428571429,19,9,10,336.44755647946823,0.4799031986531987,0.3271783020860515,0.17564801503770486,126779.94030770626,-469.0397745718779,126310.90053313438,190,0,40.13333333333333,36,9,22,39.755488463975546,0.5876736111111112,48.22635135135135,1007.0945945945939,27.974849849849832,0
4970,4,3,2,45,0.06382978723404255,0.0425531914893617,0.9574468085106383,47,1350,1000,350,0.7407407407407407,17,10,7,324.5233833867722,0.4802073697193956,0.33778385343302686,0.17284152916333642,127590.03371229615,-1118.4264962349482,126471.6072160612,191,0,39.191489361702125,37,10,18,39.22653932421675,0.5940315315315315,47.42324561403509,1010.3070175438602,27.30559506875298,0
4971,4,1,1,45,0.021739130434782608,0.021739130434782608,0.9782608695652174,46,1500,1100,400,0.7333333333333333,19,11,8,323.7293456667028,0.47816022544283415,0.3230138496520363,0.17340680570092476,127820.2174761669,-924.1689266929728,126896.04854947393,192,0,40.06521739130435,38,8,19,39.01148969889067,0.5945723684210527,47.19551282051282,1011.2179487179479,26.610998650472315,0
4972,4,1,1,45,0.021739130434782608,0.021739130434782608,0.9782608695652174,46,1500,1000,500,0.6666666666666666,20,10,10,319.4025694767447,0.4784219001610306,0.31996948719605234,0.17260364918789595,128173.82979948969,-1010.957142856262,127162.87265663342,193,0,39.30434782608695,35,11,20,38.76026307768505,0.6038690476190476,46.8460648148148,1012.6157407407392,28.93187830687826,0
4973,4,1,3,43,0.021739130434782608,0.06521739130434782,0.9347826086956522,46,1450,1000,450,0.6896551724137931,19,10,9,320.25600547542797,0.4771135265700483,0.3255461340853334,0.17455115455815712,128515.36502718944,-968.4365108351535,127546.9285163543,194,0,40.19565217391305,36,10,15,38.390807789130754,0.6053240740740741,46.50900900900901,1013.9639639639647,28.165665665665685,0
4974,4,1,0,44,0.022727272727272728,0.0,1.0,44,1450,1100,350,0.7586206896551724,18,11,7,332.0330008795937,0.47438777307963353,0.31769174920914756,0.1815514193830093,128643.06205257628,-257.251612868661,128385.81043970762,195,0,41.54545454545455,35,9,20,37.962183875261445,0.6086309523809523,46.38310185185185,1014.4675925925924,28.984788359788354,0
4975,4,1,1,44,0.022222222222222223,0.022222222222222223,0.9777777777777777,45,1450,800,650,0.5517241379310345,21,8,13,321.58688660980005,0.47413720538720544,0.3067611476805401,0.177706957555934,129062.08070031142,-699.0654576408308,128363.01524267059,196,0,41.6,37,8,22,37.801135750512586,0.6089527027027026,45.970394736842096,1016.1184210526297,27.462660028449452,0
4976,4,1,0,45,0.022222222222222223,0.0,1.0,45,1650,1300,350,0.7878787878787878,20,13,7,322.86857362212044,0.4733375420875421,0.310520683420052,0.17969635400669243,129344.54038075251,-647.6674049781949,128696.87297577431,197,0,42.48888888888889,36,9,24,37.48177977047121,0.6137152777777778,45.69256756756757,1017.2297297297309,28.256381381381416,0
4977,4,0,3,42,0.0,0.06666666666666667,0.9333333333333333,45,1600,1200,400,0.75,20,12,8,357.95694753771096,0.47310606060606064,0.30313152400835053,0.17676430708305546,124479.70920138908,-20.24665078928382,124459.4625505998,198,1,43.48888888888889,37,8,18,41.59055323590815,0.5622184684684685,50.52083333333334,997.9166666666682,26.970720720720763,15
4978,4,4,5,41,0.08695652173913043,0.10869565217391304,0.8913043478260869,46,1250,800,450,0.64,17,8,9,343.53042387085213,0.478341384863124,0.243116858934753,0.16727163861844233,123888.14242683724,-688.130783907226,123200.01164293001,199,0,40.02173913043478,42,4,17,42.56436149503602,0.5481150793650793,51.11434108527131,995.542635658914,23.703396087117,16
4979,4,9,4,46,0.18,0.08,0.92,50,1500,1100,400,0.7333333333333333,19,11,8,317.9166109037169,0.48203231292517007,0.28610572931082223,0.16246573057922617,125904.40779320984,-1984.6454268740524,123919.7623663358,177,0,32.7,44,6,18,41.12060614447828,0.5660511363636364,49.09722222222222,1003.6111111111109,22.80934343434343,0
4980,4,1,6,41,0.02127659574468085,0.1276595744680851,0.8723404255319149,47,1100,600,500,0.5454545454545454,16,6,10,332.0775445123616,0.4803422756706753,0.2775866748297431,0.16935452383527583,125819.79210955242,-1043.6144770407845,124776.17763251164,178,0,34.744680851063826,41,6,20,40.85243004054189,0.569359756097561,49.181547619047635,1003.2738095238118,24.47009291521492,0
4981,4,0,2,39,0.0,0.04878048780487805,0.9512195121951219,41,1450,1000,450,0.6896551724137931,19,10,9,356.3491457801078,0.48097052845528454,0.25705568059389705,0.18024095224591352,125479.06172642241,742.8712919000113,126221.93301832242,179,1,37.51219512195122,36,5,20,40.59561275336255,0.5743634259259259,49.5213963963964,1001.9144144144148,27.830955955955964,0
4982,4,4,2,41,0.09302325581395349,0.046511627906976744,0.9534883720930233,43,1550,1200,350,0.7741935483870968,19,12,7,347.961019087761,0.4789128829826504,0.2722737679238467,0.1795627718821868,126305.47417534716,193.68078223916143,126499.15495758632,180,0,36.53488372093023,35,8,15,39.95358376511226,0.5848214285714286,48.697916666666664,1005.2083333333328,28.72023809523808,0
4983,4,2,3,40,0.046511627906976744,0.06976744186046512,0.9302325581395349,43,1550,1100,450,0.7096774193548387,20,11,9,355.15567151943975,0.47905131044665933,0.28786842084724085,0.18490020662272985,126666.55411746203,397.26901732813667,127063.82313479016,181,0,37.48837209302326,36,7,18,39.40107953909834,0.5865162037037037,48.33896396396396,1006.644144144144,27.96233733733733,0
4984,4,1,1,40,0.024390243902439025,0.024390243902439025,0.975609756097561,41,1100,800,300,0.7272727272727273,14,8,6,358.42565738098057,0.4791920731707317,0.2689847438393971,0.18761848150940683,126887.86175679442,895.9730527692035,127783.83480956362,182,0,38.146341463414636,35,6,19,39.091159295424085,0.5907738095238095,48.11921296296296,1007.5231481481482,28.78637566137566,0
4985,4,0,4,36,0.0,0.1,0.9,40,850,500,350,0.5882352941176471,12,5,7,357.85411017859576,0.4773637820512821,0.24728473019517794,0.18799211698766993,127033.66796339155,1091.9040423525262,128125.57200574408,183,1,37.425,35,5,19,38.95570225794106,0.5922619047619048,47.97453703703703,1008.1018518518512,28.802910052910033,0
4986,4,2,0,38,0.05263157894736842,0.0,1.0,38,1550,1100,450,0.7096774193548387,20,11,9,373.2620181831744,0.47618835941204357,0.2481607243916244,0.19535661471145335,126882.03124999985,1872.048611111097,128754.07986111095,184,0,39.73684210526316,34,4,21,38.72346291701131,0.5928308823529411,48.12499999999999,1007.4999999999989,29.632352941176435,0
4987,4,0,1,37,0.0,0.02631578947368421,0.9736842105263158,38,1300,1100,200,0.8461538461538461,15,11,4,368.58118669099986,0.4757882882882883,0.24054023817218972,0.1936194472021951,127032.00113378682,1764.321145124714,128796.32227891154,185,1,40.73684210526316,34,4,21,38.68706699732327,0.5943627450980392,47.976190476190474,1008.0952380952378,29.649859943977585,0
4988,4,2,4,35,0.05128205128205128,0.10256410256410256,0.8974358974358975,39,1200,1000,200,0.8333333333333334,14,10,4,362.6465376198408,0.47478070175438597,0.23440891420141652,0.19248860651386032,127452.38803854864,1444.0476190476065,128896.43565759624,186,0,40.41025641025641,34,5,19,38.40485734496581,0.5986519607843137,47.5595238095238,1009.7619047619038,29.6988795518207,0
4989,4,0,3,32,0.0,0.08571428571428572,0.9142857142857143,35,1100,700,400,0.6363636363636364,15,7,8,341.6454947065118,0.4746498599439776,-0.015242752357667033,0.17336601406323,125613.4960111496,1837.5354553586192,127451.03146650823,187,1,40.65714285714286,33,2,17,40.82518337408313,0.5820707070707071,49.38725490196079,1002.4509803921571,30.377302436125973,16
4990,4,4,4,32,0.1111111111111111,0.1111111111111111,0.8888888888888888,36,1100,700,400,0.6363636363636364,15,7,8,332.6466457902893,0.47685185185185186,0.02681765572390593,0.1721935578208555,126432.65306122437,1211.4795918367165,127644.13265306108,188,0,40.19444444444444,34,2,17,40.2077414772727,0.5882352941176471,48.57142857142856,1005.7142857142846,29.57983193277308,0
4991,4,2,1,33,0.058823529411764705,0.029411764705882353,0.9705882352941176,34,1450,1100,350,0.7586206896551724,18,11,7,342.15289290041005,0.4746174985145573,0.06278976446224749,0.1774310232355948,126505.73284614092,1856.86049235871,128362.59333849963,189,0,43.26470588235294,33,1,20,39.89358732285704,0.5912247474747474,48.49877450980392,1006.0049019607844,30.48499702911468,0
4992,4,0,0,33,0.0,0.0,1.0,33,1350,1100,250,0.8148148148148148,16,11,5,349.50093098501253,0.4739583333333333,0.059182990122216506,0.18074191002367807,126392.7469135803,2234.8765432098835,128627.62345679018,190,1,45.57575757575758,32,1,20,39.825046040515666,0.5924479166666667,48.611111111111114,1005.555555555556,31.423611111111125,0
4993,4,3,1,35,0.08333333333333333,0.027777777777777776,0.9722222222222222,36,1200,900,300,0.75,15,9,6,345.3407159037868,0.47675264550264546,0.023031992566042714,0.16903519252132707,124108.7372448978,1511.3311759888916,125620.06842088669,191,0,42.69444444444444,34,2,18,42.29017323775387,0.5643382352941176,50.89285714285713,996.4285714285701,29.306722689075592,16
4994,4,3,1,37,0.07894736842105263,0.02631578947368421,0.9736842105263158,38,1300,800,500,0.6153846153846154,18,8,10,327.27322693326465,0.4790184921763869,0.05690989464203189,0.16385799332701562,125056.31264710659,585.516597678764,125641.82924478536,192,0,41.28947368421053,36,2,19,41.76002026570593,0.5700231481481481,49.943693693693696,1000.2252252252254,27.784034034034036,0
4995,4,2,1,38,0.05128205128205128,0.02564102564102564,0.9743589743589743,39,1250,1000,250,0.8,15,10,5,327.6737188686568,0.4769455690508322,0.11335658876642496,0.16747371681458986,125909.76902074653,451.4644513843202,126361.23347213086,193,0,40.92307692307692,38,1,13,40.870280675608555,0.575109649122807,49.09188034188034,1003.6324786324782,26.411381016644164,0
4996,4,2,1,39,0.05,0.025,0.975,40,2000,1600,400,0.8,24,16,8,323.96552098672987,0.4757211538461539,0.1294018643190058,0.1677151262802615,126436.39458550351,192.20648871528095,126628.6010742188,194,0,40.825,39,1,13,40.422168997065405,0.5787927350427351,48.567708333333336,1005.7291666666671,25.78792735042736,0
4997,4,0,0,39,0.0,0.0,1.0,39,1250,700,550,0.56,18,7,11,331.5871826972392,0.4743589743589744,0.1343689933624106,0.1721548008071996,126553.9450014611,592.7332164511745,127146.67821791228,195,1,42.51282051282051,38,1,14,40.109807460890494,0.5816885964912281,48.450854700854705,1006.1965811965819,26.478857399910048,0
4998,4,1,3,37,0.025,0.075,0.925,40,1300,800,500,0.6153846153846154,18,8,10,326.62299941910544,0.4734375,0.13538759689922486,0.17127791432953088,126960.75439453124,293.6604817708329,127254.41487630206,196,0,42.425,39,1,15,39.81750645994832,0.5841346153846154,48.046875,1007.8124999999999,25.84134615384615,0
4999,4,2,0,39,0.05128205128205128,0.0,1.0,39,1550,1200,350,0.7741935483870968,19,12,7,334.4403843180705,0.47270017993702207,0.17200312377977345,0.17806690732610783,127577.25180802096,733.3970249835531,128310.64883300451,197,0,43.38461538461539,38,1,14,38.98913388324874,0.5921052631578947,47.43589743589743,1010.2564102564096,26.58569500674762,0
5000,4,1,2,38,0.025,0.05,0.95,40,1150,500,650,0.43478260869565216,18,5,13,329.1124302042749,0.4721955128205128,0.17015132798023536,0.17702093837233232,127986.37695312485,424.3815104166529,128410.75846354151,198,0,43.275,39,1,15,38.70573399217625,0.594551282051282,47.03124999999999,1011.8749999999989,25.945512820512793,0
