period,mktsize,entries,exits,surviv,entryrate,exitrate,survivrate,firms,totresinv,totinninv,totimiinv,costshareinn,firmsres,firmsinn,firmsimi,hindex,div,gini,pcm,cs,totprofits,ts,maxage,minage,avgage,actfirms,inactfirms,profitablefirms,wmc,avgproxopt,price,totoutput,avgoutput,magtechshock
1,4,40,27,13,1.0,0.675,0.32499999999999996,40,0,0,0,0,0,0,0,437.10053365015574,1.000667735042735,0.09365389463070328,0.1866499264790279,118171.86448721656,3730.597005959257,121902.46149317581,0,0,0.0,33,7,13,46.299155533148465,0.5044191919191918,56.92401960784314,972.3039215686283,29.46375519904934,0
2,4,40,36,17,0.7547169811320755,0.6792452830188679,0.3207547169811321,53,400,0,400,0.0,8,0,8,330.73333949770245,1.0006652152878568,-0.16353043280568558,0.1561389856039492,122573.44507755105,-492.1750351526643,122081.27004239839,1,0,0.24528301886792453,43,10,13,44.25076105320201,0.533187984496124,52.43844696969697,990.2462121212119,23.028981677237486,0
3,4,29,28,18,0.6304347826086957,0.6086956521739131,0.3913043478260869,46,300,100,200,0.3333333333333333,5,1,4,332.47317127094414,0.9953502415458938,-0.1508996025364846,0.1615030692987333,123787.67602237669,31.21624228396678,123818.89226466065,2,0,0.5869565217391305,41,5,16,42.943853221679475,0.5485264227642277,51.215277777777786,995.13888888889,24.271680216802196,0
4,4,24,24,18,0.5714285714285714,0.5714285714285714,0.4285714285714286,42,750,700,50,0.9333333333333333,8,7,1,332.6885265067647,0.9920150987224158,-0.23516184553883712,0.16367257718965672,124322.6255934137,-127.85777597501178,124194.76781743868,3,0,0.8809523809523809,42,0,14,42.38364749319863,0.5525793650793651,50.678294573643406,997.286821705425,23.744924326319644,0
5,4,23,20,21,0.5609756097560976,0.4878048780487805,0.5121951219512195,41,400,300,100,0.75,5,3,2,345.9936012058216,0.9841971544715448,-0.18206977633389443,0.17489929911088872,125454.47216971639,1081.2889226751256,126535.76109239152,4,0,1.2682926829268293,38,3,18,40.880389961252725,0.5704495614035088,49.54594017094016,1001.8162393162379,26.363585245164156,0
6,4,10,10,21,0.3225806451612903,0.3225806451612903,0.6774193548387097,31,850,500,350,0.5882352941176471,12,5,7,366.2163970821723,0.9709677419354839,-0.08829140861193441,0.18498376511839484,125423.53524102113,2986.431037055131,128409.96627807626,5,0,2.225806451612903,31,0,19,40.405915550933734,0.585013440860215,49.57682291666667,1001.692708333334,32.31266801075271,0
7,4,6,4,23,0.2222222222222222,0.14814814814814814,0.8518518518518519,27,700,400,300,0.5714285714285714,10,4,6,392.95462048523797,0.9669990503323838,0.004927273227199214,0.19913840248066805,125558.65852200252,4467.771001629817,130026.42952363234,6,0,3.185185185185185,27,0,22,39.59617050235091,0.5983796296296295,49.441964285714285,1002.2321428571425,37.119708994708986,0
8,4,10,8,25,0.30303030303030304,0.24242424242424243,0.7575757575757576,33,900,500,400,0.5555555555555556,13,5,8,340.1092818536478,0.9685921717171718,-0.08999483889994797,0.17784340310667837,126844.99351211071,2028.2319300269176,128873.22544213763,7,0,3.121212121212121,33,0,21,39.59651257096514,0.5946969696969697,48.161764705882355,1007.3529411764705,30.52584670231729,0
9,4,8,8,25,0.24242424242424243,0.24242424242424243,0.7575757575757576,33,800,300,500,0.375,13,3,10,331.4579602224526,0.9640151515151516,-0.0540158870255959,0.17598025723150845,127462.99500192243,1849.724865436382,129312.71986735881,8,0,3.878787878787879,33,0,14,39.18133090614887,0.6010101010101009,47.54901960784314,1009.8039215686283,30.600118835412978,0
10,4,4,4,25,0.13793103448275862,0.13793103448275862,0.8620689655172413,29,1000,800,200,0.8,12,8,4,370.0021242195031,0.9606937602627258,-0.010833772861399416,0.19415078925964838,126987.00086805572,3597.092013888909,130584.09288194463,9,0,5.206896551724138,29,0,23,38.697550640760646,0.6066810344827586,48.02083333333334,1007.916666666668,34.75574712643683,0
11,4,2,1,26,0.07407407407407407,0.037037037037037035,0.962962962962963,27,650,500,150,0.7692307692307693,8,5,3,389.2949945667538,0.9607075023741691,0.040433876499450516,0.20386051107590789,126904.52108577793,4480.658969316876,131385.1800550948,10,0,6.518518518518518,27,0,25,38.296441933737015,0.6122685185185186,48.10267857142856,1007.5892857142846,37.318121693121654,0
12,4,3,1,28,0.10344827586206896,0.034482758620689655,0.9655172413793104,29,800,500,300,0.625,11,5,6,364.58226629146606,0.9575123152709359,0.007110824571217478,0.19414139128873528,127582.64853395063,3502.874228395065,131085.5227623457,11,0,6.655172413793103,29,0,19,38.22232151040234,0.612787356321839,47.43055555555556,1010.2777777777778,34.837164750957854,0
13,4,4,4,28,0.125,0.125,0.875,32,600,300,300,0.5,9,3,6,335.0576792884098,0.9562331989247312,0.0,0.18223868897881793,128432.33471074376,2206.4480027548125,130638.78271349857,12,0,6.90625,32,0,17,38.10024289985052,0.61328125,46.590909090909086,1013.6363636363633,31.676136363636353,0
14,4,2,2,28,0.06666666666666667,0.06666666666666667,0.9333333333333333,30,500,200,300,0.4,8,2,6,356.3119585626866,0.9486590038314177,0.03207747413106965,0.1932287441471604,128314.69859232272,3144.0123135622557,131458.71090588497,13,0,8.066666666666666,30,0,22,37.681856372158855,0.6173611111111111,46.706989247311824,1013.1720430107518,33.772401433691726,0
15,4,1,2,27,0.034482758620689655,0.06896551724137931,0.9310344827586207,29,850,500,350,0.5882352941176471,12,5,7,365.8743116232344,0.9472495894909688,0.020411827520057546,0.19896801238646503,128425.93557098744,3597.550154320957,132023.4857253084,14,0,8.862068965517242,29,0,19,37.32586553393624,0.6214080459770116,46.59722222222221,1013.6111111111093,34.95210727969342,0
16,4,2,2,27,0.06896551724137931,0.06896551724137931,0.9310344827586207,29,850,600,250,0.7058823529411765,11,6,5,367.3980616151678,0.9413998357963875,0.02208859982819944,0.20121516028189032,128707.64853395069,3657.3881172839624,132365.03665123467,15,0,9.448275862068966,29,0,21,36.99927000638744,0.6242816091954022,46.31944444444445,1014.7222222222229,34.990421455938716,0
17,4,1,1,27,0.03571428571428571,0.03571428571428571,0.9642857142857143,28,600,400,200,0.6666666666666666,8,4,4,380.10140896732935,0.9399801587301587,0.020095292046857116,0.2078928000556401,128654.19649639983,4180.328271568248,132834.52476796808,16,0,10.285714285714286,28,0,21,36.73169522730491,0.6268601190476191,46.37212643678161,1014.511494252874,36.232553366174066,0
18,4,0,1,26,0.0,0.037037037037037035,0.962962962962963,27,1100,700,400,0.6363636363636364,15,7,8,421.46271721102465,0.9399335232668566,-0.006751942827704749,0.2180892069611106,126417.68751771543,5256.0684169501155,131673.75593466553,17,2,11.666666666666666,27,0,18,37.990159810594854,0.607253086419753,48.586309523809526,1005.6547619047619,37.24647266313933,7
19,4,3,3,26,0.10344827586206896,0.10344827586206896,0.896551724137931,29,800,500,300,0.625,11,5,6,393.9963131872768,0.9445812807881773,-0.02137950038483094,0.20691933727302864,127022.0003858025,4209.23996913581,131231.24035493832,18,0,11.551724137931034,29,0,19,38.056856801690095,0.6070402298850575,47.986111111111114,1008.0555555555558,34.76053639846744,0
20,4,3,3,26,0.10344827586206896,0.10344827586206896,0.896551724137931,29,1200,900,300,0.75,15,9,6,389.8745416736133,0.9412972085385878,0.010525467363939223,0.20742922762195992,127547.57185570999,4145.510223765449,131693.08207947543,19,0,12.241379310344827,29,0,17,37.61959186947156,0.6124281609195401,47.465277777777786,1010.1388888888897,34.83237547892723,0
21,4,4,4,26,0.13333333333333333,0.13333333333333333,0.8666666666666667,30,750,500,250,0.6666666666666666,10,5,5,376.21899267579005,0.9351053639846744,-0.0333510426351441,0.2024698210047193,128008.47867166724,3631.8441799629986,131640.32285163025,20,0,11.566666666666666,30,0,19,37.49142205693539,0.6142361111111111,47.009408602150536,1011.9623655913978,33.732078853046595,0
22,4,2,1,27,0.07142857142857142,0.03571428571428571,0.9642857142857143,28,550,400,150,0.7272727272727273,7,4,3,398.138255822118,0.9359016754850088,-0.007508376484922419,0.2126729407523614,127708.48041765753,4569.126329435854,132277.60674709338,21,0,13.25,28,0,20,37.24532101397773,0.6171875,47.30603448275862,1010.7758620689652,36.09913793103447,0
23,4,5,8,24,0.15625,0.25,0.75,32,550,300,250,0.5454545454545454,8,3,5,355.1278650614203,0.9378780241935485,-0.03837507778469207,0.19424454702304375,128656.40503838894,2737.8948895520853,131394.29992794103,22,0,12.4375,32,0,15,37.362839659821624,0.6155598958333334,46.369949494949495,1014.520202020202,31.70375631313131,0
24,4,4,3,25,0.14285714285714285,0.10714285714285714,0.8928571428571429,28,650,500,150,0.7692307692307693,8,5,3,394.5361890835603,0.9323743386243386,-0.0571884822062253,0.21266315624282195,128071.8045027415,4505.792335513287,132577.5968382548,23,0,13.142857142857142,28,0,23,36.96297610598534,0.620907738095238,46.946839080459775,1012.2126436781614,36.15045155993433,0
25,4,1,1,25,0.038461538461538464,0.038461538461538464,0.9615384615384616,26,750,500,250,0.6666666666666666,10,5,5,416.4952854290299,0.9241025641025641,-0.029154245205511797,0.22338053197232913,127871.23961667431,5451.553688462129,133322.79330513644,24,0,15.115384615384615,26,0,23,36.61377275963789,0.625801282051282,47.14506172839506,1011.41975308642,38.90075973409308,0
26,4,2,1,26,0.07407407407407407,0.037037037037037035,0.962962962962963,27,950,800,150,0.8421052631578947,11,8,3,403.1781112609453,0.9220085470085471,-0.01674113209188066,0.21978045201056648,128521.48216057254,4963.409686791381,133484.89184736394,25,0,15.481481481481481,27,0,19,36.28253106349673,0.628858024691358,46.50297619047619,1013.9880952380952,37.55511463844797,0
27,4,0,1,25,0.0,0.038461538461538464,0.9615384615384616,26,600,400,200,0.6666666666666666,8,4,4,446.73136094674555,0.9187179487179488,0.018213017751478988,0.22756691584277794,125772.7956866331,6037.330437433314,131810.12612406642,26,1,17.076923076923077,26,0,20,38.025641025641036,0.6041666666666666,49.22839506172839,1003.0864197530861,38.58024691358024,7
28,4,1,1,25,0.038461538461538464,0.038461538461538464,0.9615384615384616,26,1250,900,350,0.72,16,9,7,450.07735730031783,0.9226282051282051,0.023710176230916424,0.23123646520970437,126124.31171926374,6153.43111533413,132277.74283459788,27,0,17.807692307692307,25,1,20,37.57578174856415,0.6116666666666666,48.87820512820514,1004.4871794871804,40.17948717948721,0
29,4,9,9,25,0.2647058823529412,0.2647058823529412,0.7352941176470589,34,900,700,200,0.7777777777777778,11,7,4,369.7576290815432,0.9425505050505051,-0.058876998866447705,0.19797989601244717,127803.53597474517,2651.2664900518857,130454.80246479706,28,0,14.352941176470589,33,1,16,37.86498101240254,0.6044823232323233,47.21200980392156,1011.1519607843127,30.640968508615536,0
30,4,4,2,27,0.13793103448275862,0.06896551724137931,0.9310344827586207,29,650,300,350,0.46153846153846156,10,3,7,405.4470881752459,0.9242610837438423,0.029116593907882793,0.21560461648048226,127527.01190712104,4541.091128286415,132068.10303540746,29,0,17.689655172413794,28,1,20,37.24751066856331,0.6153273809523812,47.48563218390804,1010.0574712643668,36.073481116584524,0
31,4,3,2,28,0.1,0.06666666666666667,0.9333333333333333,30,700,400,300,0.5714285714285714,10,4,6,384.22123173291953,0.926867816091954,-0.0026935565006629414,0.2072974506366579,128109.37741126528,3844.4685570987504,131953.84596836404,30,0,17.1,29,1,21,37.18545639548179,0.6181752873563219,46.909722222222214,1012.36111111111,34.909003831417586,0
32,4,4,4,28,0.125,0.125,0.875,32,700,500,200,0.7142857142857143,9,5,4,359.2650179120924,0.9270413306451614,-0.02100304682488785,0.19707746760202377,128771.51701185424,2852.6202731662133,131624.13728502046,31,0,16.90625,31,1,18,37.14039448364335,0.6192876344086022,46.25651041666666,1014.9739583333322,32.74109543010749,0
33,4,0,0,28,0.0,0.0,1.0,28,1150,600,550,0.5217391304347826,17,6,11,404.91316484134205,0.9167768959435626,0.003181837274750965,0.2182424205428534,128069.20750070867,4771.381625566903,132840.58912627556,32,2,20.321428571428573,27,1,22,36.7030530236205,0.6242283950617283,46.949404761904766,1012.2023809523813,37.48897707231042,0
34,4,0,0,28,0.0,0.0,1.0,28,1050,800,250,0.7619047619047619,13,8,5,406.0866340121393,0.9162257495590829,0.005536895140127784,0.21949321242673614,128182.2014287486,4810.615743693313,132992.8171724419,33,3,21.321428571428573,27,1,22,36.55721895664953,0.6253858024691358,46.83779761904762,1012.6488095238096,37.505511463844805,0
35,4,2,1,29,0.06666666666666667,0.03333333333333333,0.9666666666666667,30,950,700,250,0.7368421052631579,12,7,5,381.9683019944672,0.9170019157088123,0.017801476620180612,0.2106874932720612,128989.67013888882,3853.99305555555,132843.66319444438,34,0,20.833333333333332,29,1,20,36.34126333059887,0.6271551724137931,46.041666666666664,1015.8333333333327,35.02873563218389,0
36,4,1,3,27,0.03333333333333333,0.1,0.9,30,450,200,250,0.4444444444444444,7,2,5,381.8929405500229,0.9166187739463602,0.014585041450305036,0.21139883047995967,129130.79668209868,3862.8279320987526,132993.62461419744,35,0,21.3,29,1,21,36.19898423977407,0.6285919540229885,45.90277777777777,1016.3888888888881,35.047892720306486,0
37,4,2,2,27,0.06896551724137931,0.06896551724137931,0.9310344827586207,29,450,300,150,0.6666666666666666,6,3,3,392.89585098576805,0.9091748768472906,0.01120336198364802,0.21727539906351348,129091.85751502842,4343.93104274012,133435.78855776854,36,0,21.482758620689655,28,1,22,35.95922286629907,0.6313244047619048,45.94109195402299,1016.2356321839081,36.29412972085386,0
38,4,4,3,28,0.12903225806451613,0.0967741935483871,0.9032258064516129,31,900,500,400,0.5555555555555556,13,5,8,359.4488316950775,0.921236559139785,0.06528743639824319,0.19458263477773213,128243.42727661147,3019.390021430136,131262.8172980416,37,0,19.806451612903224,31,0,20,37.67528495522131,0.6139112903225805,46.77734375000001,1012.8906250000011,32.67389112903229,8
39,4,4,4,28,0.125,0.125,0.875,32,850,600,250,0.7058823529411765,11,6,5,349.7287486330947,0.9219590053763441,0.03771927096292638,0.19175441210865052,128752.49496224885,2605.6897893072287,131358.18475155608,38,0,19.15625,32,0,19,37.4017686820934,0.6165364583333333,46.27525252525253,1014.8989898989907,31.71559343434346,0
40,4,2,2,28,0.06666666666666667,0.06666666666666667,0.9333333333333333,30,1150,1000,150,0.8695652173913043,13,10,3,366.32182759067103,0.9160919540229885,0.055870659952292456,0.20001913972497865,128587.20119377974,3420.859709214951,132008.06090299468,39,0,21.233333333333334,30,0,21,37.1496488205672,0.6201388888888888,46.43817204301076,1014.2473118279578,33.808243727598594,0
41,4,1,0,29,0.034482758620689655,0.0,1.0,29,650,500,150,0.7692307692307693,8,5,3,375.5301182210548,0.911535303776683,0.0787907416154936,0.20457984052341047,128496.3348765433,3850.8487654321143,132347.18364197543,40,0,22.93103448275862,29,0,22,37.00913242009132,0.6221264367816092,46.527777777777786,1013.8888888888896,34.96168582375481,0
42,4,1,1,29,0.03333333333333333,0.03333333333333333,0.9666666666666667,30,800,600,200,0.75,10,6,4,366.91768477909494,0.9131704980842912,0.06525883754799455,0.20155121986447294,128825.87808200369,3453.6985850965443,132279.57666710025,41,0,23.133333333333333,30,0,22,36.89069464671876,0.6225694444444445,46.20295698924731,1015.1881720430106,33.83960573476702,0
43,4,0,0,29,0.0,0.0,1.0,29,1200,900,300,0.75,15,9,6,376.13149163206157,0.9091748768472906,0.08264540780225493,0.20673091758123083,128848.62075617285,3892.8047839506207,132741.42554012348,42,2,24.93103448275862,29,0,22,36.63360693114454,0.6257183908045977,46.18055555555556,1015.2777777777778,35.009578544061306,0
44,4,0,0,29,0.0,0.0,1.0,29,800,400,400,0.5,12,4,8,377.0547141714827,0.9086617405582923,0.08432053120048288,0.20760723418839483,128919.13580246917,3921.913580246919,132841.0493827161,43,3,25.93103448275862,29,0,22,36.53811086797958,0.6264367816091954,46.111111111111114,1015.5555555555559,35.01915708812262,0
45,4,0,0,29,0.0,0.0,1.0,29,1150,1000,150,0.8695652173913043,13,10,3,375.84287333078845,0.9059934318555007,0.08227233745794504,0.20804978419324593,129130.79668209885,3906.577932098781,133037.37461419764,44,4,26.93103448275862,29,0,22,36.3527147672406,0.6285919540229885,45.902777777777786,1016.3888888888896,35.047892720306535,0
46,4,1,1,29,0.03333333333333333,0.03333333333333333,0.9666666666666667,30,1200,800,400,0.6666666666666666,16,8,8,364.9951126738849,0.9052681992337165,0.09136095715668135,0.2048839232476074,129680.10210718002,3466.520696034217,133146.62280321424,45,0,27.0,30,0,19,36.06877364300164,0.63125,45.36290322580645,1018.5483870967743,33.95161290322581,0
47,4,1,0,30,0.03333333333333333,0.0,1.0,30,550,400,150,0.7272727272727273,7,4,3,364.02155666258807,0.9006704980842912,0.08443155860130003,0.2061339979071431,130022.58209041506,3466.2045467684056,133488.78663718345,46,0,26.6,30,0,21,35.74531057810578,0.6347222222222222,45.026881720430104,1019.8924731182794,33.99641577060932,0
48,4,0,1,29,0.0,0.03333333333333333,0.9666666666666667,30,1200,800,400,0.6666666666666666,16,8,8,362.7865774809844,0.8977490421455939,0.08423987005575229,0.20633996125940943,130193.99144771078,3446.526513180714,133640.5179608915,47,1,27.6,30,0,22,35.6026932701172,0.6364583333333333,44.858870967741936,1020.5645161290328,34.018817204301094,0
49,4,1,1,29,0.03333333333333333,0.03333333333333333,0.9666666666666667,30,1050,700,350,0.6666666666666666,14,7,7,363.9408300808715,0.8943486590038314,0.08350443099061122,0.207911460673268,130365.5137154586,3489.066655104659,133854.58037056326,48,0,28.333333333333332,30,0,24,35.399118188997114,0.6381944444444443,44.690860215053775,1021.2365591397862,34.04121863799288,0
50,4,0,1,28,0.0,0.034482758620689655,0.9655172413793104,29,900,700,200,0.7777777777777778,11,7,4,373.32921590345836,0.8913177339901478,0.09600180179334794,0.21251715009097716,130227.14361496913,3923.519483024698,134150.66309799382,49,3,30.310344827586206,29,0,24,35.3000124733524,0.6397270114942528,44.82638888888889,1020.6944444444443,35.1963601532567,0
51,4,0,0,28,0.0,0.0,1.0,28,1050,700,350,0.6666666666666666,14,7,7,382.75844467778626,0.8882275132275131,0.08835062741312782,0.21787788389350898,130225.9215219975,4369.014235698233,134594.93575769573,50,4,30.821428571428573,28,0,24,35.0606465840841,0.6428571428571428,44.82758620689655,1020.6896551724128,36.45320197044332,0
52,4,3,1,30,0.0967741935483871,0.03225806451612903,0.967741935483871,31,950,600,350,0.631578947368421,13,6,7,350.04259304189304,0.8912186379928315,0.07506376975632167,0.20395815087907646,131128.00598144543,2980.0774468316113,134108.08342827705,51,0,28.741935483870968,31,0,23,34.982307822696825,0.6431451612903225,43.94531250000001,1024.218750000001,33.03931451612906,0
53,4,0,0,30,0.0,0.0,1.0,30,850,500,350,0.5882352941176471,12,5,7,358.9744984821792,0.8852969348659004,0.08338800682325176,0.20931481659775708,131155.97043372056,3416.3297418776656,134572.30017559824,52,1,30.7,30,0,24,34.72532038665093,0.6461805555555555,43.91801075268817,1024.3279569892466,34.14426523297489,0
54,4,1,0,31,0.03225806451612903,0.0,1.0,31,950,600,350,0.631578947368421,13,6,7,349.88448168151507,0.8836917562724015,0.08359744163001914,0.20600821724117918,131528.3966064453,3003.948974609374,134532.3455810547,53,0,30.677419354838708,31,0,25,34.582063975628316,0.6471774193548387,43.5546875,1025.78125,33.08971774193548,0
55,4,0,0,31,0.0,0.0,1.0,31,950,400,550,0.42105263157894735,15,4,11,351.5794791237234,0.8818100358422939,0.08329308919465372,0.20773234291253262,131661.99578179242,3057.93117947048,134719.92696126289,54,1,31.677419354838708,31,0,18,34.403810369618554,0.648521505376344,43.424479166666664,1026.3020833333326,33.106518817204275,0
56,4,1,1,31,0.03125,0.03125,0.96875,32,750,400,350,0.5333333333333333,11,4,7,341.91319183746174,0.8828125000000001,0.07552531334480284,0.20369616070082447,131976.01807213548,2624.8683170084746,134600.88638914397,55,0,31.65625,32,0,19,34.33557589907431,0.6490885416666666,43.11868686868687,1027.5252525252524,32.11016414141414,0
57,4,0,0,31,0.0,0.0,1.0,31,1150,1000,150,0.8695652173913043,13,10,3,350.78475794230735,0.878673835125448,0.0829259519644232,0.20909315027799757,131996.29041883672,3060.4573567708235,135056.74777560754,56,3,33.67741935483871,31,0,20,34.08726136171651,0.6518817204301076,43.09895833333333,1027.604166666666,33.14852150537632,0
58,4,0,0,31,0.0,0.0,1.0,31,650,500,150,0.7692307692307693,8,5,3,350.2369712031486,0.8759856630824373,0.08392979703892567,0.2095053882287925,132130.12695312497,3055.3710937499986,135185.49804687497,57,4,34.67741935483871,31,0,20,33.96656534954408,0.6532258064516129,42.96875,1028.1249999999998,33.16532258064515,0
59,4,1,0,32,0.03125,0.0,1.0,32,900,500,400,0.5555555555555556,13,5,8,342.45303297830225,0.8760080645161291,0.08094186902133904,0.20684163191889465,132495.48037190086,2674.695821854919,135170.1761937558,58,0,34.5625,32,0,21,33.799362276183466,0.654296875,42.61363636363637,1029.545454545455,32.17329545454547,0
60,4,2,4,30,0.058823529411764705,0.11764705882352941,0.8823529411764706,34,650,400,250,0.6153846153846154,9,4,5,325.5487590813302,0.873923054070113,0.06235619896972344,0.1996837292963826,133072.72002551006,1864.3317743764067,134937.05179988648,59,0,33.470588235294116,34,0,21,33.65615745548249,0.6553308823529412,42.05357142857142,1031.7857142857133,30.346638655462158,0
61,4,0,0,30,0.0,0.0,1.0,30,950,600,350,0.631578947368421,13,6,7,361.74990575161,0.8662356321839081,0.07894736842105221,0.2179322602942629,132398.00347222234,3578.993055555561,135976.9965277779,60,1,36.266666666666666,30,0,23,33.40080971659918,0.6586805555555555,42.708333333333336,1029.1666666666674,34.30555555555558,0
62,4,0,1,29,0.0,0.03333333333333333,0.9666666666666667,30,850,600,250,0.7058823529411765,11,6,5,363.2508231701084,0.8650383141762452,0.07932114882506536,0.2194401660475574,132501.77043588844,3626.275436466633,136128.04587235508,61,2,37.266666666666666,30,0,24,33.25772410791993,0.6597222222222222,42.607526881720425,1029.5698924731175,34.318996415770584,0
63,4,1,0,30,0.03333333333333333,0.0,1.0,30,750,500,250,0.6666666666666666,10,5,5,355.26620183613204,0.8597222222222223,0.050514926345978095,0.21680565109665628,132882.5970668574,3441.7391100127124,136324.3361768701,62,0,36.233333333333334,30,0,24,33.08048711597793,0.6635416666666667,42.23790322580645,1031.048387096774,34.368279569892465,0
64,4,0,0,30,0.0,0.0,1.0,30,1200,900,300,0.75,15,9,6,354.7755217089411,0.856992337164751,0.05223206531179403,0.21751253231931553,133055.88073765746,3440.993901029008,136496.87463868645,63,1,37.233333333333334,30,0,25,32.919163626888995,0.6652777777777779,42.06989247311827,1031.7204301075262,34.390681003584206,0
65,4,0,0,30,0.0,0.0,1.0,30,750,400,350,0.5333333333333333,11,4,7,355.98106406594127,0.855316091954023,0.057728870946737176,0.2188613763780914,133159.90513715456,3480.4809443288104,136640.3860814834,64,2,38.233333333333334,30,0,25,32.78367408950817,0.6663194444444445,41.96908602150537,1032.1236559139782,34.40412186379927,0
66,4,0,0,30,0.0,0.0,1.0,30,950,600,350,0.631578947368421,13,6,7,355.8176676432292,0.8548850574712644,0.060546875,0.21896471854967947,133194.588969823,3478.597597988196,136673.1865678112,65,3,39.233333333333334,30,0,25,32.75309244791667,0.6666666666666667,41.93548387096774,1032.2580645161283,34.40860215053761,0
67,4,1,1,30,0.03225806451612903,0.03225806451612903,0.967741935483871,31,1000,700,300,0.7,13,7,6,348.14935308163973,0.8560931899641577,0.06913024692867675,0.21161704917727323,132733.2305908203,3042.197672526042,135775.42826334634,66,0,38.935483870967744,31,0,18,33.413886782916364,0.6592741935483871,42.3828125,1030.46875,33.24092741935484,1
68,4,1,1,30,0.03225806451612903,0.03225806451612903,0.967741935483871,31,600,400,200,0.6666666666666666,8,4,4,349.1303307369996,0.8596774193548387,0.06313026323297999,0.2122133208488952,132733.23059082034,3068.239339192709,135801.46993001306,67,0,39.903225806451616,31,0,18,33.388615112458915,0.6592741935483871,42.3828125,1030.4687500000002,33.24092741935485,0
69,4,0,0,30,0.0,0.0,1.0,30,700,500,200,0.7142857142857143,9,5,4,359.414272462645,0.8532088122605365,0.07537952934011916,0.21772265374555327,132605.57804731763,3532.0674716730296,136137.64551899067,68,6,42.233333333333334,30,0,26,33.2520444560442,0.6607638888888889,42.50672043010753,1029.97311827957,34.33243727598566,0
70,4,0,0,30,0.0,0.0,1.0,30,850,600,250,0.7058823529411765,11,6,5,359.4102160722832,0.8517241379310345,0.07925906600573929,0.21832319464422525,132709.42630650944,3539.42471673026,136248.8510232397,69,7,43.233333333333334,30,0,20,33.14771936690148,0.6618055555555555,42.405913978494624,1030.3763440860216,34.34587813620072,0
71,4,0,0,30,0.0,0.0,1.0,30,1100,800,300,0.7272727272727273,14,8,6,359.3530307990252,0.8505747126436782,0.08139454007998537,0.21869198731483538,132778.68106139443,3542.884292981844,136321.56535437627,70,8,44.233333333333334,30,0,21,33.079573117718624,0.6625000000000001,42.33870967741935,1030.645161290323,34.35483870967743,0
72,4,0,0,30,0.0,0.0,1.0,30,650,200,450,0.3076923076923077,11,2,9,360.88589111814116,0.8491379310344828,0.08164276401564563,0.22003138194563918,132847.95388195157,3588.5904439819537,136436.54432593353,71,9,45.233333333333334,30,0,21,32.9704476314646,0.6631944444444444,42.27150537634408,1030.9139784946228,34.363799283154094,0
73,4,0,0,30,0.0,0.0,1.0,30,900,600,300,0.6666666666666666,12,6,6,359.46329404025516,0.8463122605363985,0.08576330076004357,0.22018202567908665,133021.2149706612,3563.2488221181466,136584.46379277937,72,10,46.233333333333334,30,0,23,32.833061889250814,0.6649305555555556,42.103494623655905,1031.5860215053754,34.38620071684584,0
74,4,0,0,30,0.0,0.0,1.0,30,850,400,450,0.47058823529411764,13,4,9,359.86275969105543,0.8461206896551724,0.08574095783943347,0.22083664317731666,133090.55102107167,3578.8665958492084,136669.4176169209,73,11,47.233333333333334,30,0,23,32.7531370761148,0.6656250000000001,42.03629032258063,1031.8548387096764,34.39516129032255,0
75,4,1,1,30,0.03225806451612903,0.03225806451612903,0.967741935483871,31,950,700,250,0.7368421052631579,12,7,5,347.93664825813744,0.8467741935483871,0.06947640615724926,0.2153299038439985,133404.9563937716,3083.294677734366,136488.25107150598,74,0,46.67741935483871,31,0,23,32.7456726325519,0.665994623655914,41.73177083333333,1033.0729166666658,33.3249327956989,0
76,4,0,0,30,0.0,0.0,1.0,30,900,600,300,0.6666666666666666,12,6,6,358.8445233622698,0.8450670498084292,0.07356935224955508,0.2214459817664514,133298.6675663372,3566.699365533591,136865.36693187078,75,13,49.233333333333334,30,0,24,32.57055620634299,0.6677083333333333,41.83467741935484,1032.661290322581,34.422043010752695,0
77,4,0,0,30,0.0,0.0,1.0,30,1300,1000,300,0.7692307692307693,16,10,6,359.15973092879943,0.8422892720306514,0.07026827894075294,0.22330618355484214,133576.40921277032,3595.053438258766,137171.46265102908,76,14,50.233333333333334,30,0,25,32.28394660425605,0.6704861111111111,41.56586021505377,1033.7365591397854,34.45788530465951,0
78,4,0,1,29,0.0,0.03333333333333333,0.9666666666666667,30,900,600,300,0.6666666666666666,12,6,6,357.58745836103697,0.8417145593869733,0.06622037349971865,0.22274658438635261,133645.88978855935,3558.018809978035,137203.90859853738,77,15,51.233333333333334,30,0,25,32.25497205251527,0.6711805555555556,41.498655913978496,1034.0053763440858,34.46684587813619,0
79,4,0,0,29,0.0,0.0,1.0,29,950,700,250,0.7368421052631579,12,7,5,367.3367004794684,0.8401067323481116,0.07421923862736102,0.22841161751618075,133579.88281249997,4013.758680555555,137593.64149305553,78,16,52.58620689655172,29,0,25,32.069142146983744,0.6734913793103449,41.5625,1033.7499999999998,35.64655172413792,0
80,4,0,0,29,0.0,0.0,1.0,29,1250,1000,250,0.8,15,10,5,369.06500372383,0.8390804597701149,0.08224735335797018,0.23015561287501168,133687.5868055556,4067.88194444445,137755.46875000003,79,17,53.58620689655172,29,0,25,31.91646521622348,0.6745689655172413,41.458333333333336,1034.166666666667,35.6609195402299,0
81,4,0,0,29,0.0,0.0,1.0,29,1750,1500,250,0.8571428571428571,20,15,5,369.91126525832175,0.8380541871921182,0.0830363341819027,0.23158310303987373,133831.2596450618,4101.138117283963,137932.39776234576,80,18,54.58620689655172,29,0,22,31.750559284116324,0.6760057471264368,41.31944444444445,1034.7222222222229,35.68007662835251,0
82,4,0,0,29,0.0,0.0,1.0,29,800,500,300,0.625,11,5,6,370.5907826190679,0.8368226600985221,0.08245877061469264,0.23246149091559717,133903.125,4124.652777777778,138027.77777777778,81,19,55.58620689655172,29,0,23,31.66096349973161,0.6767241379310345,41.25,1035.0,35.689655172413794,0
83,4,0,0,29,0.0,0.0,1.0,29,900,700,200,0.7777777777777778,11,7,4,408.3241604300834,0.8368226600985221,0.12359176242604031,0.2324379748257693,130227.14361496914,4834.977816358033,135062.12143132716,82,20,56.58620689655172,29,0,20,34.407033836803215,0.6397270114942528,44.82638888888889,1020.6944444444445,35.196360153256705,7
84,4,0,1,28,0.0,0.034482758620689655,0.9655172413793104,29,850,600,250,0.7058823529411765,11,6,5,407.9834748327045,0.8380541871921182,0.12213533075893168,0.2331146735619664,130372.61362135022,4837.979208182869,135210.5928295331,83,21,57.58620689655172,28,1,21,34.26743340836617,0.6443452380952381,44.68390804597701,1021.2643678160917,36.47372742200328,0
85,4,0,0,28,0.0,0.0,1.0,28,750,500,250,0.6666666666666666,10,5,5,428.22926202347435,0.8370260141093474,0.07456655891860131,0.23167951966071282,128219.87714356578,5384.989410139309,133604.8665537051,84,22,57.82142857142857,27,1,20,35.957855813497886,0.6257716049382716,46.80059523809524,1012.7976190476193,37.5110229276896,5
86,4,2,3,27,0.06666666666666667,0.1,0.9,30,700,400,300,0.5714285714285714,10,4,6,406.57056805650944,0.8504789272030652,0.04868007112570094,0.22365970075704594,128883.87586805558,4480.0781250000055,133363.9539930556,85,0,54.9,29,1,18,35.82487005881549,0.6260775862068966,46.145833333333336,1015.4166666666669,35.01436781609196,0
87,4,0,1,26,0.0,0.037037037037037035,0.962962962962963,27,950,800,150,0.8421052631578947,11,8,3,442.7586608231775,0.8325023741690408,0.08346251964991902,0.2402186232306785,128332.93750442892,5964.103909793097,134297.041414222,86,24,61.03703703703704,27,0,20,35.473423654966474,0.626929012345679,46.6889880952381,1013.2440476190482,37.52755731922401,0
88,4,1,1,26,0.037037037037037035,0.037037037037037035,0.962962962962963,27,900,700,200,0.7777777777777778,11,7,4,432.4868207187761,0.8344017094017094,0.056869772998805246,0.23710290332010067,128747.91843820864,5736.355583900229,134484.27402210888,87,0,59.03703703703704,27,0,19,35.306695992179854,0.6311728395061729,46.279761904761905,1014.8809523809525,37.58818342151676,0
89,4,0,0,26,0.0,0.0,1.0,26,750,600,150,0.8,9,6,3,445.4474796396201,0.8317307692307693,0.03173647091846843,0.24434596110006532,128770.29332895148,6272.080523167214,135042.3738521187,88,1,58.96153846153846,26,0,19,34.95482996300237,0.6350160256410255,46.25771604938272,1014.96913580247,39.03727445394115,0
90,4,2,2,26,0.07142857142857142,0.07142857142857142,0.9285714285714286,28,400,200,200,0.5,6,2,4,418.8107925797915,0.8486000881834215,-0.00043904802277006105,0.23246462581075947,129237.90966854931,5225.246275928121,134463.15594447745,89,0,55.67857142857143,28,0,19,35.15113513258915,0.6328125,45.797413793103445,1016.8103448275858,36.31465517241378,0
91,4,3,2,27,0.10344827586206896,0.06896551724137931,0.9310344827586207,29,950,800,150,0.8421052631578947,11,8,3,407.2504611296598,0.8547824302134647,-0.0059266506427595456,0.22807892517506004,129589.9908371913,4755.116705246908,134345.1075424382,90,0,54.6551724137931,29,0,18,35.08488496339745,0.6332614942528736,45.451388888888886,1018.194444444444,35.11015325670497,0
92,4,3,3,27,0.1,0.1,0.9,30,550,500,50,0.9090909090909091,6,5,1,395.0316014298892,0.856800766283525,-0.01689076368749487,0.22330176814062133,129954.04996242333,4267.191293791177,134221.2412562145,91,0,53.733333333333334,30,0,18,35.02449688021793,0.6340277777777779,45.09408602150537,1019.6236559139779,33.9874551971326,0
93,4,0,0,27,0.0,0.0,1.0,27,900,700,200,0.7777777777777778,11,7,4,431.03177045928663,0.8389126305792973,0.022135585878275688,0.24087069525666002,129504.14540816318,5764.080215419488,135268.22562358266,92,2,60.7037037037037,27,0,19,34.56749512670565,0.6388888888888891,45.53571428571428,1017.8571428571422,37.698412698412675,0
94,4,0,0,27,0.0,0.0,1.0,27,650,500,150,0.7692307692307693,8,5,3,431.08486668413303,0.8358262108262109,0.022728748620040262,0.24183154324477096,129655.6565334467,5778.51828231292,135434.17481575962,93,3,61.7037037037037,27,0,20,34.41091954022988,0.6404320987654322,45.38690476190476,1018.4523809523808,37.720458553791886,0
95,4,0,0,27,0.0,0.0,1.0,27,550,200,350,0.36363636363636365,9,2,7,428.9877465073628,0.8353513770180437,0.01787211484889273,0.2413540756233288,129769.34800612948,5733.892033375839,135503.24003950533,94,4,62.7037037037037,27,0,20,34.34792001363125,0.6415895061728396,45.27529761904761,1018.8988095238092,37.736992945326264,0
96,4,0,1,26,0.0,0.037037037037037035,0.962962962962963,27,900,800,100,0.8888888888888888,10,8,2,431.3691685443399,0.834045584045584,0.021797304529752592,0.24363645290167116,129921.0141413335,5808.783969316877,135729.79811065036,95,5,63.7037037037037,27,0,20,34.13203060380479,0.6431327160493827,45.12648809523809,1019.4940476190466,37.759038800705426,0
97,4,2,1,27,0.07142857142857142,0.03571428571428571,0.9642857142857143,28,700,500,200,0.7142857142857143,9,5,4,417.11503634935787,0.845679012345679,0.015621421283861014,0.23789079504513258,130300.56700414541,5270.513570011335,135571.08057415675,96,0,62.07142857142857,27,1,21,34.10778919496671,0.6469907407407407,44.754464285714285,1020.9821428571429,37.81415343915344,0
98,4,0,0,27,0.0,0.0,1.0,27,700,600,100,0.8571428571428571,8,6,2,429.389923602592,0.8351139601139601,0.028436838238472095,0.243700108958557,130110.72137188197,5773.6465419500955,135884.36791383207,97,1,65.37037037037037,27,0,21,33.98847724620771,0.6450617283950617,44.94047619047618,1020.2380952380943,37.78659611992942,0
99,4,3,2,28,0.1,0.06666666666666667,0.9333333333333333,30,950,700,250,0.7368421052631579,12,7,5,393.8826364548793,0.8440613026819924,0.001153167819834433,0.22878714840889777,131008.00781249987,4320.444479875269,135328.45229237515,98,0,59.733333333333334,29,1,21,33.98156627323295,0.6476293103448276,44.06249999999999,1023.749999999999,35.301724137931,0
100,4,1,1,28,0.034482758620689655,0.034482758620689655,0.9655172413793104,29,1050,700,350,0.6666666666666666,14,7,7,405.6685762682839,0.8442118226600985,0.01917214280875279,0.2357907238570791,131033.74991742629,4831.254954419335,135865.00487184562,99,0,62.758620689655174,28,1,21,33.65375619796052,0.6510416666666667,44.03735632183908,1023.8505747126433,36.56609195402297,0
101,4,1,0,29,0.034482758620689655,0.0,1.0,29,800,500,300,0.625,11,5,6,402.72897361476845,0.8428776683087028,0.01789893051230984,0.23543139670660052,131254.50026423566,4771.998034746989,136026.49829898265,100,0,63.724137931034484,28,1,22,33.50480229949524,0.6532738095238095,43.82183908045977,1024.7126436781605,36.59688013136287,0
102,4,0,0,29,0.0,0.0,1.0,29,850,700,150,0.8235294117647058,10,7,3,405.6034488175913,0.8401067323481116,0.019106618215555704,0.23802518180611273,131401.77037917817,4859.40224930637,136261.17262848455,101,1,64.72413793103448,28,1,22,33.28165872571,0.6547619047619048,43.678160919540225,1025.2873563218386,36.61740558292281,0
103,4,0,0,29,0.0,0.0,1.0,29,650,300,350,0.46153846153846156,10,3,7,405.9771572099682,0.8390804597701149,0.018869382904512788,0.23870386722938652,131475.43640177033,4875.204782666135,136350.64118443648,102,2,65.72413793103448,28,1,22,33.1973241804427,0.6555059523809523,43.60632183908046,1025.574712643678,36.62766830870278,0
104,4,0,0,29,0.0,0.0,1.0,29,950,700,250,0.7368421052631579,12,7,5,407.10825677300386,0.8377463054187192,0.01319239554008167,0.2400627631392255,131585.97414205974,4913.947309750301,136499.92145181005,103,3,66.72413793103448,28,1,18,33.05617793959763,0.6566220238095237,43.49856321839081,1026.005747126437,36.64306239737275,0
105,4,1,1,29,0.03333333333333333,0.03333333333333333,0.9666666666666667,30,1400,1200,200,0.8571428571428571,16,12,4,397.2158494082072,0.8383141762452108,0.0029786862334029163,0.2339160002070553,131534.85952133193,4449.546190311015,135984.40571164296,104,0,65.46666666666667,30,0,19,33.361722571628235,0.65,43.54838709677419,1025.8064516129032,34.193548387096776,1
106,4,0,2,27,0.0,0.06896551724137931,0.9310344827586207,29,900,700,200,0.7777777777777778,11,7,4,405.8569922651434,0.833435960591133,-0.005626010923837743,0.23230180374397902,130439.87509645063,4787.987075617287,135227.86217206792,105,1,68.58620689655173,29,0,19,34.253200770450945,0.641882183908046,44.61805555555556,1021.5277777777778,35.225095785440615,4
107,4,0,0,27,0.0,0.0,1.0,27,1200,1100,100,0.9166666666666666,13,11,2,420.9839970977969,0.8244301994301995,0.033847631691140245,0.2405672915971839,130376.54400953084,5577.2877249858175,135953.83173451666,106,8,74.29629629629629,27,0,20,33.9314986157657,0.6477623456790124,44.68005952380952,1021.2797619047615,37.82517636684302,0
108,4,0,0,27,0.0,0.0,1.0,27,850,600,250,0.7058823529411765,11,6,5,423.6371456599904,0.823005698005698,0.03200172516038613,0.2437510209953211,130642.63791454078,5669.014845521537,136311.6527600623,107,9,75.29629629629629,27,0,17,33.59230955846676,0.6504629629629629,44.419642857142854,1022.3214285714283,37.86375661375661,0
109,4,1,1,27,0.03571428571428571,0.03571428571428571,0.9642857142857143,28,1500,1300,200,0.8666666666666667,17,13,4,413.59642174393827,0.8289792768959435,0.011480486680430335,0.2406287100219629,131070.52873976076,5242.060336570204,136312.58907633097,108,0,73.57142857142857,28,0,17,33.413427809737605,0.6514136904761905,44.001436781609186,1023.9942528735623,36.57122331691294,0
110,4,2,1,28,0.06896551724137931,0.034482758620689655,0.9655172413793104,29,500,200,300,0.4,8,2,6,400.7566945132749,0.8292282430213465,0.011488026301041732,0.2356040949272312,131470.52469135803,4737.538580246907,136208.06327160494,109,0,71.96551724137932,29,0,18,33.336154749006866,0.6522988505747127,43.61111111111111,1025.5555555555554,35.3639846743295,0
111,4,0,0,28,0.0,0.0,1.0,28,800,600,200,0.75,10,6,4,412.00670422117463,0.8218143738977072,0.029757733506857287,0.24155035617239765,131364.94510916228,5224.647616924285,136589.59272608656,110,1,75.53571428571429,28,0,19,33.15492875496379,0.6543898809523809,43.71408045977011,1025.1436781609189,36.612274220032816,0
112,4,1,1,28,0.034482758620689655,0.034482758620689655,0.9655172413793104,29,900,700,200,0.7777777777777778,11,7,4,402.766926918359,0.8283045977011494,0.02266822763378218,0.23878555659241577,131791.20611496895,4816.227816358004,136607.43393132696,111,0,73.89655172413794,29,0,18,32.959528157265886,0.6555316091954024,43.2986111111111,1026.805555555554,35.407088122605316,0
113,4,0,2,26,0.0,0.07142857142857142,0.9285714285714286,28,1000,700,300,0.7,13,7,6,415.38197113545846,0.8203262786596119,0.03653415453527442,0.24565304650593647,131696.55833003027,5340.875198176758,137037.43352820704,112,3,77.53571428571429,28,0,18,32.731721257932065,0.6577380952380953,43.39080459770114,1026.4367816091944,36.65845648604266,0
114,4,0,0,26,0.0,0.0,1.0,26,1000,500,500,0.5,15,5,10,438.8894684680579,0.8144230769230769,0.03424530596643227,0.25679867489835867,131288.5832237844,6324.235301402216,137612.81852518662,113,15,80.3076923076923,26,0,20,32.543730863825736,0.6606570512820513,43.788580246913575,1024.845679012345,39.41714150047481,0
115,4,0,0,26,0.0,0.0,1.0,26,700,400,300,0.5714285714285714,10,4,6,434.8149742685624,0.8116666666666666,0.021562999143498462,0.25573277159193475,131486.35164227994,6234.4469212010035,137720.79856348096,114,16,81.3076923076923,26,0,22,32.446835189086165,0.6626602564102565,43.59567901234566,1025.6172839506157,39.44681861348522,0
116,4,0,0,26,0.0,0.0,1.0,26,1000,700,300,0.7,13,7,6,436.69809437835215,0.8091666666666667,0.019517018840429,0.2581759133964818,131684.26890432098,6301.253858024694,137985.52276234567,115,17,82.3076923076923,26,0,18,32.19722598105548,0.6646634615384615,43.40277777777778,1026.388888888889,39.47649572649573,0
117,4,1,1,26,0.037037037037037035,0.037037037037037035,0.962962962962963,27,1000,700,300,0.7,13,7,6,423.74078991654005,0.8136277302943971,0.007508232240349466,0.2527075902559262,132015.40577168364,5788.062464569152,137803.46823625278,116,0,80.22222222222223,27,0,20,32.19362390192103,0.6643518518518519,43.08035714285714,1027.678571428571,38.0621693121693,0
118,4,1,1,26,0.037037037037037035,0.037037037037037035,0.962962962962963,27,600,300,300,0.5,9,3,6,425.9286792497205,0.8161206077872745,0.004504287116130268,0.25426874568520463,132053.64062942882,5849.08654868197,137902.7271781108,117,0,81.18518518518519,27,0,20,32.09862579026109,0.6647376543209876,43.04315476190476,1027.8273809523807,38.0676807760141,0
119,4,0,0,26,0.0,0.0,1.0,26,950,800,150,0.8421052631578947,11,8,3,436.6741981541278,0.8068589743589744,0.01949357145332553,0.26032349915025377,132001.2461181602,6328.307660798638,138329.55377895883,118,20,85.3076923076923,26,0,20,31.87571957751415,0.6678685897435898,43.094135802469125,1027.6234567901222,39.52397910731239,0
120,4,0,0,26,0.0,0.0,1.0,26,800,500,300,0.625,11,5,6,444.48192412577794,0.8055769230769231,-0.0026639272904551703,0.2563604622438233,130735.62349965706,6421.924296982164,137157.5477966392,119,21,86.3076923076923,26,0,17,32.96457673155274,0.6550480769230769,44.3287037037037,1022.6851851851851,39.33404558404558,4
121,4,0,0,26,0.0,0.0,1.0,26,450,300,150,0.6666666666666666,6,3,3,443.13437924414245,0.8042948717948718,-0.0017226778650396568,0.25663092303649854,130893.49291742871,6400.681346212461,137294.17426364118,120,22,87.3076923076923,26,0,19,32.83787010506208,0.656650641025641,44.17438271604938,1023.3024691358021,39.357787274453926,0
122,4,0,0,26,0.0,0.0,1.0,26,700,700,0,1.0,7,7,0,440.72839208423176,0.8037820512820513,-0.00172215843857626,0.2557612795008495,130972.46334876539,6344.656635802469,137317.11998456786,121,23,88.3076923076923,26,0,19,32.818860244233385,0.6574519230769231,44.09722222222222,1023.6111111111109,39.36965811965811,0
123,4,0,1,25,0.0,0.038461538461538464,0.9615384615384616,26,650,400,250,0.6153846153846154,9,4,5,440.00912334169385,0.8011538461538461,-0.005946585060508935,0.25613162653469124,131090.963648834,6336.243998628258,137427.20764746226,122,24,89.3076923076923,26,0,20,32.71643309222424,0.6586538461538463,43.98148148148148,1024.074074074074,39.387464387464384,0
124,4,0,0,25,0.0,0.0,1.0,25,650,400,250,0.6153846153846154,9,4,5,456.0502855227718,0.8025,0.0097698449976511,0.26455887135639816,130958.79368528113,6944.759050378051,137903.55273565918,123,25,91.48,25,0,20,32.440732477428114,0.6612500000000001,44.11057692307693,1023.5576923076928,40.942307692307715,0
125,4,0,0,25,0.0,0.0,1.0,25,800,700,100,0.875,9,7,2,454.9884456308695,0.7981944444444444,0.010084454175789848,0.2659228630131426,131246.00643080217,6943.083292241958,138189.08972304413,124,26,92.48,25,0,20,32.17469502658743,0.6641666666666666,43.83012820512821,1024.6794871794878,40.98717948717951,0
126,4,0,0,25,0.0,0.0,1.0,25,800,400,400,0.5,12,4,8,456.7734374999999,0.7954166666666667,0.018199999999999994,0.26869025735294133,131492.439184747,7012.450690335323,138504.88987508233,125,27,93.48,25,0,20,31.877604166666664,0.6666666666666665,43.5897435897436,1025.6410256410265,41.025641025641065,0
127,4,1,1,25,0.038461538461538464,0.038461538461538464,0.9615384615384616,26,800,600,200,0.75,10,6,4,444.77962534833864,0.8002564102564103,0.0006238879774473904,0.26487859978257966,131961.6031283342,6538.7664799573395,138500.36960829154,126,0,90.84615384615384,26,0,19,31.707782617402614,0.6674679487179487,43.13271604938272,1027.46913580247,39.518043684710385,0
128,4,0,0,25,0.0,0.0,1.0,25,350,200,150,0.5714285714285714,5,2,3,456.82071483729374,0.7898611111111111,0.015258311222100751,0.27075396114362077,131780.23619843027,7039.988340318862,138820.22453874914,127,29,95.48,25,0,19,31.58313173091932,0.6695833333333334,43.30929487179487,1026.76282051282,41.0705128205128,0
129,4,0,0,25,0.0,0.0,1.0,25,650,400,250,0.6153846153846154,9,4,5,455.5518149130066,0.7906944444444445,0.015905118601747592,0.27029407684838397,131821.37573964504,7010.293392504941,138831.66913214998,128,30,96.48,25,0,19,31.57381398252185,0.6699999999999999,43.269230769230774,1026.9230769230774,41.076923076923094,0
130,4,0,0,25,0.0,0.0,1.0,25,800,600,200,0.75,10,6,4,451.9998469134061,0.7879166666666667,0.015897675869599004,0.26905951890082147,131944.83288646457,6927.808853139391,138872.64173960398,129,31,97.48,25,0,19,31.539378932043885,0.6712500000000001,43.14903846153847,1027.4038461538466,41.09615384615387,0
131,4,0,0,25,0.0,0.0,1.0,25,800,500,300,0.625,11,5,6,449.67937879768203,0.7870833333333334,0.01719008264462829,0.2682598936027473,132027.16975365707,6873.979135848123,138901.1488895052,130,32,98.48,25,0,19,31.515248973439363,0.6720833333333334,43.068910256410255,1027.7243589743587,41.10897435897434,0
132,4,0,0,25,0.0,0.0,1.0,25,300,100,200,0.3333333333333333,5,1,4,455.13748359773876,0.7855555555555556,0.01588528678304235,0.2724031804816318,132150.72320841558,7029.349523339923,139180.0727317555,131,33,99.48,25,0,19,31.249350581878637,0.6733333333333333,42.948717948717956,1028.2051282051289,41.12820512820515,0
133,4,0,0,25,0.0,0.0,1.0,25,500,300,200,0.6,7,3,4,454.08277243158324,0.7859722222222222,0.01750350631136044,0.27206808129724286,132191.9205343935,7005.214753862592,139197.13528825608,132,34,100.48,25,0,20,31.234578723183212,0.6737500000000001,42.90865384615385,1028.3653846153848,41.13461538461539,0
134,4,0,1,24,0.0,0.04,0.96,25,650,500,150,0.7692307692307693,8,5,3,453.1400122281423,0.7848611111111111,0.021707165109034143,0.27239315341804055,132315.55103550295,6991.494082840242,139307.0451183432,133,35,101.48,25,0,20,31.133177570093455,0.675,42.78846153846154,1028.8461538461538,41.15384615384615,0
135,4,0,1,23,0.0,0.041666666666666664,0.9583333333333334,24,650,400,250,0.6153846153846154,9,4,5,462.39538254543754,0.7802687198067633,0.0038824069572731545,0.27730242037783226,132226.53125,7428.187500000002,139654.71875,134,36,101.33333333333333,24,0,20,30.985658726300443,0.6783854166666666,42.875,1028.5,42.854166666666664,0
136,4,1,1,23,0.041666666666666664,0.041666666666666664,0.9583333333333334,24,600,400,200,0.6666666666666666,8,4,4,464.4656170970944,0.7892512077294686,-0.008438647656081155,0.27886009617930624,132269.38888888896,7486.916666666688,139756.30555555565,135,0,98.125,24,0,20,30.888825880319736,0.6788194444444444,42.83333333333334,1028.6666666666674,42.86111111111114,0
137,4,1,1,23,0.041666666666666664,0.041666666666666664,0.9583333333333334,24,850,700,150,0.8235294117647058,10,7,3,477.94202286538945,0.7929498792270531,-0.005913760475804608,0.2846872049241667,131969.53125,7814.756944444444,139784.28819444444,136,0,99.08333333333333,24,0,20,30.84786428764532,0.67578125,43.125,1027.5,42.8125,8
138,4,1,1,23,0.041666666666666664,0.041666666666666664,0.9583333333333334,24,850,800,50,0.9411764705882353,9,8,1,475.8083644970652,0.7934782608695652,-0.005742001729355906,0.2843784876180135,132098.0,7770.666666666666,139868.66666666666,137,0,100.04166666666667,24,0,21,30.77172503242542,0.6770833333333334,43.0,1028.0,42.833333333333336,0
139,4,0,0,23,0.0,0.0,1.0,23,700,500,200,0.7142857142857143,9,5,4,493.4233460909831,0.7779973649538867,0.016577143235041003,0.2934257224945072,131907.10373866704,8417.208899980702,140324.31263864774,138,40,105.3913043478261,23,0,21,30.513949918314452,0.6798007246376812,43.185763888888886,1027.2569444444443,44.66334541062802,0
140,4,1,1,23,0.041666666666666664,0.041666666666666664,0.9583333333333334,24,550,400,150,0.7272727272727273,7,4,3,480.2163009917893,0.7898550724637681,-0.00607582631237813,0.288316635186899,132269.38888888882,7903.583333333323,140172.97222222213,139,0,101.95833333333333,24,0,21,30.483770792827826,0.6788194444444444,42.83333333333333,1028.666666666666,42.861111111111086,0
141,4,0,0,23,0.0,0.0,1.0,23,600,400,200,0.6666666666666666,8,4,4,495.83637691745764,0.7768445322793149,0.014806110458284172,0.29590235396687,132040.89506172837,8494.135802469124,140535.0308641975,140,42,107.3913043478261,23,0,21,30.315315315315313,0.6811594202898551,43.05555555555555,1027.7777777777776,44.685990338164245,0
142,4,0,0,23,0.0,0.0,1.0,23,900,700,200,0.7777777777777778,11,7,4,494.09261336324295,0.7745388669301713,0.008453494771601289,0.29660574814358814,132264.03130425344,8470.136176215276,140734.16748046872,141,43,108.3913043478261,23,0,21,30.13238396624472,0.6834239130434783,42.838541666666664,1028.6458333333333,44.72373188405797,0
143,4,0,0,23,0.0,0.0,1.0,23,550,300,250,0.5454545454545454,8,3,5,494.51720237997665,0.7722332015810277,0.0073930646013025125,0.2979164609459858,132398.0034722222,8494.618055555546,140892.62152777772,142,44,109.3913043478261,23,0,21,29.98481781376518,0.6847826086956521,42.70833333333333,1029.1666666666663,44.74637681159419,0
144,4,0,0,23,0.0,0.0,1.0,23,450,200,250,0.4444444444444444,7,2,5,494.2917511495836,0.7697628458498024,0.010206026834811643,0.2984877886269889,132487.3559268904,8497.481433256158,140984.83736014654,143,45,110.3913043478261,23,0,21,29.8995222034851,0.6856884057971016,42.62152777777777,1029.5138888888885,44.76147342995167,0
145,4,0,0,23,0.0,0.0,1.0,23,450,300,150,0.6666666666666666,6,3,3,494.0096549384827,0.7677865612648221,0.006332639479316615,0.29902706868317114,132576.73852237643,8498.837770061715,141075.57629243814,144,46,111.3913043478261,23,0,21,29.815688918858175,0.6865942028985508,42.534722222222214,1029.8611111111102,44.77657004830914,0
146,4,0,0,23,0.0,0.0,1.0,23,600,200,400,0.3333333333333333,10,2,8,492.2951736764483,0.766304347826087,0.002812609867572924,0.2994123105474792,132755.5941358024,8470.987654320978,141226.5817901234,145,47,112.3913043478261,23,0,21,29.677672955974852,0.6884057971014492,42.36111111111111,1030.555555555555,44.80676328502413,0
147,4,0,0,23,0.0,0.0,1.0,23,500,200,300,0.4,8,2,6,492.4036899828185,0.7656455862977603,0.0028121361249642263,0.29983596999261464,132800.3268771701,8478.274197048602,141278.6010742187,146,48,113.3913043478261,23,0,21,29.629337207343777,0.6888586956521741,42.31770833333333,1030.7291666666663,44.814311594202884,0
148,4,1,1,23,0.041666666666666664,0.041666666666666664,0.9583333333333334,24,250,100,150,0.4,4,1,3,476.9809047599969,0.774909420289855,-0.012448858742463598,0.293002555781141,133128.00000000003,7899.902777777779,141027.9027777778,147,0,109.625,24,0,21,29.69389265719207,0.6875,42.0,1032.0000000000002,43.00000000000001,0
149,4,0,0,23,0.0,0.0,1.0,23,700,400,300,0.5714285714285714,10,4,6,504.73584253271235,0.7656455862977603,-0.018085774444978275,0.289227890292601,130484.2160071856,8572.012140721454,139056.22814790707,148,50,115.3913043478261,23,0,19,31.682419994335877,0.6653079710144927,44.57465277777778,1021.7013888888891,44.42179951690822,6
150,4,1,0,24,0.041666666666666664,0.0,1.0,24,800,700,100,0.875,9,7,2,499.05254209043534,0.774909420289855,-0.055239898989899006,0.26863892159336195,128017.99999999999,7977.541666666667,135995.54166666666,149,0,111.54166666666667,24,0,18,34.373970685112,0.6354166666666666,47.0,1011.9999999999999,42.166666666666664,7
151,4,1,0,25,0.04,0.0,1.0,25,1000,800,200,0.8,12,8,4,481.4465465793869,0.7920833333333334,-0.06346877470355727,0.2618357185825129,128428.64287989,7366.305319280101,135794.9481991701,150,0,108.04,25,0,18,34.39443346508564,0.6354166666666666,46.59455128205129,1013.6217948717959,40.54487179487184,0
152,4,0,0,25,0.0,0.0,1.0,25,700,300,400,0.42857142857142855,11,3,8,480.6430922735586,0.7901388888888888,-0.0611184834123224,0.2627349545847693,128631.7723742605,7365.194567718634,135996.96694197913,151,1,109.04,25,0,18,34.20484465508162,0.6375,46.39423076923078,1014.423076923078,40.57692307692312,0
153,4,3,1,27,0.10714285714285714,0.03571428571428571,0.9642857142857143,28,850,600,250,0.7058823529411765,11,6,5,427.9824740012454,0.8234678130511464,-0.07137298105884515,0.23537370768613275,128872.9341103516,5431.0714344695725,134304.00554482118,152,0,98.25,28,0,19,35.292556954860615,0.6290922619047619,46.15660919540231,1015.3735632183923,36.26334154351401,5
154,4,1,0,28,0.03571428571428571,0.0,1.0,28,650,300,350,0.46153846153846156,10,3,7,423.87663220961883,0.8247354497354497,-0.06209599224305107,0.2341918392958147,129055.35737878202,5340.710050865397,134396.06742964743,153,0,99.21428571428571,28,0,20,35.209570607089006,0.6309523809523808,45.977011494252885,1016.0919540229896,36.28899835796391,0
155,4,0,0,28,0.0,0.0,1.0,28,750,300,450,0.4,12,3,9,424.28110722923947,0.8227513227513227,-0.05737704918032793,0.23528315946348732,129201.38888888892,5363.5416666666715,134564.9305555556,154,1,100.21428571428571,28,0,20,35.0495218579235,0.632440476190476,45.833333333333336,1016.666666666667,36.30952380952382,0
156,4,2,1,29,0.06666666666666667,0.03333333333333333,0.9666666666666667,30,1200,1000,200,0.8333333333333334,14,10,4,419.32528113286094,0.8342432950191571,-0.09646258503401384,0.23891789273849076,130262.58680555565,4959.201388888898,135221.78819444455,155,0,94.46666666666667,28,2,19,34.09013605442177,0.6432291666666666,44.79166666666667,1020.8333333333342,36.458333333333364,2
157,4,1,2,28,0.03333333333333333,0.06666666666666667,0.9333333333333333,30,900,700,200,0.7777777777777778,11,7,4,420.7650334890805,0.8331896551724138,-0.09663242812250816,0.24019093116521248,130335.93285523186,4968.160630532436,135304.0934857643,156,0,95.43333333333334,28,2,19,33.97853055672812,0.6439732142857142,44.7198275862069,1021.1206896551723,36.468596059113295,0
158,4,1,1,28,0.034482758620689655,0.034482758620689655,0.9655172413793104,29,700,400,300,0.5714285714285714,10,4,6,431.4382237871002,0.8234811165845648,-0.0869180626127688,0.24605965531199447,130300.5670041454,5443.329037344102,135743.8960414895,157,0,99.55172413793103,27,2,20,33.74219622989846,0.6469907407407407,44.754464285714285,1020.9821428571428,37.814153439153436,0
159,4,1,1,28,0.034482758620689655,0.034482758620689655,0.9655172413793104,29,1100,900,200,0.8181818181818182,13,9,4,430.0536293543286,0.8189655172413793,-0.08222811671087549,0.2459906759906759,130414.54081632648,5417.049319727884,135831.59013605435,158,0,100.51724137931035,27,2,22,33.66113053613053,0.6481481481481481,44.64285714285714,1021.428571428571,37.830687830687815,0
160,4,1,2,27,0.034482758620689655,0.06896551724137931,0.9310344827586207,29,900,800,100,0.8888888888888888,10,8,2,426.274697410558,0.8246100164203612,-0.08032596041909212,0.24575165441320085,130718.71456916099,5344.416099773238,136063.13066893423,159,0,101.17241379310344,27,2,18,33.447322467986034,0.6512345679012346,44.345238095238095,1022.6190476190476,37.87477954144621,0
161,4,2,1,28,0.06896551724137931,0.034482758620689655,0.9655172413793104,29,500,400,100,0.8,6,4,2,427.08177874428804,0.8270730706075533,-0.07446189645142542,0.24718975678836058,130870.93431122445,5378.518282312919,136249.45259353737,160,0,102.06896551724138,27,2,19,33.271524141943,0.6527777777777778,44.19642857142857,1023.2142857142853,37.896825396825385,0
162,4,1,1,28,0.034482758620689655,0.034482758620689655,0.9655172413793104,29,950,800,150,0.8421052631578947,11,8,3,424.04678204434833,0.8266625615763546,-0.06018444266238954,0.24640556253928345,131023.24263038543,5311.996882086158,136335.2395124716,161,0,103.03448275862068,27,2,21,33.19404069767441,0.654320987654321,44.047619047619044,1023.8095238095233,37.91887125220457,0
163,4,1,1,28,0.034482758620689655,0.034482758620689655,0.9655172413793104,29,400,200,200,0.5,6,2,4,416.0178975164663,0.8324096880131363,-0.0721708862344429,0.24294174931305085,131213.7525908801,5117.45389562074,136331.20648650083,162,0,99.24137931034483,27,2,21,33.20579157588962,0.65625,43.86160714285714,1024.553571428571,37.94642857142856,0
164,4,0,0,28,0.0,0.0,1.0,28,500,300,200,0.6,7,3,4,428.57484338316533,0.8266644620811286,-0.061102976011025434,0.2489637049915867,131011.95749504655,5629.6858329523,136641.64332799884,163,2,103.78571428571429,26,2,21,33.08963923223796,0.6578525641025641,44.058641975308646,1023.7654320987659,39.375593542260226,0
165,4,0,0,28,0.0,0.0,1.0,28,1100,600,500,0.5454545454545454,16,6,10,426.6109987339709,0.8253417107583774,-0.05828542371474266,0.24863365827992545,131137.5319984764,5588.942699475611,136726.474697952,164,3,104.78571428571429,27,1,21,33.01204053465057,0.6554783950617284,43.9360119047619,1024.2559523809518,37.93540564373896,0
166,4,0,0,28,0.0,0.0,1.0,28,800,500,300,0.625,11,5,6,431.0445984389226,0.8225308641975309,-0.06536035849134902,0.25196715660869456,131251.8711911848,5715.082022392282,136966.95321357707,165,4,105.78571428571429,27,1,21,32.782094103979084,0.6566358024691359,43.82440476190476,1024.7023809523807,37.95194003527336,0
167,4,0,0,28,0.0,0.0,1.0,28,500,300,200,0.6,7,3,4,431.0445984389226,0.8225308641975309,-0.06536035849134902,0.25196715660869456,131251.8711911848,5715.082022392282,136966.95321357707,166,5,106.78571428571429,27,1,21,32.782094103979084,0.6566358024691359,43.82440476190476,1024.7023809523807,37.95194003527336,0
168,4,0,0,28,0.0,0.0,1.0,28,600,500,100,0.8333333333333334,7,5,2,430.24725602121595,0.818176807760141,-0.06194933349918108,0.25275650820479106,131442.54723373725,5710.5590543509,137153.10628808814,167,6,107.78571428571429,27,1,21,32.608505054902515,0.6585648148148149,43.638392857142854,1025.4464285714284,37.97949735449735,0
169,4,0,0,28,0.0,0.0,1.0,28,650,400,250,0.6153846153846154,9,4,5,429.09543487864494,0.8169091710758377,-0.057990385013884205,0.25283623316695564,131557.01929209186,5690.103280895693,137247.12257298754,168,7,108.78571428571429,27,1,17,32.52163717242045,0.6597222222222222,43.526785714285715,1025.8928571428573,37.996031746031754,0
170,4,1,1,28,0.034482758620689655,0.034482758620689655,0.9655172413793104,29,650,600,50,0.9230769230769231,7,6,1,417.77603569687517,0.8214285714285714,-0.06432666759893713,0.24875240893158654,131954.7687318338,5225.508034416703,137180.27676625052,169,0,106.0,28,1,18,32.40834615205331,0.6603422619047619,43.139367816091955,1027.4425287356323,36.694376026272586,0
171,4,0,1,27,0.0,0.03571428571428571,0.9642857142857143,28,750,600,150,0.8,9,6,3,431.0372034353161,0.8146494708994708,-0.05427267269753855,0.2557685073866824,131824.3145239867,5764.23677543935,137588.55129942604,170,9,110.78571428571429,27,1,18,32.20019441626819,0.6624228395061729,43.26636904761905,1026.9345238095239,38.03461199294533,0
172,4,0,0,27,0.0,0.0,1.0,27,600,500,100,0.8333333333333334,7,5,2,434.927224741093,0.8041310541310541,-0.06813879423620839,0.2573964322933942,131723.87021795465,6058.059461210195,137781.92967916484,171,10,115.14814814814815,26,1,19,32.20240779715373,0.6650641025641025,43.3641975308642,1026.5432098765439,39.48243114909784,2
173,4,1,3,25,0.03571428571428571,0.10714285714285714,0.8928571428571429,28,700,200,500,0.2857142857142857,12,2,10,420.34119814200324,0.812334656084656,-0.07243686529193971,0.25093315951312156,132053.6406294289,5501.517104237538,137555.15773366645,172,0,112.0,27,1,19,32.24219994208774,0.6647376543209876,43.043154761904766,1027.8273809523814,38.06768077601413,0
174,4,1,0,26,0.038461538461538464,0.0,1.0,26,650,300,350,0.46153846153846156,10,3,7,447.9600271234578,0.7875,-0.013761790380221406,0.2428453821689098,128300.82887993424,6294.728557003474,134595.55743693773,173,0,120.38461538461539,26,0,20,35.37477786240163,0.6302083333333335,46.72067901234566,1013.1172839506155,38.96604938271598,7
175,4,1,1,26,0.037037037037037035,0.037037037037037035,0.962962962962963,27,700,500,200,0.7142857142857143,9,5,4,434.9473208578547,0.8000949667616335,-0.02312641279777372,0.23754815216082825,128596.93877551012,5786.578798185932,134383.51757369604,174,0,116.88888888888889,27,0,15,35.399550078247266,0.6296296296296298,46.42857142857142,1014.2857142857135,37.56613756613754,0
176,4,5,5,26,0.16129032258064516,0.16129032258064516,0.8387096774193549,31,650,500,150,0.7692307692307693,8,5,3,391.15565837712586,0.8377240143369176,-0.051223446608550605,0.2189295699964745,129565.68611992737,3936.0702514648538,133501.75637139223,175,0,102.64516129032258,31,0,15,35.519381208168134,0.6273521505376343,45.47526041666667,1018.0989583333339,32.84190188172045,0
177,4,1,1,26,0.037037037037037035,0.037037037037037035,0.962962962962963,27,750,500,250,0.6666666666666666,10,5,5,433.7672583826429,0.7935660018993352,-0.004862298195631665,0.23893959148196436,128936.76757812501,5785.709635416668,134722.4772135417,176,0,118.81481481481481,27,0,17,35.080128205128204,0.6331018518518519,46.09375,1015.6250000000001,37.61574074074075,0
178,4,2,2,26,0.07142857142857142,0.07142857142857142,0.9285714285714286,28,300,200,100,0.6666666666666666,4,2,2,424.8558454749027,0.8067129629629629,-0.020049859706493978,0.2358199857588929,129237.90966854923,5381.496275928108,134619.40594447733,177,0,115.5,28,0,17,34.99746832461966,0.6328125,45.79741379310344,1016.8103448275851,36.31465517241376,0
179,4,3,3,26,0.10344827586206896,0.10344827586206896,0.896551724137931,29,600,400,200,0.6666666666666666,8,4,4,412.82167357314506,0.8138341543513957,-0.030757943450533398,0.23140737848916637,129625.34722222209,4902.430555555536,134527.77777777764,178,0,112.41379310344827,29,0,16,34.90691489361702,0.6336206896551726,45.41666666666666,1018.3333333333322,35.1149425287356,0
180,4,1,0,27,0.037037037037037035,0.0,1.0,27,700,500,200,0.7142857142857143,9,5,4,434.4326498958709,0.7929724596391263,0.015460066907012404,0.24323962279767156,129579.88989866774,5858.746988378675,135438.63688704642,179,0,121.70370370370371,27,0,18,34.40331774334989,0.6396604938271606,45.46130952380952,1018.1547619047614,37.70943562610227,0
181,4,0,0,27,0.0,0.0,1.0,27,900,600,300,0.6666666666666666,12,6,6,432.07109741372284,0.7926163342830009,0.010605199794388787,0.2426190862835874,129693.54815493897,5807.3667357567865,135500.91489069574,180,1,122.70370370370371,27,0,18,34.346999026053076,0.6408179012345678,45.34970238095237,1018.6011904761897,37.725970017636655,0
182,4,0,0,27,0.0,0.0,1.0,27,650,400,250,0.6153846153846154,9,4,5,429.60220324919214,0.7897673314339981,0.013629283489096755,0.24193387235612393,129807.2562358276,5753.096655328789,135560.3528911564,181,2,123.70370370370371,27,0,18,34.29346767912773,0.6419753086419753,45.238095238095234,1019.0476190476186,37.74250440917106,0
183,4,1,1,27,0.03571428571428571,0.03571428571428571,0.9642857142857143,28,800,600,200,0.75,10,6,4,416.7538526702379,0.8014770723104055,-0.0017495173745172288,0.2372291161353661,130225.92152199756,5254.430902364902,135480.35242436247,182,0,120.25,28,0,18,34.193177552552555,0.6428571428571428,44.82758620689655,1020.6896551724133,36.45320197044333,0
184,4,0,0,27,0.0,0.0,1.0,27,750,500,250,0.6666666666666666,10,5,5,426.3876729357654,0.7873931623931625,0.013008340896322412,0.24199618258672265,130110.72137188214,5695.521541950126,135806.24291383228,183,4,125.70370370370371,27,0,19,34.06505250875147,0.6450617283950617,44.9404761904762,1020.2380952380958,37.78659611992947,0
185,4,0,0,27,0.0,0.0,1.0,27,850,600,250,0.7058823529411765,11,6,5,426.85713548440094,0.7858499525166193,0.010583553374047705,0.2429720408537348,130224.61214303425,5717.460981788539,135942.07312482278,184,5,126.70370370370371,27,0,20,33.93670724595421,0.6462191358024691,44.828869047619044,1020.6845238095234,37.80313051146383,0
186,4,0,0,27,0.0,0.0,1.0,27,600,300,300,0.5,9,3,6,428.44034734664245,0.784306742640076,0.01058046823970149,0.2443498938607908,130300.5670041454,5765.204037344101,136065.7710414895,185,6,127.70370370370371,27,0,20,33.81871568770344,0.6469907407407407,44.754464285714285,1020.9821428571428,37.814153439153436,0
187,4,0,0,27,0.0,0.0,1.0,27,600,200,400,0.3333333333333333,10,2,8,434.38429752066105,0.784306742640076,-0.0009090909090909705,0.2437871057513913,129672.49657064468,5882.2858736151275,135554.78244425982,186,7,128.7037037037037,26,1,18,34.309659090909086,0.6442307692307692,45.37037037037037,1018.5185185185182,39.17378917378916,3
188,4,1,1,27,0.03571428571428571,0.03571428571428571,0.9642857142857143,28,850,500,350,0.5882352941176471,12,5,7,421.68112412847404,0.800870811287478,-0.015164626644702528,0.23816466458402094,129921.01414133352,5357.047858205767,135278.0619995393,187,0,125.07142857142857,27,1,19,34.378953194180895,0.6431327160493827,45.12648809523809,1019.4940476190468,37.75903880070544,0
189,4,1,1,27,0.03571428571428571,0.03571428571428571,0.9642857142857143,28,900,600,300,0.6666666666666666,12,6,6,423.32361516034996,0.7949735449735449,-0.005393586005830953,0.24119601328903648,130262.58680555542,5428.645833333315,135691.23263888873,188,0,126.03571428571429,27,1,20,33.98809523809524,0.6466049382716049,44.79166666666666,1020.8333333333322,37.8086419753086,0
190,4,0,0,27,0.0,0.0,1.0,27,750,600,150,0.8,9,6,3,433.17311409290414,0.7888176638176638,0.010689255281601362,0.24581179890714056,130105.09842725948,5871.60612901995,135976.70455627944,189,1,130.7037037037037,26,1,20,33.897733575354195,0.6486378205128205,44.94598765432098,1020.2160493827154,39.23907882241213,0
191,4,0,0,27,0.0,0.0,1.0,27,700,500,200,0.7142857142857143,9,5,4,426.43040732764064,0.7889363722697056,-0.011901159858799693,0.2417414230219299,130065.74121704,5692.797401310767,135758.53861835078,190,2,131.7037037037037,26,1,20,34.10993444276349,0.6482371794871795,44.98456790123456,1020.0617283950611,39.23314339981004,3
192,4,1,1,27,0.03571428571428571,0.03571428571428571,0.9642857142857143,28,750,300,450,0.4,12,3,9,412.21794021444515,0.7999889770723103,-0.02142024884524174,0.23625111665378784,130490.55103812346,5158.109233276625,135648.6602714001,191,0,127.96428571428571,27,1,19,34.03910573842121,0.6489197530864198,44.56845238095237,1021.7261904761896,37.84171075837739,0
193,4,1,1,27,0.03571428571428571,0.03571428571428571,0.9642857142857143,28,800,600,200,0.75,10,6,4,411.67703811055407,0.8040674603174602,-0.015689332501559683,0.23686945157617276,130642.63791454067,5156.51484552152,135799.1527600622,192,0,128.82142857142858,27,1,20,33.89798641436197,0.650462962962963,44.41964285714285,1022.3214285714273,37.863756613756564,0
194,4,0,0,27,0.0,0.0,1.0,27,1050,800,250,0.7619047619047619,13,8,5,425.50487604932937,0.7865622032288699,-0.012082766953632529,0.24391928868594026,130498.99798525375,5705.591992455414,136204.58997770917,193,2,134.59259259259258,26,1,20,33.69109651110104,0.6526442307692308,44.56018518518518,1021.7592592592591,39.29843304843304,0
195,4,0,0,27,0.0,0.0,1.0,27,600,500,100,0.8333333333333334,7,5,2,423.772528736251,0.7856125356125356,-0.01338971106412945,0.2431734562644239,130538.42068663308,5663.719326322198,136202.14001295526,194,3,135.59259259259258,26,1,20,33.69513238699285,0.6530448717948718,44.5216049382716,1021.913580246913,39.30436847103512,0
196,4,0,0,27,0.0,0.0,1.0,27,1300,900,400,0.6923076923076923,17,9,8,441.90970562120106,0.7856125356125356,0.01867156412611015,0.2324829320876752,127092.01388888882,5832.638888888884,132924.6527777777,195,4,136.59259259259258,26,1,19,36.77685950413224,0.6177884615384615,47.916666666666664,1008.3333333333327,38.782051282051256,6
197,4,3,2,28,0.1,0.06666666666666667,0.9333333333333333,30,950,600,350,0.631578947368421,13,6,7,405.1846501052511,0.8199712643678161,-0.0035126234906697196,0.2184161042875052,128074.2283950618,4378.74228395063,132452.97067901242,196,0,123.83333333333333,29,1,19,36.69102177094768,0.617816091954023,46.94444444444445,1012.2222222222229,34.90421455938699,0
198,4,3,3,28,0.0967741935483871,0.0967741935483871,0.9032258064516129,31,650,300,350,0.46153846153846156,10,3,7,393.2849735099804,0.821415770609319,-0.01577821511080657,0.21364327811709305,128382.79714417853,3898.20499479709,132281.00213897563,197,0,120.74193548387096,30,1,18,36.675508399646326,0.6180555555555556,46.63978494623656,1013.4408602150538,33.78136200716846,0
199,4,0,0,28,0.0,0.0,1.0,28,750,600,150,0.8,9,6,3,428.02243884762765,0.7964616402116401,0.018897670898847974,0.2294038244801637,127843.36911848067,5343.966128117906,133187.33524659858,198,2,134.67857142857142,27,1,19,36.351039827349425,0.6219135802469136,47.172619047619044,1011.3095238095233,37.455908289241606,0
200,4,2,2,28,0.06666666666666667,0.06666666666666667,0.9333333333333333,30,650,400,250,0.6153846153846154,9,4,5,406.8830072714684,0.8225574712643678,-0.002631578947368318,0.2208793468045113,128355.55555555549,4445.138888888885,132800.69444444438,199,0,126.63333333333334,29,1,19,36.35896381578949,0.6206896551724138,46.666666666666664,1013.3333333333328,34.942528735632166,0
201,4,3,2,29,0.0967741935483871,0.06451612903225806,0.935483870967742,31,900,600,300,0.6666666666666666,12,6,6,395.5550685566207,0.8206989247311828,0.0012983518618963075,0.21728199511332044,128825.87808200359,3991.54580731875,132817.42388932235,200,0,123.45161290322581,30,1,19,36.163886314488735,0.6225694444444445,46.202956989247305,1015.1881720430098,33.83960573476699,0
202,4,3,3,29,0.09375,0.09375,0.90625,32,950,700,250,0.7368421052631579,12,7,5,389.3442622950821,0.8256468413978495,-0.01178278688524581,0.21590909090909072,129201.38888888872,3661.3103754769104,132862.69926436563,201,0,120.5,30,2,19,35.9375,0.626388888888889,45.83333333333332,1016.6666666666653,33.88888888888884,0
203,4,3,3,29,0.09375,0.09375,0.90625,32,700,300,400,0.42857142857142855,11,3,8,389.35218500954284,0.8308551747311829,-0.007399577167019222,0.2166630394229572,129338.07376575314,3671.612325124273,133009.68609087743,202,0,121.40625,30,2,21,35.79765680056376,0.627777777777778,45.698924731182785,1017.2043010752678,33.90681003584226,0
204,4,0,0,29,0.0,0.0,1.0,29,800,500,300,0.625,11,5,6,419.23849778159547,0.8028530377668308,0.023983763636008737,0.23077707961996236,128909.40844233058,5008.757349055358,133918.16579138592,203,3,134.9655172413793,28,1,21,35.4770915864931,0.6294642857142857,46.12068965517241,1015.5172413793105,36.26847290640394,0
205,4,1,0,30,0.03333333333333333,0.0,1.0,30,850,600,250,0.7058823529411765,11,6,5,406.81891375309294,0.814176245210728,0.019710422073486944,0.22580146077228155,129236.69222608024,4515.1861496913525,133751.8783757716,204,0,131.43333333333334,29,1,22,35.45721782088056,0.6296695402298851,45.79861111111111,1016.8055555555555,35.06226053639847,0
206,4,2,1,31,0.0625,0.03125,0.96875,32,900,600,300,0.6666666666666666,12,6,6,386.59339118628185,0.8316952284946237,0.02559938066658174,0.21858576508157204,129963.68620130747,3648.6204359266458,133612.3066372341,205,0,124.15625,31,1,18,35.229775890690846,0.6313844086021505,45.084635416666664,1019.661458333333,32.89230510752687,0
207,4,2,2,31,0.06060606060606061,0.06060606060606061,0.9393939393939394,33,350,200,150,0.5714285714285714,5,2,3,376.8334482467845,0.836489898989899,0.01759240512024496,0.21417495982633708,130165.93491735542,3210.1756198347202,133376.11053719014,206,0,121.3030303030303,32,1,18,35.2728285077951,0.630859375,44.88636363636364,1020.4545454545458,31.889204545454557,0
208,4,1,1,31,0.03125,0.03125,0.96875,32,650,400,250,0.6153846153846154,9,4,5,386.9522672078457,0.8293010752688172,0.041392893595304736,0.22009665242199528,130196.13477918843,3675.937906901047,133872.0726860895,207,0,126.0625,31,1,21,34.98394573445607,0.6337365591397849,44.856770833333336,1020.5729166666672,32.921706989247326,0
209,4,1,0,32,0.03125,0.0,1.0,32,600,300,300,0.5,9,3,6,384.3198359858135,0.8296790994623656,0.05356004589495189,0.21972338144844886,130395.54172092002,3622.7186414930466,134018.26036241307,208,0,126.8125,31,1,22,34.84829168791435,0.635752688172043,44.66145833333333,1021.3541666666657,32.94690860215051,0
210,4,0,0,32,0.0,0.0,1.0,32,1000,800,200,0.8,12,8,4,384.46071692431417,0.8290910618279571,0.0516373598369011,0.22055904286710662,130528.56445312501,3636.62109375,134165.185546875,209,1,127.8125,31,1,21,34.709480122324166,0.6370967741935484,44.53125,1021.8750000000001,32.96370967741936,0
211,4,1,1,32,0.030303030303030304,0.030303030303030304,0.9696969696969697,33,1100,900,200,0.8181818181818182,13,9,4,376.01852607348144,0.83364898989899,0.04512914880725294,0.21729686863390485,130810.95838434852,3237.468753188451,134048.42713753696,210,0,124.9090909090909,32,1,21,34.638566609067716,0.6373697916666666,44.255050505050505,1022.9797979797979,31.968118686868685,0
212,4,1,1,32,0.030303030303030304,0.030303030303030304,0.9696969696969697,33,1100,900,200,0.8181818181818182,13,9,4,375.90416651285335,0.8345959595959597,0.043609444226347494,0.21777721726852578,130907.84940631056,3241.7612042138585,134149.61061052443,211,0,125.87878787878788,32,1,21,34.54323462882994,0.6383463541666666,44.160353535353536,1023.3585858585857,31.979955808080803,0
213,4,2,2,32,0.058823529411764705,0.058823529411764705,0.9411764705882353,34,800,600,200,0.75,10,6,4,368.0891005242552,0.8387923351158646,0.031213059386433928,0.2148900056133223,131202.54229142642,2858.8451557093467,134061.38744713576,212,0,123.11764705882354,33,1,21,34.44477671451356,0.6388888888888888,43.872549019607845,1024.509803921569,31.045751633986942,0
214,4,0,0,32,0.0,0.0,1.0,32,1350,1000,350,0.7407407407407407,17,10,7,386.55011669658717,0.8274949596774194,0.04022174853652305,0.2236753178940928,130861.41798231323,3716.8992784287993,134578.31726074204,213,5,131.8125,31,1,23,34.31799864257231,0.640456989247312,44.20572916666666,1023.1770833333322,33.005712365591364,0
215,4,0,0,32,0.0,0.0,1.0,32,850,500,350,0.5882352941176471,12,5,7,386.8654238227034,0.8277889784946237,0.044069697162488985,0.2240512428756538,130894.72664727087,3727.728780110653,134622.45542738153,214,6,132.8125,31,1,23,34.27612185604615,0.6407930107526882,44.17317708333332,1023.3072916666652,33.00991263440855,0
216,4,1,0,33,0.030303030303030304,0.0,1.0,33,750,600,150,0.8,9,6,3,376.23356112125816,0.8342803030303031,0.03886822886330066,0.21999362983142137,131263.42337516567,3277.141044281185,134540.56441944686,215,0,129.75757575757575,32,1,25,34.17452152127486,0.6419270833333335,43.81313131313131,1024.7474747474737,32.02335858585855,0
217,4,0,0,33,0.0,0.0,1.0,33,850,500,350,0.5882352941176471,12,5,7,380.21644376457596,0.8334911616161617,0.037477554782222144,0.22309931023355256,131397.01844143824,3391.8932991159822,134788.91174055423,216,1,130.75757575757575,30,3,25,33.93719410942143,0.6486111111111111,43.68279569892473,1025.2688172043004,34.17562724014335,0
218,4,1,1,33,0.029411764705882353,0.029411764705882353,0.9705882352941176,34,1050,500,550,0.47619047619047616,16,5,11,369.4432895121344,0.8399064171122995,0.027822342941997702,0.21847872852394237,131695.40617201052,2930.7968139648356,134626.20298597537,217,0,127.88235294117646,31,3,21,33.91171402596304,0.6488575268817205,43.39192708333333,1026.4322916666658,33.110719086021476,0
219,4,1,1,33,0.029411764705882353,0.029411764705882353,0.9705882352941176,34,1250,800,450,0.64,17,8,9,372.22081798905145,0.8360442661913251,0.03023963484214498,0.22089583081110986,131829.09011840823,3013.9063517252607,134842.99647013348,218,0,128.85294117647058,31,3,21,33.705385444402175,0.6502016129032258,43.26171875,1026.9531250000002,33.12752016129033,0
220,4,1,1,33,0.029411764705882353,0.029411764705882353,0.9705882352941176,34,1050,800,250,0.7619047619047619,13,8,5,373.47321120992524,0.8377896613190732,0.04100951074804016,0.2226171135097227,131996.2904188367,3059.4156901041574,135055.70610894085,219,0,129.8235294117647,31,3,22,33.504392633890866,0.6518817204301076,43.09895833333333,1027.6041666666658,33.148521505376316,0
221,4,0,0,33,0.0,0.0,1.0,33,600,500,100,0.8333333333333334,7,5,2,382.0978741999668,0.8316761363636365,0.04722001298646372,0.22675740660761015,131829.09011840823,3474.3230183919286,135303.41313680017,220,1,134.63636363636363,31,2,23,33.45180360086218,0.6502016129032258,43.26171875,1026.9531250000002,33.12752016129033,0
222,4,0,0,33,0.0,0.0,1.0,33,700,600,100,0.8571428571428571,8,6,2,382.4134446870065,0.8304135101010102,0.05320121365748731,0.22754465147665767,131929.3975830078,3490.315077039931,135419.71266004775,221,2,135.63636363636363,31,2,23,33.34231094212083,0.6512096774193548,43.1640625,1027.34375,33.140120967741936,0
223,4,0,0,33,0.0,0.0,1.0,33,600,200,400,0.3333333333333333,10,2,8,382.68011978229134,0.8290719696969697,0.052680888970802364,0.2281050985892632,131996.29041883687,3502.471245659729,135498.7616644966,222,3,136.63636363636363,31,2,23,33.26786619361378,0.6518817204301075,43.098958333333336,1027.6041666666672,33.14852150537636,0
224,4,0,0,33,0.0,0.0,1.0,33,550,400,150,0.7272727272727273,7,4,3,383.89006502358427,0.8282039141414143,0.055846020376042915,0.22923057286657908,132063.20020887593,3539.5501030816076,135602.75031195753,223,4,137.63636363636363,31,2,23,33.16917912338484,0.6525537634408602,43.03385416666667,1027.864583333334,33.15692204301077,0
225,4,0,1,32,0.0,0.030303030303030304,0.9696969696969697,33,1300,1000,300,0.7692307692307693,16,10,6,383.51690513350417,0.8254419191919192,0.06568405226802909,0.23043095570036612,132297.5179884168,3547.6669311523347,135845.18491956915,224,5,138.63636363636363,31,2,23,32.94216449394591,0.6549059139784946,42.80598958333333,1028.776041666666,33.18632392473116,0
226,4,0,0,32,0.0,0.0,1.0,32,850,500,350,0.5882352941176471,12,5,7,390.22043436419773,0.8155661962365592,0.06697945250228643,0.23422407719131022,132259.71075052032,3922.0883555902446,136181.79910611056,225,6,143.375,30,2,24,32.8079402412997,0.6572916666666666,42.84274193548387,1028.6290322580649,34.28763440860216,0
227,4,0,0,32,0.0,0.0,1.0,32,1050,800,250,0.7619047619047619,13,8,5,391.2537494468028,0.8147261424731184,0.06895242914979738,0.23570652710575696,132398.0034722223,3960.315318244889,136358.3187904672,226,7,144.375,29,3,24,32.6417004048583,0.6616379310344828,42.708333333333336,1029.1666666666672,35.48850574712645,0
228,4,0,0,32,0.0,0.0,1.0,32,800,500,300,0.625,11,5,6,390.8671604716785,0.8137180779569894,0.07366432811656742,0.23592079750945286,132469.48302469132,3955.594135802463,136425.0771604938,227,8,145.375,29,3,25,32.57948821730527,0.6623563218390804,42.638888888888886,1029.4444444444443,35.49808429118774,0
229,4,0,0,32,0.0,0.0,1.0,32,1050,800,250,0.7619047619047619,13,8,5,386.35407196402036,0.8135080645161291,0.04384239199694129,0.22145510611407376,130495.30241224507,3683.478291829432,134178.7807040745,228,9,146.375,31,1,19,34.694920564122164,0.636760752688172,44.563802083333336,1021.7447916666672,32.959509408602166,5
230,4,1,1,32,0.030303030303030304,0.030303030303030304,0.9696969696969697,33,950,700,250,0.7368421052631579,12,7,5,384.02077630178206,0.8198390151515152,0.04187887802166457,0.2157576339277701,129715.36705438222,3365.3282862222436,133080.69534060446,229,0,142.9090909090909,32,1,19,35.54835977524376,0.6263020833333334,45.32828282828283,1018.6868686868688,31.83396464646465,3
231,4,2,2,32,0.058823529411764705,0.058823529411764705,0.9411764705882353,34,1050,800,250,0.7619047619047619,13,8,5,377.04304701520886,0.8290255496137849,0.03322826186824579,0.21362350444571676,130043.7500750911,3006.4183547193115,133050.1684298104,230,0,139.64705882352942,33,1,21,35.391760783371375,0.627209595959596,45.00612745098038,1019.9754901960767,30.908348187759902,0
232,4,2,0,34,0.058823529411764705,0.0,1.0,34,850,700,150,0.8235294117647058,10,7,3,371.6065773028982,0.8266488413547237,0.046565596310253365,0.2119048507807641,130294.81207274768,2883.8658046476535,133178.67787739533,231,0,140.58823529411765,32,2,24,35.27521848462362,0.6321614583333334,44.76010101010101,1020.959595959596,31.904987373737374,0
233,4,2,3,33,0.05555555555555555,0.08333333333333333,0.9166666666666666,36,850,500,350,0.5882352941176471,12,5,7,354.2875786480495,0.8319775132275132,0.04325009048136108,0.20521940876405856,130901.38888888873,2075.347222222203,132976.73611111092,232,0,133.72222222222223,34,2,20,35.10280944625408,0.6335784313725491,44.16666666666666,1023.333333333332,30.098039215686235,0
234,4,2,1,34,0.05714285714285714,0.02857142857142857,0.9714285714285714,35,800,600,200,0.75,10,6,4,362.7411533882801,0.8275910364145658,0.04887983706720944,0.20953636036899484,130794.81336805562,2488.9322916666715,133283.7456597223,233,0,138.42857142857142,33,2,21,34.994484046164274,0.6347853535353535,44.270833333333336,1022.9166666666672,30.997474747474765,0
235,4,4,3,35,0.10526315789473684,0.07894736842105263,0.9210526315789473,38,800,500,300,0.625,11,5,6,337.3730746620863,0.8484471313418682,0.04290533918590622,0.19837178597085253,131476.45968632118,1272.4085594564506,132748.86824577762,234,0,128.39473684210526,35,3,23,34.95525805966219,0.637202380952381,43.605324074074076,1025.578703703704,29.302248677248684,0
236,4,0,0,35,0.0,0.0,1.0,35,850,600,250,0.7058823529411765,11,6,5,354.5056477064969,0.8260504201680672,0.044121652292328895,0.20076502362401372,130026.38996056258,2219.0179183813666,132245.40787894395,235,1,140.4,35,0,21,35.98407474655774,0.6226190476190474,45.02314814814816,1019.9074074074088,29.140211640211678,5
237,4,0,1,34,0.0,0.02857142857142857,0.9714285714285714,35,1300,1100,200,0.8461538461538461,15,11,4,353.94979238172624,0.8260504201680672,0.05120742097568387,0.19055903641779956,128024.02388038549,2063.029669172198,130087.05354955769,236,2,141.4,34,1,19,38.038907187389704,0.6044730392156863,46.99404761904762,1012.0238095238095,29.765406162464984,3
238,4,4,3,35,0.10526315789473684,0.07894736842105263,0.9210526315789473,38,1000,800,200,0.8,12,8,4,330.0321670036439,0.843142484589853,0.04618403532132587,0.18091544337207052,128743.83674214764,897.9781750172781,129641.81491716493,237,0,131.07894736842104,36,2,15,37.91033251960348,0.6076388888888888,46.28378378378379,1014.8648648648657,28.190690690690715,0
239,4,1,0,36,0.027777777777777776,0.0,1.0,36,1000,700,300,0.7,13,7,6,342.45747554670925,0.8297619047619048,0.0569935177576919,0.18689271199118632,128566.75347222236,1605.7291666666856,130172.48263888905,238,0,139.33333333333334,34,2,16,37.77560942207616,0.6099877450980391,46.45833333333334,1014.1666666666679,29.828431372549055,0
240,4,0,0,36,0.0,0.0,1.0,36,400,100,300,0.25,7,1,6,343.38753241558265,0.8306216931216932,0.051249201319615745,0.18768474430488666,128627.12762188222,1633.7903911564804,130260.9180130387,239,1,140.33333333333334,34,2,17,37.69046082228221,0.6106004901960783,46.39880952380953,1014.404761904763,29.835434173669498,0
241,4,1,1,36,0.02702702702702703,0.02702702702702703,0.972972972972973,37,600,300,300,0.5,9,3,6,337.993982095863,0.8370870870870871,0.05757717608218993,0.1863213057081213,128966.15655006858,1317.9569615912246,130284.1135116598,240,0,137.51351351351352,35,2,19,37.48195837131573,0.6119047619047618,46.06481481481482,1015.7407407407406,29.02116402116402,0
242,4,1,1,36,0.02702702702702703,0.02702702702702703,0.972972972972973,37,950,500,450,0.5263157894736842,14,5,9,334.4162019802444,0.8416541541541541,0.06404879204605951,0.18531088340646618,129171.97312510727,1239.4401309585207,130411.41325606579,241,0,136.67567567567568,35,2,20,37.3634910243273,0.6139880952380952,45.862268518518526,1016.5509259259268,29.044312169312192,0
243,4,1,1,36,0.02702702702702703,0.02702702702702703,0.972972972972973,37,950,700,250,0.7368421052631579,12,7,5,332.751398313324,0.8414039039039038,0.05935061729957525,0.1848090015859828,129261.91184807262,1202.419732199725,130464.33158027234,242,0,137.05405405405406,34,3,21,37.314397486927334,0.6170343137254901,45.773809523809526,1016.9047619047623,29.908963585434183,0
244,4,3,3,36,0.07692307692307693,0.07692307692307693,0.9230769230769231,39,750,400,350,0.5333333333333333,11,4,7,319.2492970001431,0.850820962663068,0.05235326123920303,0.17963729099858805,129774.47041636235,486.0816897979132,130260.55210616026,243,0,130.94871794871796,36,3,15,37.13804155614499,0.6180555555555556,45.270270270270274,1018.9189189189192,28.30330330330331,0
245,4,3,3,36,0.07692307692307693,0.07692307692307693,0.9230769230769231,39,650,400,250,0.6153846153846154,9,4,5,318.99717214493114,0.8483468286099866,0.052727082195785036,0.18019657998806615,129927.00277970132,489.269294398262,130416.27207409957,244,0,131.87179487179486,37,2,16,36.99003369900338,0.6176801801801801,45.12061403508771,1019.5175438596482,27.554528212422923,0
246,4,1,1,36,0.02702702702702703,0.02702702702702703,0.972972972972973,37,650,400,250,0.6153846153846154,9,4,5,335.6895858419368,0.8337087087087087,0.06999818816657788,0.1885388669428772,129701.96926708249,1307.9200692301065,131009.8893363126,245,0,139.8918918918919,35,2,17,36.792812369806455,0.6193452380952381,45.34143518518518,1018.6342592592594,29.10383597883598,0
247,4,2,1,37,0.05263157894736842,0.02631578947368421,0.9736842105263158,38,700,500,200,0.7142857142857143,9,5,4,328.8750601486147,0.8409495021337127,0.07999895422406311,0.18655473825211652,130090.20580969493,956.6848520818226,131046.89066177675,246,0,136.97368421052633,36,2,19,36.57297531000478,0.6212384259259258,44.96058558558559,1020.1576576576584,28.337712712712733,0
248,4,2,1,38,0.05128205128205128,0.02564102564102564,0.9743589743589743,39,1700,1500,200,0.8823529411764706,19,15,4,325.39004218165735,0.8419928025191183,0.10322438648618926,0.1867386202668133,130542.57079101264,695.4505232379205,131238.02131425057,247,0,134.17948717948718,37,2,17,36.2043991416309,0.6238738738738738,44.51754385964912,1021.9298245614036,27.619724988146043,0
249,4,1,0,39,0.02564102564102564,0.0,1.0,39,1300,1000,300,0.7692307692307693,16,10,6,324.7501960500673,0.8437921727395412,0.10495110495110516,0.18691177950437218,130654.64854570644,686.0245460141668,131340.67309172062,248,0,135.15384615384616,37,2,18,36.10753610753612,0.625,44.40789473684211,1022.3684210526321,27.631578947368435,0
250,4,1,0,40,0.025,0.0,1.0,40,1000,700,300,0.7,13,7,6,316.56813993434815,0.8471688034188034,0.09921981004070535,0.1837092276626887,130972.46334876542,292.3418209876519,131264.80516975306,249,0,132.75,38,2,19,35.99615558570782,0.6263706140350876,44.09722222222222,1023.6111111111111,26.937134502923975,0
251,4,0,0,40,0.0,0.0,1.0,40,550,500,50,0.9090909090909091,6,5,1,315.53078861265453,0.8470886752136753,0.10059263404212038,0.18340343709484236,131034.66932508696,269.09450954862973,131303.76383463558,250,1,133.75,39,1,20,35.96002051751622,0.6252670940170939,44.03645833333334,1023.8541666666679,26.252670940170972,0
252,4,0,1,39,0.0,0.025,0.975,40,1100,800,300,0.7272727272727273,14,8,6,316.46606719783466,0.8471955128205129,0.0981359983724952,0.18420236273664364,131088.00048828122,296.9807942708326,131384.98128255206,251,2,134.75,39,1,20,35.882349201505455,0.625801282051282,43.984375,1024.0624999999998,26.258012820512814,0
253,4,1,2,38,0.025,0.05,0.95,40,750,500,250,0.6666666666666666,10,5,5,316.8214689682554,0.8444444444444444,0.09574608660296802,0.1853085381515872,131274.74500868062,318.1315104166706,131592.87651909728,252,0,135.575,39,1,20,35.685183302839334,0.6276709401709402,43.802083333333336,1024.7916666666672,26.276709401709414,0
254,4,0,0,38,0.0,0.0,1.0,38,1350,1000,350,0.7407407407407407,17,10,7,326.3677739139613,0.8386379800853485,0.08365627253064156,0.19059877996575336,131215.75869498303,964.9190135426209,132180.67770852565,253,4,143.5,37,1,17,35.50005351027397,0.6306306306306306,43.859649122807014,1024.5614035087715,27.69084874348031,1
255,4,0,2,36,0.0,0.05263157894736842,0.9473684210526316,38,850,600,250,0.7058823529411765,11,6,5,313.00449028991477,0.8395862968231389,0.04694860253323507,0.17809004739366055,130208.06081753617,551.1415415662397,130759.2023591024,254,5,144.5,38,0,18,36.85862207334518,0.6186951754385963,44.84508547008548,1020.6196581196597,26.85841205578052,4
256,4,1,1,36,0.02702702702702703,0.02702702702702703,0.972972972972973,37,1100,1000,100,0.9090909090909091,12,10,2,323.64196661985943,0.8395895895895896,0.07015242070553063,0.18453339566426877,130290.57167830478,1033.4993699984584,131324.07104830325,255,0,149.0810810810811,37,0,20,36.50375451974368,0.6213400900900901,44.76425438596491,1020.9429824561397,27.593053579895667,0
257,4,1,1,36,0.02702702702702703,0.02702702702702703,0.972972972972973,37,700,600,100,0.8571428571428571,8,6,2,322.8921797538126,0.8377752752752753,0.06680746869669152,0.1847704881195649,130430.54112803932,1023.0003462603811,131453.5414742997,256,0,149.8108108108108,37,0,20,36.38140475168169,0.6227477477477478,44.62719298245614,1021.4912280701748,27.607871028923643,0
258,4,0,0,36,0.0,0.0,1.0,36,900,700,200,0.7777777777777778,11,7,4,332.78150188353686,0.8340939153439154,0.06767214440645564,0.18988860148382844,130320.07250071042,1473.6218904715806,131793.694391182,257,2,154.97222222222223,36,0,21,36.24062534465644,0.6235532407407407,44.735360360360374,1021.0585585585605,28.362737737737792,0
259,4,0,0,36,0.0,0.0,1.0,36,650,500,150,0.7692307692307693,8,5,3,333.5094287533686,0.8319775132275132,0.06945516236112681,0.19086839294774818,130435.08193582112,1500.2659331629154,131935.34786898404,258,3,155.97222222222223,36,0,22,36.10567559622241,0.6247106481481481,44.62274774774776,1021.5090090090102,28.375250250250286,0
260,4,1,0,37,0.02702702702702703,0.0,1.0,37,800,600,200,0.75,10,6,4,326.5093527890644,0.8393393393393394,0.06912893600996473,0.1887442541215596,130822.85534972308,1142.977166051099,131965.83251577418,259,0,152.72972972972974,37,0,16,35.892729546266516,0.6266891891891891,44.24342105263158,1023.0263157894743,27.64935988620201,0
261,4,0,1,36,0.0,0.02702702702702703,0.972972972972973,37,1100,500,600,0.45454545454545453,17,5,12,327.2788751506176,0.8402152152152152,0.07348479584983414,0.19001713796058278,130991.17036011102,1174.1285780240264,132165.29893813503,260,1,153.72972972972974,37,0,17,35.70319194515853,0.6283783783783783,44.07894736842106,1023.6842105263175,27.66714082503561,0
262,4,0,0,36,0.0,0.0,1.0,36,1000,600,400,0.6,14,6,8,333.58812790383786,0.8322751322751323,0.0753356812678847,0.19305616115504934,130866.81909950508,1531.1234376268371,132397.94253713192,261,2,158.86111111111111,36,0,18,35.66728116516253,0.6290509259259258,44.20045045045046,1023.1981981981996,28.42217217217221,0
263,4,0,0,36,0.0,0.0,1.0,36,800,500,300,0.625,11,5,6,333.28730774833866,0.8327380952380953,0.07328345070422548,0.19317060285822096,130924.43795146518,1527.0906886616608,132451.52864012684,262,3,159.86111111111111,36,0,18,35.61679320715964,0.6296296296296295,44.14414414414416,1023.423423423425,28.42842842842847,0
264,4,0,0,36,0.0,0.0,1.0,36,1200,1000,200,0.8333333333333334,14,10,4,360.61356067139354,0.8316798941798942,0.04154375614552608,0.20453332842713345,130085.41907793173,2190.3594437624147,132275.77852169416,263,4,160.86111111111111,35,1,17,35.76837985023825,0.6232142857142859,44.96527777777776,1020.138888888886,29.146825396825314,3
265,4,1,0,37,0.02702702702702703,0.0,1.0,37,950,700,250,0.7368421052631579,12,7,5,351.1130417498912,0.8350225225225225,0.05630605806953248,0.20124122727711669,130492.60567577685,1763.5311409382066,132256.13681671506,264,0,157.48648648648648,36,1,15,35.597836070392,0.6252893518518521,44.56644144144143,1021.7342342342321,28.381506506506447,0
266,4,0,0,37,0.0,0.0,1.0,37,1050,700,350,0.6666666666666666,14,7,7,353.5770273064968,0.83495995995996,0.055650537025895286,0.20280391566239858,130521.3723013551,1829.871763655513,132351.24406501063,265,1,158.48648648648648,36,1,15,35.505749026522665,0.6255787037037039,44.53828828828827,1021.8468468468444,28.384634634634565,0
267,4,0,1,36,0.0,0.02702702702702703,0.972972972972973,37,1150,700,450,0.6086956521739131,16,7,9,353.4882266414497,0.8352727727727728,0.059848963110311626,0.20305437626568312,130578.91506371213,1831.6218245271994,132410.53688823932,266,2,159.48648648648648,36,1,15,35.44972087556925,0.6261574074074076,44.48198198198197,1022.0720720720702,28.39089089089084,0
268,4,0,0,36,0.0,0.0,1.0,36,1000,700,300,0.7,13,7,6,353.48239603024604,0.8340608465608467,0.048460144927536364,0.20325237771739108,130617.28395061703,2034.1820987654,132651.46604938243,267,3,158.22222222222223,35,1,15,35.411005434782595,0.6285714285714287,44.44444444444443,1022.2222222222201,29.206349206349145,0
269,4,1,0,37,0.02702702702702703,0.0,1.0,37,950,800,150,0.8421052631578947,11,8,3,346.53982317271544,0.8376501501501501,0.05801575758657318,0.20070155342067952,130895.62694028464,1672.1094827935779,132567.73642307823,268,0,154.9189189189189,36,1,16,35.30684861156965,0.6293402777777779,44.172297297297284,1023.3108108108089,28.425300300300247,0
270,4,0,0,37,0.0,0.0,1.0,37,800,400,400,0.5,12,4,8,347.17871939089446,0.8358358358358359,0.062413970454890055,0.20167423245895325,131010.8900074059,1696.838603806491,132707.7286112124,269,1,155.9189189189189,36,1,17,35.1739815935174,0.6304976851851853,44.059684684684676,1023.7612612612601,28.43781281281278,0
271,4,1,0,38,0.02631578947368421,0.0,1.0,38,600,400,200,0.6666666666666666,8,4,4,342.71928085134516,0.8415422000948317,0.06482670089858789,0.20073557878435902,131328.12499999977,1402.1197295267948,132730.24472952657,270,0,152.78947368421052,36,2,18,34.96781842818428,0.6336805555555557,43.749999999999986,1024.9999999999982,28.47222222222217,0
272,4,0,0,38,0.0,0.0,1.0,38,1300,900,400,0.6923076923076923,17,9,8,342.78251356710666,0.8412458511142722,0.06400309869577292,0.20107551569039542,131385.8453047641,1407.3540601412124,132793.19936490533,271,1,153.78947368421052,36,2,18,34.90796170181605,0.6342592592592593,43.69369369369369,1025.2252252252244,28.478478478478458,0
273,4,0,0,38,0.0,0.0,1.0,38,1150,900,250,0.782608695652174,14,9,5,347.2531308215344,0.8412458511142722,0.006891474434852496,0.20539988886685837,131703.53366457688,1550.7766212158192,133254.31028579272,272,2,154.78947368421052,36,2,17,34.47293837995977,0.6374421296296295,43.38400900900901,1026.463963963965,28.512887887887914,2
274,4,0,0,38,0.0,0.0,1.0,38,850,500,350,0.5882352941176471,12,5,7,347.1388099611434,0.8408605974395448,0.014557670772676001,0.20580049864926578,131790.24252292843,1549.901590779978,133340.1441137084,273,3,155.78947368421052,36,2,17,34.38848066096365,0.6383101851851851,43.29954954954955,1026.8018018018026,28.522272272272296,0
275,4,0,0,38,0.0,0.0,1.0,38,1400,1200,200,0.8571428571428571,16,12,4,346.6638996525246,0.8397048364153628,0.012373381942361261,0.2064596227434488,131963.7458404351,1549.4133491599787,133513.15918959508,274,4,156.78947368421052,36,2,17,34.225896901943585,0.6400462962962963,43.130630630630634,1027.477477477478,28.541041041041055,0
276,4,1,1,38,0.02564102564102564,0.02564102564102564,0.9743589743589743,39,650,400,250,0.6153846153846154,9,4,5,339.4194558304872,0.8441295546558705,0.01979326427561867,0.2034131039127246,132200.59447378045,1174.2907673514983,133374.88524113194,275,0,153.74358974358975,37,2,18,34.17375253225292,0.6404842342342343,42.90021929824562,1028.3991228070179,27.79457088667616,0
277,4,0,0,38,0.0,0.0,1.0,38,1300,900,400,0.6923076923076923,17,9,8,344.82056352490866,0.8424016121384542,0.012885543175648051,0.20646272560957013,132166.31063073222,1514.7323421394528,133681.04297287166,276,1,157.02631578947367,36,2,18,34.06937903844047,0.6420717592592592,42.933558558558566,1028.265765765767,28.56293793793797,0
278,4,0,1,37,0.0,0.02631578947368421,0.9736842105263158,38,850,600,250,0.7058823529411765,11,6,5,344.5066686559236,0.8411569464201043,0.0021231239017076575,0.2069078512933509,132282.1316882764,1514.415302126476,133796.54699040286,277,2,158.02631578947367,36,2,18,33.96095602992155,0.6432291666666665,42.82094594594596,1028.7162162162183,28.575450450450507,0
279,4,0,0,37,0.0,0.0,1.0,37,950,700,250,0.7368421052631579,12,7,5,350.6624289791716,0.838526026026026,0.007298027100007376,0.2105870046464107,132278.91375171472,1877.0490397805258,134155.96279149523,278,3,161.35135135135135,35,2,18,33.80588058805882,0.6452380952380952,42.824074074074076,1028.703703703704,29.391534391534396,0
280,4,0,0,37,0.0,0.0,1.0,37,1300,1000,300,0.7692307692307693,16,10,6,353.5741605976417,0.835960960960961,0.004265986053507254,0.21351270594134542,132487.35592689022,1968.8211323302203,134456.17705922044,279,4,162.35135135135135,35,2,19,33.52129005059021,0.6473214285714286,42.621527777777764,1029.513888888887,29.414682539682488,0
281,4,0,2,35,0.0,0.05405405405405406,0.9459459459459459,37,800,500,300,0.625,11,5,6,354.4918380440226,0.8358983983983984,0.009622569298901151,0.2145760799262387,132576.7385223764,1999.474344135787,134576.21286651219,280,5,163.35135135135135,35,2,19,33.4077882670263,0.6482142857142857,42.534722222222214,1029.86111111111,29.424603174603142,0
282,4,1,1,35,0.027777777777777776,0.027777777777777776,0.9722222222222222,36,650,200,450,0.3076923076923077,11,2,9,355.3979325729727,0.8346230158730159,0.010652642934196432,0.215329335617742,132612.49999999977,2226.041666666638,134838.5416666664,281,0,165.08333333333334,34,2,20,33.348503236245946,0.6507352941176472,42.499999999999986,1029.9999999999982,30.29411764705877,0
283,4,0,1,34,0.0,0.02857142857142857,0.9714285714285714,35,950,700,250,0.7368421052631579,12,7,5,361.63446195493884,0.8294117647058823,0.01756044479205654,0.21859372297448865,132524.15687475947,2585.0604334870914,135109.21730824656,282,7,170.8,33,2,20,33.27679917479964,0.6521464646464648,42.585784313725476,1029.656862745096,31.20172311348776,0
284,4,0,0,34,0.0,0.0,1.0,34,1250,1000,250,0.8,15,10,5,362.4256970069299,0.822638146167558,0.022014207229590133,0.21962422374500698,132618.8113496011,2812.89302792195,135431.70437752307,283,8,173.7941176470588,33,1,20,33.161188776521904,0.6530934343434345,42.493872549019606,1030.0245098039215,31.21286393345217,0
285,4,0,0,34,0.0,0.0,1.0,34,1200,900,300,0.75,15,9,6,364.1077185336609,0.8207442067736186,0.025032182235406486,0.22120070068143213,132713.49961553252,2864.401912725882,135577.9015282584,284,9,174.7941176470588,33,1,19,33.02261734855695,0.654040404040404,42.40196078431373,1030.3921568627452,31.224004753416523,0
286,4,0,0,34,0.0,0.0,1.0,34,750,600,150,0.8,9,6,3,367.33223576573073,0.8203357100415924,0.028285788218509467,0.22372421687368313,132808.22167255398,2956.948199010014,135765.169871564,285,10,175.7941176470588,33,1,19,32.84426643680894,0.6549873737373737,42.31004901960785,1030.7598039215698,31.2351455733809,0
287,4,0,0,34,0.0,0.0,1.0,34,1000,700,300,0.7,13,7,6,365.3912866034077,0.8187759952465835,0.03333333333333366,0.22329467514652704,132934.57031250012,2914.6267361111245,135849.19704861124,286,11,176.7941176470588,33,1,19,32.767255892255896,0.65625,42.18750000000001,1031.250000000001,31.25000000000003,0
288,4,0,0,34,0.0,0.0,1.0,34,1050,800,250,0.7619047619047619,13,8,5,364.5567373076842,0.8178475935828877,0.03283417380250597,0.22410925851133728,133155.82498317971,2908.570621876223,136064.39560505594,287,12,177.7941176470588,33,1,19,32.56649251959155,0.6584595959595958,41.973039215686285,1032.1078431372564,31.275995246583527,0
289,4,0,0,34,0.0,0.0,1.0,34,800,700,100,0.875,9,7,2,365.44566739245755,0.8159907902554961,0.04499378673852661,0.22542058517195107,133282.33882401013,2941.49065263362,136223.82947664376,288,13,178.7941176470588,33,1,19,32.41652820634543,0.6597222222222221,41.85049019607844,1032.5980392156873,31.290849673202647,0
290,4,0,0,34,0.0,0.0,1.0,34,1200,1000,200,0.8333333333333334,14,10,4,365.5046826222682,0.8153223410576352,0.05384250474383312,0.22661290322580668,133472.22222222242,2956.944444444468,136429.1666666669,289,14,179.7941176470588,33,1,19,32.22446236559139,0.6616161616161615,41.66666666666668,1033.3333333333348,31.313131313131358,0
291,4,0,0,34,0.0,0.0,1.0,34,850,500,350,0.5882352941176471,12,5,7,366.2710297338649,0.8141339869281047,0.050624452077435045,0.22748821315640505,133537.46588358335,2982.181027446185,136519.64691102953,290,15,180.7941176470588,32,2,20,32.13922143497026,0.6647135416666666,41.60353535353536,1033.585858585859,32.29955808080809,0
292,4,0,0,34,0.0,0.0,1.0,34,1050,600,450,0.5714285714285714,15,6,9,372.03482105518884,0.8131313131313131,0.053944902750554746,0.23250047970291093,133765.94424357213,3153.1178259871444,136919.06206955927,291,16,181.7941176470588,32,2,18,31.76110704259735,0.6669921875,41.38257575757576,1034.4696969696972,32.32717803030304,0
293,4,0,0,34,0.0,0.0,1.0,34,950,600,350,0.631578947368421,13,6,7,385.33031610204984,0.8132427213309567,0.06169878537967399,0.2302101632096864,132082.88278546729,3379.107795078832,135461.99058054612,292,17,182.7941176470588,33,1,16,33.11228342075982,0.6477272727272727,43.01470588235295,1027.9411764705894,31.14973262032089,4
294,4,0,1,33,0.0,0.029411764705882353,0.9705882352941176,34,800,400,400,0.5,12,4,8,382.6762184261936,0.8129827688651219,0.0675878358015436,0.2295783775018616,132240.3961967753,3321.0509479527213,135561.44714472804,293,18,183.7941176470588,33,1,16,33.021441479010285,0.6493055555555556,42.86151960784314,1028.5539215686279,31.168300653594784,0
295,4,0,0,33,0.0,0.0,1.0,33,600,500,100,0.8333333333333334,7,5,2,393.9531184806127,0.8135258838383839,0.07109542793119705,0.23530244589513352,132073.33953486898,3806.1407955820914,135879.48033045107,294,19,182.54545454545453,32,1,16,32.900339843590054,0.6500651041666666,43.0239898989899,1027.904040404041,32.122001262626284,0
296,4,0,0,33,0.0,0.0,1.0,33,400,200,200,0.5,6,2,4,389.91470247614706,0.8135258838383839,0.08596326928212239,0.21710730876643516,129361.89746263139,3488.021152178352,132849.91861480975,295,20,183.54545454545453,32,1,20,35.759019072442186,0.6227213541666666,45.67550505050505,1017.29797979798,31.790561868686876,7
297,4,2,2,33,0.05714285714285714,0.05714285714285714,0.9428571428571428,35,850,800,50,0.9411764705882353,9,8,1,371.3456735317543,0.8284313725490196,0.0804991575048799,0.20961324999686307,129898.25857426306,2647.431264172341,132545.6898384354,296,0,174.0,34,1,17,35.685020826034496,0.6234681372549019,45.148809523809526,1019.404761904762,29.982492997198882,0
298,4,3,2,34,0.08333333333333333,0.05555555555555555,0.9444444444444444,36,900,600,300,0.6666666666666666,12,6,6,361.191337390962,0.8363095238095238,0.0725775963101587,0.2053271451822124,130173.98787133502,2203.543354552483,132377.5312258875,297,0,170.08333333333334,35,1,19,35.663703640694116,0.6241071428571427,44.87847222222223,1020.4861111111122,29.156746031746064,0
299,4,0,0,34,0.0,0.0,1.0,34,750,600,150,0.8,9,6,3,374.51955599264403,0.8202243018419489,0.08631175480531228,0.21134692447400394,129887.55076172644,2929.0855680507743,132816.63632977722,298,1,181.08823529411765,33,1,19,35.61503165825119,0.6256313131313129,45.15931372549021,1019.3627450980407,30.889780154486083,0
300,4,0,0,34,0.0,0.0,1.0,34,750,400,350,0.5333333333333333,11,4,7,375.6243314267173,0.818887403446227,0.088475620962156,0.21264936640361518,130012.50270328732,2967.171881007324,132979.67458429464,299,2,182.08823529411765,33,1,20,35.459725226307796,0.6268939393939392,45.03676470588236,1019.8529411764716,30.9046345811052,0
301,4,0,0,34,0.0,0.0,1.0,34,850,600,250,0.7058823529411765,11,6,5,371.89604103592876,0.8168820558526442,0.09015698520580462,0.21121462739871405,130137.5147178972,2879.5253027681965,133017.0400206654,300,3,183.08823529411765,33,1,21,35.427676355192574,0.6281565656565655,44.914215686274524,1020.3431372549039,30.919489007724362,0
302,4,1,0,35,0.02857142857142857,0.0,1.0,35,750,300,450,0.4,12,3,9,361.666468908111,0.8226890756302521,0.08581084455691168,0.20703535488328914,130444.94224773257,2435.512329931994,132880.45457766455,301,0,178.82857142857142,34,1,22,35.37660723303424,0.6289828431372548,44.61309523809525,1021.5476190476202,30.045518207282946,0
303,4,0,1,34,0.0,0.02857142857142857,0.9714285714285714,35,1200,900,300,0.75,15,9,6,358.93310039962154,0.8199579831932773,0.09160955486060263,0.20660304733458132,130657.85147392303,2379.4855442177027,133037.33701814074,302,1,179.82857142857142,34,1,16,35.230602779071575,0.6311274509803921,44.40476190476191,1022.3809523809534,30.070028011204514,0
304,4,0,0,34,0.0,0.0,1.0,34,800,500,300,0.625,11,5,6,372.259314850278,0.814950980392157,0.10430244040062076,0.21381836679416807,130575.52984429075,2921.5914552095473,133497.1212995003,303,6,186.08823529411765,33,1,17,34.973521183053556,0.6325757575757576,44.485294117647065,1022.0588235294125,30.971479500891288,0
305,4,2,1,35,0.05555555555555555,0.027777777777777776,0.9722222222222222,36,1300,1000,300,0.7692307692307693,16,10,6,356.5011167101034,0.828505291005291,0.10666566204540939,0.20752117635861808,131090.963648834,2146.814986282579,133237.77863511659,304,0,176.69444444444446,35,1,18,34.85439270644967,0.6333333333333333,43.98148148148148,1024.074074074074,29.259259259259256,0
306,4,1,1,35,0.027777777777777776,0.027777777777777776,0.9722222222222222,36,1400,1100,300,0.7857142857142857,17,11,6,358.2851374726895,0.8318121693121694,0.11519589388349272,0.20952817748898242,131268.81456832998,2206.3330546982243,133475.1476230282,305,0,177.66666666666666,35,1,19,34.62888713199307,0.6351190476190476,43.807870370370374,1024.7685185185192,29.279100529100546,0
307,4,1,0,36,0.027777777777777776,0.0,1.0,36,750,600,150,0.8,9,6,3,358.42624819992625,0.8255621693121694,0.1196285975979463,0.21043798744007952,131419.6588010205,2220.864444671914,133640.52324569243,306,0,178.63888888888889,34,2,21,34.47284144123224,0.6387867647058822,43.66071428571429,1025.3571428571436,30.157563025210106,0
308,4,1,1,36,0.02702702702702703,0.02702702702702703,0.972972972972973,37,900,500,400,0.5555555555555556,13,5,8,347.744763710822,0.8302677677677678,0.12063743563179807,0.20590761375934546,131743.6731074247,1762.6344950274442,133506.30760245214,307,0,174.78378378378378,35,2,16,34.41986095452835,0.6398809523809523,43.34490740740741,1026.6203703703713,29.33201058201061,0
309,4,0,0,36,0.0,0.0,1.0,36,700,500,200,0.7142857142857143,9,5,4,356.21215010812597,0.8266203703703704,0.12435689141619277,0.20980725204933173,131541.75347222228,2171.3541666666774,133713.10763888896,308,1,180.61111111111111,34,2,21,34.40630923368535,0.6400122549019608,43.54166666666667,1025.833333333334,30.171568627451,0
310,4,0,0,36,0.0,0.0,1.0,36,950,700,250,0.7368421052631579,12,7,5,355.9685819684756,0.8249007936507937,0.1304951078037111,0.21061276540883306,131713.96933138277,2177.206977666316,133891.1763090491,309,2,181.61111111111111,35,1,18,34.23875765775926,0.6395833333333334,43.37384259259259,1026.5046296296289,29.32870370370368,0
311,4,0,0,36,0.0,0.0,1.0,36,1050,800,250,0.7619047619047619,13,8,5,357.30145843094954,0.8233796296296297,0.1304719497989706,0.21173154560727797,131773.38023244587,2216.564187885787,133989.94442033165,310,3,182.61111111111111,35,1,19,34.144614474129185,0.6401785714285715,43.315972222222214,1026.7361111111102,29.335317460317434,0
312,4,0,0,36,0.0,0.0,1.0,36,1100,800,300,0.7272727272727273,14,8,6,361.12186916183975,0.8220238095238096,0.1312027439787693,0.2148336267212121,131921.9660922494,2327.9813957475744,134249.94748799698,311,4,183.61111111111111,35,1,20,33.89665014270693,0.6416666666666668,43.17129629629628,1027.314814814813,29.351851851851798,0
313,4,0,1,35,0.0,0.027777777777777776,0.9722222222222222,36,850,500,350,0.5882352941176471,12,5,7,362.6252701168785,0.8186507936507937,0.13428532112387082,0.21674546764321073,132100.37964034622,2380.5871699245367,134480.96681027077,312,5,184.61111111111111,35,1,21,33.67813180214666,0.643452380952381,42.997685185185176,1028.009259259258,29.371693121693085,0
314,4,0,0,35,0.0,0.0,1.0,35,1300,800,500,0.6153846153846154,18,8,10,365.4030404946624,0.8224789915966386,0.11764705882352966,0.21853328654514553,132122.4773242629,2655.5909863945412,134778.06831065743,313,6,182.25714285714287,34,1,21,33.58446232823837,0.6458333333333335,42.97619047619047,1028.0952380952372,30.238095238095212,0
315,4,0,0,35,0.0,0.0,1.0,35,1300,900,400,0.6923076923076923,17,9,8,363.5045733067852,0.8220588235294117,0.11529112165759958,0.21792616299773157,132214.28748582737,2612.099631519241,134826.3871173466,314,7,183.25714285714287,34,1,21,33.54072616429371,0.6467524509803924,42.886904761904745,1028.4523809523787,30.248599439775845,0
316,4,1,1,35,0.027777777777777776,0.027777777777777776,0.9722222222222222,36,1200,800,400,0.6666666666666666,16,8,8,353.52040816326553,0.83125,0.10690476190476228,0.21333128078817717,132461.07266435964,2165.79359685048,134626.86626121012,315,0,179.13888888888889,33,3,21,33.549107142857146,0.6515151515151516,42.6470588235294,1029.4117647058806,31.1942959001782,0
317,4,0,0,35,0.0,0.0,1.0,35,1100,1000,100,0.9090909090909091,12,10,2,364.96254433426225,0.821218487394958,0.1126793151318839,0.21968915273157075,132367.3752834464,2661.82681405892,135029.2020975053,316,9,185.25714285714287,34,1,21,33.348999305876916,0.6482843137254903,42.73809523809522,1029.0476190476165,30.266106442576955,0
318,4,0,0,35,0.0,0.0,1.0,35,1000,800,200,0.8,12,8,4,364.7002901211295,0.821218487394958,0.10896471949103526,0.21970968697541235,132398.0034722223,2657.125141723362,135055.12861394568,317,10,186.25714285714287,32,3,22,33.324898785425084,0.6533203125,42.708333333333336,1029.1666666666672,32.16145833333335,0
319,4,1,0,36,0.027777777777777776,0.0,1.0,36,850,600,250,0.7058823529411765,11,6,5,352.6616934004416,0.8242063492063493,0.11851037415639865,0.21515176407381534,132871.3884833957,2171.729773404448,135043.11825680017,318,0,182.05555555555554,33,3,18,33.15887614406276,0.6556186868686869,42.248774509803916,1031.0049019607836,31.242572786690413,0
320,4,0,0,36,0.0,0.0,1.0,36,850,500,350,0.5882352941176471,12,5,7,354.2016768948978,0.8241732804232805,0.1141725972943517,0.21690159224694608,133011.3112953514,2222.5659013605355,135233.87719671192,319,1,183.05555555555554,34,2,19,32.978697826505105,0.654718137254902,42.113095238095234,1031.5476190476184,30.339635854341715,0
321,4,0,0,36,0.0,0.0,1.0,36,900,500,400,0.5555555555555556,13,5,8,354.0977544401072,0.8235449735449736,0.11562323745064873,0.21737389061521598,133103.4297052154,2226.325113378688,135329.7548185941,320,2,184.05555555555554,34,2,20,32.888930549146295,0.6556372549019608,42.023809523809526,1031.904761904762,30.35014005602241,0
322,4,0,0,36,0.0,0.0,1.0,36,850,600,250,0.7058823529411765,11,6,5,355.67134672730475,0.8208994708994709,0.11396832718327188,0.2190612158252265,133226.3038548754,2276.9557823129403,135503.25963718834,321,3,185.05555555555554,34,2,21,32.72505381303814,0.6568627450980391,41.90476190476191,1032.3809523809534,30.364145658263336,0
323,4,0,0,36,0.0,0.0,1.0,36,800,500,300,0.625,11,5,6,354.28297160875945,0.8207010582010582,0.11336561371147491,0.21856689158850498,133287.76218820873,2244.3168934240502,135532.07908163278,322,4,186.05555555555554,34,2,21,32.699254476981025,0.6574754901960783,41.8452380952381,1032.6190476190484,30.371148459383775,0
324,4,0,0,36,0.0,0.0,1.0,36,1350,1000,350,0.7407407407407407,17,10,7,351.28509280879433,0.8199074074074074,0.10782205840948045,0.218158596263659,133533.73724489802,2181.6822562358366,135715.41950113385,323,5,187.05555555555554,34,2,22,32.53018697688706,0.6599264705882353,41.60714285714286,1033.5714285714291,30.39915966386556,0
325,4,0,0,36,0.0,0.0,1.0,36,1050,700,350,0.6666666666666666,14,7,7,354.2986780112844,0.8198082010582011,0.08153941024778599,0.21808073907402636,133203.26063368036,2238.747829861087,135442.00846354145,324,6,188.05555555555554,35,1,18,32.783594012781705,0.6544642857142858,41.92708333333332,1032.2916666666652,29.494047619047574,1
326,4,0,1,35,0.0,0.027777777777777776,0.9722222222222222,36,850,500,350,0.5882352941176471,12,5,7,356.1746877512,0.8197089947089947,0.08159021863638616,0.22011793029720952,133352.6502486281,2299.367712620008,135652.01796124812,325,7,189.05555555555554,35,1,21,32.58535036605409,0.6559523809523811,41.7824074074074,1032.870370370369,29.510582010581974,0
327,4,0,0,35,0.0,0.0,1.0,35,750,600,150,0.8,9,6,3,363.35755685169045,0.8151260504201681,0.09381122507779138,0.22472227518190468,133379.9762613381,2692.924461451274,136072.90072278937,326,8,194.94285714285715,34,1,21,32.3724597595175,0.6583946078431371,41.755952380952394,1032.9761904761924,30.381652661064482,0
328,4,0,0,35,0.0,0.0,1.0,35,850,700,150,0.8235294117647058,10,7,3,363.5535900104056,0.815406162464986,0.08940092165898639,0.22540322580645183,133472.22222222242,2704.8611111111354,136177.08333333355,327,9,195.94285714285715,34,1,21,32.27486559139785,0.659313725490196,41.66666666666668,1033.3333333333348,30.392156862745143,0
329,4,0,0,35,0.0,0.0,1.0,35,1100,800,300,0.7272727272727273,14,8,6,362.8015624906665,0.8140756302521008,0.08759420780760463,0.2255144568613689,133567.21460796345,2691.678831459076,136258.89343942254,328,10,196.94285714285715,33,2,23,32.19904663110057,0.6625631313131313,41.574754901960794,1033.700980392158,31.324272133095697,0
330,4,0,0,35,0.0,0.0,1.0,35,1050,500,550,0.47619047619047616,16,5,11,364.01165136727974,0.8137955182072829,0.08335252129864168,0.22681529438853607,133656.80980725627,2730.5272108843587,136387.33701814062,329,11,197.94285714285715,34,1,23,32.07796070304706,0.6611519607843137,41.48809523809524,1034.0476190476193,30.41316526610645,2
331,4,0,0,35,0.0,0.0,1.0,35,1000,700,300,0.7,13,7,6,366.8074127986282,0.8102240896358542,0.09683726279470983,0.23028089922628678,133933.9303429705,2825.5916950113374,136759.52203798183,330,12,198.94285714285715,34,1,18,31.728004600345027,0.6639093137254901,41.220238095238095,1035.1190476190475,30.444677871148457,0
332,4,0,0,35,0.0,0.0,1.0,35,1400,1100,300,0.7857142857142857,17,11,6,366.8951061266529,0.811204481792717,0.09147322454608098,0.23169239575574274,134149.66695011346,2843.7712585034105,136993.43820861686,331,13,199.94285714285715,34,1,18,31.509758293112693,0.6660539215686274,41.011904761904766,1035.9523809523816,30.46918767507005,0
333,4,0,1,34,0.0,0.02857142857142857,0.9714285714285714,35,950,500,450,0.5263157894736842,14,5,9,368.3141427101421,0.8097338935574229,0.09236071223434794,0.23317633543940247,134242.1786422901,2888.658588435353,137130.83723072545,332,14,200.94285714285715,34,1,18,31.380432701512532,0.6669730392156864,40.92261904761904,1036.3095238095225,30.47969187675066,0
334,4,0,1,33,0.0,0.029411764705882353,0.9705882352941176,34,1050,800,250,0.7619047619047619,13,8,5,389.1101015068259,0.807226678550208,0.08496013291298699,0.23327704142383518,132214.28748582752,3489.182964852589,135703.47045068012,333,15,200.73529411764707,34,0,20,32.88237450322181,0.6467524509803922,42.88690476190475,1028.4523809523798,30.248599439775877,5
335,4,1,1,33,0.029411764705882353,0.029411764705882353,0.9705882352941176,34,700,400,300,0.5714285714285714,10,4,6,387.259495396175,0.8044414735591207,0.08836459155619703,0.23311079931786446,132367.37528344654,3452.104591836712,135819.47987528326,334,0,200.64705882352942,34,0,21,32.77538369581983,0.6482843137254903,42.73809523809523,1029.0476190476177,30.26610644257699,0
336,4,0,0,33,0.0,0.0,1.0,33,700,400,300,0.5714285714285714,10,4,6,385.63151927437667,0.8008996212121213,0.0895382395382398,0.23270867542419266,132461.07266435976,3616.232939254122,136077.30560361387,335,1,203.87878787878788,33,0,21,32.72271825396827,0.6515151515151516,42.647058823529406,1029.4117647058815,31.19429590017823,0
337,4,0,0,33,0.0,0.0,1.0,33,800,600,200,0.75,10,6,4,383.77726795857296,0.7998737373737375,0.08606291376400832,0.23236773486483028,132587.25610342165,3576.7949826989457,136164.0510861206,336,2,204.87878787878788,33,0,21,32.643185784547036,0.6527777777777779,42.52450980392156,1029.9019607843127,31.209150326797353,0
338,4,0,1,32,0.0,0.030303030303030304,0.9696969696969697,33,1100,1000,100,0.9090909090909091,12,10,2,405.9792129032876,0.8011363636363638,0.08838534276399135,0.24355850849873453,132240.39619677537,4137.370392397165,136377.76658917253,337,3,205.87878787878788,33,0,16,32.422231820167596,0.6493055555555556,42.86151960784314,1028.5539215686283,31.168300653594798,3
339,4,0,0,32,0.0,0.0,1.0,32,800,200,600,0.25,14,2,12,416.2897853333893,0.7953209005376345,0.10068079945965858,0.24907036899116758,132138.24043783802,4601.559949239878,136739.8003870779,338,20,213.21875,32,0,16,32.26058168570141,0.6507161458333334,42.96085858585859,1028.156565656566,32.12989267676769,0
340,4,0,0,32,0.0,0.0,1.0,32,550,200,350,0.36363636363636365,9,2,7,416.2897853333893,0.7953209005376345,0.10068079945965858,0.24907036899116758,132138.24043783802,4601.559949239878,136739.8003870779,339,21,214.21875,32,0,16,32.26058168570141,0.6507161458333334,42.96085858585859,1028.156565656566,32.12989267676769,0
341,4,0,0,32,0.0,0.0,1.0,32,1300,1100,200,0.8461538461538461,15,11,4,416.9979547542556,0.7930527553763441,0.1089589213400417,0.2507834932319135,132333.03880024992,4636.5213052239515,136969.56010547388,340,22,215.21875,32,0,17,32.04508733177895,0.6526692708333334,42.77146464646464,1028.914141414141,32.15356691919191,0
342,4,0,0,32,0.0,0.0,1.0,32,1000,700,300,0.7,13,7,6,415.51246537396116,0.7928007392473119,0.1076670040485832,0.2503209242618743,132398.00347222228,4602.6041666666715,137000.60763888893,341,23,216.21875,32,0,17,32.01754385964912,0.6533203125,42.708333333333336,1029.166666666667,32.16145833333334,0
343,4,1,1,32,0.030303030303030304,0.030303030303030304,0.9696969696969697,33,700,200,500,0.2857142857142857,12,2,10,402.902756068017,0.8006628787878789,0.09728393460109497,0.24497536339667056,132745.06987997398,4096.670901816601,136841.74078179058,342,0,210.63636363636363,33,0,14,31.991393150196217,0.6543560606060608,42.37132352941176,1030.5147058823525,31.227718360071286,0
344,4,2,2,32,0.058823529411764705,0.058823529411764705,0.9411764705882353,34,900,400,500,0.4444444444444444,14,4,10,395.49954196799797,0.8075609031491385,0.08148816877316367,0.24239031334474312,133042.0138888887,3723.6111111110886,136765.6249999998,343,0,205.38235294117646,34,0,14,31.88274098007538,0.6550245098039217,42.08333333333332,1031.6666666666652,30.343137254901915,0
345,4,0,0,32,0.0,0.0,1.0,32,1150,800,350,0.6956521739130435,15,8,7,412.0717479004851,0.7912046370967742,0.09970055752971496,0.2504033905149557,132723.0659658452,4538.285155851432,137261.3511216966,344,26,219.21875,32,0,14,31.777406772045914,0.6565755208333335,42.39267676767676,1030.429292929292,32.20091540404037,0
346,4,0,0,32,0.0,0.0,1.0,32,950,700,250,0.7368421052631579,12,7,5,405.9744589148378,0.7910366263440861,0.027214772308825186,0.2437342606322168,132268.09007052841,4339.493259616351,136607.58333014476,345,27,220.21875,32,0,18,32.39433738390408,0.6520182291666667,42.83459595959595,1028.6616161616153,32.14567550505048,3
347,4,0,0,32,0.0,0.0,1.0,32,800,400,400,0.5,12,4,8,409.3742331288343,0.7912466397849462,0.024294478527607133,0.24641063515509598,132365.5191434548,4437.406578410368,136802.92572186515,346,28,221.21875,32,0,19,32.20833333333333,0.6529947916666667,42.73989898989899,1029.0404040404042,32.15751262626263,0
348,4,0,0,32,0.0,0.0,1.0,32,1700,1300,400,0.7647058823529411,21,13,8,412.4558482047989,0.789944556451613,0.03274411548363343,0.24977003369016687,132592.99314164382,4537.751090449963,137130.74423209377,347,29,222.21875,32,0,21,31.898982469044995,0.6552734375,42.5189393939394,1029.9242424242432,32.1851325757576,0
349,4,0,0,32,0.0,0.0,1.0,32,900,700,200,0.7777777777777778,11,7,4,405.5872802468728,0.7904485887096775,0.021908188016257935,0.23777203585264417,131362.56946251015,4261.608405321309,135624.17786783146,348,30,223.21875,30,2,18,33.32186093265155,0.6482638888888889,43.71639784946237,1025.1344086021509,34.17114695340503,4
350,4,1,1,32,0.030303030303030304,0.030303030303030304,0.9696969696969697,33,900,700,200,0.7777777777777778,11,7,4,395.7529871105013,0.7948232323232324,0.011364597510245655,0.2338324620993234,131661.99578179262,3821.1256239149407,135483.12140570756,349,0,217.42424242424244,31,2,17,33.27042628774422,0.648521505376344,43.42447916666667,1026.3020833333342,33.106518817204325,0
351,4,0,0,32,0.0,0.0,1.0,32,900,700,200,0.7777777777777778,11,7,4,408.1128147037636,0.788012432795699,0.021751768636184998,0.24055020190222606,131569.33108235057,4339.026007341892,135908.35708969246,350,32,225.21875,30,2,18,33.047294641687415,0.6503472222222222,43.51478494623656,1025.9408602150538,34.198028673835125,0
352,4,0,0,32,0.0,0.0,1.0,32,500,100,400,0.2,9,1,8,410.73332278322243,0.7875084005376345,0.023137688277668822,0.24253278572698395,131638.28775364198,4413.646266909465,136051.93402055145,351,33,226.21875,30,2,18,32.91011787819253,0.6510416666666666,43.44758064516129,1026.2096774193544,34.20698924731182,0
353,4,0,0,32,0.0,0.0,1.0,32,1100,700,400,0.6363636363636364,15,7,8,410.4948466324936,0.7863743279569894,0.02114692408376939,0.2434922848037461,131810.75846918713,4421.52741646432,136232.28588565145,352,34,227.21875,30,2,18,32.741328534031396,0.6527777777777779,43.27956989247311,1026.881720430107,34.229390681003565,0
354,4,0,0,32,0.0,0.0,1.0,32,750,500,250,0.6666666666666666,10,5,5,411.8655323525802,0.7857442876344086,0.02487161454926068,0.24497184932068242,131914.2950955312,4466.190274887256,136380.48537041846,353,35,228.21875,30,2,18,32.60118190937239,0.6538194444444445,43.17876344086021,1027.2849462365587,34.24283154121862,0
355,4,0,1,31,0.0,0.03125,0.96875,32,750,600,150,0.8,9,6,3,409.35759480879096,0.7868363575268817,0.019709954378405836,0.2437917570291448,131962.84188164596,4403.998311360672,136366.84019300662,354,36,229.21875,31,1,18,32.61640370886665,0.6515456989247312,43.131510416666664,1027.4739583333328,33.14432123655912,0
356,4,0,0,31,0.0,0.0,1.0,31,700,400,300,0.5714285714285714,10,4,6,419.5378629416178,0.7860215053763441,0.03273927615638539,0.24930858076204065,131879.77837033183,4865.712076540639,136745.49044687246,355,37,234.90322580645162,30,1,18,32.43915205443601,0.6534722222222222,43.21236559139785,1027.1505376344085,34.238351254480285,0
357,4,0,0,31,0.0,0.0,1.0,31,1000,800,200,0.8,12,8,4,419.5621192740504,0.7838709677419354,0.030094028018577967,0.25045991616617197,132052.4071605099,4880.837560700664,136933.24472121056,356,38,235.90322580645162,30,1,19,32.2634693343795,0.6552083333333334,43.04435483870968,1027.8225806451615,34.26075268817205,0
358,4,0,0,31,0.0,0.0,1.0,31,900,600,300,0.6666666666666666,12,6,6,424.1124465881457,0.7840501792114696,0.028712249294842396,0.254102140081903,132190.5914881778,5012.735034397034,137203.32652257485,357,39,236.90322580645162,30,1,19,32.00643706705006,0.6565972222222223,42.909946236559136,1028.360215053763,34.27867383512544,0
359,4,0,1,30,0.0,0.03225806451612903,0.967741935483871,31,1100,800,300,0.7272727272727273,14,8,6,425.87767849164754,0.7827956989247312,0.03267962834932514,0.25539310312053976,132225.14886113998,5062.347887038963,137287.49674817894,358,40,237.90322580645162,30,1,19,31.92602151942848,0.6569444444444444,42.876344086021504,1028.4946236559138,34.283154121863795,0
360,4,0,0,30,0.0,0.0,1.0,30,650,500,150,0.7692307692307693,8,5,3,428.557273087594,0.7814176245210728,0.04993904562870033,0.25794296248102366,132363.42351716963,5345.061567811308,137708.48508498093,359,41,242.63333333333333,30,0,19,31.716954022988507,0.6583333333333334,42.74193548387097,1029.0322580645163,34.30107526881721,0
361,4,0,0,30,0.0,0.0,1.0,30,750,300,450,0.4,12,3,9,427.5632432230925,0.7791666666666667,0.052923187623673096,0.2580699314958928,132469.4830246914,5327.820874442782,137797.3038991342,360,42,243.63333333333333,29,1,19,31.635073754272362,0.6623563218390804,42.63888888888889,1029.444444444445,35.49808429118776,0
362,4,0,0,30,0.0,0.0,1.0,30,550,300,250,0.5454545454545454,8,3,5,429.0769022421945,0.7788793103448276,0.05361927884183082,0.2594760320737057,132540.98186728402,5374.054783950629,137915.03665123464,361,43,244.63333333333333,29,1,20,31.523693912417958,0.6630747126436781,42.56944444444445,1029.7222222222229,35.507662835249064,0
363,4,0,0,30,0.0,0.0,1.0,30,1450,1100,350,0.7586206896551724,18,11,7,425.90121521905036,0.7743295019157088,0.05523685354193786,0.25967109067806987,132847.9538819518,5316.020999537538,138163.97488148935,362,44,245.63333333333333,30,0,17,31.29481747066493,0.6631944444444444,42.271505376344095,1030.9139784946246,34.36379928315416,0
364,4,0,0,30,0.0,0.0,1.0,30,500,400,100,0.8,6,4,2,423.4365638737778,0.774808429118774,0.054683698296836836,0.2586469202260848,132917.2447681814,5256.404280841729,138173.64904902314,363,45,246.63333333333333,30,0,18,31.288288581856094,0.6638888888888889,42.20430107526882,1031.1827956989255,34.37275985663085,0
365,4,0,0,30,0.0,0.0,1.0,30,1200,700,500,0.5833333333333334,17,7,10,418.23728111739,0.7725574712643678,0.05020624375841232,0.2566592811461396,133090.55102107197,5132.686040293695,138223.23706136565,364,46,247.63333333333333,30,0,18,31.247286266336683,0.6656249999999999,42.036290322580655,1031.8548387096787,34.395161290322626,0
366,4,0,0,30,0.0,0.0,1.0,30,850,600,250,0.7058823529411765,11,6,5,425.70002362948964,0.7725574712643678,0.09365942028985508,0.24477751358695654,130617.28395061726,5128.723134337943,135746.0070849552,365,47,248.63333333333333,29,1,17,33.56544384057972,0.6436781609195403,44.44444444444444,1022.2222222222221,35.24904214559386,4
367,4,1,0,31,0.03225806451612903,0.0,1.0,31,550,400,150,0.7272727272727273,7,4,3,413.90247761506765,0.7836021505376344,0.08801813059962305,0.24005082764956123,130949.53399598214,4640.067312695105,135589.60130867726,366,0,241.58064516129033,30,1,19,33.528671481724665,0.6440972222222222,44.119623655913976,1023.5215053763437,34.11738351254479,0
368,4,0,2,29,0.0,0.06451612903225806,0.935483870967742,31,750,700,50,0.9333333333333333,8,7,1,433.4399422694991,0.7851254480286738,0.09458850344012348,0.2450130701979449,129954.04996242338,5066.001669268122,135020.0516316915,367,1,242.58064516129033,30,1,16,34.04544555760613,0.6340277777777779,45.094086021505376,1019.6236559139783,33.98745519713261,8
369,4,0,0,29,0.0,0.0,1.0,29,650,400,250,0.6153846153846154,9,4,5,446.0906477274821,0.7731937602627258,0.12349232122976983,0.25132017190873956,129822.94401919014,5782.560237481841,135605.504256672,368,50,254.3793103448276,28,1,16,33.85732412237418,0.6387648809523809,45.22270114942529,1019.1091954022991,36.396756978653535,0
370,4,1,1,29,0.03333333333333333,0.03333333333333333,0.9666666666666667,30,450,400,50,0.8888888888888888,5,4,1,436.5903934414004,0.785632183908046,0.10540883927761158,0.24785108425197283,130120.84297839509,5361.9020061728415,135482.74498456792,369,0,246.86666666666667,29,1,16,33.79446864506761,0.6386494252873562,44.93055555555556,1020.2777777777779,35.18199233716476,0
371,4,2,1,30,0.06451612903225806,0.03225806451612903,0.967741935483871,31,750,500,250,0.6666666666666666,10,5,5,429.6353724498507,0.7957885304659498,0.10248227100848384,0.24609332825857716,130468.4812731242,5010.774908949032,135479.25618207324,370,0,239.83870967741936,30,1,17,33.616739025566815,0.639236111111111,44.59005376344087,1021.6397849462377,34.054659498207926,0
372,4,2,3,29,0.0625,0.09375,0.90625,32,700,300,400,0.42857142857142855,11,3,8,416.0104630007315,0.8088037634408602,0.10637722646310444,0.24113880819953917,130928.03955078137,4493.486870659736,135421.5264214411,371,0,233.28125,31,1,17,33.496607294317215,0.6411290322580644,44.14062500000001,1023.4375000000009,33.014112903225836,0
373,4,1,1,29,0.03333333333333333,0.03333333333333333,0.9666666666666667,30,850,700,150,0.8235294117647058,10,7,3,432.59508483905586,0.790948275862069,0.11288424102494443,0.24942816050665415,130723.78713348786,5310.093557098795,136033.88069058667,372,0,238.4,29,1,17,33.2805638553126,0.6447557471264367,44.34027777777779,1022.6388888888906,35.26340996168588,0
374,4,1,1,29,0.03333333333333333,0.03333333333333333,0.9666666666666667,30,950,800,150,0.8421052631578947,11,8,3,431.41396627620816,0.7974137931034483,0.10095936283826545,0.24943448003065563,130830.33371913595,5288.406635802489,136118.74035493843,373,0,239.36666666666667,29,1,17,33.20209973753282,0.6458333333333333,44.23611111111112,1023.0555555555567,35.277777777777814,0
375,4,0,0,29,0.0,0.0,1.0,29,850,600,250,0.7058823529411765,11,6,5,444.5717796442439,0.7808908045977011,0.1167801881582391,0.25643937824211743,130739.70512947555,5824.63667591493,136564.3418053905,374,3,248.6206896551724,28,1,17,32.958110892572826,0.648065476190476,44.32471264367817,1022.7011494252879,36.52504105090314,0
376,4,0,0,29,0.0,0.0,1.0,29,600,100,500,0.16666666666666666,11,1,10,442.97669062258876,0.7798645320197044,0.11496190379315174,0.25576245422077976,130776.44266498237,5786.183156625742,136562.62582160812,375,4,249.6206896551724,28,1,17,32.96138268483403,0.6484374999999998,44.28879310344829,1022.8448275862086,36.53017241379316,0
377,4,0,0,29,0.0,0.0,1.0,29,200,0,200,0.0,4,0,4,442.0342286327482,0.7795566502463054,0.11595311894614468,0.25546133992412096,130813.18536134255,5764.7810972387715,136577.96645858133,376,5,250.6206896551724,28,1,17,32.94797518726593,0.6488095238095237,44.25287356321841,1022.9885057471283,36.53530377668316,0
378,4,2,1,30,0.06451612903225806,0.03225806451612903,0.967741935483871,31,550,300,250,0.5454545454545454,8,3,5,420.0338180685268,0.7966845878136201,0.09165643260157919,0.24624857912341552,131363.71768904346,4836.452306603354,136200.1699956468,377,0,235.38709677419354,29,2,18,32.95045273901459,0.6512212643678159,43.71527777777779,1025.1388888888907,35.34961685823761,0
379,4,0,0,30,0.0,0.0,1.0,30,1000,800,200,0.8,12,8,4,430.9723548039555,0.7851053639846743,0.10134616253331519,0.2521923081759229,131292.53713348773,5316.690779321,136609.22791280874,378,1,244.23333333333332,29,1,18,32.74255206215838,0.6505028735632183,43.78472222222223,1024.8611111111118,35.34003831417627,0
380,4,0,0,30,0.0,0.0,1.0,30,500,400,100,0.8,6,4,2,431.1698158794577,0.7845306513409962,0.09729035272132691,0.25278526181593514,131364.94510916236,5328.124661677387,136693.06977083976,379,2,245.23333333333332,28,2,19,32.66380518570427,0.6543898809523809,43.714080459770116,1025.1436781609195,36.61227422003284,0
381,4,0,0,30,0.0,0.0,1.0,30,1000,900,100,0.9,11,9,2,426.1145267209834,0.7850574712643679,0.09647893901186144,0.25054410969805446,131475.43640177042,5204.718671555039,136680.15507332547,380,3,246.23333333333332,28,2,19,32.681014756701224,0.6555059523809523,43.606321839080465,1025.5747126436786,36.62766830870281,0
382,4,0,0,30,0.0,0.0,1.0,30,850,600,250,0.7058823529411765,11,6,5,427.3562953569551,0.7859195402298851,0.09756370764491762,0.2522461703668905,131622.83037719657,5249.969034879133,136872.7994120757,381,4,247.23333333333332,28,2,17,32.49935825632409,0.6569940476190474,43.46264367816093,1026.1494252873572,36.64819376026276,0
383,4,1,0,31,0.03225806451612903,0.0,1.0,31,650,500,150,0.7692307692307693,8,5,3,421.31726254611226,0.7904121863799283,0.09945393182288198,0.23595697874144758,129589.99083719133,4732.602172283505,134322.59300947483,382,0,240.2258064516129,29,2,18,34.72681648706406,0.6332614942528736,45.451388888888886,1018.1944444444442,35.110153256704976,4
384,4,1,0,32,0.03125,0.0,1.0,32,550,300,250,0.5454545454545454,8,3,5,407.85959520946733,0.8017893145161291,0.08882251153592602,0.23035108188114742,129919.79067305467,4197.8066467221615,134117.59731977683,383,0,233.6875,30,2,19,34.732476378817836,0.6336805555555556,45.12768817204301,1019.4892473118277,33.982974910394255,0
385,4,0,1,31,0.0,0.03125,0.96875,32,950,700,250,0.7368421052631579,12,7,5,405.54042731443906,0.8031334005376345,0.0803459689105519,0.23025111321943947,130125.41415553818,4154.22321222106,134279.63736775925,384,1,234.6875,30,2,19,34.58179642559171,0.6357638888888889,44.9260752688172,1020.2956989247309,34.009856630824366,0
386,4,3,2,32,0.08823529411764706,0.058823529411764705,0.9411764705882353,34,950,700,250,0.7368421052631579,12,7,5,385.7465906506067,0.8152480689245396,0.07531111740731866,0.22198934928912303,130649.553058999,3279.523932506876,133929.07699150586,385,0,221.58823529411765,32,2,18,34.55369272570086,0.6357421875,44.41287878787878,1022.3484848484842,31.94839015151513,0
387,4,0,0,32,0.0,0.0,1.0,32,650,500,150,0.7692307692307693,8,5,3,403.5596710484971,0.7995631720430109,0.09435871281916275,0.2305448406486075,130365.5137154584,4122.052766215741,134487.56648167415,386,1,236.4375,30,2,21,34.387612968325,0.6381944444444445,44.69086021505376,1021.2365591397846,34.04121863799282,0
388,4,1,0,33,0.030303030303030304,0.0,1.0,33,1150,800,350,0.6956521739130435,15,8,7,393.0664309595061,0.8051609848484849,0.09481467759613493,0.22627255248490027,130661.65500217008,3671.742078993051,134333.39708116313,387,0,230.24242424242425,31,2,19,34.3543046357616,0.6384408602150538,44.401041666666664,1022.3958333333328,32.980510752688154,0
389,4,1,0,34,0.029411764705882353,0.0,1.0,34,950,800,150,0.8421052631578947,11,8,3,382.29354031618146,0.8098262032085563,0.08919307207279115,0.2218506607976581,130972.46334876544,3213.985339506171,134186.4486882716,388,0,224.44117647058823,32,2,20,34.31422433288104,0.6389973958333334,44.09722222222222,1023.6111111111112,31.987847222222225,0
390,4,0,1,33,0.0,0.029411764705882353,0.9705882352941176,34,850,600,250,0.7058823529411765,11,6,5,383.3440014839116,0.8099004753416519,0.0883005730035542,0.22302151018899027,131069.41415416797,3248.9347388021624,134318.34889297013,389,1,225.44117647058823,32,2,21,34.189015618577876,0.6399739583333334,44.00252525252525,1023.9898989898992,31.99968434343435,0
391,4,0,0,33,0.0,0.0,1.0,33,1200,900,300,0.75,15,9,6,388.9490521277991,0.7997948232323233,0.09289740024816528,0.2259025010495842,131004.77629833692,3590.8367130905044,134595.61301142743,390,2,233.0909090909091,32,1,21,34.11111453708272,0.6393229166666666,44.06565656565657,1023.7373737373739,31.991792929292934,0
392,4,0,0,33,0.0,0.0,1.0,33,400,300,100,0.75,5,3,2,403.5376236283924,0.8003472222222223,0.13372811346273372,0.22272482688943895,129014.56921616684,3812.4465349865413,132827.01575115338,391,3,234.0909090909091,33,0,21,35.767993566546046,0.6167929292929293,46.0171568627451,1015.9313725490194,30.785799168152103,4
393,4,0,0,33,0.0,0.0,1.0,33,1100,800,300,0.7272727272727273,14,8,6,402.700887077005,0.7997159090909092,0.13293431115690835,0.22278842271711832,129107.96215698296,3798.3781778642915,132906.34033484725,392,4,235.0909090909091,33,0,21,35.69363217974998,0.617739898989899,45.92524509803922,1016.2990196078438,30.796939988116478,0
394,4,1,1,33,0.029411764705882353,0.029411764705882353,0.9705882352941176,34,750,400,350,0.5333333333333333,11,4,7,392.6310291559705,0.8092691622103387,0.12048358669310422,0.21840100996800882,129322.448979592,3355.2012471655507,132677.65022675754,393,0,229.14705882352942,34,0,21,35.73023954431959,0.6176470588235293,45.71428571428572,1017.1428571428584,29.915966386554658,0
395,4,1,1,33,0.029411764705882353,0.029411764705882353,0.9705882352941176,34,950,700,250,0.7368421052631579,12,7,5,390.69056439322117,0.8053327391562686,0.11804628240249992,0.21765590373562393,129383.00028344683,3309.7434807256395,132692.74376417248,394,0,230.11764705882354,34,0,21,35.717733442546226,0.6182598039215685,45.65476190476191,1017.3809523809534,29.9229691876751,0
396,4,0,0,33,0.0,0.0,1.0,33,800,500,300,0.625,11,5,6,428.08234290873685,0.7986111111111112,0.18507143810922666,0.22278725962776447,126651.92733625273,4275.49543447278,130927.4227707255,395,7,238.0909090909091,30,3,17,37.58095206302576,0.6003472222222221,48.35349462365591,1006.5860215053762,33.55286738351254,7
397,4,6,5,34,0.15384615384615385,0.1282051282051282,0.8717948717948718,39,650,500,150,0.7692307692307693,8,5,3,373.248403442732,0.8355263157894737,0.14275909402882614,0.20067266561478214,127968.81028163554,1753.5941002732764,129722.40438190881,396,0,202.30769230769232,35,4,17,37.60724090597115,0.6017857142857144,47.04861111111109,1011.8055555555534,28.908730158730098,0
398,4,1,0,35,0.02857142857142857,0.0,1.0,35,850,600,250,0.7058823529411765,11,6,5,413.01839361318093,0.8172268907563025,0.20122654192526568,0.21958764079900242,127519.07560560442,3533.5447523329026,131052.62035793733,397,0,226.14285714285714,31,4,18,37.06450625241717,0.606518817204301,47.493489583333336,1010.026041666667,32.581485215053775,0
399,4,2,1,36,0.05405405405405406,0.02702702702702703,0.972972972972973,37,950,700,250,0.7368421052631579,12,7,5,400.61767138863405,0.8323948948948949,0.17672131670950386,0.2099831943222776,126942.0085742629,2856.296620617633,129798.30519488054,398,0,214.86486486486487,34,3,18,37.97253396337862,0.5934436274509804,48.06547619047618,1007.738095238094,29.639355742296885,7
400,4,3,2,37,0.07692307692307693,0.05128205128205128,0.9487179487179487,39,650,500,150,0.7692307692307693,8,5,3,383.7371175377917,0.8476720647773279,0.17897012855766348,0.20422302206523435,127559.26354595332,1989.9333987710284,129549.19694472435,399,0,204.71794871794873,35,4,18,37.762564925145114,0.5976190476190477,47.4537037037037,1010.1851851851849,28.862433862433853,0
401,4,4,5,36,0.0975609756097561,0.12195121951219512,0.8780487804878049,41,1050,900,150,0.8571428571428571,12,9,3,368.4444491980877,0.8520325203252033,0.17015293784967334,0.19827252604368212,128005.79415060394,1232.604863996604,129238.39901460054,400,0,195.6341463414634,37,4,19,37.6908612345144,0.5982545045045045,47.01206140350877,1011.9517543859641,27.35004741583687,0
402,4,2,2,36,0.05263157894736842,0.05263157894736842,0.9473684210526316,38,800,600,200,0.75,10,6,4,383.35007193499916,0.8464319582740636,0.18336687838212384,0.20490694787517041,127734.7032000172,2193.4215320644776,129928.12473208168,401,0,208.39473684210526,35,3,19,37.592073124189,0.5994047619047618,47.280092592592595,1010.8796296296301,28.882275132275147,0
403,4,2,1,37,0.05263157894736842,0.02631578947368421,0.9736842105263158,38,850,500,350,0.5882352941176471,12,5,7,383.5137438510561,0.8435277382645804,0.1886116304010219,0.20563205573291551,127859.63909433084,2207.1857753023355,130066.82486963317,402,0,209.3421052631579,36,2,20,37.45963701146868,0.5986689814814814,47.156531531531535,1011.373873873874,28.093718718718723,0
404,4,0,0,37,0.0,0.0,1.0,37,1100,900,200,0.8181818181818182,13,9,4,386.85916364598995,0.8385885885885885,0.19199148794021803,0.20738499214347592,127851.72994898826,2492.1226637517057,130343.85261273997,403,1,216.0,35,2,20,37.38317311360341,0.6005952380952382,47.16435185185185,1011.3425925925919,28.895502645502628,0
405,4,2,1,38,0.05128205128205128,0.02564102564102564,0.9743589743589743,39,350,200,150,0.5714285714285714,5,2,3,372.152973887518,0.8477282950967162,0.18948630580636183,0.2018734200609731,128325.39859693889,1752.3404365604365,130077.73903349933,404,0,205.87179487179486,34,5,21,37.26966083108133,0.6075367647058822,46.69642857142858,1013.2142857142867,29.800420168067255,0
406,4,2,1,39,0.05,0.025,0.975,40,1150,800,350,0.6956521739130435,15,8,7,364.8245098373974,0.8576923076923076,0.1943788130892956,0.20042004608069103,128829.5659468591,1400.0366498255116,130229.60259668462,405,0,201.675,36,4,18,36.94005361434647,0.6085069444444444,46.19932432432433,1015.2027027027034,28.200075075075095,0
407,4,1,0,40,0.025,0.0,1.0,40,900,600,300,0.6666666666666666,12,6,6,362.732238287914,0.8519497863247864,0.193087583148559,0.19999051279688182,128972.51136271418,1356.497544842155,130329.00890755634,406,0,202.65,36,4,20,36.84728381374725,0.6099537037037037,46.058558558558566,1015.7657657657667,28.215715715715742,0
408,4,2,3,39,0.047619047619047616,0.07142857142857142,0.9285714285714286,42,600,500,100,0.8333333333333334,7,5,2,349.2380451578351,0.8593689508323654,0.20353826578954481,0.19526691717502612,129525.18332315247,647.6330813225355,130172.816404475,407,0,193.95238095238096,35,7,17,36.62746352093992,0.6175595238095237,45.5150462962963,1017.9398148148151,29.08399470899472,0
409,4,1,1,39,0.025,0.025,0.975,40,950,700,250,0.7368421052631579,12,7,5,366.8569920846168,0.8453792735042736,0.21615449505905038,0.20376032933856414,129263.69214965389,1484.257857554774,130747.95000720865,408,0,204.275,33,7,22,36.44552904314294,0.6193181818181819,45.772058823529406,1016.9117647058815,30.81550802139035,0
410,4,3,4,38,0.07142857142857142,0.09523809523809523,0.9047619047619048,42,1300,800,500,0.6153846153846154,18,8,10,358.9453192156858,0.8526180797522261,0.22520989335148633,0.20358713279067228,130085.41907793177,938.7104552468705,131024.12953317864,409,0,195.28571428571428,35,7,20,35.81092579986383,0.6232142857142859,44.96527777777776,1020.1388888888863,29.146825396825324,0
411,4,1,1,38,0.02564102564102564,0.02564102564102564,0.9743589743589743,39,800,400,400,0.5,12,4,8,387.1898694373583,0.8476720647773279,0.24517322954822984,0.21682632688492043,129586.77685950401,2234.93744260788,131821.71430211188,410,0,211.05128205128204,32,7,20,35.59880332341271,0.625,45.454545454545446,1018.1818181818172,31.818181818181788,0
412,4,1,0,39,0.02564102564102564,0.0,1.0,39,1100,600,500,0.5454545454545454,16,6,10,390.3150703409855,0.8440733243364823,0.2586404633238981,0.2198348173567402,129811.85154894882,2333.5043936842794,132145.3559426331,411,0,212.02564102564102,32,7,22,35.28966877297319,0.6272786458333335,45.23358585858584,1019.0656565656544,31.8458017676767,0
413,4,1,0,40,0.025,0.0,1.0,40,1450,1100,350,0.7586206896551724,18,11,7,385.4996621668009,0.8477831196581197,0.26160912166102945,0.2193024952724603,130201.83000283418,2038.5522959183343,132240.38229875252,412,0,207.7,34,6,23,35.01521248882149,0.6265318627450982,44.85119047619046,1020.5952380952357,30.01750700280105,0
414,4,0,0,40,0.0,0.0,1.0,40,900,400,500,0.4444444444444444,14,4,10,385.6726364014998,0.8463675213675214,0.2645918367346942,0.2197437114380637,130262.58680555547,2047.785572562353,132310.37237811784,413,1,208.7,31,9,23,34.94897959183674,0.6344086021505377,44.791666666666664,1020.8333333333327,32.9301075268817,0
415,4,3,1,42,0.06976744186046512,0.023255813953488372,0.9767441860465116,43,1000,700,300,0.7,13,7,6,352.9847549871247,0.8585732742709486,0.2334835394490269,0.19847439890419635,129745.78622118742,563.9971897573226,130309.78341094474,414,0,195.06976744186048,36,7,16,36.30784606315168,0.6177662037037037,45.29842342342342,1018.8063063063064,28.300175175175177,5
416,4,1,1,42,0.023255813953488372,0.023255813953488372,0.9767441860465116,43,700,400,300,0.5714285714285714,10,4,6,352.39422463382243,0.8610649686231081,0.23071802871703695,0.1984328151033889,129803.15778193738,548.3766283175091,130351.53441025488,415,0,196.04651162790697,36,7,17,36.26459645633033,0.6183449074074074,45.24211711711712,1019.0315315315318,28.306431431431438,0
417,4,0,1,41,0.0,0.023809523809523808,0.9761904761904762,42,950,600,350,0.631578947368421,13,6,7,357.7522915706927,0.8555216802168022,0.2273873084392224,0.2012328065620963,129760.92470689722,884.453634044915,130645.37834094213,416,2,201.71428571428572,35,7,17,36.171025975993025,0.6199404761904762,45.28356481481481,1018.8657407407402,29.11044973544972,0
418,4,0,0,41,0.0,0.0,1.0,41,1400,800,600,0.5714285714285714,20,8,12,369.6432487344114,0.8519817073170731,0.2352431471025005,0.20768465393436356,129716.28578514735,1389.7498582766375,131106.035643424,417,3,207.46341463414635,34,7,17,35.913579525534644,0.6216299019607843,45.32738095238095,1018.6904761904759,29.961484593837525,0
419,4,1,0,42,0.023809523809523808,0.0,1.0,42,1050,600,450,0.5714285714285714,15,6,9,363.75766106047894,0.8560056136275649,0.24856659361680888,0.20664628005448257,130147.65346004779,1068.441203027338,131216.0946630751,418,0,203.5,36,6,18,35.62497700768863,0.6218171296296298,44.90427927927927,1020.3828828828821,28.343968968968948,0
420,4,2,0,44,0.045454545454545456,0.0,1.0,44,1250,800,450,0.64,17,8,9,351.4975568647265,0.8634822057787175,0.2637724371160428,0.20342081539317847,130866.81909950484,399.9748904309641,131266.7939899358,419,0,195.20454545454547,36,8,19,35.20915877907403,0.6290509259259259,44.20045045045045,1023.1981981981976,28.422172172172154,0
421,4,0,0,44,0.0,0.0,1.0,44,1550,1100,450,0.7096774193548387,20,11,9,355.4301156540493,0.8639226568005638,0.26819781626204864,0.20662216186231563,131039.7137001866,515.0921191461659,131554.80581933277,420,1,196.20454545454547,36,8,19,34.93364129637776,0.6307870370370371,44.03153153153153,1023.8738738738733,28.440940940940926,0
422,4,1,1,44,0.022222222222222223,0.022222222222222223,0.9777777777777777,45,1400,1000,400,0.7142857142857143,18,10,8,350.7108156170756,0.8646464646464647,0.26505077133372423,0.2057262413258927,131385.8453047641,216.004433487531,131601.84973825165,421,0,192.82222222222222,36,9,21,34.704754320445225,0.6342592592592593,43.69369369369369,1025.2252252252244,28.478478478478458,0
423,4,1,1,44,0.022222222222222223,0.022222222222222223,0.9777777777777777,45,1750,1500,250,0.8571428571428571,20,15,5,346.29584736545536,0.8616161616161616,0.26436932982148087,0.20436837831567561,131616.8533398264,115.67395097801398,131732.5272908044,422,0,193.64444444444445,36,9,17,34.5848880597015,0.6365740740740741,43.46846846846847,1026.1261261261268,28.503503503503524,0
424,4,1,2,43,0.022222222222222223,0.044444444444444446,0.9555555555555556,45,1800,1200,600,0.6666666666666666,24,12,12,334.65734728594293,0.8625841750841752,0.24704862916363401,0.19928171571819908,131958.55391418294,-167.8200790780899,131790.73383510485,423,0,185.88888888888889,38,7,17,34.53953069217704,0.6362390350877192,43.13568376068376,1027.4572649572651,27.038349077822765,0
425,4,1,2,42,0.022727272727272728,0.045454545454545456,0.9545454545454546,44,650,400,250,0.6153846153846154,9,4,5,341.9133431380618,0.8601568005637773,0.20297056587379148,0.194681270888815,130236.65229030358,106.66035028844041,130343.31264059202,424,0,191.04545454545453,40,4,20,36.09202840833666,0.6156249999999999,44.81707317073172,1020.7317073170747,25.518292682926866,7
426,4,0,0,42,0.0,0.0,1.0,42,850,500,350,0.5882352941176471,12,5,7,348.31625148354783,0.8514808362369338,0.22952560421153323,0.19804266870064616,130180.80210387928,668.8178007889782,130849.61990466826,425,1,200.78571428571428,38,4,20,35.985264865996655,0.6184210526315788,44.87179487179488,1020.5128205128226,26.85560053981112,0
427,4,0,1,41,0.0,0.023809523809523808,0.9761904761904762,42,950,500,450,0.5263157894736842,14,5,9,347.556196195132,0.8501984126984127,0.23628497790868908,0.19831147665251672,130318.55955678686,658.6302527541632,130977.18980954103,426,2,201.78571428571428,37,5,20,35.865012886597945,0.6216216216216215,44.736842105263165,1021.0526315789486,27.596017069701315,0
428,4,1,0,42,0.023809523809523808,0.0,1.0,42,1100,800,300,0.7272727272727273,14,8,6,348.399415163537,0.8497628726287263,0.23987130539668944,0.19951059318246314,130458.54403518396,690.33608898893,131148.8801241729,427,0,202.66666666666666,37,5,22,35.701651998139596,0.6230292792792792,44.59978070175439,1021.6008771929829,27.61083451872927,0
429,4,1,2,41,0.023255813953488372,0.046511627906976744,0.9534883720930233,43,1500,1100,400,0.7333333333333333,19,11,8,339.4294863552081,0.8534514581026209,0.23634727419125623,0.19607044447106753,130794.81336805577,279.12326388890904,131073.93663194467,428,0,198.93023255813952,39,4,16,35.590631364562114,0.6228632478632478,44.27083333333334,1022.9166666666683,26.228632478632523,0
430,4,0,1,40,0.0,0.024390243902439025,0.975609756097561,41,1350,1200,150,0.8888888888888888,15,12,3,355.645710917497,0.8438516260162602,0.2518371192295612,0.20410209518171632,130542.57079101265,1085.381078793477,131627.95186980613,429,5,209.609756097561,37,4,16,35.431419885550795,0.6238738738738738,44.51754385964912,1021.9298245614037,27.619724988146046,0
431,4,0,0,40,0.0,0.0,1.0,40,800,400,400,0.5,12,4,8,363.12518130653194,0.8392361111111111,0.2544354394089756,0.20750990984681394,130377.57087746523,1468.6758126369512,131846.24669010218,430,6,215.25,36,4,21,35.40770757525637,0.6241319444444444,44.67905405405405,1021.2837837837833,28.368993993993982,0
432,4,1,1,40,0.024390243902439025,0.024390243902439025,0.975609756097561,41,1250,700,550,0.56,18,7,11,358.05620236793897,0.842530487804878,0.24785623665720657,0.20675694098134192,130781.15297866902,1165.4005953685441,131946.55357403756,431,0,210.97560975609755,38,3,17,35.12812478239675,0.6244517543859649,44.284188034188034,1022.863247863248,26.917453891138106,0
433,4,0,0,40,0.0,0.0,1.0,40,1550,1100,450,0.7096774193548387,20,11,9,362.89488629948465,0.8374732905982906,0.2520533990992919,0.20916920331452368,130710.70545744846,1486.8493190212373,132197.5547764697,432,8,217.25,37,3,17,35.07577382228892,0.6255630630630631,44.353070175438596,1022.5877192982458,27.637505926979617,0
434,4,1,0,41,0.024390243902439025,0.0,1.0,41,1450,1200,250,0.8275862068965517,17,12,5,357.4005992900579,0.8405995934959349,0.2644150768651443,0.2081435081892159,131109.19922017664,1171.7012747461376,132280.90049492277,433,0,212.9268292682927,38,3,18,34.81292162180959,0.6277412280701755,43.96367521367521,1024.1452991452982,26.951192082771005,0
435,4,0,0,41,0.0,0.0,1.0,41,1200,700,500,0.5833333333333334,17,7,10,358.2465928088472,0.8398882113821138,0.26440946924326925,0.20938105250637754,131246.0064308022,1203.6869247205918,132449.6933555228,434,1,213.9268292682927,38,3,19,34.65292983004901,0.629111842105263,43.83012820512821,1024.679487179488,26.965249662618106,0
436,4,0,1,40,0.0,0.024390243902439025,0.975609756097561,41,950,400,550,0.42105263157894735,15,4,11,359.5743274505915,0.8389227642276422,0.2661114416022208,0.2106078203639178,131328.12500000003,1244.470126561473,132572.5951265615,435,2,214.9268292682927,37,4,19,34.535907859078584,0.6317567567567568,43.75,1025.0000000000002,27.70270270270271,0
437,4,1,2,39,0.024390243902439025,0.04878048780487805,0.9512195121951219,41,1250,900,350,0.72,16,9,7,359.3349080559226,0.8372967479674797,0.26346886945457015,0.21139740439969176,131496.76462950138,1250.2755655586316,132747.04019506002,436,0,214.34146341463415,37,4,19,34.37165918323712,0.6334459459459459,43.58552631578947,1025.657894736842,27.720483641536273,0
438,4,0,0,39,0.0,0.0,1.0,39,700,500,200,0.7142857142857143,9,5,4,378.8683648473248,0.8282163742690059,0.27935697335565424,0.22124161639158926,131212.72243527308,2142.469919243559,133355.19235451665,437,4,225.5897435897436,36,3,19,34.15837729904006,0.6325231481481481,43.86261261261261,1024.5495495495493,28.459709709709703,0
439,4,0,0,39,0.0,0.0,1.0,39,1250,700,550,0.56,18,7,11,377.01134494977885,0.8275416104363473,0.27551510730557993,0.22116334394471118,131387.44882758908,2106.9624848039925,133494.41131239306,438,5,226.5897435897436,35,4,19,34.029032136674964,0.6363095238095239,43.692129629629626,1025.2314814814808,29.292328042328023,0
440,4,0,1,38,0.0,0.02564102564102564,0.9743589743589743,39,1200,900,300,0.75,15,9,6,372.44978178149387,0.8270355375618533,0.2705761852681283,0.21916666441883095,131506.13667052455,1995.88638117282,133502.02305169735,439,6,227.5897435897436,35,4,19,34.02589708869329,0.6375000000000001,43.57638888888888,1025.6944444444432,29.30555555555552,0
441,4,1,1,38,0.02564102564102564,0.02564102564102564,0.9743589743589743,39,1200,900,300,0.75,15,9,6,369.13065053349,0.8309716599190283,0.2530793518614902,0.21823004059539922,131684.26890432098,1921.739969135806,133606.0088734568,440,0,224.35897435897436,35,4,19,33.930987821380256,0.6392857142857142,43.40277777777778,1026.388888888889,29.325396825396826,0
442,4,0,0,38,0.0,0.0,1.0,38,1500,1100,400,0.7333333333333333,19,11,8,373.65889503178806,0.8246503082029398,0.25900598363658545,0.22061230651876804,131633.3616780045,2237.1952947845753,133870.55697278908,441,8,231.26315789473685,34,4,19,33.86625096674401,0.6409313725490196,43.45238095238095,1026.190476190476,30.182072829131645,0
443,4,1,0,39,0.02564102564102564,0.0,1.0,39,700,400,300,0.5714285714285714,10,4,6,367.58043922570647,0.8304093567251463,0.2602226188619523,0.21901873419099468,131981.42387902946,1902.7579518175553,133884.18183084702,442,0,226.30769230769232,35,4,21,33.67077795299242,0.6422619047619048,43.113425925925924,1027.546296296296,29.358465608465604,0
444,4,1,0,40,0.025,0.0,1.0,40,1250,900,350,0.72,16,9,7,358.7995213820908,0.8338141025641026,0.25516194331983755,0.21615483361311347,132398.00347222234,1500.8680555555607,133898.8715277779,443,0,221.625,36,4,22,33.47672064777326,0.6443865740740742,42.708333333333336,1029.1666666666674,28.587962962962983,0
445,4,1,1,40,0.024390243902439025,0.024390243902439025,0.975609756097561,41,1050,600,450,0.5714285714285714,15,6,9,349.40036278903847,0.8365853658536585,0.24222071120477118,0.21239745210164154,132736.761551631,1075.6545283163778,133812.41607994738,444,0,217.1951219512195,37,4,18,33.378112364332836,0.6458333333333335,42.37938596491227,1030.4824561403489,27.850877192982402,0
446,4,0,0,40,0.0,0.0,1.0,40,950,600,350,0.631578947368421,13,6,7,356.8380275143108,0.8313034188034188,0.24461180973209462,0.21596848190723822,132571.90626014516,1461.3395067364563,134033.24576688162,445,2,223.625,36,4,23,33.35224166211044,0.6461226851851853,42.53941441441441,1029.8423423423415,28.606731731731706,0
447,4,1,1,40,0.024390243902439025,0.024390243902439025,0.975609756097561,41,750,400,350,0.5333333333333333,11,4,7,349.8002875146497,0.8346036585365854,0.24544871977812477,0.21312200278193252,132821.51870046533,1092.2010859110262,133913.71978637634,446,0,219.14634146341464,37,4,19,33.2826959897883,0.646677927927928,42.29714912280701,1030.8114035087704,27.8597676623992,0
448,4,1,1,40,0.024390243902439025,0.024390243902439025,0.975609756097561,41,1550,1200,350,0.7741935483870968,19,12,7,348.5189267492187,0.8338922764227642,0.2360531820856524,0.21362961444843,133047.67001625506,1073.9262321098895,134121.59624836495,447,0,220.0487804878049,37,4,19,33.08877581747972,0.6489301801801801,42.077850877192986,1031.6885964912285,27.883475580844014,0
449,4,0,1,39,0.0,0.025,0.975,40,950,700,250,0.7368421052631579,12,7,5,359.1574113160619,0.8303418803418804,0.24200152871806058,0.2195703319647862,132949.08717839472,1549.9299975651452,134499.01717595986,448,2,226.55,36,4,20,32.91339084225084,0.6498842592592593,42.17342342342343,1031.306306306307,28.64739739739742,0
450,4,0,0,39,0.0,0.0,1.0,39,1400,1000,400,0.7142857142857143,18,10,8,367.8232348273395,0.821693657219973,0.24860396301797327,0.2244225599891739,132874.89819101503,1974.8949759945062,134849.79316700954,449,3,233.2051282051282,35,4,20,32.764556204161046,0.6511904761904762,42.24537037037037,1031.018518518518,29.457671957671945,0
451,4,1,0,40,0.025,0.0,1.0,40,1050,700,350,0.6666666666666666,14,7,7,359.9344307390082,0.8276709401709401,0.24539925820879271,0.22159294335691657,133210.5262991031,1589.4109903822712,134799.9372894854,450,0,228.35,36,4,22,32.630858877858984,0.6524884259259259,41.92004504504504,1032.3198198198195,28.67555055055054,0
452,4,0,0,40,0.0,0.0,1.0,40,1000,700,300,0.7,13,7,6,362.06978564113547,0.8275373931623932,0.24411331661031754,0.22325607696997787,133268.65875588427,1650.5109416849298,134919.1696975692,451,1,229.35,36,4,22,32.51740466063184,0.6530671296296295,41.86373873873874,1032.545045045045,28.681806806806808,0
453,4,0,0,40,0.0,0.0,1.0,40,1000,600,400,0.6,14,6,8,363.19048915182015,0.8276976495726496,0.24302965870679372,0.2242976414822451,133326.8038942658,1684.6054246814285,135011.4093189472,452,2,230.35,36,4,22,32.43012394140952,0.6536458333333335,41.80743243243243,1032.7702702702695,28.68806306306304,0
454,4,0,0,40,0.0,0.0,1.0,40,850,600,250,0.7058823529411765,11,6,5,364.42208522649366,0.8270299145299145,0.24089003290521194,0.22542484996183831,133387.2576778432,1721.8525171206552,135109.11019496387,453,3,231.35,37,3,23,32.33766319923574,0.6523085585585585,41.74890350877193,1033.0043859649127,27.919037458511152,0
455,4,0,0,40,0.0,0.0,1.0,40,700,400,300,0.5714285714285714,10,4,6,361.7783936130293,0.825534188034188,0.23741691184482927,0.22447872333920033,133501.315399014,1659.6053376491432,135160.92073666316,454,4,232.35,36,4,23,32.29155315825796,0.6553819444444444,41.63851351351352,1033.4459459459472,28.706831831831867,0
456,4,0,0,40,0.0,0.0,1.0,40,1350,900,450,0.6666666666666666,18,9,9,361.09165036485985,0.8259615384615384,0.23305467813963565,0.22475813166100214,133617.71981018197,1649.6485928496206,135267.36840303158,455,5,233.35,36,4,23,32.192616998874485,0.6565393518518519,41.52590090090091,1033.8963963963977,28.71934434434438,0
457,4,0,0,40,0.0,0.0,1.0,40,1150,800,350,0.6956521739130435,15,8,7,359.6637298844061,0.8257211538461539,0.2329287682849268,0.224706465412549,133755.63274276713,1621.4099530624956,135377.04269582964,456,6,234.35,37,3,19,32.091371634513465,0.6559684684684683,41.39254385964913,1034.4298245614045,27.957562825983906,0
458,4,0,1,39,0.0,0.025,0.975,40,1050,900,150,0.8571428571428571,12,9,3,339.38282026643617,0.8268963675213675,0.15323474567492035,0.2074770338208935,132948.3427044525,1221.0603866455501,134169.40309109804,457,7,235.35,38,2,17,33.423978728547276,0.6461074561403508,42.1741452991453,1031.303418803419,27.139563652721552,8
459,4,0,0,39,0.0,0.0,1.0,39,1250,1000,250,0.8,15,10,5,341.8262238199894,0.8191070625281152,0.18365314917039122,0.2095883075193421,133058.54752218933,1296.580169296518,134355.12769148586,458,12,242.2051282051282,38,1,17,33.250491871181545,0.647203947368421,42.06730769230769,1031.730769230769,27.150809716599184,0
460,4,0,0,39,0.0,0.0,1.0,39,1000,800,200,0.8,12,8,4,344.84473999918015,0.8179262258209627,0.1901979204815063,0.21222228521478195,133196.3677496529,1386.413361092843,134582.78111074577,459,13,243.2051282051282,38,1,18,33.03448216380322,0.6485745614035088,41.93376068376068,1032.2649572649566,27.164867296446225,0
461,4,0,0,39,0.0,0.0,1.0,39,900,700,200,0.7777777777777778,11,7,4,344.6223575720366,0.8170265407107513,0.19124108507386706,0.2123999020137856,133251.51581561822,1384.290306085164,134635.80612170338,460,14,244.2051282051282,38,1,18,32.984961368653416,0.6491228070175439,41.880341880341874,1032.4786324786312,27.170490328385032,0
462,4,1,0,40,0.025,0.0,1.0,40,1350,900,450,0.6666666666666666,18,9,9,341.5764514809522,0.8178418803418803,0.20089351999151606,0.21258906673359007,133613.8899108376,1128.2369336375864,134742.1268444752,461,0,239.075,37,3,19,32.70086523844876,0.654560810810811,41.529605263157876,1033.8815789473656,27.942745376955827,0
463,4,0,0,40,0.0,0.0,1.0,40,1050,600,450,0.5714285714285714,15,6,9,344.25283667707606,0.8157318376068377,0.21296777271281742,0.2149131044589578,133727.27816491583,1207.1989698753164,134934.47713479114,462,1,240.075,37,3,18,32.51826477967419,0.6556869369369371,41.41995614035086,1034.320175438594,27.95459933617822,0
464,4,0,0,40,0.0,0.0,1.0,40,800,600,200,0.75,10,6,4,342.6168897785848,0.8154647435897436,0.21376523582406026,0.21422069947388614,133783.99032635015,1167.3309335564536,134951.3212599066,463,2,241.075,37,3,18,32.503864158275924,0.6562500000000002,41.365131578947356,1034.5394736842084,27.960526315789416,0
465,4,1,1,40,0.024390243902439025,0.024390243902439025,0.975609756097561,41,850,600,250,0.7058823529411765,11,6,5,338.7209236274139,0.8195630081300813,0.21307304995055554,0.21333475716182715,134052.44545118333,881.2736275476565,134933.719078731,464,0,236.17073170731706,38,3,18,32.336479933972974,0.6570723684210527,41.105769230769226,1035.5769230769222,27.252024291497953,0
466,4,0,0,40,0.0,0.0,1.0,40,1150,600,550,0.5217391304347826,17,6,11,345.77687452683915,0.8141292735042736,0.21836016096579502,0.21753304637954288,134010.9592013887,1267.578124999976,135278.53732638867,465,4,243.075,37,3,18,32.195254862508364,0.6585022522522523,41.14583333333332,1035.4166666666652,27.984234234234194,0
467,4,0,0,40,0.0,0.0,1.0,40,1000,800,200,0.8,12,8,4,343.69942809633824,0.8129006410256411,0.2116080880796103,0.21672795712937298,134096.12212411498,1217.7520967989976,135313.87422091397,466,5,244.075,37,3,19,32.163967111299314,0.6593468468468469,41.06359649122806,1035.7456140350866,27.99312470365099,0
468,4,0,0,40,0.0,0.0,1.0,40,1050,900,150,0.8571428571428571,12,9,3,343.8101695741415,0.8126068376068376,0.21290348184993113,0.21730182557231184,134181.31209843405,1226.57993324868,135407.89203168274,467,6,245.075,37,3,19,32.07603538293292,0.6601914414414415,40.9813596491228,1036.0745614035081,28.002015173067786,0
469,4,0,0,40,0.0,0.0,1.0,40,1000,600,400,0.6,14,6,8,346.4208148932919,0.8111645299145299,0.21710832539934377,0.21963219068989198,134294.94081111497,1304.5125663665706,135599.45337748155,468,7,246.075,37,3,19,31.894967206177927,0.6613175675675675,40.87171052631579,1036.5131578947369,28.013869132290186,0
470,4,0,0,40,0.0,0.0,1.0,40,1200,900,300,0.75,15,9,6,346.02333078524146,0.810443376068376,0.2145833333333329,0.21989224569255675,134380.19390581723,1299.7364573715015,135679.93036318873,469,8,247.075,37,3,19,31.820184715172,0.6621621621621622,40.78947368421053,1036.8421052631584,28.022759601706984,0
471,4,0,1,39,0.0,0.025,0.975,40,850,600,250,0.7058823529411765,11,6,5,348.45284227036876,0.809508547008547,0.21366687810550822,0.22195390134918627,134465.4740521121,1370.9753241381904,135836.4493762503,470,9,248.075,37,3,19,31.672106811854658,0.6630067567567568,40.70723684210526,1037.1710526315783,28.03165007112374,0
472,4,0,1,38,0.0,0.02564102564102564,0.9743589743589743,39,1050,700,350,0.6666666666666666,14,7,7,349.0205458652824,0.8063427800269906,0.20353120548433057,0.22337314935378103,134638.42220599003,1598.3421741478146,136236.76438013784,471,10,244.69230769230768,36,3,20,31.484872323495384,0.6666666666666665,40.540540540540555,1037.83783783784,28.82882882882889,0
473,4,0,0,38,0.0,0.0,1.0,38,450,200,250,0.4444444444444444,7,2,5,355.42110998059303,0.8024241346609767,0.21857809610473455,0.22710978267826207,134580.80317911957,1966.5716896004856,136547.37486872004,472,11,251.1315789473684,35,3,20,31.376301357129563,0.6681547619047619,40.59606481481482,1037.6157407407413,29.646164021164036,0
474,4,0,0,38,0.0,0.0,1.0,38,1250,700,550,0.56,18,7,11,355.43282150162395,0.8018314366998578,0.22383404014863006,0.22839345275724607,134784.55387397564,1981.3708556529837,136765.92472962863,473,12,252.1315789473684,36,2,17,31.172730723348884,0.6681134259259258,40.39977477477479,1038.4009009009035,28.84446946946954,0
475,4,0,0,38,0.0,0.0,1.0,38,1550,1300,250,0.8387096774193549,18,13,5,357.5102874434546,0.8018314366998578,0.18911670893744903,0.2102122532870905,131476.4596863213,1817.3139483757911,133293.77363469708,474,13,253.1315789473684,35,3,19,34.43895064514916,0.6372023809523808,43.60532407407408,1025.5787037037048,29.30224867724871,6
476,4,1,1,38,0.02564102564102564,0.02564102564102564,0.9743589743589743,39,1100,600,500,0.5454545454545454,16,6,10,355.0944349150508,0.807242465137202,0.1842588452962397,0.21067704307028967,131819.1518165126,1561.6494450531782,133380.8012615658,475,0,247.6153846153846,36,3,14,34.15510655408122,0.638599537037037,43.271396396396405,1026.9144144144157,28.525400400400436,0
477,4,0,0,38,0.0,0.0,1.0,38,700,400,300,0.5714285714285714,10,4,6,362.89283272121446,0.7993717401612138,0.191732713207726,0.21521291523413202,131803.0907064472,1966.0793895747613,133769.17009602196,476,15,255.1315789473684,35,3,15,33.971107604448456,0.6404761904761904,43.28703703703704,1026.851851851852,29.338624338624342,0
478,4,0,0,38,0.0,0.0,1.0,38,850,700,150,0.8235294117647058,10,7,3,362.1543027177149,0.7999644381223329,0.19069829503335822,0.2152792656811599,131892.24222232925,1953.068603180712,133845.31082550995,477,16,256.13157894736844,35,3,16,33.90011737089202,0.6413690476190477,43.200231481481474,1027.199074074073,29.348544973544943,0
479,4,1,0,39,0.02564102564102564,0.0,1.0,39,1000,800,200,0.8,12,8,4,353.6204485380046,0.808029689608637,0.1916113525837575,0.21189382782474145,132195.26113951797,1549.3895077510056,133744.65064726898,478,0,250.53846153846155,36,3,18,33.81401481968171,0.6423611111111112,42.90540540540541,1028.378378378379,28.566066066066085,0
480,4,1,2,38,0.025,0.05,0.95,40,1250,900,350,0.72,16,9,7,339.3439530061571,0.8159188034188034,0.11121503017004919,0.20072161788780826,131703.53366457685,959.5158925817791,132663.04955715864,479,0,245.25,36,4,15,34.67590053026147,0.6374421296296295,43.38400900900901,1026.4639639639647,28.51288788788791,3
481,4,0,0,38,0.0,0.0,1.0,38,1250,1000,250,0.8,15,10,5,352.88863205100944,0.7982456140350878,0.12280602759579207,0.20749476898500321,131476.4596863213,1679.3096011231335,133155.76928744442,480,19,259.13157894736844,35,3,19,34.5574474288079,0.6372023809523808,43.60532407407408,1025.5787037037048,29.30224867724871,0
482,4,1,1,38,0.02564102564102564,0.02564102564102564,0.9743589743589743,39,1150,800,350,0.6956521739130435,15,8,7,342.1988261337869,0.8054993252361674,0.12291831879460724,0.20287183983666254,131790.2425229284,1219.6932574466437,133009.93578037503,481,0,253.46153846153845,36,3,15,34.5152902683337,0.6383101851851851,43.29954954954955,1026.8018018018024,28.52227227227229,0
483,4,1,0,39,0.02564102564102564,0.0,1.0,39,1350,900,450,0.6666666666666666,18,9,9,340.0651102727023,0.8029689608636977,0.12344036935775704,0.2022901598822187,131918.83710612866,1172.1987775084488,133091.03588363712,482,0,254.43589743589743,37,2,17,34.44059753797987,0.637668918918919,43.17434210526315,1027.3026315789461,27.764935988620167,0
484,4,0,0,39,0.0,0.0,1.0,39,1150,900,250,0.782608695652174,14,9,5,337.7167001646808,0.8022379667116509,0.11499346255053555,0.2016405316779437,132059.67821829786,1119.7517505386224,133179.42996883648,483,1,255.43589743589743,37,2,17,34.359220539079736,0.6390765765765766,43.03728070175438,1027.850877192982,27.77975343764816,0
485,4,1,2,38,0.025,0.05,0.95,40,900,400,500,0.4444444444444444,14,4,10,332.90631884395543,0.8086805555555555,0.11194704049844262,0.20011784335001803,132315.55103550287,809.7366042077473,133125.28763971062,484,0,250.025,38,2,18,34.22572689511941,0.6398026315789473,42.78846153846153,1028.8461538461531,27.07489878542508,0
486,4,0,0,38,0.0,0.0,1.0,38,700,300,400,0.42857142857142855,11,3,8,349.2820146843309,0.7964971550497867,0.11931785413566742,0.20833644875877158,132021.60564280508,1622.5544801558426,133644.16012296092,485,3,263.57894736842104,36,2,18,34.10037256191102,0.640625,43.07432432432433,1027.7027027027036,28.547297297297323,0
487,4,0,1,37,0.0,0.02631578947368421,0.9736842105263158,38,1300,1000,300,0.7692307692307693,16,10,6,352.1797359074408,0.7982752489331437,0.09634535651568954,0.21137543842275763,132256.9820161011,1715.6457996691245,133972.62781577022,486,4,264.57894736842104,37,1,20,33.78893063994598,0.6410472972972973,42.8453947368421,1028.6184210526314,27.800497866287337,5
488,4,0,0,37,0.0,0.0,1.0,37,800,400,400,0.5,12,4,8,356.97118473930124,0.7923548548548548,0.10820874537882563,0.2137379598593156,132166.31063073222,2035.9128976950076,134202.22352842722,487,41,272.6216216216216,36,1,20,33.757027342751805,0.6420717592592593,42.933558558558566,1028.265765765767,28.56293793793797,0
489,4,0,0,37,0.0,0.0,1.0,37,350,200,150,0.5714285714285714,5,2,3,357.2320042884914,0.7919169169169169,0.10482887618235814,0.21405791753034817,132195.261139518,2044.8756188621164,134240.1367583801,488,42,273.6216216216216,36,1,20,33.72116367352898,0.642361111111111,42.90540540540541,1028.3783783783792,28.56606606606609,0
490,4,0,0,37,0.0,0.0,1.0,37,1000,700,300,0.7,13,7,6,358.5110365720873,0.7918543543543544,0.10467056373361072,0.21548400198174955,132311.09487866264,2086.9975549874393,134398.09243365008,489,43,274.6216216216216,36,1,20,33.57163054582603,0.6435185185185184,42.7927927927928,1028.8288288288304,28.57857857857862,0
491,4,0,0,37,0.0,0.0,1.0,37,1400,1300,100,0.9285714285714286,15,13,2,355.8900184867533,0.7913538538538538,0.10072984501509064,0.21506295036512843,132513.92598257068,2032.076713537891,134546.00269610857,490,44,275.6216216216216,36,1,20,33.4349593495935,0.6455439814814814,42.595720720720735,1029.6171171171193,28.600475475475534,0
492,4,1,2,36,0.02631578947368421,0.05263157894736842,0.9473684210526316,38,1000,400,600,0.4,16,4,12,352.2906292440018,0.7997569938359412,0.09258678611422178,0.2144774556278251,132793.26331178838,1756.3644582948777,134549.62777008326,491,0,269.3421052631579,37,1,17,33.24689716312058,0.6463963963963963,42.32456140350878,1030.701754385966,27.856804172593677,0
493,4,1,2,35,0.02702702702702703,0.05405405405405406,0.9459459459459459,37,700,600,100,0.8571428571428571,8,6,2,360.03957039097406,0.7904779779779779,0.06212640978137851,0.21824267398053285,132629.89921932074,2152.1336891235487,134782.0329084443,492,0,264.3783783783784,36,1,18,33.21148099559055,0.6467013888888888,42.48310810810811,1030.0675675675682,28.612987987988006,6
494,4,0,0,35,0.0,0.0,1.0,35,650,200,450,0.3076923076923077,11,2,9,371.4323899896417,0.7838935574229692,0.06047894302229495,0.22467763450422412,132551.19756235846,2846.7616213152082,135397.95918367367,493,47,273.48571428571427,34,1,22,32.997350674373784,0.6501225490196078,42.55952380952382,1029.7619047619062,30.28711484593842,0
495,4,1,1,35,0.027777777777777776,0.027777777777777776,0.9722222222222222,36,800,700,100,0.875,9,7,2,363.92818196692815,0.7889880952380953,0.05541518497722886,0.22151609435512626,132785.41512613607,2464.870943715717,135250.28606985178,494,0,266.8611111111111,35,1,21,32.95491764926072,0.6502976190476188,42.33217592592593,1030.671296296297,29.447751322751344,0
496,4,1,0,36,0.027777777777777776,0.0,1.0,36,750,400,350,0.5333333333333333,11,4,7,363.46848744440587,0.7945767195767196,0.06534682477337639,0.22229702756466052,132964.41139671227,2465.674698859759,135430.08609557204,495,0,267.8333333333333,35,1,22,32.786841170089396,0.6520833333333332,42.158564814814824,1031.365740740742,29.467592592592627,0
497,4,0,0,36,0.0,0.0,1.0,36,1250,900,350,0.72,16,9,7,365.38423219677975,0.7916997354497355,0.06284582024824292,0.2243640367952127,133113.66705246916,2527.5270061728475,135641.194058642,496,1,268.8333333333333,35,1,22,32.587483176312254,0.6535714285714285,42.01388888888889,1031.9444444444448,29.484126984126995,0
498,4,0,0,36,0.0,0.0,1.0,36,950,800,150,0.8421052631578947,11,8,3,366.58889483345706,0.7904431216931217,0.05841365911977903,0.22618991145948159,133292.8843557099,2572.7382330246946,135865.62258873458,497,2,269.8333333333333,35,1,22,32.37642905178212,0.6553571428571429,41.84027777777778,1032.638888888889,29.503968253968253,0
499,4,0,0,36,0.0,0.0,1.0,36,550,300,250,0.5454545454545454,8,3,5,363.98605606464974,0.7904431216931217,0.05297823596792739,0.22494539919120035,133352.6502486282,2507.7010459533553,135860.35129458155,498,3,270.8333333333333,35,1,22,32.383647093978794,0.655952380952381,41.782407407407405,1032.8703703703698,29.51058201058199,0
500,4,0,0,36,0.0,0.0,1.0,36,750,600,150,0.8,9,6,3,364.40739995690103,0.7894179894179895,0.05412730418331413,0.22575051071584024,133442.32420535415,2525.474081575796,135967.79828692993,499,4,271.8333333333333,35,1,23,32.28279843919196,0.6568452380952381,41.695601851851855,1033.217592592593,29.52050264550266,0
501,4,0,0,36,0.0,0.0,1.0,36,1000,800,200,0.8,12,8,4,361.42476331851356,0.788723544973545,0.06022923740935582,0.22499006346510644,133621.76254125923,2458.84278013543,136080.60532139466,500,5,272.8333333333333,35,1,23,32.179955408783904,0.6586309523809525,41.521990740740726,1033.9120370370354,29.54034391534387,0
502,4,0,0,36,0.0,0.0,1.0,36,1000,600,400,0.6,14,6,8,365.8163212146616,0.7882936507936509,0.06428429324579721,0.22827755910434464,133711.52692043895,2582.771776406032,136294.29869684498,501,6,273.8333333333333,35,1,18,31.97646225007459,0.6595238095238095,41.43518518518518,1034.2592592592591,29.550264550264547,0
503,4,0,1,35,0.0,0.027777777777777776,0.9722222222222222,36,1200,900,300,0.75,15,9,6,365.2049746006537,0.7881283068783069,0.06369587109768382,0.22808084262795533,133741.455078125,2568.6089409722226,136310.06401909722,502,7,274.8333333333333,35,1,18,31.962277609936216,0.6598214285714286,41.40625,1034.375,29.553571428571427,0
504,4,0,0,35,0.0,0.0,1.0,35,750,500,250,0.6666666666666666,10,5,5,369.4973952769044,0.7829131652661064,0.06429886871875823,0.2306173398107575,133718.36734693882,2881.7176870748344,136600.08503401364,503,8,280.6857142857143,34,1,18,31.874424493554322,0.661764705882353,41.42857142857143,1034.2857142857147,30.420168067226903,0
505,4,0,0,35,0.0,0.0,1.0,35,600,500,100,0.8333333333333334,7,5,2,371.58357315410746,0.7820028011204482,0.06165932548813391,0.23269484278497835,133841.52494331053,2946.662414965973,136788.1873582765,504,9,281.6857142857143,34,1,18,31.697010661144358,0.6629901960784315,41.3095238095238,1034.7619047619037,30.434173669467754,0
506,4,0,0,35,0.0,0.0,1.0,35,800,700,100,0.875,9,7,2,369.1937983026455,0.7806022408963584,0.06267514249577055,0.23216764019075242,133995.55165816323,2894.065334467118,136889.61699263036,505,10,282.6857142857143,34,1,18,31.604528381434214,0.6645220588235294,41.160714285714285,1035.3571428571424,30.451680672268896,0
507,4,1,0,36,0.027777777777777776,0.0,1.0,36,1100,800,300,0.7272727272727273,14,8,6,362.69714159346466,0.7899801587301588,0.009415086577658105,0.22218004281941922,133024.10361207562,2449.4924286265395,135473.59604070216,506,0,275.80555555555554,35,1,19,32.74676035005048,0.6526785714285714,42.10069444444444,1031.5972222222222,29.474206349206348,4
508,4,1,0,37,0.02702702702702703,0.0,1.0,37,900,500,400,0.5555555555555556,13,5,8,354.07545944825347,0.7989864864864865,0.0121122103457727,0.2186684201077397,133326.80389426596,2041.549869125888,135368.35376339185,507,0,269.3243243243243,36,1,20,32.66546723367136,0.6536458333333334,41.807432432432435,1032.7702702702709,28.68806306306308,0
509,4,0,0,37,0.0,0.0,1.0,37,750,600,150,0.8,9,6,3,349.18637418978557,0.7994244244244244,0.011819536999393643,0.21615626159359608,133414.0453798393,1917.273354435522,135331.31873427483,508,1,270.3243243243243,36,1,20,32.7042911125645,0.6545138888888888,41.722972972972975,1033.1081081081081,28.69744744744745,0
510,4,0,0,37,0.0,0.0,1.0,37,800,600,200,0.75,10,6,4,349.36139170146834,0.799049049049049,0.011296322641378032,0.21677886494109852,133502.12358806998,1928.1102199664153,135430.2338080364,509,2,271.3243243243243,35,2,20,32.61155131220368,0.6574404761904762,41.637731481481474,1033.4490740740728,29.527116402116366,0
511,4,1,1,37,0.02631578947368421,0.02631578947368421,0.9736842105263158,38,750,400,350,0.5333333333333333,11,4,7,338.84184913688233,0.8029279279279279,0.006741540841761262,0.21157460124556512,133734.17494775177,1462.9470264183046,135197.1219741701,510,0,265.1578947368421,36,2,15,32.65128833242604,0.6576967592592593,41.413288288288285,1034.3468468468466,28.73185685685685,0
512,4,0,0,37,0.0,0.0,1.0,37,700,500,200,0.7142857142857143,9,5,4,345.75412696696895,0.7975475475475475,0.011837184250977462,0.21506099318029007,133591.8477794924,1837.9865397805174,135429.83431927292,511,4,273.3243243243243,35,2,20,32.61494252873563,0.6583333333333334,41.550925925925924,1033.7962962962958,29.537037037037024,0
513,4,0,0,37,0.0,0.0,1.0,37,800,700,100,0.875,9,7,2,344.859036115333,0.7967342342342342,0.012670904420596596,0.214677753980367,133621.7625412593,1816.1344468021107,135437.8969880614,512,5,274.3243243243243,35,2,20,32.608143027724914,0.6586309523809524,41.52199074074073,1033.912037037036,29.540343915343886,0
514,4,0,0,37,0.0,0.0,1.0,37,700,500,200,0.7142857142857143,9,5,4,344.6655867204822,0.7962337337337337,0.013031050076377504,0.21490488606751626,133681.60211173265,1815.0895651148762,135496.69167684752,513,6,275.3243243243243,35,2,20,32.553278306286124,0.6592261904761905,41.46412037037037,1034.1435185185182,29.546957671957664,0
515,4,0,0,37,0.0,0.0,1.0,37,1400,1200,200,0.8571428571428571,16,12,4,344.4572859550326,0.7961086086086085,0.010650755262120226,0.21525065501924687,133763.29665814445,1815.1484254524537,135578.4450835969,514,7,276.3243243243243,36,1,15,32.47695768923723,0.6579861111111112,41.38513513513512,1034.459459459458,28.734984984984944,0
516,4,0,0,37,0.0,0.0,1.0,37,1100,900,200,0.8181818181818182,13,9,4,344.3732215368535,0.7951076076076076,0.007529566785198671,0.215708625269403,133850.68081172364,1818.9180312068559,135669.59884293049,515,8,277.3243243243243,36,1,15,32.3917637029782,0.6588541666666667,41.30067567567566,1034.7972972972955,28.74436936936932,0
517,4,0,0,37,0.0,0.0,1.0,37,500,200,300,0.4,8,2,6,343.2713436763906,0.7944819819819819,0.0011230636706547337,0.21570016831285402,133967.23740209788,1797.4227183264188,135764.6601204243,516,9,278.3243243243243,36,1,15,32.30379092787991,0.6600115740740742,41.188063063063055,1035.2477477477464,28.756881881881846,0
518,4,0,0,37,0.0,0.0,1.0,37,1100,900,200,0.8181818181818182,13,9,4,342.99858737045804,0.7932932932932932,0.0008110752918844,0.2162137085706718,134083.8447188742,1798.1138655547368,135881.95858442894,517,10,279.3243243243243,36,1,15,32.19437497734768,0.6611689814814815,41.07545045045045,1035.6981981981976,28.76939439439438,0
519,4,0,1,36,0.0,0.02702702702702703,0.972972972972973,37,600,500,100,0.8333333333333334,7,5,2,343.2937885446059,0.7939814814814815,0.0055470189180375495,0.216743964366632,134142.16739966313,1810.0345700430132,135952.20196970613,518,11,280.3243243243243,36,1,15,32.12849222741602,0.6617476851851851,41.01914414414414,1035.9234234234232,28.775650650650643,0
520,4,0,0,36,0.0,0.0,1.0,36,750,600,150,0.8,9,6,3,351.277357663346,0.7842923280423281,0.007255018882926123,0.22063375610540495,133951.04595336074,2210.793895747598,136161.83984910834,519,13,288.80555555555554,35,1,15,32.112775790101374,0.6619047619047619,41.2037037037037,1035.185185185185,29.576719576719572,0
521,4,0,1,35,0.0,0.027777777777777776,0.9722222222222222,36,950,700,250,0.7368421052631579,12,7,5,351.52565291143253,0.7842923280423281,0.008998435054773157,0.22114968290757203,134010.95920138882,2221.657986111102,136232.6171874999,520,14,289.80555555555554,35,1,16,32.046445338698845,0.6625,41.14583333333333,1035.416666666666,29.583333333333314,0
522,4,0,0,35,0.0,0.0,1.0,35,800,600,200,0.75,10,6,4,360.4481721568639,0.7723389355742296,0.014382627835542339,0.22666795034332946,133995.55165816328,2659.690334467119,136655.2419926304,521,26,298.6857142857143,34,1,17,31.83089954390402,0.6645220588235294,41.160714285714285,1035.357142857143,30.451680672268907,0
523,4,0,0,35,0.0,0.0,1.0,35,1250,1000,250,0.8,15,10,5,359.45368706401666,0.772689075630252,0.011747709886068769,0.22699317741880073,134149.66695011346,2644.118480725634,136793.78543083908,522,27,299.6857142857143,34,1,18,31.70248218800276,0.6660539215686274,41.011904761904766,1035.9523809523816,30.46918767507005,0
524,4,0,0,35,0.0,0.0,1.0,35,400,300,100,0.75,5,3,2,359.45368706401666,0.772689075630252,0.011747709886068769,0.22699317741880073,134149.66695011346,2644.118480725634,136793.78543083908,523,28,300.6857142857143,34,1,18,31.70248218800276,0.6660539215686274,41.011904761904766,1035.9523809523816,30.46918767507005,0
525,4,0,0,35,0.0,0.0,1.0,35,750,500,250,0.6666666666666666,10,5,5,359.07042041977866,0.7726190476190475,0.010974369072232593,0.2275157991393445,134273.0229591837,2642.6941609977403,136915.71712018145,524,29,301.6857142857143,34,1,18,31.589086070908962,0.6672794117647058,40.892857142857146,1036.4285714285718,30.483193277310935,0
526,4,0,0,35,0.0,0.0,1.0,35,750,600,150,0.8,9,6,3,358.01428852059007,0.7731092436974789,0.014147909967845873,0.22722947699980314,134334.7222222223,2618.7500000000055,136953.4722222223,525,30,302.6857142857143,34,1,18,31.55479635584137,0.6678921568627452,40.833333333333336,1036.6666666666672,30.49019607843139,0
527,4,0,0,35,0.0,0.0,1.0,35,1050,600,450,0.5714285714285714,15,6,9,359.82763916002415,0.7738095238095237,0.015253403313105096,0.2287663311740009,134396.43565759642,2671.910430839006,137068.3460884354,526,31,303.6857142857143,34,1,18,31.446134711060086,0.6685049019607843,40.773809523809526,1036.9047619047622,30.497198879551828,0
528,4,1,0,36,0.027777777777777776,0.0,1.0,36,1150,1100,50,0.9565217391304348,12,11,1,354.4182475414101,0.7765211640211641,0.022917781344747423,0.22763151362711195,134767.013888889,2352.8663548752943,137119.8802437643,527,0,296.22222222222223,34,2,20,31.216559657570894,0.6721813725490196,40.41666666666667,1038.3333333333342,30.539215686274535,0
529,4,0,0,36,0.0,0.0,1.0,36,1000,800,200,0.8,12,8,4,353.66212100064865,0.7762235449735451,0.026090417064629667,0.2277270852937757,134859.73816609982,2338.956207483001,137198.6943735828,528,1,297.22222222222223,34,2,15,31.143744030563525,0.6731004901960784,40.327380952380956,1038.6904761904766,30.549719887955195,0
530,4,0,0,36,0.0,0.0,1.0,36,1000,900,100,0.9,11,9,2,355.2682062801844,0.7744047619047619,0.0330864610015964,0.22965825948090554,135001.46182966832,2392.345437885816,137393.80726755413,529,2,298.22222222222223,35,1,15,30.960783494821253,0.6723214285714285,40.19097222222223,1039.236111111112,29.69246031746034,0
531,4,0,1,35,0.0,0.027777777777777776,0.9722222222222222,36,750,400,350,0.5333333333333333,11,4,7,353.2631911526196,0.7746031746031746,0.03392656101151803,0.22874237344929174,135061.60950628007,2342.4590352794985,137404.06854155957,530,3,299.22222222222223,35,1,16,30.952960880377095,0.6729166666666666,40.133101851851855,1039.467592592593,29.699074074074087,0
532,4,0,0,35,0.0,0.0,1.0,35,650,400,250,0.6153846153846154,9,4,5,360.77604695535524,0.7669467787114845,0.03271852445870116,0.23310245106390062,134983.42013888893,2739.7569444444507,137723.17708333337,531,4,307.77142857142854,34,1,16,30.835672280139004,0.6743259803921569,40.208333333333336,1039.166666666667,30.563725490196088,0
533,4,0,0,35,0.0,0.0,1.0,35,1450,1100,350,0.7586206896551724,18,11,7,359.9091880341881,0.7639355742296918,0.04262820512820542,0.2339409722222221,135199.99999999988,2731.9444444444302,137931.94444444432,532,5,308.77142857142854,34,1,17,30.64236111111111,0.6764705882352942,39.99999999999999,1039.999999999999,30.58823529411762,0
534,4,0,0,35,0.0,0.0,1.0,35,1050,700,350,0.6666666666666666,14,7,7,361.77337683079463,0.7641456582633053,0.03955541026479237,0.23596263533590608,135323.83786848062,2791.3123582766275,138115.15022675725,533,6,309.77142857142854,34,1,17,30.470537757437064,0.6776960784313726,39.88095238095237,1040.4761904761895,30.602240896358513,0
535,4,0,0,35,0.0,0.0,1.0,35,850,600,250,0.7058823529411765,11,6,5,362.0385555104501,0.7627450980392156,0.03300774231485404,0.23736051023196383,135509.7009637188,2811.9472789115584,138321.64824263036,534,7,310.77142857142854,34,1,18,30.278603552099998,0.6795343137254901,39.70238095238095,1041.190476190476,30.62324929971988,0
536,4,0,0,35,0.0,0.0,1.0,35,950,500,450,0.5263157894736842,14,5,9,359.9632848655916,0.7624649859943977,0.0429959342292181,0.23661298116371604,135602.68034297045,2762.3972505668858,138365.07759353734,535,8,311.77142857142854,34,1,18,30.240122680687314,0.680453431372549,39.613095238095234,1041.5476190476186,30.633753501400548,0
537,4,0,0,35,0.0,0.0,1.0,35,550,300,250,0.5454545454545454,8,3,5,359.6800000000001,0.7620448179271708,0.04479999999999973,0.23663157894736825,135633.6805555554,2756.94444444442,138390.6249999998,536,9,312.77142857142854,34,1,19,30.216666666666654,0.6807598039215688,39.58333333333332,1041.6666666666654,30.637254901960745,0
538,4,1,1,35,0.027777777777777776,0.027777777777777776,0.9722222222222222,36,1250,1100,150,0.88,14,11,3,351.89855641961515,0.7679563492063493,0.04284745344678775,0.23347614089401544,135935.25618355614,2367.084083504785,138302.3402670609,537,0,305.05555555555554,35,1,13,30.11977432482426,0.6815476190476191,39.293981481481474,1042.8240740740732,29.79497354497352,0
539,4,0,0,35,0.0,0.0,1.0,35,900,700,200,0.7777777777777778,11,7,4,360.10222692502816,0.7585434173669467,0.042702235556932866,0.2391854139567985,135974.9167375283,2792.9740646258488,138767.89080215417,538,11,314.77142857142854,34,1,15,29.86650116044592,0.6841299019607843,39.25595238095238,1042.9761904761904,30.675770308123248,0
540,4,0,0,35,0.0,0.0,1.0,35,1000,800,200,0.8,12,8,4,360.48392858965576,0.7580532212885154,0.040803286170698394,0.2400669566990686,136068.05555555553,2810.069444444441,138878.12499999997,539,12,315.77142857142854,34,1,16,29.764044195953137,0.6850490196078431,39.166666666666664,1043.3333333333333,30.68627450980392,0
541,4,0,0,35,0.0,0.0,1.0,35,1200,1000,200,0.8333333333333334,14,10,4,360.2660997739333,0.7581232492997199,0.03664808839346856,0.24034190491767862,136130.16581632648,2808.6167800453454,138938.78259637184,540,13,316.77142857142854,34,1,16,29.708057646969348,0.6856617647058824,39.107142857142854,1043.571428571428,30.69327731092435,0
542,4,0,0,35,0.0,0.0,1.0,35,1200,800,400,0.6666666666666666,16,8,8,359.3997334011351,0.7567927170868347,0.03694237255926636,0.24069376354949054,136267.37618151994,2794.891734182082,139062.26791570202,541,14,317.77142857142854,35,0,16,29.59448786165614,0.6848214285714287,38.975694444444436,1044.0972222222213,29.831349206349177,0
543,4,0,0,35,0.0,0.0,1.0,35,800,400,400,0.5,12,4,8,359.30151479270285,0.7567226890756302,0.03579820755613272,0.24083345218868976,136297.58900248617,2794.3860382372977,139091.97504072348,542,15,318.77142857142854,35,0,17,29.56707677529003,0.6851190476190476,38.94675925925925,1044.2129629629621,29.83465608465606,0
544,4,0,1,34,0.0,0.02857142857142857,0.9714285714285714,35,1350,1000,350,0.7407407407407407,17,10,7,359.1942416076622,0.7573529411764706,0.03693418406928384,0.240967259630181,136327.80517243216,2793.6325177897716,139121.43769022194,543,16,319.77142857142854,35,0,18,29.539902656174974,0.6854166666666668,38.91782407407407,1044.3287037037028,29.837962962962937,0
545,4,0,0,34,0.0,0.0,1.0,34,1050,800,250,0.7619047619047619,13,8,5,365.92311465967384,0.7524138443256091,0.044491624908602034,0.24475818401607005,136223.3577806122,3169.455073696138,139392.81285430831,544,17,326.52941176470586,34,0,18,29.46791728437298,0.6865808823529411,39.01785714285714,1043.9285714285709,30.703781512605026,0
546,4,0,0,34,0.0,0.0,1.0,34,850,500,350,0.5882352941176471,12,5,7,368.8880917151192,0.7505941770647654,0.04622614945225845,0.24782726774184213,136378.7485827665,3261.699263038552,139640.44784580506,545,18,327.52941176470586,34,0,18,29.236237747891497,0.6881127450980392,38.86904761904762,1044.5238095238099,30.721288515406172,0
547,4,0,0,34,0.0,0.0,1.0,34,1150,800,350,0.6956521739130435,15,8,7,370.4879589054058,0.7508541295306002,0.04703134529418462,0.24956046165101683,136472.02558106591,3312.2484410431,139784.27402210902,546,19,328.52941176470586,34,0,18,29.101866621093,0.689031862745098,38.77976190476191,1044.8809523809537,30.731792717086872,0
548,4,0,0,34,0.0,0.0,1.0,34,900,700,200,0.7777777777777778,11,7,4,371.04804354481337,0.7494800950683305,0.05158783331100092,0.2506001401787278,136565.3344671202,3334.4600340136044,139899.79450113382,547,20,329.52941176470586,34,0,19,28.994637433561103,0.6899509803921569,38.69047619047619,1045.2380952380954,30.74229691876751,0
549,4,0,0,34,0.0,0.0,1.0,34,700,500,200,0.7142857142857143,9,5,4,372.19207136008197,0.7485888294711824,0.04617352405443076,0.2522635150329442,136689.7959183672,3374.971655328779,140064.76757369598,548,21,330.52941176470586,34,0,19,28.84126442015786,0.6911764705882353,38.57142857142856,1045.7142857142844,30.756302521008365,0
550,4,0,0,34,0.0,0.0,1.0,34,1050,900,150,0.8571428571428571,12,9,3,373.9268938114187,0.7476232917409389,0.048911657904347594,0.25435967270661985,136817.0614216887,3431.9193026475205,140248.98072433623,549,22,331.52941176470586,33,1,20,28.66968782944829,0.694760101010101,38.44975490196078,1046.2009803921562,31.703060011883522,0
551,4,0,0,34,0.0,0.0,1.0,34,1300,900,400,0.6923076923076923,17,9,8,374.045559229668,0.7468434343434344,0.04329472364923492,0.25560777335518614,136977.3719843331,3447.1555411380396,140424.52752547112,550,23,332.52941176470586,33,1,17,28.50766799344416,0.6963383838383839,38.29656862745099,1046.8137254901972,31.72162804515749,0
552,4,0,0,34,0.0,0.0,1.0,34,1000,600,400,0.6,14,6,8,374.86409992024295,0.7456179441473559,0.044325935922771675,0.25640224224328545,137009.44536055843,3471.984483131487,140481.42984368993,551,24,333.52941176470586,33,1,17,28.454460767099764,0.6966540404040404,38.26593137254902,1046.9362745098038,31.725341651812236,0
553,4,0,0,34,0.0,0.0,1.0,34,1450,1100,350,0.7586206896551724,18,11,7,374.0609608237246,0.7447638146167559,0.04760659528200617,0.25703159912549833,137169.8685601692,3461.978565936187,140631.8471261054,552,25,334.52941176470586,33,1,17,28.316565278427703,0.6982323232323232,38.11274509803922,1047.5490196078435,31.74390968508617,0
554,4,0,0,34,0.0,0.0,1.0,34,850,600,250,0.7058823529411765,11,6,5,372.38812814244585,0.7450237670825907,0.036619418023259964,0.2570650250203663,137330.3856239187,3428.0410479142665,140758.42667183297,553,26,335.52941176470586,33,1,18,28.201483884796765,0.6998106060606061,37.95955882352941,1048.1617647058824,31.762477718360074,0
555,4,0,0,34,0.0,0.0,1.0,34,950,700,250,0.7368421052631579,12,7,5,372.5979007811693,0.743204099821747,0.03620438357671252,0.2579245662689065,137426.74091695502,3440.98303537101,140867.72395232602,554,27,336.52941176470586,33,1,19,28.10065061555244,0.7007575757575758,37.86764705882353,1048.5294117647059,31.77361853832442,0
556,4,0,0,34,0.0,0.0,1.0,34,750,500,250,0.6666666666666666,10,5,5,373.6680990723537,0.7420528817587642,0.030648852600977383,0.2593856658524149,137523.1300010813,3477.6013131968434,141000.73131427815,555,28,337.52941176470586,33,1,19,27.977251041788364,0.7017045454545454,37.775735294117645,1048.8970588235293,31.784759358288767,0
557,4,0,0,34,0.0,0.0,1.0,34,950,500,450,0.5263157894736842,14,5,9,375.1949742502885,0.7386734997029115,0.02758511763332483,0.2621468311115801,137748.16927383697,3536.4841647443327,141284.6534385813,556,29,338.52941176470586,33,1,20,27.714705424546654,0.7039141414141414,37.56127450980392,1049.7549019607843,31.81075460487225,0
558,4,0,0,34,0.0,0.0,1.0,34,900,500,400,0.5555555555555556,13,5,8,370.6218142753934,0.7370023767082591,0.025540079493111323,0.25967770454013495,137844.67099493,3417.648410467142,141262.31940539714,557,30,339.52941176470586,33,1,21,27.739404636869324,0.7048611111111112,37.469362745098046,1050.122549019609,31.82189542483664,0
559,4,0,0,34,0.0,0.0,1.0,34,900,800,100,0.8888888888888888,10,8,2,371.4931874098817,0.7373366013071896,0.02260278673896665,0.2605316379789429,137876.84574442508,3444.061779123397,141320.9075235485,558,31,340.52941176470586,33,1,21,27.684753014391298,0.7051767676767677,37.43872549019607,1050.2450980392146,31.82560903149135,0
560,4,0,0,34,0.0,0.0,1.0,34,450,300,150,0.6666666666666666,6,3,3,371.4931874098817,0.7373366013071896,0.02260278673896665,0.2605316379789429,137876.84574442508,3444.061779123397,141320.9075235485,559,32,341.52941176470586,33,1,21,27.684753014391298,0.7051767676767677,37.43872549019607,1050.2450980392146,31.82560903149135,0
561,4,0,0,34,0.0,0.0,1.0,34,450,200,250,0.4444444444444444,7,2,5,370.1515725652109,0.7364824717765894,0.019432834386817754,0.2598336714542525,137909.0242484861,3409.4484393021894,141318.47268778828,560,33,342.52941176470586,33,1,21,27.688207327033027,0.7054924242424243,37.408088235294116,1050.3676470588232,31.829322638146156,0
562,4,0,0,34,0.0,0.0,1.0,34,1550,1300,250,0.8387096774193549,18,13,5,369.96231678261057,0.7360368389780155,0.003771271843248325,0.2418852930280763,135410.37589208476,3219.347276287965,138629.72316837273,561,34,343.52941176470586,33,1,20,30.171293025628955,0.6808712121212122,39.79779411764706,1040.8088235294117,31.539661319073083,4
563,4,0,0,34,0.0,0.0,1.0,34,800,700,100,0.875,9,7,2,372.1406335932302,0.7358511586452764,-0.020719875933205456,0.22496715099724168,132527.98064291905,3181.4361212269905,135709.41676414604,562,35,344.52941176470586,32,2,19,33.002503576537926,0.6546223958333334,42.582070707070706,1029.6717171717169,32.17724116161615,8
564,4,0,0,34,0.0,0.0,1.0,34,1200,1000,200,0.8333333333333334,14,10,4,373.4836717397387,0.7385992275698159,-0.01828279406358746,0.2269545975478784,132723.0659658453,3113.97960029589,135837.0455661412,563,36,345.52941176470586,32,2,17,32.77146387289139,0.6565755208333334,42.39267676767677,1030.4292929292928,32.2009154040404,0
565,4,0,0,34,0.0,0.0,1.0,34,900,700,200,0.7777777777777778,11,7,4,374.60821265621905,0.7377822341057636,-0.014361874572241362,0.2284298772470522,132853.20255905014,3153.5801512600847,136006.78271031022,564,37,346.52941176470586,32,2,17,32.61150234741785,0.6578776041666666,42.266414141414145,1030.9343434343439,32.216698232323246,0
566,4,0,0,34,0.0,0.0,1.0,34,1200,700,500,0.5833333333333334,17,7,10,369.78687757601307,0.7365567439096852,-0.018821945618291203,0.2266713110782898,133048.52701573828,3039.919874247538,136088.44688998582,565,38,347.52941176470586,32,2,18,32.539366866560606,0.6598307291666666,42.07702020202021,1031.6919191919199,32.240372474747495,0
567,4,0,0,34,0.0,0.0,1.0,34,1000,700,300,0.7,13,7,6,371.48168753635815,0.735034165181224,-0.022236934901193273,0.22830761758813473,133146.24304917868,3092.2782114069983,136238.52126058567,566,39,348.52941176470586,32,2,18,32.397439034336514,0.6608072916666667,41.98232323232323,1032.0707070707072,32.2522095959596,0
568,4,0,0,34,0.0,0.0,1.0,34,800,400,400,0.5,12,4,8,370.1789411665685,0.7346256684491979,-0.018942255801402963,0.22770600782819397,133178.8230314509,3059.9991391184617,136238.8221705694,567,40,349.52941176470586,32,2,18,32.39831804281344,0.6611328125,41.95075757575758,1032.19696969697,32.25615530303031,0
569,4,0,0,34,0.0,0.0,1.0,34,450,300,150,0.6666666666666666,6,3,3,370.1789411665685,0.7346256684491979,-0.018942255801402963,0.22770600782819397,133178.8230314509,3059.9991391184617,136238.8221705694,568,41,350.52941176470586,32,2,18,32.39831804281344,0.6611328125,41.95075757575758,1032.19696969697,32.25615530303031,0
570,4,0,1,33,0.0,0.029411764705882353,0.9705882352941176,34,1050,600,450,0.5714285714285714,15,6,9,371.0148412442226,0.7345142602495545,-0.0140340222952835,0.2290507008912135,133313.9766706315,3092.2927780180707,136406.26944864957,569,42,351.52941176470586,33,1,19,32.24098631383253,0.6600378787878787,41.81985294117647,1032.7205882352941,31.2945632798574,0
571,4,0,0,33,0.0,0.0,1.0,33,600,400,200,0.6666666666666666,8,4,4,370.9276844411977,0.7316130050505051,0.01146601146601145,0.2213600697471666,132040.89506172854,3195.524691358042,135236.41975308658,570,43,358.7878787878788,32,1,16,33.52477477477478,0.6497395833333333,43.055555555555564,1027.777777777779,32.11805555555559,2
572,4,0,0,33,0.0,0.0,1.0,33,450,200,250,0.4444444444444444,7,2,5,369.96339588454504,0.7321654040404041,0.009730023487547035,0.2209737348419723,132073.33953486895,3172.460240026536,135245.79977489548,571,44,359.7878787878788,32,1,16,33.516818163206814,0.6500651041666666,43.0239898989899,1027.9040404040409,32.12200126262628,0
573,4,0,0,33,0.0,0.0,1.0,33,950,700,250,0.7368421052631579,12,7,5,369.6197036449166,0.7323232323232324,0.006964674367989643,0.221527040926258,132203.15728305795,3172.978363177242,135376.1356462352,572,45,360.7878787878788,32,1,16,33.39472068753838,0.6513671875,42.89772727272728,1028.4090909090917,32.137784090909115,0
574,4,1,0,34,0.029411764705882353,0.0,1.0,34,600,300,300,0.5,9,3,6,359.38509029333864,0.7469548425430779,0.0049468900761113765,0.21705205920591936,132492.61289227704,2723.173929498271,135215.7868217753,573,0,351.1470588235294,33,1,19,33.366439511169304,0.6518308080808082,42.61642156862745,1029.5343137254904,31.198009506833042,0
575,4,0,0,34,0.0,0.0,1.0,34,1100,900,200,0.8181818181818182,13,9,4,358.5711207985317,0.7472890671420084,0.003345745723325022,0.21710603020107072,132587.2561034218,2708.3922049211824,135295.64830834296,574,1,352.1470588235294,33,1,20,33.29218229414563,0.6527777777777778,42.52450980392157,1029.9019607843138,31.20915032679739,0
576,4,0,0,34,0.0,0.0,1.0,34,600,500,100,0.8333333333333334,7,5,2,357.61710194083093,0.7482174688057042,0.01897079902194987,0.21084298432736898,131579.4706362939,2611.0137927720302,134190.48442906592,575,2,353.1470588235294,33,1,16,34.33219859850295,0.6426767676767676,43.50490196078432,1025.9803921568641,31.090314913844367,5
577,4,1,1,34,0.02857142857142857,0.02857142857142857,0.9714285714285714,35,550,200,350,0.36363636363636365,9,2,7,348.3362214974953,0.7607843137254902,0.017701107560882612,0.20715322228131566,131908.37762188225,2189.6931689342564,134098.0707908165,576,0,344.0285714285714,34,1,18,34.23871054969676,0.643688725490196,43.18452380952382,1027.261904761906,30.213585434173705,0
578,4,0,0,34,0.0,0.0,1.0,34,1050,800,250,0.7619047619047619,13,8,5,358.4873832025641,0.7484774212715389,0.024877699558525368,0.21293286737212544,131862.52170138885,2654.2100694444393,134516.73177083328,577,1,355.05882352941177,33,1,18,34.02425625422583,0.6455176767676768,43.229166666666664,1027.083333333333,31.123737373737363,0
579,4,0,0,34,0.0,0.0,1.0,34,600,400,200,0.6666666666666666,8,4,4,356.8159511883433,0.748923054070113,0.019587961631032158,0.21229156272618036,131925.4632382977,2614.6219302671975,134540.0851685649,578,2,356.05882352941177,33,1,18,34.00371287128712,0.6461489898989898,43.16789215686274,1027.3284313725485,31.131164587046925,0
580,4,0,0,34,0.0,0.0,1.0,34,900,600,300,0.6666666666666666,12,6,6,358.51093400702075,0.7492572786690435,0.01964759192491683,0.21383162820646334,132019.9037029027,2666.1157968089087,134686.0194997116,579,3,357.05882352941177,33,1,18,33.86497336831224,0.6470959595959596,43.07598039215686,1027.6960784313721,31.14230540701128,0
581,4,0,0,34,0.0,0.0,1.0,34,700,300,400,0.42857142857142855,11,3,8,359.37071125292204,0.7476232917409389,0.02556873965609152,0.2147009633895662,132082.88278546714,2693.3439061899285,134776.22669165707,580,4,358.05882352941177,33,1,18,33.779407089492935,0.6477272727272727,43.01470588235294,1027.9411764705883,31.149732620320858,0
582,4,0,0,34,0.0,0.0,1.0,34,1100,800,300,0.7272727272727273,14,8,6,361.50363464081914,0.7488116458704694,0.021713524503961246,0.21633491402542596,132145.87688629373,2754.2429594386763,134900.1198457324,581,5,359.05882352941177,33,1,18,33.661104489471604,0.6483585858585859,42.95343137254902,1028.1862745098038,31.157159833630416,0
583,4,0,0,34,0.0,0.0,1.0,34,850,500,350,0.5882352941176471,12,5,7,362.22603793405,0.747808972073678,0.018237327108176382,0.2169478004500079,132177.37956855522,2775.6177011245504,134952.99726967976,582,6,360.05882352941177,33,1,18,33.61078834465499,0.6486742424242424,42.92279411764705,1028.3088235294106,31.16087344028517,0
584,4,0,0,34,0.0,0.0,1.0,34,550,300,250,0.5454545454545454,8,3,5,359.0450127592811,0.7468434343434344,0.01772135042507439,0.21540134325151156,132240.3961967753,2696.0509479527204,134936.44714472804,583,7,361.05882352941177,33,1,18,33.629090710512735,0.6493055555555556,42.86151960784314,1028.5539215686279,31.168300653594784,0
585,4,1,1,34,0.02857142857142857,0.02857142857142857,0.9714285714285714,35,1050,800,250,0.7619047619047619,13,8,5,346.55877826291925,0.7549019607843137,0.010746899615238226,0.20980265855510935,132581.84700963707,2189.4805839002124,134771.32759353728,584,0,351.7142857142857,34,1,19,33.60690478942702,0.6504289215686274,42.5297619047619,1029.8809523809516,30.290616246498576,0
586,4,0,0,34,0.0,0.0,1.0,34,550,400,150,0.7272727272727273,7,4,3,355.48639455782336,0.74606357694593,0.022464985994397946,0.21451765188834152,132461.07266435973,2617.6218281430083,135078.69449250275,585,9,363.05882352941177,33,1,19,33.49851190476191,0.6515151515151516,42.647058823529406,1029.4117647058813,31.194295900178222,0
587,4,0,0,34,0.0,0.0,1.0,34,850,500,350,0.5882352941176471,12,5,7,354.1017681998499,0.7456922162804516,0.020282285730288452,0.21404050765576538,132524.15687475973,2585.407655709342,135109.56453046907,586,10,364.05882352941177,33,1,19,33.47070142029675,0.6521464646464646,42.58578431372549,1029.6568627450981,31.201723113487823,0
588,4,0,0,34,0.0,0.0,1.0,34,500,300,200,0.6,7,3,4,353.26200623478087,0.7452837195484254,0.023672883787661414,0.21407117248762303,132618.81134960105,2569.837472366395,135188.64882196745,587,11,365.05882352941177,33,1,20,33.39715942891136,0.6530934343434345,42.493872549019606,1030.024509803921,31.212863933452155,0
589,4,0,0,34,0.0,0.0,1.0,34,900,600,300,0.6666666666666666,12,6,6,355.69851303795787,0.7446524064171124,0.02963558788557008,0.21645618629878616,132776.64389898116,2645.690960207604,135422.33485918876,588,12,366.05882352941177,33,1,17,33.175782798256016,0.6546717171717171,42.3406862745098,1030.6372549019607,31.23143196672608,0
590,4,0,0,34,0.0,0.0,1.0,34,1000,800,200,0.8,12,8,4,356.54757463083473,0.7441696375519905,0.03163574310951356,0.21715580378131416,132808.22167255374,2670.4898656766536,135478.7115382304,589,13,367.05882352941177,33,1,17,33.12217631672808,0.6549873737373737,42.31004901960784,1030.759803921568,31.235145573380848,0
591,4,0,0,34,0.0,0.0,1.0,34,700,500,200,0.7142857142857143,9,5,4,356.420352532529,0.7427956030897208,0.03169087934674697,0.2176285084331421,132902.97752066507,2673.8652201076384,135576.8427407727,590,14,368.05882352941177,33,1,17,33.03026701529197,0.6559343434343434,42.218137254901954,1031.1274509803916,31.2462863933452,0
592,4,0,0,34,0.0,0.0,1.0,34,850,500,350,0.5882352941176471,12,5,7,356.0038137963763,0.7420528817587642,0.03469456207286914,0.21811063351804177,133029.3712153979,2671.7926999231036,135701.163915321,591,15,369.05882352941177,33,1,18,32.91409281697948,0.6571969696969697,42.095588235294116,1031.6176470588234,31.261140819964346,0
593,4,0,0,34,0.0,0.0,1.0,34,550,400,150,0.7272727272727273,7,4,3,360.2559803353341,0.7412358882947119,-0.02259632950170043,0.21239880756108537,131579.47063629355,2680.4582372164336,134259.92887350998,592,16,370.05882352941177,33,1,20,34.26451266125178,0.6426767676767678,43.5049019607843,1025.9803921568614,31.090314913844285,4
594,4,0,0,34,0.0,0.0,1.0,34,800,600,200,0.75,10,6,4,359.1830154676565,0.741198752228164,-0.019386543581962012,0.211940760289689,131610.90573637528,2654.480398164145,134265.3861345394,593,17,371.05882352941177,33,1,20,34.260295991082444,0.6429924242424243,43.47426470588234,1026.1029411764694,31.094028520499073,0
595,4,1,1,34,0.02857142857142857,0.02857142857142857,0.9714285714285714,35,700,500,200,0.7142857142857143,9,5,4,350.7445435922636,0.7524509803921569,-0.01681568315782478,0.20841762548994797,131877.80612244873,2251.0841836734444,134128.89030612216,594,0,361.42857142857144,34,1,20,34.20766689847009,0.6433823529411766,43.2142857142857,1027.1428571428553,30.21008403361339,0
596,4,0,0,34,0.0,0.0,1.0,34,1000,700,300,0.7,13,7,6,359.145686672235,0.7424613784907903,-0.01807660183748938,0.2133238837703755,131862.52170138876,2671.5711805555384,134534.0928819443,595,19,373.05882352941177,33,1,21,34.00735294117646,0.6455176767676769,43.22916666666666,1027.0833333333321,31.123737373737338,0
597,4,0,0,34,0.0,0.0,1.0,34,1150,1000,150,0.8695652173913043,13,10,3,362.5442045189675,0.7441325014854427,-0.018957678491243746,0.2158785945090215,131956.93963860045,2768.0447424067593,134724.9843810072,596,20,374.05882352941177,33,1,21,33.82484494274809,0.6464646464646465,43.13725490196078,1027.4509803921562,31.134878193701702,0
598,4,0,0,34,0.0,0.0,1.0,34,750,400,350,0.5333333333333333,11,4,7,362.9853397762182,0.7427213309566251,-0.022118432494600215,0.216860472225279,132082.88278546705,2788.830017301026,134871.71280276807,597,21,375.05882352941177,33,1,21,33.68651645207439,0.6477272727272728,43.014705882352935,1027.9411764705876,31.149732620320837,0
599,4,0,0,34,0.0,0.0,1.0,34,750,600,150,0.8,9,6,3,363.47431032743737,0.7416815210932859,-0.02024118348173598,0.21751422707897275,132145.87688629364,2806.326292771995,134952.20317906563,598,22,376.05882352941177,33,1,21,33.61044894715932,0.6483585858585859,42.95343137254901,1028.186274509803,31.157159833630395,0
600,4,0,0,34,0.0,0.0,1.0,34,900,600,300,0.6666666666666666,12,6,6,366.3003101538031,0.7404931669637552,-0.024828659126266528,0.21993739652582406,132271.9101427334,2890.2483419838327,135162.15848471722,599,23,377.05882352941177,33,1,21,33.41076959733142,0.6496212121212122,42.83088235294117,1028.676470588234,31.172014260249515,0
601,4,0,0,34,0.0,0.0,1.0,34,700,400,300,0.5714285714285714,10,4,6,369.4729357725096,0.7404931669637552,0.04475826431655716,0.2071740955647472,129637.8270977508,2779.5337129949903,132417.36081074577,600,24,378.05882352941177,33,1,16,35.997793822703564,0.6231060606060608,45.40441176470588,1018.3823529411759,30.860071301247753,6
602,4,1,1,34,0.02857142857142857,0.02857142857142857,0.9714285714285714,35,800,600,200,0.75,10,6,4,357.69530007984685,0.7519607843137255,0.04269869068468046,0.20222179836197265,129958.94451530602,2297.1407312925035,132256.08524659852,601,0,368.22857142857146,34,1,17,35.97124927028605,0.6240808823529412,45.08928571428571,1019.6428571428564,29.989495798319307,0
603,4,2,1,35,0.05555555555555555,0.027777777777777776,0.9722222222222222,36,1100,900,200,0.8181818181818182,13,9,4,350.9717698910331,0.7642526455026456,0.042916698153606214,0.20027638770884126,130321.66950660113,1947.8454003771878,132269.51490697832,602,0,358.94444444444446,35,1,18,35.77467316557092,0.6255952380952383,44.733796296296276,1021.0648148148118,29.17328042328034,0
604,4,0,0,35,0.0,0.0,1.0,35,600,400,200,0.6666666666666666,8,4,4,360.03132008843386,0.7499299719887955,0.047124388426271535,0.20482297938966476,130203.51750042841,2375.468857167326,132578.98635759574,603,1,370.2,35,0,18,35.66332123686399,0.6244047619047619,44.849537037037024,1020.6018518518497,29.160052910052848,0
605,4,2,1,36,0.05405405405405406,0.02702702702702703,0.972972972972973,37,900,700,200,0.7777777777777778,11,7,4,337.21596050841396,0.7657032032032032,-0.03326541023858598,0.19128612312120996,130090.20580969493,1392.0377541737291,131482.24356386866,604,0,351.13513513513516,36,1,19,36.360249475659565,0.6212384259259258,44.96058558558559,1020.1576576576584,28.337712712712733,8
606,4,1,0,37,0.02702702702702703,0.0,1.0,37,500,300,200,0.6,7,3,4,330.4556654902187,0.7687062062062062,-0.013343503312901461,0.1887126431469382,130351.21588059393,1215.1736926608262,131566.38957325474,605,0,352.05405405405406,35,2,20,36.26848860931656,0.6258928571428573,44.7048611111111,1021.1805555555538,29.17658730158725,0
607,4,2,2,37,0.05128205128205128,0.05128205128205128,0.9487179487179487,39,400,300,100,0.75,5,3,2,325.4443154307916,0.786493477282951,0.00568482023027439,0.18680627214006518,130550.14209733365,701.0073638179031,131251.14946115157,606,0,334.94871794871796,36,3,15,36.195362718089974,0.6258680555555557,44.51013513513512,1021.9594594594581,28.387762762762726,1
608,4,2,2,37,0.05128205128205128,0.05128205128205128,0.9487179487179487,39,1150,1000,150,0.8695652173913043,13,10,3,326.2912671489813,0.7868870895186685,0.0150855433874304,0.1883443650968871,130766.77439212053,733.6113034779821,131500.3856955985,607,0,335.84615384615387,37,2,15,35.95492066895371,0.6261261261261262,44.29824561403508,1022.8070175438586,27.64343290659077,0
609,4,0,0,37,0.0,0.0,1.0,37,850,600,250,0.7058823529411765,11,6,5,341.89702690017907,0.7715215215215215,0.014407880228369807,0.19539503661704533,130380.7656035665,1515.359224965703,131896.1248285322,608,2,355.0,35,2,19,35.94647174372923,0.6261904761904762,44.675925925925924,1021.2962962962961,29.179894179894173,0
610,4,0,0,37,0.0,0.0,1.0,37,1100,800,300,0.7272727272727273,14,8,6,342.86634765017044,0.7716466466466466,0.011426856787681405,0.19639722587333244,130469.43486636227,1546.7157225222836,132016.15058888454,609,3,356.0,35,2,20,35.83194082549751,0.6270833333333334,44.58912037037037,1021.6435185185182,29.189814814814806,0
611,4,1,0,38,0.02631578947368421,0.0,1.0,38,1000,800,200,0.8,12,8,4,334.847747167636,0.7757527264106212,0.016379290365941213,0.19349598824877898,130809.21292914537,1160.2340516191891,131969.44698076457,610,0,347.60526315789474,36,2,18,35.69325187142228,0.6284722222222222,44.25675675675676,1022.9729729729731,28.41591591591592,0
612,4,0,0,38,0.0,0.0,1.0,38,850,600,250,0.7058823529411765,11,6,5,331.6297570856477,0.7750414888572783,0.017924156782801903,0.19220990002515098,130924.43795146508,1083.6879108838684,132008.12586234894,611,1,348.60526315789474,36,2,19,35.65920261150236,0.6296296296296295,44.14414414414415,1023.4234234234242,28.42842842842845,0
613,4,0,1,37,0.0,0.02631578947368421,0.9736842105263158,38,850,800,50,0.9411764705882353,9,8,1,328.1316459154561,0.7762861545756282,-0.04050436365583343,0.19086000469520295,131061.33355034704,1001.6956171754323,132063.02916752247,612,2,349.60526315789474,35,3,17,35.61058833502882,0.6330357142857144,44.01041666666666,1023.9583333333319,29.25595238095234,1
614,4,1,1,37,0.02631578947368421,0.02631578947368421,0.9736842105263158,38,1400,1100,300,0.7857142857142857,17,11,6,326.7550119162822,0.7802572309151257,-0.039791927047169384,0.19052330694810904,131155.0401753103,971.1133430727889,132126.1535183831,613,0,350.36842105263156,36,2,17,35.551341248900634,0.6319444444444444,43.91891891891891,1024.3243243243232,28.453453453453424,0
615,4,0,2,35,0.0,0.05405405405405406,0.9459459459459459,37,600,400,200,0.6666666666666666,8,4,4,334.60671363898246,0.7722722722722722,-0.04007761294363932,0.1943267486629545,131002.08340031285,1366.8353212877107,132368.91872160055,614,4,360.8378378378378,35,2,18,35.504640097983795,0.6324404761904763,44.06828703703703,1023.7268518518513,29.24933862433861,0
616,4,1,2,34,0.027777777777777776,0.05555555555555555,0.9444444444444444,36,700,500,200,0.7142857142857143,9,5,4,344.12298504108884,0.7621031746031747,-0.04238575399133859,0.19917421255408432,130870.93431122422,1807.1393140589244,132678.07362528314,615,0,371.47222222222223,34,2,18,35.393639713011446,0.6332720588235295,44.196428571428555,1023.2142857142835,30.094537815125985,0
617,4,0,0,34,0.0,0.0,1.0,34,950,500,450,0.5263157894736842,14,5,9,362.09382042062185,0.744281045751634,-0.027029480763783198,0.2087258257357022,130714.10323245075,2666.153804458727,133380.2570369095,616,10,393.1764705882353,32,2,19,35.09280981191093,0.6363932291666667,44.349747474747474,1022.6010101010099,31.95628156565656,0
618,4,0,0,34,0.0,0.0,1.0,34,900,600,300,0.6666666666666666,12,6,6,361.1741150349378,0.7429441473559121,-0.024228499248643898,0.2088932087172092,130843.25140610656,2651.4391069788867,133494.69051308546,617,11,394.1764705882353,32,2,20,34.98549919782796,0.6376953125,44.22348484848485,1023.1060606060609,31.9720643939394,0
619,4,0,0,34,0.0,0.0,1.0,34,1150,800,350,0.6956521739130435,15,8,7,367.5811236182379,0.7425356506238859,0.03378689302174109,0.205949531769652,129606.62853529888,2729.0867806823244,132335.71531598122,618,12,395.1764705882353,33,1,18,36.07772194808841,0.6227904040404041,45.43504901960784,1018.2598039215683,30.85635769459298,8
620,4,2,1,35,0.05555555555555555,0.027777777777777776,0.9722222222222222,36,600,400,200,0.6666666666666666,8,4,4,352.5223840871916,0.7610780423280423,0.040026842085365555,0.20039908836213843,130173.98787133474,1977.848910108009,132151.83678144275,619,0,374.1666666666667,35,1,19,35.88486730180334,0.624107142857143,44.878472222222214,1020.4861111111101,29.156746031746003,0
621,4,0,0,35,0.0,0.0,1.0,35,1200,1000,200,0.8333333333333334,14,10,4,362.6801312925777,0.7557422969187675,0.046866612206792,0.20567875877207778,130080.35891439897,2435.512329931958,132515.87124433092,620,1,385.85714285714283,34,1,19,35.72081534212471,0.6253063725490197,44.97023809523809,1020.1190476190466,30.003501400560193,0
622,4,1,1,35,0.027777777777777776,0.027777777777777776,0.9722222222222222,36,650,400,250,0.6153846153846154,9,4,5,357.09310188669167,0.7676256613756615,0.0366183082096041,0.20392442964053556,130351.21588059382,2109.5040027005807,132460.7198832944,621,0,376.1111111111111,35,1,19,35.58844780686841,0.6258928571428573,44.70486111111109,1021.180555555553,29.17658730158723,0
623,4,1,0,36,0.027777777777777776,0.0,1.0,36,1100,700,400,0.6363636363636364,15,7,8,356.1407136105863,0.7665343915343916,0.044987922705314265,0.20478091032608678,130617.28395061701,2103.6265432098444,132720.91049382684,622,0,377.0833333333333,35,1,16,35.34307065217391,0.6285714285714287,44.44444444444443,1022.22222222222,29.20634920634914,0
624,4,0,0,36,0.0,0.0,1.0,36,900,600,300,0.6666666666666666,12,6,6,356.53880854719097,0.768154761904762,0.0461139407658937,0.20548078105116974,130706.03358892741,2120.354697145056,132826.38828607247,623,1,378.0833333333333,35,1,16,35.24299660441425,0.6294642857142857,44.357638888888886,1022.569444444444,29.216269841269828,0
625,4,0,0,36,0.0,0.0,1.0,36,1050,800,250,0.7619047619047619,13,8,5,357.5309451018318,0.7674933862433863,0.04709051588648783,0.20636844950129885,130765.2167593663,2150.5223068844175,132915.7390662507,624,2,379.0833333333333,35,1,17,35.157693976085405,0.6300595238095239,44.29976851851851,1022.800925925925,29.22288359788357,0
626,4,0,0,36,0.0,0.0,1.0,36,1050,700,350,0.6666666666666666,14,7,7,356.41428614031713,0.7651455026455027,0.045649059307016904,0.2063561692054055,130883.62328800141,2129.758632330234,133013.38192033165,625,3,380.0833333333333,35,1,18,35.066381065490326,0.6312500000000001,44.18402777777777,1023.2638888888879,29.236111111111082,0
627,4,0,1,35,0.0,0.027777777777777776,0.9722222222222222,36,850,800,50,0.9411764705882353,9,8,1,351.5848658520645,0.7665674603174604,0.042703150912106524,0.20402995758501702,130972.46334876539,2009.5871913580233,132982.05054012343,626,4,381.0833333333333,35,1,18,35.100067842605156,0.6321428571428571,44.09722222222222,1023.6111111111109,29.24603174603174,0
628,4,0,0,35,0.0,0.0,1.0,35,700,500,200,0.7142857142857143,9,5,4,350.4194080548979,0.7673669467787114,0.056277252026743385,0.2036668911730374,131031.70680084027,2183.210626714684,133214.91742755496,627,5,386.1714285714286,35,0,18,35.06999397090963,0.6327380952380952,44.039351851851855,1023.8425925925932,29.25264550264552,0
629,4,0,0,35,0.0,0.0,1.0,35,1150,700,450,0.6086956521739131,16,7,9,349.96380350474,0.7659663865546218,0.05741404358353508,0.2040302806994037,131150.23389274688,2179.566936728387,133329.80082947528,628,6,387.1714285714286,35,0,19,34.96186440677966,0.6339285714285714,43.92361111111111,1024.3055555555552,29.265873015873005,0
630,4,0,0,35,0.0,0.0,1.0,35,850,700,150,0.8235294117647058,10,7,3,352.002969232734,0.7642156862745098,0.055761721901320005,0.20585431239013394,131268.81456832995,2241.4024991426677,133510.2170674726,629,7,388.1714285714286,35,0,19,34.789831338001655,0.6351190476190476,43.807870370370374,1024.768518518519,29.279100529100543,0
631,4,0,0,35,0.0,0.0,1.0,35,650,400,250,0.6153846153846154,9,4,5,353.0133280062437,0.7629551820728291,0.05108606259977733,0.20724619435436167,131417.1157648536,2278.39867862657,133695.51444348018,630,8,389.1714285714286,35,0,19,34.61416356247884,0.6366071428571427,43.66319444444446,1025.347222222224,29.29563492063497,0
632,4,1,1,35,0.027777777777777776,0.027777777777777776,0.9722222222222222,36,650,300,350,0.46153846153846156,10,3,7,345.9660812551401,0.7673941798941799,0.048952541215490974,0.20417376505160892,131616.85333982654,1906.9933954224732,133523.846735249,631,0,379.3333333333333,36,0,15,34.593347600234125,0.636574074074074,43.46846846846848,1026.126126126128,28.503503503503552,0
633,4,0,0,35,0.0,0.0,1.0,35,1250,900,350,0.72,16,9,7,355.9685819684753,0.7621848739495798,0.05404378010083288,0.21061276540883322,131713.96933138304,2377.2069776663443,134091.1763090494,632,10,391.1714285714286,35,0,16,34.23875765775924,0.6395833333333332,43.3738425925926,1026.504629629631,29.32870370370374,0
634,4,0,0,35,0.0,0.0,1.0,35,1450,1000,450,0.6896551724137931,19,10,9,357.5472168220592,0.7621148459383753,0.05539798792756545,0.21254062620869224,131892.24222232937,2431.540825402948,134323.78304773232,633,11,392.1714285714286,35,0,17,34.01842723004696,0.6413690476190477,43.20023148148148,1027.199074074074,29.348544973544968,0
635,4,0,1,34,0.0,0.02857142857142857,0.9714285714285714,35,550,300,250,0.5454545454545454,8,3,5,357.8318349800088,0.7623949579831932,0.05261057104229705,0.21287636509936736,131921.9660922498,2441.175840192061,134363.14193244185,634,12,393.1714285714286,35,0,17,33.98114766411297,0.6416666666666666,43.171296296296305,1027.314814814816,29.351851851851883,0
636,4,0,0,34,0.0,0.0,1.0,34,1200,900,300,0.75,15,9,6,366.6438855537759,0.7614379084967321,0.04914457092222757,0.21821632636752317,131938.95266439908,2874.9220521541965,134813.87471655328,635,13,391.6470588235294,34,0,18,33.73768829663964,0.6439950980392157,43.154761904761905,1027.3809523809523,30.21708683473389,0
637,4,0,0,34,0.0,0.0,1.0,34,850,600,250,0.7058823529411765,11,6,5,366.0493725096433,0.7610665478312537,0.05318786458049374,0.218213962949119,132000.11337868485,2863.7117346938767,134863.82511337873,636,14,392.6470588235294,34,0,18,33.69125540624033,0.6446078431372548,43.095238095238095,1027.619047619048,30.22408963585435,0
638,4,0,0,34,0.0,0.0,1.0,34,800,500,300,0.625,11,5,6,369.4870553032222,0.7619949494949495,0.05470649531087157,0.22115451813263542,132153.07716836734,2965.7702664399053,135118.84743480725,637,15,393.6470588235294,34,0,18,33.44863185519663,0.646139705882353,42.94642857142857,1028.2142857142856,30.24159663865546,0
639,4,0,0,34,0.0,0.0,1.0,34,800,600,200,0.75,10,6,4,368.8700274348424,0.7607694592988711,0.05766612200435728,0.22132201646090519,132244.89795918352,2956.2358276643777,135201.1337868479,638,16,394.6470588235294,34,0,18,33.3719135802469,0.6470588235294118,42.85714285714285,1028.5714285714273,30.252100840336098,0
640,4,0,1,33,0.0,0.029411764705882353,0.9705882352941176,34,750,400,350,0.5333333333333333,11,4,7,368.8229662051134,0.7611779560308972,0.05895624476795214,0.22183276944403563,132336.75063775497,2961.7665816326307,135298.5172193876,639,17,395.6470588235294,34,0,18,33.28054494967024,0.6479779411764707,42.76785714285713,1028.9285714285702,30.26260504201677,0
641,4,0,0,33,0.0,0.0,1.0,33,600,400,200,0.6666666666666666,8,4,4,377.8069208642231,0.7607323232323233,0.07731875033840496,0.2270357266038046,132303.42784325723,3397.030138648576,135700.4579819058,640,18,402.7878787878788,33,0,18,33.083060353384944,0.6499368686868687,42.800245098039206,1028.799019607842,31.175727866904303,0
642,4,2,1,34,0.05714285714285714,0.02857142857142857,0.9714285714285714,35,900,600,300,0.6666666666666666,12,6,6,359.6571367966597,0.7797619047619047,0.07066521264994585,0.21944012154689327,132874.89819101492,2557.8810871056025,135432.77927812052,641,0,380.7142857142857,35,0,17,32.97504116150275,0.6511904761904763,42.24537037037036,1031.018518518517,29.457671957671916,0
643,4,0,0,34,0.0,0.0,1.0,34,500,300,200,0.6,7,3,4,366.81485313805086,0.768716577540107,0.07869175383779381,0.22370539635038875,132857.85147392284,2946.8466553287935,135804.69812925163,642,1,392.9117647058824,34,0,17,32.80768860662048,0.6531862745098039,42.26190476190476,1030.9523809523805,30.322128851540604,0
644,4,0,0,34,0.0,0.0,1.0,34,800,500,300,0.625,11,5,6,365.32148289428454,0.7684194890077244,0.07700979260325691,0.22316041500918837,132919.2247732426,2911.649659863939,135830.87443310654,643,2,393.9117647058824,34,0,17,32.784480104671744,0.6537990196078431,42.20238095238095,1031.190476190476,30.329131652661058,0
645,4,0,0,34,0.0,0.0,1.0,34,700,600,100,0.8571428571428571,8,6,2,367.58034275089756,0.7684566250742721,0.07472590882862118,0.22509425229233404,133011.3112953515,2978.4686791383274,135989.77997448982,644,3,394.9117647058824,34,0,18,32.633679553760345,0.6547181372549019,42.11309523809524,1031.5476190476193,30.339635854341743,0
646,4,0,0,34,0.0,0.0,1.0,34,950,900,50,0.9473684210526315,10,9,1,368.1043623094124,0.7690136660724897,0.07456408168803841,0.22634502278174523,133164.8596938777,3003.7131519274544,136168.57284580515,645,4,395.9117647058824,34,0,18,32.465878508266066,0.65625,41.96428571428572,1032.1428571428582,30.35714285714289,0
647,4,1,0,35,0.02857142857142857,0.0,1.0,35,1050,700,350,0.6666666666666666,14,7,7,358.5686121776845,0.7737394957983192,0.08542646071188753,0.2233927462479382,133651.68065200618,2584.65952932099,136236.34018132716,646,0,385.57142857142856,35,0,19,32.22380792478174,0.6589285714285713,41.49305555555556,1034.0277777777778,29.543650793650794,0
648,4,0,0,35,0.0,0.0,1.0,35,900,600,300,0.6666666666666666,12,6,6,360.66158983985565,0.7733193277310924,0.08769961156668105,0.22524337025847607,133741.45507812512,2647.0811631944584,136388.53624131958,647,1,386.57142857142856,35,0,16,32.07976670023498,0.6598214285714286,41.40625000000001,1034.375000000001,29.553571428571455,0
649,4,1,0,36,0.027777777777777776,0.0,1.0,36,1100,700,400,0.6363636363636364,15,7,8,354.96315245933226,0.7770502645502646,0.09564881254378998,0.22393354432928278,134113.0044740689,2321.034970781623,136434.03944485052,648,0,376.80555555555554,36,0,18,31.85543052837575,0.6614583333333333,41.04729729729731,1035.8108108108127,28.772522522522575,0
650,4,0,0,36,0.0,0.0,1.0,36,700,400,300,0.5714285714285714,10,4,6,355.558601134215,0.775925925925926,0.10009661835748762,0.22466614906832316,134171.33349565815,2341.154330005717,136512.48782566388,649,1,377.80555555555554,36,0,18,31.781702898550726,0.6620370370370369,40.99099099099101,1036.0360360360387,28.778778778778854,0
651,4,0,1,35,0.0,0.027777777777777776,0.9722222222222222,36,500,300,200,0.6,7,3,4,357.4109858940823,0.7757936507936508,0.10029824434301737,0.22619641624465955,134229.67519884772,2395.0321098125405,136624.70730866026,650,2,378.80555555555554,36,0,18,31.675405708903877,0.6626157407407407,40.9346846846847,1036.2612612612631,28.785035035035087,0
652,4,0,0,35,0.0,0.0,1.0,35,1250,1100,150,0.88,14,11,3,374.84881776884026,0.7676470588235293,0.06195288482769157,0.228302201756243,132808.22167255386,3044.056464369955,135852.27813692382,651,3,390.37142857142857,33,2,17,32.6505716720168,0.6549873737373737,42.310049019607845,1030.7598039215688,31.235145573380873,6
653,4,0,0,35,0.0,0.0,1.0,35,1000,600,400,0.6,14,6,8,377.1451892664012,0.7654761904761904,0.060375180375180415,0.23047761566280087,132934.57031250003,3027.126736111111,135961.69704861115,652,4,391.37142857142857,33,2,17,32.46422558922558,0.65625,42.1875,1031.2500000000002,31.250000000000007,0
654,4,0,1,34,0.0,0.02857142857142857,0.9714285714285714,35,1400,1000,400,0.7142857142857143,18,10,8,374.66133552020034,0.7654761904761904,0.058309868711198476,0.23032100494533783,133155.82498317957,2977.6678440984306,136133.492827278,653,5,392.37142857142857,33,2,18,32.30576664291934,0.6584595959595959,41.97303921568628,1032.1078431372553,31.27599524658349,0
655,4,0,0,34,0.0,0.0,1.0,34,1100,800,300,0.7272727272727273,14,8,6,385.47333648150664,0.7589869281045752,0.0676988857216898,0.2364931010305461,133081.0950413224,3459.842745638218,136540.93778696063,654,8,404.7647058823529,32,2,18,32.10199461576115,0.66015625,42.045454545454554,1031.8181818181827,32.24431818181821,0
656,4,1,1,34,0.02857142857142857,0.02857142857142857,0.9714285714285714,35,650,400,250,0.6153846153846154,9,4,5,375.92052527239275,0.7670868347338935,0.06332632720862419,0.23227699318150508,133345.61827181865,3025.4709727028207,136371.08924452146,655,0,394.1714285714286,33,2,18,32.08254231925328,0.6603535353535352,41.78921568627452,1032.843137254903,31.298276886512213,0
657,4,1,1,34,0.02857142857142857,0.02857142857142857,0.9714285714285714,35,1100,900,200,0.8181818181818182,13,9,4,375.2331647469935,0.7643557422969187,0.066195727668513,0.23284336117081644,133503.88259623697,3019.016874519409,136522.89947075638,656,0,395.14285714285717,33,2,19,31.941356377722446,0.6619318181818181,41.6360294117647,1033.4558823529408,31.316844919786085,0
658,4,0,0,34,0.0,0.0,1.0,34,1100,700,400,0.6363636363636364,15,7,8,381.7824659690127,0.7551990493166965,0.07608824575969608,0.23650315728029,133440.56560277307,3389.053639225309,136829.61924199839,657,11,407.7647058823529,33,1,19,31.83575989404182,0.661300505050505,41.69730392156863,1033.2107843137262,31.30941770647655,0
659,4,0,0,34,0.0,0.0,1.0,34,750,500,250,0.6666666666666666,10,5,5,381.4236326276368,0.7565730837789661,0.07219839199879274,0.2371082217405059,133570.0936926079,3389.3618238952085,136959.4555165031,658,12,408.7647058823529,32,2,20,31.71491388787102,0.6650390625,41.571969696969695,1033.712121212121,32.30350378787878,0
660,4,0,0,34,0.0,0.0,1.0,34,800,500,300,0.625,11,5,6,378.8728855582324,0.7560531788472965,0.07281288385423768,0.23593840759211898,133635.36126734514,3326.162987195178,136961.52425454033,659,13,409.7647058823529,32,2,20,31.71530915455692,0.6656901041666667,41.50883838383838,1033.9646464646462,32.31139520202019,0
661,4,0,0,34,0.0,0.0,1.0,34,800,300,500,0.375,13,3,10,377.42086972856185,0.7556446821152704,0.07347554406377932,0.2352417749678023,133668.00103305787,3289.818640955003,136957.81967401286,660,14,410.7647058823529,32,2,20,31.72008547008547,0.666015625,41.47727272727273,1034.0909090909092,32.315340909090914,0
662,4,0,0,34,0.0,0.0,1.0,34,950,700,250,0.7368421052631579,12,7,5,378.1997143876516,0.7547905525846703,0.07190858767527497,0.23635318535301503,133765.944243572,3318.048381542685,137083.99262511468,661,15,411.7647058823529,32,2,15,31.601672159160255,0.6669921875,41.38257575757575,1034.4696969696963,32.32717803030301,0
663,4,0,0,34,0.0,0.0,1.0,34,1050,800,250,0.7619047619047619,13,8,5,379.2104422612323,0.7543820558526442,0.07271122211695813,0.23761535051781796,133863.92332415056,3352.5195133149564,137216.44283746553,662,16,412.7647058823529,32,2,15,31.477244997559776,0.66796875,41.28787878787878,1034.8484848484843,32.339015151515135,0
664,4,1,0,35,0.02857142857142857,0.0,1.0,35,1350,1100,250,0.8148148148148148,16,11,5,370.0298260207704,0.7607142857142857,0.06028745748807984,0.21584642817219968,131171.1560006969,2707.4480067762465,133878.60400747316,663,0,401.9428571428571,33,2,20,34.42684033177812,0.6385732323232323,43.90318627450981,1024.3872549019613,31.04203802733216,7
665,4,0,0,35,0.0,0.0,1.0,35,700,500,200,0.7142857142857143,9,5,4,368.4543776806676,0.7601540616246498,0.0653031933979189,0.2152793187832329,131233.93233672154,2670.7433739427192,133904.67571066425,664,1,402.9428571428571,33,2,20,34.40365486584539,0.6392045454545454,43.841911764705884,1024.632352941177,31.049465240641727,0
666,4,0,0,35,0.0,0.0,1.0,35,800,600,200,0.75,10,6,4,366.84513186595257,0.7591036414565826,0.06318234610917517,0.2148664343786295,131328.12500000015,2635.4166666666815,133963.54166666683,665,2,403.9428571428571,33,2,20,34.34959349593496,0.6401515151515151,43.75000000000001,1025.0000000000011,31.060606060606094,0
667,4,0,0,35,0.0,0.0,1.0,35,700,500,200,0.7142857142857143,9,5,4,367.09504077336146,0.7591036414565826,0.0639206095050413,0.2151945585587668,131360.48179076108,2644.3562837975633,134004.83807455865,666,3,404.9428571428571,32,3,20,34.310465164018574,0.6429036458333334,43.71843434343434,1025.1262626262621,32.03519570707069,0
668,4,0,0,35,0.0,0.0,1.0,35,600,300,300,0.5,9,3,6,368.51802962500744,0.7584033613445378,0.06296687064781636,0.2169449617879391,131522.32552800726,2693.6696510560046,134215.99517906326,667,4,405.9428571428571,32,3,20,34.110352043328405,0.64453125,43.560606060606055,1025.757575757575,32.05492424242422,0
669,4,2,0,37,0.05405405405405406,0.0,1.0,37,1050,600,450,0.5714285714285714,15,6,9,350.04525720163514,0.7733983983983984,0.06481606041740307,0.20985711151734385,132214.28748582763,1856.196853741492,134070.4843395691,668,0,384.94594594594594,34,3,21,33.88678280665201,0.6467524509803921,42.88690476190476,1028.4523809523807,30.248599439775905,0
670,4,0,0,37,0.0,0.0,1.0,37,800,600,200,0.75,10,6,4,349.05605959517743,0.7723973973973974,0.055273741688923295,0.20977346780400022,132306.1295351473,1836.451247165526,134142.58078231284,669,1,385.94594594594594,34,3,21,33.81981408624547,0.647671568627451,42.797619047619044,1028.8095238095232,30.259103641456562,0
671,4,1,1,37,0.02631578947368421,0.02631578947368421,0.9736842105263158,38,900,600,300,0.6666666666666666,12,6,6,344.26328493624555,0.7797830725462305,0.05403358737766584,0.20875334299602893,132643.15653344675,1532.8656462585027,134176.02217970524,670,0,376.7631578947368,34,4,17,33.604433915019854,0.6510416666666667,42.470238095238095,1030.1190476190477,30.29761904761905,0
672,4,1,0,38,0.02631578947368421,0.0,1.0,38,1150,1000,150,0.8695652173913043,13,10,3,345.9527116727794,0.7732633949739213,0.06080609002594217,0.21150235294433903,132949.91673752814,1598.8768424036064,134548.79357993175,671,0,377.7368421052632,34,4,19,33.25301088922237,0.6541053921568629,42.17261904761904,1031.3095238095223,30.332633053221244,0
673,4,0,0,38,0.0,0.0,1.0,38,1350,1100,250,0.8148148148148148,16,11,5,343.5460007881224,0.7734115694642011,0.06035902065962051,0.2114621657025025,133203.26063368036,1552.2894965277542,134755.5501302081,672,1,378.7368421052632,35,3,19,33.06109149007737,0.6544642857142857,41.92708333333332,1032.2916666666652,29.494047619047574,0
674,4,0,0,38,0.0,0.0,1.0,38,1000,700,300,0.7,13,7,6,341.202898483755,0.7717520151730678,0.05613484630446597,0.21086528158372758,133352.65024862808,1500.0621570644519,134852.71240569252,673,2,379.7368421052632,35,3,20,32.97194830419842,0.6559523809523811,41.7824074074074,1032.8703703703688,29.510582010581967,0
675,4,0,0,38,0.0,0.0,1.0,38,1150,600,550,0.5217391304347826,17,6,11,346.1508131956722,0.7717520151730678,0.027020006695835708,0.20521476688674511,131790.2425229284,1523.8599241133106,133314.10244704172,674,3,380.7368421052632,36,2,18,34.413842582437674,0.6383101851851851,43.29954954954955,1026.8018018018024,28.52227227227229,3
676,4,1,0,39,0.02564102564102564,0.0,1.0,39,1000,600,400,0.6,14,6,8,338.0453604973677,0.7757534862798021,0.03618300481965919,0.20183676492371488,132059.67821829783,1128.4323060941638,133188.110524392,675,0,371.94871794871796,37,2,19,34.350775193798434,0.6390765765765766,43.037280701754376,1027.8508771929814,27.779753437648147,0
677,4,0,0,39,0.0,0.0,1.0,39,1200,800,400,0.6666666666666666,16,8,8,340.736125523608,0.774685110211426,0.027180526274053207,0.20389806311645642,132144.21895438983,1205.2618353724242,133349.48078976225,676,1,372.94871794871796,37,2,19,34.19659361558424,0.6399211711711712,42.95504385964912,1028.1798245614036,27.788643907064962,0
678,4,0,0,39,0.0,0.0,1.0,39,950,700,250,0.7368421052631579,12,7,5,340.0611926659725,0.7743477282950968,0.022338855174676153,0.20394974342754627,132228.78674207453,1193.1757848568866,133421.96252693143,677,2,373.94871794871796,37,2,19,34.12890902629708,0.6407657657657657,42.87280701754386,1028.5087719298251,27.79753437648176,0
679,4,1,1,39,0.025,0.025,0.975,40,1000,800,200,0.8,12,8,4,331.8144632720877,0.7796474358974359,0.020230802887770682,0.20035982980405745,132484.94059938335,792.3003040661575,133277.2409034495,678,0,365.575,36,4,20,34.0837617589149,0.6452546296296295,42.62387387387388,1029.504504504506,28.59734734734739,0
680,4,0,0,39,0.0,0.0,1.0,39,900,700,200,0.7777777777777778,11,7,4,339.91423630913437,0.7740103463787674,0.022910557713211377,0.2049394782031955,132427.7842747986,1202.8178315757973,133630.6021063744,679,1,375.6923076923077,35,4,20,33.93270456164024,0.6467261904761905,42.67939814814815,1029.282407407408,29.408068783068803,0
681,4,0,0,39,0.0,0.0,1.0,39,950,500,450,0.5263157894736842,14,5,9,336.72095121967993,0.7727170490328386,0.027738519864504152,0.20363600383285438,132542.91453615797,1125.9952520087886,133668.90978816675,680,2,376.6923076923077,36,3,20,33.899278215223106,0.6458333333333333,42.56756756756758,1029.7297297297314,28.60360360360365,0
682,4,0,0,39,0.0,0.0,1.0,39,900,500,400,0.5555555555555556,13,5,8,336.67699087939906,0.7718735942420153,0.0240542313579708,0.20392369262139015,132600.90115453317,1128.734477720992,133729.63563225415,681,3,377.6923076923077,36,3,20,33.84220788687222,0.6464120370370369,42.511261261261275,1029.954954954957,28.609859859859917,0
683,4,0,0,39,0.0,0.0,1.0,39,1100,900,200,0.8181818181818182,13,9,4,334.96083163539674,0.7718173639226271,0.021823461482403106,0.2031977246552132,132658.90045450884,1087.10712401594,133746.0075785248,682,4,378.6923076923077,36,3,16,33.828204707768535,0.6469907407407407,42.45495495495497,1030.1801801801826,28.61611611611618,0
684,4,0,0,39,0.0,0.0,1.0,39,650,400,250,0.6153846153846154,9,4,5,335.17202663561164,0.7708614484930275,0.025607398066414655,0.2036403747487283,132716.9124360849,1096.5993020047301,133813.51173808964,683,5,379.6923076923077,36,3,16,33.76457194899818,0.6475694444444444,42.39864864864866,1030.4054054054068,28.62237237237241,0
685,4,0,0,39,0.0,0.0,1.0,39,750,500,250,0.6666666666666666,10,5,5,331.29359913212613,0.7700179937022043,0.024489910235405032,0.20206481679244623,132861.99787202763,1003.2658925817968,133865.26376460944,684,6,380.6923076923077,36,3,16,33.71905152011652,0.6490162037037036,42.257882882882896,1030.96846846847,28.638013013013058,0
686,4,0,1,38,0.0,0.02564102564102564,0.9743589743589743,39,1150,700,450,0.6086956521739131,16,7,9,332.73375495386455,0.7684997750787225,0.029977519659799334,0.2035743795338978,132978.12328798414,1049.2620576657953,134027.38534564993,685,7,381.6923076923077,36,3,16,33.565573024711576,0.650173611111111,42.14527027027028,1031.4189189189206,28.65052552552557,0
687,4,0,0,38,0.0,0.0,1.0,38,750,500,250,0.6666666666666666,10,5,5,338.76383571067424,0.7624762920815552,0.035161581960965194,0.20652768546714412,132845.0671537423,1400.6209008487679,134245.68805459107,686,11,392.55263157894734,35,3,16,33.54349107443584,0.6508928571428572,42.27430555555556,1030.9027777777778,29.45436507936508,0
688,4,0,1,37,0.0,0.02631578947368421,0.9736842105263158,38,600,200,400,0.3333333333333333,10,2,8,340.00612182430365,0.762624466571835,0.04066985645933019,0.20778151889262997,132934.5703125,1439.7135416666663,134374.28385416666,687,12,393.55263157894734,35,3,16,33.42171717171717,0.6517857142857143,42.1875,1031.25,29.464285714285715,0
689,4,0,0,37,0.0,0.0,1.0,37,850,600,250,0.7058823529411765,11,6,5,346.5603315394505,0.7584459459459459,0.03988515073965426,0.21135299092476334,132857.85147392284,1808.6522108843483,134666.5036848072,688,17,404.86486486486484,34,3,16,33.32972478829869,0.6531862745098039,42.26190476190476,1030.9523809523805,30.322128851540604,0
690,4,0,0,37,0.0,0.0,1.0,37,1200,1000,200,0.8333333333333334,14,10,4,347.9114693242096,0.7561311311311312,0.043259466323070095,0.2126998630032199,132949.91673752829,1850.9601757369533,134800.87691326524,689,18,405.86486486486484,34,3,17,33.20250875370349,0.6541053921568627,42.172619047619044,1031.3095238095234,30.332633053221276,0
691,4,0,0,37,0.0,0.0,1.0,37,900,600,300,0.6666666666666666,12,6,6,344.9333308974559,0.7552552552552553,0.04575819761603306,0.21139973448071786,133042.0138888888,1778.1249999999911,134820.1388888888,690,19,406.86486486486484,34,3,17,33.18692784060313,0.6550245098039216,42.08333333333333,1031.6666666666658,30.343137254901936,0
692,4,1,1,37,0.02631578947368421,0.02631578947368421,0.9736842105263158,38,750,600,150,0.8,9,6,3,337.1320514490789,0.7620910384068279,0.053454408182284974,0.20818195813703305,133322.76562767895,1389.4754961848182,134712.24112386376,691,0,397.13157894736844,35,3,18,33.106975419328315,0.6556547619047619,41.81134259259258,1032.754629629628,29.507275132275083,0
693,4,0,0,37,0.0,0.0,1.0,37,650,300,350,0.46153846153846156,10,3,7,343.64540856580516,0.7575075075075075,0.06502064023677878,0.21217963838493628,133318.4966695009,1762.8578514738924,135081.3545209748,692,1,407.0,34,3,18,32.94308357348703,0.6577818627450982,41.815476190476176,1032.7380952380931,30.374649859943915,0
694,4,0,0,37,0.0,0.0,1.0,37,250,0,250,0.0,5,0,5,339.5152409425185,0.7575075075075075,0.08622691003482319,0.20119169688717964,131773.38023244587,1547.8141878857864,133321.19442033165,693,2,408.0,35,2,20,34.601158268515384,0.6401785714285715,43.315972222222214,1026.7361111111102,29.335317460317434,3
695,4,1,0,38,0.02631578947368421,0.0,1.0,38,1000,800,200,0.8,12,8,4,332.51550396141516,0.7614983404457089,0.09624323794364287,0.19833571824522056,132021.60564280502,1179.8461468225098,133201.45178962752,694,0,398.2368421052632,36,2,20,34.53114727153191,0.640625,43.07432432432433,1027.7027027027032,28.54729729729731,1
696,4,0,0,38,0.0,0.0,1.0,38,950,600,350,0.631578947368421,13,6,7,333.1563110469839,0.7606389284020864,0.09963785875338038,0.19886969594021087,132050.5402995902,1198.69417559452,133249.23447518473,695,1,399.2368421052632,36,2,20,34.48559219897009,0.6409143518518519,43.046171171171174,1027.815315315316,28.550425425425445,0
697,4,0,0,38,0.0,0.0,1.0,38,800,500,300,0.625,11,5,6,332.43846632920247,0.7604018492176386,0.09639898299808003,0.1987446469626255,132108.41912436092,1183.5840485756135,133292.00317293653,696,2,400.2368421052632,36,2,20,34.445859349326334,0.6414930555555556,42.98986486486487,1028.0405405405413,28.556681681681702,0
698,4,1,0,39,0.02564102564102564,0.0,1.0,39,1100,700,400,0.6363636363636364,15,7,8,324.7709635383776,0.7693994601889339,0.0952146769941129,0.1955083702891386,132369.79316953282,797.9730542089751,133167.76622374178,697,0,390.94871794871796,37,2,21,34.3805496359439,0.6421734234234234,42.73574561403508,1029.0570175438586,27.81235182550969,0
699,4,1,0,40,0.025,0.0,1.0,40,1000,600,400,0.6,14,6,8,319.24104079895767,0.775400641025641,0.0962278336617235,0.19373450952953716,132673.03040990923,470.9352628022257,133143.96567271146,698,0,382.15,38,2,17,34.218906633481964,0.6433662280701755,42.441239316239304,1030.2350427350414,27.111448493027403,0
700,4,0,1,39,0.0,0.025,0.975,40,1250,900,350,0.72,16,9,7,328.30265642975314,0.775400641025641,0.08589227875875105,0.18917427601981734,130699.20562358458,594.9741809116795,131294.17980449626,699,1,383.15,38,2,14,35.97172883362938,0.6236293859649124,44.36431623931624,1022.5427350427346,26.909019343229858,5
701,4,0,0,39,0.0,0.0,1.0,39,950,700,250,0.7368421052631579,12,7,5,338.1200097309054,0.7681623931623932,0.0975881985853031,0.19503063270007157,130738.73842191836,1041.0767014850744,131779.81512340344,700,3,393.94871794871796,37,2,16,35.680796790679366,0.6258445945945945,44.32565789473684,1022.6973684210533,27.640469416785223,0
702,4,1,1,39,0.025,0.025,0.975,40,850,500,350,0.5882352941176471,12,5,7,328.60219674569834,0.7747596153846154,0.09497495303694437,0.19082825752832033,130999.80481591079,609.364727153213,131609.169543064,701,0,385.075,38,2,17,35.660613650594875,0.6266447368421051,44.07051282051283,1023.7179487179503,26.93994601889343,0
703,4,0,0,39,0.0,0.0,1.0,39,1350,900,450,0.6666666666666666,18,9,9,334.9924494582882,0.7668690958164642,0.08922604682322022,0.1949217747969442,131075.368442694,981.8517476531351,132057.2201903471,702,5,395.94871794871796,37,2,18,35.420793625298934,0.6292229729729729,43.996710526315795,1024.0131578947373,27.67603129445236,0
704,4,1,0,40,0.025,0.0,1.0,40,1150,800,350,0.6956521739130435,15,8,7,329.2664862522225,0.7779113247863247,0.09737044356609559,0.1937312116786334,131501.32395909436,660.2827041756087,132161.60666326995,703,0,387.025,36,4,19,35.13806543697847,0.6354166666666665,43.58108108108109,1025.6756756756768,28.490990990991023,0
705,4,0,1,39,0.0,0.025,0.975,40,800,400,400,0.5,12,4,8,328.3907773480917,0.7766292735042735,0.1001282599401454,0.19347758897158365,131553.00188519558,640.1585103108803,132193.16039550645,704,1,388.025,37,3,19,35.10848653270629,0.6340090090090089,43.53070175438597,1025.8771929824572,27.726410621147494,0
706,4,1,1,39,0.025,0.025,0.975,40,1050,800,250,0.7619047619047619,13,8,5,326.77565258219073,0.7843215811965812,0.10661717581713281,0.19338013018169858,131721.78578985843,608.6945021545073,132330.48029201294,705,0,388.75,37,3,15,34.98006124047567,0.6356981981981982,43.36622807017544,1026.5350877192984,27.74419155998104,0
707,4,0,1,38,0.0,0.02564102564102564,0.9743589743589743,39,1100,900,200,0.8181818181818182,13,9,4,336.37801132539073,0.7731668915879443,0.10386373546000516,0.19896726627066444,131703.53366457683,1060.434547723406,132763.96821230024,706,1,399.6666666666667,36,3,15,34.752011336624605,0.6374421296296295,43.38400900900901,1026.4639639639645,28.512887887887903,0
708,4,0,0,38,0.0,0.0,1.0,38,1350,1000,350,0.7407407407407407,17,10,7,339.4076435617583,0.77041844476055,0.0988472759185024,0.20191570001703532,131921.9660922497,1355.0647290809347,133277.03082133064,707,2,396.60526315789474,35,3,17,34.45433378398677,0.6416666666666666,43.1712962962963,1027.3148148148152,29.351851851851865,0
709,4,0,0,38,0.0,0.0,1.0,38,650,400,250,0.6153846153846154,9,4,5,339.6277470764492,0.771011142721669,0.09728957446556219,0.20236343211709515,131981.42387902958,1364.910729595346,133346.33460862492,708,3,397.60526315789474,35,3,18,34.38884508522941,0.6422619047619047,43.11342592592593,1027.546296296297,29.35846560846563,0
710,4,0,0,38,0.0,0.0,1.0,38,1300,1100,200,0.8461538461538461,15,11,4,339.6208352277973,0.7729670459933617,0.10529774600795494,0.20319385489055006,132137.36329234662,1375.3203372291418,133512.68362957577,709,4,398.60526315789474,36,2,18,34.23215589631253,0.6417824074074073,42.96171171171172,1028.1531531531548,28.559809809809856,0
711,4,0,0,38,0.0,0.0,1.0,38,1100,600,500,0.5454545454545454,16,6,10,338.9288388099323,0.7732337600758653,0.10780111197534015,0.203557852894723,132282.1316882764,1366.8458576820312,133648.97754595842,710,5,399.60526315789474,36,2,18,34.104406130268195,0.6432291666666665,42.82094594594596,1028.7162162162183,28.575450450450507,0
712,4,0,0,38,0.0,0.0,1.0,38,1300,1100,200,0.8461538461538461,15,11,4,341.12513840283873,0.7732930298719772,0.11060351184440953,0.2050341621347591,132311.0948786626,1426.9281105429955,133738.0229892056,711,6,400.60526315789474,36,2,18,34.018808377116166,0.6435185185185184,42.7927927927928,1028.8288288288302,28.578578578578615,0
713,4,0,0,38,0.0,0.0,1.0,38,750,300,450,0.4,12,3,9,341.75285613597987,0.7735004741583689,0.11261453228212215,0.20588525723313933,132398.00347222236,1449.479166666686,133847.48263888905,712,7,401.60526315789474,36,2,19,33.91531713900136,0.644386574074074,42.70833333333334,1029.1666666666679,28.587962962962997,0
714,4,0,0,38,0.0,0.0,1.0,38,850,700,150,0.8235294117647058,10,7,3,341.75285613597987,0.7735004741583689,0.11261453228212215,0.20588525723313933,132398.00347222236,1449.479166666686,133847.48263888905,713,8,402.60526315789474,36,2,19,33.91531713900136,0.644386574074074,42.70833333333334,1029.1666666666679,28.587962962962997,0
715,4,2,1,39,0.05,0.025,0.975,40,700,600,100,0.8571428571428571,8,6,2,327.3543515967757,0.7873397435897436,0.11267676767676726,0.20004988153136308,132934.57031250015,703.3420138889032,133637.91232638905,714,0,383.425,37,3,18,33.747895622895626,0.647804054054054,42.18750000000001,1031.2500000000011,27.871621621621653,0
716,4,0,0,39,0.0,0.0,1.0,39,1150,700,450,0.6086956521739131,16,7,9,332.4073645920172,0.7750224921277553,0.10633788819180245,0.2033746861922704,132978.123287984,1040.5815021102255,134018.70479009423,715,1,394.2564102564103,36,3,18,33.57398915456563,0.6501736111111112,42.145270270270274,1031.4189189189194,28.650525525525538,0
717,4,0,0,39,0.0,0.0,1.0,39,1000,700,300,0.7,13,7,6,333.39089672179864,0.7745726495726496,0.10331973200342603,0.20445297160409082,133065.2506391525,1072.5486466195844,134137.79928577208,716,2,395.2564102564103,36,3,19,33.46135305246309,0.6510416666666667,42.06081081081081,1031.7567567567557,28.65990990990988,0
718,4,0,0,39,0.0,0.0,1.0,39,900,700,200,0.7777777777777778,11,7,4,333.39089672179864,0.7745726495726496,0.10331973200342603,0.20445297160409082,133065.2506391525,1072.5486466195844,134137.79928577208,717,3,396.2564102564103,36,3,19,33.46135305246309,0.6510416666666667,42.06081081081081,1031.7567567567557,28.65990990990988,0
719,4,0,0,39,0.0,0.0,1.0,39,850,500,350,0.5882352941176471,12,5,7,333.31374935302944,0.7729419703103914,0.0988543371522097,0.20488400488400482,133152.4065239225,1076.305570773468,134228.71209469595,718,4,397.2564102564103,36,3,19,33.376068376068375,0.6519097222222223,41.97635135135135,1032.094594594594,28.669294294294275,0
720,4,0,0,39,0.0,0.0,1.0,39,600,300,300,0.5,9,3,6,333.59584027510306,0.7729419703103914,0.10088565881714451,0.2052174142256105,133181.46482631285,1085.7565335605893,134267.22135987342,719,5,398.2564102564103,36,3,19,33.33969743254055,0.6521990740740742,41.9481981981982,1032.2072072072076,28.672422422422432,0
721,4,0,0,39,0.0,0.0,1.0,39,500,300,200,0.6,7,3,4,336.34115989781475,0.774179037336932,0.10159651669085634,0.20739153295918392,133268.6587558843,1164.7470527960404,134433.40580868034,720,6,399.2564102564103,36,3,19,33.18155378630894,0.6530671296296295,41.86373873873874,1032.5450450450453,28.681806806806815,0
722,4,0,0,39,0.0,0.0,1.0,39,1300,900,400,0.6923076923076923,17,9,8,339.2410897944363,0.7710301394511921,0.1054103843024572,0.2101688881744228,133443.8977016965,1253.930656548148,134697.82835824465,721,7,400.2564102564103,37,2,20,32.93128073154338,0.6528716216216217,41.69407894736841,1033.2236842105249,27.924964438122295,0
723,4,0,0,39,0.0,0.0,1.0,39,800,700,100,0.875,9,7,2,336.5844570701676,0.770748987854251,0.10840176526451017,0.20933911354364082,133588.61395178956,1192.773225276392,134781.38717706595,722,8,401.2564102564103,36,3,20,32.855165214233836,0.65625,41.55405405405405,1033.7837837837833,28.716216216216203,0
724,4,0,0,39,0.0,0.0,1.0,39,1100,1000,100,0.9090909090909091,12,10,2,336.66779761460725,0.7713112910481332,0.102083839424578,0.20988597321757865,133675.94103816632,1200.8769326758947,134876.8179708422,723,9,402.2564102564103,36,3,21,32.76570837416966,0.6571180555555557,41.46959459459458,1034.1216216216199,28.72560060060055,0
725,4,0,0,39,0.0,0.0,1.0,39,1150,1000,150,0.8695652173913043,13,10,3,333.9234666405371,0.7711426000899685,0.09961711485438118,0.20899787544231943,133821.54959013037,1137.231150068953,134958.78074019932,724,10,403.2564102564103,36,3,18,32.69119140908431,0.6585648148148149,41.32882882882881,1034.6846846846822,28.741241241241173,0
726,4,0,0,39,0.0,0.0,1.0,39,800,600,200,0.75,10,6,4,329.9028259197003,0.7713112910481332,0.09516556051209535,0.2069718002066866,133908.9527661104,1035.3883866974732,134944.34115280787,725,11,404.2564102564103,36,3,18,32.70794799260146,0.6594328703703705,41.24436936936935,1035.02252252252,28.750625625625553,0
727,4,0,0,39,0.0,0.0,1.0,39,400,200,200,0.5,6,2,4,331.6080442734908,0.7708052181736392,0.09735947362402286,0.20837134319933004,133967.2374020979,1084.922718326419,135052.16012042432,726,12,405.2564102564103,36,3,18,32.6056510388339,0.6600115740740742,41.188063063063055,1035.2477477477466,28.756881881881853,0
728,4,0,0,39,0.0,0.0,1.0,39,1150,1000,150,0.8695652173913043,13,10,3,327.78183352899043,0.7716486729644625,0.0918298923592733,0.20653098183330965,134067.73147747366,988.9933681517198,135056.72484562537,727,13,406.2564102564103,37,2,18,32.60444238574203,0.6590653153153154,41.091008771929815,1035.6359649122792,27.990161213845383,0
729,4,0,0,39,0.0,0.0,1.0,39,1100,600,500,0.5454545454545454,16,6,10,326.5942717825552,0.7721547458389564,0.08986708573879154,0.20610127491848995,134124.51577648867,960.8597116420137,135085.3754881307,728,14,407.2564102564103,37,2,18,32.578574326946814,0.6596283783783785,41.0361842105263,1035.8552631578928,27.99608819345656,0
730,4,0,0,39,0.0,0.0,1.0,39,1100,700,400,0.6363636363636364,15,7,8,328.32217662087896,0.7716486729644625,0.09408490589068208,0.2081575811936393,134294.94081111465,1018.4014552554308,135313.34226637008,729,15,408.2564102564103,37,2,19,32.36395412391127,0.6613175675675678,40.87171052631577,1036.5131578947344,28.013869132290118,0
731,4,0,0,39,0.0,0.0,1.0,39,1100,800,300,0.7272727272727273,14,8,6,328.5481921938006,0.7710863697705803,0.0948643963895408,0.20865390425710992,134356.87413251502,1028.541621009557,135385.41575352458,730,16,409.2564102564103,38,1,19,32.29638980489144,0.6600877192982457,40.811965811965806,1036.7521367521358,27.28295096716147,0
732,4,0,0,39,0.0,0.0,1.0,39,800,600,200,0.75,10,6,4,327.2810665800308,0.7702991452991453,0.09714263068204354,0.20800672895607028,134384.56658859274,996.3048570019404,135380.87144559468,731,17,410.2564102564103,38,1,19,32.301648634724366,0.6603618421052633,40.785256410256395,1036.858974358972,27.285762483130846,0
733,4,0,0,39,0.0,0.0,1.0,39,1150,900,250,0.782608695652174,14,9,5,326.97347164416766,0.7697368421052632,0.09286123633636278,0.2084429045432188,134495.3649485899,995.2832794579389,135490.64822804785,732,18,411.2564102564103,38,1,20,32.199291035808706,0.6614583333333335,40.67841880341879,1037.2863247863233,27.29700854700851,0
734,4,0,0,39,0.0,0.0,1.0,39,1150,900,250,0.782608695652174,14,9,5,325.95648170015363,0.7684997750787225,0.08694079780116448,0.2087797701063456,134667.64219878655,979.1809985427827,135646.82319732933,733,19,412.2564102564103,36,3,21,32.05422046218943,0.6669560185185186,40.512387387387385,1037.9504504504498,28.83195695695694,0
735,4,0,0,39,0.0,0.0,1.0,39,1350,1000,350,0.7407407407407407,17,10,7,326.3411615793265,0.7688371569950517,0.0873741587407535,0.20953102435664278,134755.321199578,995.2416098531055,135750.5628094311,734,20,413.2564102564103,36,3,21,31.957022776572668,0.6678240740740741,40.42792792792793,1038.2882882882886,28.84134134134135,0
736,4,0,0,39,0.0,0.0,1.0,39,750,400,350,0.5333333333333333,11,4,7,326.55261636847524,0.7682186234817814,0.08862308081566428,0.21000475789052142,134813.78971877278,1004.7591510429334,135818.5488698157,735,21,414.2564102564103,36,3,17,31.893388997325243,0.6684027777777778,40.37162162162162,1038.513513513513,28.847597597597584,0
737,4,0,0,39,0.0,0.0,1.0,39,1300,1000,300,0.7692307692307693,16,10,6,328.90066774403067,0.7681061628430049,0.09586209196092144,0.2125416920127391,134989.27136596054,1079.6122981089175,136068.88366406946,736,22,415.2564102564103,36,3,17,31.657952246785147,0.6701388888888888,40.2027027027027,1039.1891891891892,28.866366366366364,0
738,4,0,0,39,0.0,0.0,1.0,39,1000,800,200,0.8,12,8,4,331.5708776278196,0.7665879442195231,0.09671551597252881,0.21513660668571039,135135.5932579539,1161.4054510591693,136296.99870901307,737,23,416.2564102564103,36,3,17,31.4431477670674,0.6715856481481481,40.06193693693694,1039.7522522522524,28.88200700700701,0
739,4,0,0,39,0.0,0.0,1.0,39,850,700,150,0.8235294117647058,10,7,3,332.4854763620091,0.7660818713450293,0.09509055979389469,0.2162560464563039,135223.42443795147,1191.9649379108857,136415.38937586235,738,24,417.2564102564103,36,3,17,31.33210625090226,0.6724537037037037,39.97747747747748,1040.0900900900901,28.891391391391394,0
740,4,1,1,39,0.025,0.025,0.975,40,1250,1000,250,0.8,15,10,5,328.2441768851511,0.7735042735042735,0.09990786564178222,0.21543434332261774,135548.03070415894,898.5703533779608,136446.6010575369,739,0,407.8,37,3,17,31.120244112175783,0.673704954954955,39.665570175438596,1041.3377192982452,28.144262683736358,0
741,4,0,0,39,0.0,0.0,1.0,39,1300,800,500,0.6153846153846154,18,8,10,335.9080417304237,0.7642825011246064,0.10705668979517124,0.22026991161982257,135516.40111395178,1304.2097841084283,136820.6108980602,740,26,419.2564102564103,36,3,19,30.952123440767178,0.6753472222222223,39.695945945945944,1041.216216216216,28.922672672672668,0
742,4,0,0,39,0.0,0.0,1.0,39,1050,900,150,0.8571428571428571,12,9,3,335.36000000000007,0.7623706702654072,0.10461538461538455,0.2206315789473682,135633.68055555536,1297.272948624276,136930.95350417963,741,27,420.2564102564103,35,4,20,30.849999999999987,0.6785714285714286,39.58333333333332,1041.6666666666652,29.76190476190472,0
743,4,0,0,39,0.0,0.0,1.0,39,1150,800,350,0.6956521739130435,15,8,7,332.1129972172152,0.7612460638776428,0.10056358165284052,0.2192135289763272,135751.01072356128,1216.935009333643,136967.94573289494,742,28,421.2564102564103,36,3,20,30.818204740292487,0.6776620370370372,39.47072072072071,1042.117117117116,28.94769769769767,0
744,4,0,0,39,0.0,0.0,1.0,39,1400,1100,300,0.7857142857142857,17,11,6,328.862528900344,0.7601776878092668,0.09690204642886013,0.21809502439625322,135919.37543282547,1139.757906278851,137059.13333910433,743,29,422.2564102564103,37,2,17,30.736067297581503,0.6773648648648649,39.30921052631579,1042.7631578947367,28.182788051209098,0
745,4,0,0,39,0.0,0.0,1.0,39,1250,800,450,0.64,17,8,9,325.9386608913825,0.7587719298245614,0.09428028618780093,0.21702633718554956,136062.33558643036,1069.5950917589946,137131.93067818935,744,30,423.2564102564103,37,2,17,30.670761078998076,0.6787725225225225,39.172149122807014,1043.3114035087713,28.19760550023706,0
746,4,0,0,39,0.0,0.0,1.0,39,1100,700,400,0.6363636363636364,15,7,8,326.31081844502523,0.7568038686459739,0.10128205128205159,0.21815161457841542,136205.37088334849,1089.0572099107155,137294.4280932592,745,31,424.2564102564103,37,2,17,30.51952030812325,0.6801801801801803,39.03508771929823,1043.8596491228052,28.212422949265004,0
747,4,0,0,39,0.0,0.0,1.0,39,800,600,200,0.75,10,6,4,325.7935277958672,0.755791722896986,0.09938152435264702,0.21833439586207185,136291.22813029002,1080.5600040396985,137371.78813432972,746,32,425.2564102564103,37,2,19,30.44810371381567,0.6810247747747749,38.95285087719298,1044.1885964912276,28.221313418681827,0
748,4,0,1,38,0.0,0.02564102564102564,0.9743589743589743,39,1700,1300,400,0.7647058823529411,21,13,8,321.0023243548566,0.753936122357175,0.09829149514354119,0.21634739399588282,136491.66690712524,962.8284664512099,137454.49537357644,747,33,426.2564102564103,37,2,20,30.375131164742907,0.6829954954954955,38.7609649122807,1044.956140350877,28.242057847320996,0
749,4,0,0,38,0.0,0.0,1.0,38,1050,900,150,0.8571428571428571,12,9,3,328.16485936575737,0.7474217638691323,0.10557529255530462,0.22021714224008931,136338.4224596218,1348.2958465222002,137686.718306144,748,43,437.60526315789474,36,2,20,30.339524477032576,0.6834490740740741,38.90765765765766,1044.3693693693695,29.010260260260264,0
750,4,0,0,38,0.0,0.0,1.0,38,700,400,300,0.5714285714285714,10,4,6,326.3957618634192,0.7476292081555239,0.10585034862676768,0.2195774824370516,136426.64359883536,1305.8156551822115,137732.45925401757,749,44,438.60526315789474,36,2,21,30.298498077683146,0.6843171296296297,38.8231981981982,1044.7072072072076,29.019644644644657,0
751,4,0,0,38,0.0,0.0,1.0,38,1000,800,200,0.8,12,8,4,326.77499814209267,0.7465327169274538,0.10654491833030821,0.22038313828187645,136514.89327165007,1321.9307990422867,137836.82407069235,750,45,439.60526315789474,36,2,22,30.201373922413783,0.6851851851851851,38.73873873873874,1045.0450450450453,29.029029029029036,0
752,4,0,0,38,0.0,0.0,1.0,38,1000,700,300,0.7,13,7,6,329.9819716052056,0.7454658605974396,0.10798118073859908,0.22347794357070308,136662.03946767744,1419.2018454265428,138081.241313104,751,46,440.60526315789474,36,2,22,29.97217734697541,0.6866319444444443,38.59797297297299,1045.6081081081104,29.044669669669734,0
753,4,0,0,38,0.0,0.0,1.0,38,550,300,250,0.5454545454545454,8,3,5,329.35985143092967,0.7450509720246562,0.10746487733277399,0.2234306019166579,136720.92013888908,1406.0763888889132,138126.99652777798,752,47,441.60526315789474,36,2,22,29.930278884462158,0.6872106481481481,38.54166666666668,1045.8333333333348,29.050925925925966,0
754,4,0,0,38,0.0,0.0,1.0,38,1200,700,500,0.5833333333333334,17,7,10,327.05992993892283,0.7433321479374111,0.10810971568410799,0.22261639626831778,136838.71952611426,1350.892404228588,138189.61193034286,753,48,442.60526315789474,36,2,22,29.87411652854017,0.6883680555555554,38.42905405405407,1046.2837837837862,29.063438438438506,0
755,4,0,0,38,0.0,0.0,1.0,38,1050,800,250,0.7619047619047619,13,8,5,330.40856874757424,0.7428283546704599,0.11017189056979748,0.22584397463804812,136986.04009414843,1452.2722891810968,138438.31238332952,754,49,443.60526315789474,36,2,16,29.641109079173845,0.6898148148148147,38.2882882882883,1046.8468468468486,29.07907907907913,0
756,4,0,0,38,0.0,0.0,1.0,38,750,500,250,0.6666666666666666,10,5,5,330.40856874757424,0.7428283546704599,0.11017189056979748,0.22584397463804812,136986.04009414843,1452.2722891810968,138438.31238332952,755,50,444.60526315789474,36,2,16,29.641109079173845,0.6898148148148147,38.2882882882883,1046.8468468468486,29.07907907907913,0
757,4,0,0,38,0.0,0.0,1.0,38,800,600,200,0.75,10,6,4,330.40856874757424,0.7428283546704599,0.11017189056979748,0.22584397463804812,136986.04009414843,1452.2722891810968,138438.31238332952,756,51,445.60526315789474,36,2,16,29.641109079173845,0.6898148148148147,38.2882882882883,1046.8468468468486,29.07907907907913,0
758,4,0,0,38,0.0,0.0,1.0,38,1300,1000,300,0.7692307692307693,16,10,6,330.5988993979639,0.7420282124229493,0.10960714508068214,0.22654673290358657,137074.4704797705,1463.3338152341764,138537.8042950047,757,52,446.60526315789474,36,2,17,29.548876223249813,0.6906828703703702,38.20382882882884,1047.184684684686,29.0884634634635,0
759,4,0,0,38,0.0,0.0,1.0,38,850,500,350,0.5882352941176471,12,5,7,330.0486849856694,0.7406057373162637,0.10804440948624583,0.22655223756839235,137133.439922186,1452.1423027757764,138585.58222496178,758,53,447.60526315789474,36,2,17,29.50511593735439,0.691261574074074,38.147522522522536,1047.4099099099121,29.09471971971978,0
760,4,0,1,37,0.0,0.02631578947368421,0.9736842105263158,38,900,600,300,0.6666666666666666,12,6,6,331.36695015784693,0.7400426742532006,0.1105229223930233,0.22842228430880931,137280.9190102266,1498.0718894570416,138778.99089968362,759,54,448.60526315789474,36,2,18,29.325166559209112,0.6927083333333333,38.006756756756765,1047.972972972974,29.11036036036039,0
761,4,0,0,37,0.0,0.0,1.0,37,600,200,400,0.3333333333333333,10,2,8,333.9861107542713,0.7363613613613613,0.10348922559123497,0.23093482375665553,137387.48097779482,1777.1020876200182,139164.58306541483,760,55,442.5945945945946,35,2,19,29.15148671524252,0.6958333333333333,37.90509259259259,1048.3796296296289,29.95370370370368,0
762,4,0,0,37,0.0,0.0,1.0,37,650,400,250,0.6153846153846154,9,4,5,327.31628180883826,0.7363613613613613,0.09347775041693507,0.2114133509409893,134971.39301483208,1435.666902434852,136407.05991726695,761,56,443.5945945945946,35,2,17,31.716882007871096,0.6720238095238094,40.21990740740741,1039.1203703703711,29.68915343915346,4
763,4,0,0,37,0.0,0.0,1.0,37,700,300,400,0.42857142857142855,11,3,8,329.84161784911754,0.7366741741741741,0.09315596219827804,0.21339897177846404,135031.5339934845,1507.803926611829,136539.33792009635,762,57,444.5945945945946,35,2,17,31.591499628804755,0.6726190476190474,40.16203703703705,1039.3518518518542,29.695767195767264,0
764,4,0,0,37,0.0,0.0,1.0,37,950,600,350,0.631578947368421,13,6,7,331.3080805507808,0.7346096096096096,0.09375667552223277,0.21488378971752112,135121.770578811,1553.3868902177774,136675.15746902878,763,58,445.5945945945946,35,2,17,31.463713866933844,0.6735119047619047,40.07523148148149,1039.699074074075,29.705687830687857,0
765,4,0,0,37,0.0,0.0,1.0,37,1000,500,500,0.5,15,5,10,333.55983493534285,0.7342967967967968,0.09592835296629687,0.2170675044579237,135242.13291162977,1622.268706061385,136864.40161769115,764,59,446.5945945945946,35,2,18,31.285583806238638,0.6747023809523809,39.95949074074074,1040.162037037037,29.71891534391534,0
766,4,0,0,37,0.0,0.0,1.0,37,900,700,200,0.7777777777777778,11,7,4,334.6292110327153,0.7340465465465466,0.09235912962690174,0.21812777215178228,135302.33417191778,1655.222666966728,136957.5568388845,765,60,447.5945945945946,35,2,19,31.197968813735315,0.675297619047619,39.90162037037037,1040.393518518518,29.725529100529087,0
767,4,0,0,37,0.0,0.0,1.0,37,1100,700,400,0.6363636363636364,15,7,8,337.264191118045,0.7329829829829829,0.09485160836512208,0.2202136777300176,135362.548828125,1730.5881076388896,137093.13693576388,766,61,448.5945945945946,35,2,19,31.06961127794461,0.6758928571428571,39.84375,1040.625,29.732142857142858,0
768,4,0,0,37,0.0,0.0,1.0,37,800,600,200,0.75,10,6,4,338.0995380064362,0.7310435435435435,0.09393649820601135,0.2213149377605449,135452.8959297839,1759.312307098763,137212.20823688267,767,62,449.5945945945946,35,2,19,30.958138759172794,0.6767857142857143,39.75694444444444,1040.972222222222,29.742063492063483,0
769,4,0,0,37,0.0,0.0,1.0,37,1150,800,350,0.6956521739130435,15,8,7,336.9301382110144,0.7301676676676676,0.09215684507448474,0.22110579529427374,135543.27317226064,1733.7227527005964,137276.99592496123,768,63,450.5945945945946,35,2,19,30.89884128042681,0.6776785714285715,39.67013888888888,1041.319444444443,29.751984126984084,0
770,4,0,0,37,0.0,0.0,1.0,37,800,400,400,0.5,12,4,8,338.33801947298105,0.7292917917917918,0.09540681666001083,0.2227783842923411,135663.82304794661,1780.0458408350426,137443.86888878167,769,64,451.5945945945946,35,2,19,30.742533237047734,0.6788690476190476,39.554398148148145,1041.782407407407,29.76521164021163,0
771,4,0,0,37,0.0,0.0,1.0,37,950,600,350,0.631578947368421,13,6,7,338.896716223265,0.7269769769769769,0.09470865801385564,0.22371158598785018,135754.27061899856,1801.3353052126108,137555.60592421118,770,65,452.5945945945946,35,2,19,30.63823485858137,0.6797619047619048,39.46759259259259,1042.129629629629,29.77513227513226,0
772,4,0,0,37,0.0,0.0,1.0,37,950,700,250,0.7368421052631579,12,7,5,338.31867729723865,0.7273523523523523,0.09303540075333538,0.22351868591794818,135784.42650730873,1787.6815147033556,137572.10802201208,771,66,453.5945945945946,35,2,19,30.623380529335545,0.6800595238095237,39.438657407407405,1042.2453703703698,29.778439153439137,0
773,4,0,0,37,0.0,0.0,1.0,37,900,700,200,0.7777777777777778,11,7,4,336.6984359643422,0.7271021021021021,0.09398500778581154,0.21356028275472053,134310.72638031573,1644.442301097422,135955.16868141314,772,67,454.5945945945946,35,2,20,32.1311597439333,0.6654761904761903,40.856481481481495,1036.574074074076,29.61640211640217,2
774,4,0,0,37,0.0,0.0,1.0,37,1000,600,400,0.6,14,6,8,334.4666772959183,0.724974974974975,0.09659749034749043,0.21284243100649375,134430.72702331984,1592.5197187928957,136023.24674211274,773,68,455.5945945945946,35,2,20,32.069382440476204,0.6666666666666665,40.740740740740755,1037.0370370370388,29.62962962962968,0
775,4,0,0,37,0.0,0.0,1.0,37,1050,700,350,0.6666666666666666,14,7,7,331.972708060879,0.7240365365365365,0.09133645527710033,0.21177732258716458,134520.76266986044,1531.4443747856908,136052.20704464614,774,69,456.5945945945946,35,2,20,32.04435363903456,0.6675595238095237,40.6539351851852,1037.384259259261,29.639550264550312,0
776,4,0,0,37,0.0,0.0,1.0,37,1200,1000,200,0.8333333333333334,14,10,4,329.64612031125995,0.7248498498498498,0.09102222972219609,0.21133638692435258,134700.9243853954,1480.7274251972071,136181.6518105926,775,70,457.5945945945946,35,2,21,31.925358642732373,0.669345238095238,40.48032407407408,1038.078703703705,29.659391534391574,0
777,4,0,0,37,0.0,0.0,1.0,37,950,800,150,0.8421052631578947,11,8,3,329.52417935853697,0.7252877877877878,0.09862018487896118,0.21195845601320107,134821.09917534736,1485.362413194464,136306.46158854183,776,71,458.5945945945946,35,2,14,31.808968572383822,0.6705357142857142,40.36458333333334,1038.5416666666679,29.672619047619083,0
778,4,0,0,37,0.0,0.0,1.0,37,500,400,100,0.8,6,4,2,329.87305674531405,0.7244119119119119,0.10084387931501793,0.21235873825196924,134851.15124528483,1496.7522933813673,136347.9035386662,777,72,459.5945945945946,35,2,14,31.77002080083204,0.6708333333333332,40.33564814814816,1038.657407407409,29.67592592592597,0
779,4,0,0,37,0.0,0.0,1.0,37,1300,800,500,0.6153846153846154,18,8,10,329.57704382577367,0.7242242242242242,0.09862441253774645,0.2126968456092,134941.32754897556,1494.7127647033658,136436.04031367894,778,73,460.5945945945946,35,2,15,31.688040733726915,0.6717261904761904,40.248842592592595,1039.0046296296302,29.685846560846578,0
780,4,0,0,37,0.0,0.0,1.0,37,650,500,150,0.7692307692307693,8,5,3,331.17512420276773,0.7243493493493494,0.09781267121431947,0.21390577446708253,134971.39301483193,1539.833569101503,136511.22658393343,779,74,461.5945945945946,35,2,15,31.61663696443157,0.6720238095238095,40.219907407407405,1039.12037037037,29.68915343915343,0
781,4,0,0,37,0.0,0.0,1.0,37,800,800,0,1.0,8,8,0,330.4469576315838,0.7244119119119119,0.09386181638714741,0.21396857436836733,135061.60950628007,1526.139590835054,136587.74909711513,780,75,462.5945945945946,35,2,15,31.54587926363063,0.6729166666666666,40.133101851851855,1039.467592592593,29.699074074074087,0
782,4,0,0,37,0.0,0.0,1.0,37,850,500,350,0.5882352941176471,12,5,7,344.0472242136581,0.7260385385385385,0.05693568744820232,0.22250958880643668,135018.5294035589,1890.5500517409234,136909.07945529983,781,76,463.5945945945946,36,1,17,31.235327048795465,0.6704282407407408,40.174549549549546,1039.3018018018015,28.869494494494486,6
783,4,0,0,37,0.0,0.0,1.0,37,700,300,400,0.42857142857142855,11,3,8,343.1088740963155,0.7258508508508509,0.053485988697256515,0.22208239185897566,135047.7906115575,1867.219077185297,136915.00968874278,782,77,464.5945945945946,36,1,17,31.230588660166124,0.6707175925925927,40.1463963963964,1039.4144144144145,28.872622622622625,0
784,4,0,0,37,0.0,0.0,1.0,37,600,400,200,0.6666666666666666,8,4,4,344.74035755371267,0.7244119119119119,0.05547098224741198,0.22350020933538456,135106.32253875505,1915.320387955531,137021.64292671057,783,78,465.5945945945946,36,1,17,31.129946562680548,0.6712962962962963,40.090090090090094,1039.63963963964,28.878878878878893,0
785,4,0,0,37,0.0,0.0,1.0,37,750,400,350,0.5333333333333333,11,4,7,345.38159469687423,0.7238488488488488,0.055705006425249115,0.22409755894843567,135135.5932579539,1934.6693399480591,137070.26259790198,784,79,466.5945945945946,36,1,17,31.084154662623195,0.6715856481481481,40.06193693693694,1039.7522522522524,28.88200700700701,0
786,4,0,0,37,0.0,0.0,1.0,37,1150,900,250,0.782608695652174,14,9,5,346.6081938583297,0.7228478478478478,0.057922582608594286,0.2254417801743332,135223.42443795144,1973.9093823553303,137197.33382030678,785,80,467.5945945945946,36,1,17,30.964883788075653,0.6724537037037037,39.97747747747748,1040.09009009009,28.891391391391387,0
787,4,0,0,37,0.0,0.0,1.0,37,1050,600,450,0.5714285714285714,15,6,9,348.33024118738405,0.7214089089089089,0.05712530712530728,0.22730024213075062,135340.57706355004,2028.643170197221,137369.22023374727,786,81,468.5945945945946,36,1,18,30.803571428571438,0.6736111111111112,39.86486486486486,1040.5405405405404,28.9039039039039,0
788,4,0,0,37,0.0,0.0,1.0,37,850,600,250,0.7058823529411765,11,6,5,347.66396709358156,0.7204704704704704,0.05741050440314832,0.22760663681395668,135457.78041555072,2018.7578625923281,137476.53827814304,787,82,469.5945945945946,36,1,19,30.704375811337083,0.6747685185185186,39.752252252252255,1040.9909909909913,28.916416416416425,0
789,4,0,0,37,0.0,0.0,1.0,37,850,500,350,0.5882352941176471,12,5,7,352.7628898942215,0.7204704704704704,0.06328265279947765,0.23633074531063758,136279.62421881352,2214.878814625448,138494.50303343896,788,83,470.5945945945946,36,1,18,29.755581320103538,0.6828703703703703,38.96396396396397,1044.144144144145,29.004004004004027,1
790,4,0,0,37,0.0,0.0,1.0,37,1150,1000,150,0.8695652173913043,13,10,3,354.07394529634286,0.7198448448448448,0.06293390512426811,0.23819753375737304,136426.64359883536,2261.0239885155434,138687.6675873509,789,84,471.5945945945946,36,1,19,29.575608134813688,0.6843171296296297,38.8231981981982,1044.7072072072076,29.019644644644657,0
791,4,0,0,37,0.0,0.0,1.0,37,450,300,150,0.6666666666666666,6,3,3,354.07394529634286,0.7198448448448448,0.06293390512426811,0.23819753375737304,136426.64359883536,2261.0239885155434,138687.6675873509,790,85,472.5945945945946,36,1,19,29.575608134813688,0.6843171296296297,38.8231981981982,1044.7072072072076,29.019644644644657,0
792,4,0,1,36,0.0,0.02702702702702703,0.972972972972973,37,700,500,200,0.7142857142857143,9,5,4,354.07394529634286,0.7198448448448448,0.06293390512426811,0.23819753375737304,136426.64359883536,2261.0239885155434,138687.6675873509,791,86,473.5945945945946,36,1,19,29.575608134813688,0.6843171296296297,38.8231981981982,1044.7072072072076,29.019644644644657,0
793,4,1,0,37,0.02702702702702703,0.0,1.0,37,750,300,450,0.4,12,3,9,355.27965747479743,0.713963963963964,0.07248170484890659,0.23980730916535253,136544.3161700553,2302.2835758055453,138846.59974586085,792,0,472.2432432432432,36,1,20,29.427504220091237,0.685474537037037,38.71058558558559,1045.1576576576585,29.032157157157183,0
794,4,0,0,37,0.0,0.0,1.0,37,700,400,300,0.5714285714285714,10,4,6,364.14595369341913,0.7134634634634635,0.006715165081141894,0.22705122793096302,133681.6021117327,2336.037032852899,136017.6391445856,793,1,473.2432432432432,35,2,20,32.049640925200535,0.6592261904761905,41.464120370370374,1034.1435185185187,29.546957671957678,8
795,4,0,0,37,0.0,0.0,1.0,37,700,600,100,0.8571428571428571,8,6,2,366.8276120152241,0.7130255255255256,0.00707656296780157,0.22909422561705528,133741.45507812515,2412.0117187500136,136153.46679687515,794,2,474.2432432432432,35,2,18,31.920317220543808,0.6598214285714284,41.40625000000001,1034.3750000000011,29.553571428571463,0
796,4,0,0,37,0.0,0.0,1.0,37,950,600,350,0.631578947368421,13,6,7,364.92843860328844,0.7124624624624625,0.012444707824504242,0.2282781884307066,133801.32144043644,2365.5814632630386,136166.9029036995,795,3,475.2432432432432,35,2,18,31.909446433232652,0.6604166666666667,41.34837962962963,1034.606481481482,29.5601851851852,0
797,4,0,0,37,0.0,0.0,1.0,37,1150,800,350,0.6956521739130435,15,8,7,363.6167830678945,0.7117742742742743,0.007507003816966673,0.22819823796324087,133921.09435281658,2339.19150270064,136260.28585551723,796,4,476.2432432432432,35,2,18,31.823423347869834,0.6616071428571427,41.2326388888889,1035.0694444444462,29.57341269841275,0
798,4,0,0,37,0.0,0.0,1.0,37,650,500,150,0.7692307692307693,8,5,3,364.2020783491188,0.7130255255255256,0.012218814678289558,0.22893798951741876,133981.00090288505,2359.2317976251875,136340.23270051024,797,5,477.2432432432432,35,2,18,31.748299795043803,0.6622023809523809,41.174768518518526,1035.3009259259268,29.58002645502648,0
799,4,0,0,37,0.0,0.0,1.0,37,950,600,350,0.631578947368421,13,6,7,365.0096549497026,0.7126501501501501,0.014063236235788867,0.2300074924288692,134070.8858453362,2387.433556241438,136458.31940157764,798,6,478.2432432432432,35,2,18,31.637423632841585,0.663095238095238,41.08796296296297,1035.6481481481492,29.58994708994712,0
800,4,0,0,37,0.0,0.0,1.0,37,1000,900,100,0.9,11,9,2,364.93645014226877,0.7126501501501501,0.011416042257477166,0.2301491396986022,134100.85419077947,2387.6579378858187,136488.5121286653,799,7,479.2432432432432,35,2,19,31.60932785786121,0.663392857142857,41.059027777777786,1035.76388888889,29.593253968254,0
801,4,0,0,37,0.0,0.0,1.0,37,1000,700,300,0.7,13,7,6,364.22817850579713,0.7115865865865866,0.011048689703888837,0.23045476199027598,134220.76106235012,2377.396663880332,136598.15772623045,800,8,480.2432432432432,35,2,19,31.507711567817108,0.6645833333333332,40.943287037037045,1036.226851851853,29.606481481481516,0
802,4,0,0,37,0.0,0.0,1.0,37,750,500,250,0.6666666666666666,10,5,5,363.46244216774363,0.7118993993993994,0.008185983615958792,0.23015860729632115,134250.74615269224,2359.020811899883,136609.76696459213,801,9,481.2432432432432,35,2,19,31.497561611197973,0.6648809523809522,40.91435185185186,1036.3425925925942,29.609788359788407,0
803,4,0,0,37,0.0,0.0,1.0,37,1000,600,400,0.6,14,6,8,360.1426482218159,0.710960960960961,0.0017742427031253172,0.2286178384211773,134340.72151759718,2276.364642275408,136617.0861598726,802,10,482.2432432432432,35,2,20,31.493640913996494,0.6657738095238093,40.82754629629631,1036.689814814817,29.619708994709057,0
804,4,0,0,37,0.0,0.0,1.0,37,900,700,200,0.7777777777777778,11,7,4,360.1426482218159,0.710960960960961,0.0017742427031253172,0.2286178384211773,134340.72151759718,2276.364642275408,136617.0861598726,803,11,483.2432432432432,35,2,20,31.493640913996494,0.6657738095238093,40.82754629629631,1036.689814814817,29.619708994709057,0
805,4,0,1,36,0.0,0.02702702702702703,0.972972972972973,37,800,400,400,0.5,12,4,8,358.4991497022752,0.7084584584584585,0.0005428930772084506,0.22832344566326163,134460.73555652023,2240.811873071006,136701.54742959124,804,12,484.2432432432432,35,2,20,31.416345831938393,0.6669642857142856,40.711805555555564,1037.152777777779,29.63293650793654,0
806,4,0,0,36,0.0,0.0,1.0,36,1150,700,450,0.6086956521739131,16,7,9,363.4638530769567,0.7057208994708996,0.008944629395782888,0.2312734568410058,134427.29768990935,2571.8927154195044,136999.19040532885,805,13,493.55555555555554,34,2,20,31.321030880495925,0.6688112745098038,40.74404761904762,1037.0238095238099,30.500700280112056,0
807,4,0,0,36,0.0,0.0,1.0,36,1150,1000,150,0.8695652173913043,13,10,3,362.0574386509688,0.7082671957671958,0.010724643386743393,0.23136153457039654,134582.56927924367,2545.380753404317,137127.950032648,806,14,494.55555555555554,33,3,20,31.20238868548482,0.6726641414141414,40.594362745098046,1037.6225490196089,31.443107546048754,0
808,4,0,0,36,0.0,0.0,1.0,36,600,300,300,0.5,9,3,6,379.5009245516727,0.7079695767195767,0.03713811105837683,0.23448928094732413,133345.61827181876,2920.957083813947,136266.5753556327,807,15,495.55555555555554,33,3,20,31.990092548647354,0.6603535353535352,41.789215686274524,1032.843137254904,31.29827688651224,4
809,4,0,0,36,0.0,0.0,1.0,36,1100,600,500,0.5454545454545454,16,6,10,379.48751300728367,0.707771164021164,0.04435483870967727,0.23528225806451625,133472.22222222245,2930.208333333357,136402.4305555558,808,16,496.55555555555554,33,3,20,31.863239247311828,0.6616161616161614,41.66666666666668,1033.333333333335,31.313131313131365,0
810,4,0,0,36,0.0,0.0,1.0,36,1050,700,350,0.6666666666666666,14,7,7,376.3927137439151,0.705654761904762,0.0338759812444025,0.2341629006743121,133598.8862456749,2857.129469434854,136456.01571510974,809,17,497.55555555555554,33,3,20,31.816026552868664,0.6628787878787877,41.54411764705883,1033.823529411766,31.327985739750485,0
811,4,0,0,36,0.0,0.0,1.0,36,850,500,350,0.5882352941176471,12,5,7,375.67651891564094,0.7060846560846561,0.035343658225014396,0.23391754908422635,133630.561637952,2840.3728433775796,136470.93448132958,810,18,498.55555555555554,33,3,20,31.80274880486746,0.6631944444444443,41.51348039215688,1033.9460784313746,31.33169934640529,0
812,4,0,0,36,0.0,0.0,1.0,36,750,200,550,0.26666666666666666,13,2,11,375.67651891564094,0.7060846560846561,0.035343658225014396,0.23391754908422635,133630.561637952,2840.3728433775796,136470.93448132958,811,19,499.55555555555554,33,3,20,31.80274880486746,0.6631944444444443,41.51348039215688,1033.9460784313746,31.33169934640529,0
813,4,0,0,36,0.0,0.0,1.0,36,550,200,350,0.36363636363636365,9,2,7,375.60026114663924,0.7061838624338624,0.03658713228516497,0.234070532020336,133662.24078479467,2840.7145088427988,136502.95529363747,812,20,500.55555555555554,33,3,20,31.77293197440152,0.6635101010101008,41.482843137254925,1034.0686274509833,31.3354129530601,0
814,4,1,0,37,0.02702702702702703,0.0,1.0,37,1150,800,350,0.6956521739130435,15,8,7,367.5742379052779,0.7197822822822822,0.045352700061220164,0.23114917910789654,133995.5516581636,2450.6625566893836,136446.21421485298,813,0,488.0,34,3,16,31.64644896707677,0.6645220588235292,41.160714285714306,1035.3571428571456,30.45168067226899,0
815,4,0,0,37,0.0,0.0,1.0,37,800,500,300,0.625,11,5,6,364.3067864526923,0.7187812812812813,0.04840142371744305,0.23005788502985006,134149.6669501137,2374.326814058995,136523.9937641727,814,1,489.0,34,3,17,31.576792691335328,0.6660539215686272,41.01190476190478,1035.9523809523835,30.469187675070103,0
816,4,0,0,37,0.0,0.0,1.0,37,750,500,250,0.6666666666666666,10,5,5,364.14319524269433,0.7189064064064064,0.05122806363757704,0.23014801947691896,134180.50063775544,2372.183248299357,136552.6838860548,815,2,490.0,34,3,18,31.550183844651258,0.666360294117647,40.982142857142875,1036.0714285714314,30.472689075630335,0
817,4,0,0,37,0.0,0.0,1.0,37,1400,1100,300,0.7857142857142857,17,11,6,365.5478345848778,0.7184059059059059,0.061222779789779525,0.2322068629759083,134365.57716836748,2423.4091553288167,136788.9863236963,816,3,491.0,34,3,18,31.32870210892947,0.6681985294117645,40.80357142857144,1036.7857142857154,30.493697478991628,0
818,4,0,0,37,0.0,0.0,1.0,37,900,500,400,0.5555555555555556,13,5,8,365.79771123034294,0.7177802802802803,0.06426054153326843,0.23295538452037673,134458.16326530642,2436.897675736993,136895.0609410434,817,4,492.0,34,3,19,31.229673630241805,0.6691176470588234,40.71428571428573,1037.1428571428594,30.504201680672335,0
819,4,0,0,37,0.0,0.0,1.0,37,600,500,100,0.8333333333333334,7,5,2,351.41626793300276,0.7173423423423423,0.06520211719518487,0.21343914378667644,132704.48022959192,1926.902636054434,134631.38286564636,818,5,493.0,34,3,19,33.35860774119007,0.6516544117647058,42.41071428571429,1030.3571428571436,30.304621848739515,5
820,4,0,0,37,0.0,0.0,1.0,37,1000,700,300,0.7,13,7,6,353.170140030284,0.7173423423423423,0.06891127182153856,0.21520761734850322,132827.170138889,1982.1180555555645,134809.28819444455,819,6,494.0,34,3,19,33.190177849636214,0.6528799019607843,42.29166666666667,1030.8333333333342,30.318627450980415,0
821,4,0,0,37,0.0,0.0,1.0,37,950,700,250,0.7368421052631579,12,7,5,352.15544423564216,0.7184059059059059,0.06672053561122038,0.21529446813079528,132949.91673752837,1963.80739795919,134913.72413548757,820,7,495.0,34,3,19,33.093087460079275,0.6541053921568627,42.17261904761905,1031.309523809524,30.332633053221297,0
822,4,0,0,37,0.0,0.0,1.0,37,700,500,200,0.7142857142857143,9,5,4,352.15544423564216,0.7184059059059059,0.06672053561122038,0.21529446813079528,132949.91673752837,1963.80739795919,134913.72413548757,821,8,496.0,34,3,19,33.093087460079275,0.6541053921568627,42.17261904761905,1031.309523809524,30.332633053221297,0
823,4,0,0,37,0.0,0.0,1.0,37,1050,800,250,0.7619047619047619,13,8,5,349.68447641648174,0.7178428428428428,0.05951122462025871,0.21448799413316705,133072.72002551027,1906.6928854875316,134979.4129109978,822,9,497.0,34,3,20,33.03358524672127,0.6553308823529411,42.05357142857143,1031.785714285715,30.346638655462204,0
824,4,0,0,37,0.0,0.0,1.0,37,450,200,250,0.4444444444444444,7,2,5,348.71917031769976,0.7180305305305306,0.058200546838221845,0.21424851080681354,133134.14292800456,1885.2855725623608,135019.42850056692,823,10,498.0,34,3,20,32.99688545391626,0.6559436274509804,41.99404761904762,1032.0238095238096,30.353641456582636,0
825,4,0,0,37,0.0,0.0,1.0,37,950,700,250,0.7368421052631579,12,7,5,349.4814821591484,0.7166541541541541,0.06168968784282458,0.21524882196620268,133226.30385487524,1912.0252267573696,135138.3290816326,824,11,499.0,34,3,20,32.88481126998772,0.6568627450980392,41.904761904761905,1032.380952380952,30.364145658263297,0
826,4,0,0,37,0.0,0.0,1.0,37,850,600,250,0.7058823529411765,11,6,5,349.4814821591484,0.7166541541541541,0.06168968784282458,0.21524882196620268,133226.30385487524,1912.0252267573696,135138.3290816326,825,12,500.0,34,3,20,32.88481126998772,0.6568627450980392,41.904761904761905,1032.380952380952,30.364145658263297,0
827,4,0,0,37,0.0,0.0,1.0,37,1300,900,400,0.6923076923076923,17,9,8,351.555649932055,0.7175925925925926,0.06364871095161506,0.21724336316314194,133349.2346938777,1975.9353741496714,135325.17006802736,826,13,501.0,34,3,20,32.70804518211157,0.6580882352941175,41.78571428571429,1032.8571428571438,30.37815126050423,0
828,4,1,1,37,0.02631578947368421,0.02631578947368421,0.9736842105263158,38,950,800,150,0.8421052631578947,11,8,3,340.86541338209355,0.7278923660502608,0.054142152965495294,0.2128800977914586,133741.45507812512,1517.5672743055693,135259.02235243068,827,0,488.7894736842105,35,3,16,32.59168345082243,0.6598214285714286,41.40625000000001,1034.375000000001,29.553571428571455,0
829,4,0,1,36,0.0,0.02702702702702703,0.972972972972973,37,950,700,250,0.7368421052631579,12,7,5,339.19868366681567,0.715965965965966,0.02039975787378223,0.20720303229350887,132919.2247732426,1678.2403716694942,134597.4651449121,828,15,503.0,34,3,20,33.4579196490418,0.6537990196078431,42.20238095238095,1031.190476190476,30.329131652661058,7
830,4,0,0,36,0.0,0.0,1.0,36,450,300,150,0.6666666666666666,6,3,3,336.5389920062335,0.7096230158730159,-0.02225032789956849,0.20322568458217566,132487.35592689045,1717.4322434413593,134204.7881703318,829,16,496.02777777777777,35,1,23,33.95973861720067,0.6473214285714286,42.62152777777778,1029.513888888889,29.41468253968254,5
831,4,1,0,37,0.02702702702702703,0.0,1.0,37,650,500,150,0.7692307692307693,8,5,3,329.0516650300488,0.7197197197197197,-0.012918393204700562,0.20007653067707515,132745.92318247317,1336.0534098287662,134081.97659230194,830,0,483.5945945945946,36,1,18,33.893153753688125,0.6478587962962963,42.370495495495504,1030.5180180180193,28.625500500500536,0
832,4,1,0,38,0.02631578947368421,0.0,1.0,38,600,400,200,0.6666666666666666,8,4,4,317.8542701594967,0.730766951161688,-0.004472201867193437,0.19483327869255412,133047.67001625508,857.9540098876664,133905.62402614276,831,0,471.8421052631579,37,1,20,33.87968523045312,0.6489301801801801,42.077850877192986,1031.6885964912287,27.88347558084402,0
833,4,0,0,38,0.0,0.0,1.0,38,900,700,200,0.7777777777777778,11,7,4,316.70387110624046,0.7316559981033666,-0.01717389724177676,0.19471806262070837,133160.81781173067,834.5092961295952,133995.32710786027,832,1,472.8421052631579,37,1,20,33.79623481709693,0.6500563063063062,41.96820175438597,1032.1271929824572,27.895329540066413,0
834,4,1,0,39,0.02564102564102564,0.0,1.0,39,950,700,250,0.7368421052631579,12,7,5,308.9385562522857,0.7433085919928025,-0.015067980938287873,0.19111496483706666,133389.43591798167,441.8279503616127,133831.2638683433,833,0,461.6923076923077,38,1,21,33.76835763781158,0.6504934210526315,41.746794871794876,1033.012820512821,27.184547908232133,0
835,4,0,0,39,0.0,0.0,1.0,39,600,400,200,0.6666666666666666,8,4,4,309.89854318418287,0.7429712100764733,-0.01220016542597202,0.19213709677419358,133472.2222222223,472.56944444445446,133944.79166666677,834,1,462.6923076923077,38,1,21,33.66095430107527,0.6513157894736842,41.66666666666667,1033.3333333333342,27.192982456140374,0
836,4,0,0,39,0.0,0.0,1.0,39,500,200,300,0.4,8,2,6,308.9007014433488,0.7429712100764733,-0.013174392374226906,0.19166109589875,133499.82336410624,447.63781594711645,133947.46118005336,835,2,463.6923076923077,38,1,21,33.65919742237845,0.6515899122807017,41.63995726495727,1033.4401709401711,27.195793972109765,0
837,4,0,0,39,0.0,0.0,1.0,39,600,200,400,0.3333333333333333,10,2,8,305.9056547082506,0.7424651372019794,-0.008920691711389539,0.19008588370599408,133555.03420858,371.04803583170104,133926.08224441172,836,3,464.6923076923077,38,1,21,33.68152454780361,0.6521381578947367,41.58653846153847,1033.653846153847,27.201417004048608,0
838,4,0,1,38,0.0,0.02564102564102564,0.9743589743589743,39,750,300,450,0.4,12,3,9,312.1892349071335,0.7421839856050383,-0.009634938184209574,0.19341333060774413,133444.6239339067,548.0463328219587,133992.67026672864,837,4,465.6923076923077,38,1,18,33.62932133871022,0.6510416666666667,41.69337606837606,1033.226495726495,27.19017094017092,3
839,4,0,0,38,0.0,0.0,1.0,38,750,400,350,0.5333333333333333,11,4,7,320.0512734521912,0.7297889995258416,0.0004049442294047356,0.1982802859789608,133443.8977016964,941.7778787703553,134385.67558046675,838,7,478.8421052631579,37,1,19,33.42696505005481,0.6528716216216217,41.6940789473684,1033.223684210524,27.92496443812227,0
840,4,0,0,38,0.0,0.0,1.0,38,1150,600,550,0.5217391304347826,17,6,11,320.01250493393877,0.7270922238027501,0.0003292961991403498,0.19932086667946092,133642.23246575837,953.4371152661993,134595.66958102456,839,8,479.8421052631579,37,1,19,33.22993990809474,0.6548423423423425,41.50219298245612,1033.9912280701728,27.94570886676143,0
841,4,0,0,38,0.0,0.0,1.0,38,1200,1000,200,0.8333333333333334,14,10,4,323.1514316149126,0.7251659554291133,0.002334532675089873,0.20204995078109322,133783.99032635032,1046.4976002231333,134830.48792657346,840,9,480.8421052631579,37,1,17,33.007308779367605,0.65625,41.36513157894736,1034.5394736842097,27.96052631578945,0
842,4,1,0,39,0.02564102564102564,0.0,1.0,39,600,400,200,0.6666666666666666,8,4,4,316.38047577816326,0.7314439946018894,0.00792006920140631,0.19926419439361487,134052.44545118333,682.3152942143228,134734.76074539765,841,0,469.4871794871795,38,1,18,32.914861240070145,0.6570723684210527,41.105769230769226,1035.5769230769222,27.252024291497953,0
843,4,0,0,39,0.0,0.0,1.0,39,800,500,300,0.625,11,5,6,318.75775422574867,0.7314439946018894,-0.019615872087355157,0.20221675586822996,134317.21153163296,764.7796527636675,135081.99118439664,842,1,470.4871794871795,36,3,16,32.589625203693636,0.6634837962962963,40.85022522522522,1036.599099099099,28.794419419419416,1
844,4,0,0,39,0.0,0.0,1.0,39,1350,1000,350,0.7407407407407407,17,10,7,317.4659536579662,0.7275078722447144,-0.018048202634311172,0.20221619229971077,134465.47405211226,737.6419908048713,135203.11604291713,843,2,471.4871794871795,37,2,18,32.47557440885223,0.6630067567567567,40.70723684210527,1037.1710526315794,28.031650071123767,0
845,4,0,1,38,0.0,0.02564102564102564,0.9743589743589743,39,700,400,300,0.5714285714285714,10,4,6,318.3005716166036,0.7276203328834908,-0.017686643413310277,0.20306417451548803,134522.34251163815,763.7077033317926,135286.05021496996,844,3,472.4871794871795,37,2,18,32.39736373885778,0.6635698198198199,40.65241228070175,1037.3903508771928,28.03757705073494,0
846,4,0,2,36,0.0,0.05263157894736842,0.9473684210526316,38,1100,600,500,0.5454545454545454,16,6,10,322.16080099877263,0.7240398293029872,-0.016195211154923284,0.2051937052004631,134463.1688276114,1063.7524348673005,135526.9212624787,845,4,474.2105263157895,36,2,18,32.356134636264926,0.6649305555555556,40.70945945945946,1037.1621621621623,28.810060060060064,0
847,4,0,0,36,0.0,0.0,1.0,36,650,500,150,0.7692307692307693,8,5,3,337.0256858400173,0.7042989417989418,-0.016977032898821243,0.21272072554782484,134130.82588520242,1841.1067172496623,135971.93260245209,846,5,500.75,35,1,18,32.302141527001844,0.663690476190476,41.030092592592595,1035.8796296296302,29.596560846560863,0
848,4,0,0,36,0.0,0.0,1.0,36,1150,700,450,0.6086956521739131,16,7,9,338.3141958871531,0.7031746031746032,-0.011178105304947783,0.2145851231136927,134310.72638031538,1887.8450788751575,136198.57145919054,847,6,501.75,35,1,18,32.089288372785454,0.6654761904761906,40.856481481481474,1036.574074074073,29.616402116402085,0
849,4,0,2,34,0.0,0.05555555555555555,0.9444444444444444,36,1600,1300,300,0.8125,19,13,6,338.29911220780383,0.7034391534391535,-0.00828808053757868,0.21563560765336678,134490.74743870023,1899.620091735247,136390.36753043547,848,7,502.75,35,1,19,31.910194896972385,0.6672619047619048,40.68287037037037,1037.2685185185182,29.63624338624338,0
850,4,0,0,34,0.0,0.0,1.0,34,650,400,250,0.6153846153846154,9,4,5,346.6289518433822,0.6906565656565657,0.029550794555591287,0.2205394128194512,134423.6666786813,2519.0269367551,136942.6936154364,849,8,530.6470588235294,33,1,19,31.761108484991738,0.6710858585858586,40.747549019607845,1037.0098039215688,31.424539512774814,0
851,4,0,0,34,0.0,0.0,1.0,34,1100,800,300,0.7272727272727273,14,8,6,346.49852655624267,0.6911393345216875,0.033671795356499556,0.22085162120589188,134489.03238378683,2520.0503117913863,137009.08269557822,850,9,531.6470588235294,34,0,19,31.699280768200786,0.6694240196078431,40.68452380952381,1037.2619047619046,30.50770308123249,0
852,4,0,0,34,0.0,0.0,1.0,34,350,0,350,0.0,7,0,7,347.8976145546042,0.6899509803921569,0.039333805811481604,0.22211924621563178,134550.78124999997,2562.00751133787,137112.78876133784,851,10,532.6470588235294,32,2,20,31.601405622489985,0.6748046875,40.625,1037.4999999999998,32.42187499999999,0
853,4,0,0,34,0.0,0.0,1.0,34,700,600,100,0.8571428571428571,8,6,2,345.24818656537747,0.688168449197861,0.039025813442996604,0.22081281297852073,134614.36106305255,2495.072808535163,137109.4338715877,852,11,533.6470588235294,33,1,21,31.606735159817347,0.672979797979798,40.56372549019607,1037.7450980392148,31.446821152703478,0
854,4,0,1,33,0.0,0.029411764705882353,0.9705882352941176,34,550,300,250,0.5454545454545454,8,3,5,343.4608630435247,0.6871657754010696,0.03750164922538546,0.2202465534323767,134709.75894187327,2453.506013312183,137163.26495518544,853,12,534.6470588235294,33,1,21,31.55803624129384,0.6739267676767677,40.47181372549019,1038.1127450980387,31.45796197266784,0
855,4,0,0,33,0.0,0.0,1.0,33,850,500,350,0.5882352941176471,12,5,7,352.4305840108008,0.6875000000000001,0.03522699630702553,0.2260284135520129,134714.57791296815,2895.5074737271852,137610.08538669534,854,13,537.5757575757576,32,1,22,31.32044109300253,0.6764322916666666,40.46717171717172,1038.1313131313138,32.44160353535356,0
856,4,0,0,33,0.0,0.0,1.0,33,1050,600,450,0.5714285714285714,15,6,9,353.161402089421,0.6882102272727273,0.03710620241554974,0.22752222826857238,134878.47421500366,2926.774213090513,137805.24842809417,855,14,538.5757575757576,32,1,18,31.138071796118478,0.6780598958333333,40.30934343434344,1038.762626262627,32.461332070707094,0
857,4,0,0,33,0.0,0.0,1.0,33,500,400,100,0.8,6,4,2,353.161402089421,0.6882102272727273,0.03710620241554974,0.22752222826857238,134878.47421500366,2926.774213090513,137805.24842809417,856,15,539.5757575757576,32,1,18,31.138071796118478,0.6780598958333333,40.30934343434344,1038.762626262627,32.461332070707094,0
858,4,0,0,33,0.0,0.0,1.0,33,1000,800,200,0.8,12,8,4,354.7646712306724,0.6863952020202021,0.04100298243676148,0.22917686375419427,134976.85982297733,2977.0042597694255,137953.86408274676,857,16,540.5757575757576,32,1,18,30.998379910895103,0.6790364583333333,40.21464646464647,1039.1414141414148,32.47316919191921,0
859,4,0,0,33,0.0,0.0,1.0,33,800,600,200,0.75,10,6,4,354.82829315556023,0.6856060606060607,0.03891531559371786,0.2306803986363341,135206.56573627706,2995.022988725663,138201.58872500272,858,17,541.5757575757576,32,1,19,30.767927238881477,0.6813151041666666,39.99368686868688,1040.0252525252538,32.50078914141418,0
860,4,1,0,34,0.029411764705882353,0.0,1.0,34,650,400,250,0.6153846153846154,9,4,5,347.581314437103,0.6969325609031491,0.036875484657139745,0.22785886168654526,135506.0553633218,2619.874567474044,138125.92993079583,859,0,526.6176470588235,33,1,20,30.6585451977401,0.6818181818181819,39.705882352941174,1041.1764705882351,31.55080213903743,0
861,4,0,0,34,0.0,0.0,1.0,34,600,200,400,0.3333333333333333,10,2,8,349.17080153036443,0.6965612002376709,0.04385114836709003,0.229308614482615,135569.86045030763,2667.4073673587163,138237.26781766635,860,1,527.6176470588235,33,1,20,30.553757746920862,0.6824494949494949,39.64460784313726,1041.4215686274513,31.55822935234701,0
862,4,0,0,34,0.0,0.0,1.0,34,500,300,200,0.6,7,3,4,354.50383558545406,0.6968954248366014,0.05467788403013518,0.22311681345313172,134026.3676303855,2702.572278911563,136728.93990929707,861,2,528.6176470588235,34,0,17,31.953945351421773,0.664828431372549,41.13095238095238,1035.4761904761906,30.455182072829135,2
863,4,0,0,34,0.0,0.0,1.0,34,450,200,250,0.4444444444444444,7,2,5,354.50383558545406,0.6968954248366014,0.05467788403013518,0.22311681345313172,134026.3676303855,2702.572278911563,136728.93990929707,862,3,529.6176470588235,34,0,17,31.953945351421773,0.664828431372549,41.13095238095238,1035.4761904761906,30.455182072829135,0
864,4,0,1,33,0.0,0.029411764705882353,0.9705882352941176,34,350,100,250,0.2857142857142857,6,1,5,353.73291847071584,0.6961898395721926,0.055499956046334065,0.22281844009969265,134057.18714569145,2684.088010204064,136741.2751558955,863,4,530.6176470588235,34,0,17,31.943087328045358,0.6651348039215687,41.10119047619047,1035.595238095237,30.45868347338932,0
865,4,0,0,33,0.0,0.0,1.0,33,1300,1100,200,0.8461538461538461,15,11,4,361.3495528613225,0.6840277777777778,0.06050560064294386,0.22674281749381336,133915.8091238945,3078.0835495962892,136993.89267349077,864,23,547.5757575757576,33,0,17,31.887382587418102,0.6660353535353536,41.237745098039206,1035.049019607842,31.36512180629824,0
866,4,0,0,33,0.0,0.0,1.0,33,1300,800,500,0.6153846153846154,18,8,10,363.5609397430063,0.6848169191919192,0.05876994800071755,0.2289187735341579,134042.68340301784,3146.536788735077,137189.22019175292,865,24,548.5757575757576,33,0,17,31.70315581854043,0.6672979797979799,41.11519607843136,1035.5392156862729,31.37997623291736,0
867,4,0,0,33,0.0,0.0,1.0,33,950,800,150,0.8421052631578947,11,8,3,366.5817472578329,0.6837121212121212,0.05996085768974324,0.23162048515080114,134169.6177551903,3236.8265811226447,137406.44433631294,866,25,549.5757575757576,33,0,18,31.497910259443266,0.6685606060606061,40.99264705882353,1036.0294117647059,31.39483065953654,0
868,4,0,0,33,0.0,0.0,1.0,33,650,500,150,0.7692307692307693,8,5,3,366.09117573611627,0.6823705808080809,0.05897193314411897,0.23171160045094297,134233.10745866972,3228.311226451363,137461.41868512108,867,26,550.5757575757576,33,0,18,31.447098707032477,0.6691919191919191,40.931372549019606,1036.2745098039213,31.4022578728461,0
869,4,0,0,33,0.0,0.0,1.0,33,500,300,200,0.6,7,3,4,366.09117573611627,0.6823705808080809,0.05897193314411897,0.23171160045094297,134233.10745866972,3228.311226451363,137461.41868512108,868,27,551.5757575757576,33,0,18,31.447098707032477,0.6691919191919191,40.931372549019606,1036.2745098039213,31.4022578728461,0
870,4,0,0,33,0.0,0.0,1.0,33,950,700,250,0.7368421052631579,12,7,5,368.8939180626458,0.682449494949495,0.0594241672128446,0.23450123521623187,134391.8974222655,3315.2707191945465,137707.16814146005,869,28,552.5757575757576,33,0,20,31.215651223259666,0.670770202020202,40.77818627450981,1036.8872549019611,31.420825906120033,0
871,4,0,0,33,0.0,0.0,1.0,33,650,500,150,0.7692307692307693,8,5,3,366.6317894921202,0.6831597222222223,0.057205247990835595,0.23387626963457409,134518.996975322,3263.788116349482,137782.78509167148,870,29,553.5757575757576,33,0,21,31.14724847410907,0.6720328282828283,40.65563725490196,1037.3774509803923,31.43568033273916,0
872,4,0,0,33,0.0,0.0,1.0,33,650,400,250,0.6153846153846154,9,4,5,368.1842399701638,0.683001893939394,0.06693209466932148,0.23570673306501122,134649.04729109263,3315.135182481057,137964.1824735737,871,30,554.5757575757576,32,1,21,30.977037712895385,0.67578125,40.530303030303024,1037.8787878787869,32.43371212121209,0
873,4,0,0,33,0.0,0.0,1.0,33,850,600,250,0.7058823529411765,11,6,5,366.7432488613373,0.6818181818181819,0.06636087316938388,0.23584544346243155,134812.90373750124,3288.344461024385,138101.24819852563,872,31,555.5757575757576,32,1,17,30.850810536980756,0.6774088541666667,40.37247474747475,1038.510101010101,32.453440656565654,0
874,4,0,0,33,0.0,0.0,1.0,33,700,300,400,0.42857142857142855,11,3,8,366.3548630864091,0.6820549242424243,0.06457672630031941,0.23602204061173726,134878.47421500343,3282.6769908682586,138161.1512058717,873,32,556.5757575757576,32,1,17,30.795449941250357,0.6780598958333335,40.309343434343425,1038.7626262626252,32.46133207070704,0
875,4,0,0,33,0.0,0.0,1.0,33,900,700,200,0.7777777777777778,11,7,4,363.469179337236,0.6820549242424243,0.06610270650841454,0.23471859646614035,134964.31848627923,3211.074016003444,138175.39250228266,874,33,557.5757575757576,33,0,17,30.784757439949672,0.6764520202020203,40.2267156862745,1039.0931372549012,31.487670825906097,0
876,4,0,0,33,0.0,0.0,1.0,33,1000,700,300,0.7,13,7,6,365.20851874291003,0.683001893939394,0.06850871363957856,0.23646554625781394,135059.84026576305,3265.0008410226646,138324.84110678572,875,34,558.5757575757576,33,0,18,30.644305588304626,0.67739898989899,40.13480392156862,1039.4607843137246,31.498811645870443,0
877,4,0,0,33,0.0,0.0,1.0,33,800,600,200,0.75,10,6,4,365.20851874291003,0.683001893939394,0.06850871363957856,0.23646554625781394,135059.84026576305,3265.0008410226646,138324.84110678572,876,35,559.5757575757576,33,0,18,30.644305588304626,0.67739898989899,40.13480392156862,1039.4607843137246,31.498811645870443,0
878,4,0,0,33,0.0,0.0,1.0,33,550,300,250,0.5454545454545454,8,3,5,367.58888518520007,0.6823705808080809,0.07238719863970355,0.2382166931265126,135091.68836805545,3331.64062499998,138423.32899305542,877,36,560.5757575757576,33,0,18,30.550684702738796,0.6777146464646466,40.10416666666666,1039.5833333333323,31.502525252525224,0
879,4,0,0,33,0.0,0.0,1.0,33,550,400,150,0.7272727272727273,7,4,3,367.500066844711,0.6827651515151516,0.07115587221656772,0.23857980621096936,135155.39583633683,3333.923400855418,138489.31923719225,878,37,561.5757575757576,33,0,19,30.48946670595167,0.6783459595959597,40.042892156862735,1039.8284313725478,31.509952465834782,0
880,4,0,0,33,0.0,0.0,1.0,33,700,400,300,0.5714285714285714,10,4,6,368.2308986807733,0.6801609848484849,0.07596816218724345,0.2401136966052046,135314.73021193763,3365.4129421376256,138680.14315407525,879,38,562.5757575757576,33,0,19,30.311641146446803,0.6799242424242424,39.889705882352935,1040.4411764705874,31.52852049910871,0
881,4,0,0,33,0.0,0.0,1.0,33,900,700,200,0.7777777777777778,11,7,4,358.6528105009585,0.6801609848484849,0.08185734973355041,0.22255475724463464,133503.8825962371,2976.308541186091,136480.1911374232,880,39,563.5757575757576,33,0,22,32.36973299339895,0.6619318181818181,41.63602941176471,1033.4558823529417,31.31684491978611,5
882,4,1,0,34,0.029411764705882353,0.0,1.0,34,1050,800,250,0.7619047619047619,13,8,5,347.1975379500985,0.687945632798574,0.08514288034321082,0.2176054936842256,133872.3232001135,2496.0282029478612,136368.35140306136,881,0,547.9705882352941,34,0,18,32.29705893630891,0.6632965686274509,41.27976190476191,1034.8809523809534,30.437675070028043,0
883,4,0,0,34,0.0,0.0,1.0,34,650,400,250,0.6153846153846154,9,4,5,347.91847746513315,0.6863487819370173,0.08665241625629094,0.2186054248581502,133964.73922902506,2521.7616213152055,136486.50085034026,882,1,548.9705882352941,34,0,18,32.18601464274762,0.6642156862745097,41.1904761904762,1035.238095238096,30.44817927170871,0
884,4,0,1,33,0.0,0.029411764705882353,0.9705882352941176,34,1050,700,350,0.6666666666666666,14,7,7,347.2576553830892,0.6857917409387998,0.08200739774010568,0.21873963390133908,134057.18714569154,2510.4768990929674,136567.6640447845,883,2,549.9705882352941,34,0,19,32.11073111851939,0.6651348039215685,41.101190476190474,1035.5952380952376,30.458683473389343,0
885,4,0,0,33,0.0,0.0,1.0,33,1300,1100,200,0.8461538461538461,15,11,4,351.4985881688391,0.6840277777777778,0.06168165325761166,0.22170642292559917,134106.1430699731,2827.623990772782,136933.7670607459,884,3,541.2727272727273,33,0,19,31.952003470578944,0.6679292929292929,41.05392156862745,1035.7843137254904,31.387403446226983,0
886,4,0,0,33,0.0,0.0,1.0,33,1200,800,400,0.6666666666666666,16,8,8,351.2175889170633,0.6848169191919192,0.05897193314411875,0.2222975996918178,134233.10745866972,2829.005670895806,137062.11312956552,885,4,542.2727272727273,33,0,20,31.83242667928098,0.6691919191919192,40.931372549019606,1036.2745098039213,31.4022578728461,0
887,4,0,0,33,0.0,0.0,1.0,33,500,400,100,0.8,6,4,2,352.95763507509116,0.6858428030303031,0.062368781214843905,0.22378678241867467,134296.61218041135,2880.202926758933,137176.8151071703,886,5,543.2727272727273,33,0,20,31.72391030188381,0.6698232323232323,40.870098039215684,1036.519607843137,31.409685086155665,0
888,4,0,0,33,0.0,0.0,1.0,33,450,200,250,0.4444444444444444,7,2,5,352.07260980612426,0.6858428030303031,0.059187620889748604,0.22361368460659234,134360.13192041515,2860.9044598231367,137221.03638023828,887,6,544.2727272727273,33,0,20,31.683412135539793,0.6704545454545455,40.80882352941176,1036.7647058823525,31.417112299465227,0
889,4,0,0,33,0.0,0.0,1.0,33,700,300,400,0.42857142857142855,11,3,8,351.14927853809576,0.6853693181818182,0.06014768340459664,0.22341542819468888,134423.66667868107,2840.5547145328483,137264.22139321393,888,7,545.2727272727273,33,0,20,31.64391790750808,0.6710858585858587,40.74754901960783,1037.009803921567,31.424539512774757,0
890,4,0,0,33,0.0,0.0,1.0,33,1350,1100,250,0.8148148148148148,16,11,5,354.59845607314554,0.6842645202020202,0.062051788551552356,0.22679303066672166,134614.36106305255,2946.808919646273,137561.16998269883,889,8,546.2727272727273,33,0,22,31.364155251141543,0.672979797979798,40.56372549019607,1037.7450980392148,31.446821152703478,0
891,4,0,0,33,0.0,0.0,1.0,33,750,500,250,0.6666666666666666,10,5,5,353.4489004483845,0.6826862373737375,0.060327033765825044,0.22665144857670427,134709.75894187318,2922.60323553439,137632.36217740757,890,9,547.2727272727273,33,0,22,31.2988185180813,0.6739267676767678,40.471813725490186,1038.112745098038,31.457961972667817,0
892,4,0,0,33,0.0,0.0,1.0,33,600,400,200,0.6666666666666666,8,4,4,351.0197073111634,0.6811079545454546,0.060534557467072814,0.2260822978092262,134868.83049788524,2868.3234813533,137737.15397923853,891,10,548.2727272727273,33,0,19,31.203299512348597,0.6755050505050506,40.31862745098038,1038.7254901960769,31.476530005941722,0
893,4,0,0,33,0.0,0.0,1.0,33,600,400,200,0.6666666666666666,8,4,4,348.6761747848458,0.680239898989899,0.0607561640702341,0.2251656729627346,134964.31848627923,2811.76846044789,137776.08694672713,892,11,549.2727272727273,33,0,19,31.169040177693905,0.6764520202020203,40.2267156862745,1039.0931372549012,31.487670825906097,0
894,4,0,0,33,0.0,0.0,1.0,33,800,500,300,0.625,11,5,6,349.40107468010905,0.6804766414141414,0.058048662009058116,0.2266298713750797,135123.54022491333,2842.4620338331206,137966.00225874645,893,12,550.2727272727273,33,0,19,30.991670595630993,0.6780303030303031,40.073529411764696,1039.7058823529399,31.506238859179994,0
895,4,1,1,33,0.029411764705882353,0.029411764705882353,0.9705882352941176,34,700,300,400,0.42857142857142855,11,3,8,340.95490964428876,0.6966354723707665,0.05121744454387023,0.22295951944801895,135416.75347222207,2434.2013888888696,137850.95486111095,894,0,535.0588235294117,34,0,20,30.9197357886309,0.6786151960784315,39.79166666666666,1040.8333333333321,30.61274509803918,0
896,4,0,0,33,0.0,0.0,1.0,33,800,400,400,0.5,12,4,8,348.20017570961215,0.6805555555555556,0.05389426784337292,0.22665054382079652,135250.98519800065,2818.8833621683875,138069.86856016904,895,14,552.2727272727273,33,0,20,30.896068960100536,0.6792929292929293,39.95098039215686,1040.1960784313717,31.521093285799143,0
897,4,0,0,33,0.0,0.0,1.0,33,800,600,200,0.75,10,6,4,347.3145438705051,0.6800820707070707,0.05510161099747646,0.22627422585700044,135282.85582768632,2797.1406730584276,138079.99650074475,896,15,553.2727272727273,33,0,20,30.887398397926738,0.6796085858585859,39.920343137254896,1040.3186274509794,31.52480689245392,0
898,4,0,0,33,0.0,0.0,1.0,33,950,700,250,0.7368421052631579,12,7,5,344.6406276442757,0.679608585858586,0.0504658024968867,0.2253297036630356,135410.37589208476,2733.583387399076,138143.95927948382,897,16,554.2727272727273,33,0,21,30.830168962675145,0.6808712121212122,39.79779411764706,1040.8088235294117,31.539661319073083,0
899,4,0,0,33,0.0,0.0,1.0,33,950,800,150,0.8421052631578947,11,8,3,345.65917656847614,0.6777935606060607,0.056262281518254076,0.2268004651198719,135537.95602953187,2769.9876549884593,138307.94368452032,898,17,555.2727272727273,33,0,21,30.676881056058992,0.6821338383838385,39.67524509803921,1041.2990196078429,31.554515745692207,0
900,4,0,0,33,0.0,0.0,1.0,33,1350,900,450,0.6666666666666666,18,9,9,345.8319768783146,0.6763731060606061,0.058168131562627456,0.22792740057514962,135697.51567906578,2785.708020953481,138483.22370001927,899,18,556.2727272727273,33,0,21,30.513898690504195,0.6837121212121212,39.52205882352941,1041.9117647058824,31.573083778966133,0
901,4,0,0,33,0.0,0.0,1.0,33,1100,700,400,0.6363636363636364,15,7,8,349.3745497362369,0.6747948232323233,0.0617745762349573,0.23108708554093554,135825.23098087285,2890.77578335257,138716.00676422543,900,19,557.2727272727273,33,0,21,30.29479191159183,0.6849747474747474,39.399509803921575,1042.4019607843145,31.58793820558529,0
902,4,0,0,33,0.0,0.0,1.0,33,750,500,250,0.6666666666666666,10,5,5,348.28618021792283,0.6745580808080809,0.05520777694690748,0.23119464849099253,135953.00635572866,2870.1106545559487,138823.11701028462,901,20,558.2727272727273,33,0,17,30.196337641989825,0.6862373737373737,39.27696078431373,1042.8921568627457,31.602792632204412,0
903,4,0,0,33,0.0,0.0,1.0,33,800,600,200,0.75,10,6,4,347.5292360745553,0.6750315656565657,0.05809297010988512,0.23131480740443242,136048.8773098088,2856.1924800557535,138905.06978986456,902,21,559.2727272727273,33,0,18,30.12096695250401,0.6871843434343434,39.185049019607845,1043.259803921569,31.61393345216876,0
904,4,0,0,33,0.0,0.0,1.0,33,750,500,250,0.6666666666666666,10,5,5,347.0451933994881,0.6750315656565657,0.06050640300111776,0.23120053025064488,136080.8418036333,2845.2404123414112,138926.0822159747,903,22,560.2727272727273,33,0,18,30.101891003053794,0.6875,39.154411764705884,1043.3823529411768,31.61764705882354,0
905,4,0,0,33,0.0,0.0,1.0,33,900,700,200,0.7777777777777778,11,7,4,346.4926434556037,0.6758996212121212,0.059517328978407,0.23145708582834326,136176.7578125,2836.8489583333335,139013.60677083334,904,23,561.2727272727273,33,0,19,30.02120758483034,0.6884469696969697,39.0625,1043.75,31.62878787878788,0
906,4,0,0,33,0.0,0.0,1.0,33,650,300,350,0.46153846153846156,10,3,7,347.6693052702904,0.6764520202020202,0.06143842462659199,0.23266259321269483,136240.72059123896,2873.343335495961,139114.06392673493,905,24,562.2727272727273,33,0,20,29.927099229174004,0.6890782828282829,39.00122549019608,1043.9950980392157,31.636215092097444,0
907,4,0,0,33,0.0,0.0,1.0,33,850,700,150,0.8235294117647058,10,7,3,346.89118923968226,0.6758207070707072,0.062207888826002256,0.23089012462841413,136048.87730980892,2838.8313689446563,138887.70867875358,906,25,563.2727272727273,33,0,18,30.137608167900076,0.6871843434343434,39.18504901960785,1043.25980392157,31.613933452168787,1
908,4,0,0,33,0.0,0.0,1.0,33,1000,600,400,0.6,14,6,8,346.4926434556038,0.6747159090909092,0.06725942055283407,0.2314570858283433,136176.7578125,2836.8489583333335,139013.60677083334,907,26,564.2727272727273,33,0,18,30.021207584830343,0.6884469696969697,39.0625,1043.75,31.62878787878788,0
909,4,0,0,33,0.0,0.0,1.0,33,1250,1000,250,0.8,15,10,5,349.12468544374104,0.675741792929293,0.06045669700170331,0.2340591223183414,136304.6983882402,2917.4669898596803,139222.1653780999,908,27,565.2727272727273,33,0,18,29.82570023080232,0.6897095959595958,38.93995098039216,1044.2401960784323,31.643642305407038,0
910,4,0,0,33,0.0,0.0,1.0,33,600,400,200,0.6666666666666666,8,4,4,349.12468544374104,0.675741792929293,0.06045669700170331,0.2340591223183414,136304.6983882402,2917.4669898596803,139222.1653780999,909,28,566.2727272727273,33,0,18,29.82570023080232,0.6897095959595958,38.93995098039216,1044.2401960784323,31.643642305407038,0
911,4,0,0,33,0.0,0.0,1.0,33,550,300,250,0.5454545454545454,8,3,5,348.6304645377163,0.6758207070707072,0.060200740242978945,0.23415109923206914,136368.69120350355,2908.4560325355715,139277.14723603913,910,29,567.2727272727273,33,0,18,29.775191638312016,0.690340909090909,38.87867647058824,1044.4852941176478,31.6510695187166,0
912,4,0,0,33,0.0,0.0,1.0,33,1150,900,250,0.782608695652174,14,9,5,347.52777032080536,0.6744791666666667,0.06113912669559474,0.23425844249213507,136496.72188881683,2887.2802828239182,139384.00217164075,911,30,568.2727272727273,33,0,19,29.677177397287053,0.6916035353535352,38.756127450980394,1044.9754901960787,31.665923945335717,0
913,4,0,0,33,0.0,0.0,1.0,33,600,400,200,0.6666666666666666,8,4,4,347.2283333744003,0.6747159090909092,0.06016544431178583,0.2342692426437411,136528.73894655914,2881.3292964244692,139410.0682429836,912,31,569.2727272727273,33,0,20,29.65329893683553,0.6919191919191918,38.72549019607844,1045.0980392156873,31.669637551990526,0
914,4,0,0,33,0.0,0.0,1.0,33,900,500,400,0.5555555555555556,13,5,8,349.4498835986899,0.6751104797979799,0.05555496353761491,0.23641212981605275,136624.8126471791,2948.7049752499192,139573.517622429,913,32,570.2727272727273,33,0,20,29.500131871996253,0.6928661616161615,38.633578431372555,1045.4656862745107,31.680778371954872,0
915,4,0,0,33,0.0,0.0,1.0,33,750,500,250,0.6666666666666666,10,5,5,350.351848853011,0.674084595959596,0.05723234927500709,0.23745451360307748,136688.8805537535,2977.840403931193,139666.72095768468,914,33,571.2727272727273,33,0,20,29.413136255322474,0.6934974747474747,38.57230392156863,1045.7107843137264,31.688205585264438,0
916,4,0,0,33,0.0,0.0,1.0,33,750,400,350,0.5333333333333333,11,4,7,353.05896675330183,0.6717171717171718,0.062040271506063505,0.23994517039858174,136785.01057285667,3058.634900038455,139843.64547289512,915,34,572.2727272727273,33,0,20,29.247207903780083,0.6944444444444444,38.48039215686275,1046.0784313725496,31.699346405228777,0
917,4,0,1,32,0.0,0.030303030303030304,0.9696969696969697,33,850,400,450,0.47058823529411764,13,4,9,353.62403283111786,0.671796085858586,0.06589498120480886,0.2405488739664745,136817.06142168885,3076.3602040080805,139893.42162569694,916,35,573.2727272727273,33,0,20,29.200709656007177,0.694760101010101,38.44975490196079,1046.2009803921574,31.703060011883558,0
918,4,0,0,32,0.0,0.0,1.0,32,650,400,250,0.6153846153846154,9,4,5,356.10301712419067,0.6674647177419355,0.08424716423313616,0.2424836239037117,136853.0016866903,3346.753360626484,140199.75504731678,917,36,584.4375,32,0,20,29.100297654961587,0.6975911458333333,38.41540404040405,1046.338383838385,32.69807449494953,0
919,4,0,0,32,0.0,0.0,1.0,32,1050,900,150,0.8571428571428571,12,9,3,360.018101364732,0.6680107526881721,0.09155609167671841,0.2458443212778939,136952.10469594956,3461.0473421079682,140413.15203805754,918,37,585.4375,32,0,16,28.899778850020105,0.6985677083333333,38.32070707070708,1046.7171717171732,32.70991161616166,0
920,4,0,0,32,0.0,0.0,1.0,32,700,600,100,0.8571428571428571,8,6,2,360.1305855947763,0.6670026881720431,0.09200928381962825,0.24685314685314705,137084.29783950638,3473.649691358052,140557.94753086445,919,38,586.4375,32,0,17,28.766025641025646,0.6998697916666666,38.19444444444446,1047.222222222224,32.7256944444445,0
921,4,0,0,32,0.0,0.0,1.0,32,500,400,100,0.8,6,4,2,361.1626865134774,0.666876680107527,0.08864150090415923,0.24779524273195164,137117.3560893021,3504.3345385674957,140621.6906278696,920,39,587.4375,32,0,17,28.70629897528632,0.7001953125,38.16287878787879,1047.348484848485,32.729640151515156,0
922,4,0,0,32,0.0,0.0,1.0,32,1250,1000,250,0.8,15,10,5,363.1957305649664,0.666876680107527,0.08837154995781549,0.24966321263442673,137183.48454558238,3564.8911781961324,140748.3757237785,921,40,588.4375,32,0,17,28.587642119641636,0.7008463541666666,38.09974747474749,1047.6010101010122,32.73753156565663,0
923,4,0,0,32,0.0,0.0,1.0,32,1000,600,400,0.6,14,6,8,365.22959519319295,0.6671286962365592,0.08853476821191997,0.2529801324503311,137448.15779321,3640.0270061728534,141088.18479938287,922,41,589.4375,32,0,19,28.272626931567327,0.7034505208333333,37.84722222222223,1048.6111111111122,32.76909722222226,0
924,4,0,0,32,0.0,0.0,1.0,32,1050,800,250,0.7619047619047619,13,8,5,366.111625629731,0.666960685483871,0.089258306247743,0.2540759627490541,137514.36596074386,3669.121613865943,141183.4875746098,923,42,590.4375,32,0,19,28.18406163476586,0.7041015625,37.784090909090914,1048.863636363637,32.776988636363654,0
925,4,0,0,32,0.0,0.0,1.0,32,450,300,150,0.6666666666666666,6,3,3,367.2688385360255,0.6662046370967742,0.09444954266458061,0.25536709451011186,137580.59007052856,3705.8127040608165,141286.40277458937,924,43,591.4375,32,0,19,28.088267741806074,0.7047526041666666,37.7209595959596,1049.116161616162,32.78488005050506,0
926,4,0,0,32,0.0,0.0,1.0,32,1250,1100,150,0.88,14,11,3,367.4395569272565,0.6651965725806452,0.09169699795451836,0.255975704746222,137646.83012256402,3715.3780545352543,141362.20817709927,925,44,592.4375,32,0,19,28.018339148919107,0.7054036458333334,37.657828282828284,1049.3686868686868,32.792771464646464,0
927,4,0,0,32,0.0,0.0,1.0,32,850,600,250,0.7058823529411765,11,6,5,367.14882641271174,0.6664146505376345,0.08831489054606712,0.25651053300800725,137746.22009233755,3714.6726099377656,141460.8927022753,926,45,593.4375,32,0,20,27.92779247855024,0.7063802083333334,37.563131313131315,1049.7474747474748,32.80460858585859,0
928,4,0,0,32,0.0,0.0,1.0,32,950,600,350,0.631578947368421,13,6,7,367.220962459058,0.66591061827957,0.08978174603174649,0.25705467372134033,137812.49999999985,3721.5277777777637,141534.0277777776,927,46,594.4375,32,0,20,27.860449735449727,0.70703125,37.49999999999999,1049.9999999999989,32.812499999999964,0
929,4,0,0,32,0.0,0.0,1.0,32,900,800,100,0.8888888888888888,10,8,2,368.1445121529666,0.6645665322580646,0.09145187454938752,0.2591961616021137,138011.43537649198,3761.630509641847,141773.06588613382,928,47,595.4375,32,0,21,27.639840182648403,0.7089843750000001,37.31060606060605,1050.7575757575742,32.83617424242419,0
930,4,0,0,32,0.0,0.0,1.0,32,750,500,250,0.6666666666666666,10,5,5,367.38568604081,0.6638524865591399,0.0843378467635405,0.25991678909616145,138177.3244598763,3752.874228395034,141930.19868827134,929,48,596.4375,32,0,16,27.496147071774548,0.7106119791666667,37.152777777777764,1051.388888888887,32.85590277777772,0
931,4,0,0,32,0.0,0.0,1.0,32,1100,900,200,0.8181818181818182,13,9,4,366.57977824432277,0.6638524865591399,0.08920760430686436,0.2250981613516791,133113.66705246913,3359.3557098765505,136473.02276234567,930,49,597.4375,32,0,22,32.55663974876627,0.6604817708333333,42.01388888888889,1031.9444444444446,32.24826388888889,8
932,4,0,0,32,0.0,0.0,1.0,32,400,300,100,0.75,5,3,2,365.2881010040429,0.6637264784946237,0.0885658796183022,0.22450112312834963,133146.24304917883,3327.347655851471,136473.5907050303,931,50,598.4375,32,0,22,32.55724451512929,0.6608072916666665,41.982323232323246,1032.0707070707085,32.25220959595964,0
933,4,0,0,32,0.0,0.0,1.0,32,600,300,300,0.5,9,3,6,362.65873031837845,0.6636004704301076,0.08336263299498636,0.22347102018186743,133243.99495268348,3264.4196064177268,136508.41455910122,932,51,599.4375,32,0,22,32.526955688720406,0.6617838541666665,41.88762626262627,1032.4494949494956,32.26404671717174,0
934,4,0,0,32,0.0,0.0,1.0,32,950,800,150,0.8421052631578947,11,8,3,387.45898841276073,0.6636004704301076,0.12388268588395435,0.22039627046730093,130198.14822785946,3689.288561116226,133887.4367889757,933,52,600.4375,32,0,19,34.9689677924863,0.6311848958333333,44.854797979797986,1020.5808080808085,31.893150252525267,7
935,4,0,0,32,0.0,0.0,1.0,32,700,500,200,0.7142857142857143,9,5,4,385.7484216643627,0.6656586021505377,0.12852373887240387,0.22033426796761058,130359.27456382009,3657.1768824609844,134016.45144628108,934,53,601.4375,32,0,20,34.848695598417414,0.6328125,44.6969696969697,1021.2121212121217,31.912878787878803,0
936,4,0,0,32,0.0,0.0,1.0,32,750,500,250,0.6666666666666666,10,5,5,383.86110521161027,0.6667506720430109,0.1302765760197775,0.2196206747639272,130423.7529971433,3612.9211942659126,134036.6741914092,935,54,602.4375,32,0,20,34.83132468067574,0.6334635416666665,44.633838383838395,1021.4646464646477,31.92077020202024,0
937,4,2,1,33,0.058823529411764705,0.029411764705882353,0.9705882352941176,34,750,400,350,0.5333333333333333,11,4,7,365.7636575562059,0.6926990493166965,0.11962107164605995,0.2120344008098922,130931.84700963713,2778.0222505668885,133709.86926020402,936,0,567.9411764705883,34,0,16,34.778362607111,0.6338848039215685,44.13690476190476,1023.4523809523805,30.101540616246485,0
938,4,1,0,34,0.029411764705882353,0.0,1.0,34,950,700,250,0.7368421052631579,12,7,5,369.27873626767774,0.6992721330956626,0.1223039785549187,0.2149212239089692,131084.19075963722,2881.3208616780103,133965.51162131524,937,0,568.9117647058823,34,0,18,34.53411997209951,0.6354166666666666,43.98809523809524,1024.0476190476193,30.119047619047624,0
939,4,0,0,34,0.0,0.0,1.0,34,500,200,300,0.4,8,2,6,371.3332349710871,0.6979723707664884,0.1199883788495062,0.2166320330119463,131175.63952664414,2941.9749149660042,134117.61444161015,938,1,569.9117647058823,34,0,19,34.38892116986248,0.6363357843137254,43.89880952380953,1024.404761904763,30.129551820728324,0
940,4,0,0,34,0.0,0.0,1.0,34,600,200,400,0.3333333333333333,10,2,8,373.53458805305036,0.6990121806298277,0.11900368373211978,0.21826287843670095,131236.6230867348,3004.283588435391,134240.90667517018,939,2,570.9117647058823,34,0,19,34.27079702567679,0.6369485294117645,43.83928571428572,1024.642857142858,30.136554621848767,0
941,4,0,0,34,0.0,0.0,1.0,34,800,600,200,0.75,10,6,4,372.38931814516417,0.6995320855614974,0.11801944613366278,0.21794015227136104,131297.62081916115,2978.7662981859557,134276.3871173471,940,3,571.9117647058823,34,0,19,34.23839392883417,0.6375612745098038,43.77976190476191,1024.8809523809537,30.143557422969224,0
942,4,0,1,33,0.0,0.029411764705882353,0.9705882352941176,34,800,600,200,0.75,10,6,4,376.07396124095294,0.6993464052287582,0.12104315787993425,0.22063357361443295,131390.93888168022,3082.545714364189,134473.4845960444,941,4,572.9117647058823,33,1,20,34.04952585863416,0.6407828282828282,43.688725490196084,1025.2450980392164,31.06803327391565,0
943,4,1,1,33,0.029411764705882353,0.029411764705882353,0.9705882352941176,34,700,600,100,0.8571428571428571,8,6,2,369.82191451540604,0.7144236482471777,0.10804923976279457,0.21803866678330866,131579.4706362939,2932.194348327585,134511.6649846215,942,0,558.2352941176471,33,1,12,34.01915113871635,0.6426767676767676,43.50490196078432,1025.9803921568641,31.090314913844367,0
944,4,0,0,33,0.0,0.0,1.0,33,800,600,200,0.75,10,6,4,379.7381357060101,0.7015467171717172,0.11792220580994583,0.2235501894547557,131522.3255280075,3388.80853994492,134911.13406795243,943,6,576.1515151515151,32,1,20,33.82262432299359,0.64453125,43.56060606060607,1025.757575757577,32.05492424242428,0
945,4,1,1,33,0.029411764705882353,0.029411764705882353,0.9705882352941176,34,800,500,300,0.625,11,5,6,371.46305209662256,0.7113784907902555,0.11178436521421675,0.22009317188582087,131768.1375552673,2989.398909073445,134757.53646434075,944,0,560.1764705882352,33,1,13,33.786404869897346,0.644570707070707,43.321078431372555,1026.7156862745105,31.112596553773045,0
946,4,0,0,33,0.0,0.0,1.0,33,700,600,100,0.8571428571428571,8,6,2,380.26043099570614,0.6998106060606061,0.11886304909560708,0.22442821515628944,131619.47959710757,3409.936007805345,135029.4156049129,945,8,578.1515151515151,32,1,14,33.71093269349085,0.6455078125,43.4659090909091,1026.1363636363646,32.066761363636395,0
947,4,0,0,33,0.0,0.0,1.0,33,800,300,500,0.375,13,3,10,381.14090475873616,0.7004419191919192,0.11380314024515226,0.2257142532114556,131749.0741537854,3442.9922648199276,135192.0664186053,946,9,579.1515151515151,32,1,14,33.557270528430294,0.6468098958333333,43.33964646464647,1026.6414141414148,32.08254419191921,0
948,4,1,0,34,0.029411764705882353,0.0,1.0,34,800,600,200,0.75,10,6,4,369.7784942782999,0.7165404040404041,0.1037701458845961,0.22147118811486188,132177.37956855536,2975.270478902343,135152.65004745772,947,0,563.0882352941177,33,1,16,33.41663190720216,0.6486742424242424,42.92279411764706,1028.3088235294117,31.160873440285204,0
949,4,0,1,33,0.0,0.029411764705882353,0.9705882352941176,34,900,700,200,0.7777777777777778,11,7,4,369.54777083346437,0.7157234105763518,0.10596715750520436,0.22170224736277808,132240.39619677523,2973.828725730484,135214.2249225057,948,1,564.0882352941177,33,1,17,33.35902438540053,0.6493055555555556,42.861519607843135,1028.5539215686272,31.168300653594763,0
950,4,0,0,33,0.0,0.0,1.0,33,600,400,200,0.6666666666666666,8,4,4,379.8221859925181,0.699179292929293,0.11382713016418933,0.22686224623368242,132073.33953486895,3432.8769066932027,135506.21644156217,949,2,581.8484848484849,32,1,17,33.263470908569786,0.6500651041666666,43.0239898989899,1027.9040404040409,32.12200126262628,0
951,4,0,0,33,0.0,0.0,1.0,33,850,600,250,0.7058823529411765,11,6,5,380.4755438453611,0.7012310606060607,0.11452193844138847,0.22783770802033984,132170.69686766661,3457.5435542291702,135628.24042189578,950,3,582.8484848484849,32,1,17,33.14838122134905,0.6510416666666666,42.929292929292934,1028.2828282828289,32.1338383838384,0
952,4,0,0,33,0.0,0.0,1.0,33,650,400,250,0.6153846153846154,9,4,5,376.47243293980677,0.6990214646464648,0.10997754528848214,0.22604503591536024,132271.91014273348,3359.34556420607,135631.25570693956,951,4,583.8484848484849,33,0,18,33.14917401318403,0.6496212121212122,42.830882352941174,1028.6764705882347,31.172014260249536,0
953,4,0,0,33,0.0,0.0,1.0,33,900,800,100,0.8888888888888888,10,8,2,375.5256960792392,0.698626893939394,0.10723887679943411,0.22604224157543895,132366.4745080018,3341.402495434453,135707.87700343624,952,5,584.8484848484849,33,0,18,33.078157873843836,0.6505681818181819,42.7389705882353,1029.0441176470592,31.183155080213915,0
954,4,2,2,33,0.05714285714285714,0.05714285714285714,0.9428571428571428,35,650,500,150,0.7692307692307693,8,5,3,357.8123675143773,0.7204481792717087,0.09414249414249465,0.21785790984103218,132796.49234693873,2503.249219418154,135299.74156635688,953,0,552.3714285714286,34,1,14,33.101370601370604,0.6525735294117647,42.32142857142857,1030.7142857142853,30.315126050420158,0
955,4,0,0,33,0.0,0.0,1.0,33,1250,900,350,0.72,16,9,7,374.3406432079693,0.6988636363636365,0.11071589190073183,0.2259066812786509,132462.98408644527,3317.2557328333846,135780.23981927865,954,7,586.8484848484849,32,1,18,33.01136595936056,0.6539713541666666,42.64520202020202,1029.419191919192,32.16934974747475,0
956,4,0,0,33,0.0,0.0,1.0,33,600,400,200,0.6666666666666666,8,4,4,371.84211087172173,0.6988636363636365,0.0784120734908138,0.21964627014283114,131651.87225793305,3190.7420161208283,134842.6142740539,955,8,587.8484848484849,32,1,13,33.89415190288714,0.6458333333333333,43.43434343434345,1026.2626262626277,32.070707070707115,4
957,4,0,0,33,0.0,0.0,1.0,33,750,600,150,0.8,9,6,3,384.26239618583037,0.6988636363636365,0.055775251276981797,0.22021609843737538,130488.24737271709,3428.345321905933,133916.59269462302,956,9,588.8484848484849,32,1,13,34.75551985500084,0.6341145833333334,44.57070707070707,1021.7171717171718,31.92866161616162,7
958,4,0,0,33,0.0,0.0,1.0,33,750,500,250,0.6666666666666666,10,5,5,384.60686436672944,0.699179292929293,0.06110013175230544,0.22114894701086965,130617.28395061739,3447.2608024691467,134064.54475308655,957,10,589.8484848484849,32,1,13,34.61560235507244,0.6354166666666666,44.44444444444445,1022.2222222222231,31.94444444444447,0
959,4,1,1,33,0.029411764705882353,0.029411764705882353,0.9705882352941176,34,850,400,450,0.47058823529411764,13,4,9,376.39939409286404,0.7078134284016637,0.05796427766508927,0.21831164857386126,130951.55709342571,3058.017349096515,134009.57444252222,958,0,573.4705882352941,33,1,14,34.486250798212005,0.6363636363636362,44.117647058823536,1023.5294117647068,31.01604278074869,0
960,4,0,0,33,0.0,0.0,1.0,33,950,700,250,0.7368421052631579,12,7,5,381.9916085972082,0.6890782828282829,0.07556322973195218,0.22186160189872267,131004.77629833706,3408.545046423854,134413.32134476092,959,1,591.5151515151515,32,1,14,34.28917941128103,0.6393229166666665,44.065656565656575,1023.737373737375,31.99179292929297,0
961,4,0,0,33,0.0,0.0,1.0,33,800,500,300,0.625,11,5,6,383.010990658965,0.6910511363636365,0.07997369826983913,0.2230152293779517,131101.7390604276,3442.6813909295033,134544.4204513571,960,2,592.5151515151515,32,1,15,34.16476595569802,0.6402994791666666,43.9709595959596,1024.1161616161621,32.003630050505066,0
962,4,0,0,33,0.0,0.0,1.0,33,450,200,250,0.4444444444444444,7,2,5,381.6748581982424,0.6903409090909092,0.08185404339250546,0.2224243139155274,131134.06795224975,3410.1153581267185,134544.18331037648,961,3,593.5151515151515,32,1,15,34.16620438856015,0.640625,43.93939393939394,1024.242424242424,32.00757575757575,0
963,4,0,0,33,0.0,0.0,1.0,33,850,700,150,0.8235294117647058,10,7,3,372.6198126929195,0.6908933080808082,0.030951184520038755,0.21094844090003237,130012.5027032872,3089.0468810073103,133101.54958429452,962,4,594.5151515151515,33,0,19,35.536329407994884,0.6268939393939394,45.036764705882355,1019.8529411764706,30.90463458110517,3
964,4,2,1,34,0.05714285714285714,0.02857142857142857,0.9714285714285714,35,600,300,300,0.5,9,3,6,356.65410381343406,0.7169467787114845,0.03215377894276994,0.2046068279771804,130528.56445312488,2310.7096354166533,132839.27408854154,963,0,561.4857142857143,35,0,12,35.41985219164119,0.6276785714285715,44.53124999999999,1021.8749999999991,29.196428571428545,0
965,4,1,1,34,0.02857142857142857,0.02857142857142857,0.9714285714285714,35,800,400,400,0.5,12,4,8,358.4667414933838,0.7207282913165266,0.03190993788819885,0.20611837635869565,130617.28395061726,2364.3904320987626,132981.674382716,964,0,562.4571428571429,35,0,13,35.28362771739132,0.6285714285714286,44.44444444444444,1022.2222222222221,29.206349206349202,0
966,4,2,2,34,0.05555555555555555,0.05555555555555555,0.9444444444444444,36,950,800,150,0.8421052631578947,11,8,3,355.8568257244467,0.7351190476190477,0.014532243415077417,0.20092223852441843,129908.37191358033,2076.620370370378,131984.9922839507,965,0,547.7777777777778,35,1,19,36.069482288828326,0.6214285714285714,45.13888888888889,1019.444444444445,29.126984126984144,8
967,4,0,1,33,0.0,0.029411764705882353,0.9705882352941176,34,1050,700,350,0.6666666666666666,14,7,7,392.9754235794479,0.7109328579916816,0.013589873989941603,0.22354503603617798,130200.04325259537,3440.7994788329547,133640.84273142833,966,3,581.0,33,1,20,34.8262888248479,0.6287878787878787,44.8529411764706,1020.5882352941194,30.92691622103392,4
968,4,1,0,34,0.029411764705882353,0.0,1.0,34,1050,900,150,0.8571428571428571,12,9,3,389.2516705440569,0.7215909090909092,0.029026489488528817,0.22307539079621205,130488.24737271733,3358.5686735015015,133846.81604621882,967,0,581.7352941176471,32,2,17,34.628079172845624,0.6341145833333333,44.57070707070709,1021.7171717171739,31.928661616161683,0
969,4,0,0,34,0.0,0.0,1.0,34,650,500,150,0.7692307692307693,8,5,3,389.6085341199393,0.7208481877599525,0.023743077661012357,0.22365187767140365,130552.75769054191,3372.8937098255433,133925.65140036747,968,1,582.7352941176471,32,2,17,34.55337286879168,0.634765625,44.507575757575765,1021.9696969696979,31.93655303030306,0
970,4,0,0,34,0.0,0.0,1.0,34,1050,700,350,0.6666666666666666,14,7,7,393.41563786008237,0.7218879976232918,0.026361655773420978,0.22697056030389373,130746.38429752068,3487.534435261714,134233.9187327824,969,2,583.7352941176471,32,2,19,34.259259259259274,0.63671875,44.31818181818182,1022.7272727272729,31.960227272727277,0
971,4,0,1,33,0.0,0.029411764705882353,0.9705882352941176,34,950,700,250,0.7368421052631579,12,7,5,394.93099612866104,0.7215909090909092,0.0256363715567689,0.22822617194254008,130810.95838434852,3532.260419855118,134343.21880420364,970,3,584.7352941176471,32,2,19,34.154889739159046,0.6373697916666666,44.255050505050505,1022.9797979797979,31.968118686868685,0
972,4,0,0,33,0.0,0.0,1.0,33,850,500,350,0.5882352941176471,12,5,7,397.80774138853064,0.713147095959596,0.05320285177773365,0.23038843327726333,130894.72664727113,3814.1871134440153,134708.91376071516,971,4,602.4242424242424,31,2,20,33.996188022225034,0.6407930107526882,44.173177083333336,1023.3072916666673,33.00991263440862,0
973,4,0,0,33,0.0,0.0,1.0,33,700,500,200,0.7142857142857143,9,5,4,397.12641128080895,0.7133838383838385,0.026490314502191303,0.2258953400691611,130198.14822785939,3741.0246722273223,133939.1729000867,972,5,603.4242424242424,32,1,20,34.722308136418,0.6311848958333334,44.85479797979798,1020.580808080808,31.89315025252525,2
974,4,1,1,33,0.029411764705882353,0.029411764705882353,0.9705882352941176,34,950,700,250,0.7368421052631579,12,7,5,384.6217251226918,0.7304292929292929,0.02306719574412419,0.22078923710234538,130552.75769054191,3242.7013187429993,133795.4590092849,973,0,586.6470588235294,32,2,17,34.68078206078576,0.634765625,44.507575757575765,1021.9696969696979,31.93655303030306,0
975,4,0,0,33,0.0,0.0,1.0,33,1150,800,350,0.6956521739130435,15,8,7,392.717213223498,0.7116477272727273,0.022943562431882336,0.22487437878211775,130455.99819214888,3646.4632116620887,134102.46140381097,974,7,605.4242424242424,32,1,20,34.572364355456685,0.6337890625,44.602272727272734,1021.5909090909101,31.924715909090942,0
976,4,1,1,33,0.029411764705882353,0.029411764705882353,0.9705882352941176,34,700,500,200,0.7142857142857143,9,5,4,383.4332706101673,0.7281639928698753,0.009559528509390347,0.22095077416928435,130700.81218762022,3223.007977700893,133923.8201653211,975,0,588.5882352941177,33,1,17,34.56076222435283,0.6338383838383839,44.36274509803922,1022.5490196078438,30.98633392751042,0
977,4,0,0,33,0.0,0.0,1.0,33,500,200,300,0.4,8,2,6,391.6032577188383,0.7112531565656566,0.015252600130287064,0.22479693389902686,130552.75769054181,3624.977043158862,134177.73473370066,976,9,607.4242424242424,32,1,17,34.502409191994076,0.634765625,44.50757575757576,1021.9696969696971,31.936553030303035,0
978,4,1,0,34,0.029411764705882353,0.0,1.0,34,800,600,200,0.75,10,6,4,383.4709692452518,0.7241532976827095,0.02872867092485265,0.22259437151532951,130982.91710219638,3245.6292351499565,134228.54633734634,977,0,590.5294117647059,33,1,18,34.27348956462747,0.6366792929292928,44.087009803921575,1023.6519607843146,31.019756387403472,0
979,4,0,0,34,0.0,0.0,1.0,34,650,400,250,0.6153846153846154,9,4,5,383.4709692452518,0.7241532976827095,0.02872867092485265,0.22259437151532951,130982.91710219638,3245.6292351499565,134228.54633734634,978,1,591.5294117647059,33,1,18,34.27348956462747,0.6366792929292928,44.087009803921575,1023.6519607843146,31.019756387403472,0
980,4,1,0,35,0.02857142857142857,0.0,1.0,35,750,400,350,0.5333333333333333,11,4,7,374.28926234435704,0.7372549019607842,0.03278677642060557,0.21887785124050435,131267.1201814059,2826.3747165532905,134093.49489795917,979,0,575.6,34,1,20,34.22058937422554,0.6372549019607843,43.80952380952381,1024.7619047619046,30.14005602240896,0
981,4,0,0,35,0.0,0.0,1.0,35,500,200,300,0.4,8,2,6,372.7939718421572,0.7370448179271708,0.03321718931475015,0.2183507549361208,131328.12500000015,2791.6666666666815,134119.79166666683,980,1,576.6,34,1,21,34.197154471544714,0.6378676470588235,43.75000000000001,1025.0000000000011,30.147058823529445,0
982,4,0,1,34,0.0,0.02857142857142857,0.9714285714285714,35,900,700,200,0.7777777777777778,11,7,4,370.42343852409346,0.7357142857142857,0.03851268160551635,0.21769747957255325,131457.5760764207,2738.993470054069,134196.56954647476,981,2,577.6,32,3,22,34.12695969793975,0.6438802083333334,43.62373737373737,1025.50505050505,32.04703282828281,0
983,4,0,0,34,0.0,0.0,1.0,34,950,800,150,0.8421052631578947,11,8,3,380.72575847709686,0.7236333927510399,0.042563366810138836,0.2229965156794426,131328.12500000012,3200.0000000000146,134528.12500000012,982,3,595.0588235294117,33,1,22,33.99390243902439,0.6401515151515151,43.75000000000001,1025.000000000001,31.060606060606087,0
984,4,0,0,34,0.0,0.0,1.0,34,800,500,300,0.625,11,5,6,382.69947507636965,0.722519310754605,0.04949274604431575,0.2245436413376552,131394.8652479383,3256.9491916232546,134651.81443956154,983,4,596.0588235294117,31,3,22,33.8757302514605,0.6458333333333334,43.68489583333333,1025.260416666666,33.07291666666665,0
985,4,0,0,34,0.0,0.0,1.0,34,800,600,200,0.75,10,6,4,382.8832704583949,0.7219251336898396,0.0463763570927227,0.22543754892909082,131528.39660644534,3272.0045301649307,134800.40113661028,984,5,597.0588235294117,31,3,22,33.73582550562748,0.6471774193548387,43.5546875,1025.7812500000002,33.089717741935495,0
986,4,0,0,34,0.0,0.0,1.0,34,1200,1000,200,0.8333333333333334,14,10,4,385.5337427255007,0.7215537730243613,0.04923354777079614,0.22779437482476733,131661.99578179244,3352.0284016927035,135014.02418348513,985,6,598.0588235294117,31,3,19,33.532627082804716,0.648521505376344,43.424479166666664,1026.3020833333328,33.10651881720428,0
987,4,0,0,34,0.0,0.0,1.0,34,900,600,300,0.6666666666666666,12,6,6,381.42246258485983,0.7204396910279264,0.05447479524399168,0.226157709770241,131795.6627739801,3253.965250651046,135049.62802463112,986,7,599.0588235294117,31,3,20,33.50293769549413,0.6498655913978495,43.294270833333336,1026.822916666667,33.12331989247313,0
988,4,0,0,34,0.0,0.0,1.0,34,850,700,150,0.8235294117647058,10,7,3,382.3876711012533,0.7209224598930482,0.056009452317233865,0.22772989529509377,131962.84188164613,3292.1927558051307,135255.03463745126,987,8,600.0588235294117,31,3,21,33.30917606555991,0.6515456989247311,43.13151041666667,1027.4739583333342,33.144321236559165,0
989,4,0,0,34,0.0,0.0,1.0,34,800,600,200,0.75,10,6,4,383.0089379455906,0.7208110516934046,0.059941564055932206,0.2283010980563897,131996.2904188367,3311.1518012152687,135307.44222005198,988,9,601.0588235294117,31,3,21,33.25941882074676,0.6518817204301076,43.09895833333333,1027.6041666666658,33.148521505376316,0
990,4,0,0,34,0.0,0.0,1.0,34,850,700,150,0.8235294117647058,10,7,3,377.17274928682804,0.7189542483660131,0.0637403897729305,0.2256178809370299,132130.126953125,3167.176649305555,135297.30360243056,989,10,602.0588235294117,31,3,21,33.274231678487006,0.6532258064516129,42.96875,1028.125,33.16532258064516,0
991,4,0,0,34,0.0,0.0,1.0,34,700,400,300,0.5714285714285714,10,4,6,377.5200854173021,0.7191770647653001,0.0632150699179479,0.2260679099734197,132170.6968676666,3179.4185542291702,135350.11542189575,990,11,603.0588235294117,32,2,21,33.224357400130984,0.6510416666666666,42.929292929292934,1028.2828282828286,32.133838383838395,0
992,4,0,0,34,0.0,0.0,1.0,34,500,300,200,0.6,7,3,4,378.12409410892997,0.7196226975638741,0.06056382778989322,0.2268187680862551,132235.6216840119,3200.294931639635,135435.9166156515,991,12,604.0588235294117,32,2,21,33.14331164579753,0.6516927083333333,42.86616161616162,1028.5353535353538,32.14172979797981,0
993,4,0,0,34,0.0,0.0,1.0,34,1100,700,400,0.6363636363636364,15,7,8,375.5230887641087,0.7208853238265004,0.06302721183756965,0.22585185195296997,132334.949298347,3138.9657823914085,135473.9150807384,992,13,605.0588235294117,33,1,21,33.110012704462434,0.6502525252525252,42.769607843137265,1028.9215686274524,31.179441473559166,0
994,4,0,0,34,0.0,0.0,1.0,34,1150,700,450,0.6086956521739131,16,7,9,376.1740071137045,0.7212566844919787,0.06108597285067896,0.22662190184654887,132398.00347222228,3160.9675365244175,135558.97100874668,993,14,606.0588235294117,31,3,21,33.029689608636986,0.6559139784946236,42.708333333333336,1029.166666666667,33.19892473118281,0
995,4,0,0,34,0.0,0.0,1.0,34,1000,800,200,0.8,12,8,4,373.1980034312867,0.7215537730243613,0.059649409979018575,0.22522926833036264,132465.01498752163,3087.1358235677026,135552.15081108932,994,15,607.0588235294117,31,3,21,33.03872586221435,0.6565860215053764,42.643229166666664,1029.4270833333328,33.207325268817186,0
996,4,0,0,34,0.0,0.0,1.0,34,650,500,150,0.7692307692307693,8,5,3,374.5537273053238,0.7211452762923352,0.05832893278692186,0.22665228992026076,132565.56404961488,3130.5852254231863,135696.14927503807,995,16,608.0588235294117,31,3,22,32.90252138913474,0.6575940860215054,42.54557291666667,1029.8177083333342,33.219926075268845,0
997,4,0,0,34,0.0,0.0,1.0,34,300,200,100,0.6666666666666666,4,2,2,374.5537273053238,0.7211452762923352,0.05832893278692186,0.22665228992026076,132565.56404961488,3130.5852254231863,135696.14927503807,996,17,609.0588235294117,31,3,22,32.90252138913474,0.6575940860215054,42.54557291666667,1029.8177083333342,33.219926075268845,0
998,4,0,0,34,0.0,0.0,1.0,34,850,400,450,0.47058823529411764,13,4,9,375.95696366782,0.7212938205585265,0.06273788927335655,0.2282595850840337,132690.54178145094,3177.186639118467,135867.72842056942,997,18,610.0588235294117,32,2,19,32.740502450980394,0.65625,42.42424242424243,1030.303030303031,32.19696969696972,0
999,4,0,0,34,0.0,0.0,1.0,34,1000,800,200,0.8,12,8,4,378.20188255923364,0.7223707664884136,0.06420878210439152,0.23062123757252764,132853.20255905023,3249.0662623712087,136102.26882142143,998,19,611.0588235294117,32,2,19,32.51888140436825,0.6578776041666665,42.26641414141415,1030.9343434343446,32.21669823232327,0
1000,4,1,0,35,0.02857142857142857,0.0,1.0,35,550,400,150,0.7272727272727273,7,4,3,368.65848955260674,0.7309523809523809,0.05797710894446806,0.2272090544609153,133250.7047319541,2824.80070766052,136075.50543961462,999,0,594.5714285714286,33,2,21,32.36535608308605,0.6594065656565655,41.881127450980394,1032.4754901960787,31.287136066547838,0
1001,4,1,0,36,0.027777777777777776,0.0,1.0,36,400,300,100,0.75,5,3,2,359.6514047866802,0.7430886243386244,0.05667562724014297,0.22298387096774194,133472.22222222234,2400.694444444454,135872.9166666668,1000,0,579.0277777777778,34,2,22,32.375672043010745,0.6593137254901961,41.66666666666667,1033.3333333333344,30.39215686274513,0
1002,4,0,0,36,0.0,0.0,1.0,36,800,500,300,0.625,11,5,6,358.9449504526462,0.7436838624338625,0.05909282533660054,0.22292648837390425,133535.54672481745,2386.3820405613305,135921.92876537878,1001,1,580.0277777777778,33,3,22,32.330448185914165,0.6622474747474747,41.60539215686275,1033.5784313725496,31.320558526440898,0
1003,4,0,2,34,0.0,0.05555555555555555,0.9444444444444444,36,1050,600,450,0.5714285714285714,15,6,9,358.97824765295223,0.7437169312169313,-0.0025631167499677865,0.2207334331312834,133164.85969387757,2360.6575963718838,135525.51729024947,1002,2,581.0277777777778,34,2,16,32.70136485966936,0.65625,41.964285714285715,1032.1428571428573,30.35714285714286,6
1004,4,0,0,34,0.0,0.0,1.0,34,800,600,200,0.75,10,6,4,371.7441834741523,0.7253045157456922,0.026726514862462025,0.22787109701180033,133048.5270157382,3092.0032075808554,136140.53022331905,1003,24,616.0588235294117,32,2,18,32.48888344959816,0.6598307291666667,42.0770202020202,1031.6919191919192,32.240372474747474,0
1005,4,0,0,34,0.0,0.0,1.0,34,750,700,50,0.9333333333333333,8,7,1,372.1336440134439,0.7245246583481878,0.019473509981433157,0.22870830121548055,133146.24304917868,3109.639322518109,136255.8823716968,1004,25,617.0588235294117,32,2,18,32.380617404779386,0.6608072916666667,41.98232323232323,1032.0707070707072,32.2522095959596,0
1006,4,0,0,34,0.0,0.0,1.0,34,850,700,150,0.8235294117647058,10,7,3,370.8307381533541,0.7236705288175876,0.02338909875876971,0.22810694389794353,133178.8230314509,3077.360250229572,136256.18328168048,1005,26,618.0588235294117,32,2,18,32.381498470948,0.6611328125,41.95075757575758,1032.19696969697,32.25615530303031,0
1007,4,0,0,34,0.0,0.0,1.0,34,700,400,300,0.5714285714285714,10,4,6,370.1699236177865,0.7234477124183007,0.02184298376885052,0.22789979634781787,133211.40699928574,3062.171270788692,136273.57827007445,1006,27,619.0588235294117,32,2,18,32.36581661774299,0.6614583333333334,41.91919191919192,1032.3232323232319,32.260101010100996,0
1008,4,0,0,34,0.0,0.0,1.0,34,750,600,150,0.8,9,6,3,370.03813695120607,0.7223336304218657,0.02641020808465777,0.22844772015295323,133313.97667063138,3066.2511113513888,136380.22778198277,1007,28,620.0588235294117,33,1,18,32.26620287963293,0.6600378787878789,41.819852941176464,1032.7205882352932,31.29456327985737,0
1009,4,0,0,34,0.0,0.0,1.0,34,350,200,150,0.5714285714285714,5,2,3,369.0852175574042,0.7229649435531789,0.023451240961501085,0.22805353471948686,133345.6182718184,3043.179306036125,136388.79757785454,1008,29,621.0588235294117,33,1,18,32.25903733586457,0.6603535353535355,41.7892156862745,1032.843137254901,31.298276886512152,0
1010,4,0,0,34,0.0,0.0,1.0,34,1300,1100,200,0.8461538461538461,15,11,4,368.4468368756369,0.7235219845513964,0.024304562294613197,0.2282421220939377,133440.56560277284,3033.1508614475015,136473.71646422034,1009,30,622.0588235294117,33,1,19,32.18022278891392,0.6613005050505052,41.69730392156862,1033.2107843137244,31.309417706476495,0
1011,4,0,0,34,0.0,0.0,1.0,34,550,400,150,0.7272727272727273,7,4,3,368.006197549117,0.7234477124183007,0.021937547163031423,0.22836472531762875,133504.84206012142,3026.1256107536965,136530.9676708751,1010,31,623.0588235294117,32,2,20,32.12711260435757,0.6643880208333334,41.63510101010101,1033.459595959596,32.29561237373738,0
1012,4,1,1,34,0.02857142857142857,0.02857142857142857,0.9714285714285714,35,700,500,200,0.7142857142857143,9,5,4,358.2163473417039,0.7357142857142857,0.018361543669600522,0.2236202641689334,133725.6103421761,2580.539936562862,136306.15027873896,1011,0,606.2285714285714,33,2,15,32.15886650868878,0.6641414141414141,41.42156862745098,1034.3137254901962,31.342840166369584,0
1013,4,0,0,34,0.0,0.0,1.0,34,400,300,100,0.75,5,3,2,367.2460994079206,0.7241532976827095,0.02442477113005026,0.2280938216808222,133537.46588358324,3008.222694112837,136545.68857769607,1012,33,625.0588235294117,32,2,20,32.11402597931428,0.6647135416666667,41.60353535353535,1033.585858585858,32.29955808080806,0
1014,4,0,0,34,0.0,0.0,1.0,34,900,500,400,0.5555555555555556,13,5,8,368.00440097143417,0.7245246583481878,0.027731092436975135,0.22937260608493487,133668.0010330578,3038.082529843892,136706.0835629017,1013,34,626.0588235294117,32,2,20,31.963522588522597,0.666015625,41.47727272727273,1034.0909090909088,32.3153409090909,0
1015,4,0,0,34,0.0,0.0,1.0,34,900,400,500,0.4444444444444444,14,4,10,367.9502239117319,0.7231877599524659,0.02724375080762087,0.23015146066662062,133798.5999515355,3046.244962248741,136844.84491378424,1014,35,627.0588235294117,32,2,16,31.83401472622243,0.6673177083333334,41.3510101010101,1034.5959595959591,32.33112373737372,0
1016,4,0,0,34,0.0,0.0,1.0,34,1100,1000,100,0.9090909090909091,12,10,2,368.0581623362878,0.7238562091503269,0.02723045793091594,0.2310368158371275,133929.2626390164,3058.7516579940802,136988.0142970105,1015,36,628.0588235294117,32,2,16,31.70031308449216,0.6686197916666667,41.224747474747474,1035.10101010101,32.34690656565656,0
1017,4,0,0,34,0.0,0.0,1.0,34,900,600,300,0.6666666666666666,12,6,6,369.2990112319386,0.723373440285205,0.02816386247256819,0.232641358688507,134059.98909550047,3101.6442837465625,137161.63337924704,1016,37,629.0588235294117,32,2,16,31.537277493294333,0.669921875,41.09848484848485,1035.6060606060607,32.3626893939394,0
1018,4,0,0,34,0.0,0.0,1.0,34,450,200,250,0.4444444444444444,7,2,5,369.7174884445321,0.724264705882353,0.02685234971502326,0.23352825193898286,134158.07578627186,3120.1173668503293,137278.19315312218,1017,38,630.0588235294117,32,2,16,31.428244972577698,0.6708984375,41.00378787878788,1035.984848484849,32.37452651515153,0
1019,4,0,0,34,0.0,0.0,1.0,34,850,500,350,0.5882352941176471,12,5,7,368.75993887240384,0.7232248960190137,0.026609279022928423,0.23333946170592285,134223.48684126625,3099.248960565253,137322.7358018315,1018,39,631.0588235294117,32,2,17,31.3875858007392,0.6715494791666666,40.94065656565657,1036.2373737373741,32.38241792929294,0
1020,4,0,0,34,0.0,0.0,1.0,34,1100,900,200,0.8181818181818182,13,9,4,382.8746226312223,0.722296494355318,0.0181596072952237,0.2244506257614008,131361.49300469286,3259.394968758913,134620.88797345178,1019,40,632.0588235294117,31,3,21,33.90503937507939,0.645497311827957,43.717447916666664,1025.130208333333,33.06871639784945,8
1021,4,1,2,33,0.02857142857142857,0.05714285714285714,0.9428571428571428,35,750,400,350,0.5333333333333333,11,4,7,375.46857320277144,0.7369047619047618,0.008338020247469213,0.2217884130081486,131651.87225793273,2886.2281272318974,134538.10038516464,1020,0,614.9714285714285,32,3,16,33.8011093339895,0.6458333333333335,43.434343434343425,1026.2626262626252,32.07070707070704,0
1022,4,0,2,31,0.0,0.06060606060606061,0.9393939393939394,33,650,500,150,0.7692307692307693,8,5,3,384.2032220094705,0.7038352272727273,0.04017324809404044,0.22621472219660735,131528.39660644517,3506.7267523871396,135035.1233588323,1021,42,651.6363636363636,31,2,21,33.70197596682746,0.6471774193548387,43.55468749999999,1025.7812499999989,33.089717741935445,0
1023,4,0,0,31,0.0,0.0,1.0,31,700,500,200,0.7142857142857143,9,5,4,395.7453694175051,0.6885304659498208,0.06455980955293006,0.23287486479269098,131506.13667052455,4208.588927469114,135714.72559799365,1022,45,672.8064516129032,29,2,21,33.428543218235156,0.6526580459770116,43.57638888888888,1025.6944444444432,35.36877394636011,0
1024,4,0,0,31,0.0,0.0,1.0,31,850,600,250,0.7058823529411765,11,6,5,397.2503139665542,0.6908602150537635,0.07894046682402323,0.23267518389469613,131328.12500000012,4234.027777777792,135562.1527777779,1023,46,673.8064516129032,31,0,18,33.57046070460704,0.6451612903225805,43.75000000000001,1025.000000000001,33.064516129032285,2
1025,4,0,0,31,0.0,0.0,1.0,31,950,800,150,0.8421052631578947,11,8,3,393.8935049997545,0.6898745519713262,0.07451777765565737,0.2317502958098015,131500.39247673136,4159.430100300606,135659.82257703197,1024,47,674.8064516129032,30,1,19,33.48185034726773,0.6496527777777779,43.581989247311824,1025.672043010752,34.189068100358405,0
1026,4,0,0,31,0.0,0.0,1.0,31,900,700,200,0.7777777777777778,11,7,4,393.5978650075694,0.6902329749103943,0.07060175891608145,0.23199478792299427,131569.3310823505,4157.0815628974315,135726.4126452479,1025,48,675.8064516129032,30,1,16,33.419581641119684,0.6503472222222222,43.51478494623655,1025.9408602150531,34.198028673835104,0
1027,4,1,1,31,0.03125,0.03125,0.96875,32,300,200,100,0.6666666666666666,4,2,2,383.069056139771,0.7090893817204301,0.0638235480598528,0.22713402832467927,131795.6627739801,3697.3680284288234,135493.0308024089,1026,0,655.65625,31,1,16,33.46066869557866,0.6498655913978495,43.294270833333336,1026.822916666667,33.12331989247313,0
1028,4,0,0,31,0.0,0.0,1.0,31,650,500,150,0.7692307692307693,8,5,3,387.8642309755014,0.6899641577060932,0.07095284977951355,0.21329797412884077,128870.65463595928,3796.8634711371637,132667.51810709643,1027,50,677.8064516129032,31,0,21,36.31326408480806,0.6202956989247311,46.15885416666667,1015.3645833333339,32.75369623655916,8
1029,4,1,0,32,0.03125,0.0,1.0,32,600,400,200,0.6666666666666666,8,4,4,378.3542301608736,0.7072412634408602,0.06584627329192583,0.20947397199415624,129137.2133583307,3371.9221890623344,132509.13554739303,1028,0,657.59375,32,0,22,36.28234989648035,0.6204427083333334,45.89646464646464,1016.4141414141408,31.7629419191919,0
1030,4,1,1,32,0.030303030303030304,0.030303030303030304,0.9696969696969697,33,600,400,200,0.6666666666666666,8,4,4,371.22255749995907,0.7172506313131314,0.05663534463633768,0.20703685750118825,129426.12879106724,3009.1956496786042,132435.32444074584,1029,0,638.6363636363636,32,1,20,36.168931215618144,0.6233723958333334,45.61237373737374,1017.5505050505051,31.798453282828284,0
1031,4,1,1,32,0.030303030303030304,0.030303030303030304,0.9696969696969697,33,1050,600,450,0.5714285714285714,15,6,9,370.18576709017,0.7196969696969697,0.060358136966541576,0.20781409764205985,129683.21352731863,3001.3759756657496,132684.58950298437,1030,0,639.6060606060606,32,1,20,35.933432502789145,0.6259765625,45.359848484848484,1018.560606060606,31.830018939393938,0
1032,4,3,4,31,0.08571428571428572,0.11428571428571428,0.8857142857142857,35,1050,900,150,0.8571428571428571,12,9,3,351.8079539899983,0.7405462184873949,0.04224037339556652,0.19966848779432347,130110.72137188204,2154.797335600908,132265.51870748296,1031,0,603.9714285714285,34,1,20,35.96727926876702,0.6256127450980392,44.94047619047619,1020.238095238095,30.00700280112044,0
1033,4,0,0,31,0.0,0.0,1.0,31,1250,900,350,0.72,16,9,7,398.7177753819056,0.6861111111111111,0.0471780272051705,0.21663764757719778,128390.74315200625,4081.294190129768,132472.03734213603,1032,55,682.8064516129032,29,2,21,36.52970969804942,0.6210488505747126,46.63194444444445,1013.4722222222229,34.94731800766286,5
1034,4,1,1,31,0.03125,0.03125,0.96875,32,950,600,350,0.631578947368421,13,6,7,388.4057716766813,0.7048891129032259,0.0438410596026495,0.21280577475754292,128723.560888542,3599.3947999768793,132322.95568851888,1033,0,662.4375,30,2,21,36.45005518763797,0.6215277777777778,46.303763440860216,1014.7849462365589,33.826164874551964,0
1035,4,1,0,32,0.03125,0.0,1.0,32,600,400,200,0.6666666666666666,8,4,4,386.7953982246715,0.7073672715053764,0.049769131470938976,0.21247022856661416,128825.87808200372,3565.851362874322,132391.72944487803,1034,0,663.40625,30,2,23,36.38620415728852,0.6225694444444445,46.20295698924731,1015.1881720430108,33.83960573476703,0
1036,4,2,0,34,0.058823529411764705,0.0,1.0,34,500,300,200,0.6,7,3,4,366.31572994523856,0.7395276292335117,0.03876308527878769,0.20413362046325975,129394.01113406816,2679.812327823715,132073.82346189188,1035,0,625.3235294117648,32,2,25,36.32647679324894,0.623046875,45.643939393939405,1017.4242424242441,31.794507575757628,0
1037,4,0,0,34,0.0,0.0,1.0,34,850,500,350,0.5882352941176471,12,5,7,385.67812795315945,0.7415701128936424,0.05790110388628511,0.2089537489885501,128276.40109592007,3143.499604532537,131419.9007004526,1036,1,626.3235294117648,31,3,23,36.97729220222794,0.614247311827957,46.744791666666664,1013.0208333333327,32.67809139784944,7
1038,4,0,0,34,0.0,0.0,1.0,34,650,400,250,0.6153846153846154,9,4,5,385.67812795315945,0.7417557932263815,0.05790110388628511,0.2089537489885501,128276.40109592007,3094.680447048606,131371.08154296866,1037,2,627.3235294117648,31,3,23,36.97729220222794,0.614247311827957,46.744791666666664,1013.0208333333327,32.67809139784944,0
1039,4,0,0,34,0.0,0.0,1.0,34,900,500,400,0.5555555555555556,13,5,8,383.4686336429161,0.7426841948900773,0.05401165735539837,0.2079281838589219,128309.3791537814,3040.5244615342776,131349.90361531568,1038,3,628.3235294117648,31,3,23,36.999448442787994,0.6145833333333334,46.71223958333333,1013.1510416666661,32.68229166666665,0
1040,4,2,2,34,0.05555555555555555,0.05555555555555555,0.9444444444444444,36,1200,700,500,0.5833333333333334,17,7,10,358.8855965937196,0.7672288359788361,0.04732932276000379,0.19795544898087958,128989.67013888873,2058.5069444444257,131048.17708333315,1039,0,594.3611111111111,34,2,22,36.92746786983867,0.6142769607843138,46.04166666666666,1015.833333333332,29.87745098039212,0
1041,4,0,0,34,0.0,0.0,1.0,34,850,600,250,0.7058823529411765,11,6,5,378.2882109771979,0.7385992275698159,0.06381880859846722,0.2072462407378145,128720.4610020661,2938.6865817263506,131659.14758379245,1040,1,630.2058823529412,32,2,22,36.709904193106865,0.6162109375,46.30681818181818,1014.7727272727273,31.711647727272727,0
1042,4,2,1,35,0.05555555555555555,0.027777777777777776,0.9722222222222222,36,950,500,450,0.5263157894736842,14,5,9,362.15622206339975,0.7583333333333334,0.07049222034760705,0.20114941972437045,129263.6921496541,2163.6268313840046,131427.31898103812,1041,0,596.1388888888889,33,3,23,36.565035751586734,0.6193181818181817,45.77205882352942,1016.9117647058833,30.815508021390404,0
1043,4,0,0,35,0.0,0.0,1.0,35,1100,900,200,0.8181818181818182,13,9,4,349.77460087645346,0.7525910364145658,0.04187746746600407,0.19527416288931135,129466.28146701382,2056.8033854166606,131523.08485243047,1042,1,614.1714285714286,35,0,17,36.673703514158994,0.6169642857142856,45.572916666666664,1017.7083333333327,29.077380952380935,6
1044,4,0,1,34,0.0,0.02857142857142857,0.9714285714285714,35,700,600,100,0.8571428571428571,8,6,2,351.9707271133413,0.7533613445378151,0.040459949327616984,0.19694239921685436,129554.6392746914,2119.8881172839574,131674.52739197537,1043,2,615.1714285714286,35,0,17,36.52796725784447,0.6178571428571428,45.486111111111114,1018.055555555556,29.0873015873016,0
1045,4,2,1,35,0.05555555555555555,0.027777777777777776,0.9722222222222222,36,300,200,100,0.6666666666666666,4,2,2,344.41409920808593,0.7553240740740741,0.047579150247364366,0.19422380136650375,129860.5420242878,1745.160320793773,131605.70234508158,1044,0,598.9166666666666,36,0,18,36.409650867307505,0.6189236111111112,45.185810810810814,1019.2567567567568,28.31268768768769,0
1046,4,1,1,35,0.027777777777777776,0.027777777777777776,0.9722222222222222,36,600,500,100,0.8333333333333334,7,5,2,342.41730909752727,0.7588293650793652,0.0475686390024177,0.19338140357204697,129917.93894823876,1697.2302116305468,131615.1691598693,1045,0,599.8888888888889,36,0,18,36.4022975809124,0.6195023148148149,45.1295045045045,1019.4819819819818,28.31894394394394,0
1047,4,0,0,35,0.0,0.0,1.0,35,1100,900,200,0.8181818181818182,13,9,4,357.9846291883363,0.7491596638655462,0.07499665283170454,0.19791170950463993,129080.3854875284,2242.2153244667797,131322.6008119952,1046,2,618.0285714285715,34,1,20,36.857866682286776,0.6151960784313726,45.952380952380956,1016.1904761904767,29.887955182072844,6
1048,4,1,1,35,0.027777777777777776,0.027777777777777776,0.9722222222222222,36,1000,600,400,0.6,14,6,8,348.7166178024919,0.7638227513227513,0.06626682270333539,0.19412270352588218,129352.72285997722,1821.5454931972654,131174.2683531745,1047,0,601.8333333333334,34,2,20,36.8161205383265,0.617953431372549,45.6845238095238,1017.2619047619039,29.919467787114822,0
1049,4,0,0,35,0.0,0.0,1.0,35,450,200,250,0.4444444444444444,7,2,5,357.7667293738242,0.747689075630252,0.07540983606557394,0.1983979135618479,129201.38888888882,2244.791666666657,131446.18055555547,1048,4,620.0285714285715,33,2,20,36.74009562841529,0.6186868686868687,45.83333333333333,1016.6666666666661,30.80808080808079,0
1050,4,0,0,35,0.0,0.0,1.0,35,950,600,350,0.631578947368421,13,6,7,359.80583705279156,0.7461484593837534,0.08226422890197305,0.19984396491727327,129263.69214965389,2301.9661908881076,131565.658340542,1049,5,621.0285714285715,33,2,20,36.624789105808645,0.6193181818181819,45.772058823529406,1016.9117647058815,30.81550802139035,0
1051,4,0,0,35,0.0,0.0,1.0,35,700,300,400,0.42857142857142855,11,3,8,357.7181351000456,0.7439775910364145,0.08051760333138325,0.19931382265775682,129388.34372597066,2256.9114042675724,131645.25513023822,1050,6,622.0285714285715,33,2,21,36.55093150244921,0.6205808080808082,45.64950980392156,1017.4019607843127,30.830362448009474,0
1052,4,0,0,35,0.0,0.0,1.0,35,850,500,350,0.5882352941176471,12,5,7,359.56796153278816,0.7422268907563024,0.08950202115765094,0.20082124549628774,129481.87183114635,2311.5065419549824,131793.37837310132,1051,7,623.0285714285715,33,2,17,36.40866445916117,0.6215277777777779,45.55759803921567,1017.7696078431346,30.841503267973778,0
1053,4,0,0,35,0.0,0.0,1.0,35,600,300,300,0.5,9,3,6,360.16366284350323,0.7419467787114845,0.08976643390320294,0.20131355205774779,129513.05537533615,2329.1792820068845,131842.23465734304,1052,8,624.0285714285715,33,2,17,36.36176659442972,0.6218434343434345,45.52696078431371,1017.8921568627429,30.845216874628573,0
1054,4,4,3,36,0.10256410256410256,0.07692307692307693,0.9230769230769231,39,1200,900,300,0.75,15,9,6,327.57311262266626,0.7873369320737742,0.08017226187329274,0.18690936426116816,130318.55955678648,737.7712373037563,131056.33079409023,1053,0,560.9230769230769,37,2,18,36.375107388316145,0.6216216216216217,44.73684210526314,1021.0526315789456,27.596017069701233,0
1055,4,0,0,36,0.0,0.0,1.0,36,700,600,100,0.8571428571428571,8,6,2,353.5181046707602,0.7506613756613757,0.09498940357251007,0.1996017606371829,129908.3719135802,1984.9922839506112,131893.3641975308,1054,1,608.6666666666666,35,1,18,36.12908719346049,0.6214285714285714,45.138888888888886,1019.444444444444,29.126984126984116,0
1056,4,2,2,36,0.05263157894736842,0.05263157894736842,0.9473684210526316,38,700,400,300,0.5714285714285714,10,4,6,340.96885775444815,0.763780227596017,0.09282497155990987,0.19470438300487009,130348.82010388775,1289.4599131789546,131638.2800170667,1055,0,577.578947368421,36,2,19,36.00251801205704,0.6238425925925926,44.70720720720721,1021.1711711711717,28.36586586586588,0
1057,4,1,0,37,0.02702702702702703,0.0,1.0,37,1000,800,200,0.8,12,8,4,349.5018078707865,0.7578203203203203,0.10348768448757117,0.19928606640130606,130292.12648158851,1707.4667513288598,131999.59323291737,1056,0,593.7837837837837,35,2,20,35.84214280315913,0.6252976190476192,44.762731481481474,1020.9490740740729,29.169973544973512,0
1058,4,0,0,37,0.0,0.0,1.0,37,700,500,200,0.7142857142857143,9,5,4,348.8877692011155,0.757007007007007,0.1074955281664256,0.19939026395276183,130380.76560356651,1697.6508916323696,132078.41649519888,1057,1,594.7837837837837,35,2,20,35.767981263221515,0.6261904761904762,44.675925925925924,1021.2962962962962,29.179894179894177,0
1059,4,0,0,37,0.0,0.0,1.0,37,1150,1000,150,0.8695652173913043,13,10,3,348.33143673410433,0.7577577577577578,0.1046412985223184,0.19922390986250604,130410.31867551857,1685.2027338391486,132095.52140935772,1058,2,595.7837837837837,35,2,20,35.75224268177525,0.6264880952380952,44.64699074074073,1021.4120370370362,29.183201058201032,0
1060,4,1,0,38,0.02631578947368421,0.0,1.0,38,800,600,200,0.75,10,6,4,342.1024274861603,0.7697664770033191,0.11209454504428296,0.19775809469924854,130822.8553497228,1350.9632771621823,132173.81862688498,1059,0,581.078947368421,37,1,15,35.493926402286526,0.6266891891891893,44.24342105263157,1023.026315789472,27.649359886201946,0
1061,4,0,2,36,0.0,0.05263157894736842,0.9473684210526316,38,850,500,350,0.5882352941176471,12,5,7,338.70486879330053,0.769203413940256,0.10841834576798792,0.1962217591836047,130906.99932912036,1267.7676063788704,132174.76693549924,1060,1,582.078947368421,37,1,15,35.495798957105606,0.6275337837837839,44.16118421052631,1023.3552631578935,27.658250355618744,0
1062,4,0,0,36,0.0,0.0,1.0,36,1150,1000,150,0.8695652173913043,13,10,3,356.1407136105864,0.7532738095238096,0.1175271739130439,0.20478091032608692,130617.2839506171,2103.6265432098585,132720.91049382696,1061,2,615.1666666666666,35,1,16,35.34307065217392,0.6285714285714286,44.444444444444436,1022.2222222222207,29.206349206349163,0
1063,4,0,0,36,0.0,0.0,1.0,36,1200,1100,100,0.9166666666666666,13,11,2,357.1906534168388,0.7537367724867725,0.11940608255980667,0.20569897211762422,130676.4470271777,2135.281099965711,132811.7281271434,1062,3,616.1666666666666,35,1,16,35.25630141121425,0.6291666666666667,44.386574074074076,1022.4537037037042,29.212962962962976,0
1064,4,0,1,35,0.0,0.027777777777777776,0.9722222222222222,36,850,400,450,0.47058823529411764,13,4,9,358.19477266780683,0.7535714285714287,0.1146410923767498,0.20675161372079726,130765.21675936629,2167.883417995529,132933.1001773618,1063,4,617.1666666666666,35,1,16,35.140719889857046,0.6300595238095239,44.29976851851851,1022.8009259259248,29.222883597883566,0
1065,4,0,0,35,0.0,0.0,1.0,35,550,300,250,0.5454545454545454,8,3,5,366.61469833238374,0.7460084033613444,0.11709394599810308,0.21085870157938238,130627.42524092973,2577.986819727893,133205.41206065763,1064,5,635.5142857142857,34,1,18,35.06511781374946,0.6308210784313726,44.43452380952381,1022.2619047619049,30.066526610644264,0
1066,4,1,0,36,0.027777777777777776,0.0,1.0,36,950,600,350,0.631578947368421,13,6,7,358.94878439651836,0.757936507936508,0.12276188322213422,0.2081432196995679,130942.84664619765,2200.355125814466,133143.2017720121,1065,0,618.8333333333334,35,1,20,34.9415969316597,0.6318452380952382,44.126157407407405,1023.4953703703699,29.242724867724853,0
1067,4,0,0,36,0.0,0.0,1.0,36,900,600,300,0.6666666666666666,12,6,6,360.91686855588745,0.7571428571428572,0.1253814852492372,0.20992975253872037,131061.33355034729,2260.44921875001,133321.7827690973,1066,1,619.8333333333334,35,1,20,34.77132078670736,0.6330357142857143,44.01041666666667,1023.9583333333339,29.255952380952397,0
1068,4,2,3,35,0.05263157894736842,0.07894736842105263,0.9210526315789473,38,900,500,400,0.5555555555555556,13,5,8,334.8882838096279,0.7718409198672357,0.06508662244621077,0.198387035964417,131761.3363997444,1225.3368312358093,132986.67323098023,1067,0,588.1578947368421,36,2,15,34.73204818836606,0.6380208333333333,43.32770270270271,1026.6891891891898,28.519144144144164,4
1069,4,0,0,35,0.0,0.0,1.0,35,750,300,450,0.4,12,3,9,356.96257573796197,0.7430672268907562,0.0794604537093806,0.20875473220501425,131268.81456832998,2371.6108324760016,133640.42540080598,1068,9,639.5142857142857,35,0,18,34.66277012273172,0.6351190476190476,43.807870370370374,1024.7685185185192,29.279100529100546,0
1070,4,0,0,35,0.0,0.0,1.0,35,700,500,200,0.7142857142857143,9,5,4,357.5883489720529,0.7422268907563024,0.07482879344206284,0.20961643581998793,131359.53006355753,2394.55428727261,133754.08435083015,1069,10,640.5142857142857,33,2,18,34.555065750149424,0.6404671717171716,43.71936274509805,1025.1225490196098,31.064319667260904,0
1071,4,1,1,35,0.027777777777777776,0.027777777777777776,0.9722222222222222,36,1000,800,200,0.8,12,8,4,347.5836869640698,0.750297619047619,0.07377012205338351,0.20538169741722062,131663.90483276665,1952.845096371903,133616.74992913855,1070,0,623.6944444444445,34,2,15,34.5044078413177,0.6412377450980391,43.42261904761906,1026.3095238095254,30.185574229691923,0
1072,4,1,1,35,0.027777777777777776,0.027777777777777776,0.9722222222222222,36,700,500,200,0.7142857142857143,9,5,4,345.4682492831844,0.7501322751322752,0.07192460317460347,0.20462350149850178,131755.55555555577,1903.4722222222558,133659.027777778,1071,0,624.6666666666666,34,2,15,34.46631493506496,0.6421568627450979,43.33333333333335,1026.6666666666686,30.196078431372605,0
1073,4,0,0,35,0.0,0.0,1.0,35,1050,500,550,0.47619047619047616,16,5,11,353.2709091058363,0.7411764705882352,0.07262928093873677,0.20896872419989324,131705.233564014,2305.5255190311564,134010.75908304515,1072,13,643.5142857142857,33,2,16,34.31679799426935,0.6439393939393938,43.38235294117648,1026.4705882352953,31.105169340463494,0
1074,4,0,0,35,0.0,0.0,1.0,35,1450,1100,350,0.7586206896551724,18,11,7,352.5626519755278,0.74187675070028,0.06189510286873401,0.20941371978787365,131862.52170138882,2297.96006944444,134160.48177083326,1073,14,644.5142857142857,33,2,17,34.17638607167006,0.6455176767676768,43.229166666666664,1027.0833333333328,31.123737373737356,0
1075,4,0,0,35,0.0,0.0,1.0,35,1150,900,250,0.782608695652174,14,9,5,354.34710111038106,0.7422268907563024,0.06784845324991329,0.2110676210961835,131969.53125,2352.604166666668,134322.13541666666,1074,15,645.5142857142857,34,1,17,34.0227088402271,0.6443014705882353,43.125,1027.5,30.220588235294116,0
1076,4,1,0,36,0.027777777777777776,0.0,1.0,36,800,600,200,0.75,10,6,4,346.0397080097623,0.7527777777777779,0.06847850551429224,0.20748372775808005,132219.38898533946,1950.631751543208,134170.02073688267,1075,0,628.5555555555555,35,1,18,33.98463875759622,0.6446428571428571,42.88194444444444,1028.472222222222,29.384920634920626,0
1077,4,0,0,36,0.0,0.0,1.0,36,800,700,100,0.875,9,7,2,346.8893948984262,0.753207671957672,0.06533355833052079,0.20848545174118382,132308.68115837185,1979.2956693672788,134287.97682773913,1076,1,629.5555555555555,35,1,19,33.87297502531218,0.6455357142857143,42.795138888888886,1028.8194444444441,29.394841269841262,0
1078,4,1,0,37,0.02702702702702703,0.0,1.0,37,800,600,200,0.75,10,6,4,352.89638719658024,0.7607607607607607,0.08506587418305611,0.2070169667408816,131387.4488275894,1873.2613436642896,133260.71017125368,1077,0,613.5135135135135,35,2,19,34.6471174832543,0.6363095238095237,43.69212962962964,1025.2314814814833,29.292328042328094,8
1079,4,1,1,37,0.02631578947368421,0.02631578947368421,0.9736842105263158,38,800,400,400,0.5,12,4,8,345.6363151448253,0.771011142721669,0.08544545076475174,0.20397915178754228,131616.8533398265,1498.312839866919,133115.16617969342,1078,0,598.3421052631579,36,2,16,34.60180714076676,0.636574074074074,43.46846846846848,1026.1261261261277,28.50350350350355,0
1080,4,1,1,37,0.02631578947368421,0.02631578947368421,0.9736842105263158,38,850,700,150,0.8235294117647058,10,7,3,343.2985419138459,0.7745080606922712,0.08514882928660117,0.20306075337733348,131703.53366457697,1442.72621439009,133146.25987896707,1079,0,599.3157894736842,36,2,16,34.57441945511063,0.6374421296296295,43.38400900900902,1026.4639639639656,28.512887887887935,0
1081,4,0,0,37,0.0,0.0,1.0,37,1650,1200,450,0.7272727272727273,21,12,9,347.49270318390177,0.7577577577577578,0.09239127211477438,0.20538576503359823,131674.63705259337,1751.1951140329804,133425.83216662635,1080,3,616.5135135135135,36,1,16,34.49592202472386,0.6371527777777777,43.412162162162176,1026.3513513513533,28.509759759759813,0
1082,4,1,1,37,0.02631578947368421,0.02631578947368421,0.9736842105263158,38,1100,800,300,0.7272727272727273,14,8,6,344.80839239105467,0.7625948316737791,0.09057338148487193,0.20541636650327882,131975.16453379902,1501.2288636888454,133476.39339748787,1081,0,601.2631578947369,37,1,16,34.26206292462562,0.6382319819819819,43.11951754385966,1027.5219298245627,27.770862968231423,0
1083,4,0,0,37,0.0,0.0,1.0,37,1300,1200,100,0.9230769230769231,14,12,2,352.2330083646268,0.7561311311311312,0.09545678105204547,0.20945694278371113,131905.89871966574,1892.3223054135392,133798.22102507929,1082,5,618.5135135135135,36,1,16,34.14113315793322,0.6394675925925926,43.186936936936945,1027.2522522522534,28.534784784784815,0
1084,4,0,0,37,0.0,0.0,1.0,37,1250,1000,250,0.8,15,10,5,353.2418847652325,0.7555680680680681,0.09605791675059527,0.21037721648811908,131963.7458404351,1923.0244602710895,133886.77030070618,1083,6,619.5135135135135,36,1,17,34.05692861318135,0.6400462962962963,43.130630630630634,1027.477477477478,28.541041041041055,0
1085,4,0,0,37,0.0,0.0,1.0,37,850,600,250,0.7058823529411765,11,6,5,352.84714962427415,0.7533158158158159,0.09923135229883684,0.21078460613680483,132079.4781267756,1920.7734761788981,134000.2516029545,1084,7,620.5135135135135,36,1,17,33.950482033304105,0.6412037037037037,43.018018018018026,1027.9279279279292,28.553553553553588,0
1086,4,1,1,37,0.02631578947368421,0.02631578947368421,0.9736842105263158,38,850,500,350,0.5882352941176471,12,5,7,344.27013888039966,0.7607871028923661,0.09462127926937347,0.20678248674621708,132285.18029586028,1508.3674784549064,133793.54777431517,1085,0,605.1578947368421,37,1,17,33.96397356640374,0.6413288288288288,42.81798245614035,1028.7280701754387,27.80346135609294,0
1087,4,0,0,37,0.0,0.0,1.0,37,1250,1000,250,0.8,15,10,5,343.4747144754019,0.7515640640640641,0.08140785322583466,0.20057336022446767,131212.72243527308,1613.6504747991144,132826.3729100722,1086,9,622.5135135135135,36,1,18,35.064941012676755,0.6325231481481481,43.86261261261261,1024.5495495495493,28.459709709709703,3
1088,4,1,0,38,0.02631578947368421,0.0,1.0,38,900,700,200,0.7777777777777778,11,7,4,333.37539074495044,0.7638691322901849,0.07932871480490666,0.1962971192175664,131530.20154867697,1169.8371936125263,132700.0387422895,1087,0,607.1052631578947,36,2,19,35.003613642185385,0.6357060185185186,43.552927927927925,1025.7882882882877,28.494119119119105,0
1089,4,0,0,38,0.0,0.0,1.0,38,950,700,250,0.7368421052631579,12,7,5,327.76416281648966,0.7622095779990516,0.0721449532825873,0.19396511329253938,131721.78578985823,1034.7361688211604,132756.5219586794,1088,1,608.1052631578947,37,1,15,34.95469272947378,0.6356981981981983,43.36622807017543,1026.5350877192968,27.744191559980994,0
1090,4,0,0,38,0.0,0.0,1.0,38,300,100,200,0.3333333333333333,5,1,4,327.7039991197535,0.7606685633001422,0.0744396231929676,0.19421647137704845,131778.07113727272,1036.8401815943112,132814.91131886703,1089,2,609.1052631578947,37,1,15,34.899615548910724,0.6362612612612613,43.31140350877192,1026.7543859649102,27.750118539592165,0
1091,4,1,0,39,0.02564102564102564,0.0,1.0,39,1250,900,350,0.72,16,9,7,322.285991403658,0.7642825011246064,0.08762060019072293,0.1931709186333505,132205.65440317037,721.6060796990203,132927.26048286937,1090,0,594.4615384615385,38,1,17,34.60917480434933,0.6387061403508772,42.89529914529914,1028.4188034188028,27.06365272154744,0
1092,4,0,1,38,0.0,0.02564102564102564,0.9743589743589743,39,1150,900,250,0.782608695652174,14,9,5,323.70398638593474,0.7640013495276653,0.08607545049543153,0.1944445218284572,132288.07259706708,764.4352901965156,133052.50788726358,1091,1,595.4615384615385,38,1,17,34.48999549970573,0.6395285087719298,42.815170940170944,1028.739316239317,27.07208726945571,0
1093,4,0,0,38,0.0,0.0,1.0,38,1200,1000,200,0.8333333333333334,14,10,4,341.55287082400304,0.7590979137031769,0.06408444384618783,0.20545718844951583,132341.58587257622,1440.329716835951,133781.91558941218,1092,2,611.7631578947369,37,1,17,33.977159704461485,0.6418918918918919,42.76315789473684,1028.947368421053,27.809388335704135,2
1094,4,0,0,38,0.0,0.0,1.0,38,1050,800,250,0.7619047619047619,13,8,5,341.16548102553134,0.759009009009009,0.062459692117880605,0.20537768052755698,132369.79316953302,1432.0008319867684,133801.7940015198,1093,3,612.7631578947369,37,1,17,33.95877730420884,0.6421734234234234,42.73574561403509,1029.0570175438602,27.812351825509733,0
1095,4,0,0,38,0.0,0.0,1.0,38,1150,500,650,0.43478260869565216,18,5,13,341.4250356504774,0.7584459459459459,0.06616236948646859,0.2056877653796781,132398.00347222234,1440.7986111111159,133838.80208333346,1094,4,613.7631578947369,37,1,17,33.92375168690957,0.642454954954955,42.708333333333336,1029.1666666666674,27.815315315315335,0
1096,4,0,0,38,0.0,0.0,1.0,38,650,400,250,0.6153846153846154,9,4,5,341.26187797601773,0.7576754385964912,0.07122194066333276,0.2058975906451708,132454.43309479853,1440.3297168359584,133894.7628116345,1095,5,614.7631578947369,37,1,17,33.87125408322681,0.643018018018018,42.65350877192983,1029.3859649122817,27.82124229492653,0
1097,4,0,1,37,0.0,0.02631578947368421,0.9736842105263158,38,1000,500,500,0.5,15,5,10,340.8394562922928,0.7575272641062115,0.07300536462041185,0.205796891005038,132482.65241468546,1431.0630434364525,133913.7154581219,1096,6,615.7631578947369,37,1,17,33.85377835765256,0.6432995495495495,42.626096491228076,1029.495614035089,27.824205784732133,0
1098,4,0,0,37,0.0,0.0,1.0,37,1200,700,500,0.5833333333333334,17,7,10,347.65362487501835,0.7516891891891891,0.07418754787175863,0.20944011059543807,132398.00347222236,1805.7291666666856,134203.73263888905,1097,10,633.2432432432432,36,1,17,33.763495276653174,0.6443865740740741,42.70833333333334,1029.1666666666679,28.587962962962997,0
1099,4,1,0,38,0.02631578947368421,0.0,1.0,38,650,500,150,0.7692307692307693,8,5,3,340.24481489430474,0.7566678520625889,0.0801010293343487,0.20683187389241114,132736.76155163138,1432.5989727608649,134169.36052439225,1098,0,617.5526315789474,37,1,17,33.61397815137972,0.6458333333333333,42.37938596491229,1030.4824561403518,27.85087719298248,0
1100,4,0,0,38,0.0,0.0,1.0,38,850,500,350,0.5882352941176471,12,5,7,340.44135404394,0.7564307728781413,0.08126490444362355,0.20757649874974854,132849.7770948753,1445.5115997229866,134295.28869459828,1099,1,618.5526315789474,37,1,17,33.49553286534781,0.6469594594594594,42.26973684210526,1030.9210526315785,27.862731152204823,0
1101,4,2,1,39,0.05,0.025,0.975,40,900,700,200,0.7777777777777778,11,7,4,324.18846461249217,0.7723557692307692,0.08183881379866875,0.20012480935045132,133310.81271701396,643.5655381944556,133954.37825520843,1100,0,588.575,39,1,18,33.453113442270194,0.6479700854700854,41.82291666666667,1032.708333333334,26.47970085470087,0
1102,4,0,0,39,0.0,0.0,1.0,39,1050,800,250,0.7619047619047619,13,8,5,351.12928250547816,0.7627642825011246,0.12807613791865702,0.21234961370569416,132542.91453615794,1513.777370064332,134056.6919062223,1101,1,604.6666666666666,36,3,20,33.52836103820355,0.6458333333333334,42.56756756756757,1029.729729729731,28.603603603603638,2
1103,4,0,0,39,0.0,0.0,1.0,39,1200,900,300,0.75,15,9,6,352.5128822553064,0.7614709851551957,0.13523839958736694,0.2136802739555525,132629.8992193207,1550.7496094067144,134180.64882872743,1102,2,605.6666666666666,36,3,17,33.405305929084236,0.6467013888888888,42.48310810810811,1030.067567567568,28.612987987988,0
1104,4,0,0,39,0.0,0.0,1.0,39,1300,900,400,0.6923076923076923,17,9,8,358.06431962734024,0.7593904633378318,0.13700434356172053,0.21754903881740797,132716.91243608482,1704.2381908936063,134421.15062697843,1103,3,606.6666666666666,36,3,17,33.17486338797814,0.6475694444444444,42.39864864864865,1030.405405405406,28.622372372372393,0
1105,4,0,0,39,0.0,0.0,1.0,39,650,300,350,0.46153846153846156,10,3,7,357.8242582131499,0.7586032388663968,0.13579572360033532,0.21757141441252723,132745.92318247302,1699.9422987176417,134445.86548119067,1104,4,607.6666666666666,36,3,17,33.15188686118092,0.6478587962962963,42.3704954954955,1030.5180180180182,28.625500500500507,0
1106,4,1,0,40,0.025,0.0,1.0,40,1200,600,600,0.5,18,6,12,350.5108030803972,0.7614049145299145,0.07530272452068587,0.21574919618178517,133203.26063368074,1337.8363715277972,134541.09700520855,1105,0,593.45,39,1,16,32.88134880591994,0.6469017094017093,41.92708333333334,1032.2916666666683,26.469017094017136,3
1107,4,0,0,40,0.0,0.0,1.0,40,1150,800,350,0.6956521739130435,15,8,7,349.5833789309053,0.7620459401709402,0.07861105507363253,0.21580134612210455,133310.81271701405,1320.6488715277874,134631.46158854183,1106,1,594.45,39,1,16,32.79747495124739,0.6479700854700854,41.82291666666667,1032.7083333333346,26.479700854700887,0
1108,4,0,1,39,0.0,0.025,0.975,40,1250,1000,250,0.8,15,10,5,349.39559260271113,0.7618856837606838,0.07471762807583682,0.2159979237062648,133364.60503472242,1319.401041666686,134684.0060763891,1107,2,595.45,39,1,16,32.7484200618529,0.6485042735042734,41.77083333333334,1032.9166666666683,26.48504273504278,0
1109,4,0,0,39,0.0,0.0,1.0,39,600,300,300,0.5,9,3,6,355.37114086279166,0.7631578947368421,0.07901914586517278,0.21902466232767942,133251.5158156182,1670.748639418497,134922.2644550367,1108,3,600.5384615384615,38,1,16,32.70751414183225,0.6491228070175439,41.880341880341874,1032.478632478631,27.170490328385025,0
1110,4,0,0,39,0.0,0.0,1.0,39,1000,500,500,0.5,15,5,10,360.33803808971777,0.7620895186684661,0.08079297000368668,0.2225806910040448,133334.25931633057,1809.0810824384425,135143.340398769,1109,4,601.5384615384615,38,1,16,32.49629323126786,0.6499451754385965,41.80021367521367,1032.7991452991448,27.178924876293284,0
1111,4,0,0,39,0.0,0.0,1.0,39,400,200,200,0.5,6,2,4,362.60288483347045,0.7600652271704904,0.0877060415887847,0.22464654062937128,133444.62393390646,1877.4811207903867,135322.10505469685,1110,5,602.5384615384615,38,1,16,32.32710336745599,0.6510416666666667,41.693376068376054,1033.226495726493,27.190170940170873,0
1112,4,0,0,39,0.0,0.0,1.0,39,800,600,200,0.75,10,6,4,360.6572820785233,0.7587719298245614,0.08894256268818701,0.22412104140766217,133557.21381819385,1833.67920109854,135390.8930192924,1111,6,603.5384615384615,37,2,17,32.26448410593683,0.6539977477477479,41.58442982456139,1033.6622807017527,27.936818397344666,0
1113,4,0,0,39,0.0,0.0,1.0,39,450,300,150,0.6666666666666666,6,3,3,360.7912420074081,0.7571974808816915,0.08697992708171975,0.22489241264850346,133670.57802641162,1845.4347731994126,135516.01279961102,1112,7,604.5384615384615,37,2,18,32.147417205669264,0.655123873873874,41.47478070175437,1034.1008771929796,27.948672356567016,0
1114,4,1,2,38,0.025,0.05,0.95,40,850,600,250,0.7058823529411765,11,6,5,353.63083936212894,0.7624732905982906,0.08868209255533244,0.22247408501642763,134010.95920138864,1478.081597222198,135489.04079861083,1113,0,590.4,39,1,17,31.99195171026156,0.65491452991453,41.14583333333332,1035.4166666666647,26.54914529914525,0
1115,4,0,0,38,0.0,0.0,1.0,38,850,600,250,0.7058823529411765,11,6,5,368.1005500697104,0.7444582740635373,0.09923233991274572,0.22997752247401604,133755.63274276673,2247.1043975068974,136002.73714027362,1114,9,621.7894736842105,37,1,17,31.87318917390996,0.6559684684684686,41.39254385964911,1034.4298245614013,27.95756282598382,0
1116,4,0,0,38,0.0,0.0,1.0,38,650,400,250,0.6153846153846154,9,4,5,368.5708339968135,0.744547178757705,0.09761247315426891,0.23044836439761004,133783.99032635035,2261.775378000913,136045.76570435127,1115,10,622.7894736842105,37,1,17,31.83260466348701,0.65625,41.36513157894736,1034.53947368421,27.96052631578946,0
1117,4,0,0,38,0.0,0.0,1.0,38,400,200,200,0.5,6,2,4,368.5708339968135,0.744547178757705,0.09761247315426891,0.23044836439761004,133783.99032635035,2261.775378000913,136045.76570435127,1116,11,623.7894736842105,37,1,17,31.83260466348701,0.65625,41.36513157894736,1034.53947368421,27.96052631578946,0
1118,4,0,0,38,0.0,0.0,1.0,38,1200,900,300,0.75,15,9,6,365.27847601264045,0.7456140350877193,0.1005352363960752,0.22927053281644413,133925.8233302552,2184.0441289627274,136109.86745921793,1117,12,624.7894736842105,37,1,19,31.77568855932202,0.6576576576576578,41.22807017543858,1035.0877192982434,27.97534376481739,0
1119,4,0,0,38,0.0,0.0,1.0,38,650,400,250,0.6153846153846154,9,4,5,363.91386548668294,0.7451398767188241,0.1037276289314839,0.22894327993276126,134010.95920138876,2153.6892361111013,136164.64843749985,1118,13,625.7894736842105,37,1,19,31.72577129443327,0.6585022522522523,41.14583333333333,1035.4166666666656,27.984234234234204,0
1120,4,0,0,38,0.0,0.0,1.0,38,1000,600,400,0.6,14,6,8,362.36251913013297,0.7459992887624467,0.09977930849996675,0.22814344204433137,134039.3438365649,2114.1668590335266,136153.5106955984,1119,14,626.7894736842105,37,1,19,31.737522942256092,0.6587837837837839,41.11842105263157,1035.526315789472,27.98719772403978,0
1121,4,0,0,38,0.0,0.0,1.0,38,850,600,250,0.7058823529411765,11,6,5,360.89593854205555,0.744606448553817,0.0974661964533432,0.22774775760900437,134124.51577648876,2080.9986005309165,136205.51437701966,1120,15,627.7894736842105,37,1,19,31.690285275748916,0.6596283783783785,41.03618421052631,1035.8552631578934,27.99608819345658,0
1122,4,0,0,38,0.0,0.0,1.0,38,750,600,150,0.8,9,6,3,361.29290893312077,0.7443397344713134,0.10023391812865512,0.22852864721673294,134209.71476800545,2097.8036511234127,136307.51841912887,1121,16,628.7894736842105,37,1,19,31.594797178130506,0.660472972972973,40.95394736842105,1036.184210526315,28.004978662873377,0
1123,4,0,0,38,0.0,0.0,1.0,38,950,600,350,0.631578947368421,13,6,7,362.9164974696267,0.7436581318160266,0.1022141906453784,0.22973367833793953,134238.1204433093,2143.445699638328,136381.56614294765,1122,17,629.7894736842105,37,1,19,31.524331640390773,0.6607545045045047,40.92653508771929,1036.2938596491215,28.007942152678957,0
1124,4,0,0,38,0.0,0.0,1.0,38,650,400,250,0.6153846153846154,9,4,5,362.9164974696267,0.7436581318160266,0.1022141906453784,0.22973367833793953,134238.1204433093,2143.445699638328,136381.56614294765,1123,18,630.7894736842105,37,1,19,31.524331640390773,0.6607545045045047,40.92653508771929,1036.2938596491215,28.007942152678957,0
1125,4,0,0,38,0.0,0.0,1.0,38,850,600,250,0.7058823529411765,11,6,5,365.46888054789616,0.7439248458985301,0.10730629196218788,0.23188877830200053,134323.35550361636,2218.201273468744,136541.5567770851,1124,19,631.7894736842105,37,1,19,31.372963824836045,0.6615990990990992,40.84429824561403,1036.6228070175428,28.01683262209575,0
1126,4,0,1,37,0.0,0.02631578947368421,0.9736842105263158,38,1450,1000,450,0.6896551724137931,19,10,9,363.05866034418807,0.7422652916073968,0.10642570281124497,0.23179899083513528,134550.78124999988,2170.350011541999,136721.1312615419,1125,20,632.7894736842105,35,3,19,31.208165997322613,0.6678571428571429,40.62499999999999,1037.499999999999,29.642857142857117,0
1127,4,0,0,37,0.0,0.0,1.0,37,1150,600,550,0.5217391304347826,17,6,11,372.344579224765,0.7357982982982982,0.07903976484036934,0.23253972777999443,133741.45507812485,2559.58116319443,136301.0362413193,1126,21,648.4594594594595,35,2,18,31.777651896609594,0.6598214285714286,41.40624999999999,1034.3749999999989,29.553571428571395,2
1128,4,0,0,37,0.0,0.0,1.0,37,1000,700,300,0.7,13,7,6,373.6867601757829,0.736111111111111,0.08567377087345784,0.233756889377979,133801.32144043618,2599.956463263011,136401.2779036992,1127,22,649.4594594594595,35,2,18,31.682911026587607,0.6604166666666668,41.34837962962962,1034.60648148148,29.56018518518514,0
1129,4,0,0,37,0.0,0.0,1.0,37,500,300,200,0.6,7,3,4,372.0733300301789,0.7356106106106106,0.08801015780881549,0.23293666459872528,133831.2596450616,2559.0084876543037,136390.2681327159,1128,23,650.4594594594595,35,2,18,31.694630872483216,0.6607142857142858,41.319444444444436,1034.7222222222213,29.563492063492035,0
1130,4,0,0,37,0.0,0.0,1.0,37,1350,1100,250,0.8148148148148148,16,11,5,371.873490335128,0.7324824824824825,0.08738547421904985,0.23414159873528426,134040.92084887254,2569.2530167609675,136610.17386563352,1129,24,651.4594594594595,35,2,18,31.48972188070489,0.662797619047619,41.116898148148145,1035.532407407407,29.586640211640198,0
1131,4,0,0,37,0.0,0.0,1.0,37,900,700,200,0.7777777777777778,11,7,4,375.43833561192525,0.7328578578578578,0.09215337558539494,0.23715938899522515,134160.80092860502,2673.8215609996514,136834.62248960466,1130,25,652.4594594594595,35,2,19,31.27734796856963,0.6639880952380952,41.001157407407405,1035.9953703703695,29.5998677248677,0
1132,4,0,0,37,0.0,0.0,1.0,37,1050,900,150,0.8571428571428571,12,9,3,376.3942966330926,0.7329829829829829,0.09045632632856204,0.23834756237996554,134250.74615269213,2706.243034122091,136956.98918681423,1131,26,653.4594594594595,35,2,19,31.162515821606725,0.6648809523809524,40.914351851851855,1036.3425925925933,29.60978835978838,0
1133,4,0,0,37,0.0,0.0,1.0,37,1150,800,350,0.6956521739130435,15,8,7,376.11607142857116,0.733546046046046,0.08424227799227801,0.23934659090909094,134430.72702331975,2712.3113854595485,137143.0384087793,1132,27,654.4594594594595,35,2,19,30.989583333333343,0.6666666666666665,40.74074074074075,1037.037037037038,29.629629629629658,0
1134,4,0,0,37,0.0,0.0,1.0,37,1000,800,200,0.8,12,8,4,374.2705517294339,0.7329829829829829,0.06430233003812202,0.2304189488048168,133210.5262991032,2571.3554348267303,135781.8817339299,1133,28,655.4594594594595,36,1,18,32.260872331915216,0.6524884259259258,41.92004504504505,1032.3198198198202,28.67555055055056,4
1135,4,0,1,36,0.0,0.02702702702702703,0.972972972972973,37,450,300,150,0.6666666666666666,6,3,3,373.46854388184727,0.73241991991992,0.06272604811158677,0.23028467241779801,133268.65875588424,2554.3303861293743,135822.98914201363,1134,29,656.4594594594595,36,1,18,32.22316137710401,0.6530671296296295,41.86373873873874,1032.5450450450448,28.6818068068068,0
1136,4,1,1,36,0.02702702702702703,0.02702702702702703,0.972972972972973,37,650,300,350,0.46153846153846156,10,3,7,371.2552591683012,0.7432432432432432,0.04840250504192811,0.2296517266332608,133387.257677843,2504.1441837873076,135891.40186163032,1135,0,627.3513513513514,37,0,18,32.16119573293706,0.6523085585585586,41.748903508771924,1033.004385964911,27.91903745851111,0
1137,4,0,0,36,0.0,0.0,1.0,36,950,800,150,0.8421052631578947,11,8,3,375.56088660665955,0.7321097883597885,0.04919795490616563,0.23193729906193103,133326.80389426596,2814.466535792555,136141.27043005853,1136,31,645.7777777777778,36,0,18,32.11072947333988,0.6536458333333334,41.807432432432435,1032.7702702702709,28.68806306306308,0
1138,4,0,1,35,0.0,0.027777777777777776,0.9722222222222222,36,850,700,150,0.8235294117647058,10,7,3,377.8616024973987,0.7316137566137567,0.04681899641577081,0.23427419354838705,133472.22222222207,2886.884815558783,136359.10703778086,1137,32,646.7777777777778,35,1,18,31.905241935483875,0.6571428571428573,41.66666666666666,1033.3333333333321,29.52380952380949,0
1139,4,0,0,35,0.0,0.0,1.0,35,1150,800,350,0.6956521739130435,15,8,7,386.71361353611724,0.721218487394958,0.0480797709546843,0.24016077201148572,133533.73724489796,3327.8628117913777,136861.60005668935,1138,33,664.4857142857143,34,1,18,31.614739307379253,0.6599264705882353,41.607142857142854,1033.5714285714284,30.399159663865543,0
1140,4,0,0,35,0.0,0.0,1.0,35,1100,800,300,0.7272727272727273,14,8,6,384.1515009600061,0.7200280112044818,0.052339830578172375,0.23916528930735845,133626.03635204077,3266.528486394551,136892.56483843533,1139,34,665.4857142857143,34,1,18,31.588226827864137,0.6608455882352942,41.51785714285714,1033.9285714285709,30.409663865546204,0
1141,4,0,0,35,0.0,0.0,1.0,35,1050,700,350,0.6666666666666666,14,7,7,382.6725528510992,0.7192577030812325,0.053257063957789175,0.2394389601748671,133810.73022959186,3241.1387471655357,137051.8689767574,1140,35,666.4857142857143,34,1,16,31.441050128485408,0.6626838235294117,41.339285714285715,1034.6428571428573,30.430672268907568,0
1142,4,1,0,36,0.027777777777777776,0.0,1.0,36,300,100,200,0.3333333333333333,5,1,4,385.4943856332213,0.7260582010582011,0.08077762890179141,0.2445104615956891,134310.72638031552,3155.206189986282,137465.9325703018,1141,0,648.9444444444445,35,1,17,30.866644335268706,0.6654761904761904,40.85648148148148,1036.5740740740741,29.616402116402117,0
1143,4,0,0,36,0.0,0.0,1.0,36,1350,1000,350,0.7407407407407407,17,10,7,380.86870706268087,0.7260582010582011,0.04236358832078224,0.23177321464523507,132776.64389898127,2965.8555692611308,135742.4994682424,1142,1,649.9444444444445,33,3,18,32.52724930638131,0.6546717171717171,42.340686274509814,1030.6372549019618,31.231431966726117,7
1144,4,0,0,36,0.0,0.0,1.0,36,1100,800,300,0.7272727272727273,14,8,6,381.85571751796283,0.7253306878306879,0.02854351499788743,0.23355361327261479,132966.16685890066,2954.778210303757,135920.9450692044,1143,2,650.9444444444445,33,3,18,32.31097512674271,0.6565656565656565,42.15686274509805,1031.3725490196098,31.25371360665484,0
1145,4,0,0,36,0.0,0.0,1.0,36,1050,700,350,0.6666666666666666,14,7,7,377.97426538801506,0.7251322751322752,0.02668897071438958,0.23176732267310268,133060.97902549506,2858.7251597943205,135919.7041852894,1144,3,651.9444444444445,33,3,18,32.31566991329137,0.6575126262626263,42.06495098039216,1031.7401960784318,31.264854426619145,0
1146,4,0,0,36,0.0,0.0,1.0,36,900,500,400,0.5555555555555556,13,5,8,380.65956354971826,0.7233134920634922,0.028160282789912117,0.23440615229114262,133219.07439446385,2942.2229430988273,136161.2973375627,1145,4,652.9444444444445,33,3,18,32.08738920544476,0.659090909090909,41.91176470588236,1032.352941176472,31.283422459893092,0
1147,4,0,0,36,0.0,0.0,1.0,36,650,300,350,0.46153846153846156,10,3,7,380.75891337026275,0.7217261904761906,0.026753121998078555,0.2350949162624223,133318.49666950124,2952.441184807269,136270.93785430852,1146,5,653.9444444444445,34,2,18,31.98487031700288,0.657781862745098,41.8154761904762,1032.738095238096,30.374649859944004,0
1148,4,0,0,36,0.0,0.0,1.0,36,700,400,300,0.5714285714285714,10,4,6,380.3497661672878,0.7216269841269842,0.02521702389183389,0.235426196205401,133410.72137188204,2948.547335600904,136359.26870748296,1147,6,654.9444444444445,34,2,18,31.902752170238927,0.6587009803921569,41.726190476190474,1033.0952380952378,30.385154061624643,0
1149,4,0,0,36,0.0,0.0,1.0,36,700,500,200,0.7142857142857143,9,5,4,379.7606960479452,0.7208002645502646,0.028289869544622537,0.2352564654532559,133441.47002551015,2935.165107709747,136376.63513321988,1148,7,655.9444444444445,34,2,18,31.887074163690137,0.6590073529411764,41.69642857142857,1033.2142857142853,30.38865546218486,0
1150,4,0,0,36,0.0,0.0,1.0,36,1500,1200,300,0.8,18,12,6,376.97570608497665,0.7191137566137566,0.029832220510186858,0.23472649684420285,133630.56163795176,2875.0986086836742,136505.66024663544,1149,8,656.9444444444445,33,3,19,31.76916656789539,0.6631944444444444,41.513480392156865,1033.9460784313726,31.33169934640523,0
1151,4,0,0,36,0.0,0.0,1.0,36,800,600,200,0.75,10,6,4,378.116973710435,0.719510582010582,0.02897549290584145,0.2364491475602586,133788.99491782006,2917.5779748173763,136706.57289263743,1150,9,657.9444444444445,33,3,15,31.580687830687825,0.6647727272727273,41.36029411764706,1034.5588235294117,31.350267379679142,0
1152,4,0,1,35,0.0,0.027777777777777776,0.9722222222222222,36,900,600,300,0.6666666666666666,12,6,6,384.3610049249934,0.7172619047619048,0.033658273475938305,0.2411822472211363,133915.80912389464,3094.402994040748,137010.21211793539,1151,10,658.9444444444445,33,3,15,31.291933064961704,0.6660353535353536,41.23774509803921,1035.049019607843,31.365121806298276,0
1153,4,0,0,35,0.0,0.0,1.0,35,700,500,200,0.7142857142857143,9,5,4,386.3524687685901,0.713235294117647,0.03958188153310083,0.24295170582073924,133994.61789613313,3353.8302851749922,137348.44818130814,1152,11,665.6285714285714,32,3,16,31.161331300813,0.6692708333333333,41.161616161616166,1035.353535353536,32.354797979798,0
1154,4,0,0,35,0.0,0.0,1.0,35,850,400,450,0.47058823529411764,13,4,9,388.43776570475075,0.7137254901960783,0.03204402570488174,0.2449158333648017,134092.6806735282,3417.3322556371777,137510.0129291654,1153,12,666.6285714285714,32,3,16,31.00898045430534,0.6702473958333334,41.06691919191919,1035.732323232323,32.3666351010101,0
1155,4,0,0,35,0.0,0.0,1.0,35,1150,800,350,0.6956521739130435,15,8,7,389.1352629573992,0.7128851540616246,0.040367675220222,0.2460126323442542,134190.77932098764,3443.672839506171,137634.45216049382,1154,13,667.6285714285714,32,3,16,30.89253798033959,0.6712239583333334,40.97222222222222,1036.111111111111,32.37847222222222,0
1156,4,0,0,35,0.0,0.0,1.0,35,750,400,350,0.5333333333333333,11,4,7,392.2471913262136,0.7103641456582632,0.039375750300120194,0.24909061778650732,134354.35677800732,3540.0238177226784,137894.38059573,1155,14,668.6285714285714,32,3,17,30.647911338448413,0.6728515625,40.81439393939394,1036.742424242424,32.39820075757575,0
1157,4,0,0,35,0.0,0.0,1.0,35,750,700,50,0.9333333333333333,8,7,1,390.6769122143074,0.7097338935574229,0.04119989566124693,0.24898454878514625,134485.2904837517,3508.0596048872603,137993.35008863898,1156,15,669.6285714285714,32,3,18,30.557415297220526,0.6741536458333334,40.688131313131315,1037.247474747475,32.413983585858595,0
1158,4,0,0,35,0.0,0.0,1.0,35,650,600,50,0.9230769230769231,7,6,1,388.86469573071406,0.7095238095238094,0.041078600114744734,0.24827515188960966,134550.78125,3464.4097222222217,138015.19097222222,1157,16,670.6285714285714,32,3,19,30.538821954484597,0.6748046875,40.625,1037.5,32.421875,0
1159,4,0,0,35,0.0,0.0,1.0,35,1050,700,350,0.6666666666666666,14,7,7,386.244078733213,0.7087535014005601,0.036297943301834,0.24816182058608932,134780.12447709416,3411.6050020406024,138191.72947913475,1158,17,671.6285714285714,32,3,16,30.377300178339812,0.6770833333333334,40.4040404040404,1038.3838383838383,32.44949494949495,0
1160,4,0,0,35,0.0,0.0,1.0,35,850,500,350,0.5882352941176471,12,5,7,388.44119701581303,0.7079831932773109,0.03319787433573018,0.2500248268115868,134845.6869834711,3475.924012855836,138321.61099632693,1159,18,672.6285714285714,32,3,16,30.25468028203258,0.677734375,40.34090909090909,1038.636363636364,32.457386363636374,0
1161,4,0,0,35,0.0,0.0,1.0,35,1150,1000,150,0.8695652173913043,13,10,3,385.5463992858101,0.7081932773109243,0.030040102078016773,0.2488361819390534,134944.06063475672,3405.439336547298,138349.49997130403,1160,19,673.6285714285714,32,3,16,30.23149835946044,0.6787109375,40.246212121212125,1039.015151515152,32.4692234848485,0
1162,4,0,0,35,0.0,0.0,1.0,35,1050,800,250,0.7619047619047619,13,8,5,387.70782157094396,0.7083333333333333,0.03306955435235337,0.25091279773364883,135042.4701561066,3471.4043847566672,138513.87454086327,1161,20,674.6285714285714,32,3,16,30.0769861516035,0.6796875,40.151515151515156,1039.39393939394,32.48106060606062,0
1163,4,0,1,34,0.0,0.02857142857142857,0.9714285714285714,35,850,400,450,0.47058823529411764,13,4,9,386.24291226638263,0.7084033613445377,0.03220400728597439,0.2506469962579717,135140.91554752062,3439.4441574839248,138580.35970500455,1162,21,675.6285714285714,32,3,16,30.016697024893737,0.6806640625,40.05681818181818,1039.772727272727,32.49289772727272,0
1164,4,0,0,34,0.0,0.0,1.0,34,950,800,150,0.8421052631578947,11,8,3,385.32908140983693,0.7091874628639335,0.002630958925626148,0.25096650606605914,135272.231867284,3624.864969135805,138897.0968364198,1163,22,662.5294117647059,32,2,16,29.909323542501095,0.6819661458333334,39.93055555555556,1040.277777777778,32.508680555555564,0
1165,4,0,0,34,0.0,0.0,1.0,34,1100,800,300,0.7272727272727273,14,8,6,381.8272100882346,0.7080362448009507,0.004037608252129399,0.2502819693471845,135502.18887103355,3547.6845474951506,139049.8734185287,1164,23,663.5294117647059,32,2,17,29.771000080847287,0.6842447916666667,39.70959595959596,1041.161616161616,32.5363005050505,0
1166,4,0,0,34,0.0,0.0,1.0,34,750,500,250,0.6666666666666666,10,5,5,379.5200000000002,0.7055852644087939,0.005882352941176894,0.24968421052631595,135633.68055555556,3495.1388888888937,139128.81944444447,1165,24,664.5294117647059,32,2,17,29.70000000000001,0.685546875,39.583333333333336,1041.6666666666667,32.552083333333336,0
1167,4,0,0,34,0.0,0.0,1.0,34,800,700,100,0.875,9,7,2,377.2079311300304,0.7053995840760547,0.004736245643296,0.24884868550089062,135732.3411673554,3439.8631198347166,139172.2042871901,1166,25,665.5294117647059,32,2,19,29.661941112322797,0.6865234375,39.48863636363637,1042.0454545454547,32.56392045454546,0
1168,4,0,0,34,0.0,0.0,1.0,34,1000,700,300,0.7,13,7,6,374.43981605337376,0.7055109922756982,-0.0005413645235277098,0.2481640450215697,135896.8552316089,3377.0386950311085,139273.89392664,1167,26,666.5294117647059,32,2,16,29.570315653507716,0.6881510416666667,39.330808080808076,1042.6767676767668,32.58364898989896,0
1169,4,0,0,34,0.0,0.0,1.0,34,800,600,200,0.75,10,6,4,372.21565209990786,0.7060308972073679,0.002075663820788387,0.24737518117436327,135995.61149691348,3323.939043209868,139319.55054012334,1168,27,667.5294117647059,32,2,17,29.530071016422564,0.6891276041666667,39.23611111111111,1043.0555555555547,32.595486111111086,0
1170,4,0,1,33,0.0,0.029411764705882353,0.9705882352941176,34,850,500,350,0.5882352941176471,12,5,7,371.98682157173914,0.7065136660724897,0.001772822418727893,0.24745210304554802,136028.53822314038,3320.1647153351514,139348.70293847553,1169,28,668.5294117647059,32,2,18,29.503298232873398,0.689453125,39.204545454545446,1043.181818181817,32.599431818181785,0
1171,4,0,0,33,0.0,0.0,1.0,33,1250,1000,250,0.8,15,10,5,373.20431252436464,0.6957070707070707,0.00932626531465175,0.24918472110875595,136160.28498367514,3563.1211100908113,139723.40609376595,1170,29,685.6969696969697,32,1,18,29.340571820308085,0.6907552083333334,39.07828282828283,1043.6868686868688,32.61521464646465,0
1172,4,0,0,33,0.0,0.0,1.0,33,650,300,350,0.46153846153846156,10,3,7,370.75719848112897,0.6939709595959597,0.01552160052764684,0.2484734223208214,136292.0955132129,3506.255101520249,139798.35061473315,1171,30,686.6969696969697,32,1,18,29.27347843611447,0.6920572916666667,38.9520202020202,1044.191919191919,32.63099747474747,0
1173,4,0,0,33,0.0,0.0,1.0,33,500,300,200,0.6,7,3,4,369.48452772768576,0.6945233585858587,0.013321462722985844,0.24785129998667407,136325.05810950417,3473.9999426079,139799.05805211206,1172,31,687.6969696969697,32,1,18,29.273969290291372,0.6923828125,38.92045454545455,1044.3181818181822,32.634943181818194,0
1174,4,0,0,33,0.0,0.0,1.0,33,500,200,300,0.4,8,2,6,378.43860047019314,0.6947601010101011,0.0021929117353030048,0.2397344752192078,134264.8579422578,3562.200986399472,137827.05892865726,1173,32,688.6969696969697,33,0,18,31.095418982302633,0.6695075757575757,40.90073529411765,1036.3970588235297,31.405971479500902,4
1175,4,0,0,33,0.0,0.0,1.0,33,550,300,250,0.5454545454545454,8,3,5,378.43860047019314,0.6947601010101011,0.0021929117353030048,0.2397344752192078,134264.8579422578,3562.200986399472,137827.05892865726,1174,33,689.6969696969697,33,0,18,31.095418982302633,0.6695075757575757,40.90073529411765,1036.3970588235297,31.405971479500902,0
1176,4,1,0,34,0.029411764705882353,0.0,1.0,34,550,400,150,0.7272727272727273,7,4,3,370.11991992365915,0.7057338086749851,-0.0004967382015990118,0.23651361222593387,134582.56927924365,3162.64207276049,137745.21135200415,1175,0,670.3823529411765,33,1,19,30.99324337624503,0.6726641414141414,40.594362745098046,1037.6225490196086,31.443107546048747,0
1177,4,0,0,34,0.0,0.0,1.0,34,650,300,350,0.46153846153846156,10,3,7,368.2698591781767,0.7055109922756982,-0.0048435145513756606,0.23615548653280372,134709.75894187338,3121.9087910899743,137831.66773296337,1176,1,671.3823529411765,33,1,21,30.91417286428207,0.6739267676767677,40.4718137254902,1038.1127450980398,31.457961972667874,0
1178,4,0,1,33,0.0,0.029411764705882353,0.9705882352941176,34,1000,700,300,0.7,13,7,6,369.97573906019016,0.7055109922756982,-0.038021626400769115,0.22012112282055152,131925.46323829758,2965.0017421183948,134890.46498041597,1177,2,672.3823529411765,33,1,17,33.66572726549763,0.64614898989899,43.167892156862735,1027.3284313725476,31.131164587046896,7
1179,4,0,0,33,0.0,0.0,1.0,33,850,600,250,0.7058823529411765,11,6,5,378.9471990562024,0.6925505050505051,-0.032769902666607065,0.22460631360969652,131781.48275686143,3387.644755637169,135169.12751249858,1178,37,693.6969696969697,32,1,17,33.580812428266924,0.6471354166666667,43.3080808080808,1026.767676767676,32.086489898989875,0
1180,4,0,0,33,0.0,0.0,1.0,33,450,400,50,0.8888888888888888,5,4,1,378.39064613870744,0.6919981060606061,-0.03161083352894545,0.22446762400044537,131813.89534550047,3375.4290059687723,135189.32435146923,1179,38,694.6969696969697,32,1,17,33.56233862043526,0.6474609375,43.27651515151515,1026.8939393939393,32.0904356060606,0
1181,4,0,0,33,0.0,0.0,1.0,33,900,500,400,0.5555555555555556,13,5,8,377.24750097180765,0.6934185606060607,-0.03052280642938332,0.22417154276155235,131878.7324794662,3350.1844518416256,135228.91693130785,1180,39,695.6969696969697,32,1,18,33.52617291538618,0.6481119791666667,43.21338383838383,1027.1464646464633,32.09832702020198,0
1182,4,2,2,33,0.05714285714285714,0.05714285714285714,0.9428571428571428,35,650,200,450,0.3076923076923077,11,2,9,359.0575038956501,0.7179971988795518,-0.03561480776098058,0.21685421209398648,132492.61289227675,2515.5136779932936,135008.12657027005,1181,0,656.8857142857142,33,2,19,33.374871047097564,0.6518308080808082,42.61642156862744,1029.5343137254883,31.19800950683298,0
1183,4,1,1,33,0.029411764705882353,0.029411764705882353,0.9705882352941176,34,900,700,200,0.7777777777777778,11,7,4,366.3397416270051,0.7052510398098634,-0.03332118936188111,0.22032868701291766,132334.94929834662,2895.910226835811,135230.85952518243,1182,0,677.1764705882352,33,1,19,33.34623630300142,0.6502525252525254,42.769607843137244,1028.9215686274497,31.17944147355908,0
1184,4,0,0,33,0.0,0.0,1.0,33,450,200,250,0.4444444444444444,7,2,5,374.87256188761035,0.6936553030303031,-0.023371839946425776,0.22467527715780605,132203.15728305775,3311.867252066101,135515.02453512384,1183,42,698.6969696969697,32,1,19,33.259668508287305,0.6513671875,42.897727272727266,1028.40909090909,32.137784090909065,0
1185,4,0,0,33,0.0,0.0,1.0,33,950,800,150,0.8421052631578947,11,8,3,373.63303097594934,0.6928661616161617,-0.023974716490054115,0.22489728230827083,132365.5191434548,3291.226022854812,135656.7451663096,1184,43,699.6969696969697,32,1,21,33.12781186094069,0.6529947916666667,42.73989898989899,1029.0404040404042,32.15751262626263,0
1186,4,0,1,32,0.0,0.030303030303030304,0.9696969696969697,33,900,700,200,0.7777777777777778,11,7,4,378.7568204751768,0.6933396464646465,-0.04032233354781334,0.22981011990794442,132666.15125868045,3454.24923756185,136120.4004962423,1185,44,700.6969696969697,31,2,17,32.69295584765758,0.6586021505376344,42.447916666666664,1030.2083333333326,33.2325268817204,1
1187,4,0,0,32,0.0,0.0,1.0,32,550,400,150,0.7272727272727273,7,4,3,377.9056752942246,0.6836357526881721,-0.01351244629770032,0.22970395654980744,132733.2305908203,3632.1282280815963,136365.3588189019,1186,45,719.65625,31,1,18,32.64731277904138,0.6592741935483871,42.3828125,1030.46875,33.24092741935484,0
1188,4,0,0,32,0.0,0.0,1.0,32,650,400,250,0.6153846153846154,9,4,5,378.0394662874666,0.6838877688172044,-0.013805569588279276,0.23060989938861004,132867.44011772992,3645.8272298177026,136513.2673475476,1187,46,720.65625,31,1,19,32.50873537088491,0.6606182795698925,42.252604166666664,1030.9895833333326,33.257728494623635,0
1189,4,0,0,32,0.0,0.0,1.0,32,700,600,100,0.8571428571428571,8,6,2,377.3762240975742,0.6840977822580646,-0.009354090392627246,0.2308260286545857,132968.14176771368,3635.8030531141444,136603.94482082783,1188,47,721.65625,31,1,19,32.4244887009216,0.6616263440860215,42.154947916666664,1031.3802083333328,33.27032930107525,0
1190,4,0,0,32,0.0,0.0,1.0,32,900,600,300,0.6666666666666666,12,6,6,380.53328936863875,0.6840977822580646,-0.005158379606259089,0.23338589666850557,133068.88156467007,3727.427842881939,136796.309407552,1189,48,722.65625,31,1,19,32.241712939592794,0.6626344086021505,42.057291666666664,1031.7708333333328,33.282930107526866,0
1191,4,0,0,32,0.0,0.0,1.0,32,500,200,300,0.4,8,2,6,381.0614064527868,0.6834257392473119,-0.004802233156699476,0.23413121763913095,133136.0626220703,3746.603054470485,136882.6656765408,1190,49,723.65625,31,1,20,32.1605055092943,0.6633064516129032,41.9921875,1032.03125,33.29133064516129,0
1192,4,0,0,32,0.0,0.0,1.0,32,450,300,150,0.6666666666666666,6,3,3,384.0540529320305,0.6832997311827957,-0.01145715096481248,0.2366095249182651,133236.86599731454,3834.0316772461083,137070.89767456066,1191,50,724.65625,31,1,20,31.98188611426409,0.6643145161290323,41.89453125000001,1032.4218750000007,33.303931451612925,0
1193,4,0,0,32,0.0,0.0,1.0,32,500,200,300,0.4,8,2,6,377.18545012160365,0.6832997311827957,-0.008458886618999184,0.21344772003991327,129996.88042534728,3406.5863715277833,133403.46679687506,1192,51,725.65625,31,1,20,35.435818862785155,0.6317204301075269,45.052083333333336,1019.7916666666671,32.8965053763441,7
1194,4,0,0,32,0.0,0.0,1.0,32,900,600,300,0.6666666666666666,12,6,6,376.70545618885717,0.6838877688172044,-0.012948366096502184,0.21353911315365479,130063.28158908429,3399.1095648871615,133462.39115397146,1193,52,726.65625,31,1,20,35.38049953195472,0.6323924731182795,44.98697916666667,1020.052083333334,32.90490591397852,0
1195,4,1,0,33,0.030303030303030304,0.0,1.0,33,700,400,300,0.5714285714285714,10,4,6,366.33572167321813,0.7039141414141414,-0.00870617411598995,0.20941976343566526,130391.51178770036,2953.413714161836,133344.9255018622,1194,0,705.6060606060606,32,1,21,35.31158569250424,0.6331380208333333,44.66540404040405,1021.3383838383849,31.916824494949527,0
1196,4,2,3,32,0.05714285714285714,0.08571428571428572,0.9142857142857143,35,900,600,300,0.6666666666666666,12,6,6,351.3034621056988,0.7303921568627451,-0.008748255002326344,0.20349087333292357,130901.38888888885,2197.2222222222194,133098.61111111107,1195,0,666.2285714285714,34,1,17,35.17915309446255,0.633578431372549,44.166666666666664,1023.3333333333329,30.098039215686264,0
1197,4,0,0,32,0.0,0.0,1.0,32,700,400,300,0.5714285714285714,10,4,6,382.35318413442326,0.6865759408602151,-0.005124649324152131,0.21822515793174274,130329.05578613271,3566.3458930121396,133895.40167914485,1196,55,729.65625,31,1,20,34.96610133469353,0.6350806451612904,44.72656249999999,1021.0937499999992,32.93850806451611,0
1198,4,0,0,32,0.0,0.0,1.0,32,650,400,250,0.6153846153846154,9,4,5,381.1266812659719,0.6867019489247312,-0.000633365200764624,0.2180845233064587,130428.79104614256,3541.9784545898438,133970.76950073242,1197,56,730.65625,31,1,20,34.896032504780116,0.6360887096774194,44.62890625,1021.4843749999999,32.95110887096774,0
1199,4,2,1,33,0.058823529411764705,0.029411764705882353,0.9705882352941176,34,750,500,250,0.6666666666666666,10,5,5,369.60484253130073,0.7082590612002377,-0.035528017084828334,0.21287766819477053,130681.82615294353,2895.226608788568,133577.0527617321,1198,0,688.6176470588235,32,2,17,34.93352268049724,0.6360677083333334,44.38131313131313,1022.4747474747471,31.952335858585847,4
1200,4,1,1,33,0.029411764705882353,0.029411764705882353,0.9705882352941176,34,600,400,200,0.6666666666666666,8,4,4,369.0507739478888,0.7119726678550209,-0.03042095633612607,0.2132702832044076,130810.95838434855,2855.1770865217836,133666.13547087033,1199,0,689.5882352941177,32,2,17,34.81676335061301,0.6373697916666666,44.255050505050505,1022.9797979797981,31.968118686868692,0
1201,4,2,0,35,0.05714285714285714,0.0,1.0,35,600,400,200,0.6666666666666666,8,4,4,359.90481856038065,0.7200980392156863,-0.002555168408826747,0.2108013937282231,131328.12500000012,2453.125000000013,133781.25000000012,1200,0,670.8285714285714,33,2,20,34.52743902439024,0.6401515151515151,43.75000000000001,1025.000000000001,31.060606060606087,0
1202,4,1,0,36,0.027777777777777776,0.0,1.0,36,800,500,300,0.625,11,5,6,351.53946614284223,0.7301256613756614,0.006428101921663876,0.2077191047030464,131663.90483276665,2057.0117630385707,133720.91659580523,1201,0,653.1666666666666,34,2,16,34.40291149518617,0.6412377450980391,43.42261904761906,1026.3095238095254,30.185574229691923,0
1203,4,1,0,37,0.02702702702702703,0.0,1.0,37,950,800,150,0.8421052631578947,11,8,3,344.1621770770268,0.7456831831831832,0.005119885061320328,0.20522605576003528,132011.15779588927,1686.6494930984506,133697.80728898774,1202,0,636.4864864864865,35,2,17,34.242430641588776,0.6425595238095236,43.084490740740755,1027.6620370370388,29.361772486772537,0
1204,4,0,0,37,0.0,0.0,1.0,37,700,500,200,0.7142857142857143,9,5,4,341.3659478659396,0.7460585585585585,0.002696311895726611,0.20387834451899212,132070.63567654765,1616.8835465963866,133687.51922314405,1203,1,637.4864864864865,35,2,17,34.25442423901212,0.6431547619047618,43.02662037037038,1027.8935185185198,29.368386243386283,0
1205,4,0,1,36,0.0,0.02702702702702703,0.972972972972973,37,1150,900,250,0.782608695652174,14,9,5,342.89919717447145,0.7460585585585585,-0.005756659186261892,0.2020916545049543,131565.5006858709,1622.7409122084916,133188.2415980794,1204,2,638.4864864864865,35,2,18,34.72378910950663,0.6380952380952382,43.51851851851851,1025.9259259259247,29.312169312169278,1
1206,4,0,0,36,0.0,0.0,1.0,36,850,700,150,0.8235294117647058,10,7,3,350.8302469776104,0.7388227513227513,-0.0059825586645509965,0.20597824929912462,131419.65880102038,2021.198270975055,133440.85707199544,1205,3,657.0555555555555,34,2,21,34.667556793993576,0.6387867647058822,43.660714285714285,1025.3571428571427,30.157563025210077,0
1207,4,0,0,36,0.0,0.0,1.0,36,650,500,150,0.7692307692307693,8,5,3,352.912606303053,0.7387566137566138,-0.009138911454101617,0.2078638365354343,131541.7534722221,2084.5486111111068,133626.3020833332,1206,4,658.0555555555555,34,2,21,34.49092878418631,0.6400122549019608,43.541666666666664,1025.8333333333326,30.17156862745096,0
1208,4,0,0,36,0.0,0.0,1.0,36,1000,600,400,0.6,14,6,8,354.53485930846625,0.7379960317460318,-0.004285898427429657,0.20932126624924516,131633.36167800447,2133.723072562352,133767.0847505668,1207,5,659.0555555555555,34,2,18,34.35687354988399,0.6409313725490196,43.45238095238095,1026.1904761904757,30.182072829131638,0
1209,4,0,0,36,0.0,0.0,1.0,36,900,600,300,0.6666666666666666,12,6,6,354.3625611401587,0.7363425925925926,-0.009469696969696573,0.20989167082917087,131755.55555555545,2137.847222222212,133893.40277777766,1208,6,660.0555555555555,34,2,18,34.2380275974026,0.6421568627450981,43.33333333333333,1026.6666666666658,30.196078431372523,0
1210,4,1,2,35,0.02702702702702703,0.05405405405405406,0.9459459459459459,37,750,200,550,0.26666666666666666,13,2,11,345.93654108686684,0.7501251251251251,-0.010211631029475088,0.20596101108169793,131951.69331114966,1729.382474922831,133681.0757860725,1209,0,643.1891891891892,35,2,18,34.256716796214924,0.6419642857142858,43.14236111111111,1027.4305555555552,29.35515873015872,0
1211,4,0,0,35,0.0,0.0,1.0,35,700,300,400,0.42857142857142855,11,3,8,361.12935438547373,0.7235994397759103,-0.005833609545906615,0.21321472841114963,131633.3616780046,2507.334183673477,134140.6958616781,1210,8,680.7142857142857,34,1,18,34.18769334880124,0.6409313725490196,43.452380952380956,1026.1904761904768,30.18207282913167,0
1212,4,0,0,35,0.0,0.0,1.0,35,700,500,200,0.7142857142857143,9,5,4,363.3664987491608,0.7239495798319328,-0.004122344832156788,0.2148796949393185,131694.45153061225,2570.670351473929,134265.12188208618,1211,9,681.7142857142857,34,1,18,34.068613237454585,0.6415441176470588,43.392857142857146,1026.4285714285716,30.189075630252105,0
1213,4,0,0,35,0.0,0.0,1.0,35,800,400,400,0.5,12,4,8,363.84625078764947,0.7231792717086835,0.000530020703933598,0.21568205587927683,131786.1128826531,2589.976615646262,134376.08949829938,1212,10,682.7142857142857,34,1,18,33.96376811594202,0.6424632352941175,43.30357142857143,1026.7857142857147,30.199579831932784,0
1214,4,0,1,34,0.0,0.02857142857142857,0.9714285714285714,35,850,700,150,0.8235294117647058,10,7,3,364.23820064655627,0.722829131652661,0.00031127889264181974,0.21643575724369762,131877.8061224491,2606.9869614512627,134484.79308390038,1213,11,683.7142857142857,34,1,18,33.86116906196877,0.6433823529411764,43.21428571428572,1027.1428571428582,30.210084033613477,0
1215,4,0,0,34,0.0,0.0,1.0,34,1250,1000,250,0.8,15,10,5,373.79486332385886,0.7051396316102199,0.004309981749262892,0.2218414273834233,131831.05656478275,3055.5543540945755,134886.61091887733,1214,14,704.5,33,1,19,33.66298727128082,0.6452020202020202,43.259803921568626,1026.9607843137253,31.120023767082586,0
1216,4,0,1,33,0.0,0.029411764705882353,0.9705882352941176,34,650,400,250,0.6153846153846154,9,4,5,373.7273559961541,0.702688651218063,-0.003620341266277416,0.22253765288861896,131956.93963860048,3063.1836312956475,135020.12326989614,1215,15,705.5,33,1,19,33.53759144402035,0.6464646464646465,43.13725490196078,1027.4509803921565,31.13487819370171,0
1217,4,0,0,33,0.0,0.0,1.0,33,500,300,200,0.6,7,3,4,372.2425127830532,0.6934185606060607,0.0182637182637182,0.22214472537053181,132040.89506172843,3230.24691358025,135271.14197530868,1216,16,724.3939393939394,32,1,19,33.490990990990994,0.6497395833333334,43.05555555555556,1027.777777777778,32.118055555555564,0
1218,4,0,0,33,0.0,0.0,1.0,33,950,600,350,0.631578947368421,13,6,7,369.9633958845452,0.6928661616161617,0.020152389885838007,0.22097373484197225,132073.33953486884,3172.460240026522,135245.79977489536,1217,17,725.3939393939394,32,1,19,33.516818163206814,0.6500651041666667,43.023989898989896,1027.90404040404,32.12200126262625,0
1219,4,0,0,33,0.0,0.0,1.0,33,750,500,250,0.6666666666666666,10,5,5,372.60394976211853,0.6928661616161617,0.025156390132442974,0.2229326938216701,132138.2404378379,3247.0460603509755,135385.28649818889,1218,18,726.3939393939394,32,1,19,33.383478652421296,0.6507161458333335,42.96085858585858,1028.1565656565651,32.12989267676766,0
1220,4,0,0,33,0.0,0.0,1.0,33,1100,800,300,0.7272727272727273,14,8,6,372.4533176008208,0.6908933080808082,0.021823537287454897,0.22380159526633384,132300.5624426078,3255.15668044076,135555.71912304856,1219,19,727.3939393939394,32,1,19,33.22364383897888,0.65234375,42.8030303030303,1028.787878787878,32.14962121212119,0
1221,4,2,1,34,0.05714285714285714,0.02857142857142857,0.9714285714285714,35,1300,900,400,0.6923076923076923,17,9,8,352.516617445524,0.7163165266106442,0.02231204527081676,0.2148093870837995,132827.17013888876,2364.7569444444257,135191.9270833332,1220,0,686.7714285714286,34,1,18,33.20701967124764,0.6528799019607844,42.29166666666666,1030.8333333333321,30.318627450980358,0
1222,4,1,0,35,0.02857142857142857,0.0,1.0,35,1050,600,450,0.5714285714285714,15,6,9,350.08294689437764,0.7122549019607842,0.03347843292441621,0.2142032946252038,132980.61224489784,2310.848922902472,135291.46116780033,1221,0,687.7428571428571,34,1,19,33.11571829793781,0.6544117647058825,42.14285714285713,1031.4285714285704,30.336134453781483,0
1223,4,0,0,35,0.0,0.0,1.0,35,900,600,300,0.6666666666666666,12,6,6,350.6752175114499,0.7116246498599439,0.021561228021027334,0.21545028069502184,133134.14292800447,2337.3689058956797,135471.51183390015,1222,1,688.7428571428571,34,1,19,32.94641827200368,0.6559436274509804,41.99404761904761,1032.023809523809,30.353641456582615,0
1224,4,0,0,35,0.0,0.0,1.0,35,650,500,150,0.7692307692307693,8,5,3,350.6752175114499,0.7116246498599439,0.021561228021027334,0.21545028069502184,133134.14292800447,2337.3689058956797,135471.51183390015,1223,2,689.7428571428571,34,1,19,32.94641827200368,0.6559436274509804,41.99404761904761,1032.023809523809,30.353641456582615,0
1225,4,0,0,35,0.0,0.0,1.0,35,850,600,250,0.7058823529411765,11,6,5,350.64913007155155,0.7123249299719887,0.02141127238578533,0.2157898230553882,133195.58000283432,2340.9828514739097,135536.56285430823,1224,3,690.7428571428571,34,1,20,32.885480336754696,0.6565563725490197,41.9345238095238,1032.2619047619037,30.36064425770305,0
1226,4,1,0,36,0.027777777777777776,0.0,1.0,36,900,700,200,0.7777777777777778,11,7,4,345.1349712075733,0.7182539682539683,0.01773559313597417,0.21415636955610973,133502.12358807,2015.2503161436741,135517.3739042137,1225,0,672.5277777777778,35,1,21,32.720746070855256,0.6574404761904762,41.637731481481474,1033.449074074073,29.52711640211637,0
1227,4,1,0,37,0.02702702702702703,0.0,1.0,37,650,300,350,0.46153846153846156,10,3,7,337.40951481256064,0.72754004004004,0.022299430158361,0.21101301651347826,133792.42153893763,1628.5672074101117,135420.98874634775,1226,0,655.3243243243244,36,1,19,32.63012046007037,0.658275462962963,41.35698198198198,1034.5720720720724,28.738113113113123,0
1228,4,0,1,36,0.0,0.02702702702702703,0.972972972972973,37,1300,1000,300,0.7692307692307693,16,10,6,339.05959666978777,0.7266641641641641,0.020991294786574022,0.21305364813297045,133967.23740209802,1684.57549610421,135651.81289820222,1227,1,656.3243243243244,36,1,20,32.41279596794663,0.6600115740740742,41.18806306306306,1035.2477477477476,28.756881881881878,0
1229,4,0,0,36,0.0,0.0,1.0,36,500,100,400,0.2,9,1,8,345.4655017755238,0.7184854497354498,0.021699543821705358,0.2161032974367674,133801.3214404363,2044.7481299296917,135846.06957036597,1228,2,675.5,35,1,20,32.4128584479994,0.6604166666666667,41.348379629629626,1034.6064814814808,29.560185185185166,0
1230,4,0,0,36,0.0,0.0,1.0,36,550,400,150,0.7272727272727273,7,4,3,345.47993333633633,0.7188492063492063,0.019276659209545688,0.21628785742484913,133831.25964506165,2047.2029320987622,135878.46257716042,1229,3,676.5,35,1,21,32.38255033557047,0.6607142857142857,41.31944444444444,1034.7222222222217,29.56349206349205,0
1231,4,1,1,36,0.02702702702702703,0.02702702702702703,0.972972972972973,37,600,400,200,0.6666666666666666,8,4,4,335.8763601853483,0.725975975975976,0.01577066409602268,0.2115560964564699,134054.68813407992,1605.160143251342,135659.84827733127,1230,0,659.1891891891892,36,1,21,32.40788567493113,0.6608796296296298,41.103603603603595,1035.5855855855846,28.76626626626624,0
1232,4,0,1,35,0.0,0.027777777777777776,0.9722222222222222,36,750,500,250,0.6666666666666666,10,5,5,345.6262520642075,0.7182208994708995,0.05835481678145915,0.21130276793452582,132949.91673752837,1991.1125324856087,134941.02927001397,1231,5,678.5,34,2,18,33.26142791180885,0.6541053921568627,42.17261904761905,1031.309523809524,30.332633053221297,4
1233,4,0,0,35,0.0,0.0,1.0,35,1050,800,250,0.7619047619047619,13,8,5,354.1100420708699,0.7162464985994397,0.06740901683867495,0.21658358387125298,132966.16685890043,2416.930988081506,135383.09784698192,1232,6,695.2857142857143,33,2,18,33.026378326996195,0.6565656565656566,42.15686274509804,1031.3725490196077,31.25371360665478,0
1234,4,0,0,35,0.0,0.0,1.0,35,500,300,200,0.6,7,3,4,353.22275012494674,0.7147058823529411,0.07194790206907964,0.2163021293167958,133011.31129535136,2396.524234693869,135407.83553004524,1233,7,696.2857142857143,34,1,18,33.00394306597424,0.654718137254902,42.113095238095234,1031.5476190476181,30.339635854341708,0
1235,4,0,0,35,0.0,0.0,1.0,35,550,200,350,0.36363636363636365,9,2,7,353.74163863232445,0.7139355742296918,0.07532887145165046,0.2167980933796126,133042.01388888882,2412.499999999991,135454.51388888882,1234,8,697.2857142857143,34,1,18,32.95974690360797,0.6550245098039216,42.08333333333333,1031.666666666666,30.343137254901944,0
1236,4,0,0,35,0.0,0.0,1.0,35,1250,1000,250,0.8,15,10,5,358.1733984208257,0.7142156862745097,0.08131437140550046,0.22005706526648747,133134.1429280045,2537.021683673458,135671.16461167796,1235,9,698.2857142857143,34,1,19,32.75296074133885,0.6559436274509804,41.99404761904761,1032.0238095238092,30.353641456582622,0
1237,4,0,1,34,0.0,0.02857142857142857,0.9714285714285714,35,950,700,250,0.7368421052631579,12,7,5,356.4474722188022,0.7141456582633052,0.07798916176640147,0.21972060600950058,133257.03125,2499.82638888889,135756.85763888888,1236,10,699.2857142857143,34,1,20,32.67419962335217,0.6571691176470589,41.875,1032.5,30.36764705882353,0
1238,4,0,0,34,0.0,0.0,1.0,34,650,500,150,0.7692307692307693,8,5,3,364.7045548151953,0.7047311348781937,0.08520329747100774,0.22382014224081215,133092.5905901576,2907.8948000768887,136000.4853902345,1237,16,720.5588235294117,33,1,20,32.626187648456074,0.6578282828282829,42.03431372549019,1031.8627450980389,31.268568033273905,0
1239,4,1,1,34,0.02857142857142857,0.02857142857142857,0.9714285714285714,35,700,400,300,0.5714285714285714,10,4,6,356.19860287766835,0.717436974789916,0.0760499843593081,0.22029474534351595,133379.97626133784,2501.9522392290237,135881.92850056686,1238,0,700.9428571428572,34,1,21,32.557335484614484,0.6583946078431373,41.75595238095238,1032.9761904761904,30.38165266106442,0
1240,4,0,0,34,0.0,0.0,1.0,34,750,600,150,0.8,9,6,3,366.05270804532967,0.7030600118835414,0.0863292023040676,0.22560307719692013,133250.7047319538,2955.356263216045,136206.06099516983,1239,18,722.5588235294117,33,1,21,32.43261622156282,0.6594065656565657,41.88112745098038,1032.4754901960764,31.28713606654777,0
1241,4,0,0,34,0.0,0.0,1.0,34,900,600,300,0.6666666666666666,12,6,6,364.2231256217908,0.7020944741532977,0.0881655153164469,0.225433256166791,133408.91273788913,2918.122236639738,136327.03497452885,1240,19,723.5588235294117,33,1,23,32.321075523922495,0.6609848484848486,41.72794117647058,1033.0882352941167,31.305704099821718,0
1242,4,0,0,34,0.0,0.0,1.0,34,550,300,250,0.5454545454545454,8,3,5,363.8544902644205,0.7022801544860369,0.08423839119425769,0.22578255455480903,133503.8825962369,2915.197430074952,136419.08002631183,1241,20,724.5588235294117,33,1,23,32.23534032965731,0.6619318181818183,41.636029411764696,1033.45588235294,31.316844919786064,0
1243,4,1,1,34,0.02857142857142857,0.02857142857142857,0.9714285714285714,35,1100,700,400,0.6363636363636364,15,7,8,356.80988556084344,0.7135854341736694,0.07991056014994391,0.22288433469720795,133749.15143140563,2544.60388321993,136293.75531462557,1242,0,704.8285714285714,34,1,20,32.17166340583881,0.6620710784313726,41.39880952380951,1034.4047619047599,30.423669467787054,0
1244,4,0,0,34,0.0,0.0,1.0,34,1150,800,350,0.6956521739130435,15,8,7,362.0798663370821,0.7019830659536542,0.042856340914034785,0.2154233867639288,131925.46323829758,2753.510819156072,134678.97405745366,1243,22,726.5588235294117,33,1,16,33.86851862897132,0.64614898989899,43.167892156862735,1027.3284313725476,31.131164587046896,8
1245,4,1,0,35,0.02857142857142857,0.0,1.0,35,850,600,250,0.7058823529411765,11,6,5,355.28897397847317,0.7145658263305321,0.05298376698515561,0.21351928463991385,132306.1295351472,2401.381802721066,134707.51133786826,1244,0,706.7714285714286,34,1,17,33.659502044279876,0.6476715686274511,42.79761904761904,1028.8095238095223,30.259103641456537,0
1246,4,0,1,34,0.0,0.02857142857142857,0.9714285714285714,35,1100,1000,100,0.9090909090909091,12,10,2,353.5204081632655,0.7150560224089635,0.04719727891156489,0.21333128078817726,132461.07266435976,2365.570382564779,134826.64304692452,1245,1,707.7714285714286,33,2,19,33.549107142857146,0.6515151515151516,42.647058823529406,1029.4117647058815,31.19429590017823,0
1247,4,1,0,35,0.02857142857142857,0.0,1.0,35,750,300,450,0.4,12,3,9,346.80278614933576,0.7245798319327731,0.040470417470764186,0.21167434325859008,132888.53635204062,2217.2229308389815,135105.75928287962,1246,0,674.4857142857143,34,1,16,33.29268175345419,0.6534926470588236,42.23214285714285,1031.071428571427,30.325630252100797,0
1248,4,0,0,35,0.0,0.0,1.0,35,700,500,200,0.7142857142857143,9,5,4,331.81307422830304,0.7254901960784313,0.012078977932636237,0.19434765776229182,131328.12500000006,1715.27777777778,133043.40277777784,1247,1,675.4857142857143,35,0,17,35.247289972899715,0.6357142857142857,43.75,1025.0000000000005,29.2857142857143,8
1249,4,0,1,34,0.0,0.02857142857142857,0.9714285714285714,35,1000,800,200,0.8,12,8,4,329.6770938960196,0.7263305322128851,0.014627539503385911,0.19369622360203811,131446.78605109747,1666.9988854595358,133113.784936557,1248,2,676.4857142857143,35,0,19,35.18246802106847,0.6369047619047619,43.63425925925926,1025.4629629629635,29.298941798941815,0
1250,4,0,0,34,0.0,0.0,1.0,34,750,600,150,0.8,9,6,3,338.82562457989303,0.7105243612596555,0.02068148127907521,0.198613169044075,131358.63272392296,2101.534155328799,133460.16687925174,1249,5,697.3235294117648,34,0,19,35.03682305578135,0.6381740196078431,43.720238095238095,1025.119047619048,30.150560224089645,0
1251,4,1,1,34,0.02857142857142857,0.02857142857142857,0.9714285714285714,35,550,300,250,0.5454545454545454,8,3,5,331.1438639586037,0.721078431372549,0.018562083078211833,0.1954674765550588,131624.8780971366,1717.3541452332054,133342.2322423698,1250,0,678.3714285714286,35,0,18,34.96550492518233,0.6386904761904761,43.46064814814815,1026.1574074074083,29.318783068783095,0
1252,4,1,1,34,0.02857142857142857,0.02857142857142857,0.9714285714285714,35,850,600,250,0.7058823529411765,11,6,5,330.59531362151193,0.7187675070028011,0.01832385677238557,0.19560038936018623,131713.96933138304,1708.8041998885674,133422.7735312716,1251,0,679.3428571428572,35,0,18,34.88990209343406,0.6395833333333332,43.3738425925926,1026.504629629631,29.32870370370374,0
1253,4,0,0,34,0.0,0.0,1.0,34,500,200,300,0.4,8,2,6,337.7347047997143,0.7111928104575164,0.019233526066803952,0.19892412517150657,131541.7534722224,2085.243055555581,133626.99652777798,1252,8,700.3235294117648,34,0,20,34.880178716490654,0.6400122549019607,43.54166666666668,1025.8333333333348,30.171568627451023,0
1254,4,0,0,34,0.0,0.0,1.0,34,650,500,150,0.7692307692307693,8,5,3,339.9669007675715,0.7094474153297683,0.025311446777737112,0.20104215489835406,131694.45153061225,2154.3509070294854,133848.80243764175,1253,9,701.3235294117648,34,0,19,34.66906363566072,0.6415441176470588,43.392857142857146,1026.4285714285716,30.189075630252105,0
1255,4,0,0,34,0.0,0.0,1.0,34,850,600,250,0.7058823529411765,11,6,5,339.86812700286714,0.7097445038621509,0.02291825821237592,0.20130650599400607,131755.5555555557,2155.9027777777987,133911.45833333352,1254,10,702.3235294117648,34,0,19,34.61005140692641,0.642156862745098,43.33333333333334,1026.666666666668,30.19607843137259,0
1256,4,0,0,34,0.0,0.0,1.0,34,650,500,150,0.7692307692307693,8,5,3,339.31832351946616,0.7082219251336899,0.028518536196210142,0.2014658759120739,131847.23816609982,2147.6367630385525,133994.87492913837,1255,11,703.3235294117648,34,0,20,34.53184768749276,0.6430759803921569,43.24404761904762,1027.0238095238099,30.20658263305323,0
1257,4,0,0,34,0.0,0.0,1.0,34,750,500,250,0.6666666666666666,10,5,5,363.8707118778506,0.7098187759952467,0.011238641798183124,0.21312427409988383,131328.12499999997,2810.894982993196,134139.01998299317,1256,12,704.3235294117648,33,1,20,34.42581300813009,0.6401515151515151,43.75,1024.9999999999998,31.060606060606055,6
1258,4,1,1,34,0.02857142857142857,0.02857142857142857,0.9714285714285714,35,950,700,250,0.7368421052631579,12,7,5,355.49524532161485,0.72093837535014,0.013024673968880185,0.21005651198887215,131663.90483276662,2361.1784297052363,134025.08326247186,1257,0,685.1714285714286,34,1,17,34.301415149054634,0.6412377450980391,43.42261904761906,1026.3095238095252,30.18557422969192,0
1259,4,1,1,34,0.02857142857142857,0.02857142857142857,0.9714285714285714,35,600,300,300,0.5,9,3,6,352.77266787247606,0.7218487394957983,0.005964115902652445,0.20878234145946226,131725.00177154213,2293.7960600907227,134018.79783163284,1258,0,686.1428571428571,34,1,17,34.30964668135605,0.6418504901960783,43.36309523809525,1026.5476190476204,30.192577030812366,0
1260,4,1,0,35,0.02857142857142857,0.0,1.0,35,500,200,300,0.4,8,2,6,353.1564820769929,0.7182072829131653,0.02588975335209409,0.21018899588444487,131938.95266439923,2319.0192743764314,134257.97193877565,1259,0,687.1142857142858,34,1,18,34.084105832367705,0.6439950980392156,43.15476190476191,1027.3809523809534,30.217086834733923,0
1261,4,0,0,35,0.0,0.0,1.0,35,900,700,200,0.7777777777777778,11,7,4,357.5289852074605,0.7201680672268908,0.028922201264105496,0.21347892519233846,132061.2882653062,2443.147675736973,134504.4359410432,1260,1,688.1142857142858,34,1,18,33.84849625511544,0.645220588235294,43.03571428571429,1027.8571428571436,30.231092436974812,0
1262,4,0,0,35,0.0,0.0,1.0,35,800,500,300,0.625,11,5,6,352.9450799635284,0.7204481792717087,0.0060946164221606924,0.20172657168601665,130384.14292800448,2203.6883503401295,132587.83127834462,1261,2,689.1142857142858,34,1,19,35.66096475890741,0.6283700980392157,44.672619047619044,1021.3095238095234,30.038515406162453,2
1263,4,0,0,35,0.0,0.0,1.0,35,950,700,250,0.7368421052631579,12,7,5,365.0547348283558,0.7204481792717087,0.012017673048601019,0.1945621388920357,127617.73003472216,2317.491319444433,129935.2213541666,1262,3,690.1142857142858,35,0,19,38.17439862542954,0.5982142857142857,47.39583333333333,1010.4166666666661,28.869047619047603,5
1264,4,0,0,35,0.0,0.0,1.0,35,700,500,200,0.7142857142857143,9,5,4,368.78691777485983,0.7205882352941176,0.018846934101171664,0.19683663606418575,127676.20991941025,2417.0631858710676,130093.27310528132,1263,4,691.1142857142858,35,0,19,38.02011757520231,0.5988095238095237,47.33796296296297,1010.648148148149,28.875661375661398,0
1265,4,3,0,38,0.07894736842105263,0.0,1.0,38,600,400,200,0.6666666666666666,8,4,4,347.09801317360984,0.7613205310573732,0.044530484984290686,0.18922997469906622,128525.67361379019,1324.773207090182,129850.44682088037,1264,0,637.4736842105264,35,3,15,37.699867785260444,0.6074404761904761,46.49884259259259,1014.0046296296288,28.971560846560823,0
1266,4,2,2,38,0.05,0.05,0.95,40,750,600,150,0.8,9,6,3,331.65674950176333,0.7772970085470086,0.040315704263357066,0.18301368577330776,129006.37846500849,557.1672293398012,129563.54569434829,1265,0,606.55,37,3,15,37.60197427594892,0.6083896396396395,46.02521929824562,1015.8991228070178,27.456733048838316,0
1267,4,0,0,38,0.0,0.0,1.0,38,850,500,350,0.5882352941176471,12,5,7,346.8791276597984,0.7585348506401138,0.04005150894802867,0.18994936365980325,128701.77636584778,1328.7919828103406,130030.56834865813,1266,2,639.4736842105264,35,3,16,37.52578324018098,0.6092261904761905,46.325231481481474,1014.699074074073,28.991402116402085,0
1268,4,0,0,38,0.0,0.0,1.0,38,800,600,200,0.75,10,6,4,344.95498866022524,0.7567271218587008,0.0340205343123805,0.18977786044839862,128886.73460200077,1292.0244146173352,130178.7590166181,1267,3,640.4736842105264,36,2,17,37.386094783926666,0.6090856481481481,46.143018018018026,1015.427927927929,28.20633133133136,0
1269,4,3,2,39,0.07317073170731707,0.04878048780487805,0.9512195121951219,41,750,500,250,0.6666666666666666,10,5,5,325.0250064374502,0.7805386178861788,0.05180628588538738,0.1820375277308902,129591.85157933187,224.88571559409678,129816.73729492596,1268,0,594.5365853658536,37,4,13,37.17603560916074,0.6143018018018018,45.44956140350876,1018.201754385963,27.518966334755756,0
1270,4,3,3,39,0.07142857142857142,0.07142857142857142,0.9285714285714286,42,1300,1100,200,0.8461538461538461,15,11,4,318.7581338647792,0.7871660859465738,0.06085765193825132,0.17985046453009185,129881.14458917717,-119.8657453064817,129761.27884387069,1269,0,581.3095238095239,38,4,13,37.042544457254635,0.6154057017543861,45.165598290598275,1019.3376068376047,26.824673864147492,0
1271,4,1,1,39,0.025,0.025,0.975,40,1100,800,300,0.7272727272727273,14,8,6,331.0876083656397,0.7711004273504274,0.06559304703476543,0.18609406952965216,129731.44531249956,590.4947916666225,130321.94010416619,1270,0,611.35,37,3,13,36.88011247443765,0.6157094594594597,45.31249999999998,1018.7499999999965,27.53378378378369,0
1272,4,0,1,38,0.0,0.02564102564102564,0.9743589743589743,39,900,800,100,0.8888888888888888,10,8,2,338.2441933481667,0.7634390463337832,0.07218251042952262,0.18957597004371862,129619.76431450027,968.6265245075027,130588.39083900777,1271,3,628.025641025641,37,2,13,36.81120114138042,0.6145833333333335,45.422149122807,1018.3114035087692,27.52192982456133,0
1273,4,3,1,40,0.07317073170731707,0.024390243902439025,0.975609756097561,41,1200,1000,200,0.8333333333333334,14,10,4,327.89683719732204,0.7789126016260163,0.09122817498842473,0.18656987287220417,130209.42382812472,339.05164930552553,130548.47547743024,1272,0,598.1463414634146,39,2,16,36.47725726338708,0.6169871794871796,44.843749999999986,1020.6249999999978,26.16987179487174,0
1274,4,1,1,40,0.024390243902439025,0.024390243902439025,0.975609756097561,41,1100,800,300,0.7272727272727273,14,8,6,328.8819578628605,0.772510162601626,0.10473457675753206,0.18819805402029524,130430.54112803933,379.2720476492685,130809.8131756886,1273,0,599.1219512195122,37,4,18,36.22844210676971,0.6227477477477478,44.62719298245614,1021.4912280701749,27.607871028923647,0
1275,4,0,0,40,0.0,0.0,1.0,40,1000,700,300,0.7,13,7,6,332.97747995880366,0.7610309829059829,0.10074988972209997,0.19014104460116055,130348.82010388761,680.6443267591854,131029.4644306468,1274,1,614.875,36,4,18,36.20653212762829,0.6238425925925927,44.707207207207205,1021.1711711711707,28.365865865865853,0
1276,4,1,2,39,0.024390243902439025,0.04878048780487805,0.9512195121951219,41,900,600,300,0.6666666666666666,12,6,6,301.8839631239102,0.7708841463414634,0.030222209014657997,0.17793268418955077,131568.4692382814,-256.31781684026294,131312.15142144114,1275,0,600.8536585365854,39,2,12,35.772773039564086,0.6306089743589742,43.51562500000001,1025.9375000000011,26.306089743589773,7
1277,4,1,1,39,0.025,0.025,0.975,40,1100,900,200,0.8181818181818182,13,9,4,308.89639555641213,0.7573450854700855,0.03487088713036268,0.18222610460219793,131602.03904594926,130.27910183358892,131732.31814778285,1276,0,616.775,38,2,13,35.55918540885744,0.6326754385964912,43.48290598290598,1026.0683760683758,27.001799370220414,0
1278,4,1,1,39,0.025,0.025,0.975,40,1000,600,400,0.6,14,6,8,307.3619028523545,0.7598290598290598,0.04142210427724069,0.18197415431351063,131739.10307774504,98.31628040764815,131837.4193581527,1277,0,617.75,38,2,13,35.46089603496722,0.6340460526315788,43.349358974358985,1026.6025641025653,27.01585695006751,0
1279,4,0,1,38,0.0,0.02564102564102564,0.9743589743589743,39,850,500,350,0.5882352941176471,12,5,7,316.89055023920696,0.7510683760683761,0.0493319967791237,0.18753029907329066,131721.78578985855,548.2778354878561,132270.0636253464,1278,5,634.5897435897435,37,2,14,35.23374635049491,0.6356981981981982,43.366228070175445,1026.5350877192993,27.74419155998106,0
1280,4,1,1,38,0.02564102564102564,0.02564102564102564,0.9743589743589743,39,700,400,300,0.5714285714285714,10,4,6,317.07318518980566,0.7537674313990104,0.05846569972130511,0.18819438862406349,131834.3685076178,560.2286280394036,132394.59713565718,1279,0,635.4102564102565,37,2,14,35.115933518399885,0.6368243243243243,43.256578947368425,1026.973684210527,27.75604551920343,0
1281,4,0,0,38,0.0,0.0,1.0,38,600,300,300,0.5,9,3,6,326.8210881318099,0.745791844476055,0.05765222161272621,0.19331435550431222,131703.53366457694,1008.6984366123108,132712.23210118926,1280,7,653.1315789473684,36,2,14,34.99725726823917,0.6374421296296295,43.38400900900902,1026.4639639639654,28.512887887887928,0
1282,4,0,0,38,0.0,0.0,1.0,38,850,600,250,0.7058823529411765,11,6,5,328.3668714171885,0.7458807491702228,0.05498089377864468,0.1946715951613739,131790.24252292863,1055.1099241133395,132845.35244704198,1281,8,654.1315789473684,36,2,14,34.87035716896981,0.6383101851851851,43.29954954954957,1026.8018018018042,28.52227227227234,0
1283,4,0,0,38,0.0,0.0,1.0,38,850,300,550,0.35294117647058826,14,3,11,328.182753568311,0.7462660028449503,0.05465986531947631,0.1950068335698094,131876.97991488155,1055.9500801477661,132932.92999502932,1282,9,655.1315789473684,36,2,14,34.787852209187584,0.6391782407407405,43.215090090090115,1027.1396396396433,28.531656656656757,0
1284,4,0,0,38,0.0,0.0,1.0,38,1150,900,250,0.782608695652174,14,9,5,326.6010450587654,0.7469476055002371,0.04964350815662577,0.19451096182220518,131963.74584043544,1019.8994602711326,132983.6453007066,1283,10,656.1315789473684,36,2,14,34.74125018266843,0.6400462962962961,43.130630630630655,1027.4774774774808,28.541041041041133,0
1285,4,0,0,38,0.0,0.0,1.0,38,650,400,250,0.6153846153846154,9,4,5,325.9252833742098,0.7453176861071598,0.048470991217498094,0.194553306825142,132050.54029959056,1007.7219533723419,133058.26225296292,1284,11,657.1315789473684,36,2,15,34.67139622365875,0.6409143518518516,43.046171171171196,1027.8153153153187,28.55042542542552,0
1286,4,0,0,38,0.0,0.0,1.0,38,1100,800,300,0.7272727272727273,14,8,6,324.3302026889779,0.746384542437174,0.04165057887245194,0.19449164419950374,132224.21481870415,976.8612785082729,133201.0760972124,1285,12,658.1315789473684,36,2,15,34.53798496295486,0.6426504629629628,42.87725225225227,1028.4909909909934,28.56919419419426,0
1287,4,0,0,38,0.0,0.0,1.0,38,1050,700,350,0.6666666666666666,14,7,7,324.94538015670855,0.7457325746799431,0.03739278699100779,0.19545924545700116,132340.06123944905,1000.6583018829796,133340.71954133202,1286,13,659.1315789473684,36,2,17,34.405895443435135,0.6438078703703702,42.76463963963965,1028.9414414414425,28.581706706706736,0
1288,4,0,0,38,0.0,0.0,1.0,38,850,700,150,0.8235294117647058,10,7,3,323.91751935608994,0.7456436699857752,0.04006103881147105,0.19529064161706222,132426.97934420916,979.0837289992853,133406.06307320844,1287,14,660.1315789473684,36,2,18,34.345140408460985,0.6446759259259258,42.68018018018019,1029.27927927928,28.591091091091112,0
1289,4,0,0,38,0.0,0.0,1.0,38,1000,500,500,0.5,15,5,10,324.56619250777834,0.7435099573257468,0.04475353044759256,0.19658823819047305,132600.90115453306,1007.5539221654233,133608.45507669848,1288,15,661.1315789473684,36,2,20,34.154047306654995,0.646412037037037,42.51126126126127,1029.954954954956,28.609859859859892,0
1290,4,0,0,38,0.0,0.0,1.0,38,1050,700,350,0.6666666666666666,14,7,7,324.56619250777834,0.7431839734471314,0.04475353044759256,0.19658823819047305,132600.90115453306,1007.5539221654233,133608.45507669848,1289,16,662.1315789473684,36,2,20,34.154047306654995,0.646412037037037,42.51126126126127,1029.954954954956,28.609859859859892,0
1291,4,0,0,38,0.0,0.0,1.0,38,850,600,250,0.7058823529411765,11,6,5,322.8553281804783,0.7422949265054528,0.03985915817089736,0.19585414736041232,132658.90045450866,965.9265684603713,133624.82702296902,1290,17,663.1315789473684,36,2,14,34.13997595102755,0.6469907407407407,42.454954954954964,1030.1801801801812,28.616116116116146,0
1292,4,0,0,38,0.0,0.0,1.0,38,1050,700,350,0.6666666666666666,14,7,7,324.93076422771156,0.7418504030346136,0.039541278598178575,0.1972655316469367,132687.90486009675,1022.8764659930342,133710.78132608978,1291,18,664.1315789473684,36,2,14,34.057456188290146,0.6472800925925926,42.42680180180181,1030.292792792794,28.61924424424428,0
1293,4,0,0,38,0.0,0.0,1.0,38,800,500,300,0.625,11,5,6,324.0487855011584,0.7408131816026553,0.04412221289513907,0.19749284836735065,132832.97444403882,1008.8728086194484,133841.84725265828,1292,19,665.1315789473684,36,2,16,33.934846333114834,0.6487268518518519,42.286036036036045,1030.8558558558573,28.634884884884926,0
1294,4,0,0,38,0.0,0.0,1.0,38,1450,900,550,0.6206896551724138,20,9,11,325.2423108305437,0.7399537695590327,0.04976186235701685,0.19930065615509118,133036.20501836305,1053.8005488596827,134090.00556722272,1293,20,666.1315789473684,36,2,17,33.700605829057956,0.6507523148148149,42.08896396396397,1031.644144144145,28.656781781781806,0
1295,4,0,1,37,0.0,0.02631578947368421,0.9736842105263158,38,1000,600,400,0.6,14,6,8,326.5260148487083,0.7405464675201517,0.050400064331952654,0.2003990538552388,133094.29943034257,1091.7502384140917,134186.04966875666,1294,21,667.1315789473684,36,2,17,33.609352832041914,0.6513310185185186,42.03265765765766,1031.8693693693697,28.663038038038046,0
1296,4,0,0,37,0.0,0.0,1.0,37,850,500,350,0.5882352941176471,12,5,7,355.3969705941155,0.7255380380380381,0.04544873628413382,0.21242502643451752,132100.37964034622,1989.614947702313,134089.99458804852,1295,22,685.3513513513514,35,2,19,33.86390077309914,0.643452380952381,42.997685185185176,1028.009259259258,29.371693121693085,2
1297,4,0,1,36,0.0,0.02702702702702703,0.972972972972973,37,700,500,200,0.7142857142857143,9,5,4,355.3969705941155,0.7255380380380381,0.04544873628413382,0.21242502643451752,132100.37964034622,1989.614947702313,134089.99458804852,1296,23,686.3513513513514,35,2,19,33.86390077309914,0.643452380952381,42.997685185185176,1028.009259259258,29.371693121693085,0
1298,4,0,0,36,0.0,0.0,1.0,36,900,600,300,0.6666666666666666,12,6,6,355.88760810463987,0.7267857142857144,0.04443319078700636,0.21338848081091943,132219.3889853393,2211.048418209858,134430.43740354915,1297,24,688.3611111111111,35,1,19,33.7314314652262,0.6446428571428573,42.881944444444436,1028.4722222222206,29.384920634920586,0
1299,4,1,1,36,0.02702702702702703,0.02702702702702703,0.972972972972973,37,700,500,200,0.7142857142857143,9,5,4,348.1709273206958,0.736986986986987,0.0398249452954047,0.20991307887276778,132426.97934420907,1821.4448401103791,134248.42418431945,1298,0,670.7297297297297,36,1,19,33.721052151714076,0.6446759259259259,42.68018018018018,1029.2792792792793,28.59109109109109,0
1300,4,2,1,37,0.05263157894736842,0.02631578947368421,0.9736842105263158,38,1100,700,400,0.6363636363636364,15,7,8,339.9169338566627,0.7393018018018018,0.05777052922515691,0.2080415482621746,132991.11415291234,1441.1863506078691,134432.3005035202,1299,0,654.0263157894736,37,1,18,33.367328407923175,0.6483671171171171,42.132675438596486,1031.4692982456133,27.877548601232792,0
1301,4,0,1,36,0.0,0.02702702702702703,0.972972972972973,37,1100,900,200,0.8181818181818182,13,9,4,346.691281512184,0.7303553553553553,0.06422018348623881,0.21162035823503725,132891.02447041642,1814.431915023139,134705.45638543955,1300,1,672.7027027027027,36,1,18,33.29305919615553,0.6493055555555556,42.22972972972973,1031.0810810810815,28.64114114114115,0
1302,4,0,0,36,0.0,0.0,1.0,36,700,500,200,0.7142857142857143,9,5,4,352.77322503116744,0.7297949735449736,0.07413539367181765,0.21541169717633107,132904.73257726766,2177.046226637514,135081.77880390518,1301,2,686.7777777777778,35,1,18,33.12252123320985,0.6514880952380953,42.21643518518518,1031.1342592592591,29.460978835978832,0
1303,4,0,0,36,0.0,0.0,1.0,36,750,600,150,0.8,9,6,3,356.23402492836385,0.731415343915344,0.07423199680829806,0.21804654053307543,132994.25582990397,2275.4158093278393,135269.67163923182,1302,3,687.7777777777778,35,1,18,32.943409634949134,0.6523809523809523,42.129629629629626,1031.4814814814813,29.470899470899464,0
1304,4,0,0,36,0.0,0.0,1.0,36,1150,800,350,0.6956521739130435,15,8,7,360.58468322214316,0.7318452380952382,0.07343117093537743,0.2212396731538477,133083.80922335823,2397.596638160155,135481.40586151837,1303,4,688.7777777777778,35,1,18,32.74128341746121,0.6532738095238095,42.042824074074076,1031.828703703704,29.48082010582011,0
1305,4,0,1,35,0.0,0.027777777777777776,0.9722222222222222,36,750,400,350,0.5333333333333333,11,4,7,363.97859974626255,0.7322420634920636,0.07297234994330459,0.22368002577101467,133143.5282305598,2492.2789941272267,135635.80722468704,1304,5,689.7777777777778,35,1,18,32.5937581772644,0.6538690476190476,41.9849537037037,1032.060185185185,29.487433862433857,0
1306,4,0,0,35,0.0,0.0,1.0,35,1200,900,300,0.75,15,9,6,386.9653767820773,0.7235994397759103,0.10765202211230718,0.22352941176470587,130794.81336805549,3130.0107435270825,133924.82411158257,1305,6,707.5142857142857,33,2,16,34.37499999999999,0.6347853535353536,44.27083333333333,1022.9166666666661,30.99747474747473,4
1307,4,2,1,36,0.05405405405405406,0.02702702702702703,0.972972972972973,37,700,500,200,0.7142857142857143,9,5,4,368.0251597272195,0.742992992992993,0.10446380881163497,0.21539079903400715,131298.46810967507,2264.227939600476,133562.69604927555,1306,0,670.2162162162163,35,2,18,34.34935535479013,0.6354166666666666,43.77893518518518,1024.8842592592591,29.282407407407405,0
1308,4,0,0,36,0.0,0.0,1.0,36,700,500,200,0.7142857142857143,9,5,4,378.7242026529868,0.7330687830687831,0.1155395460531412,0.22111943609441015,131206.12953514745,2738.187358276647,133944.3168934241,1307,1,689.8333333333334,34,2,18,34.16874854752497,0.6366421568627452,43.86904761904762,1024.5238095238099,30.133053221288524,0
1309,4,1,0,37,0.02702702702702703,0.0,1.0,37,650,500,150,0.7692307692307693,8,5,3,374.31834453948903,0.7409284284284284,0.13510378127547495,0.22100165273495845,131633.36167800447,2454.613095238088,134087.97477324255,1308,0,672.1621621621622,34,3,15,33.84933294663574,0.6409313725490196,43.45238095238095,1026.1904761904757,30.182072829131638,0
1310,4,0,0,37,0.0,0.0,1.0,37,1150,900,250,0.782608695652174,14,9,5,370.1472732148828,0.7392392392392393,0.13271580486913082,0.21917265109586173,131743.67310742452,2352.912272805207,134096.58538022972,1309,1,673.1621621621622,35,2,15,33.84488913942127,0.6398809523809523,43.344907407407405,1026.62037037037,29.33201058201057,0
1311,4,2,1,38,0.05128205128205128,0.02564102564102564,0.9743589743589743,39,800,400,400,0.5,12,4,8,363.1259976096526,0.752080521817364,0.1608581239369724,0.2117793226935129,131163.91354372134,1725.8053911900179,132889.71893491136,1310,0,639.5897435897435,38,1,18,34.61097204839383,0.6282894736842104,43.910256410256416,1024.3589743589753,26.956815114709876,4
1312,4,0,0,38,0.0,0.0,1.0,38,1000,700,300,0.7,13,7,6,364.8006089257139,0.7446953532479849,0.16683196213231177,0.21242130220487318,131103.44048168664,1965.3229839950732,133068.76346568172,1311,1,657.3157894736842,37,1,18,34.62928265524625,0.6295045045045045,43.969298245614034,1024.1228070175437,27.678994784257938,0
1313,4,0,0,38,0.0,0.0,1.0,38,850,600,250,0.7058823529411765,11,6,5,366.06066892240585,0.743391417733523,0.16931777217015154,0.2137794306506849,131215.758694983,2006.5856802092858,133222.34437519228,1312,2,658.3157894736842,37,1,18,34.48335830479452,0.6306306306306306,43.859649122807014,1024.5614035087713,27.690848743480306,0
1314,4,4,3,39,0.09523809523809523,0.07142857142857142,0.9285714285714286,42,700,400,300,0.5714285714285714,10,4,6,337.7335955380263,0.7775358110723964,0.16183083536984477,0.20150441602808616,132032.19112507434,518.3894188075775,132550.58054388192,1313,0,596.5238095238095,40,2,15,34.386433303668554,0.63359375,43.0640243902439,1027.7439024390242,25.693597560975604,0
1315,4,0,0,39,0.0,0.0,1.0,39,850,600,250,0.7058823529411765,11,6,5,365.477589454258,0.7513495276653172,0.18795040257132234,0.2133027757320073,131191.27498584625,1789.494187851553,132980.7691736978,1314,1,643.4102564102565,38,1,17,34.523064622657905,0.6285635964912281,43.883547008547005,1024.4658119658116,26.959626630679253,1
1316,4,0,1,38,0.0,0.02564102564102564,0.9743589743589743,39,350,100,250,0.2857142857142857,6,1,5,365.477589454258,0.7513495276653172,0.18795040257132234,0.2133027757320073,131191.27498584625,1789.494187851553,132980.7691736978,1315,2,644.4102564102565,38,1,17,34.523064622657905,0.6285635964912281,43.883547008547005,1024.4658119658116,26.959626630679253,0
1317,4,0,0,38,0.0,0.0,1.0,38,650,500,150,0.7692307692307693,8,5,3,376.14814960635584,0.7429765291607396,0.16235508958628686,0.2075371533699656,129001.10995708554,2104.7771007187257,131105.88705780427,1316,3,662.2368421052631,36,2,19,36.4773860991021,0.6102430555555556,46.03040540540541,1015.878378378379,28.21884384384386,7
1318,4,1,0,39,0.02564102564102564,0.0,1.0,39,900,500,400,0.5555555555555556,13,5,8,366.39580896602155,0.7517993702204229,0.16068936331139327,0.20365122940772434,129292.17864229028,1674.888526143355,130967.06716843364,1317,0,646.2307692307693,34,5,20,36.42821608334308,0.6173406862745099,45.74404761904762,1017.0238095238097,29.912464985994404,0
1319,4,0,0,39,0.0,0.0,1.0,39,600,200,400,0.3333333333333333,10,2,8,366.39580896602155,0.7517993702204229,0.16068936331139327,0.20365122940772434,129292.17864229028,1674.4224773242656,130966.60111961454,1318,1,647.2307692307693,34,5,20,36.42821608334308,0.6173406862745099,45.74404761904762,1017.0238095238097,29.912464985994404,0
1320,4,4,3,40,0.09302325581395349,0.06976744186046512,0.9302325581395349,43,700,500,200,0.7142857142857143,9,5,4,333.51958433750485,0.7847914359542266,0.15144408156704592,0.18923223474978187,130099.04308431932,78.11575443784697,130177.15883875717,1319,0,587.9302325581396,38,5,19,36.445570216776616,0.6175986842105263,44.951923076923066,1020.192307692306,26.84716599190279,0
1321,4,2,1,41,0.047619047619047616,0.023809523809523808,0.9761904761904762,42,950,500,450,0.5263157894736842,14,5,9,340.1961378680128,0.777826171118854,0.16522335503418906,0.19299907723926768,130094.74068944286,451.5456678978126,130546.28635734066,1320,0,602.8333333333334,37,5,21,36.279646746918885,0.6193693693693694,44.95614035087719,1020.175438596491,27.572309151256512,0
1322,4,2,1,42,0.046511627906976744,0.023255813953488372,0.9767441860465116,43,650,300,350,0.46153846153846156,10,3,7,333.20790871939494,0.7822074566260613,0.17224679720810387,0.19067351828193407,130430.54112803958,92.20577485382384,130522.7469028934,1321,0,589.7674418604652,37,6,22,36.1179690854444,0.6227477477477477,44.62719298245615,1021.4912280701769,27.6078710289237,0
1323,4,0,1,41,0.0,0.023809523809523808,0.9761904761904762,42,850,600,250,0.7058823529411765,11,6,5,359.09579877103454,0.7759872241579558,0.17075497410738705,0.20238440640413588,129837.58680555542,924.826388888881,130762.41319444429,1322,1,604.8095238095239,39,3,15,36.05887162714637,0.6132478632478633,45.20833333333333,1019.1666666666655,26.132478632478602,5
1324,4,0,1,40,0.0,0.024390243902439025,0.975609756097561,41,1050,900,150,0.8571428571428571,12,9,3,364.6175491719809,0.7664634146341464,0.19072408776294503,0.20543926766400028,129826.69850107744,1267.4185249105044,131094.11702598794,1323,2,620.4878048780488,38,3,15,35.929255337736315,0.6148574561403508,45.21901709401709,1019.1239316239311,26.819050832208713,0
1325,4,0,1,39,0.0,0.025,0.975,40,700,400,300,0.5714285714285714,10,4,6,369.78220038213715,0.7572916666666667,0.19276103336921424,0.20769508110943496,129703.52055440134,1592.4106455832557,131295.9311999846,1324,3,636.925,37,3,15,35.92303552206674,0.6154279279279279,45.33991228070175,1018.6403508771929,27.530820293978184,0
1326,4,0,0,39,0.0,0.0,1.0,39,1300,1000,300,0.7692307692307693,16,10,6,377.82781075131396,0.749212775528565,0.19409828256450012,0.21182249799281655,129631.08114448907,1995.645518829645,131626.72666331872,1325,4,654.1282051282051,36,3,16,35.7919569464411,0.6166087962962963,45.41103603603604,1018.3558558558557,28.287662662662658,0
1327,4,0,0,39,0.0,0.0,1.0,39,750,500,250,0.6666666666666666,10,5,5,383.0452837192602,0.7491003148897886,0.19986734468273282,0.2152191078586604,129717.10519641277,2137.5050726402255,131854.610269053,1326,5,655.1282051282051,36,3,17,35.57143120347853,0.6174768518518519,45.326576576576585,1018.6936936936949,28.29704704704708,0
1328,4,0,0,39,0.0,0.0,1.0,39,1100,800,300,0.7272727272727273,14,8,6,392.7928343551169,0.748144399460189,0.22171395532730798,0.2208574749789151,129745.78622118752,2392.6430230906712,132138.4292442782,1327,6,656.1282051282051,36,3,16,35.29392800560038,0.6177662037037037,45.29842342342343,1018.8063063063072,28.300175175175198,5
1329,4,0,0,39,0.0,0.0,1.0,39,800,600,200,0.75,10,6,4,394.9669311693941,0.7478632478632479,0.16935336037212712,0.20749671172701986,127035.24470416369,2271.3688773232734,129306.61358148696,1328,7,657.1282051282051,36,3,16,38.01873882931188,0.5902777777777778,47.972972972972975,1008.1081081081086,28.003003003003016,8
1330,4,6,3,42,0.13333333333333333,0.06666666666666667,0.9333333333333333,45,850,700,150,0.8235294117647058,10,7,3,352.58725748784707,0.8067340067340067,0.17492575358607243,0.19132465334381607,128338.88942992045,64.62330961990536,128403.51273954035,1329,0,570.3777777777777,37,8,18,37.75148342531473,0.601632882882883,46.683114035087705,1013.2675438596467,27.385609293503965,0
1331,4,2,2,42,0.045454545454545456,0.045454545454545456,0.9545454545454546,44,1050,600,450,0.5714285714285714,15,6,9,360.200386978608,0.799638830162086,0.19148775019692632,0.196041347254016,128458.27880245086,454.14434704972655,128912.4231495006,1330,0,584.2954545454545,36,8,16,37.43658816559282,0.6047453703703705,46.5653153153153,1013.7387387387369,28.159409409409356,0
1332,4,1,0,43,0.023255813953488372,0.0,1.0,43,800,500,300,0.625,11,5,6,365.56843914923735,0.7862679955703211,0.1873268431328281,0.1984222991166501,128349.69142500393,784.1192719049614,129133.81069690888,1331,0,598.8372093023256,35,8,19,37.411598134399384,0.6056547619047621,46.67245370370368,1013.3101851851823,28.951719576719494,0
1333,4,1,1,43,0.022727272727272728,0.022727272727272728,0.9772727272727273,44,1550,1300,250,0.8387096774193549,18,13,5,357.6332757749411,0.7948158914728682,0.18725850223464313,0.19590476887586558,128715.26668137705,406.57249310118107,129121.83917447823,1332,0,586.2045454545455,36,8,17,37.23920763511265,0.6073495370370372,46.311936936936924,1014.7522522522501,28.1875625625625,0
1334,4,1,0,44,0.022727272727272728,0.0,1.0,44,950,800,150,0.8421052631578947,11,8,3,356.74476765745874,0.7992424242424243,0.19894430104057514,0.19612261129266115,128858.14868922955,393.89406298187794,129252.04275221143,1333,0,587.1590909090909,36,8,18,37.11596051464064,0.6087962962962965,46.17117117117116,1015.3153153153136,28.203203203203156,0
1335,4,1,1,44,0.022222222222222223,0.022222222222222223,0.9777777777777777,45,1050,800,250,0.7619047619047619,13,8,5,348.81882034218586,0.8076599326599327,0.200306910276699,0.19289098012717024,129089.93632656176,5.799861495812081,129095.73618805756,1334,0,575.0888888888888,37,8,19,37.08099554021003,0.6092342342342343,45.942982456140335,1016.2280701754364,27.46562351825504,0
1336,4,2,1,45,0.043478260869565216,0.021739130434782608,0.9782608695652174,46,850,600,250,0.7058823529411765,11,6,5,343.38644677289386,0.8154388083735911,0.2148236905169465,0.19160843031703623,129445.89548405624,-310.0067800789291,129135.88870397731,1335,0,563.0869565217391,38,8,14,36.85695538057742,0.6110197368421054,45.5929487179487,1017.6282051282027,26.779689608636914,0
1337,4,0,0,45,0.0,0.0,1.0,45,1450,1000,450,0.6896551724137931,19,10,9,352.26751496875943,0.8111531986531987,0.21237335632679488,0.19617875173350208,129368.65790435494,114.47512696211481,129483.13303131706,1336,1,576.6,37,8,20,36.709599770065395,0.6120495495495497,45.668859649122794,1017.3245614035068,27.495258416310993,0
1338,4,2,1,46,0.0425531914893617,0.02127659574468085,0.9787234042553191,47,1000,800,200,0.8,12,8,4,338.24278528383655,0.8207292630280604,0.22425318866320776,0.1910203196522158,129917.22140841973,-611.2874348958728,129305.93397352386,1337,0,553.0212765957447,39,8,17,36.509421511528906,0.6140491452991454,45.130208333333314,1019.4791666666634,26.14049145299137,0
1339,4,0,1,45,0.0,0.021739130434782608,0.9782608695652174,46,950,500,450,0.5263157894736842,14,5,9,345.081802113593,0.8128623188405797,0.22860503067820304,0.19429694383467783,129799.47973738005,-241.71232376363935,129557.76741361641,1338,1,565.9782608695652,38,8,17,36.45462011602712,0.6145833333333335,45.24572649572648,1019.0170940170914,26.816239316239248,0
1340,4,2,3,44,0.0425531914893617,0.06382978723404255,0.9361702127659575,47,1050,900,150,0.8571428571428571,12,9,3,342.9753541266198,0.8214616096207215,0.24426270459309496,0.19475035325624582,130129.69970703124,-473.74403211805554,129655.95567491317,1339,0,554.7021276595744,39,8,18,36.17332397481707,0.6161858974358975,44.921875,1020.3124999999999,26.16185897435897,0
1341,4,0,1,43,0.0,0.022727272727272728,0.9772727272727273,44,1500,1100,400,0.7333333333333333,19,11,8,359.8489705596136,0.8003875968992248,0.25078583403185206,0.20345963122162075,129962.8351230918,553.3984860106937,130516.23360910249,1340,1,591.5681818181819,38,6,18,35.91239696842693,0.6162280701754383,45.0854700854701,1019.6581196581218,26.833108412055836,0
1342,4,1,0,44,0.022727272727272728,0.0,1.0,44,900,700,200,0.7777777777777778,11,7,4,361.25479016474304,0.8026338971106414,0.2577820085673481,0.20511196468925674,130126.29323727096,601.7493516692408,130728.0425889402,1341,0,592.3636363636364,38,6,19,35.71051483420593,0.6178728070175438,44.92521367521368,1020.2991452991466,26.84997750787228,0
1343,4,0,0,44,0.0,0.0,1.0,44,1150,900,250,0.782608695652174,14,9,5,359.6519816418772,0.802677942212826,0.25466822750114115,0.20448784099066772,130180.80210387926,563.9566896778668,130744.75879355714,1342,1,593.3636363636364,38,6,19,35.69605841708544,0.6184210526315788,44.87179487179488,1020.5128205128225,26.855600539811117,0
1344,4,1,1,44,0.022222222222222223,0.022222222222222223,0.9777777777777777,45,1300,1000,300,0.7692307692307693,16,10,6,351.63285135727824,0.8081228956228956,0.2533852635704492,0.20138972395916843,130463.84222059899,175.1516141621437,130638.99383476113,1343,0,581.1555555555556,36,9,20,35.61370149911817,0.625,44.5945945945946,1021.6216216216217,28.37837837837838,0
1345,4,0,0,44,0.0,0.0,1.0,44,1400,800,600,0.5714285714285714,20,8,12,359.7445468497916,0.8003655743481325,0.2590229281255796,0.20590826008406363,130439.87509645055,585.0067515431975,131024.88184799375,1344,3,595.3636363636364,35,9,21,35.430829367777015,0.6267857142857144,44.61805555555555,1021.5277777777771,29.18650793650792,0
1346,4,0,0,44,0.0,0.0,1.0,44,1300,700,600,0.5384615384615384,19,7,12,359.91056179323186,0.8014006342494715,0.25634345265065783,0.20631756100718493,130498.99798525359,593.5935356652767,131092.59152091885,1345,4,596.3636363636364,35,9,19,35.366636459749294,0.6273809523809524,44.560185185185176,1021.7592592592578,29.19312169312165,0
1347,4,0,0,44,0.0,0.0,1.0,44,1200,900,300,0.75,15,9,6,363.8334385193069,0.8012684989429176,0.2620196760450326,0.20952441954886283,130676.44702717755,708.8922110768075,131385.33923825435,1346,5,597.3636363636364,35,9,19,35.0865029054411,0.6291666666666667,44.38657407407407,1022.453703703703,29.212962962962944,0
1348,4,0,0,44,0.0,0.0,1.0,44,650,300,350,0.46153846153846156,10,3,7,360.6866587825498,0.8015327695560254,0.2590929108324245,0.2082718958500889,130780.41459956569,634.1501552227826,131414.56475478847,1347,6,598.3636363636364,36,8,19,35.06160776542258,0.6281828703703705,44.284909909909906,1022.8603603603597,28.412787787787767,0
1349,4,1,1,44,0.022222222222222223,0.022222222222222223,0.9777777777777777,45,1150,800,350,0.6956521739130435,15,8,7,350.9731891772877,0.804882154882155,0.2509135596364309,0.20410965079339352,131054.49631090656,199.3229052523923,131253.81921615894,1348,0,586.0444444444445,38,7,19,35.032780328324996,0.6271929824561404,44.01709401709402,1023.9316239316239,26.94556905083221,0
1350,4,0,0,44,0.0,0.0,1.0,44,1300,1200,100,0.9230769230769231,14,12,2,357.8403094509609,0.7994846723044398,0.25443886341734134,0.20821623987305443,131075.36844269387,580.8100809864536,131656.1785236803,1349,8,600.3636363636364,37,7,19,34.83588089374308,0.629222972972973,43.99671052631579,1024.0131578947364,27.676031294452336,0
1351,4,1,1,44,0.022222222222222223,0.022222222222222223,0.9777777777777777,45,1750,1200,550,0.6857142857142857,23,12,11,347.76981162461414,0.8020202020202021,0.24784039734312446,0.2041428442248438,131412.43128895407,140.4987592335877,131552.93004818767,1350,0,588.0,37,8,19,34.75330178590525,0.6326013513513514,43.667763157894726,1025.3289473684194,27.711593172119443,0
1352,4,1,0,45,0.022222222222222223,0.0,1.0,45,1200,800,400,0.6666666666666666,16,8,8,350.2989309672143,0.8077441077441078,0.25140210226260473,0.20623325986144053,131524.88175448214,214.60509483687306,131739.48684931902,1351,0,588.9777777777778,37,8,20,34.57498218421521,0.6337274774774775,43.55811403508772,1025.767543859649,27.723447131341867,0
1353,4,0,0,45,0.0,0.0,1.0,45,1050,700,350,0.6666666666666666,14,7,7,353.32257441965544,0.8075757575757576,0.255528243857837,0.20832005852833743,131581.12502164117,298.11636753615517,131879.24138917733,1352,1,589.9777777777778,37,8,18,34.440681664351125,0.6342905405405406,43.503289473684205,1025.9868421052624,27.72937411095304,0
1354,4,0,1,44,0.0,0.022222222222222223,0.9777777777777777,45,800,500,300,0.625,11,5,6,351.64501757832966,0.8077861952861953,0.2536312332315669,0.20804220005496238,131711.68456424863,263.15152677331935,131974.83609102195,1353,2,590.9777777777778,38,7,18,34.35201568137662,0.6337719298245614,43.376068376068375,1026.495726495726,27.013045434098057,0
1355,4,0,0,44,0.0,0.0,1.0,44,1200,900,300,0.75,15,9,6,360.4235152312076,0.7978109584214236,0.26550116550116565,0.2129775317275317,131665.51246537393,691.0693674976874,132356.58183287163,1354,13,605.3636363636364,37,7,18,34.17334401709402,0.6351351351351351,43.421052631578945,1026.315789473684,27.738264580369837,0
1356,4,0,0,44,0.0,0.0,1.0,44,900,700,200,0.7777777777777778,11,7,4,362.36202101693283,0.797084214235377,0.26605134877939896,0.21443952217196724,131721.78578985823,746.1945021544941,132467.9802920127,1355,14,606.3636363636364,37,7,19,34.06679484440648,0.6356981981981983,43.36622807017543,1026.5350877192968,27.744191559980994,0
1357,4,0,0,44,0.0,0.0,1.0,44,1250,900,350,0.72,16,9,7,359.98154109251004,0.7967538759689923,0.25885402508640487,0.21334602220191506,131778.07113727275,687.534626038756,132465.6057633115,1356,15,607.3636363636364,37,7,19,34.071087854193365,0.6362612612612613,43.31140350877192,1026.7543859649104,27.750118539592172,0
1358,4,0,0,44,0.0,0.0,1.0,44,900,600,300,0.6666666666666666,12,6,6,360.20127047782694,0.7959830866807611,0.2568235202764355,0.21379246510109776,131834.3685076175,697.3814058171531,132531.74991343464,1357,16,608.3636363636364,37,7,19,34.00864830237028,0.6368243243243243,43.25657894736841,1026.9736842105247,27.75604551920337,0
1359,4,0,0,44,0.0,0.0,1.0,44,950,700,250,0.7368421052631579,12,7,5,363.01787942455087,0.7951902748414377,0.2629066066299206,0.21578372426708034,131890.67790089233,775.7348414896564,132666.412742382,1358,17,609.3636363636364,37,7,19,33.87951892968971,0.6373873873873874,43.2017543859649,1027.1929824561382,27.761972498814547,0
1360,4,0,0,44,0.0,0.0,1.0,44,1400,900,500,0.6428571428571429,19,9,10,355.83644684271235,0.7940010570824525,0.25681624263108915,0.21277567127533595,132116.0357032932,602.3401431209446,132718.37584641413,1359,18,610.3636363636364,37,7,19,33.83683518202501,0.6396396396396395,42.98245614035087,1028.0701754385955,27.785680417259336,0
1361,4,0,0,44,0.0,0.0,1.0,44,1150,800,350,0.6956521739130435,15,8,7,353.8740497048197,0.7940891472868218,0.25313111925396004,0.21191767804162173,132172.40521121875,554.476858264069,132726.88206948282,1360,19,611.3636363636364,37,7,19,33.83050757091064,0.6402027027027027,42.92763157894736,1028.2894736842097,27.791607396870532,0
1362,4,0,0,44,0.0,0.0,1.0,44,950,700,250,0.7368421052631579,12,7,5,351.7724628438561,0.7925475687103595,0.2448456105335568,0.21144657391825122,132313.38158135198,508.84082121421864,132822.2224025662,1361,20,612.3636363636364,37,7,19,33.74265071583359,0.6416103603603605,42.790570175438596,1028.8377192982457,27.806424845898533,0
1363,4,0,0,44,0.0,0.0,1.0,44,1300,1000,300,0.7692307692307693,16,10,6,354.21003458506107,0.7920410500352361,0.24576739050423235,0.2133899476646589,132398.0034722223,579.340277777783,132977.3437500001,1362,21,613.3636363636364,37,7,19,33.59480431848853,0.642454954954955,42.708333333333336,1029.1666666666672,27.81531531531533,0
1364,4,0,0,44,0.0,0.0,1.0,44,1550,1100,450,0.7096774193548387,20,11,9,362.80386542332457,0.7925475687103595,0.24246923754582395,0.21295588357600284,131410.26925131492,735.2307281393859,132145.4999794543,1363,22,614.3636363636364,38,6,17,34.370115661144105,0.6307565789473684,43.669871794871796,1025.320512820513,26.982118758434552,5
1365,4,0,0,44,0.0,0.0,1.0,44,850,700,150,0.8235294117647058,10,7,3,364.0308054191976,0.7932743128964059,0.24249921866861146,0.21398234545124792,131465.0463533677,771.4653416977226,132236.51169506542,1364,23,615.3636363636364,38,6,17,34.283302080077796,0.6313048245614035,43.616452991452995,1025.5341880341884,26.98774179037338,0
1366,4,0,1,43,0.0,0.022727272727272728,0.9772727272727273,44,1350,1100,250,0.8148148148148148,16,11,5,366.3774236436774,0.7931862226920366,0.24495896168810893,0.21598050333027838,131574.63480029593,841.1951429980331,132415.82994329397,1365,24,616.3636363636364,38,6,14,34.112386754139344,0.6324013157894737,43.50961538461539,1025.9615384615388,26.99898785425102,0
1367,4,0,0,43,0.0,0.0,1.0,43,1000,500,500,0.5,15,5,10,371.8045717567336,0.7933277962347729,0.2492216172966204,0.21954063009913363,131637.38031173046,1188.6759627962397,132826.0562745267,1366,25,629.4418604651163,37,6,15,33.90976154859849,0.6348536036036037,43.4484649122807,1026.2061403508767,27.735301090564235,0
1368,4,0,0,43,0.0,0.0,1.0,43,1100,600,500,0.5454545454545454,16,6,10,373.6944348255246,0.793235511258767,0.25594062725870503,0.22130936073822816,131749.92696069946,1246.8428987765474,132996.76985947601,1367,26,630.4418604651163,37,6,15,33.747530171953436,0.6359797297297298,43.338815789473685,1026.6447368421054,27.747155049786635,0
1369,4,0,0,43,0.0,0.0,1.0,43,1150,900,250,0.782608695652174,14,9,5,373.5968660217456,0.7928202288667404,0.257127602776295,0.22157914188053493,131806.21831957911,1248.4780172745516,133054.69633685367,1368,27,631.4418604651163,37,6,15,33.693161594589796,0.6365427927927928,43.28399122807018,1026.8640350877195,27.753082029397824,0
1370,4,0,0,43,0.0,0.0,1.0,43,1350,900,450,0.6666666666666666,18,9,9,371.7757978900364,0.7924972314507198,0.2582335905180011,0.22148194545629588,131975.164533799,1213.0344192444013,133188.19895304338,1369,28,632.4418604651163,37,6,15,33.56932291110875,0.6382319819819819,43.11951754385966,1027.5219298245624,27.770862968231416,0
1371,4,0,0,43,0.0,0.0,1.0,43,1000,600,400,0.6,14,6,8,374.5620944914908,0.7927279438907345,0.257143424081276,0.22397284425715686,132116.0357032934,1297.13180978764,133413.16751308105,1370,29,633.4418604651163,37,6,15,33.35555318543801,0.6396396396396395,42.982456140350884,1028.0701754385973,27.785680417259385,0
1372,4,0,0,43,0.0,0.0,1.0,43,900,700,200,0.7777777777777778,11,7,4,372.1981077475157,0.7928663713547434,0.25793848526090524,0.22339030382466077,132256.98201610125,1245.1596885580282,133502.14170465927,1371,30,634.4418604651163,37,6,16,33.274148989091415,0.6410472972972973,42.84539473684211,1028.6184210526326,27.800497866287365,0
1373,4,1,0,44,0.022727272727272728,0.0,1.0,44,1300,1000,300,0.7692307692307693,16,10,6,365.30149559781347,0.8002995066948556,0.26085293832897616,0.2207323708921153,132510.87474030486,881.359288434917,133392.23402873977,1372,0,621.0,37,7,17,33.195775647852315,0.643581081081081,42.59868421052632,1029.605263157896,27.827169274537727,0
1374,4,1,1,44,0.022222222222222223,0.022222222222222223,0.9777777777777777,45,1200,1000,200,0.8333333333333334,14,10,4,359.0156905561172,0.806986531986532,0.2547322117433011,0.21883401125558935,132838.18354381275,538.198439440449,133376.3819832532,1373,0,608.1777777777778,38,7,14,33.02846581683768,0.6450109649122806,42.28098290598292,1030.87606837607,27.128317588843945,0
1375,4,1,0,45,0.022222222222222223,0.0,1.0,45,1150,800,350,0.6956521739130435,15,8,7,359.549244373667,0.8083333333333333,0.2639783646930203,0.22012986394595807,133003.4394061839,564.2572275184565,133567.69663370235,1374,0,609.1555555555556,38,7,17,32.848696702917316,0.6466557017543859,42.1207264957265,1031.517094017095,27.14518668466039,0
1376,4,0,0,45,0.0,0.0,1.0,45,600,300,300,0.5,9,3,6,361.071615691277,0.8078703703703705,0.2668185426806118,0.22138848207813727,133058.54752218936,608.7329470742961,133667.28046926364,1375,1,610.1555555555556,38,7,17,32.754090297193756,0.647203947368421,42.06730769230769,1031.7307692307693,27.15080971659919,0
1377,4,0,0,45,0.0,0.0,1.0,45,1300,1100,200,0.8461538461538461,15,11,4,365.0477850798085,0.8068602693602694,0.2745417327905424,0.22465552225739557,133196.3677496531,724.6078055373032,133920.97555519038,1376,2,611.1555555555556,38,7,17,32.513109777133785,0.6485745614035088,41.93376068376069,1032.264957264958,27.16486729644626,0
1378,4,0,0,45,0.0,0.0,1.0,45,1300,1000,300,0.7692307692307693,16,10,6,364.55220760745937,0.8058922558922559,0.2708876474239599,0.2250167074542597,133306.67529585818,719.4485535831907,134026.12384944136,1377,3,612.1555555555556,38,7,17,32.415166563211265,0.6496710526315788,41.82692307692309,1032.6923076923092,27.176113360323928,0
1379,4,0,0,45,0.0,0.0,1.0,45,1000,800,200,0.8,12,8,4,361.1877097566293,0.8037457912457913,0.2727450633657529,0.22410758159685545,133500.5497484804,643.8542914490417,134144.40403992945,1378,4,613.1555555555556,37,8,18,32.30758178603007,0.6534346846846846,41.63925438596492,1033.4429824561412,27.930891417733545,0
1380,4,0,0,45,0.0,0.0,1.0,45,900,400,500,0.4444444444444444,14,4,10,361.06669062004437,0.80239898989899,0.2714321066214165,0.22471932843936637,133613.88991083798,648.7050101954494,134262.59492103342,1379,5,614.1555555555556,37,8,18,32.19710025806907,0.6545608108108107,41.5296052631579,1033.8815789473688,27.942745376955912,0
1381,4,0,0,45,0.0,0.0,1.0,45,1300,900,400,0.6923076923076923,17,9,8,359.4869535204336,0.8009680134680135,0.2793993993993995,0.22476868167430666,133783.99032635032,618.7198224453558,134402.71014879568,1380,6,615.1555555555556,37,8,16,32.067545486663136,0.65625,41.36513157894736,1034.5394736842097,27.96052631578945,0
1382,4,0,0,45,0.0,0.0,1.0,45,1400,1100,300,0.7857142857142857,17,11,6,365.37219243341804,0.8003787878787879,0.2875354541067916,0.22950624542674006,133954.1989482342,788.6278710757292,134742.82681930994,1381,7,616.1555555555556,37,8,16,31.744849592204226,0.657939189189189,41.20065789473685,1035.1973684210539,27.978307254623076,0
1383,4,0,0,45,0.0,0.0,1.0,45,1100,900,200,0.8181818181818182,13,9,4,365.06159195281396,0.7987373737373737,0.2910297127531938,0.23019838435155415,134096.12212411518,790.6687634656912,134886.79088758086,1382,8,617.1555555555556,37,8,18,31.61082292328324,0.6593468468468467,41.063596491228076,1035.7456140350882,27.993124703651034,0
1384,4,0,0,45,0.0,0.0,1.0,45,1050,800,250,0.7619047619047619,13,8,5,360.14648009542395,0.7992845117845119,0.26981828506530436,0.21794431321238503,132567.3284087409,548.7313404124081,133116.0597491533,1383,9,618.1555555555556,37,8,21,33.271667376490626,0.6441441441441442,42.543859649122794,1029.8245614035068,27.83309625414883,3
1385,4,0,0,45,0.0,0.0,1.0,45,1000,600,400,0.6,14,6,8,362.4875004583715,0.7981902356902357,0.27536252454285304,0.219690811568125,132623.79410010754,614.8935249307253,133238.68762503826,1384,10,619.1555555555556,37,8,21,33.15458448655169,0.6447072072072073,42.48903508771929,1030.0438596491213,27.839023233760035,0
1386,4,1,0,46,0.021739130434782608,0.0,1.0,46,950,700,250,0.7368421052631579,12,7,5,358.1784158617396,0.8073067632850242,0.27677881576174745,0.2195172667509077,133042.01388888882,330.55555555554474,133372.56944444435,1385,0,606.6739130434783,39,7,21,32.84531502423263,0.6452991452991453,42.08333333333333,1031.666666666666,26.452991452991437,0
1387,4,0,0,46,0.0,0.0,1.0,46,1350,1000,350,0.7407407407407407,17,10,7,375.38597727457307,0.8066223832528181,0.2433108538708113,0.2266696568192964,132484.9405993832,781.4936135459822,133266.4342129292,1386,1,607.6739130434783,36,10,19,32.9623350105739,0.6452546296296295,42.623873873873876,1029.504504504505,28.59734734734736,6
1388,4,0,1,45,0.0,0.021739130434782608,0.9782608695652174,46,1350,1000,350,0.7407407407407407,17,10,7,377.1797096240203,0.8061996779388084,0.24294423388764974,0.22792822769943297,132513.92598257054,796.3128246489872,133310.23880721952,1387,2,608.6739130434783,36,10,19,32.88695358926683,0.6455439814814814,42.59572072072073,1029.6171171171181,28.600475475475506,0
1389,4,0,0,45,0.0,0.0,1.0,45,1550,1000,550,0.6451612903225806,21,10,11,377.9191691178919,0.7990740740740742,0.2560001943776271,0.22890388879153928,132600.90115453303,1022.4844777209773,133623.385632254,1388,3,622.9111111111112,36,9,19,32.78026824112545,0.646412037037037,42.51126126126127,1029.9549549549558,28.609859859859885,0
1390,4,0,0,45,0.0,0.0,1.0,45,900,700,200,0.7777777777777778,11,7,4,377.1665058430865,0.7992424242424243,0.25162026915415625,0.22880100765600517,132658.9004545087,1006.8987906825926,133665.79924519127,1389,4,623.9111111111112,36,9,17,32.741218481270955,0.6469907407407407,42.454954954954964,1030.1801801801814,28.61611611611615,0
1391,4,0,1,44,0.0,0.022222222222222223,0.9777777777777777,45,950,700,250,0.7368421052631579,12,7,5,380.07243096423747,0.7983164983164983,0.2568226950354615,0.2313912468305589,132793.26331178812,1094.2116805170713,133887.4749923052,1390,5,624.9111111111112,37,8,17,32.53102836879433,0.6463963963963963,42.32456140350877,1030.701754385964,27.856804172593623,0
1392,4,0,0,44,0.0,0.0,1.0,44,1150,800,350,0.6956521739130435,15,8,7,383.5167420730669,0.7934504933051445,0.2686753927741472,0.23373583601443818,132832.97444403887,1388.7339197305737,134221.70836376946,1391,6,638.9545454545455,36,8,19,32.402274051416505,0.6487268518518517,42.28603603603605,1030.855855855858,28.634884884884944,0
1393,4,1,2,43,0.022222222222222223,0.044444444444444446,0.9555555555555556,45,850,600,250,0.7058823529411765,11,6,5,373.09193389338657,0.7982744107744109,0.2562177603078486,0.22938696105411144,133160.81781173055,936.2454072406915,134097.06321897125,1392,0,625.7333333333333,37,8,19,32.34124349304153,0.6500563063063063,41.968201754385966,1032.1271929824563,27.89532954006639,0
1394,4,0,0,43,0.0,0.0,1.0,43,1650,900,750,0.5454545454545454,24,9,15,383.21170797856416,0.7875138427464009,0.26914360080431665,0.23549957271156835,133143.52823055984,1604.4317719050032,134747.96000246485,1393,8,651.8604651162791,35,8,19,32.09751504616649,0.6538690476190476,41.9849537037037,1032.0601851851852,29.487433862433864,0
1395,4,0,0,43,0.0,0.0,1.0,43,1250,900,350,0.72,16,9,7,381.3432904210549,0.7865448504983389,0.26231431722713716,0.2347274539175561,133203.26063368047,1559.2339409722122,134762.4945746527,1394,9,652.8604651162791,35,8,19,32.0856458123108,0.6544642857142857,41.92708333333333,1032.291666666666,29.494047619047603,0
1396,4,0,0,43,0.0,0.0,1.0,43,850,500,350,0.5882352941176471,12,5,7,382.49685749248715,0.7852990033222591,0.2624533996094447,0.2360360823153506,133297.72973987507,1597.1925472770176,134894.9222871521,1395,10,653.8604651162791,36,7,20,31.960877862595428,0.6533564814814814,41.83558558558559,1032.657657657658,28.684934934934947,0
1397,4,1,0,44,0.022727272727272728,0.0,1.0,44,1200,600,600,0.5,18,6,12,343.2543982127154,0.7925255461592671,0.17080789665110552,0.2057650682182233,132210.46142578122,282.22654466649874,132492.68797044773,1396,0,639.9772727272727,39,5,21,34.065232620952784,0.6370192307692308,42.890625,1028.4374999999998,26.370192307692303,7
1398,4,0,0,44,0.0,0.0,1.0,44,1250,900,350,0.72,16,9,7,344.160666382216,0.7910059901338972,0.17391104238005806,0.20674761199457212,132290.8203125,305.85937499999966,132596.6796875,1397,1,640.9772727272727,39,5,21,33.961117861482386,0.6378205128205128,42.8125,1028.75,26.378205128205128,0
1399,4,1,2,43,0.022222222222222223,0.044444444444444446,0.9555555555555556,45,1000,600,400,0.6,14,6,8,337.17222499612575,0.7950757575757577,0.17869986168741336,0.2041671010654936,132590.4923661337,-58.7469295601976,132531.7454365735,1398,0,627.7111111111111,38,7,21,33.83990318118949,0.6425438596491226,42.52136752136754,1029.9145299145323,27.103013945119272,0
1400,4,0,0,43,0.0,0.0,1.0,43,500,200,300,0.4,8,2,6,352.25729607013125,0.7859449981543004,0.18846577300471234,0.21205889223421934,132370.51647308085,725.6960424428607,133096.21251552372,1399,3,657.3023255813954,38,5,21,33.672696913067554,0.6403508771929823,42.73504273504275,1029.0598290598311,27.080521817363977,0
1401,4,0,0,43,0.0,0.0,1.0,43,1150,800,350,0.6956521739130435,15,8,7,353.2697488083207,0.7847452934662237,0.18939893017659948,0.21347953161629088,132513.92598257065,762.6379762305635,133276.5639588012,1400,4,658.3023255813954,36,7,22,33.50240621240294,0.6455439814814813,42.595720720720735,1029.617117117119,28.60047547547553,0
1402,4,0,0,43,0.0,0.0,1.0,43,1350,1100,250,0.8148148148148148,16,11,5,356.8816081618712,0.7846068660022149,0.1968304166115864,0.21649555381066343,132658.9004545088,868.7043462381632,133527.60480074698,1401,5,659.3023255813954,36,7,19,33.26364596997522,0.6469907407407407,42.45495495495497,1030.1801801801823,28.616116116116174,0
1403,4,0,0,43,0.0,0.0,1.0,43,950,700,250,0.7368421052631579,12,7,5,355.1210248141179,0.7850221483942413,0.1944592705553434,0.21576078200857782,132716.91243608494,826.11319089362,133543.02562697855,1402,6,660.3023255813954,36,7,20,33.25068306010929,0.6475694444444443,42.39864864864866,1030.405405405407,28.622372372372418,0
1404,4,0,0,43,0.0,0.0,1.0,43,1000,400,600,0.4,16,4,12,356.39673990016337,0.7846530084902178,0.19611200593462708,0.2172074405490081,132832.9744440389,868.2478086194628,133701.22225265836,1403,7,661.3023255813954,36,7,21,33.101194377685516,0.6487268518518517,42.28603603603605,1030.8558558558582,28.63488488488495,0
1405,4,0,0,43,0.0,0.0,1.0,43,1500,1200,300,0.8,18,12,6,355.8755062748562,0.785345145810262,0.19541177993396075,0.21841173904866093,133094.29943034257,873.0002384140926,133967.29966875666,1404,8,662.3023255813954,36,7,21,32.85223180181164,0.6513310185185186,42.03265765765766,1031.8693693693697,28.663038038038046,0
1406,4,0,0,43,0.0,0.0,1.0,43,900,700,200,0.7777777777777778,11,7,4,353.8347285984337,0.7854374307862679,0.19170879676440844,0.21743279123796888,133141.2310979619,821.99827416174,133963.22937212363,1405,9,663.3023255813954,38,5,21,32.85778985507248,0.6480263157894737,41.98717948717949,1032.0512820512822,27.159244264507425,0
1407,4,0,0,43,0.0,0.0,1.0,43,1150,800,350,0.6956521739130435,15,8,7,357.6511858032546,0.7851144333702473,0.19388668566148204,0.22042991451547508,133251.51581561822,931.5125283073872,134183.0283439256,1406,10,664.3023255813954,38,5,21,32.648661699779254,0.6491228070175439,41.880341880341874,1032.4786324786312,27.170490328385032,0
1408,4,0,0,43,0.0,0.0,1.0,43,1550,1100,450,0.7096774193548387,20,11,9,358.445170230367,0.7846068660022149,0.1960618747727778,0.22143201637595566,133337.70751953128,958.8514539930561,134296.55897352434,1407,11,665.3023255813954,39,4,21,32.541708690536225,0.6482371794871795,41.796875,1032.8125000000002,26.4823717948718,0
1409,4,0,0,43,0.0,0.0,1.0,43,950,800,150,0.8421052631578947,11,8,3,357.9580428031737,0.7835917312661499,0.1995057142991128,0.22161222649949322,133418.40820312515,951.6384548611255,134370.04665798627,1408,12,666.3023255813954,39,4,21,32.47336492572428,0.6490384615384615,41.71875000000001,1033.1250000000011,26.490384615384645,0
1410,4,0,0,43,0.0,0.0,1.0,43,600,400,200,0.6666666666666666,8,4,4,355.6012801118403,0.7826688815060908,0.19648717344422728,0.22064590585438515,133501.3153990138,894.680282584095,134395.9956815979,1409,13,667.3023255813954,36,7,21,32.45114598089426,0.6553819444444444,41.63851351351351,1033.4459459459454,28.706831831831817,0
1411,4,0,0,43,0.0,0.0,1.0,43,1100,900,200,0.8181818181818182,13,9,4,357.22832570131595,0.782392026578073,0.20180036838384918,0.22200398115181955,133559.51126379738,942.2481180504639,134501.75938184783,1410,14,668.3023255813954,36,7,21,32.35079166212732,0.6559606481481483,41.5822072072072,1033.6711711711696,28.713088088088043,0
1412,4,0,0,43,0.0,0.0,1.0,43,900,700,200,0.7777777777777778,11,7,4,357.4477356962452,0.7802694721299372,0.2023000032922313,0.22284063522733297,133675.94103816632,956.4324882314495,134632.37352639777,1411,15,669.3023255813954,36,7,21,32.228483792515156,0.6571180555555557,41.46959459459458,1034.1216216216199,28.72560060060055,0
1413,4,0,0,43,0.0,0.0,1.0,43,1100,800,300,0.7272727272727273,14,8,6,356.8737463191925,0.7797157622739018,0.2101047739348576,0.2231857799478841,133792.42153893743,949.4005407434317,134741.82207968086,1412,16,670.3023255813954,36,7,18,32.12669170204275,0.658275462962963,41.356981981981974,1034.5720720720708,28.738113113113076,0
1414,4,0,0,43,0.0,0.0,1.0,43,1200,900,300,0.75,15,9,6,354.8094216995574,0.7792543373938723,0.20373510134878625,0.22242145875981806,133879.81520371724,900.3639619349062,134780.17916565214,1413,17,671.3023255813954,36,7,18,32.0926278563656,0.6591435185185186,41.27252252252252,1034.90990990991,28.747497497497502,0
1415,4,0,0,43,0.0,0.0,1.0,43,700,300,400,0.42857142857142855,11,3,8,357.2025068520759,0.7793004798818752,0.20822719005107504,0.22445404275400785,133967.23740209814,970.6866072153358,134937.9240093135,1414,18,672.3023255813954,36,7,19,31.943235795351548,0.6600115740740741,41.18806306306307,1035.2477477477485,28.756881881881903,0
1416,4,0,0,43,0.0,0.0,1.0,43,1500,1100,400,0.7333333333333333,19,11,8,358.21243031949155,0.7781930601698043,0.2104073370740207,0.2258039562473176,134083.84471887432,1006.0999766658623,135089.94469554018,1415,19,673.3023255813954,36,7,19,31.800451234098087,0.6611689814814814,41.075450450450454,1035.6981981981985,28.769394394394403,0
1417,4,1,0,44,0.022727272727272728,0.0,1.0,44,800,500,300,0.625,11,5,6,356.9853485209374,0.7827915785764623,0.23518244552851586,0.2275752297301236,134495.36494859008,802.5749461246204,135297.9398947147,1416,0,658.9772727272727,38,6,21,31.421018299172584,0.6614583333333334,40.6784188034188,1037.2863247863247,27.297008547008545,0
1418,4,0,0,44,0.0,0.0,1.0,44,850,600,250,0.7058823529411765,11,6,5,355.74361346364924,0.783254052149401,0.23115905288242122,0.2273158584961951,134580.80317911957,775.2864879787438,135356.0896670983,1417,1,659.9772727272727,35,9,22,31.367935489867993,0.6681547619047619,40.59606481481482,1037.6157407407413,29.646164021164036,0
1419,4,0,0,44,0.0,0.0,1.0,44,750,600,150,0.8,9,6,3,358.3233342193855,0.7825713530655392,0.2352015528233613,0.22972137130905432,134700.92438539525,853.2968696416367,135554.2212550369,1418,2,660.9772727272727,35,9,23,31.18112851674285,0.669345238095238,40.480324074074076,1038.078703703704,29.659391534391542,0
1420,4,0,0,44,0.0,0.0,1.0,44,1450,900,550,0.6206896551724138,20,9,11,352.970771389036,0.7824171952078929,0.22765793528505407,0.2194951917712284,133582.64391116964,648.4057128315795,134231.04962400123,1419,3,661.9772727272727,38,6,20,32.43764641036241,0.6524122807017543,41.55982905982906,1033.7606837606843,27.204228520018006,5
1421,4,0,0,44,0.0,0.0,1.0,44,950,500,450,0.5263157894736842,14,5,9,352.90519300960545,0.7813601127554616,0.22885332606837228,0.21961823490379115,133610.2564673278,630.3506693330435,134240.60713666084,1420,4,662.9772727272727,38,6,21,32.41168922875547,0.6526864035087719,41.53311965811966,1033.8675213675215,27.207040035987408,0
1422,4,0,1,43,0.0,0.022727272727272728,0.9772727272727273,44,1200,700,500,0.5833333333333334,17,7,10,356.55308722081804,0.7807875264270614,0.22804282494365102,0.2223862038851496,133693.11125721398,733.7383117832024,134426.8495689972,1421,5,663.9772727272727,38,6,21,32.23441804407713,0.6535087719298245,41.45299145299146,1034.1880341880355,27.215474583895674,0
1423,4,0,0,43,0.0,0.0,1.0,43,1400,1200,200,0.8571428571428571,16,12,4,360.6404415409324,0.7764857881136951,0.23750912282778014,0.22497094210410581,133698.92659279806,1043.447983995101,134742.37457679317,1422,6,678.4651162790698,37,6,22,32.122914899632455,0.6554054054054053,41.447368421052644,1034.2105263157916,27.951635846372746,0
1424,4,1,0,44,0.022727272727272728,0.0,1.0,44,900,700,200,0.7777777777777778,11,7,4,354.46413165616514,0.7812059548978154,0.23523149364049045,0.223082231429322,134024.78723792848,701.395965738938,134726.18320366743,1423,0,664.0227272727273,38,6,20,31.9565535149264,0.6567982456140349,41.132478632478644,1035.4700854700873,27.249212775528612,0
1425,4,0,0,44,0.0,0.0,1.0,44,1650,1400,250,0.8484848484848485,19,14,5,354.1664414368948,0.7802149400986611,0.2402848466102414,0.22407438457250128,134218.45465565423,707.1344921104613,134925.5891477647,1424,1,665.0227272727273,38,6,21,31.77067223425097,0.6587171052631577,40.945512820512825,1036.2179487179492,27.268893387314453,0
1426,4,0,0,44,0.0,0.0,1.0,44,1100,700,400,0.6363636363636364,15,7,8,352.06481535662556,0.779862579281184,0.24203069657615117,0.22325051232614265,134301.49778106515,656.5664036817977,134958.06418474694,1425,2,666.0227272727273,38,6,21,31.742166563595138,0.6595394736842104,40.86538461538462,1036.5384615384621,27.277327935222687,0
1427,4,0,0,44,0.0,0.0,1.0,44,1000,600,400,0.6,14,6,8,351.4841025602686,0.7783870683579986,0.23893146218991212,0.2232200085893225,134356.8741325152,644.8610654540147,135001.73519796922,1426,3,667.0227272727273,38,6,21,31.701918452871656,0.6600877192982456,40.81196581196581,1036.752136752137,27.282950967161497,0
1428,4,0,0,44,0.0,0.0,1.0,44,1050,700,350,0.6666666666666666,14,7,7,352.6453294208782,0.7773520084566596,0.2410113487998391,0.2246506426771395,134469.7387695315,684.0250651041958,135153.7638346357,1427,4,668.0227272727273,39,5,21,31.559141809782066,0.6594551282051281,40.703125000000014,1037.187500000002,26.594551282051334,0
1429,4,0,0,44,0.0,0.0,1.0,44,1100,800,300,0.7272727272727273,14,8,6,354.63163660370884,0.7755902043692742,0.24753819080425332,0.22659095096679097,134578.49368105788,745.1827072175979,135323.6763882755,1428,5,669.0227272727273,38,6,22,31.3990853239978,0.6622807017543859,40.5982905982906,1037.6068376068383,27.305443094916797,0
1430,4,0,0,44,0.0,0.0,1.0,44,850,600,250,0.7058823529411765,11,6,5,352.97089052321746,0.7752598661028894,0.24507688851866738,0.22570153124766384,134606.2089656842,702.4146897143754,135308.62365539858,1429,6,670.0227272727273,38,6,22,31.414513195373882,0.6625548245614035,40.5715811965812,1037.7136752136757,27.308254610886205,0
1431,4,0,0,44,0.0,0.0,1.0,44,850,600,250,0.7058823529411765,11,6,5,353.097758134223,0.7758104298801973,0.24462929001833866,0.22629932836623431,134689.37194097458,711.7030553729339,135401.0749963475,1430,7,671.0227272727273,38,6,22,31.328264374914234,0.6633771929824561,40.491452991452995,1038.0341880341887,27.31668915879444,0
1432,4,0,0,44,0.0,0.0,1.0,44,1000,600,400,0.6,14,6,8,356.46833628682816,0.7745110993657506,0.2515669142547099,0.22880840766416113,134744.82819234434,806.452945795907,135551.28113814024,1431,8,672.0227272727273,38,6,22,31.18547197640119,0.6639254385964912,40.438034188034194,1038.2478632478642,27.322312190733268,0
1433,4,0,0,44,0.0,0.0,1.0,44,1250,1100,150,0.88,14,11,3,353.89051904370984,0.7731897463002114,0.25294114896522024,0.2276750321392394,134828.03397116312,742.8725847395849,135570.9065559027,1432,9,673.0227272727273,38,6,16,31.169418441175463,0.6647478070175438,40.35790598290599,1038.5683760683773,27.33074673864151,0
1434,4,0,0,44,0.0,0.0,1.0,44,1100,700,400,0.6363636363636364,15,7,8,354.4568045983585,0.7738284002818887,0.2559552746718521,0.22856352572376912,134911.26543209876,764.0432098765446,135675.3086419753,1433,10,674.0227272727273,38,6,17,31.071746880570412,0.6655701754385964,40.27777777777778,1038.888888888889,27.339181286549707,0
1435,4,0,0,44,0.0,0.0,1.0,44,950,800,150,0.8421052631578947,11,8,3,358.57209402056986,0.7722427766032417,0.2654395963748484,0.23228405291745297,135077.80540032135,887.0263076192462,135964.83170794058,1434,11,675.0227272727273,38,6,18,30.79886091127097,0.6672149122807018,40.11752136752136,1039.5299145299139,27.356050382366153,0
1436,4,0,0,44,0.0,0.0,1.0,44,1550,1000,550,0.6451612903225806,21,10,11,361.9753989188063,0.7714719873150107,0.26462389690432864,0.2353928195373797,135216.66718030884,989.0214086127386,136205.6885889216,1435,12,676.0227272727273,38,6,20,30.57203389830506,0.6685855263157896,39.98397435897435,1040.0641025641014,27.370107962213194,0
1437,4,0,0,44,0.0,0.0,1.0,44,500,200,300,0.4,8,2,6,360.44761658482406,0.7711416490486258,0.26216665421677776,0.2345800798843477,135244.4480970119,949.7077945795535,136194.15589159145,1436,13,677.0227272727273,38,6,20,30.584086551629674,0.6688596491228072,39.95726495726494,1040.1709401709377,27.37291947818257,0
1438,4,0,0,44,0.0,0.0,1.0,44,1250,600,650,0.48,19,6,13,361.91112315235034,0.7701506342494715,0.2613508013703105,0.23607852835771836,135327.80796853296,995.3277951274547,136323.13576366042,1437,14,678.0227272727273,38,6,20,30.46300099257282,0.6696820175438598,39.87713675213674,1040.4914529914515,27.38135402609083,0
1439,4,0,0,44,0.0,0.0,1.0,44,1100,800,300,0.7272727272727273,14,8,6,360.9548968237843,0.7688953488372093,0.26048111216245773,0.23603804509576248,135416.75347222213,975.8680555555516,136392.6215277777,1438,15,679.0227272727273,39,5,20,30.399319455564452,0.6688034188034189,39.791666666666664,1040.8333333333328,26.688034188034173,0
1440,4,0,1,43,0.0,0.022727272727272728,0.9772727272727273,44,700,400,300,0.5714285714285714,10,4,6,362.8100317239829,0.7676620859760395,0.2663671857668932,0.23781118202253368,135501.3872880724,1032.2525241258368,136533.63981219823,1439,16,680.0227272727273,40,4,20,30.266796811452743,0.66796875,39.71036585365853,1041.1585365853646,26.028963414634113,0
1441,4,0,0,43,0.0,0.0,1.0,43,1300,1000,300,0.7692307692307693,16,10,6,368.45441265159377,0.7661498708010336,0.2694267723424757,0.2413062516408928,135470.96896701376,1382.9752604166574,136853.94422743042,1440,17,693.7906976744187,39,4,20,30.150173437395782,0.6693376068376069,39.73958333333333,1041.0416666666656,26.69337606837604,0
1442,4,0,0,43,0.0,0.0,1.0,43,1100,800,300,0.7272727272727273,14,8,6,369.26975025735436,0.7661037283130306,0.27585084089804357,0.2427566228023197,135606.5551757811,1415.0797526041522,137021.63492838526,1441,18,694.7906976744187,39,4,20,29.993936893689362,0.670673076923077,39.60937499999999,1041.5624999999989,26.70673076923074,0
1443,4,0,0,43,0.0,0.0,1.0,43,950,600,350,0.631578947368421,13,6,7,371.0331689156101,0.7661037283130306,0.2805479231660688,0.24430091428030673,135663.00834195683,1467.103315969051,137130.11165792588,1442,19,695.7906976744187,36,7,20,29.891813497639884,0.6767939814814815,39.55518018018018,1041.7792792792793,28.938313313313316,0
1444,4,0,0,43,0.0,0.0,1.0,43,1000,800,200,0.8,12,8,4,371.1773843923206,0.7655961609449982,0.28183975306407616,0.24459637894570885,135692.3392987583,1473.1855165976888,137165.524815356,1443,20,696.7906976744187,36,7,20,29.858859345727048,0.6770833333333334,39.52702702702703,1041.8918918918926,28.94144144144146,0
1445,4,0,0,43,0.0,0.0,1.0,43,1200,700,500,0.5833333333333334,17,7,10,367.5484348662783,0.7654577334809892,0.284491068064723,0.24297047439769393,135805.061413127,1382.9875538627152,137188.0489669897,1444,21,697.7906976744187,37,6,20,29.841240619959326,0.6762387387387387,39.4188596491228,1042.324561403508,28.1709340919867,0
1446,4,0,0,43,0.0,0.0,1.0,43,1350,1000,350,0.7407407407407407,17,10,7,370.055760663688,0.7633813215208564,0.28766781600762936,0.24541354838993543,135919.37543282556,1459.5495729455333,137378.9250057711,1445,22,698.7906976744187,37,6,17,29.662197686645655,0.6773648648648647,39.309210526315795,1042.7631578947373,28.182788051209116,0
1447,4,0,0,43,0.0,0.0,1.0,43,900,500,400,0.5555555555555556,13,5,8,369.54933457433395,0.7614894795127353,0.28619757419909897,0.24586659924057438,136033.73754424445,1454.2354378270288,137487.9729820715,1446,23,699.7906976744187,37,6,17,29.561698549505998,0.6784909909909909,39.199561403508774,1043.2017543859654,28.194642010431497,0
1448,4,0,0,43,0.0,0.0,1.0,43,750,400,350,0.5333333333333333,11,4,7,371.45619533946393,0.7604743447766703,0.28287162145653055,0.2479326835372382,136148.14774738377,1514.614592951676,137662.76234033544,1447,24,700.7906976744187,37,6,18,29.398245429712123,0.679617117117117,39.08991228070175,1043.6403508771928,28.206495969653858,0
1449,4,0,0,43,0.0,0.0,1.0,43,1150,900,250,0.782608695652174,14,9,5,368.8523298585243,0.7596437799926171,0.28029288095583693,0.2470729143048222,136274.34807372701,1453.022157389137,137727.37023111616,1448,25,701.7906976744187,38,5,18,29.340828473003857,0.6790021929824561,38.96901709401709,1044.1239316239312,27.47694556905082,0
1450,4,0,0,43,0.0,0.0,1.0,43,650,400,250,0.6153846153846154,9,4,5,369.56393121752353,0.7596899224806202,0.28289576998301147,0.2477447094458212,136302.2374260354,1474.4781393819726,137776.71556541737,1449,26,702.7906976744187,38,5,18,29.294556987927148,0.6792763157894738,38.942307692307686,1044.2307692307684,27.47975708502022,0
1451,4,0,0,43,0.0,0.0,1.0,43,950,600,350,0.631578947368421,13,6,7,368.7912388604549,0.7595053525286083,0.2821318796033172,0.24729981067398388,136312.69666883675,1454.1856553819405,137766.8823242187,1450,27,703.7906976744187,39,4,18,29.30434330839568,0.6776175213675215,38.932291666666664,1044.270833333333,26.776175213675206,0
1452,4,0,0,43,0.0,0.0,1.0,43,1200,900,300,0.75,15,9,6,355.74900720280544,0.7590900701365817,0.2729890146819065,0.23266802884873175,135422.04231112453,1043.457258785404,136465.49956990994,1451,28,704.7906976744187,40,3,20,30.529518974158695,0.6671874999999999,39.78658536585367,1040.853658536587,26.02134146341468,5
1453,4,0,1,42,0.0,0.023255813953488372,0.9767441860465116,43,950,700,250,0.7368421052631579,12,7,5,355.1225335550366,0.7584902177925433,0.27357190688594524,0.23277225567954912,135501.38728807273,1023.9191907925348,136525.30647886527,1452,29,705.7906976744187,40,3,20,30.466894420042284,0.66796875,39.710365853658544,1041.158536585367,26.028963414634177,0
1454,4,0,0,42,0.0,0.0,1.0,42,1450,1000,450,0.6896551724137931,19,10,9,360.6399999999996,0.7553474641889276,0.2727619047619043,0.23726315789473687,135633.68055555577,1382.98611111113,137016.6666666669,1453,30,689.3809523809524,39,3,20,30.191666666666656,0.6709401709401709,39.58333333333334,1041.6666666666683,26.709401709401753,0
1455,4,0,0,42,0.0,0.0,1.0,42,900,700,200,0.7777777777777778,11,7,4,360.74107379446355,0.7539924506387921,0.2713270518067321,0.23853407566761647,135814.58574459865,1398.7798996913411,137213.36564429,1454,31,690.3809523809524,35,7,20,30.009160559626917,0.6803571428571429,39.409722222222214,1042.3611111111102,29.781746031746007,0
1456,4,0,0,42,0.0,0.0,1.0,42,1300,1000,300,0.7692307692307693,16,10,6,358.2864928610851,0.7533149438637243,0.26264988294729763,0.2379159607347998,135965.43216574477,1342.9155682012765,137308.34773394605,1455,32,691.3809523809524,35,7,17,29.92326508341656,0.6818452380952382,39.26504629629628,1042.939814814813,29.79828042328037,0
1457,4,0,0,42,0.0,0.0,1.0,42,1250,1000,250,0.8,15,10,5,360.27744909382847,0.7507017034456059,0.2703640338370883,0.2406653359946772,136176.75781249985,1412.2829861110959,137589.04079861095,1456,33,692.3809523809524,35,7,18,29.661510312707918,0.6839285714285714,39.06249999999999,1043.7499999999989,29.821428571428537,0
1458,4,0,0,42,0.0,0.0,1.0,42,950,600,350,0.631578947368421,13,6,7,361.68042092458677,0.7509678668215254,0.27096429598586624,0.2423049756367608,136279.6242188134,1457.934370180988,137737.5585889944,1457,34,693.3809523809524,36,6,18,29.52280162496404,0.6828703703703705,38.96396396396396,1044.144144144144,29.004004004004003,0
1459,4,0,0,42,0.0,0.0,1.0,42,900,600,300,0.6666666666666666,12,6,6,362.11919179393914,0.7497822299651568,0.2688938882639669,0.24307155051707335,136348.4813235803,1474.8803718451818,137823.36169542547,1458,35,694.3809523809524,37,5,18,29.443022747156608,0.6815878378378378,38.89802631578947,1044.4078947368419,28.227240398293024,0
1460,4,0,0,42,0.0,0.0,1.0,42,1400,900,500,0.6428571428571429,19,9,10,362.2420597430146,0.7479674796747967,0.27086705433327296,0.24453904486334385,136548.96218067096,1492.7554632194492,138041.7176438904,1459,36,695.3809523809524,37,5,19,29.240977759127155,0.6835585585585585,38.70614035087719,1045.1754385964912,28.247984826932193,0
1461,4,0,0,42,0.0,0.0,1.0,42,850,700,150,0.8235294117647058,10,7,3,363.1331860422372,0.7472415795586528,0.2723147162987716,0.24534008947842997,136577.61432604265,1519.1728464527528,138096.7871724954,1460,37,696.3809523809524,37,5,19,29.189285464526737,0.6838400900900901,38.67872807017544,1045.2850877192984,28.250948316737794,0
1462,4,0,0,42,0.0,0.0,1.0,42,800,600,200,0.75,10,6,4,363.1340358722649,0.7467818428184282,0.2695103792589997,0.24575585581230874,136637.13223208423,1523.5186554898164,138160.65088757404,1461,38,697.3809523809524,38,4,20,29.130262620069487,0.6825657894736841,38.621794871794876,1045.512820512821,27.513495276653185,0
1463,4,0,0,42,0.0,0.0,1.0,42,650,500,150,0.7692307692307693,8,5,3,362.4579849021465,0.7459591560201316,0.2660201183494315,0.24609562806616786,136751.18319455144,1513.38870508735,138264.5718996388,1462,39,698.3809523809524,35,7,21,29.034916639002628,0.6895833333333334,38.512731481481474,1045.9490740740728,29.88425925925922,0
1464,4,0,0,42,0.0,0.0,1.0,42,1150,700,450,0.6086956521739131,16,7,9,361.61826315077076,0.7467334494773519,0.2685244960906681,0.24676065622050392,136927.10235573413,1503.0681864296773,138430.1705421638,1463,40,699.3809523809524,36,6,21,28.88265726992325,0.6892361111111112,38.3445945945946,1046.6216216216217,29.072822822822825,0
1465,4,0,0,42,0.0,0.0,1.0,42,800,500,300,0.625,11,5,6,362.09265695681654,0.7473625629113434,0.26841037619867203,0.24750098081401237,136986.04009414828,1520.3278447366374,138506.3679388849,1464,41,700.3809523809524,36,6,17,28.811899383247276,0.6898148148148149,38.28828828828829,1046.8468468468475,29.079079079079097,0
1466,4,0,0,42,0.0,0.0,1.0,42,1000,600,400,0.6,14,6,8,360.0460920021408,0.7465156794425087,0.26956559589100726,0.2467257634139947,137074.47047977036,1470.6254819008268,138545.09596167118,1465,42,701.3809523809524,36,6,18,28.777959995698463,0.6906828703703703,38.20382882882883,1047.184684684685,29.08846346346347,0
1467,4,0,0,42,0.0,0.0,1.0,42,1400,1200,200,0.8571428571428571,16,12,4,362.6668207515154,0.7459591560201316,0.2657578827791591,0.24999832843804468,137280.9190102265,1557.4468894570273,138838.36589968353,1466,43,702.3809523809524,36,6,19,28.505131098216204,0.6927083333333333,38.00675675675676,1047.9729729729734,29.11036036036037,0
1468,4,0,0,42,0.0,0.0,1.0,42,1500,900,600,0.6,21,9,12,364.88425192430776,0.7449186991869918,0.2664764295176345,0.25246188255428587,137409.83403547245,1627.7368998153283,139037.57093528777,1467,44,703.3809523809524,37,5,19,28.319563550163846,0.6920045045045045,37.88377192982456,1048.4649122807016,28.336889521100044,0
1469,4,0,0,42,0.0,0.0,1.0,42,1050,500,550,0.47619047619047616,16,5,11,368.39573549812576,0.7440718157181572,0.2640289235156337,0.2559998391264045,137560.2117233727,1735.3190746219557,139295.53079799464,1468,45,704.3809523809524,38,4,20,28.078852225277537,0.6916118421052632,37.74038461538461,1049.038461538461,27.60627530364371,0
1470,4,0,1,41,0.0,0.023809523809523808,0.9761904761904762,42,900,700,200,0.7777777777777778,11,7,4,368.0356522350368,0.7437088656600852,0.2660830618892507,0.2567885119003553,137700.34334136904,1735.7271349258558,139436.0704762949,1469,46,705.3809523809524,38,4,20,27.94983374049945,0.6929824561403508,37.60683760683761,1049.5726495726499,27.620332883490786,0
1471,4,0,0,41,0.0,0.0,1.0,41,650,300,350,0.46153846153846156,10,3,7,373.29940422066073,0.7405487804878049,0.2605567050237987,0.2604389137900996,137697.39246691298,2080.4709141274307,139777.8633810404,1470,47,697.4146341463414,37,4,20,27.814632957236377,0.6948198198198199,37.60964912280702,1049.5614035087726,28.36652441915602,0
1472,4,0,0,41,0.0,0.0,1.0,41,950,600,350,0.631578947368421,13,6,7,372.26432776495693,0.7409044715447154,0.2608454163513749,0.2599333632161875,137726.1648415858,2054.1076340797104,139780.2724756655,1471,48,698.4146341463414,37,4,20,27.81335962254953,0.6951013513513513,37.58223684210526,1049.6710526315783,28.369487908961574,0
1473,4,0,1,40,0.0,0.024390243902439025,0.975609756097561,41,900,600,300,0.6666666666666666,12,6,6,373.8347190728144,0.739430894308943,0.25977545489740606,0.2616843033509699,137812.49999999988,2103.927650815621,139916.42765081552,1472,49,699.4146341463414,33,8,21,27.686838624338616,0.7045454545454546,37.49999999999999,1049.999999999999,31.81818181818179,0
1474,4,0,0,40,0.0,0.0,1.0,40,650,400,250,0.6153846153846154,9,4,5,372.8258852942556,0.7372863247863248,0.2436602870813398,0.2612219960005292,137844.6709949297,2278.4122993560013,140123.0832942857,1473,50,687.575,33,7,21,27.681541019955656,0.7048611111111112,37.46936274509803,1050.1225490196068,31.82189542483657,0
1475,4,0,0,40,0.0,0.0,1.0,40,900,500,400,0.5555555555555556,13,5,8,370.6876334647194,0.7367521367521368,0.24011562004080744,0.2599528062341615,137875.00708616766,2221.7120181405735,140096.71910430823,1474,51,688.575,34,6,21,27.707719338018595,0.7028186274509804,37.44047619047618,1050.2380952380943,30.88935574229689,0
1476,4,0,0,40,0.0,0.0,1.0,40,800,700,100,0.875,9,7,2,370.96758284707755,0.7360576923076924,0.23816863100634666,0.2606224483314179,137937.52834467107,2234.070294784562,140171.59863945562,1475,52,689.575,34,6,21,27.63863705046842,0.7034313725490197,37.38095238095237,1050.4761904761892,30.896358543417332,0
1477,4,0,0,40,0.0,0.0,1.0,40,800,300,500,0.375,13,3,10,371.4748751824548,0.7341880341880341,0.24268437747819216,0.2616926355335614,138031.33680555542,2255.0347222222017,140286.3715277776,1476,53,690.575,34,6,21,27.53271213322759,0.7043504901960785,37.29166666666666,1050.8333333333321,30.906862745098003,0
1478,4,0,0,40,0.0,0.0,1.0,40,750,400,350,0.5333333333333333,11,4,7,368.75600399646544,0.733573717948718,0.2416477916194797,0.2604892412231029,138125.17715419483,2186.897675736939,140312.07482993178,1477,54,691.575,34,6,18,27.511560966402417,0.7052696078431373,37.20238095238094,1051.1904761904748,30.91736694677867,0
1479,4,0,1,39,0.0,0.025,0.975,40,2000,1500,500,0.75,25,15,10,368.83369860113055,0.7318910256410256,0.2363066432028158,0.2628084629844418,138420.80868484214,2210.851766117957,140631.6604509601,1478,55,692.575,35,5,18,27.218067165273496,0.705952380952381,36.92129629629629,1052.314814814814,30.066137566137545,0
1480,4,0,0,39,0.0,0.0,1.0,39,750,500,250,0.6666666666666666,10,5,5,372.9015085929008,0.7288573999100315,0.23380653681082864,0.26013787874894,137694.28211995785,2469.2811054297604,140163.5632253876,1479,56,700.2051282051282,36,3,19,27.828147353361945,0.6967592592592593,37.612612612612615,1049.54954954955,29.154154154154167,2
1481,4,0,0,39,0.0,0.0,1.0,39,500,300,200,0.6,7,3,4,374.48858847403864,0.7275078722447144,0.23228755796874223,0.261692850206521,137753.38471917872,2517.4141202012934,140270.79883938,1480,57,701.2051282051282,36,3,20,27.728089465779885,0.6973379629629629,37.55630630630631,1049.7747747747753,29.160410410410424,0
1482,4,0,0,39,0.0,0.0,1.0,39,1250,1000,250,0.8,15,10,5,358.5499528324844,0.728969860548808,0.17339698461760622,0.23264172273382494,135135.5932579539,1890.5974809268757,137026.19073888077,1481,58,702.2051282051282,36,3,20,30.74185891187407,0.6715856481481481,40.06193693693694,1039.7522522522524,28.88200700700701,8
1483,4,0,0,39,0.0,0.0,1.0,39,1050,800,250,0.7619047619047619,13,8,5,355.625608069862,0.728744939271255,0.17144364388544142,0.23111910559642337,135194.1442075522,1815.6999482590777,137009.84415581127,1482,59,703.2051282051282,36,3,20,30.75956506045841,0.6721643518518519,40.005630630630634,1039.977477477478,28.88826326326328,0
1484,4,0,0,39,0.0,0.0,1.0,39,900,700,200,0.7777777777777778,11,7,4,350.89578531136976,0.7281264057579847,0.16584526584526627,0.22897436838114804,135340.57706355,1698.0876146416658,137038.66467819168,1483,60,704.2051282051282,36,3,20,30.736832611832615,0.6736111111111112,39.86486486486486,1040.5405405405402,28.903903903903895,0
1485,4,0,0,39,0.0,0.0,1.0,39,900,500,400,0.5555555555555556,13,5,8,351.07922338855076,0.7262708052181737,0.1725672920913599,0.23003029200759376,135487.08917955105,1713.34040966641,137200.42958921747,1484,61,705.2051282051282,36,3,20,30.58635298359473,0.6750578703703705,39.72409909909909,1041.1036036036026,28.919544544544515,0
1486,4,0,0,39,0.0,0.0,1.0,39,1200,900,300,0.75,15,9,6,351.6800000000001,0.7245838956365273,0.17312820512820526,0.23136842105263156,135633.68055555547,1740.0890755620394,137373.76963111752,1485,62,706.2051282051282,34,5,21,30.424999999999997,0.6807598039215688,39.58333333333333,1041.666666666666,30.637254901960766,0
1487,4,0,0,39,0.0,0.0,1.0,39,1450,1000,450,0.6896551724137931,19,10,9,348.4199035731841,0.7228407557354926,0.16811490187031675,0.22980398475233518,135724.11807966811,1657.7968267746792,137381.9149064428,1486,63,707.2051282051282,35,4,22,30.420068310563153,0.6794642857142857,39.49652777777777,1042.0138888888882,29.771825396825378,0
1488,4,0,0,39,0.0,0.0,1.0,39,1100,700,400,0.6363636363636364,15,7,8,344.197697566639,0.7213787674313991,0.1650270984196387,0.22798035732943256,135874.9142661179,1553.5665294924488,137428.48079561035,1487,64,708.2051282051282,35,4,15,30.380402605091763,0.680952380952381,39.35185185185185,1042.5925925925922,29.788359788359777,0
1489,4,0,0,39,0.0,0.0,1.0,39,1150,700,450,0.6086956521739131,16,7,9,341.3522947468079,0.7222222222222222,0.16112339156830435,0.22705595812199117,136025.79417706188,1486.5433974194075,137512.3375744813,1488,65,709.2051282051282,35,4,16,30.304953030807354,0.6824404761904762,39.207175925925924,1043.171296296296,29.804894179894173,0
1490,4,0,0,39,0.0,0.0,1.0,39,1150,800,350,0.6956521739130435,15,8,7,340.981337260971,0.7224471434997751,0.16202056401723608,0.22719488214395064,136086.1695842978,1480.5688175154219,137566.73840181323,1489,66,710.2051282051282,35,4,16,30.254783693843585,0.6830357142857144,39.14930555555555,1043.4027777777774,29.811507936507926,0
1491,4,0,0,39,0.0,0.0,1.0,39,750,500,250,0.6666666666666666,10,5,5,342.1682423606865,0.721884840305893,0.1655789776007146,0.22837387426841652,136146.55838745268,1517.0057173782404,137663.5641048309,1490,67,711.2051282051282,35,4,16,30.163972681231755,0.6836309523809524,39.091435185185176,1043.634259259258,29.818121693121658,0
1492,4,0,0,39,0.0,0.0,1.0,39,700,300,400,0.42857142857142855,11,3,8,340.3925101631336,0.7215474583895637,0.16231826163666518,0.22266439996021575,135428.4748219505,1419.7676984417099,136848.24252039223,1491,68,712.2051282051282,36,3,17,30.922725305636707,0.6744791666666665,39.78040540540542,1040.87837837838,28.91328828828833,1
1493,4,0,0,39,0.0,0.0,1.0,39,950,600,350,0.631578947368421,13,6,7,339.8671054559769,0.7206477732793523,0.16361997476113244,0.22268401062654214,135487.0891795513,1409.520965221994,136896.6101447733,1492,69,713.2051282051282,36,3,18,30.87817739318551,0.6750578703703702,39.72409909909911,1041.1036036036046,28.91954454454457,0
1494,4,0,0,39,0.0,0.0,1.0,39,750,500,250,0.6666666666666666,10,5,5,340.5874014374656,0.7196356275303644,0.16943540940512936,0.2235210575650992,135545.7162187527,1433.0326525850378,136978.74887133774,1493,70,714.2051282051282,36,3,19,30.80120579647454,0.6756365740740741,39.6677927927928,1041.3288288288302,28.92580080080084,0
1495,4,0,0,39,0.0,0.0,1.0,39,900,600,300,0.6666666666666666,12,6,6,339.99122860760275,0.719523166891588,0.1725813740085551,0.22349530016998712,135604.3559395545,1420.858316086366,137025.21425564087,1494,71,715.2051282051282,36,3,20,30.758505424009805,0.6762152777777778,39.61148648648649,1041.5540540540546,28.932057057057072,0
1496,4,0,0,39,0.0,0.0,1.0,39,650,200,450,0.3076923076923077,11,2,9,337.9887353403562,0.7187359424201529,0.1741761798885071,0.2229401206054361,135726.70245181408,1374.825643521351,137101.52809533544,1495,72,716.2051282051282,34,5,21,30.689239879660313,0.6816789215686274,39.49404761904762,1042.0238095238096,30.64775910364146,0
1497,4,0,0,39,0.0,0.0,1.0,39,1200,1000,200,0.8333333333333334,14,10,4,335.3927569375355,0.7181736392262709,0.16573407940314433,0.22199806292532107,135850.78125,1312.6736111111113,137163.45486111112,1496,73,717.2051282051282,34,5,22,30.633826272315485,0.6829044117647058,39.375,1042.5,30.66176470588235,0
1498,4,0,0,39,0.0,0.0,1.0,39,950,800,150,0.8421052631578947,11,8,3,336.27558344209774,0.7170490328385065,0.16725360874236306,0.22297031304839773,135912.84190759636,1340.8340419501128,137253.67594954648,1497,74,718.2051282051282,34,5,18,30.54929215663888,0.6835171568627451,39.31547619047619,1042.7380952380952,30.668767507002798,0
1499,4,0,0,39,0.0,0.0,1.0,39,700,500,200,0.7142857142857143,9,5,4,338.39683478578564,0.7160931174089069,0.1679529616979678,0.22476836008781428,135974.91673752846,1402.6962868480855,137377.61302437654,1498,75,719.2051282051282,34,5,18,30.432456340600385,0.6841299019607843,39.25595238095239,1042.9761904761915,30.67577030812328,0
1500,4,0,0,39,0.0,0.0,1.0,39,1300,900,400,0.6923076923076923,17,9,8,336.5605446620868,0.7166554206027891,0.16941099369214352,0.22413500101964529,136068.05555555565,1359.0277777777883,137427.08333333343,1499,76,720.2051282051282,34,5,18,30.38804579339723,0.6850490196078431,39.16666666666667,1043.3333333333342,30.686274509803948,0
1501,4,0,0,39,0.0,0.0,1.0,39,1000,700,300,0.7,13,7,6,333.0485785709184,0.7181174089068826,0.16411192320853552,0.22237904709301168,136161.22626133793,1269.6605725623663,137430.8868339003,1500,77,721.2051282051282,34,5,18,30.387390213299877,0.6859681372549019,39.077380952380956,1043.6904761904766,30.696778711484605,0
1502,4,0,0,39,0.0,0.0,1.0,39,900,700,200,0.7777777777777778,11,7,4,331.91102824291556,0.7189046333783177,0.1622396233174681,0.2217165668662673,136176.75781249985,1239.7135416666522,137416.4713541665,1501,78,722.2051282051282,35,4,18,30.40169660678643,0.6839285714285714,39.06249999999999,1043.7499999999989,29.821428571428537,0
1503,4,0,0,39,0.0,0.0,1.0,39,1050,700,350,0.6666666666666666,14,7,7,328.8225931976258,0.7170490328385065,0.15582444381912297,0.22021593268268616,136267.37618152006,1161.558400848763,137428.93458236882,1502,79,723.2051282051282,35,4,18,30.392625540405728,0.6848214285714286,38.97569444444444,1044.0972222222222,29.831349206349206,0
1504,4,0,0,39,0.0,0.0,1.0,39,300,200,100,0.6666666666666666,4,2,2,328.8225931976258,0.7170490328385065,0.15582444381912297,0.22021593268268616,136267.37618152006,1161.558400848763,137428.93458236882,1503,80,724.2051282051282,35,4,18,30.392625540405728,0.6848214285714286,38.97569444444444,1044.0972222222222,29.831349206349206,0
1505,4,0,0,39,0.0,0.0,1.0,39,800,600,200,0.75,10,6,4,329.9936618043138,0.7173864147548359,0.15805099794019473,0.2217567235877836,136388.24755926355,1201.4514478309309,137589.6990070945,1504,81,725.2051282051282,35,4,18,30.242497691597404,0.6860119047619047,38.8599537037037,1044.5601851851852,29.84457671957672,0
1506,4,0,0,39,0.0,0.0,1.0,39,850,400,450,0.47058823529411764,13,4,9,329.0924832680423,0.7155308142150247,0.16161771096965527,0.22153004075023264,136448.70334201393,1180.8485243055616,137629.5518663195,1505,82,726.2051282051282,35,4,19,30.206256231306078,0.6866071428571427,38.802083333333336,1044.791666666667,29.851190476190485,0
1507,4,1,0,40,0.025,0.0,1.0,40,1300,1100,200,0.8461538461538461,15,11,4,323.4441932654415,0.7239850427350427,0.16566200215285232,0.21997046525885455,136809.2649237076,850.03246489734,137659.29738860496,1506,0,709.025,36,4,21,29.99775744528166,0.6880787037037037,38.45720720720721,1046.171171171172,29.060310310310335,0
1508,4,0,0,40,0.0,0.0,1.0,40,900,700,200,0.7777777777777778,11,7,4,326.4337872475487,0.7234775641025641,0.17438670109748244,0.2227515138530629,136927.10235573415,939.5265197630115,137866.62887549718,1507,1,710.025,36,4,22,29.80327810056667,0.6892361111111112,38.3445945945946,1046.621621621622,29.07282282282283,0
1509,4,0,0,40,0.0,0.0,1.0,40,1050,700,350,0.6666666666666666,14,7,7,326.9233190445579,0.7231570512820513,0.1808358433734938,0.22346170395869197,136986.04009414828,956.7861780699716,137942.82627221826,1508,2,711.025,36,4,16,29.732322145725764,0.6898148148148149,38.28828828828829,1046.8468468468475,29.079079079079097,0
1510,4,0,0,40,0.0,0.0,1.0,40,550,300,250,0.5454545454545454,8,3,5,326.996340071788,0.7230769230769231,0.18415886845218887,0.22370014522791853,137015.51371895548,960.7143038308625,137976.22802278635,1509,3,712.025,36,4,17,29.701337348965616,0.6901041666666667,38.26013513513514,1046.9594594594598,29.08220720720722,0
1511,4,0,0,40,0.0,0.0,1.0,40,750,500,250,0.6666666666666666,10,5,5,323.99676263151804,0.7231036324786325,0.18079569892473057,0.22221016906143934,137103.953615778,884.2474230987784,137988.20103887678,1510,4,713.025,36,4,17,29.6926523297491,0.6909722222222222,38.17567567567568,1047.2972972972977,29.091591591591605,0
1512,4,0,0,40,0.0,0.0,1.0,40,1200,800,400,0.6666666666666666,16,8,8,325.03468769932005,0.7233974358974359,0.18001988605826091,0.22348837395911128,137192.42204620162,918.4592109000928,138110.88125710172,1511,5,714.025,36,4,18,29.578272241929138,0.6918402777777778,38.09121621621622,1047.6351351351352,29.100975975975977,0
1513,4,0,0,40,0.0,0.0,1.0,40,750,500,250,0.6666666666666666,10,5,5,323.78459865545227,0.7240918803418803,0.1783100483610962,0.22300634274529874,137251.41685181812,887.9789840516274,138139.39583586974,1512,6,715.025,36,4,19,29.552883754253962,0.6924189814814814,38.03490990990991,1047.860360360361,29.10723223223225,0
1514,4,0,0,40,0.0,0.0,1.0,40,1400,1300,100,0.9285714285714286,15,13,2,322.76209367313584,0.7233974358974359,0.1794634224943601,0.22305807943602268,137369.4445078526,867.5299032140422,138236.97441106665,1513,7,716.025,36,4,19,29.4634224943603,0.6935763888888888,37.922297297297305,1048.310810810812,29.11974474474478,0
1515,4,0,0,40,0.0,0.0,1.0,40,950,800,150,0.8421052631578947,11,8,3,321.92678953297695,0.7221153846153846,0.17992574775151615,0.22273979461029864,137409.8340354725,847.1813442597731,138257.01537973227,1514,8,717.025,37,3,20,29.445548351112024,0.6920045045045045,37.88377192982456,1048.464912280702,28.336889521100055,0
1516,4,0,0,40,0.0,0.0,1.0,40,1200,800,400,0.6666666666666666,16,8,8,321.92678953297695,0.7221153846153846,0.17992574775151615,0.22273979461029864,137409.8340354725,847.1813442597731,138257.01537973227,1515,9,718.025,37,3,20,29.445548351112024,0.6920045045045045,37.88377192982456,1048.464912280702,28.336889521100055,0
1517,4,0,0,40,0.0,0.0,1.0,40,1000,800,200,0.8,12,8,4,321.26945871478665,0.721474358974359,0.17687121053732024,0.22302348636180339,137524.8213392583,836.5049823022566,138361.32632156057,1516,10,719.025,37,3,20,29.34960624433758,0.6931306306306306,37.77412280701755,1048.9035087719303,28.34874348032244,0
1518,4,0,0,40,0.0,0.0,1.0,40,900,500,400,0.5555555555555556,13,5,8,322.1519124506438,0.7211004273504273,0.17752926421404736,0.22400795772730808,137582.3330255463,864.4823407202209,138446.81536626653,1517,11,720.025,37,3,20,29.2698752787068,0.6936936936936937,37.719298245614034,1049.1228070175437,28.35467045993361,0
1519,4,0,0,40,0.0,0.0,1.0,40,1200,900,300,0.75,15,9,6,322.1573515443938,0.719017094017094,0.1786770082523763,0.22494619448099787,137726.16484158585,873.899300746378,138600.06414233224,1518,12,721.025,37,3,20,29.12825568439011,0.6951013513513513,37.58223684210526,1049.6710526315787,28.369487908961588,0
1520,4,0,0,40,0.0,0.0,1.0,40,1150,800,350,0.6956521739130435,15,8,7,322.1844293272864,0.7159188034188034,0.18194444444444446,0.22552910052910047,137812.50000000003,880.2353849261316,138692.73538492617,1519,13,722.025,36,4,21,29.04265873015872,0.6979166666666667,37.5,1050.0000000000002,29.16666666666667,0
1521,4,0,0,40,0.0,0.0,1.0,40,900,400,500,0.4444444444444444,14,4,10,323.58746199570174,0.715625,0.18426541554959752,0.2267057162366581,137842.06239601085,920.7926253956612,138762.85502140652,1520,14,723.025,36,4,21,28.976764968722076,0.6982060185185186,37.471846846846844,1050.1126126126126,29.169794794794793,0
1522,4,0,0,40,0.0,0.0,1.0,40,900,800,100,0.8888888888888888,10,8,2,324.3515358495194,0.7153846153846154,0.18261848595324914,0.22743627243102396,137871.62796242192,943.7748559370237,138815.40281835894,1521,15,724.025,36,4,21,28.92763957395096,0.6984953703703703,37.443693693693696,1050.2252252252256,29.172922922922933,0
1523,4,0,0,40,0.0,0.0,1.0,40,950,700,250,0.7368421052631579,12,7,5,326.0590311882171,0.7132478632478633,0.18832797427652714,0.22942162601704877,137989.92193206723,998.5720517815112,138988.49398384875,1522,16,725.025,36,4,21,28.766523758485167,0.6996527777777778,37.33108108108108,1050.6756756756758,29.18543543543544,0
1524,4,0,0,40,0.0,0.0,1.0,40,1500,1200,300,0.8,18,12,6,324.41703702762305,0.7140224358974359,0.18041626486660256,0.2288574608147246,138078.67569850257,959.0149693612527,139037.69066786382,1523,17,726.025,36,4,17,28.722454373370482,0.7005208333333333,37.24662162162162,1051.0135135135135,29.19481981981982,0
1525,4,0,0,40,0.0,0.0,1.0,40,750,500,250,0.6666666666666666,10,5,5,324.58340033585733,0.7139423076923077,0.17785989717223694,0.2295689867829971,138167.45799853903,969.3726665855037,139136.83066512452,1524,18,727.025,36,4,17,28.630882247929172,0.7013888888888888,37.16216216216216,1051.351351351351,29.204204204204196,0
1526,4,0,0,40,0.0,0.0,1.0,40,1100,700,400,0.6363636363636364,15,7,8,326.5659891145358,0.7144764957264957,0.17504817987152,0.2317725181101644,138285.87878418955,1031.892957146329,139317.7717413359,1525,19,728.025,36,4,17,28.462482155603134,0.7025462962962963,37.049549549549546,1051.8018018018015,29.216716716716707,0
1527,4,0,0,40,0.0,0.0,1.0,40,650,400,250,0.6153846153846154,9,4,5,327.4887154440168,0.7138087606837606,0.17110938670662512,0.23303328776797028,138374.72766262892,1063.2323624300057,139437.96002505894,1526,20,729.025,36,4,18,28.35099361375718,0.7034143518518519,36.965090090090094,1052.1396396396403,29.226101101101122,0
1528,4,0,0,40,0.0,0.0,1.0,40,650,500,150,0.7692307692307693,8,5,3,327.44908984953946,0.713969017094017,0.17134260706470794,0.23329836045182073,138417.6035534971,1064.9436605493847,139482.54721404647,1527,21,730.025,37,3,18,28.309953631343127,0.7018581081081081,36.92434210526315,1052.3026315789461,28.44061166429584,0
1529,4,0,0,40,0.0,0.0,1.0,40,1150,600,550,0.5217391304347826,17,6,11,328.4296875000002,0.7128739316239316,0.1705104166666669,0.23459263392857135,138504.15512465363,1097.7752770083016,139601.93040166193,1528,22,731.025,37,3,18,28.19921875000001,0.7027027027027029,36.84210526315789,1052.6315789473676,28.449502133712638,0
1530,4,0,0,40,0.0,0.0,1.0,40,1250,900,350,0.72,16,9,7,328.39335489602655,0.7130608974358974,0.171261584921379,0.23516490582151686,138590.7337474029,1102.4552025623095,139693.1889499652,1529,23,732.025,37,3,19,28.115237425804438,0.7035472972972974,36.75986842105262,1052.9605263157882,28.45839260312941,0
1531,4,0,0,40,0.0,0.0,1.0,40,900,900,0,1.0,9,9,0,326.44859780160704,0.7124198717948718,0.1701795939614783,0.23417018535357992,138648.4678578985,1052.3195839104203,139700.78744180893,1530,24,733.025,37,3,20,28.1098169356238,0.7041103603603605,36.705043859649116,1053.1798245614027,28.464319582740615,0
1532,4,0,0,40,0.0,0.0,1.0,40,600,400,200,0.6666666666666666,8,4,4,325.6609985711325,0.7112713675213675,0.17369900083263978,0.2342029097508563,138735.09156663585,1036.1216912896207,139771.21325792547,1531,25,734.025,37,3,20,28.045639050791003,0.704954954954955,36.622807017543856,1053.5087719298242,28.473210052157413,0
1533,4,0,0,40,0.0,0.0,1.0,40,850,600,250,0.7058823529411765,11,6,5,326.0489259431509,0.7094284188034188,0.17563468941837512,0.23508298778991887,138821.74232696588,1052.5359966528013,139874.27832361867,1532,26,735.025,37,3,22,27.950503763049287,0.7057995495495496,36.54057017543859,1053.8377192982446,28.48210052157418,0
1534,4,0,0,40,0.0,0.0,1.0,40,1500,1200,300,0.8,18,12,6,326.47338399904464,0.7096955128205128,0.17494798710080128,0.2357917836500985,138879.52452918186,1068.0936682440492,139947.6181974259,1533,27,736.025,37,3,22,27.882706577897977,0.7063626126126127,36.485745614035075,1054.0570175438581,28.488027501185353,0
1535,4,0,1,39,0.0,0.025,0.975,40,1150,700,450,0.6086956521739131,16,7,9,327.80088530634305,0.7089476495726496,0.17524960998439942,0.23715617097219624,138937.3187543282,1108.75521795167,140046.07397227988,1534,28,737.025,37,3,22,27.791103310799105,0.7069256756756757,36.430921052631575,1054.2763157894733,28.493954480796575,0
1536,4,0,0,39,0.0,0.0,1.0,39,950,600,350,0.631578947368421,13,6,7,330.55421697963914,0.707714799820063,0.1566233382084692,0.23915367692143627,138938.09983970472,1385.3149602305168,140323.41479993524,1523,29,717.5897435897435,36,3,22,27.717768639179663,0.708912037037037,36.43018018018019,1054.2792792792804,29.28553553553557,0
1537,4,0,0,39,0.0,0.0,1.0,39,1450,1300,150,0.896551724137931,16,13,3,330.37042630467556,0.7073774179037338,0.15617864945219218,0.23986429556353456,139056.85034696877,1388.0541859427244,140444.9045329115,1524,30,718.5897435897435,36,3,23,27.60627980639193,0.7100694444444444,36.31756756756758,1054.7297297297312,29.298048048048088,0
1538,4,0,0,39,0.0,0.0,1.0,39,1100,900,200,0.8181818181818182,13,9,4,330.5386325233859,0.7073774179037338,0.1530195537454293,0.2404103966986863,139116.24462300146,1396.658651895153,140512.9032748966,1525,31,719.5897435897435,36,3,24,27.54367705664675,0.7106481481481481,36.26126126126127,1054.9549549549556,29.304304304304324,0
1539,4,0,0,39,0.0,0.0,1.0,39,1300,1000,300,0.7692307692307693,16,10,6,331.7058613401329,0.7056905083220874,0.14366853803473534,0.24211427823050855,139235.07121986873,1437.0178455482746,140672.089065417,1526,32,720.5897435897435,36,3,17,27.396544672072846,0.7118055555555556,36.14864864864866,1055.405405405407,29.31681681681686,0
1540,4,0,0,39,0.0,0.0,1.0,39,1200,1000,200,0.8333333333333334,14,10,4,330.85360355555537,0.7046221322537112,0.14146735042735048,0.24213524850377321,139324.22445672043,1419.1843448178145,140743.40880153826,1527,33,721.5897435897435,36,3,19,27.331777777777777,0.712673611111111,36.0641891891892,1055.743243243245,29.326201201201247,0
1541,4,0,0,39,0.0,0.0,1.0,39,950,600,350,0.631578947368421,13,6,7,332.1097399212569,0.7051282051282052,0.14363459350660746,0.24327038449232113,139353.948543138,1456.160721532377,140810.10926467038,1528,34,722.5897435897435,36,3,19,27.269535693970436,0.7129629629629628,36.03603603603605,1055.855855855858,29.329329329329386,0
1542,4,0,0,39,0.0,0.0,1.0,39,950,800,150,0.8421052631578947,11,8,3,330.8585668595149,0.7049595141700405,0.14513509523106483,0.2427849483574752,139413.40622717328,1425.2239570651966,140838.6301842385,1529,35,723.5897435897435,36,3,20,27.2443929053814,0.7135416666666665,35.97972972972974,1056.0810810810824,29.335585585585623,0
1543,4,0,0,39,0.0,0.0,1.0,39,1300,1000,300,0.7692307692307693,16,10,6,344.4165433766594,0.7054655870445344,0.16090441846320958,0.24011381870751777,137672.31131063268,1683.324316056695,139355.63562668939,1530,36,724.5897435897435,38,1,19,28.597212324815914,0.6927083333333333,37.63354700854701,1049.4658119658122,27.617521367521373,5
1544,4,0,0,39,0.0,0.0,1.0,39,1250,1000,250,0.8,15,10,5,342.5383434209094,0.7047345928924876,0.16299199738690207,0.23997730175143014,137841.2843976031,1643.2563817270502,139484.54077933016,1531,37,725.5897435897435,37,2,19,28.480017228777292,0.6962274774774775,37.47258771929825,1050.109649122807,28.381341868183974,0
1545,4,0,0,39,0.0,0.0,1.0,39,900,500,400,0.5555555555555556,13,5,8,341.8467115434084,0.7036099865047234,0.16726897263810026,0.2404664206951272,137980.8205950033,1633.6579552925737,139614.47855029587,1532,38,726.5897435897435,38,1,19,28.360789099044148,0.6957236842105263,37.33974358974359,1050.6410256410256,27.648448043184885,0
1546,4,0,0,39,0.0,0.0,1.0,39,700,400,300,0.5714285714285714,10,4,6,341.7355351608607,0.7037224471434999,0.16801324416982766,0.24058475220523023,138008.8840149938,1632.5079671634142,139641.3919821572,1533,39,727.5897435897435,38,1,20,28.336087103880693,0.6959978070175439,37.31303418803419,1050.7478632478633,27.651259559154298,0
1547,4,0,0,39,0.0,0.0,1.0,39,850,700,150,0.8235294117647058,10,7,3,340.0439844602354,0.7034975258659469,0.16408066652068265,0.2395897300251342,138036.95028855282,1587.7269157717815,139624.6772043246,1534,40,728.5897435897435,38,1,20,28.352904297139748,0.6962719298245614,37.28632478632478,1050.8547008547005,27.654071075123696,0
1548,4,0,0,39,0.0,0.0,1.0,39,1200,800,400,0.6666666666666666,16,8,8,345.4547144556813,0.7033850652271705,0.17559412132582897,0.24420074642556766,138149.2439184746,1744.8615220249756,139894.10544049955,1535,41,729.5897435897435,38,1,17,28.100228658536576,0.6973684210526316,37.179487179487175,1051.2820512820506,27.66531713900133,0
1549,4,0,0,39,0.0,0.0,1.0,39,1000,800,200,0.8,12,8,4,344.1816176176972,0.7022042285200181,0.17078038130669704,0.24370039428729304,138205.40785484682,1713.5521677989452,139918.96002264577,1536,42,730.5897435897435,38,1,18,28.078430874483487,0.6979166666666667,37.12606837606837,1051.4957264957254,27.670940170940142,0
1550,4,0,0,39,0.0,0.0,1.0,39,950,700,250,0.7368421052631579,12,7,5,345.38784724761985,0.7014732343679713,0.17165734171016633,0.2449566259586144,138261.5832054933,1750.774116078592,140012.3573215719,1537,43,731.5897435897435,38,1,18,27.991458417987264,0.6984649122807018,37.07264957264957,1051.7094017094005,27.67656320287896,0
1551,4,0,0,39,0.0,0.0,1.0,39,700,200,500,0.2857142857142857,12,2,10,353.6954000986866,0.7014732343679713,0.20260162338275833,0.23250883083303983,135605.12759935754,1821.6912252049115,137426.81882456245,1538,44,732.5897435897435,37,2,17,30.40089746289083,0.6742680180180181,39.61074561403509,1041.55701754386,28.150189663347568,6
1552,4,0,0,39,0.0,0.0,1.0,39,950,700,250,0.7368421052631579,12,7,5,353.6954000986866,0.7014732343679713,0.20260162338275833,0.23250883083303983,135605.12759935754,1792.5819723376458,137397.7095716952,1539,45,733.5897435897435,37,2,17,30.40089746289083,0.6742680180180181,39.61074561403509,1041.55701754386,28.150189663347568,0
1553,4,0,0,39,0.0,0.0,1.0,39,700,400,300,0.5714285714285714,10,4,6,351.78405317277793,0.7023166891587944,0.19828484151784487,0.23180666249984316,135690.79548514937,1746.7716028008706,137437.56708795024,1540,46,734.5897435897435,37,2,17,30.365537079912993,0.6751126126126126,39.52850877192983,1041.8859649122815,28.159080132764363,0
1554,4,0,0,39,0.0,0.0,1.0,39,1100,700,400,0.6363636363636364,15,7,8,353.63330742340264,0.7009109311740891,0.19868625150055985,0.23358475240162907,135776.49042253388,1803.0178756925216,137579.5082982264,1541,47,735.5897435897435,37,2,18,30.232224267929155,0.6759572072072071,39.44627192982456,1042.2149122807018,28.16797060218113,0
1555,4,0,0,39,0.0,0.0,1.0,39,850,600,250,0.7058823529411765,11,6,5,356.77253596129884,0.6999550157444895,0.2035861310385545,0.23679438866210153,135947.96145208142,1900.4997932056008,137848.46124528704,1542,48,736.5897435897435,37,2,15,29.980088844495842,0.6776463963963963,39.281798245614034,1042.872807017544,28.1857515410147,0
1556,4,0,0,39,0.0,0.0,1.0,39,1000,800,200,0.8,12,8,4,363.8676657333147,0.7003486279802069,0.21467716735270126,0.23021216503244718,134218.454655654,1967.5511587770989,136186.0058144311,1543,49,737.5897435897435,38,1,15,31.51935766573873,0.658717105263158,40.94551282051281,1036.2179487179474,27.268893387314403,3
1557,4,0,0,39,0.0,0.0,1.0,39,850,500,350,0.5882352941176471,12,5,7,359.2555344008372,0.7000112460638777,0.20495383030158965,0.22832841921153385,134384.5665885929,1855.6798570019557,136240.24644559485,1544,50,738.5897435897435,38,1,15,31.47282328696548,0.6603618421052633,40.7852564102564,1036.8589743589732,27.285762483130874,0
1558,4,0,0,39,0.0,0.0,1.0,39,700,500,200,0.7142857142857143,9,5,4,359.912596807698,0.6993927125506073,0.20789649552398126,0.229093218177857,134439.9600614542,1877.3270280882195,136317.28708954243,1545,51,739.5897435897435,38,1,15,31.40044984718931,0.6609100877192984,40.731837606837594,1037.0726495726476,27.291385515069674,0
1559,4,1,1,39,0.025,0.025,0.975,40,1200,1000,200,0.8333333333333334,14,10,4,353.66001402519333,0.7100694444444444,0.1995137388082744,0.22683263077774274,134717.09863987498,1528.8558559792423,136245.9544958542,1546,0,722.075,38,2,16,31.286019347535238,0.6636513157894738,40.464743589743584,1038.141025641025,27.319500674763816,0
1560,4,0,0,39,0.0,0.0,1.0,39,900,700,200,0.7777777777777778,11,7,4,359.6841247065709,0.6993927125506073,0.20531825596680453,0.23016940628456045,134633.92710387893,1885.1372452333865,136519.0643491123,1547,53,741.5897435897435,38,1,17,31.212682725962512,0.662828947368421,40.54487179487179,1037.820512820512,27.31106612685558,0
1561,4,0,0,39,0.0,0.0,1.0,39,900,600,300,0.6666666666666666,12,6,6,361.7144440522611,0.6997300944669366,0.20777226272749627,0.2319986305515391,134717.09863987486,1945.8240877711778,136662.92272764604,1548,54,742.5897435897435,38,1,17,31.07697849130389,0.6636513157894738,40.46474358974358,1038.141025641024,27.31950067476379,0
1562,4,0,0,39,0.0,0.0,1.0,39,1150,900,250,0.782608695652174,14,9,5,365.2758725803996,0.6996738641475484,0.21084203861981687,0.2348202038016852,134800.29585798795,2047.8591387244994,136848.15499671246,1549,55,743.5897435897435,38,1,14,30.90149176954732,0.6644736842105264,40.38461538461537,1038.4615384615367,27.32793522267202,0
1563,4,0,0,39,0.0,0.0,1.0,39,800,600,200,0.75,10,6,4,363.5478825383962,0.7000674763832658,0.2068585325451906,0.2338880851195065,134828.03397116272,2003.2892514062105,136831.32322256893,1550,56,744.5897435897435,38,1,14,30.918672633131013,0.664747807017544,40.35790598290597,1038.568376068374,27.33074673864142,0
1564,4,0,0,39,0.0,0.0,1.0,39,600,500,100,0.8333333333333334,7,5,2,364.27789930016337,0.6988866396761134,0.21088128666534844,0.23507648113431226,134939.01495954767,2031.0601806194586,136970.07514016712,1551,57,745.5897435897435,38,1,14,30.788988860325613,0.6658442982456141,40.25106837606837,1038.9957264957254,27.34199280251909,0
1565,4,0,0,39,0.0,0.0,1.0,39,750,600,150,0.8,9,6,3,363.9486489437582,0.6986617183985605,0.21073248399248223,0.23522448559972964,134994.52257515135,2026.2148212067832,137020.73739635813,1552,58,746.5897435897435,38,1,15,30.742178129604863,0.6663925438596492,40.19764957264956,1039.2094017093998,27.34761583445789,0
1566,4,0,0,39,0.0,0.0,1.0,39,750,600,150,0.8,9,6,3,362.8682360132518,0.7007984705353126,0.20180285579525203,0.23524788838407382,135105.57204918153,2005.1041210095414,137110.67617019106,1553,59,747.5897435897435,38,1,15,30.65953310725173,0.6674890350877194,40.09081196581195,1039.63675213675,27.358861898335523,0
1567,4,0,1,38,0.0,0.02564102564102564,0.9743589743589743,39,1050,800,250,0.7619047619047619,13,8,5,366.2916821895146,0.7007984705353126,0.20382732532265235,0.23856736518256222,135272.23186728402,2109.818672839508,137382.0505401235,1554,60,748.5897435897435,38,1,15,30.404428126390734,0.6691337719298245,39.93055555555556,1040.2777777777783,27.37573099415206,0
1568,4,0,0,38,0.0,0.0,1.0,38,1050,800,250,0.7619047619047619,13,8,5,370.85238631986385,0.6999170222854434,0.19326446716559476,0.2414740280725154,135262.7265721184,2432.5009858802773,137695.22755799867,1555,61,753.7894736842105,37,1,15,30.295294438002887,0.6708896396396395,39.939692982456144,1040.241228070176,28.114627785680433,0
1569,4,0,0,38,0.0,0.0,1.0,38,1050,700,350,0.6666666666666666,14,7,7,370.8196134905061,0.69950213371266,0.19212938573385308,0.24221947361585655,135376.81215614433,2440.075431863666,137816.887588008,1556,62,754.7894736842105,37,1,15,30.182431601868448,0.6720157657657657,39.83004385964913,1040.6798245614045,28.126481744902826,0
1570,4,0,0,38,0.0,0.0,1.0,38,700,400,300,0.5714285714285714,10,4,6,369.74290726519195,0.7005986249407302,0.1951759005687801,0.2420923559707402,135462.4079043552,2417.252904739927,137879.66080909513,1557,63,755.7894736842105,37,1,16,30.12516677199636,0.6728603603603602,39.74780701754386,1041.008771929825,28.13537221431959,0
1571,4,0,0,38,0.0,0.0,1.0,38,750,600,150,0.8,9,6,3,368.0856391532252,0.7002133712660028,0.19520800421274376,0.241198974724629,135490.94583189065,2374.454279201301,137865.40011109196,1558,64,756.7894736842105,37,1,16,30.139876250658247,0.6731418918918919,39.72039473684211,1041.1184210526321,28.138335704125193,0
1572,4,0,0,38,0.0,0.0,1.0,38,900,500,400,0.5555555555555556,13,5,8,365.4399999999996,0.6975462304409673,0.1909473684210521,0.24042105263157898,135633.68055555574,2313.1944444444634,137946.8750000002,1559,65,757.7894736842105,38,0,16,30.066666666666666,0.6726973684210525,39.58333333333334,1041.666666666668,27.412280701754423,0
1573,4,0,0,38,0.0,0.0,1.0,38,850,700,150,0.8235294117647058,10,7,3,365.1000127290455,0.6967164532954007,0.19545133911302215,0.24059154684965336,135692.33929875842,2308.254961042147,138000.59425980056,1560,66,758.7894736842105,36,2,16,30.01715845222655,0.6770833333333333,39.52702702702704,1041.8918918918935,28.941441441441484,0
1574,4,0,0,38,0.0,0.0,1.0,38,650,400,250,0.6153846153846154,9,4,5,368.0401704395041,0.6966868183973447,0.19336631692683914,0.24312717897342,135780.35119156336,2394.524718975756,138174.87591053912,1561,67,759.7894736842105,36,2,17,29.85300738339637,0.6779513888888888,39.44256756756758,1042.2297297297312,28.950825825825866,0
1575,4,0,0,38,0.0,0.0,1.0,38,1050,600,450,0.5714285714285714,15,6,9,367.93016817697975,0.6966275486012328,0.19008374885577317,0.24345457947207313,135839.04163876726,2395.856287030287,138234.89792579756,1562,68,760.7894736842105,36,2,18,29.79749558892369,0.6785300925925926,39.38626126126127,1042.4549549549558,28.957082082082106,0
1576,4,0,0,38,0.0,0.0,1.0,38,650,500,150,0.7692307692307693,8,5,3,367.14600964869777,0.6966275486012328,0.18680259889382134,0.24333607038921215,135897.74476757168,2378.86294233423,138276.60770990592,1563,69,761.7894736842105,36,2,14,29.759558267631498,0.6791087962962963,39.32995495495496,1042.6801801801805,28.963338338338346,0
1577,4,0,0,38,0.0,0.0,1.0,38,1250,800,450,0.64,17,8,9,365.8607605001033,0.6950865339023233,0.19041951884568364,0.24368799036904817,136073.93024358837,2356.8223206314606,138430.75256421985,1564,70,762.7894736842105,36,2,17,29.617961863644528,0.6808449074074074,39.161036036036045,1043.3558558558573,28.982107107107147,0
1578,4,0,0,38,0.0,0.0,1.0,38,1250,1000,250,0.8,15,10,5,366.5342333755366,0.6944049312470365,0.18602775821729578,0.24474346361127322,136162.0657819982,2381.611679246816,138543.677461245,1565,71,763.7894736842105,36,2,17,29.512839879154082,0.681712962962963,39.07657657657658,1043.6936936936936,28.991491491491487,0
1579,4,0,0,38,0.0,0.0,1.0,38,900,600,300,0.6666666666666666,12,6,6,363.6231066795028,0.6934862494073021,0.1849996309942148,0.24340431927983183,136250.22985400943,2308.746373062253,138558.9762270717,1566,72,764.7894736842105,36,2,17,29.50126739294574,0.6825810185185186,38.99211711711712,1044.0315315315318,29.00087587587588,0
1580,4,0,0,38,0.0,0.0,1.0,38,950,700,250,0.7368421052631579,12,7,5,364.66315665725676,0.691145092460882,0.18045349569598956,0.2449775197684785,136377.11242882413,2346.3416628193136,138723.45409164345,1567,73,765.7894736842105,37,1,18,29.348187416894113,0.6818693693693694,38.87061403508771,1044.5175438596482,28.2302038880986,0
1581,4,0,0,38,0.0,0.0,1.0,38,650,500,150,0.7692307692307693,8,5,3,364.2856756615761,0.6893966334755809,0.17383775842165994,0.24532001437308532,136463.02377895114,2342.304964027384,138805.32874297854,1568,74,766.7894736842105,37,1,18,29.272811942491334,0.682713963963964,38.78837719298245,1044.8464912280697,28.2390943575154,0
1582,4,0,0,38,0.0,0.0,1.0,38,1050,700,350,0.6666666666666666,14,7,7,364.2856756615761,0.6893966334755809,0.17383775842165994,0.24532001437308532,136463.02377895114,2342.304964027384,138805.32874297854,1569,75,767.7894736842105,37,1,18,29.272811942491334,0.682713963963964,38.78837719298245,1044.8464912280697,28.2390943575154,0
1583,4,0,0,38,0.0,0.0,1.0,38,800,600,200,0.75,10,6,4,363.93076923923894,0.6892484589853011,0.17282266526757595,0.24528007290310794,136491.66690712524,2334.703466451209,138826.37037357644,1570,76,768.7894736842105,37,1,18,29.25367261280167,0.6829954954954955,38.7609649122807,1044.956140350877,28.242057847320996,0
1584,4,0,1,37,0.0,0.02631578947368421,0.9736842105263158,38,750,400,350,0.5333333333333333,11,4,7,362.7444625440208,0.6883594120436226,0.17044262638976315,0.24527700041806333,136606.26947714668,2310.633560326241,138916.90303747292,1571,77,769.7894736842105,37,1,18,29.17103699042025,0.6841216216216217,38.65131578947368,1045.3947368421043,28.25391180654336,0
1585,4,0,0,37,0.0,0.0,1.0,37,900,700,200,0.7777777777777778,11,7,4,372.0312604724779,0.6827452452452453,0.1904734903790819,0.25135180766010834,136577.61432604247,2762.2284020082957,139339.84272805077,1572,78,786.5405405405405,37,0,18,28.956759851743072,0.6838400900900901,38.67872807017543,1045.285087719297,28.25094831673776,0
1586,4,0,0,37,0.0,0.0,1.0,37,900,600,300,0.6666666666666666,12,6,6,370.41837979217956,0.6826201201201201,0.19039360215830858,0.2510788975179822,136692.25296485424,2726.664574676787,139418.91753953102,1573,79,787.5405405405405,37,0,18,28.885197126979133,0.6849662162162163,38.5690789473684,1045.7236842105237,28.2628022759601,0
1587,4,0,0,37,0.0,0.0,1.0,37,850,700,150,0.8235294117647058,10,7,3,369.51259027250916,0.6835585585585585,0.19236496952805826,0.25110186397616063,136781.44959919402,2708.499559990432,139489.94915918444,1574,80,788.5405405405405,35,2,18,28.820443313417407,0.6898809523809524,38.48379629629629,1046.0648148148143,29.887566137566125,0
1588,4,0,0,37,0.0,0.0,1.0,37,1050,800,250,0.7619047619047619,13,8,5,370.2101161588864,0.6832457457457457,0.19529785344587913,0.25179302031303025,136811.7193528163,2729.81650270061,139541.5358555169,1575,81,789.5405405405405,35,2,18,28.772195486226344,0.6901785714285714,38.45486111111111,1046.180555555555,29.890873015872998,0
1589,4,0,0,37,0.0,0.0,1.0,37,850,600,250,0.7058823529411765,11,6,5,368.78602140834977,0.6821821821821822,0.1891622906772743,0.25169298049778915,136932.83185710304,2699.782852151913,139632.61470925497,1576,82,790.5405405405405,35,2,19,28.689432894688323,0.6913690476190476,38.33912037037037,1046.6435185185185,29.90410052910053,0
1590,4,0,0,37,0.0,0.0,1.0,37,950,600,350,0.631578947368421,13,6,7,367.860021718947,0.6812437437437437,0.19115146123858606,0.25165523340110735,137015.51371895536,2680.5059704975138,139696.0196894529,1577,83,791.5405405405405,36,1,17,28.63177189774478,0.6901041666666667,38.26013513513513,1046.9594594594587,29.082207207207187,0
1591,4,0,0,37,0.0,0.0,1.0,37,800,500,300,0.625,11,5,6,364.54721999261056,0.6792417417417418,0.19172015796034692,0.25023274488201275,137133.43992218573,2598.322858331304,139731.76278051705,1578,84,792.5405405405405,36,1,18,28.601763251263293,0.6912615740740741,38.14752252252252,1047.4099099099103,29.09471971971973,0
1592,4,0,0,37,0.0,0.0,1.0,37,700,500,200,0.7142857142857143,9,5,4,364.54721999261056,0.6792417417417418,0.19172015796034692,0.25023274488201275,137133.43992218573,2598.322858331304,139731.76278051705,1579,85,793.5405405405405,36,1,18,28.601763251263293,0.6912615740740741,38.14752252252252,1047.4099099099103,29.09471971971973,0
1593,4,0,0,37,0.0,0.0,1.0,37,900,500,400,0.5555555555555556,13,5,8,363.30238984724394,0.678490990990991,0.19186225571949067,0.24958927846078738,137162.92939899355,2566.324009820625,139729.25340881417,1580,86,794.5405405405405,36,1,18,28.605183473088204,0.6915509259259259,38.119369369369366,1047.5225225225222,29.097847847847838,0
1594,4,0,0,37,0.0,0.0,1.0,37,1150,1100,50,0.9565217391304348,12,11,1,364.563782605677,0.6779904904904905,0.19350491690917182,0.25130596747618017,137280.91901022653,2609.530222790361,139890.4492330169,1581,87,795.5405405405405,36,1,18,28.455431979368136,0.6927083333333333,38.00675675675676,1047.9729729729736,29.110360360360378,0
1595,4,0,0,37,0.0,0.0,1.0,37,900,800,100,0.8888888888888888,10,8,2,364.8249589237456,0.678490990990991,0.18906142928489267,0.251913257986812,137339.93283824375,2621.0070712604575,139960.9399095042,1582,88,796.5405405405405,36,1,18,28.390228835410387,0.693287037037037,37.950450450450454,1048.198198198199,29.11661661661664,0
1596,4,0,0,37,0.0,0.0,1.0,37,450,300,150,0.6666666666666666,6,3,3,365.9984701665164,0.6781781781781782,0.1919238250065316,0.25315347379273906,137398.95934786138,2657.5617847577287,140056.52113261912,1583,89,797.5405405405405,36,1,18,28.301109917651257,0.6938657407407407,37.89414414414414,1048.4234234234234,29.122872872872872,0
1597,4,0,0,37,0.0,0.0,1.0,37,1350,1000,350,0.7407407407407407,17,10,7,366.0279175488314,0.6779904904904905,0.19420924037630027,0.25403755767882397,137517.05041189847,2667.0159179449793,140184.06632984345,1584,90,798.5405405405405,36,1,18,28.183603535895788,0.6950231481481481,37.781531531531535,1048.8738738738746,29.135385385385405,0
1598,4,0,0,37,0.0,0.0,1.0,37,1000,700,300,0.7,13,7,6,365.4059778872057,0.6769894894894894,0.19141412529842272,0.2542559743073264,137605.6519991277,2656.3855663095746,140262.03756543726,1585,91,799.5405405405405,36,1,18,28.11236628385389,0.6958912037037036,37.69707207207208,1049.2117117117134,29.144769769769816,0
1599,4,0,0,37,0.0,0.0,1.0,37,650,500,150,0.7692307692307693,8,5,3,364.34039529848496,0.6771771771771772,0.19155601190372584,0.2537312259634743,137635.19220233764,2629.212066796543,140264.4042691342,1586,92,800.5405405405405,36,1,18,28.111137940902918,0.6961805555555556,37.668918918918926,1049.3243243243255,29.14789789789793,0
1600,4,0,0,37,0.0,0.0,1.0,37,550,300,250,0.5454545454545454,8,3,5,363.6150031857925,0.6765515515515516,0.18575898073805996,0.25387681233668735,137723.83183436832,2615.6903102426913,140339.52214461102,1587,93,801.5405405405405,36,1,18,28.042636698494434,0.697048611111111,37.58445945945947,1049.6621621621634,29.157282282282317,0
1601,4,0,0,37,0.0,0.0,1.0,37,1300,1200,100,0.9230769230769231,14,12,2,365.18822169257305,0.676488988988989,0.1892616632507227,0.2554125874598544,137782.9407743893,2663.34142419447,140446.28219858377,1588,94,802.5405405405405,36,1,18,27.942990453716636,0.6976273148148149,37.528153153153156,1049.8873873873877,29.163538538538546,0
1602,4,0,0,37,0.0,0.0,1.0,37,1200,700,500,0.5833333333333334,17,7,10,361.8732892013078,0.675487987987988,0.18827623815155015,0.25377155463703804,137875.0070861679,2578.6628033853076,140453.66988955322,1589,95,803.5405405405405,34,3,18,27.939148341268044,0.7028186274509803,37.4404761904762,1050.238095238096,30.889355742296942,0
1603,4,0,0,37,0.0,0.0,1.0,37,1050,1000,50,0.9523809523809523,11,10,1,361.49876814676315,0.6758008008008008,0.19248143327463474,0.2542013250115685,137968.79428854873,2575.1098356009043,140543.90412414965,1590,96,804.5405405405405,34,3,18,27.856468366383382,0.7037377450980392,37.351190476190474,1050.5952380952378,30.899859943977585,0
1604,4,0,0,37,0.0,0.0,1.0,37,350,200,150,0.5714285714285714,5,2,3,361.14586155924695,0.6754254254254254,0.1933109179880088,0.2541844795950489,138000.06377551015,2567.630385487524,140567.69416099766,1591,97,805.5405405405405,34,3,19,27.834900672256218,0.7040441176470589,37.32142857142857,1050.7142857142853,30.903361344537803,0
1605,4,0,0,37,0.0,0.0,1.0,37,900,600,300,0.6666666666666666,12,6,6,365.60573354111074,0.6726101101101101,0.19657967082009375,0.2586575142902999,138177.32445987657,2703.6844135802485,140881.00887345683,1592,98,806.5405405405405,35,2,16,27.542932628797885,0.7035714285714285,37.15277777777778,1051.3888888888891,30.03968253968255,0
1606,4,0,0,37,0.0,0.0,1.0,37,800,600,200,0.75,10,6,4,363.840724806586,0.6726101101101101,0.19868195660449195,0.25832691461267604,138299.03978052127,2663.764574759948,140962.80435528123,1593,99,807.5405405405405,35,2,16,27.46937353286385,0.7047619047619047,37.03703703703704,1051.851851851852,30.052910052910057,0
1607,4,0,0,37,0.0,0.0,1.0,37,1150,900,250,0.782608695652174,14,9,5,366.95235814993003,0.6717342342342342,0.20356476141781932,0.2614679341927245,138420.80868484228,2758.768432784639,141179.57711762693,1594,100,808.5405405405405,35,2,16,27.267561225986217,0.7059523809523809,36.9212962962963,1052.314814814815,30.06613756613757,0
1608,4,0,0,37,0.0,0.0,1.0,37,600,400,200,0.6666666666666666,8,4,4,366.91667968765336,0.6703578578578578,0.2026239543556747,0.2621451061868978,138512.17052737056,2764.485141246571,141276.65566861714,1595,101,809.5405405405405,35,2,17,27.17850925416895,0.7068452380952381,36.83449074074074,1052.6620370370372,30.076058201058206,0
1609,4,0,0,37,0.0,0.0,1.0,37,850,600,250,0.7058823529411765,11,6,5,370.0463082616028,0.6695445445445445,0.21528373775379595,0.26580832292729656,138694.9846348808,2864.7134077074693,141559.69804258825,1596,102,810.5405405405405,35,2,18,26.916112698238283,0.7086309523809524,36.660879629629626,1053.356481481481,30.095899470899457,0
1610,4,0,0,37,0.0,0.0,1.0,37,550,300,250,0.5454545454545454,8,3,5,371.01828200431794,0.6706081081081081,0.21476749156889774,0.26722709172209747,138786.43689986286,2898.4610768175635,141684.89797668043,1597,103,811.5405405405405,35,2,18,26.8004906268307,0.7095238095238094,36.574074074074076,1053.703703703704,30.10582010582011,0
1611,4,0,0,37,0.0,0.0,1.0,37,900,600,300,0.6666666666666666,12,6,6,366.90819849064803,0.6692942942942943,0.20955071685279236,0.26498278855307944,138877.91930566274,2791.089436514062,141669.0087421768,1598,104,812.5405405405405,35,2,18,26.8187703597965,0.7104166666666667,36.48726851851852,1054.050925925926,30.115740740740744,0
1612,4,0,0,37,0.0,0.0,1.0,37,1700,1400,300,0.8235294117647058,20,14,6,365.7925799565769,0.6693568568568569,0.20856711360608626,0.26465485391774896,138938.9243210948,2764.5655167609684,141703.48983785577,1599,105,813.5405405405405,35,2,18,26.78818110293848,0.7110119047619048,36.429398148148145,1054.2824074074072,30.12235449735449,0
1613,4,0,0,37,0.0,0.0,1.0,37,1350,1200,150,0.8888888888888888,15,12,3,366.203498960087,0.6692942942942943,0.20822468830371355,0.2654319871937433,138999.942732446,2780.453076774693,141780.3958092207,1600,106,814.5405405405405,35,2,18,26.71736088244978,0.7116071428571429,36.37152777777778,1054.5138888888891,30.12896825396826,0
1614,4,0,0,37,0.0,0.0,1.0,37,550,400,150,0.7272727272727273,7,4,3,366.90834247436794,0.668606106106106,0.21176805508602747,0.26666687665960037,139091.49546682095,2806.7660108024684,141898.26147762343,1601,107,815.5405405405405,35,2,19,26.608788676761026,0.7125,36.28472222222222,1054.8611111111109,30.138888888888882,0
1615,4,0,0,37,0.0,0.0,1.0,37,950,700,250,0.7368421052631579,12,7,5,368.4494214697976,0.6684184184184184,0.21257625249728762,0.26876174599692904,139213.61266503762,2858.635009430711,142072.24767446832,1602,108,816.5405405405405,35,2,15,26.44814286758792,0.7136904761904763,36.168981481481474,1055.3240740740732,30.152116402116377,0
1616,4,0,0,37,0.0,0.0,1.0,37,850,600,250,0.7058823529411765,11,6,5,366.82825484764544,0.6687312312312312,0.20881934566145133,0.26806680161943314,139274.69135802463,2817.97839506172,142092.66975308635,1603,109,817.5405405405405,35,2,16,26.430921052631575,0.7142857142857143,36.11111111111111,1055.555555555555,30.15873015873014,0
1617,4,0,0,37,0.0,0.0,1.0,37,1050,1000,50,0.9523809523809523,11,10,1,367.35338612674764,0.6676676676676676,0.20399746380890882,0.2689404163923106,139335.78344693058,2837.09437157063,142172.8778185012,1604,110,818.5405405405405,35,2,16,26.357067163633705,0.7148809523809524,36.05324074074073,1055.787037037036,30.165343915343886,0
1618,4,0,0,37,0.0,0.0,1.0,37,1250,700,550,0.56,18,7,11,372.201521402909,0.6679179179179179,0.20578930530706097,0.2729876753440626,139396.88893175565,2976.746827846342,142373.63575960198,1605,111,819.5405405405405,35,2,16,26.16907788981441,0.7154761904761906,35.99537037037036,1056.018518518517,30.17195767195763,0
1619,4,0,0,37,0.0,0.0,1.0,37,550,200,350,0.36363636363636365,9,2,7,370.87513604803905,0.6672922922922923,0.2054054054054053,0.27226352505537843,139427.4466976379,2942.034652563425,142369.48135020133,1606,112,820.5405405405405,35,2,16,26.174086757990846,0.7157738095238095,35.966435185185176,1056.1342592592582,30.17526455026452,0
1620,4,0,0,37,0.0,0.0,1.0,37,750,400,350,0.5333333333333333,11,4,7,371.7069252425175,0.6676676676676676,0.1968363368297643,0.27387510254551595,139549.71125096446,2974.318817515429,142524.0300684799,1607,113,821.5405405405405,35,2,16,26.032081827144264,0.7169642857142857,35.85069444444444,1056.597222222222,30.188492063492056,0
1621,4,0,0,37,0.0,0.0,1.0,37,750,500,250,0.6666666666666666,10,5,5,370.1803930236367,0.6671046046046046,0.19679890820830415,0.2738284751231584,139681.12274013885,2941.442582785495,142622.56532292435,1608,114,822.5405405405405,36,1,17,25.943459039096634,0.7161458333333334,35.726351351351354,1057.094594594595,29.36373873873875,0
1622,4,0,0,37,0.0,0.0,1.0,37,750,500,250,0.6666666666666666,10,5,5,368.60753004635257,0.6661036036036035,0.19530265089370502,0.27339847607703405,139770.4186449964,2904.085758055359,142674.50440305175,1609,115,823.5405405405405,36,1,18,25.89745296414626,0.7170138888888888,35.641891891891895,1057.4324324324327,29.373123123123133,0
1623,4,0,0,37,0.0,0.0,1.0,37,600,400,200,0.6666666666666666,8,4,4,365.5654438854036,0.6644144144144144,0.1884123851336963,0.2721174152028118,139889.52423707506,2827.7552045288685,142717.27944160393,1610,116,824.5405405405405,36,1,19,25.861143637782995,0.7181712962962963,35.52927927927929,1057.8828828828841,29.38563563563567,0
1624,4,0,0,37,0.0,0.0,1.0,37,550,400,150,0.7272727272727273,7,4,3,365.2351724899103,0.6627252252252253,0.18869444156800452,0.27236108577104756,139949.09605551505,2822.866447528615,142771.96250304367,1611,117,825.5405405405405,36,1,19,25.811515538527026,0.71875,35.472972972972975,1058.1081081081086,29.391891891891905,0
1625,4,0,0,37,0.0,0.0,1.0,37,1300,1000,300,0.7692307692307693,16,10,6,363.309718328355,0.6631631631631631,0.18235263719461225,0.2716725572462074,140040.18034297062,2775.617058212386,142815.797401183,1612,118,826.5405405405405,34,3,20,25.773253852210097,0.7239583333333333,35.386904761904766,1058.4523809523816,31.1309523809524,0
1626,4,0,0,37,0.0,0.0,1.0,37,1050,500,550,0.47619047619047616,16,5,11,367.9773548563529,0.6631631631631631,0.19147166108492097,0.26949555410577997,139348.0034722223,2855.381944444455,142203.38541666677,1613,119,827.5405405405405,34,3,17,26.328597737437516,0.7172181372549019,36.04166666666667,1055.833333333334,31.05392156862747,1
1627,4,0,0,37,0.0,0.0,1.0,37,700,300,400,0.42857142857142855,11,3,8,374.0578299567487,0.6634134134134134,0.1634788951806334,0.24481748990582416,135447.73242630382,2763.9597505668885,138211.6921768707,1614,120,828.5405405405405,34,3,19,30.027495044220792,0.678921568627451,39.76190476190476,1040.9523809523807,30.616246498599434,7
1628,4,0,0,37,0.0,0.0,1.0,37,450,300,150,0.6666666666666666,6,3,3,371.96763144776173,0.6629129129129129,0.15849716627214971,0.24387023273179328,135509.70096371873,2681.0445011337806,138190.74546485252,1615,121,829.5405405405405,34,3,19,30.020152069517508,0.6795343137254901,39.70238095238095,1041.1904761904755,30.623249299719866,0
1629,4,0,0,37,0.0,0.0,1.0,37,950,900,50,0.9473684210526315,10,9,1,376.73250181572905,0.6629129129129129,0.11568078084831024,0.22731742680794356,132457.5684263543,2580.2142275376923,135037.78265389198,1616,122,830.5405405405405,35,2,19,32.955269470054716,0.6470238095238097,42.65046296296295,1029.3981481481458,29.411375661375594,7
1630,4,0,0,37,0.0,0.0,1.0,37,1250,1100,150,0.88,14,11,3,372.02742936953626,0.662037037037037,0.10301357556988466,0.22533528933866084,132600.90115453288,2466.2344777209637,135067.13563225383,1617,123,831.5405405405405,36,1,19,32.93197390480356,0.6464120370370371,42.51126126126126,1029.9549549549547,28.609859859859853,0
1631,4,0,0,37,0.0,0.0,1.0,37,600,500,100,0.8333333333333334,7,5,2,367.4543168986228,0.6621621621621622,0.09508645162814999,0.22308158893865296,132687.90486009658,2351.348688215242,135039.25354831183,1618,124,832.5405405405405,36,1,13,32.96216344227056,0.6472800925925927,42.4268018018018,1030.2927927927926,28.61924424424424,0
1632,4,0,0,37,0.0,0.0,1.0,37,800,600,200,0.75,10,6,4,366.32525165361125,0.661473973973974,0.09301006831331371,0.2227403573343655,132745.92318247317,2325.6367431621,135071.55992563526,1619,125,833.5405405405405,36,1,14,32.932876188394715,0.6478587962962963,42.370495495495504,1030.5180180180193,28.625500500500536,0
1633,4,0,0,37,0.0,0.0,1.0,37,500,300,200,0.6,7,3,4,366.85264435236763,0.6609734734734735,0.09579625507088907,0.22357983398146292,132832.97444403867,2346.0255863972125,135179.00003043588,1620,126,834.5405405405405,36,1,14,32.831731119364946,0.6487268518518519,42.28603603603604,1030.8558558558561,28.634884884884894,0
1634,4,0,0,37,0.0,0.0,1.0,37,950,500,450,0.5263157894736842,14,5,9,368.96583779866893,0.6633508508508509,0.09830638498760758,0.22591758517619037,133007.1625679734,2415.0198340232155,135422.1824019966,1621,127,835.5405405405405,36,1,15,32.60211972343522,0.650462962962963,42.11711711711712,1031.5315315315318,28.65365365365366,0
1635,4,0,0,37,0.0,0.0,1.0,37,950,500,450,0.5263157894736842,14,5,9,371.98980520822965,0.6638513513513513,0.09497639889262,0.22901481157446896,133210.52629910325,2510.591545937841,135721.1178450411,1622,128,836.5405405405405,36,1,16,32.31973382786081,0.6524884259259258,41.92004504504505,1032.3198198198206,28.67555055055057,0
1636,4,0,0,37,0.0,0.0,1.0,37,1200,1100,100,0.9166666666666666,13,11,2,369.2347193924398,0.6642267267267267,0.09072285285612813,0.2276740512514648,133268.6587558843,2441.4831639071517,135710.14191979147,1623,129,837.5405405405405,36,1,16,32.3324517395572,0.6530671296296295,41.86373873873874,1032.5450450450453,28.681806806806815,0
1637,4,0,0,37,0.0,0.0,1.0,37,650,300,350,0.46153846153846156,10,3,7,370.6778349797489,0.6645395395395395,0.08559884712975951,0.22892164475416038,133326.80389426608,2484.2582024592357,135811.0620967253,1624,130,838.5405405405405,36,1,16,32.23680623705158,0.6536458333333333,41.80743243243244,1032.7702702702718,28.688063063063105,0
1638,4,0,0,37,0.0,0.0,1.0,37,1050,800,250,0.7619047619047619,13,8,5,370.3324277969856,0.6646646646646647,0.08772736110865598,0.22924626805732462,133414.0453798395,2481.5094655466473,135895.55484538613,1625,131,839.5405405405405,36,1,19,32.15813712666231,0.6545138888888888,41.72297297297298,1033.1081081081095,28.697447447447487,0
1639,4,1,0,38,0.02631578947368421,0.0,1.0,38,500,300,200,0.6,7,3,4,362.690877214969,0.6776612138454243,0.08715273707654436,0.22573018358151442,133613.88991083796,2092.1077879732275,135705.99769881117,1626,0,818.421052631579,37,1,20,32.15511984303744,0.6545608108108107,41.5296052631579,1033.8815789473686,27.942745376955905,0
1640,4,0,0,38,0.0,0.0,1.0,38,800,500,300,0.625,11,5,6,362.690877214969,0.6776612138454243,0.08715273707654436,0.22573018358151442,133613.88991083796,2092.1077879732275,135705.99769881117,1627,1,819.421052631579,37,1,20,32.15511984303744,0.6545608108108107,41.5296052631579,1033.8815789473686,27.942745376955905,0
1641,4,0,0,38,0.0,0.0,1.0,38,750,500,250,0.6666666666666666,10,5,5,361.6143336779276,0.6785798956851589,0.0859225034596669,0.2255784652943262,133698.92659279777,2069.4896506617383,135768.4162434595,1628,2,820.421052631579,37,1,20,32.09773466214306,0.6554054054054055,41.44736842105263,1034.2105263157891,27.951635846372678,0
1642,4,1,2,37,0.02564102564102564,0.05128205128205128,0.9487179487179487,39,650,300,350,0.46153846153846156,10,3,7,355.343578734498,0.6875281151596941,0.08429331703147369,0.22313181687352873,133941.82971957407,1719.0738229600342,135660.9035425341,1629,0,800.3589743589744,38,1,13,32.0167629958372,0.6559758771929824,41.212606837606835,1035.1495726495723,27.240778227620325,0
1643,4,0,0,37,0.0,0.0,1.0,37,750,600,150,0.8,9,6,3,373.4673105931841,0.6659159159159159,0.09742560504755637,0.23301112639183466,133705.05640775923,2586.8935658631744,136291.9499736224,1630,136,844.5405405405405,36,1,13,31.785124491869926,0.6574074074074073,41.44144144144145,1034.2342342342351,28.728728728728754,0
1644,4,0,0,37,0.0,0.0,1.0,37,700,500,200,0.7142857142857143,9,5,4,374.7159585336039,0.6658533533533534,0.10063573969092632,0.23434414642942264,133792.4215389376,2626.8310962990004,136419.2526352366,1631,137,845.5405405405405,36,1,14,31.665215340517392,0.658275462962963,41.35698198198198,1034.5720720720722,28.738113113113116,0
1645,4,0,0,37,0.0,0.0,1.0,37,1150,1000,150,0.8695652173913043,13,10,3,373.28837111824936,0.6647897897897898,0.10297326706467058,0.23400546593292715,133879.81520371724,2595.155628601572,136474.97083231882,1632,138,846.5405405405405,36,1,15,31.614526659412398,0.6591435185185186,41.27252252252252,1034.90990990991,28.747497497497502,0
1646,4,0,0,37,0.0,0.0,1.0,37,1200,900,300,0.75,15,9,6,372.46038568020936,0.6659159159159159,0.1088958452743114,0.23441295320530633,134025.53471968594,2583.840470538108,136609.37519022403,1633,139,847.5405405405405,36,1,16,31.489940184883086,0.6605902777777778,41.13175675675676,1035.4729729729734,28.76313813813815,0
1647,4,0,0,37,0.0,0.0,1.0,37,650,500,150,0.7692307692307693,8,5,3,370.189285407029,0.666041041041041,0.10791415532091886,0.2333537256948898,134083.84471887417,2527.280532221403,136611.12525109557,1634,140,848.5405405405405,36,1,16,31.490341053242,0.6611689814814815,41.07545045045045,1035.6981981981974,28.76939439439437,0
1648,4,0,0,37,0.0,0.0,1.0,37,750,400,350,0.5333333333333333,11,4,7,371.7329867674855,0.6667292292292292,0.11242068155111618,0.23488622790253216,134171.33349565792,2575.1821077834657,136746.5156034414,1635,141,849.5405405405405,36,1,16,31.36277173913042,0.662037037037037,40.990990990990994,1036.0360360360369,28.7787787787788,0
1649,4,0,0,37,0.0,0.0,1.0,37,900,700,200,0.7777777777777778,11,7,4,370.45957534946217,0.6681681681681682,0.11550714212311197,0.2350158780904065,134317.21153163293,2551.8194292265202,136869.03096085944,1636,142,850.5405405405405,36,1,16,31.249773673728047,0.6634837962962963,40.85022522522522,1036.5990990990988,28.794419419419413,0
1650,4,0,0,37,0.0,0.0,1.0,37,750,600,150,0.8,9,6,3,369.2016763272369,0.6681056056056056,0.11588043299598416,0.23477962953185055,134404.77639801963,2524.49375050726,136929.2701485269,1637,143,851.5405405405405,36,1,16,31.19479438169706,0.6643518518518519,40.765765765765764,1036.936936936937,28.803803803803802,0
1651,4,0,0,37,0.0,0.0,1.0,37,800,400,400,0.5,12,4,8,370.70193446120675,0.6680430430430431,0.11484652205685997,0.23592219173830342,134433.9710276154,2566.9866234477627,137000.95765106316,1638,144,852.5405405405405,36,1,16,31.126705758859078,0.6646412037037037,40.73761261261261,1037.049549549549,28.806931931931917,0
1652,4,0,0,37,0.0,0.0,1.0,37,900,700,200,0.7777777777777778,11,7,4,369.47829496957036,0.6668543543543544,0.11516782225717148,0.23552003978994573,134492.3697980076,2538.4022958769683,137030.77209388456,1639,145,853.5405405405405,36,1,16,31.100043426338072,0.6652199074074073,40.68130630630631,1037.2747747747758,28.813188188188217,0
1653,4,0,0,37,0.0,0.0,1.0,37,950,700,250,0.7368421052631579,12,7,5,370.80047096014596,0.667042042042042,0.11635732117659847,0.2367418391514777,134550.78125,2578.298611111111,137129.07986111112,1640,146,854.5405405405405,36,1,16,31.00736278447121,0.6657986111111112,40.625,1037.5,28.819444444444443,0
1654,4,0,0,37,0.0,0.0,1.0,37,800,600,200,0.75,10,6,4,370.15105181606924,0.6669169169169169,0.11429074218005297,0.2367065886526773,134609.2053835931,2565.147791372459,137174.35317496557,1641,147,855.5405405405405,36,1,16,30.965816603364086,0.6663773148148149,40.568693693693696,1037.7252252252256,28.82570070070071,0
1655,4,0,0,37,0.0,0.0,1.0,37,950,700,250,0.7368421052631579,12,7,5,368.4243366107674,0.6669169169169169,0.10582140878268409,0.23636074872753407,134726.09169558072,2527.274191421151,137253.36588700186,1642,148,856.5405405405405,36,1,17,30.89385146617493,0.6675347222222222,40.45608108108108,1038.1756756756758,28.83821321321322,0
1656,4,0,0,37,0.0,0.0,1.0,37,1100,800,300,0.7272727272727273,14,8,6,366.95394344404133,0.667042042042042,0.09936475938210498,0.2363675401066927,134872.27091956828,2498.3823350377443,137370.65325460603,1643,149,857.5405405405405,36,1,16,30.786083405608547,0.6689814814814814,40.31531531531532,1038.7387387387394,28.85385385385387,0
1657,4,0,0,37,0.0,0.0,1.0,37,1000,600,400,0.6,14,6,8,366.43278411527854,0.6680430430430431,0.09383586925316822,0.23641320742989935,134930.76480196422,2488.6111618375216,137419.37596380175,1644,150,858.5405405405405,36,1,17,30.741247561239966,0.6695601851851851,40.25900900900901,1038.9639639639647,28.86011011011013,0
1658,4,0,0,37,0.0,0.0,1.0,37,900,600,300,0.6666666666666666,12,6,6,365.60605402562885,0.66747997997998,0.09080261192937233,0.2366440307613292,135047.79061155755,2474.8579660741857,137522.64857763174,1645,151,859.5405405405405,36,1,17,30.645991332611054,0.6707175925925927,40.1463963963964,1039.4144144144148,28.872622622622632,0
1659,4,0,0,37,0.0,0.0,1.0,37,450,300,150,0.6666666666666666,6,3,3,365.60605402562885,0.66747997997998,0.09080261192937233,0.2366440307613292,135047.79061155755,2474.8579660741857,137522.64857763174,1646,152,860.5405405405405,36,1,17,30.645991332611054,0.6707175925925927,40.1463963963964,1039.4144144144148,28.872622622622632,0
1660,4,0,0,37,0.0,0.0,1.0,37,700,500,200,0.7142857142857143,9,5,4,366.5822213542628,0.6679804804804804,0.09367378428151896,0.2374681042330667,135077.05498995614,2503.369374442008,137580.42436439815,1647,153,861.5405405405405,36,1,17,30.59144007510924,0.6710069444444444,40.11824324324324,1039.5270270270269,28.875750750750747,0
1661,4,0,0,37,0.0,0.0,1.0,37,700,200,500,0.2857142857142857,12,2,10,367.87028916075195,0.6672922922922923,0.09654433462925693,0.23849568184916176,135106.32253875505,2540.3203879555304,137646.64292671057,1648,154,862.5405405405405,36,1,17,30.528776718659746,0.6712962962962963,40.090090090090094,1039.63963963964,28.878878878878893,0
1662,4,0,0,37,0.0,0.0,1.0,37,1200,900,300,0.75,15,9,6,368.3414903688796,0.6649774774774775,0.10206374376108074,0.23996746742085415,135281.99440995057,2565.994288207132,137847.9886981577,1649,155,863.5405405405405,36,1,17,30.3413888287508,0.6730324074074073,39.921171171171174,1040.315315315316,28.897647647647666,0
1663,4,0,0,37,0.0,0.0,1.0,37,850,600,250,0.7058823529411765,11,6,5,366.85325173177455,0.664039039039039,0.09681296922937421,0.239582395706949,135369.87314595006,2532.17563002192,137902.04877597198,1650,156,864.5405405405405,36,1,17,30.292536882732755,0.6739004629629629,39.836711711711715,1040.6531531531534,28.90703203203204,0
1664,4,0,1,36,0.0,0.02702702702702703,0.972972972972973,37,1000,700,300,0.7,13,7,6,365.17445736092833,0.6649774774774775,0.09724467571952689,0.2392656171723449,135487.08917955132,2495.2848541108833,137982.3740336622,1651,157,865.5405405405405,36,1,17,30.21948801153778,0.6750578703703705,39.72409909909911,1041.1036036036048,28.91954454454458,0
1665,4,0,0,36,0.0,0.0,1.0,36,950,800,150,0.8421052631578947,11,8,3,371.4254505388735,0.6656415343915344,0.09289739027283517,0.2427222130265663,135392.66117969825,2857.656035665299,138250.31721536355,1652,158,862.8055555555555,35,1,17,30.150874851720037,0.6761904761904761,39.81481481481482,1040.740740740741,29.735449735449745,0
1666,4,0,0,36,0.0,0.0,1.0,36,850,600,250,0.7058823529411765,11,6,5,373.66694540856884,0.663723544973545,0.09723148765843881,0.24459683457093662,135452.89592978393,2922.8539737654287,138375.74990354935,1653,159,863.8055555555555,35,1,17,30.032521681120745,0.6767857142857143,39.75694444444444,1040.9722222222222,29.74206349206349,0
1667,4,0,0,36,0.0,0.0,1.0,36,850,600,250,0.7058823529411765,11,6,5,372.38040092390384,0.6633597883597884,0.09516798162758788,0.24478095163726893,135603.54141214426,2899.220223551098,138502.76163569535,1654,160,864.8055555555555,35,1,18,29.91593973404452,0.6782738095238094,39.61226851851852,1041.5509259259263,29.758597883597893,0
1668,4,0,0,36,0.0,0.0,1.0,36,1100,700,400,0.6363636363636364,15,7,8,373.10630094606285,0.6625992063492064,0.09155190285798942,0.24629392475940962,135754.27061899853,2930.1547496570547,138684.4253686556,1655,161,865.8055555555555,35,1,19,29.74696431215756,0.6797619047619048,39.46759259259259,1042.1296296296289,29.775132275132254,0
1669,4,0,0,36,0.0,0.0,1.0,36,700,500,200,0.7142857142857143,9,5,4,372.6271338837552,0.6622685185185185,0.09465660153937261,0.2468106780900636,135874.9142661179,2926.1359739368904,138801.05024005478,1656,162,866.8055555555555,35,1,15,29.63939461219657,0.680952380952381,39.35185185185185,1042.5925925925922,29.788359788359777,0
1670,4,0,0,36,0.0,0.0,1.0,36,750,400,350,0.5333333333333333,11,4,7,372.96033163061816,0.6639219576719577,0.092210386151798,0.24787009650849,135995.61149691336,2944.193672839482,138939.80516975286,1657,163,867.8055555555555,35,1,15,29.51065246338216,0.6821428571428572,39.2361111111111,1043.0555555555538,29.80158730158725,0
1671,4,0,0,36,0.0,0.0,1.0,36,900,400,500,0.4444444444444444,14,4,10,361.69695179902925,0.6639219576719577,0.07634306378854006,0.22662455823651856,133861.20119866682,2483.4376875428675,136344.6388862097,1658,164,868.8055555555555,35,1,19,31.93306583901876,0.6610119047619047,41.29050925925926,1034.8379629629628,29.566798941798936,3
1672,4,0,0,36,0.0,0.0,1.0,36,750,500,250,0.6666666666666666,10,5,5,360.7167260610025,0.66494708994709,0.0729329754715573,0.22619417702927674,133891.14610125188,2459.355174039798,136350.5012752917,1659,165,869.8055555555555,35,1,19,31.928446283456335,0.6613095238095237,41.26157407407408,1034.953703703705,29.57010582010586,0
1673,4,0,0,36,0.0,0.0,1.0,36,800,700,100,0.875,9,7,2,359.0189222317241,0.6663690476190477,0.07321594931991848,0.22567984956871215,133981.00090288505,2420.3429087362983,136401.34381162134,1660,166,870.8055555555555,35,1,19,31.88245295323274,0.6622023809523809,41.174768518518526,1035.3009259259268,29.58002645502648,0
1674,4,0,0,36,0.0,0.0,1.0,36,1050,600,450,0.5714285714285714,15,6,9,362.09608428492305,0.665542328042328,0.07640441066905068,0.22817153254799244,134070.8858453361,2509.3085562414235,136580.19440157752,1661,167,871.8055555555555,35,1,19,31.71285948442853,0.6630952380952382,41.08796296296296,1035.6481481481483,29.589947089947092,0
1675,4,0,0,36,0.0,0.0,1.0,36,1050,700,350,0.6666666666666666,14,7,7,361.42716471763583,0.6647156084656085,0.07819481680071472,0.22849547871131917,134190.7793209878,2500.038580246927,136690.81790123472,1662,168,872.8055555555555,35,1,19,31.610254691689008,0.6642857142857143,40.97222222222223,1036.1111111111122,29.603174603174637,0
1676,4,0,0,36,0.0,0.0,1.0,36,550,300,250,0.5454545454545454,8,3,5,361.42716471763583,0.6647156084656085,0.07819481680071472,0.22849547871131917,134190.7793209878,2500.038580246927,136690.81790123472,1663,169,873.8055555555555,35,1,19,31.610254691689008,0.6642857142857143,40.97222222222223,1036.1111111111122,29.603174603174637,0
1677,4,0,0,36,0.0,0.0,1.0,36,700,400,300,0.5714285714285714,10,4,6,364.83271565586944,0.663723544973545,0.07875641884349194,0.2317852104145587,134370.72000385798,2604.5669367283863,136975.28694058637,1664,170,874.8055555555555,35,1,19,31.342096450100463,0.6660714285714285,40.79861111111111,1036.805555555555,29.623015873015856,0
1678,4,0,0,36,0.0,0.0,1.0,36,1250,1000,250,0.8,15,10,5,366.3757028921389,0.6630621693121693,0.07831213270847304,0.23353193807392225,134490.7474387002,2654.8284250685792,137145.57586376878,1665,171,875.8055555555555,35,1,19,31.182120806367614,0.6672619047619048,40.68287037037037,1037.268518518518,29.636243386243372,0
1679,4,0,1,35,0.0,0.027777777777777776,0.9722222222222222,36,950,700,250,0.7368421052631579,12,7,5,366.3627491798935,0.6639550264550265,0.07852845963651234,0.23450443813144695,134643.43112244873,2665.6809129258386,137309.11203537456,1666,172,876.8055555555555,34,2,19,31.029909382885982,0.6709558823529413,40.53571428571427,1037.8571428571408,30.525210084033553,0
1680,4,0,0,35,0.0,0.0,1.0,35,600,400,200,0.6666666666666666,8,4,4,371.6315946354386,0.6634453781512605,0.07111650894860255,0.2378947826883996,134646.1566014272,3007.753177864265,137653.90977929148,1667,173,861.7714285714286,33,2,19,30.890478017869075,0.6732954545454546,40.53308823529411,1037.8676470588225,31.45053475935826,0
1681,4,0,1,34,0.0,0.02857142857142857,0.9714285714285714,35,1150,900,250,0.782608695652174,14,9,5,371.6315946354386,0.6634453781512605,0.07111650894860255,0.2378947826883996,134646.1566014272,3007.753177864265,137653.90977929148,1668,174,862.7714285714286,33,2,19,30.890478017869075,0.6732954545454546,40.53308823529411,1037.8676470588225,31.45053475935826,0
1682,4,0,0,34,0.0,0.0,1.0,34,1250,1100,150,0.88,14,11,3,356.2484994765038,0.6577540106951872,0.08551496880039267,0.21319007921596764,132145.87688629373,2615.354070549787,134761.23095684353,1669,175,878.8529411764706,33,1,16,33.79618593563767,0.6483585858585859,42.95343137254902,1028.1862745098038,31.157159833630416,5
1683,4,0,0,34,0.0,0.0,1.0,34,900,700,200,0.7777777777777778,11,7,4,356.0440693892498,0.6572712418300654,0.0796416755453373,0.21342298787961328,132208.88600538264,2614.437956555182,134823.32396193783,1670,176,879.8529411764706,33,1,17,33.73798458849697,0.648989898989899,42.892156862745104,1028.4313725490204,31.16458704694001,0
1684,4,0,0,34,0.0,0.0,1.0,34,750,500,250,0.6666666666666666,10,5,5,356.4563203608965,0.6574197860962567,0.07615383537260545,0.21402677776175702,132271.9101427335,2629.8316753171803,134901.74181805068,1671,177,880.8529411764706,33,1,18,33.663926614248275,0.6496212121212122,42.830882352941174,1028.676470588235,31.172014260249544,0
1685,4,0,0,34,0.0,0.0,1.0,34,750,400,350,0.5333333333333333,11,4,7,357.81234785683705,0.6554887106357695,0.07981391699128437,0.21520003385429817,132334.9492983467,2670.2157823913803,135005.16508073808,1672,178,881.8529411764706,33,1,19,33.56558678735907,0.6502525252525253,42.76960784313725,1028.9215686274504,31.179441473559102,0
1686,4,0,0,34,0.0,0.0,1.0,34,800,700,100,0.875,9,7,2,357.4912746998781,0.6564913844325609,0.0810478532248915,0.21518668341612024,132366.4745080018,2663.9719398788993,135030.44644788068,1673,179,882.8529411764706,33,1,20,33.54211325473385,0.6505681818181819,42.7389705882353,1029.0441176470592,31.183155080213915,0
1687,4,0,0,34,0.0,0.0,1.0,34,600,500,100,0.8333333333333334,7,5,2,355.45405352107144,0.6570112893642306,0.08217159021685072,0.21467789386272612,132492.61289227701,2619.0072628316057,135111.62015510863,1674,180,883.8529411764706,33,1,20,33.467617942308465,0.6518308080808082,42.61642156862745,1029.5343137254902,31.198009506833035,0
1688,4,0,0,34,0.0,0.0,1.0,34,1150,900,250,0.782608695652174,14,9,5,354.37735532731455,0.6565656565656566,0.08035295517707297,0.2143868190651853,132555.70461180792,2594.9480067762393,135150.65261858416,1675,181,884.8529411764706,33,1,20,33.4318844460312,0.6524621212121213,42.55514705882353,1029.7794117647056,31.205436720142593,0
1689,4,1,0,35,0.02857142857142857,0.0,1.0,35,850,600,250,0.7058823529411765,11,6,5,348.01512840608655,0.6738795518207282,0.09077415311541404,0.2125886489600507,132919.22477324243,2251.5802154194803,135170.8049886619,1676,0,860.5428571428571,34,1,18,33.2306338028169,0.6537990196078433,42.20238095238094,1031.1904761904748,30.329131652661022,0
1690,4,0,0,35,0.0,0.0,1.0,35,600,500,100,0.8333333333333334,7,5,2,354.57258500913156,0.6739495798319327,0.08944483103922352,0.21704999621977164,132997.76715986637,2458.9100621866373,135456.677222053,1677,1,861.5428571428571,33,2,17,32.98272840679578,0.6568813131313131,42.12622549019608,1031.4950980392155,31.25742721330956,3
1691,4,0,0,35,0.0,0.0,1.0,35,900,500,400,0.5555555555555556,13,5,8,356.9738125493377,0.6731092436974789,0.09678524776494157,0.21926159558555586,133124.20590938575,2504.371065215296,135628.57697460105,1678,2,862.5428571428571,33,2,17,32.793883347187595,0.6581439393939394,42.00367647058823,1031.9852941176466,31.272281639928686,0
1692,4,1,1,35,0.027777777777777776,0.027777777777777776,0.9722222222222222,36,900,600,300,0.6666666666666666,12,6,6,348.2032074014403,0.6863095238095238,0.0903458213256485,0.21499379531725918,133318.496669501,2084.3856292516857,135402.8822987527,1679,0,839.5555555555555,34,2,17,32.82540826128722,0.6577818627450981,41.81547619047618,1032.7380952380943,30.37464985994395,0
1693,4,0,0,35,0.0,0.0,1.0,35,750,500,250,0.6666666666666666,10,5,5,356.3707863225351,0.6733893557422969,0.09731421980556898,0.21913012180257996,133164.85969387746,2491.2131519274258,135656.07284580488,1680,4,864.5428571428571,34,1,17,32.76864667435601,0.65625,41.96428571428571,1032.1428571428564,30.357142857142836,0
1694,4,0,0,35,0.0,0.0,1.0,35,800,400,400,0.5,12,4,8,355.67134672730515,0.6730392156862745,0.09185556141275697,0.2190612158252262,133226.3038548751,2476.955782312898,135703.259637188,1681,5,865.5428571428571,34,1,17,32.72505381303813,0.6568627450980393,41.90476190476189,1032.3809523809507,30.364145658263254,0
1695,4,0,0,35,0.0,0.0,1.0,35,900,600,300,0.6666666666666666,12,6,6,353.41212035645196,0.6719887955182072,0.08816797035817214,0.2182099746684853,133318.496669501,2423.2745181405744,135741.77118764157,1682,6,866.5428571428571,34,1,18,32.690922190201725,0.6577818627450981,41.81547619047618,1032.7380952380943,30.37464985994395,0
1696,4,0,0,35,0.0,0.0,1.0,35,1050,500,550,0.47619047619047616,16,5,11,352.2066139646188,0.6711484593837534,0.09085819666732564,0.217645625552495,133349.2346938774,2393.296485260755,135742.53117913817,1683,7,867.5428571428571,34,1,18,32.69123636084217,0.6580882352941178,41.78571428571428,1032.8571428571418,30.37815126050417,0
1697,4,0,0,35,0.0,0.0,1.0,35,750,400,350,0.5333333333333333,11,4,7,355.04116088035073,0.6705882352941176,0.09731206689381611,0.21994305747898366,133441.47002551003,2475.44288548751,135916.91291099755,1684,8,868.5428571428571,34,1,19,32.52558858547451,0.6590073529411765,41.69642857142856,1033.2142857142844,30.388655462184836,0
1698,4,0,0,35,0.0,0.0,1.0,35,750,500,250,0.6666666666666666,10,5,5,356.37707560444386,0.6700980392156862,0.09572597448798104,0.22114259592143307,133503.88259623697,2515.5481953810886,136019.43079161807,1685,9,869.5428571428571,33,2,20,32.428529783785926,0.6619318181818181,41.6360294117647,1033.4558823529408,31.316844919786085,0
1699,4,0,0,35,0.0,0.0,1.0,35,800,600,200,0.75,10,6,4,356.6274966452554,0.6696078431372549,0.09455161317639105,0.2216767084895157,133567.2146079633,2526.7482759035056,136093.96288386683,1686,10,870.5428571428571,33,2,21,32.35860007903578,0.6625631313131313,41.57475490196079,1033.700980392157,31.324272133095665,0
1700,4,0,0,35,0.0,0.0,1.0,35,850,500,350,0.5882352941176471,12,5,7,355.27591677924863,0.6693277310924369,0.09350403034613586,0.22102563672195716,133598.88624567463,2492.893358323713,136091.77960399835,1687,11,871.5428571428571,33,2,21,32.36180259206574,0.662878787878788,41.54411764705882,1033.823529411764,31.327985739750424,0
1701,4,0,0,35,0.0,0.0,1.0,35,800,700,100,0.875,9,7,2,354.8181931409848,0.6693277310924369,0.08818609690854284,0.22111934370189293,133662.24078479435,2485.158953287201,136147.39973808156,1688,12,872.5428571428571,33,2,22,32.31018408785653,0.663510101010101,41.4828431372549,1034.0686274509808,31.335412953060025,0
1702,4,0,0,35,0.0,0.0,1.0,35,900,500,400,0.5555555555555556,13,5,8,351.61774462377997,0.6684873949579831,0.08641467865774488,0.2196410196287579,133749.15143140577,2405.7149943310546,136154.86642573684,1689,13,873.5428571428571,34,1,17,32.30593278858326,0.6620710784313726,41.39880952380952,1034.404761904761,30.42366946778709,0
1703,4,0,0,35,0.0,0.0,1.0,35,600,300,300,0.5,9,3,6,353.52726107412855,0.6676470588235294,0.08656912707545605,0.22101812221109177,133779.93905895686,2458.9710884353626,136238.91014739222,1690,14,874.5428571428571,34,1,17,32.225738396624465,0.6623774509803921,41.36904761904761,1034.523809523809,30.42717086834732,0
1704,4,0,0,35,0.0,0.0,1.0,35,900,700,200,0.7777777777777778,11,7,4,357.57226556883705,0.6676470588235294,0.09347422392401139,0.22410783738932227,133872.32320011334,2573.805980725624,136446.12918083897,1691,15,875.5428571428571,34,1,18,32.02864373633959,0.663296568627451,41.279761904761905,1034.8809523809523,30.437675070028007,0
1705,4,0,0,35,0.0,0.0,1.0,35,750,400,350,0.5333333333333333,11,4,7,356.12302360588416,0.6682773109243697,0.08619387051210459,0.22413589430708997,134026.3676303856,2545.975056689354,136572.34268707494,1692,16,876.5428571428571,34,1,20,31.912029585345287,0.664828431372549,41.13095238095239,1035.4761904761913,30.455182072829157,0
1706,4,0,0,35,0.0,0.0,1.0,35,650,400,250,0.6153846153846154,9,4,5,356.04696032294123,0.6662464985994397,0.08320882657165862,0.22465298054894203,134118.8368055555,2550.5208333333285,136669.35763888882,1693,17,877.5428571428571,34,1,20,31.821533923303836,0.6657475490196079,41.041666666666664,1035.833333333333,30.465686274509796,0
1707,4,0,0,35,0.0,0.0,1.0,35,900,700,200,0.7777777777777778,11,7,4,358.3208142239422,0.6675070028011204,0.08650547430278555,0.22646812245395553,134180.50063775506,2615.933248299313,136796.43388605438,1694,18,878.5428571428571,34,1,20,31.70099391014591,0.666360294117647,40.982142857142854,1036.0714285714282,30.472689075630242,0
1708,4,0,0,35,0.0,0.0,1.0,35,800,500,300,0.625,11,5,6,359.19332346055825,0.6649859943977591,0.09309422632036624,0.22778559849752947,134303.87081916095,2648.2107426303764,136952.08156179133,1695,19,879.5428571428571,34,1,21,31.555070632824158,0.6675857843137255,40.863095238095234,1036.5476190476186,30.486694677871135,0
1709,4,0,0,35,0.0,0.0,1.0,35,650,300,350,0.46153846153846156,10,3,7,362.08826045520885,0.6658963585434173,0.09102837461046431,0.23020355828940614,134396.43565759616,2732.6743197278647,137129.10997732403,1696,20,880.5428571428571,34,1,21,31.38753348641408,0.6685049019607844,40.77380952380951,1036.9047619047603,30.497198879551775,0
1710,4,0,0,35,0.0,0.0,1.0,35,800,600,200,0.75,10,6,4,359.084744951382,0.6663165266106442,0.08942302962732218,0.22887383926564667,134489.03238378675,2658.591978458037,137147.6243622448,1697,21,881.5428571428571,34,1,21,31.37290064654348,0.6694240196078433,40.6845238095238,1037.261904761904,30.507703081232467,0
1711,4,0,0,35,0.0,0.0,1.0,35,900,700,200,0.7777777777777778,11,7,4,358.86517959387766,0.6677170868347339,0.08582903040734391,0.22912161466378322,134550.78124999988,2657.1322278911416,137207.91347789104,1698,22,882.5428571428571,33,2,21,31.31693440428379,0.6723484848484849,40.62499999999999,1037.499999999999,31.439393939393913,0
1712,4,0,0,35,0.0,0.0,1.0,35,1000,800,200,0.8,12,8,4,358.1451100243682,0.6677871148459383,0.08580875902557539,0.22906138910017723,134614.36106305252,2642.2950307573838,137256.6560938099,1699,23,883.5428571428571,33,2,21,31.27214218233349,0.672979797979798,40.56372549019607,1037.7450980392146,31.44682115270347,0
1713,4,0,0,35,0.0,0.0,1.0,35,650,600,50,0.9230769230769231,7,6,1,365.80861580241265,0.6677871148459383,0.07604705560962288,0.21478741673114318,131422.3514543687,2615.085694204177,134037.43714857288,1700,24,884.5428571428571,33,2,22,34.28088024381498,0.6410984848484846,43.65808823529413,1025.3676470588252,31.071746880570462,5
1714,4,1,0,36,0.027777777777777776,0.0,1.0,36,600,300,300,0.5,9,3,6,359.23545473639996,0.6800595238095238,0.08043478260869552,0.21294885203446393,131786.11288265308,2268.448837868485,134054.56172052157,1701,0,860.9444444444445,34,2,18,34.082125603864725,0.6424632352941175,43.30357142857143,1026.7857142857144,30.199579831932777,0
1715,4,0,0,36,0.0,0.0,1.0,36,1100,700,400,0.6363636363636364,15,7,8,359.85252735774026,0.6799603174603175,0.07925792869007653,0.21400189238938244,131908.37762188207,2293.512613378687,134201.89023526077,1702,1,861.9444444444445,34,2,19,33.94295399235139,0.6436887254901961,43.18452380952381,1027.2619047619046,30.213585434173666,0
1716,4,0,0,36,0.0,0.0,1.0,36,650,500,150,0.7692307692307693,8,5,3,359.9381433398519,0.6791666666666667,0.07833198161665322,0.2143979375546074,131969.53125,2300.1736111111118,134269.70486111112,1703,2,862.9444444444445,34,2,20,33.87908894295756,0.6443014705882353,43.125,1027.5,30.220588235294116,0
1717,4,0,0,36,0.0,0.0,1.0,36,800,400,400,0.5,12,4,8,361.13248697085646,0.6752314814814815,0.0866013071895424,0.21597923528257013,132122.47732426287,2342.7437641723186,134465.22108843518,1704,3,863.9444444444445,34,2,21,33.69422572178477,0.6458333333333334,42.97619047619047,1028.095238095237,30.238095238095205,0
1718,4,0,0,36,0.0,0.0,1.0,36,1050,900,150,0.8571428571428571,12,9,3,360.7702590389438,0.6770502645502646,0.09036055497691864,0.216637651727277,132275.51197562367,2344.2141439909383,134619.7261196146,1705,4,864.9444444444445,34,2,22,33.549357713227636,0.6473651960784313,42.827380952380956,1028.6904761904768,30.255602240896376,0
1719,4,0,0,36,0.0,0.0,1.0,36,800,600,200,0.75,10,6,4,363.9788553168244,0.6772817460317461,0.08986965910843736,0.21909702126452849,132367.37528344666,2435.7851473922824,134803.16043083894,1706,5,865.9444444444445,34,2,22,33.374305876908835,0.6482843137254901,42.738095238095234,1029.0476190476186,30.266106442577016,0
1720,4,0,0,36,0.0,0.0,1.0,36,1150,800,350,0.6956521739130435,15,8,7,359.7525998188288,0.678207671957672,0.05702433985409017,0.20987600823328975,131175.63952664402,2238.1590136054456,133413.79854024947,1707,6,866.9444444444445,34,2,18,34.68550261475886,0.6363357843137254,43.898809523809526,1024.4047619047622,30.1295518207283,4
1721,4,0,0,36,0.0,0.0,1.0,36,900,700,200,0.7777777777777778,11,7,4,358.50546666869775,0.6786044973544973,0.05431331552251528,0.20981465415029363,131297.62081916098,2214.182964852608,133511.80378401358,1708,7,867.9444444444445,34,2,19,34.59412630193209,0.6375612745098038,43.779761904761905,1024.8809523809523,30.143557422969185,0
1722,4,0,0,36,0.0,0.0,1.0,36,550,200,350,0.36363636363636365,9,2,7,357.91876106896615,0.6793320105820106,0.052683137411171366,0.20981012167777868,131359.53006355735,2203.2115940739163,133562.74165763127,1709,8,868.9444444444445,33,3,19,34.54659792787409,0.6404671717171717,43.719362745098046,1025.1225490196084,31.06431966726086,0
1723,4,0,0,36,0.0,0.0,1.0,36,950,700,250,0.7368421052631579,12,7,5,367.1255934222454,0.680952380952381,0.02477040486353621,0.21165160050316031,130718.71456916103,2398.0371315192738,133116.7517006803,1710,9,869.9444444444445,34,2,12,34.95949747768722,0.6317401960784315,44.345238095238095,1022.6190476190479,30.07703081232494,4
1724,4,0,0,36,0.0,0.0,1.0,36,700,500,200,0.7142857142857143,9,5,4,366.3107208125701,0.6801587301587302,0.021609248913718293,0.21151490008209692,130779.59183673467,2381.193310657595,133160.78514739228,1711,10,870.9444444444445,34,2,12,34.91862585350715,0.6323529411764706,44.285714285714285,1022.8571428571427,30.08403361344537,0
1725,4,0,0,36,0.0,0.0,1.0,36,750,500,250,0.6666666666666666,10,5,5,365.45757253939234,0.6796957671957672,0.02478473353502464,0.21135547633940352,130840.48327664396,2363.3290816326503,133203.81235827663,1712,11,871.9444444444445,34,2,13,34.87874292141803,0.6329656862745099,44.226190476190474,1023.095238095238,30.09103641456582,0
1726,4,0,0,36,0.0,0.0,1.0,36,750,400,350,0.5333333333333333,11,4,7,362.11725244958257,0.6798611111111111,0.022646788931539596,0.20992056772144715,130931.84700963715,2282.536139455777,133214.38314909293,1713,12,872.9444444444445,34,2,13,34.87166065681827,0.6338848039215685,44.13690476190476,1023.4523809523806,30.10154061624649,0
1727,4,0,0,36,0.0,0.0,1.0,36,800,600,200,0.75,10,6,4,359.8120068408711,0.6786044973544973,0.02293048020896138,0.20944846292947558,131090.96364883403,2233.6205418381332,133324.58419067218,1714,13,873.9444444444445,35,1,14,34.769627787823985,0.6333333333333333,43.98148148148148,1024.0740740740741,29.25925925925926,0
1728,4,0,0,36,0.0,0.0,1.0,36,950,800,150,0.8421052631578947,11,8,3,359.23010629129544,0.6798611111111111,0.025103578154425543,0.20943257184966846,131150.233892747,2222.622492283958,133372.85638503096,1715,14,874.9444444444445,35,1,15,34.72457627118644,0.6339285714285714,43.923611111111114,1024.305555555556,29.26587301587303,0
1729,4,1,1,36,0.02702702702702703,0.02702702702702703,0.972972972972973,37,450,200,250,0.4444444444444444,7,2,5,351.11786895541934,0.6869994994994995,0.024826904357219126,0.20581409433078443,131357.78523930485,1824.5336880572886,133182.31892736215,1716,0,852.2702702702703,35,2,16,34.722653456776186,0.6360119047619046,43.721064814814824,1025.115740740742,29.2890211640212,0
1730,4,0,0,36,0.0,0.0,1.0,36,750,500,250,0.6666666666666666,10,5,5,360.4221472681934,0.6800925925925927,0.029854445071836322,0.2109410518215369,131298.46810967516,2264.575161822713,133563.04327149788,1717,16,876.9444444444445,35,1,17,34.54416054959534,0.6354166666666665,43.77893518518519,1024.88425925926,29.28240740740743,0
1731,4,0,0,36,0.0,0.0,1.0,36,1000,800,200,0.8,12,8,4,359.3113145297713,0.6795634920634921,0.027442289577930046,0.21062149281251627,131358.63272392296,2239.7319487530094,133598.36467267596,1718,17,877.9444444444445,34,2,18,34.51181628150039,0.6381740196078431,43.720238095238095,1025.119047619048,30.150560224089645,0
1732,4,0,0,36,0.0,0.0,1.0,36,950,600,350,0.631578947368421,13,6,7,359.8139136310523,0.678505291005291,0.02835816083059317,0.2115902297564174,131480.6990504535,2261.7169784580474,133742.41602891154,1719,18,878.9444444444445,34,2,19,34.37560456568002,0.6393995098039216,43.601190476190474,1025.5952380952378,30.164565826330524,0
1733,4,1,0,37,0.02702702702702703,0.0,1.0,37,650,400,250,0.6153846153846154,9,4,5,355.325212043346,0.685497997997998,0.03202661572631138,0.2105604513050451,131773.3802324461,1964.4808545524827,133737.86108699857,1720,0,856.1621621621622,35,2,13,34.195341562394326,0.6401785714285714,43.31597222222223,1026.736111111112,29.335317460317487,0
1734,4,0,0,37,0.0,0.0,1.0,37,950,800,150,0.8421052631578947,11,8,3,356.1333493077236,0.686498998998999,0.03068969611720518,0.212031907565705,131951.6933111497,1998.4796971450555,133950.17300829475,1721,1,857.1621621621622,35,2,15,33.99480398783373,0.6419642857142858,43.14236111111111,1027.4305555555554,29.355158730158728,0
1735,4,0,0,37,0.0,0.0,1.0,37,400,300,100,0.75,5,3,2,356.39936236600363,0.6867492492492493,0.02915192732719185,0.21235661336143485,131981.42387902946,2007.6190629286662,133989.04294195812,1722,2,858.1621621621622,35,2,15,33.95800480588721,0.6422619047619048,43.113425925925924,1027.546296296296,29.358465608465604,0
1736,4,1,1,37,0.02631578947368421,0.02631578947368421,0.9736842105263158,38,850,600,250,0.7058823529411765,11,6,5,351.22135287619165,0.7007467994310099,0.02768488385141943,0.21064298529275427,132228.78674207444,1688.3146737457619,133917.10141582022,1723,0,836.5526315789474,37,1,16,33.84195095948827,0.6407657657657657,42.872807017543856,1028.5087719298242,27.797534376481735,0
1737,4,0,0,37,0.0,0.0,1.0,37,1050,800,250,0.7619047619047619,13,8,5,359.00039468838224,0.6866866866866866,0.036434682217814984,0.21478857165825235,132137.36329234645,2087.4731150069074,134224.83640735334,1724,4,860.1621621621622,36,1,17,33.734027017159555,0.6417824074074074,42.961711711711715,1028.1531531531534,28.559809809809817,0
1738,4,0,0,37,0.0,0.0,1.0,37,800,500,300,0.625,11,5,6,359.1281301108972,0.6871871871871872,0.03548269959018535,0.21506408711238775,132172.4052112188,2093.36574715296,134265.77095837178,1725,5,861.1621621621622,37,0,17,33.695439681524135,0.6402027027027027,42.92763157894736,1028.2894736842102,27.791607396870546,0
1739,4,0,0,37,0.0,0.0,1.0,37,1350,1100,250,0.8148148148148148,16,11,5,356.639041694739,0.688501001001001,0.03130112209396119,0.2145321004656043,132341.58587257602,2039.6352723914915,134381.2211449675,1726,6,862.1621621621622,37,0,18,33.58908780903668,0.6418918918918919,42.763157894736835,1028.9473684210514,27.809388335704092,0
1740,4,0,0,37,0.0,0.0,1.0,37,850,500,350,0.5882352941176471,12,5,7,354.21003458506135,0.6885635635635635,0.025166867272130578,0.21338994766465863,132398.00347222204,1979.3643236380187,134377.36779586007,1727,7,863.1621621621622,35,2,18,33.59480431848852,0.6464285714285715,42.70833333333332,1029.1666666666652,29.404761904761862,0
1741,4,1,1,37,0.02631578947368421,0.02631578947368421,0.9736842105263158,38,800,600,200,0.75,10,6,4,344.48806985864144,0.7032657657657658,0.02378337796801988,0.20878199537110145,132623.79410010754,1537.4629693751706,134161.2570694827,1728,0,841.421052631579,37,1,19,33.618089560712505,0.6447072072072073,42.48903508771929,1030.0438596491213,27.839023233760035,0
1742,4,0,0,37,0.0,0.0,1.0,37,700,300,400,0.42857142857142855,11,3,8,354.54629427296885,0.6930055055055055,0.029477044020510323,0.21458146003483103,132571.90626014507,2000.5756178475533,134572.48187799263,1729,1,864.4324324324324,36,1,19,33.41124476034261,0.6461226851851853,42.5394144144144,1029.8423423423408,28.60673173173169,0
1743,4,0,1,36,0.0,0.02702702702702703,0.972972972972973,37,900,600,300,0.6666666666666666,12,6,6,352.73462558946136,0.6929429429429429,0.02557065755229515,0.21414526141459708,132687.90486009634,1960.7236882152124,134648.62854831156,1730,2,865.4324324324324,36,1,12,33.34130323896965,0.6472800925925928,42.42680180180179,1030.2927927927908,28.61924424424419,0
1744,4,0,0,36,0.0,0.0,1.0,36,950,700,250,0.7368421052631579,12,7,5,360.57126874773235,0.6779100529100529,0.02067692008649802,0.21839634595806362,132600.90115453294,2362.41503327652,134963.31618780945,1731,11,890.4166666666666,36,0,18,33.2269571397332,0.6464120370370371,42.51126126126126,1029.9549549549552,28.609859859859867,0
1745,4,0,0,36,0.0,0.0,1.0,36,800,600,200,0.75,10,6,4,362.4435962357531,0.6779100529100529,0.020672399553029353,0.2198696298650311,132658.9004545086,2416.2737906825782,135075.17424519119,1732,12,891.4166666666666,36,0,12,33.12039972307244,0.6469907407407407,42.45495495495496,1030.1801801801805,28.616116116116125,0
1746,4,0,0,36,0.0,0.0,1.0,36,950,600,350,0.631578947368421,13,6,7,361.2393361236435,0.6784722222222223,0.018086372524016125,0.21930847287294053,132687.90486009658,2386.418132659687,135074.32299275626,1733,13,892.4166666666666,36,0,12,33.12224468976574,0.6472800925925927,42.4268018018018,1030.2927927927926,28.61924424424424,0
1747,4,0,0,36,0.0,0.0,1.0,36,800,500,300,0.625,11,5,6,361.2393361236435,0.6784722222222223,0.018086372524016125,0.21930847287294053,132687.90486009658,2386.418132659687,135074.32299275626,1734,14,893.4166666666666,36,0,12,33.12224468976574,0.6472800925925927,42.4268018018018,1030.2927927927926,28.61924424424424,0
1748,4,0,0,36,0.0,0.0,1.0,36,900,600,300,0.6666666666666666,12,6,6,360.5172280735,0.6792989417989418,0.011454691142191331,0.21937856857238505,132774.9370992614,2373.5304561318057,135148.46755539323,1735,15,894.4166666666666,36,0,12,33.05333988927739,0.6481481481481481,42.34234234234234,1030.6306306306305,28.628628628628626,0
1749,4,0,0,36,0.0,0.0,1.0,36,650,400,250,0.6153846153846154,9,4,5,360.97119809800296,0.6797619047619048,0.014595926492365185,0.2199953626757069,132832.97444403855,2389.7755863971975,135222.75003043574,1736,16,895.4166666666666,36,0,12,32.98330420217027,0.6487268518518519,42.28603603603603,1030.8558558558552,28.63488488488487,0
1750,4,0,0,36,0.0,0.0,1.0,36,1100,900,200,0.8181818181818182,13,9,4,382.4059082864589,0.6797619047619048,0.03650957065507554,0.20559609165068995,127968.8102816356,2588.7402992801153,130557.55058091572,1737,17,896.4166666666666,35,1,13,37.37560054907344,0.6017857142857144,47.0486111111111,1011.8055555555538,28.90873015873011,6
1751,4,3,2,37,0.07692307692307693,0.05128205128205128,0.9487179487179487,39,700,500,200,0.7142857142857143,9,5,4,359.7425456911423,0.7235717498875394,0.03908643554922131,0.19718375311714711,128740.17373666805,1462.6635665497765,130202.83730321782,1738,0,828.3846153846154,38,1,13,37.16027125662352,0.6038925438596492,46.28739316239316,1014.8504273504267,26.70659019343228,0
1752,4,1,1,37,0.02631578947368421,0.02631578947368421,0.9736842105263158,38,850,600,250,0.7058823529411765,11,6,5,368.63473938567324,0.7053402086296823,0.03841689945325988,0.20143177637666013,128616.79945992975,1882.5240699061023,130499.32352983585,1739,0,851.1578947368421,37,1,13,37.06074568515116,0.6044481981981983,46.408991228070164,1014.3640350877175,27.415244191559932,0
1753,4,1,0,38,0.02631578947368421,0.0,1.0,38,750,500,250,0.6666666666666666,10,5,5,366.08021537557215,0.7089556661925083,0.04922801330717408,0.20059635247489138,128728.04763244446,1824.9582804324257,130553.00591287689,1740,0,852.1315789473684,37,1,14,37.011862956960194,0.6055743243243243,46.29934210526315,1014.8026315789463,27.42709815078233,0
1754,4,2,0,40,0.05,0.0,1.0,40,850,600,250,0.7058823529411765,11,6,5,360.3263739935542,0.7268429487179487,0.08896682367397091,0.20062413731020823,129360.29188368062,1322.3849826388941,130682.67686631951,1741,0,810.475,39,1,16,36.51315789473684,0.608440170940171,45.677083333333336,1017.2916666666672,26.084401709401725,0
1755,4,1,0,41,0.024390243902439025,0.0,1.0,41,1050,700,350,0.6666666666666666,14,7,7,359.807720820505,0.735619918699187,0.1009343792669537,0.20177018300740235,129640.87106095905,1129.1572683257268,130770.02832928477,1742,0,791.6829268292682,40,1,14,36.240769384292975,0.6096354166666667,45.40142276422764,1018.3943089430892,25.45985772357723,0
1756,4,1,1,41,0.023809523809523808,0.023809523809523808,0.9761904761904762,42,400,300,100,0.75,5,3,2,353.13463690127355,0.7386759581881533,0.0979005908932915,0.19925636431414506,129883.08930342956,773.2435161564445,130656.33281958601,1743,0,773.8095238095239,41,1,14,36.164537712895374,0.6105182926829269,45.16369047619047,1019.3452380952369,24.862078977932608,0
1757,4,0,1,40,0.0,0.024390243902439025,0.975609756097561,41,600,300,300,0.5,9,3,6,357.4693595070313,0.7334857723577236,0.0925598445173641,0.2012546472642898,129796.16057117116,1079.6300771696615,130875.79064834082,1744,2,793.6829268292682,40,1,15,36.142415478208825,0.6111979166666668,45.24898373983739,1019.0040650406496,25.47510162601624,0
1758,4,0,0,40,0.0,0.0,1.0,40,1700,1500,200,0.8823529411764706,19,15,4,362.46385922589747,0.7217147435897436,0.09752197016145536,0.2045600534247191,129890.67382812487,1416.1349826388732,131306.80881076373,1745,3,814.425,39,1,15,35.919085087540026,0.6137820512820513,45.15624999999999,1019.374999999999,26.137820512820486,0
1759,4,0,0,40,0.0,0.0,1.0,40,850,600,250,0.7058823529411765,11,6,5,362.93831304411134,0.7225961538461538,0.09692256614567363,0.20524570458629707,129970.32470703112,1434.2420789930406,131404.56678602417,1746,4,815.425,39,1,15,35.82603347294581,0.6145833333333335,45.07812499999999,1019.687499999999,26.145833333333307,0
1760,4,0,0,40,0.0,0.0,1.0,40,1100,1000,100,0.9090909090909091,12,10,2,359.779822599431,0.7213675213675214,0.09176707852547761,0.2040141171231167,130076.56385633671,1359.784613715268,131436.34847005198,1747,5,816.425,39,1,16,35.79863593042649,0.6156517094017095,44.97395833333333,1020.1041666666658,26.156517094017072,0
1761,4,1,0,41,0.024390243902439025,0.0,1.0,41,950,800,150,0.8421052631578947,11,8,3,353.7700551966539,0.7339430894308943,0.10330299720907687,0.2022405605646398,130392.29811124313,1025.7781000065938,131418.07621124972,1748,0,797.4878048780488,40,1,17,35.63163349917082,0.6171875000000002,44.664634146341456,1021.3414634146327,25.533536585365816,0
1762,4,0,0,41,0.0,0.0,1.0,41,950,800,150,0.8421052631578947,11,8,3,352.6654869564178,0.7332317073170732,0.10390108077691806,0.20242032744484756,130548.03688280759,1007.9573996959248,131555.99428250353,1749,1,798.4878048780488,40,1,15,35.5020220100769,0.6187500000000001,44.51219512195121,1021.951219512193,25.548780487804827,0
1763,4,0,0,41,0.0,0.0,1.0,41,1100,800,300,0.7272727272727273,14,8,6,361.18384812667165,0.7347052845528456,0.10771166044165659,0.20828613545551283,130729.84959556165,1243.502028389203,131973.35162395085,1750,2,799.4878048780488,40,1,17,35.100119248733,0.6205729166666667,44.33434959349594,1022.6626016260175,25.56656504065044,0
1764,4,0,0,41,0.0,0.0,1.0,41,850,600,250,0.7058823529411765,11,6,5,364.2470386327566,0.7334349593495935,0.11420070890884704,0.21061889361952693,130833.79937743754,1331.164795260774,132164.9641726983,1751,3,800.4878048780488,40,1,18,34.91647627562002,0.6216145833333333,44.23272357723578,1023.0691056910582,25.576727642276456,0
1765,4,0,0,41,0.0,0.0,1.0,41,700,400,300,0.5714285714285714,10,4,6,360.65219728040745,0.7330792682926829,0.11092111318332676,0.2089624641319739,130911.78882444323,1242.7248578888361,132154.51368233206,1752,4,801.4878048780488,40,1,18,34.92945216815624,0.6223958333333333,44.15650406504066,1023.3739837398382,25.584349593495954,0
1766,4,0,0,41,0.0,0.0,1.0,41,600,300,300,0.5,9,3,6,363.9994335289299,0.7342987804878048,0.11545118925134656,0.2116153660013832,131041.82287535543,1339.8298590455584,132381.652734401,1753,5,802.4878048780488,40,1,18,34.71215880893302,0.6236979166666666,44.029471544715456,1023.8821138211393,25.597052845528484,0
1767,4,2,1,42,0.046511627906976744,0.023255813953488372,0.9767441860465116,43,1350,1000,350,0.7407407407407407,17,10,7,352.8353019474808,0.7531376891842008,0.12043117110838808,0.20845695023681834,131658.81406092533,691.0879000239888,132349.90196094933,1754,0,766.1162790697674,41,2,15,34.37479861446754,0.6283028455284553,43.42757936507937,1026.2896825396829,25.031455671699582,0
1768,4,1,1,42,0.023255813953488372,0.023255813953488372,0.9767441860465116,43,1350,1100,250,0.8148148148148148,16,11,5,353.26023944549445,0.7477851605758582,0.13066397034041088,0.20940684297026754,131786.11288265322,710.9587585034199,132497.07164115665,1755,0,767.0930232558139,41,2,16,34.23550724637682,0.6295731707317072,43.30357142857144,1026.7857142857156,25.043554006968673,0
1769,4,0,0,42,0.0,0.0,1.0,42,900,600,300,0.6666666666666666,12,6,6,364.7108792770365,0.7381194347657762,0.13697961608645826,0.21551873433696878,131666.88484243854,1204.0690685108257,132870.95391094935,1756,2,786.3571428571429,40,2,16,34.06195332871243,0.6299479166666666,43.41971544715448,1026.3211382113834,25.658028455284587,0
1770,4,1,1,42,0.023255813953488372,0.023255813953488372,0.9767441860465116,43,700,300,400,0.42857142857142855,11,3,8,358.15823146772857,0.7482004429678848,0.1339685834237463,0.21273735917300046,131862.5217013891,845.5295138889134,132708.051215278,1757,0,769.046511627907,41,2,16,34.032707910750524,0.6303353658536583,43.22916666666668,1027.083333333335,25.050813008130124,0
1771,4,0,0,42,0.0,0.0,1.0,42,900,500,400,0.5555555555555556,13,5,8,363.4881737794713,0.7362320944638018,0.12985792040715305,0.21568103323790744,131823.382710771,1183.2481285941165,133006.6308393651,1758,4,788.3571428571429,40,2,16,33.93534553851228,0.6315104166666665,43.26727642276424,1026.9308943089452,25.67327235772363,0
1772,4,0,0,42,0.0,0.0,1.0,42,750,400,350,0.5333333333333333,11,4,7,361.52314291973937,0.7339576074332171,0.13052254238326078,0.21510520610804273,131927.76626222828,1138.9881395003092,133066.7544017286,1759,5,789.3571428571429,40,2,17,33.88049427902531,0.6325520833333333,43.16565040650407,1027.3373983739846,25.683434959349615,0
1773,4,0,0,42,0.0,0.0,1.0,42,650,200,450,0.3076923076923077,11,2,9,363.3894681429629,0.7339576074332171,0.1518289511977513,0.19852163555199334,128607.9830643964,946.9573129420522,129554.94037733844,1760,6,790.3571428571429,40,2,15,37.20276859366129,0.5992187499999999,46.41768292682928,1014.3292682926846,25.358231707317113,5
1774,4,2,1,43,0.045454545454545456,0.022727272727272728,0.9772727272727273,44,1150,700,450,0.6086956521739131,16,7,9,356.4306789907904,0.7479959478505991,0.17681077145754376,0.19728767239759418,129127.5137931167,405.00148353467097,129532.51527665136,1761,0,755.3863636363636,42,2,18,36.84931833349223,0.6014384920634919,45.906007751938,1016.3759689922505,24.19942783314882,0
1775,4,1,0,44,0.022727272727272728,0.0,1.0,44,650,300,350,0.46153846153846156,10,3,7,357.2929537946137,0.75303911205074,0.19018526276590797,0.19880146403443907,129333.80126953137,442.0745550687244,129775.8758246001,1762,0,754.4318181818181,39,5,19,36.617276839051044,0.6081730769230769,45.70312500000001,1017.1875000000009,26.08173076923079,0
1776,4,0,0,44,0.0,0.0,1.0,44,750,600,150,0.8,9,6,3,354.11518342066285,0.7540301268498943,0.18874938722152645,0.197664963588323,129459.81744497319,368.7374000264364,129828.55484499963,1763,1,755.4318181818181,40,4,15,36.56984388522735,0.6078125,45.579268292682926,1017.6829268292679,25.442073170731696,0
1777,4,2,1,45,0.043478260869565216,0.021739130434782608,0.9782608695652174,46,1300,1000,300,0.7692307692307693,16,10,6,339.49581501736486,0.7703099838969405,0.20015827895858918,0.19200057437536683,129972.73875114786,-374.95982552800376,129597.77892561986,1764,0,723.5434782608696,43,3,17,36.42118623080733,0.6085271317829457,45.07575757575758,1019.6969696969697,23.713883016208598,0
1778,4,1,0,46,0.021739130434782608,0.0,1.0,46,800,400,400,0.5,12,4,8,307.4478115813478,0.7734299516908213,0.17723875329243288,0.1750649741698545,130238.42047068692,-1191.3736979166722,129047.04677277025,1765,0,724.4565217391304,43,3,16,36.96974441042769,0.6111918604651163,44.81534090909091,1020.7386363636358,23.738107822410136,3
1779,4,1,1,46,0.02127659574468085,0.02127659574468085,0.9787234042553191,47,950,700,250,0.7368421052631579,12,7,5,301.3006562100365,0.7817221708294788,0.1784457576955336,0.17271962292351958,130498.99798525375,-1536.113254458165,128962.88473079559,1766,0,710.0212765957447,44,3,12,36.8637668025978,0.6124526515151516,44.56018518518518,1021.7592592592591,23.221801346801342,0
1780,4,0,0,46,0.0,0.0,1.0,46,1200,1000,200,0.8333333333333334,14,10,4,305.4891873020038,0.773731884057971,0.1724218535893347,0.17492661107293078,130455.9981921487,-1229.4206267217644,129226.57756542694,1767,2,726.4565217391304,43,3,17,36.80014831294032,0.6133720930232559,44.60227272727273,1021.5909090909087,23.757928118393224,0
1781,4,0,0,46,0.0,0.0,1.0,46,1150,700,450,0.6086956521739131,16,7,9,295.7206287453464,0.7743156199677939,0.14765323760138283,0.16965025543811954,130528.56445312483,-1480.0021701389028,129048.56228298592,1768,3,727.4565217391304,43,3,15,36.976512062521245,0.6140988372093024,44.53124999999999,1021.8749999999986,23.7645348837209,2
1782,4,1,0,47,0.02127659574468085,0.0,1.0,47,950,800,150,0.8421052631578947,11,8,3,294.44220116670454,0.7807585568917669,0.16473135095886238,0.17003152097692545,130782.97432270228,-1698.3946330589893,129084.5796896433,1769,0,712.9574468085107,44,3,16,36.75300232340605,0.6152935606060608,44.282407407407405,1022.87037037037,23.247053872053865,0
1783,4,2,2,47,0.04081632653061224,0.04081632653061224,0.9591836734693877,49,1150,800,350,0.6956521739130435,15,8,7,287.97843484657693,0.7939342403628118,0.18154754547605467,0.16827374873390988,131237.27192419904,-2241.299167546906,128995.97275665213,1770,0,684.8163265306123,46,3,17,36.461758089634856,0.6173007246376812,43.8386524822695,1024.6453900709223,22.274899784150485,0
1784,4,0,0,47,0.0,0.0,1.0,47,1050,400,650,0.38095238095238093,17,4,13,297.08250690607144,0.7779448041936478,0.1809607370037294,0.17272020827378204,131043.55709876529,-1613.8503086419882,129429.7067901233,1771,1,714.8297872340426,44,3,17,36.423290830168206,0.6178977272727273,44.02777777777777,1023.8888888888878,23.270202020201996,0
1785,4,0,0,47,0.0,0.0,1.0,47,1500,1200,300,0.8,18,12,6,299.2065189331621,0.7788313290163429,0.18630960849987188,0.1748162269542961,131233.23473936884,-1546.8321330589945,129686.40260630984,1772,2,715.8297872340426,44,3,17,36.1781959756612,0.6197916666666667,43.84259259259259,1024.6296296296284,23.28703703703701,0
1786,4,0,0,47,0.0,0.0,1.0,47,900,800,100,0.8888888888888888,10,8,2,299.46427668243615,0.7789855072463767,0.18297218799676274,0.17529191319925347,131304.3992198215,-1535.8046124828752,129768.59460733863,1773,3,716.8297872340426,44,3,18,36.10006926250488,0.620501893939394,43.77314814814814,1024.907407407406,23.293350168350138,0
1787,4,0,1,46,0.0,0.02127659574468085,0.9787234042553191,47,900,600,300,0.6666666666666666,12,6,6,301.82681862915274,0.7782917052112241,0.16555677697073068,0.17951847828287637,131913.47321625412,-1419.2418653418124,130494.2313509123,1774,4,717.8297872340426,41,6,14,35.428033961049415,0.6308434959349594,43.179563492063494,1027.2817460317463,25.055652342237714,2
1788,4,0,0,46,0.0,0.0,1.0,46,1100,800,300,0.7272727272727273,14,8,6,308.78547124242414,0.7702697262479872,0.1713114031219678,0.18341112930423517,131862.52170138902,-1056.5538194444337,130805.96788194458,1775,5,734.1739130434783,41,5,15,35.30045638945232,0.6303353658536586,43.22916666666667,1027.0833333333344,25.050813008130106,0
1789,4,1,1,46,0.02127659574468085,0.02127659574468085,0.9787234042553191,47,1600,1300,300,0.8125,19,13,6,309.4616463886233,0.7760946654332408,0.19055749610720651,0.18593968872144961,132298.2967989454,-1211.7502516375173,131086.5465473079,1776,0,719.531914893617,42,5,17,34.84604094062982,0.6331845238095237,42.80523255813954,1028.7790697674423,24.49473975636767,0
1790,4,0,0,46,0.0,0.0,1.0,46,1150,800,350,0.6956521739130435,15,8,7,313.2166816700959,0.7674315619967794,0.1864935587761669,0.1879300090020575,132244.89795918367,-915.738378684814,131329.15958049885,1777,1,735.9347826086956,41,5,17,34.80299961419751,0.6341463414634146,42.857142857142854,1028.5714285714284,25.08710801393728,0
1791,4,0,2,44,0.0,0.043478260869565216,0.9565217391304348,46,1600,1200,400,0.75,20,12,8,311.68363275507943,0.7669887278582931,0.18810958857064342,0.1879007043180621,132424.15229030332,-945.0232528317754,131479.12903747155,1778,2,736.9347826086956,40,6,18,34.66277481569248,0.6375000000000001,42.68292682926829,1029.2682926829264,25.73170731707316,0
1792,4,1,1,44,0.022222222222222223,0.022222222222222223,0.9777777777777777,45,1100,600,500,0.5454545454545454,16,6,10,310.4549007603474,0.7648148148148148,0.17507047970074963,0.1872899160096224,132450.30369034637,-776.0308224271291,131674.27286791924,1779,0,721.4,40,5,18,34.66819692631717,0.6377604166666667,42.65752032520325,1029.3699186991869,25.73424796747967,0
1793,4,0,0,44,0.0,0.0,1.0,44,1000,800,200,0.8,12,8,4,318.9416266788671,0.759535764622974,0.1809578839239856,0.19201587728625663,132373.07328285553,-356.1433357370416,132016.92994711848,1780,4,738.7954545454545,42,2,19,34.52722849968613,0.6339285714285714,42.73255813953488,1029.06976744186,24.501661129568095,0
1794,4,0,1,43,0.0,0.022727272727272728,0.9772727272727273,44,950,700,250,0.7368421052631579,12,7,5,319.49872545122815,0.7587869978858351,0.18034841891232967,0.1926154305176072,132424.80604383664,-338.0816080788046,132086.72443575785,1781,5,739.7954545454545,39,5,19,34.46102368181357,0.639155982905983,42.68229166666666,1029.270833333332,26.39155982905979,0
1795,4,0,0,43,0.0,0.0,1.0,43,1050,900,150,0.8571428571428571,12,9,3,327.3609315417866,0.7506921373200443,0.19124835200315737,0.19694823561203034,132346.95845930933,65.04472159230795,132412.00318090164,1782,6,757.5348837209302,41,2,19,34.33683635428717,0.6351626016260163,42.75793650793649,1028.9682539682515,25.096786682152477,0
1796,4,0,0,43,0.0,0.0,1.0,43,1800,1700,100,0.9444444444444444,19,17,2,329.54332213104965,0.7503229974160206,0.19548785079208741,0.19896487794829534,132480.48159105846,131.64112990691729,132612.1227209654,1783,7,758.5348837209302,38,5,19,34.146689497716885,0.6414473684210527,42.628205128205124,1029.487179487179,27.09176788124155,0
1797,4,0,0,43,0.0,0.0,1.0,43,1300,1000,300,0.7692307692307693,16,10,6,341.38624783733627,0.7505537098560354,0.16536180857963534,0.1938641362153197,130132.94004891257,285.11922466784665,130418.05927358041,1784,8,759.5348837209302,40,3,17,36.21057436918992,0.6145833333333335,44.918699186991866,1020.3252032520315,25.508130081300788,5
1798,4,0,0,43,0.0,0.0,1.0,43,950,700,250,0.7368421052631579,12,7,5,342.5798648431969,0.7507844222960501,0.16444388874996552,0.19506078018622808,130236.65229030316,323.2909478484785,130559.94323815164,1785,9,760.5348837209302,40,3,17,36.0750199123855,0.6156250000000001,44.817073170731696,1020.7317073170714,25.518292682926784,0
1799,4,0,0,43,0.0,0.0,1.0,43,1000,800,200,0.8,12,8,4,345.2220810275091,0.7523532668881506,0.14935055169267653,0.19225513011844084,129368.65790435496,341.29520347080836,129709.95310782577,1786,10,761.5348837209302,37,6,20,36.88878709491989,0.6120495495495497,45.668859649122794,1017.3245614035069,27.495258416310996,2
1800,4,0,0,43,0.0,0.0,1.0,43,1000,700,300,0.7,13,7,6,345.8564848536119,0.7523532668881506,0.12653819760726126,0.19272038064721733,129391.54071015041,353.2585580750057,129744.79926822541,1787,11,762.5348837209302,38,5,18,36.849382197486776,0.6104714912280702,45.646367521367516,1017.4145299145293,26.77406657669814,1
1801,4,0,0,43,0.0,0.0,1.0,43,1300,800,500,0.6153846153846154,18,8,10,344.8096753335858,0.7531376891842008,0.12712162895410684,0.19276202216017183,129519.29253472229,331.90104166667,129851.19357638896,1788,12,763.5348837209302,39,4,16,36.74614544958385,0.6100427350427351,45.520833333333336,1017.9166666666672,26.100427350427363,0
1802,4,0,0,43,0.0,0.0,1.0,43,1000,700,300,0.7,13,7,6,345.04834845574237,0.7537375415282391,0.1227080864752712,0.19315593114584334,129572.31445312499,341.74262152777646,129914.05707465277,1789,13,764.5348837209302,39,4,16,36.68619125571244,0.6105769230769231,45.46875,1018.1249999999999,26.105769230769226,0
1803,4,1,0,44,0.022727272727272728,0.0,1.0,44,1100,800,300,0.7272727272727273,14,8,6,322.6726660406948,0.7660103946441156,0.1400108268800233,0.1682653039542743,126733.61177209362,-560.3463211175253,126173.26545097609,1790,0,748.1363636363636,40,4,12,40.14979477863006,0.5802083333333332,48.27235772357725,1006.9105691056934,25.172764227642336,8
1804,4,0,0,44,0.0,0.0,1.0,44,950,800,150,0.8421052631578947,11,8,3,327.62436608155,0.7653717406624384,0.14313848665205464,0.17138471456287138,126861.55443395166,-487.4127296912866,126374.14170426037,1791,1,749.1363636363636,40,4,13,39.89395238575609,0.5815104166666665,48.14532520325205,1007.4186991869943,25.18546747967486,0
1805,4,1,0,45,0.022222222222222223,0.0,1.0,45,1100,800,300,0.7272727272727273,14,8,6,321.23883227614147,0.7733164983164984,0.1500407357682998,0.1693280137686379,127170.80213758687,-829.1417265294406,126341.66041105743,1792,0,733.4666666666667,39,6,14,39.738136424661775,0.5862713675213675,47.83854166666667,1008.6458333333339,25.86271367521369,0
1806,4,2,1,46,0.0425531914893617,0.02127659574468085,0.9787234042553191,47,850,600,250,0.7058823529411765,11,6,5,309.5131281205091,0.7887758248535306,0.15207835403051995,0.16485782932945928,127592.67132779026,-1501.6786344167365,126090.99269337353,1793,0,703.2127659574468,41,6,13,39.602971982194305,0.5873983739837398,47.42063492063492,1010.3174603174593,24.641889276035595,0
1807,4,0,0,46,0.0,0.0,1.0,46,1000,900,100,0.9,11,9,2,311.86615776811203,0.782950885668277,0.14911681446912795,0.16600800232894328,127567.61508133344,-1243.1956057886155,126324.41947554483,1794,1,719.5,41,5,13,39.56911437362924,0.5871443089430894,47.445436507936506,1010.2182539682537,24.6394696089818,0
1808,4,0,0,46,0.0,0.0,1.0,46,1050,800,250,0.7619047619047619,13,8,5,310.87379491511757,0.7836151368760065,0.14849380101779475,0.16558256942549965,127592.67132779026,-1266.956412194515,126325.71491559574,1795,2,720.5,41,5,13,39.56860434668762,0.5873983739837398,47.42063492063492,1010.3174603174593,24.641889276035595,0
1809,4,3,2,47,0.061224489795918366,0.04081632653061224,0.9591836734693877,49,1700,1100,600,0.6470588235294118,23,11,12,294.51128649253485,0.8055555555555556,0.15519305876252854,0.1596899155996686,128308.6462620026,-2242.331104252417,126066.31515775018,1796,0,677.3265306122449,44,5,16,39.25337384999695,0.5904356060606062,46.712962962962955,1013.148148148147,23.026094276094252,0
1810,4,2,2,47,0.04081632653061224,0.04081632653061224,0.9591836734693877,49,1450,900,550,0.6206896551724138,20,9,11,307.01222224918513,0.8059452947845805,0.18735967293321298,0.16844184085563382,128778.12499999984,-1892.7083333333487,126885.4166666665,1797,0,678.2857142857143,44,5,12,38.45956486042691,0.5951704545454547,46.24999999999999,1014.9999999999987,23.068181818181788,0
1811,4,0,1,46,0.0,0.02127659574468085,0.9787234042553191,47,1550,1100,450,0.7096774193548387,20,11,9,320.0369808002673,0.7906645081714462,0.1922576606313875,0.1748511020363879,128610.97965867404,-1167.9460744546923,127443.03358421935,1798,1,708.1276595744681,42,5,12,38.299062221373056,0.5962301587301588,46.41472868217053,1014.3410852713153,24.1509782207456,0
1812,4,2,2,46,0.041666666666666664,0.041666666666666664,0.9583333333333334,48,1700,1200,500,0.7058823529411765,22,12,10,318.12120221829207,0.7983525413711584,0.20515075962345053,0.17566250018528326,129032.9621230055,-1390.3757927284323,127642.58633027707,1799,0,693.1458333333334,43,5,15,37.91874436884456,0.5990794573643412,45.999053030303024,1016.003787878787,23.627995066948532,0
1813,4,1,0,47,0.02127659574468085,0.0,1.0,47,1050,700,350,0.6666666666666666,14,7,7,322.6230110505355,0.792823003391921,0.20468320565752074,0.1777988644496168,128955.22072742016,-1079.2156796466616,127876.0050477735,1800,0,708.7234042553191,42,5,16,37.88339534439993,0.599702380952381,46.075581395348834,1015.697674418604,24.183277962347717,0
1814,4,3,2,48,0.06,0.04,0.96,50,700,400,300,0.5714285714285714,10,4,6,309.1524880341717,0.815969387755102,0.21465065502183367,0.17267297502396425,129483.95061728399,-1993.7081647403636,127490.24245254362,1801,0,667.14,44,6,12,37.68934224890831,0.6022727272727273,45.55555555555556,1017.777777777778,23.13131313131314,0
1815,4,0,0,48,0.0,0.0,1.0,48,1050,800,250,0.7619047619047619,13,8,5,324.92434258402955,0.8004210992907801,0.2224167778413062,0.18041037307284685,129250.65068956192,-1200.6634592272123,128049.98723033471,1802,1,695.9375,42,6,17,37.52481576774029,0.6026785714285714,45.78488372093023,1016.860465116279,24.2109634551495,0
1816,4,0,0,48,0.0,0.0,1.0,48,1150,800,350,0.6956521739130435,15,8,7,323.96415242972927,0.8004210992907801,0.2230095591971546,0.18010210507957833,129299.9218796948,-1222.292079802892,128077.6297998919,1803,2,696.9375,42,6,17,37.499206046747965,0.6031746031746031,45.736434108527135,1017.054263565892,24.215577703949812,0
1817,4,0,0,48,0.0,0.0,1.0,48,1050,800,250,0.7619047619047619,13,8,5,324.2492538262338,0.7997931442080378,0.228881006792357,0.18093866438273687,129447.79178685177,-1205.3300207319262,128242.46176611984,1804,3,697.9375,42,6,13,37.34189519456611,0.6046626984126984,45.59108527131783,1017.6356589147289,24.229420450350688,0
1818,4,2,1,49,0.04,0.02,0.98,50,1400,1300,100,0.9285714285714286,15,13,2,319.57311305475395,0.8111054421768708,0.24689792953141998,0.18065395898146586,129955.57270233218,-1693.9386145404465,128261.63408779174,1805,0,670.98,44,6,15,36.946437220002444,0.6070075757575757,45.0925925925926,1019.6296296296314,23.173400673400714,0
1819,4,1,2,48,0.02,0.04,0.96,50,1450,1100,350,0.7586206896551724,18,11,7,324.0970697138418,0.8104081632653061,0.2629102785085724,0.1844358285728284,130215.33028978082,-1559.5186042523726,128655.81168552845,1806,0,671.96,44,6,16,36.56823611237111,0.6096117424242424,44.837962962962976,1020.6481481481505,23.196548821548877,0
1820,4,1,0,49,0.02040816326530612,0.0,1.0,49,1300,900,400,0.6923076923076923,17,9,8,345.09891366894306,0.8093820861678005,0.2938207319541086,0.19089648768775724,129102.89345592218,-884.6031163454643,128218.29033957672,1807,0,685.2244897959183,42,7,17,37.16231248410882,0.6011904761904763,45.93023255813954,1016.2790697674424,24.197120708748628,3
1821,4,3,3,49,0.057692307692307696,0.057692307692307696,0.9423076923076923,52,1350,1000,350,0.7407407407407407,17,10,7,321.63632637869523,0.8209056058320764,0.2900346075192697,0.18078179724043902,129731.44531250003,-2054.655787099634,127676.7895254004,1808,0,646.6346153846154,43,9,14,37.120824812542594,0.6061046511627908,45.3125,1018.7500000000002,23.691860465116285,0
1822,4,1,0,50,0.02,0.0,1.0,50,1000,700,300,0.7,13,7,6,335.91902500443234,0.8157653061224489,0.3086031560490945,0.18844506615822393,129655.65653344651,-1289.2396541950313,128366.41687925148,1809,0,673.48,41,9,16,36.833966491330614,0.6082317073170733,45.38690476190475,1018.4523809523794,24.840301974448277,0
1823,4,0,1,49,0.0,0.02,0.98,50,1350,900,450,0.6666666666666666,18,9,9,338.4822535677964,0.8160714285714286,0.3001167996885348,0.1908653497889978,129857.80915375406,-1209.0872228521027,128648.72193090196,1810,1,674.48,41,9,16,36.56357471935632,0.6102642276422764,45.18849206349206,1019.2460317460315,24.859659310878815,0
1824,4,2,2,49,0.0392156862745098,0.0392156862745098,0.9607843137254902,51,1550,900,650,0.5806451612903226,22,9,13,330.99172494754,0.8218300653594772,0.29941580583225846,0.1878712599446172,130114.25212013998,-1586.6518500991517,128527.60027004083,1811,0,662.1372549019608,42,9,16,36.494641783012,0.611359126984127,44.93701550387597,1020.2519379844958,24.291712809154664,0
1825,4,1,1,49,0.02,0.02,0.98,50,1350,1000,350,0.7407407407407407,17,10,7,340.9586022326185,0.8168707482993197,0.3053457834840978,0.1931347322068069,130034.82187145666,-1132.7017786281385,128902.12009282853,1812,0,676.36,41,9,16,36.32094397432159,0.6120426829268293,45.01488095238094,1019.9404761904741,24.876596980255467,0
1826,4,1,0,50,0.02,0.0,1.0,50,950,700,250,0.7368421052631579,12,7,5,340.6690752206134,0.8169387755102041,0.3149329185300407,0.19359790650382483,130161.33334120679,-1131.6117882338192,129029.72155297297,1813,0,677.34,41,9,17,36.200093978870946,0.6133130081300813,44.89087301587301,1020.4365079365074,24.888695315524572,0
1827,4,2,1,51,0.038461538461538464,0.019230769230769232,0.9807692307692307,52,1700,1300,400,0.7647058823529411,21,13,8,327.85809159193093,0.8294840372046254,0.31669751750287345,0.1887656699411419,130667.99433893932,-1831.8094135802426,128836.18492535908,1814,0,652.25,41,11,17,36.01461931560904,0.6183943089430894,44.39484126984127,1022.4206349206352,24.937088656600856,0
1828,4,0,0,51,0.0,0.0,1.0,51,1350,700,650,0.5185185185185185,20,7,13,336.0578242534521,0.8211437908496733,0.3251650232572645,0.1931468340766413,130599.97046235719,-1422.1716157710223,129177.79884658617,1815,1,666.0392156862745,40,11,17,35.87380691986478,0.6192708333333332,44.461382113821145,1022.1544715447164,25.553861788617912,0
1829,4,0,0,51,0.0,0.0,1.0,51,1250,700,550,0.56,18,7,11,334.5777011229876,0.8212418300653596,0.328984694036597,0.19307282018932054,130755.83316808783,-1450.4027860400477,129305.43038204778,1816,2,667.0392156862745,40,11,17,35.75409048754637,0.6208333333333333,44.3089430894309,1022.7642276422769,25.569105691056922,0
1830,4,0,0,51,0.0,0.0,1.0,51,1350,1000,350,0.7407407407407407,17,10,7,335.8184660333258,0.8204575163398694,0.3346699292535795,0.19423981156487316,130845.55820302654,-1411.9290713970768,129433.62913162945,1817,3,668.0392156862745,41,10,17,35.63170674553155,0.6201727642276422,44.22123015873016,1023.1150793650789,24.954026325977534,0
1831,4,0,1,50,0.0,0.0196078431372549,0.9803921568627451,51,1150,700,450,0.6086956521739131,16,7,9,400.4926640313832,0.8211437908496733,0.3657606339485129,0.2198095681388838,128792.54301717474,135.2928179493341,128927.83583512407,1818,4,669.0392156862745,43,8,14,36.07272522312403,0.596656976744186,46.23579545454546,1015.0568181818195,23.605972515856266,8
1832,4,2,3,49,0.038461538461538464,0.057692307692307696,0.9423076923076923,52,950,700,250,0.7368421052631579,12,7,5,393.1714758640735,0.8272844394167923,0.3707639740669362,0.2173832215419749,129083.74592764046,-249.590620713313,128834.15530692715,1819,0,657.0576923076923,44,8,14,35.960516324981015,0.5982481060606061,45.94907407407407,1016.2037037037026,23.095538720538695,0
1833,4,3,2,50,0.057692307692307696,0.038461538461538464,0.9615384615384616,52,900,500,400,0.5555555555555556,13,5,8,338.38566893424047,0.8272687280040221,0.2700622710622713,0.18859073905570733,129398.4924283397,-1623.1228742726676,127775.36955406703,1820,0,657.5,42,10,18,37.032341269841275,0.6041666666666666,45.639534883720934,1017.4418604651167,24.2248062015504,6
1834,4,1,1,50,0.0196078431372549,0.0196078431372549,0.9803921568627451,51,1250,900,350,0.72,16,9,7,341.45422569761183,0.823529411764706,0.2630398752071754,0.19044567661666142,129428.42306193305,-1361.2236040249486,128067.1994579081,1821,0,671.3725490196078,41,10,13,36.92386906502875,0.6059451219512195,45.610119047619044,1017.5595238095233,24.81852497096398,0
1835,4,2,3,49,0.038461538461538464,0.057692307692307696,0.9423076923076923,52,1550,900,650,0.5806451612903226,22,9,13,332.7144016883978,0.8241107340372046,0.2531636773268573,0.18730324668925008,129793.15020131003,-1763.1899375037556,128029.96026380626,1822,0,659.4230769230769,42,10,13,36.776103081019386,0.6081349206349207,45.251937984496124,1018.9922480620156,24.261720191952755,0
1836,4,0,0,49,0.0,0.0,1.0,49,850,500,350,0.5882352941176471,12,5,7,347.3960526283766,0.8122874149659864,0.2513610748511572,0.19363553889981683,129403.18720080622,-809.168713781814,128594.01848702441,1823,10,700.7551020408164,41,8,18,36.79837818512742,0.6056910569105691,45.63492063492063,1017.4603174603172,24.816105303910177,0
1837,4,1,0,50,0.02,0.0,1.0,50,1250,700,550,0.56,18,7,11,340.26191328463074,0.8147959183673469,0.26735005452562666,0.1914234199276113,129766.82098765438,-1169.0586419753058,128597.76234567908,1824,0,687.72,44,6,15,36.610550708833145,0.6051136363636364,45.27777777777778,1018.8888888888894,23.156565656565668,0
1838,4,0,0,50,0.0,0.0,1.0,50,1200,700,500,0.5833333333333334,17,7,10,337.81526331029266,0.8149659863945578,0.2591280653950958,0.19073569482288838,129908.37191358031,-1222.9938271604847,128685.37808641982,1825,1,688.72,44,6,15,36.52929155313352,0.6065340909090909,45.13888888888889,1019.4444444444449,23.16919191919193,0
1839,4,1,1,50,0.0196078431372549,0.0196078431372549,0.9803921568627451,51,850,600,250,0.7058823529411765,11,6,5,331.08036603233245,0.8219607843137255,0.26302107289483967,0.18809156036683838,130149.48710452189,-1582.0120341029162,128567.47507041898,1826,0,676.1960784313726,46,5,16,36.45670431508831,0.6064311594202899,44.902482269503544,1020.3900709219856,22.18239284613012,0
1840,4,1,1,50,0.0196078431372549,0.0196078431372549,0.9803921568627451,51,1100,700,400,0.6363636363636364,15,7,8,328.18047185342726,0.8201633986928105,0.260266748138692,0.18721914537162163,130310.92620092956,-1646.7523891703845,128664.17381175917,1827,0,677.1764705882352,43,8,18,36.36732517158226,0.6119186046511629,44.74431818181817,1021.0227272727258,23.744714587737807,0
1841,4,0,0,50,0.0,0.0,1.0,50,950,400,550,0.42105263157894735,15,4,11,330.9401531087361,0.8145748299319727,0.2712962611501235,0.18891914049078318,130336.78583768991,-1373.2648278348818,128963.52100985503,1828,1,691.32,42,8,18,36.27071866894413,0.61359126984127,44.71899224806201,1021.1240310077509,24.312476928755974,0
1842,4,0,0,50,0.0,0.0,1.0,50,1450,1000,450,0.6896551724137931,19,10,9,331.28998984480785,0.8149319727891157,0.27835202521086355,0.1898187838786845,130480.1847039283,-1354.6441868973982,129125.54051703091,1829,2,692.32,43,7,18,36.11674313343838,0.6136143410852715,44.57859848484848,1021.6856060606045,23.76013037350243,0
1843,4,0,0,50,0.0,0.0,1.0,50,800,600,200,0.75,10,6,4,331.22663061935094,0.8156802721088435,0.272146364057434,0.1904950174499679,130625.3508540664,-1346.6810326273921,129278.669821439,1830,3,693.32,43,7,13,35.97161108537903,0.6150678294573644,44.43655303030304,1022.2537878787892,23.77334390415789,0
1844,4,0,1,49,0.0,0.02,0.98,50,850,500,350,0.5882352941176471,12,5,7,334.6822599634168,0.8163265306122449,0.2775201407537733,0.1929649613104613,130722.17312507179,-1249.9215342343848,129472.2515908374,1831,4,694.32,43,7,14,35.785431521437154,0.6160368217054264,44.34185606060606,1022.6325757575761,23.782152924594794,0
1845,4,0,0,49,0.0,0.0,1.0,49,1450,900,550,0.6206896551724138,20,9,11,349.35554603369843,0.8113662131519275,0.2951141562049593,0.19504021055709897,129466.28146701385,-696.7942026802165,128769.48726433363,1832,8,709.4081632653061,43,6,13,36.68436540429886,0.6034399224806202,45.572916666666664,1017.7083333333329,23.66763565891472,4
1846,4,0,0,49,0.0,0.0,1.0,49,1400,1100,300,0.7857142857142857,17,11,6,349.15790156841535,0.810763888888889,0.29652017085904103,0.19528862860876509,129538.57197687095,-754.1168072773224,128784.45516959362,1833,9,710.4081632653061,43,6,13,36.61589147286821,0.6041666666666667,45.50189393939394,1017.992424242424,23.67424242424242,0
1847,4,0,1,48,0.0,0.02040816326530612,0.9795918367346939,49,1350,1100,250,0.8148148148148148,16,11,5,352.4545454545456,0.8110119047619048,0.30042671614100236,0.19780612244897958,129672.49657064464,-659.2678326474696,129013.22873799717,1834,10,711.4081632653061,44,5,13,36.39583333333334,0.6041666666666667,45.37037037037037,1018.5185185185179,23.148148148148135,0
1848,4,1,0,49,0.02040816326530612,0.0,1.0,49,1650,1200,450,0.7272727272727273,21,12,9,352.6106667718546,0.8157950680272109,0.2967944332270924,0.19872942187187967,129837.5868055558,-643.5763888888698,129194.01041666692,1835,0,710.9591836734694,44,5,14,36.224107386208786,0.6058238636363635,45.20833333333334,1019.1666666666686,23.16287878787883,0
1849,4,1,1,49,0.02,0.02,0.98,50,750,400,350,0.5333333333333333,11,4,7,350.61600560597907,0.8207142857142857,0.3084793608521972,0.19917747368388075,130147.02896089324,-873.673712849188,129273.35524804404,1836,0,697.72,45,5,16,35.960848498298574,0.6076388888888888,44.90489130434783,1020.380434782609,22.675120772946865,0
1850,4,1,1,49,0.02,0.02,0.98,50,1200,600,600,0.5,18,6,12,351.35430475703623,0.8231462585034013,0.30127074274558563,0.2000713320013662,130239.47113428099,-847.9602335381362,129391.51090074285,1837,0,696.94,45,5,17,35.848252580826454,0.6085648148148148,44.81431159420289,1020.7427536231871,22.683172302737493,0
1851,4,0,0,49,0.0,0.0,1.0,49,1500,1100,400,0.7333333333333333,19,11,8,362.3490212411495,0.8150864512471655,0.30587255310287387,0.20645467489321306,130262.58680555552,-359.8876286494459,129902.69917690607,1838,2,712.1632653061224,40,9,17,35.54421768707483,0.6158854166666667,44.791666666666664,1020.833333333333,25.520833333333325,0
1852,4,2,2,49,0.0392156862745098,0.0392156862745098,0.9607843137254902,51,900,500,400,0.5555555555555556,13,5,8,347.14858747738265,0.82640522875817,0.2961962490764294,0.200403628719573,130770.59771184863,-1120.6343441517397,129649.9633676969,1839,0,685.1960784313726,43,8,15,35.417727525229154,0.6165213178294573,44.29450757575758,1022.8219696969699,23.786557434813254,0
1853,4,1,1,49,0.02,0.02,0.98,50,1050,700,350,0.6666666666666666,14,7,7,348.960647468244,0.8190816326530612,0.29457922668688385,0.2009952375592202,130683.32732407922,-879.3322967369616,129803.99502734226,1840,0,699.88,42,8,15,35.45970748041445,0.6170634920634921,44.379844961240316,1022.4806201550398,24.34477667035809,0
1854,4,1,1,49,0.02,0.02,0.98,50,1500,1200,300,0.8,18,12,6,344.9048245195594,0.8214625850340136,0.29014256619144563,0.19923325745776932,130794.81336805578,-977.6475694444238,129817.16579861136,1841,0,700.86,43,7,15,35.450610997963345,0.6167635658914727,44.27083333333334,1022.9166666666684,23.78875968992252,0
1855,4,0,1,48,0.0,0.02040816326530612,0.9795918367346939,49,1700,900,800,0.5294117647058824,25,9,16,374.22771627823465,0.8147675736961452,0.2853905533404901,0.20617296935489493,128942.64510459545,-8.158650548682658,128934.48645404677,1842,6,716.1632653061224,44,5,17,36.585870787370474,0.5968276515151515,46.08796296296297,1015.6481481481491,23.082912457912478,8
1856,4,1,1,48,0.02040816326530612,0.02040816326530612,0.9795918367346939,49,1150,900,250,0.782608695652174,14,9,5,366.87375108825256,0.8145904195011338,0.29487091311613445,0.2033269517010562,129177.85600994511,-321.60708161865614,128856.24892832646,1843,0,717.0,44,5,17,36.532622886115924,0.5991950757575758,45.85648148148148,1016.5740740740739,23.103956228956225,0
1857,4,1,0,49,0.02040816326530612,0.0,1.0,49,1150,800,350,0.6956521739130435,15,8,7,363.2885618114407,0.8124291383219955,0.2923776883485989,0.202234577242916,129352.72285997732,-401.5206391198453,128951.20222085748,1844,0,717.9795918367347,41,8,18,36.44553345036084,0.6051829268292683,45.68452380952381,1017.2619047619047,24.811265969802555,0
1858,4,0,0,49,0.0,0.0,1.0,49,1150,600,550,0.5217391304347826,17,6,11,360.7276291111579,0.811437074829932,0.29174184538812087,0.20145371513616597,129478.90216561164,-458.67652037666824,129020.22564523497,1845,1,718.9795918367347,41,8,14,36.38218068687655,0.6064532520325203,45.56051587301587,1017.7579365079367,24.823364305071628,0
1859,4,2,2,49,0.0392156862745098,0.0392156862745098,0.9607843137254902,51,1000,700,300,0.7,13,7,6,347.50425053270857,0.8236601307189543,0.2895228936261154,0.19620624607000633,129908.37191358034,-1171.2577160493743,128737.11419753097,1846,0,691.7450980392157,44,7,15,36.28235694822889,0.6065340909090908,45.13888888888889,1019.4444444444451,23.169191919191935,0
1860,4,0,0,49,0.0,0.0,1.0,49,1300,900,400,0.6923076923076923,17,9,8,357.32772750544984,0.8119331065759637,0.28752756810486724,0.20065326236844497,129694.42942130883,-531.3168529535498,129163.11256835528,1847,1,720.9387755102041,42,7,15,36.24944507864027,0.6071428571428572,45.348837209302324,1018.6046511627908,24.252491694352162,0
1861,4,1,1,49,0.02,0.02,0.98,50,1050,700,350,0.6666666666666666,14,7,7,352.4535411125037,0.8164795918367347,0.287225726214799,0.1992752140785261,129962.243070324,-838.8694437880711,129123.37362653592,1848,0,707.5,45,5,17,36.1015183145302,0.6057870370370371,45.08605072463768,1019.6557971014494,22.659017713365543,0
1862,4,0,1,48,0.0,0.02040816326530612,0.9795918367346939,49,1250,700,550,0.56,18,7,11,355.7330949015181,0.8129251700680272,0.2951975778508238,0.20133835083480606,130002.78206447208,-550.7415980795448,129452.04046639253,1849,1,722.4489795918367,44,5,17,35.97674928878397,0.6074810606060606,45.046296296296305,1019.8148148148164,23.177609427609465,0
1863,4,0,0,48,0.0,0.0,1.0,48,1300,800,500,0.6153846153846154,18,8,10,361.4864850889702,0.8146978427895981,0.28740407228617393,0.2049438114409678,130069.31889921954,-196.33981864094875,129872.97908057859,1850,2,718.0833333333334,43,5,17,35.76247060279737,0.6094961240310077,44.98106060606061,1020.0757575757582,23.72269203664554,0
1864,4,2,0,50,0.04,0.0,1.0,50,750,500,250,0.6666666666666666,10,5,5,349.70845041587006,0.8242006802721088,0.2894451294697906,0.20027029835603014,130460.49783854622,-874.9418513084702,129585.55598723775,1851,0,690.32,42,8,19,35.666239843181884,0.6148313492063493,44.597868217054256,1021.6085271317818,24.32401255075671,0
1865,4,0,1,49,0.0,0.02,0.98,50,1150,600,550,0.5217391304347826,17,6,11,343.97882094149713,0.8220748299319728,0.2841508718726309,0.19812579249861778,130683.32732407907,-1009.5406300703114,129673.78669400876,1852,1,691.32,42,8,14,35.5870530073288,0.6170634920634921,44.37984496124031,1022.4806201550387,24.344776670358062,0
1866,4,1,1,49,0.02,0.02,0.98,50,1000,800,200,0.8,12,8,4,343.37765193265,0.8228741496598639,0.28352695915853277,0.1979063004284685,130708.09789262975,-1023.5520514091606,129684.54584122059,1853,0,692.28,42,8,14,35.57736346694463,0.6173115079365079,44.355620155038764,1022.5775193798457,24.34708379475823,0
1867,4,2,1,50,0.0392156862745098,0.0196078431372549,0.9803921568627451,51,950,500,450,0.5263157894736842,14,5,9,338.5901059664114,0.8287254901960786,0.28693342622022944,0.1963241344037004,130940.15438475672,-1332.9918503213892,129607.16253443534,1854,0,679.6666666666666,43,8,16,35.46524179620036,0.6182170542635659,44.12878787878788,1023.484848484849,23.80197322057788,0
1868,4,0,0,50,0.0,0.0,1.0,50,1650,1300,350,0.7878787878787878,20,13,7,345.2195128098225,0.8239455782312924,0.28680977054034096,0.200168052277283,130940.15438475642,-959.3807392103076,129980.77364554611,1855,1,694.26,43,7,18,35.29561435973353,0.618217054263566,44.12878787878787,1023.4848484848466,23.80197322057783,0
1869,4,1,1,50,0.0196078431372549,0.0196078431372549,0.9803921568627451,51,1150,600,550,0.5217391304347826,17,6,11,340.2170484315248,0.8283986928104576,0.2923811852592113,0.19877728922614837,131233.23473936887,-1270.443244170106,129962.79149519876,1856,0,681.6274509803922,44,7,19,35.12768088439063,0.6197916666666667,43.84259259259259,1024.6296296296287,23.287037037037013,0
1870,4,0,0,50,0.0,0.0,1.0,50,1200,800,400,0.6666666666666666,16,8,8,346.2008393841492,0.8246088435374149,0.29579137666094235,0.20189878155544774,131162.08954903978,-918.3149005486955,130243.77464849109,1857,1,696.1,44,6,19,35.04625026364157,0.6190814393939394,43.91203703703704,1024.351851851852,23.280723905723907,0
1871,4,2,3,49,0.038461538461538464,0.057692307692307696,0.9423076923076923,52,1450,1100,350,0.7586206896551724,18,11,7,334.53941344109217,0.8341503267973855,0.28816402124272966,0.1972523725089951,131582.46429358778,-1595.5707951905058,129986.89349839727,1858,0,670.2884615384615,41,11,13,34.92111454908787,0.627540650406504,43.50198412698413,1025.9920634920632,25.024196670538124,0
1872,4,0,0,49,0.0,0.0,1.0,49,1200,900,300,0.75,15,9,6,347.1128847254219,0.8293650793650794,0.29049132606410377,0.20373477187551187,131408.21533203154,-677.3030598958024,130730.91227213574,1859,3,699.5510204081633,39,10,20,34.77439550949913,0.6290064102564101,43.671875000000014,1025.3125000000023,26.290064102564163,0
1873,4,1,0,50,0.02,0.0,1.0,50,1300,800,500,0.6153846153846154,18,8,10,310.54048629906606,0.832108843537415,0.20152440075875155,0.18584357895235126,132147.21734947938,-1792.5877722448631,130354.62957723452,1860,0,686.54,46,4,17,34.96975053170086,0.6263586956521738,42.952127659574465,1028.1914893617018,22.35198889916743,2
1874,4,0,3,47,0.0,0.06,0.94,50,1700,1300,400,0.7647058823529411,21,13,8,310.11792930478885,0.8306972789115646,0.19740973718224897,0.18637589692294543,132306.78101107845,-1793.8590079724345,130512.92200310601,1861,1,687.54,46,4,17,34.82065919862127,0.6279438405797101,42.79698581560284,1028.812056737589,22.365479494295414,0
1875,4,1,1,47,0.020833333333333332,0.020833333333333332,0.9791666666666666,48,1550,1100,450,0.7096774193548387,20,11,9,318.6590629096188,0.8198877068557919,0.19766342517558044,0.19088606001479122,132183.68055555568,-1175.6944444444343,131007.98611111124,1862,0,716.7083333333334,44,4,18,34.72447325769855,0.6292613636363635,42.91666666666667,1028.3333333333344,23.371212121212146,0
1876,4,0,0,47,0.0,0.0,1.0,47,1200,1000,200,0.8333333333333334,14,10,4,321.35498488313834,0.8142537773666357,0.20046793618197012,0.19235239392839693,132154.46815455705,-906.3005767906177,131248.16757776643,1863,3,732.9574468085107,43,4,19,34.684487628169705,0.6303294573643411,42.945075757575765,1028.219696969698,23.912085976039485,0
1877,4,0,0,47,0.0,0.0,1.0,47,1050,700,350,0.6666666666666666,14,7,7,324.04927110604064,0.8136756090040086,0.19937016262964957,0.19471633193008966,132300.56244260777,-825.6198347107561,131474.942607897,1864,4,733.9574468085107,43,4,19,34.46858124693176,0.6317829457364341,42.8030303030303,1028.7878787878778,23.925299506694834,0
1878,4,0,1,46,0.0,0.02127659574468085,0.9787234042553191,47,900,500,400,0.5555555555555556,13,5,8,325.86884338298586,0.8134443416589577,0.19521364709752476,0.19606261640085942,132349.27847365692,-774.2987402433523,131574.97973341355,1865,5,734.9574468085107,43,4,19,34.372890974906426,0.6322674418604652,42.75568181818181,1028.9772727272718,23.9297040169133,0
1879,4,0,0,46,0.0,0.0,1.0,46,850,600,250,0.7058823529411765,11,6,5,326.64533657551226,0.8128019323671498,0.19004733641470684,0.19733118096878424,132502.61423631755,-543.7008925803596,131958.9133437372,1866,6,740.2826086956521,40,6,21,34.19907544500379,0.6382812500000001,42.606707317073166,1029.5731707317063,25.739329268292657,0
1880,4,0,0,46,0.0,0.0,1.0,46,1300,1000,300,0.7692307692307693,16,10,6,328.77778018457775,0.8132045088566828,0.1891958559447462,0.19917291106818275,132607.26631180188,-480.3354691321253,132126.93084266977,1867,7,741.2826086956521,40,6,21,34.039220522940305,0.6393229166666667,42.50508130081301,1029.9796747967482,25.749491869918707,0
1881,4,1,0,47,0.02127659574468085,0.0,1.0,47,1050,700,350,0.6666666666666666,14,7,7,324.2212464882388,0.8168748072772124,0.19454290930226925,0.1982708281465723,132960.14817964216,-778.2990047871035,132181.84917485504,1868,0,726.4893617021277,41,6,19,33.803065281518535,0.641260162601626,42.16269841269841,1031.3492063492058,25.154858691444044,0
1882,4,0,0,47,0.0,0.0,1.0,47,1450,1000,450,0.6896551724137931,19,10,9,325.8459300403361,0.8151017576318224,0.19828188992108697,0.20013028575141753,133122.0000676042,-724.547615828362,132397.45245177584,1869,1,727.4893617021277,42,5,19,33.59917840375589,0.6413690476190477,42.00581395348838,1031.9767441860472,24.570874861572552,0
1883,4,0,0,47,0.0,0.0,1.0,47,1250,700,550,0.56,18,7,11,321.85890571191555,0.8126734505087881,0.19285921426172958,0.19852713033734978,133280.93278463656,-820.4689643346983,132460.46382030187,1870,2,728.4893617021277,44,3,20,33.543123804399805,0.6401515151515151,41.851851851851855,1032.592592592593,23.468013468013478,0
1884,4,1,1,47,0.020833333333333332,0.020833333333333332,0.9791666666666666,48,1200,800,400,0.6666666666666666,16,8,8,316.7647026392316,0.8158244680851063,0.18705609943372625,0.19680211310662837,133549.11821499452,-1138.7219593341292,132410.3962556604,1871,0,714.2916666666666,41,7,20,33.40681687302044,0.6471036585365852,41.59226190476191,1033.6309523809539,25.2105110336818,0
1885,4,0,0,47,0.0,0.0,1.0,47,1400,900,500,0.6428571428571429,19,9,10,322.90582726326716,0.8110545790934319,0.1916609471516808,0.20020161290322583,133472.22222222234,-780.2083333333236,132692.01388888902,1872,4,730.4893617021277,42,5,20,33.32493279569891,0.6448412698412698,41.66666666666667,1033.3333333333344,24.60317460317463,0
1886,4,0,0,47,0.0,0.0,1.0,47,1150,600,550,0.5217391304347826,17,6,11,319.24061496184777,0.8111702127659574,0.19034804925406346,0.19861531035924881,133600.39451255047,-869.8655793335754,132730.5289332169,1873,5,731.4893617021277,41,6,20,33.29165067331989,0.647611788617886,41.542658730158735,1033.8293650793657,25.21535036778941,0
1887,4,0,0,47,0.0,0.0,1.0,47,950,700,250,0.7368421052631579,12,7,5,318.1836119375029,0.8101295097132284,0.1866804918273708,0.19836997433232845,133677.3274124466,-893.2130259511052,132784.1143864955,1874,6,732.4893617021277,41,6,20,33.242197492964976,0.6483739837398372,41.468253968253975,1034.1269841269852,25.22260936895086,0
1888,4,0,0,47,0.0,0.0,1.0,47,1100,900,200,0.8181818181818182,13,9,4,318.30552144480544,0.809936786925686,0.18543657223553245,0.19872175847805643,133728.6283147519,-886.6878464348608,132841.94046831704,1875,7,733.4893617021277,41,6,16,33.18786367414797,0.6488821138211381,41.4186507936508,1034.3253968253973,25.22744870305847,0
1889,4,0,0,47,0.0,0.0,1.0,47,1100,700,400,0.6363636363636364,15,7,8,317.80550425656475,0.8088189947579402,0.1784949307439665,0.19896226947154694,133831.25964506174,-893.5378086419777,132937.72183641978,1876,8,734.4893617021277,41,6,16,33.09843400447426,0.6498983739837398,41.31944444444444,1034.7222222222224,25.23712737127372,0
1890,4,0,0,47,0.0,0.0,1.0,47,1350,800,550,0.5925925925925926,19,8,11,319.7191894694893,0.8073543015726179,0.17719875415216246,0.2009341070760015,133973.3376900427,-833.2306126434682,133140.10707739924,1877,9,735.4893617021277,42,5,16,32.90726787719952,0.6498015873015873,41.18217054263566,1035.2713178294578,24.649317091177565,0
1891,4,0,0,47,0.0,0.0,1.0,47,850,600,250,0.7058823529411765,11,6,5,321.04945148086864,0.8069303114400246,0.18000792372518593,0.20218358797737462,134048.58599430646,-792.7549989483582,133255.8309953581,1878,10,736.4893617021277,42,5,16,32.79783069773245,0.6505456349206348,41.10949612403102,1035.5620155038778,24.656238464378042,0
1892,4,0,0,47,0.0,0.0,1.0,47,950,600,350,0.631578947368421,13,6,7,319.41551019147795,0.8060437866173296,0.18125215224241265,0.20142963943579423,134098.76326730681,-833.3550229853813,133265.40824432144,1879,11,737.4893617021277,42,5,16,32.79013471793432,0.6510416666666666,41.061046511627914,1035.7558139534897,24.660852713178326,0
1893,4,1,1,47,0.020833333333333332,0.020833333333333332,0.9791666666666666,48,1200,900,300,0.75,15,9,6,313.82252231455817,0.8099697104018913,0.1809515107212476,0.1987542641325537,134256.19834710754,-1173.4762396694111,133082.72210743814,1880,0,723.1041666666666,43,5,16,32.77823464912281,0.6511627906976744,40.909090909090914,1036.3636363636372,24.101479915433423,0
1894,4,0,0,47,0.0,0.0,1.0,47,1350,1100,250,0.8148148148148148,16,11,5,319.0198951708819,0.8054656182547024,0.18494944839535865,0.20164047793556442,134182.60306366225,-838.6160073748774,133343.98705628735,1881,13,739.4893617021277,43,4,16,32.716863936873544,0.6504360465116279,40.98011363636364,1036.079545454546,24.09487315010572,0
1895,4,0,0,47,0.0,0.0,1.0,47,1050,700,350,0.6666666666666666,14,7,7,319.6181914598115,0.8060823311748381,0.18898749064471287,0.2025605735684794,134280.734592014,-816.2868923611005,133464.4476996529,1882,14,740.4893617021277,43,4,16,32.60364321608041,0.6514050387596899,40.88541666666667,1036.4583333333342,24.103682170542655,0
1896,4,0,0,47,0.0,0.0,1.0,47,1550,1000,550,0.6451612903225806,21,10,11,323.0151882748896,0.8044634597594819,0.19547338003203185,0.20542005073767702,134406.72260802475,-716.9174382715948,133689.80516975315,1883,15,741.4893617021277,44,3,17,32.39016876506831,0.6512784090909091,40.76388888888889,1036.944444444445,23.566919191919204,0
1897,4,0,0,47,0.0,0.0,1.0,47,1100,900,200,0.8181818181818182,13,9,4,323.0151882748896,0.8044634597594819,0.19547338003203185,0.20542005073767702,134406.72260802475,-716.9174382715948,133689.80516975315,1884,16,742.4893617021277,44,3,17,32.39016876506831,0.6512784090909091,40.76388888888889,1036.944444444445,23.566919191919204,0
1898,4,0,0,47,0.0,0.0,1.0,47,2050,1900,150,0.926829268292683,22,19,3,321.0148194119127,0.8041936478569226,0.19007041544542913,0.20441654304905268,134454.73358196166,-767.6075960219425,133687.12598593973,1885,17,743.4893617021277,44,3,17,32.394243073535115,0.6517518939393939,40.717592592592595,1037.1296296296302,23.57112794612796,0
1899,4,0,0,47,0.0,0.0,1.0,47,1850,1300,550,0.7027027027027027,24,13,11,304.3856090780137,0.8040394696268887,0.1580748615462284,0.1955984653851087,134785.82493173663,-1194.6269166141897,133591.19801512244,1886,18,744.4893617021277,45,2,12,32.496656199116075,0.6537037037037038,40.398550724637666,1038.4057971014463,23.07568438003214,1
1900,4,0,3,44,0.0,0.06382978723404255,0.9361702127659575,47,1000,800,200,0.8,12,8,4,302.65500312724737,0.8028060437866172,0.15919969721482174,0.194991436846251,134879.89983721887,-1235.5846985927553,133644.31513862612,1887,19,745.4893617021277,45,2,12,32.44826183001975,0.6546296296296297,40.30797101449274,1038.7681159420274,23.08373590982283,0
1901,4,0,0,44,0.0,0.0,1.0,44,1200,800,400,0.6666666666666666,16,8,8,309.44873381662444,0.796665785764623,0.17188825545488529,0.19880411460305436,134777.0754461871,-458.68093113394593,134318.39451505317,1888,20,781.2727272727273,42,2,16,32.37390350877193,0.6577380952380952,40.406976744186046,1038.3720930232557,24.72314507198228,0
1902,4,0,0,44,0.0,0.0,1.0,44,1250,1000,250,0.8,15,10,5,307.4767322754013,0.795630725863284,0.16490736751400248,0.19844910038386473,134944.0606347566,-501.5682392102913,134442.49239554632,1889,21,782.2727272727273,43,1,14,32.25938753189937,0.6579457364341086,40.24621212121212,1039.015151515151,24.163143058491883,0
1903,4,0,0,44,0.0,0.0,1.0,44,950,500,450,0.5263157894736842,14,5,9,307.65131055663187,0.7955866807610994,0.1586849909703929,0.1988318894021484,134993.26091167363,-493.82927284204936,134499.43163883156,1890,22,783.2727272727273,43,1,15,32.20604762772614,0.6584302325581395,40.19886363636364,1039.204545454546,24.167547568710372,0
1904,4,0,0,44,0.0,0.0,1.0,44,1050,700,350,0.6666666666666666,14,7,7,318.4804687457313,0.7942653276955602,0.17543528259118735,0.20238204598357606,134378.90199043,-240.5888609102255,134138.31312951978,1891,23,784.2727272727273,43,1,19,32.53541038755443,0.6523740310077519,40.7907196969697,1036.8371212121222,24.112491190979586,1
1905,4,0,0,44,0.0,0.0,1.0,44,1050,700,350,0.6666666666666666,14,7,7,322.2968798530035,0.7939349894291755,0.1764610686009258,0.20549709091442417,134501.66168072805,-130.1068210513942,134371.55485967666,1892,24,785.2727272727273,43,1,19,32.31429919055444,0.6535852713178293,40.6723484848485,1037.3106060606085,24.12350246652578,0
1906,4,0,0,44,0.0,0.0,1.0,44,700,400,300,0.5714285714285714,10,4,6,322.41415461040924,0.7928779069767442,0.17935377875136882,0.20584903717433856,134550.7812500003,-123.78472222219301,134426.9965277781,1893,25,786.2727272727273,43,1,20,32.26238286479251,0.6540697674418603,40.625000000000014,1037.5000000000023,24.12790697674424,0
1907,4,0,0,44,0.0,0.0,1.0,44,1000,800,200,0.8,12,8,4,321.5339686038785,0.7920410500352361,0.1806027974580624,0.20556413231979642,134599.9097867888,-144.31136650592316,134455.59842028288,1894,26,787.2727272727273,43,1,20,32.23634178986435,0.6545542635658913,40.57765151515154,1037.6893939393976,24.132311486962735,0
1908,4,0,0,44,0.0,0.0,1.0,44,1000,700,300,0.7,13,7,6,320.97218171879126,0.7911161028893587,0.1792394945441278,0.2060385831595336,134747.3492022501,-149.9698691459713,134597.37933310412,1895,27,788.2727272727273,43,1,21,32.104311078681754,0.6560077519379843,40.43560606060608,1038.2575757575783,24.145525017618098,0
1909,4,0,0,44,0.0,0.0,1.0,44,1200,900,300,0.75,15,9,6,317.6590636190631,0.7906756518675123,0.17790597440487987,0.20446505925903108,134845.68698347127,-233.00906795222988,134612.67791551905,1896,28,789.2727272727273,43,1,17,32.0926027230732,0.6569767441860466,40.3409090909091,1038.6363636363653,24.15433403805501,0
1910,4,0,0,44,0.0,0.0,1.0,44,1400,1000,400,0.7142857142857143,18,10,8,318.1798087048772,0.7900369978858351,0.17984018624226383,0.20549658863558673,134968.6596522757,-211.1395381370445,134757.52011413866,1897,29,790.2727272727273,43,1,17,31.956943558431302,0.658187984496124,40.22253787878788,1039.1098484848492,24.165345313601144,0
1911,4,0,0,44,0.0,0.0,1.0,44,800,400,400,0.5,12,4,8,316.79508538109104,0.7899489076814659,0.18362377418499842,0.20502021563342332,135042.47015610675,-243.84182736453045,134798.62832874223,1898,30,791.2727272727273,43,1,17,31.919642857142875,0.6589147286821705,40.15151515151516,1039.3939393939413,24.171952078928868,0
1912,4,1,2,43,0.022222222222222223,0.044444444444444446,0.9555555555555556,45,1000,700,300,0.7,13,7,6,310.26882495093986,0.7968013468013468,0.18326557662443022,0.20180947948314476,135224.07514574777,-608.83701989024,134615.23812585755,1899,0,774.6666666666666,44,1,17,31.909144188254857,0.6593276515151514,39.97685185185186,1040.092592592594,23.638468013468046,0
1913,4,0,0,43,0.0,0.0,1.0,43,850,600,250,0.7058823529411765,11,6,5,316.5331265787178,0.7866371354743448,0.19650389503634424,0.20499021418611138,135067.07814114162,-49.35909162648352,135017.71904951514,1900,32,809.3720930232558,43,0,17,31.902026206310186,0.659156976744186,40.127840909090914,1039.4886363636372,24.174154334038075,0
1914,4,0,0,43,0.0,0.0,1.0,43,1000,600,400,0.6,14,6,8,319.52055859093105,0.7851605758582503,0.20075535324308302,0.20720710057707228,135116.3008368487,34.48718362604336,135150.78802047475,1901,33,810.3720930232558,43,0,17,31.77552979931385,0.659641472868217,40.08049242424243,1039.6780303030312,24.17855884425654,0
1915,4,0,0,43,0.0,0.0,1.0,43,850,400,450,0.47058823529411764,13,4,9,322.5163901250256,0.7833148763381321,0.20383136570741311,0.20986493063585812,135239.3968089992,123.38441230487913,135362.7812213041,1902,34,811.3720930232558,43,0,17,31.575473415877642,0.6608527131782945,39.96212121212122,1040.1515151515164,24.189570119802706,0
1916,4,0,0,43,0.0,0.0,1.0,43,900,600,300,0.6666666666666666,12,6,6,321.23143882428315,0.7826227390180879,0.20381281028040332,0.20917174602754907,135264.02272906635,90.2113284837128,135354.23405755006,1903,35,812.3720930232558,43,0,17,31.584452283416784,0.6610949612403101,39.938446969696976,1040.2462121212131,24.191772374911935,0
1917,4,0,0,43,0.0,0.0,1.0,43,1100,700,400,0.6363636363636364,15,7,8,318.58685512339173,0.7811461794019933,0.20597341527574065,0.20801847599233222,135362.548828125,24.945746527778738,135387.49457465278,1904,36,813.3720930232558,43,0,18,31.555513847180514,0.6620639534883721,39.84375,1040.625,24.200581395348838,0
1918,4,0,0,43,0.0,0.0,1.0,43,800,500,300,0.625,11,5,6,318.82389509498614,0.780454042081949,0.2031429520559105,0.20845885966621008,135411.82532892848,34.505118658174354,135446.33044758666,1905,37,814.3720930232558,43,0,19,31.500489036484396,0.6625484496124032,39.796401515151516,1040.8143939393938,24.2049859055673,0
1919,4,0,0,43,0.0,0.0,1.0,43,700,400,300,0.5714285714285714,10,4,6,319.7657377576105,0.7793466223698782,0.2173813733535237,0.20979379787486177,135535.05581381993,67.8934228650026,135602.94923668492,1906,38,815.3720930232558,43,0,19,31.35382563356372,0.6637596899224807,39.6780303030303,1041.287878787878,24.215997181113444,0
1920,4,0,0,43,0.0,0.0,1.0,43,900,800,100,0.8888888888888888,10,8,2,321.71005684441025,0.7771779254337393,0.22066115519452234,0.21180421986978995,135659.51677256534,128.67791060599643,135788.19468317134,1907,39,816.3720930232558,41,2,20,31.179867790369176,0.6679369918699187,39.55853174603174,1041.7658730158719,25.408923732094436,0
1921,4,0,0,43,0.0,0.0,1.0,43,1100,800,300,0.7272727272727273,14,8,6,322.58055167495036,0.7783314876338132,0.2160834270234857,0.2134556950252128,135840.43918493323,163.89676240866243,136004.3359473419,1908,40,817.3720930232558,41,2,20,30.97798502728079,0.6697154471544715,39.38492063492063,1042.4603174603174,25.425861401471156,0
1922,4,0,0,43,0.0,0.0,1.0,43,400,300,100,0.75,5,3,2,324.2958586562494,0.77750092284976,0.22187608551838212,0.21505828204011596,135918.01426878624,215.52982882968138,136133.54409761593,1909,41,818.3720930232558,41,2,17,30.856463863254348,0.6704776422764227,39.31051587301587,1042.7579365079368,25.433120402632607,0
1923,4,0,0,43,0.0,0.0,1.0,43,1600,1100,500,0.6875,21,11,10,325.8611678742545,0.7757475083056478,0.22251208776145903,0.21735787094922537,136124.98941995786,271.5696058516065,136396.55902580946,1910,42,819.3720930232558,41,2,17,30.610779700224995,0.672510162601626,39.11210317460318,1043.551587301588,25.45247773906312,0
1924,4,0,0,43,0.0,0.0,1.0,43,1000,800,200,0.8,12,8,4,323.04073828967574,0.7748246585455888,0.2223754342234363,0.21626467746568362,136254.42885487518,203.1462585033919,136457.57511337858,1911,43,820.3720930232558,41,2,17,30.55634739642721,0.6737804878048781,38.988095238095234,1044.0476190476184,25.464576074332154,0
1925,4,0,0,43,0.0,0.0,1.0,43,1100,900,200,0.8181818181818182,13,9,4,320.13920325939335,0.7739018087855297,0.2170336467095495,0.21495060790273565,136358.0246913581,130.70987654321868,136488.73456790132,1912,44,821.3720930232558,41,2,17,30.52969858156029,0.6747967479674797,38.88888888888889,1044.444444444445,25.47425474254744,0
1926,4,0,0,43,0.0,0.0,1.0,43,850,700,150,0.8235294117647058,10,7,3,321.88880822434123,0.7739479512735327,0.2205990160662079,0.21676041740529176,136461.65989543975,185.0962144117001,136646.75610985144,1913,45,822.3720930232558,41,2,17,30.381614761362194,0.6758130081300813,38.789682539682545,1044.8412698412706,25.483933410762695,0
1927,4,0,0,43,0.0,0.0,1.0,43,1200,900,300,0.75,15,9,6,316.6687065357141,0.7721022517534145,0.2121207439565116,0.21403067099209894,136591.2592612278,50.835478867483175,136642.0947400953,1914,46,823.3720930232558,41,2,17,30.390034323494987,0.6770833333333333,38.66567460317461,1045.3373015873026,25.496031746031772,0
1928,4,0,2,41,0.0,0.046511627906976744,0.9534883720930233,43,850,400,450,0.47058823529411764,13,4,9,320.31627359255157,0.7730251015134736,0.21117278949092255,0.2171390216464086,136695.58620275257,157.164157803045,136852.75036055563,1915,47,824.3720930232558,42,1,18,30.191731529528052,0.6765873015873014,38.56589147286823,1045.7364341085297,24.898486526393565,0
1929,4,0,0,41,0.0,0.0,1.0,41,1250,1000,250,0.8,15,10,5,326.53048997608397,0.7675304878048781,0.1955771788689009,0.2208428106761329,136614.6569192448,721.770172351137,137336.42709159592,1916,48,822.3414634146342,40,1,18,30.10919931304882,0.6789062499999998,38.64329268292684,1045.4268292682948,26.13567073170737,0
1930,4,0,0,41,0.0,0.0,1.0,41,900,700,200,0.7777777777777778,11,7,4,325.4209729147399,0.7676829268292683,0.19651581490059256,0.220425042154033,136667.78336514323,694.9126057571723,137362.69597090041,1917,49,823.3414634146342,40,1,18,30.08573071565103,0.6794270833333333,38.592479674796756,1045.630081300814,26.14075203252035,0
1931,4,0,0,41,0.0,0.0,1.0,41,650,500,150,0.7692307692307693,8,5,3,325.80717973708977,0.7667682926829268,0.1958188153310101,0.22085348349767175,136694.35046103527,707.2001619406641,137401.55062297592,1918,50,824.3414634146342,40,1,18,30.049400712666035,0.6796874999999998,38.56707317073172,1045.7317073170746,26.143292682926862,0
1932,4,0,0,41,0.0,0.0,1.0,41,1200,900,300,0.75,15,9,6,323.20407201432744,0.7646849593495935,0.19545820506748757,0.22075609693286305,136960.1634278539,653.2165047260374,137613.37993257993,1919,51,825.3414634146342,40,1,15,29.855177993527523,0.6822916666666666,38.31300813008131,1046.7479674796757,26.168699186991894,0
1933,4,0,0,41,0.0,0.0,1.0,41,850,500,350,0.5882352941176471,12,5,7,321.6115744689905,0.7646849593495935,0.1799429813116249,0.21174702806217066,135660.8086480034,539.7765270109314,136200.58517501433,1920,52,826.3414634146342,39,2,18,31.181152718061522,0.671207264957265,39.557291666666664,1041.770833333333,26.71207264957264,4
1934,4,0,0,41,0.0,0.0,1.0,41,1050,900,150,0.8571428571428571,12,9,3,319.91106774872856,0.7643292682926829,0.17726128295558952,0.21158956080380228,135823.6341688369,490.2967664930659,136313.93093532996,1921,53,827.3414634146342,39,2,18,31.064192565204355,0.672809829059829,39.40104166666667,1042.3958333333342,26.72809829059831,0
1935,4,0,0,41,0.0,0.0,1.0,41,1150,600,550,0.5217391304347826,17,6,11,321.1116669871163,0.7634654471544715,0.17127003188537793,0.21335707508573304,135986.55734592024,533.3740234375101,136519.93136935774,1922,54,828.3414634146342,39,2,16,30.871637704317735,0.6744123931623931,39.24479166666667,1043.0208333333342,26.744123931623953,0
1936,4,0,0,41,0.0,0.0,1.0,41,1050,600,450,0.5714285714285714,15,6,9,325.14865489374864,0.7615345528455284,0.1759155776643122,0.21670086999804924,136095.22705078125,650.2360026041677,136745.4630533854,1923,55,829.3414634146342,39,2,16,30.658817510232605,0.6754807692307692,39.140625,1043.4375,26.754807692307693,0
1937,4,0,0,41,0.0,0.0,1.0,41,950,700,250,0.7368421052631579,12,7,5,323.7835705833841,0.759959349593496,0.17876442237476287,0.21628742514970056,136176.7578125,618.3593750000007,136795.1171875,1924,56,830.3414634146342,39,2,17,30.613772455089826,0.6762820512820513,39.0625,1043.75,26.762820512820515,0
1938,4,0,0,41,0.0,0.0,1.0,41,1000,800,200,0.8,12,8,4,323.15216641130473,0.7586890243902439,0.1737835298927728,0.2161969967806474,136231.12521701396,604.6766493055654,136835.80186631953,1925,57,831.3414634146342,39,2,17,30.57648174017162,0.6768162393162394,39.01041666666667,1043.958333333334,26.76816239316241,0
1939,4,0,0,41,0.0,0.0,1.0,41,500,400,100,0.8,6,4,2,322.170127687166,0.7583333333333333,0.17425495883051378,0.21587121389947564,136285.5034722224,581.4236111111304,136866.92708333352,1926,58,832.3414634146342,39,2,17,30.548350625166282,0.6773504273504274,38.95833333333334,1044.166666666668,26.77350427350431,0
1940,4,0,0,41,0.0,0.0,1.0,41,850,500,350,0.5882352941176471,12,5,7,322.170127687166,0.7583333333333333,0.17425495883051378,0.21587121389947564,136285.5034722224,581.4236111111304,136866.92708333352,1927,59,833.3414634146342,39,2,17,30.548350625166282,0.6773504273504274,38.95833333333334,1044.166666666668,26.77350427350431,0
1941,4,0,0,41,0.0,0.0,1.0,41,900,500,400,0.5555555555555556,13,5,8,321.4745591245324,0.7572662601626017,0.17394773588669432,0.21573654148477683,136339.89257812517,565.9613715277931,136905.85394965296,1928,60,834.3414634146342,39,2,18,30.512750182857893,0.6778846153846153,38.90625000000001,1044.3750000000014,26.77884615384619,0
1942,4,0,0,41,0.0,0.0,1.0,41,1150,800,350,0.6956521739130435,15,8,7,316.57409831337225,0.755640243902439,0.16578849469084878,0.2132676145185655,136475.91281467036,440.94780815974644,136916.8606228301,1929,61,835.3414634146342,39,2,18,30.50636775994417,0.6792200854700854,38.77604166666668,1044.895833333335,26.792200854700898,0
1943,4,0,0,41,0.0,0.0,1.0,41,850,500,350,0.5882352941176471,12,5,7,312.75054284448413,0.7549288617886178,0.16424773255305247,0.2115070382740733,136612.00086805577,345.0954861111302,136957.0963541669,1930,62,836.3414634146342,39,2,18,30.47196758336655,0.6805555555555555,38.64583333333334,1045.4166666666683,26.8055555555556,0
1944,4,0,0,41,0.0,0.0,1.0,41,1050,800,250,0.7619047619047619,13,8,5,313.7704140087551,0.7552337398373984,0.16841368652777966,0.21252546665451325,136666.45507812515,376.3780381944597,137042.8331163196,1931,63,837.3414634146342,39,2,18,30.39159527130238,0.6810897435897436,38.59375000000001,1045.6250000000011,26.810897435897466,0
1945,4,0,0,41,0.0,0.0,1.0,41,700,500,200,0.7142857142857143,9,5,4,311.9050355845582,0.7552337398373984,0.16348580575737004,0.21175378379341114,136748.15673828128,330.4877387152781,137078.64447699656,1932,64,838.3414634146342,39,2,18,30.359795671081883,0.6818910256410257,38.515625,1045.9375000000002,26.818910256410263,0
1946,4,0,0,41,0.0,0.0,1.0,41,1550,1300,250,0.8387096774193549,18,13,5,312.66481398839716,0.755030487804878,0.16319714152555576,0.21342772085294942,136938.8888888889,363.19444444445026,137302.08333333334,1933,65,839.3414634146342,39,2,20,30.151937367303614,0.6837606837606838,38.333333333333336,1046.6666666666667,26.837606837606838,0
1947,4,0,0,41,0.0,0.0,1.0,41,900,500,400,0.5555555555555556,13,5,8,313.8672901917853,0.7542174796747968,0.16767716468570204,0.21508574426026028,137075.2075195313,404.68478732638914,137479.89230685768,1934,66,840.3414634146342,39,2,15,29.98617742630723,0.6850961538461539,38.203125,1047.1875000000005,26.85096153846155,0
1948,4,0,0,41,0.0,0.0,1.0,41,750,600,150,0.8,9,6,3,315.1231385862082,0.7540142276422764,0.16411510177154254,0.2164534345370841,137157.03125000003,444.2708333333335,137601.30208333337,1935,67,841.3414634146342,39,2,16,29.872712808273654,0.6858974358974359,38.125,1047.5000000000002,26.858974358974365,0
1949,4,0,0,41,0.0,0.0,1.0,41,750,500,250,0.6666666666666666,10,5,5,318.202039323,0.7533028455284553,0.1615250509797077,0.21908243077002432,137238.87939453108,533.9382595485962,137772.81765407967,1936,68,842.3414634146342,39,2,16,29.71147314179674,0.6866987179487181,38.04687499999999,1047.8124999999986,26.866987179487143,0
1950,4,0,0,41,0.0,0.0,1.0,41,800,600,200,0.75,10,6,4,321.0550815455599,0.7522357723577235,0.16393657227497593,0.22139377487524847,137293.45838758667,615.7524956597024,137909.21088324636,1937,69,843.3414634146342,39,2,16,29.582981313984675,0.6872329059829061,37.99479166666666,1048.0208333333321,26.872329059829028,0
1951,4,0,1,40,0.0,0.024390243902439025,0.975609756097561,41,800,600,200,0.75,10,6,4,321.1623668932191,0.7517784552845529,0.16251114816394607,0.22199025140201611,137375.34722222213,623.9583333333285,137999.30555555545,1938,70,844.3414634146342,39,2,17,29.4995363010069,0.688034188034188,37.916666666666664,1048.3333333333328,26.880341880341867,0
1952,4,0,0,40,0.0,0.0,1.0,40,800,500,300,0.625,11,5,6,326.85987898512093,0.7474893162393162,0.1774006116207949,0.22549194183150742,137308.15458579877,976.1053583168873,138284.25994411565,1939,71,863.9,38,2,17,29.4164118246687,0.6891447368421053,37.980769230769226,1048.0769230769226,27.580971659919015,0
1953,4,0,0,40,0.0,0.0,1.0,40,900,600,300,0.6666666666666666,12,6,6,328.29734682641094,0.7471688034188034,0.17589686098654767,0.22684884275075645,137364.14730805738,1019.2570220614908,138383.40433011888,1940,72,864.9,38,2,17,29.323574874303578,0.6896929824561404,37.92735042735042,1048.2905982905968,27.58659469185781,0
1954,4,0,0,40,0.0,0.0,1.0,40,750,500,250,0.6666666666666666,10,5,5,327.1736715793317,0.7466346153846154,0.1743937232524968,0.22643740570377707,137420.15144459042,992.0510994228819,138412.2025440133,1941,73,865.9,38,2,18,29.29785680320631,0.6902412280701755,37.87393162393162,1048.5042735042725,27.592217723796647,0
1955,4,0,0,40,0.0,0.0,1.0,40,800,600,200,0.75,10,6,4,332.7570401649241,0.743482905982906,0.1742566191446031,0.2314216809079001,137588.2323398347,1156.690590985439,138744.92293082015,1942,74,866.9,38,2,18,28.98591310251188,0.6918859649122808,37.7136752136752,1049.1452991452975,27.609086819613093,0
1956,4,0,0,40,0.0,0.0,1.0,40,600,300,300,0.5,9,3,6,321.1116669871163,0.7426014957264957,0.13084240487366405,0.2133570750857329,135986.55734592013,733.3740234374962,136719.93136935763,1943,75,867.9,39,1,16,30.87163770431772,0.6744123931623932,39.244791666666664,1043.0208333333333,26.74412393162393,7
1957,4,0,0,40,0.0,0.0,1.0,40,1200,1000,200,0.8333333333333334,14,10,4,320.7399303933564,0.7413194444444444,0.12674668130551958,0.21409016406469286,136149.57817925359,733.7212456597333,136883.2994249133,1944,76,868.9,39,1,17,30.720069368200402,0.6760149572649572,39.08854166666667,1043.6458333333342,26.760149572649595,0
1958,4,0,0,40,0.0,0.0,1.0,40,1100,800,300,0.7272727272727273,14,8,6,321.559183247265,0.7407051282051282,0.12909099980043903,0.21513125063445224,136231.1252170141,761.2738715278037,136992.39908854192,1945,77,869.9,39,1,19,30.6180569413956,0.6768162393162392,39.01041666666668,1043.958333333335,26.768162393162438,0
1959,4,0,0,40,0.0,0.0,1.0,40,650,300,350,0.46153846153846156,10,3,7,320.07512391092075,0.7394497863247863,0.13043640897755626,0.21463231553223985,136312.69666883702,726.06065538197,137038.75732421898,1946,78,870.9,39,1,19,30.57616375727349,0.6776175213675213,38.93229166666668,1044.270833333335,26.77617521367526,0
1960,4,0,0,40,0.0,0.0,1.0,40,850,500,350,0.5882352941176471,12,5,7,320.110471692424,0.7373931623931624,0.13058436378141192,0.2151519979980989,136394.2925347226,732.2482638889296,137126.54079861153,1947,79,871.9,39,1,19,30.49461507778221,0.6784188034188032,38.854166666666686,1044.5833333333362,26.78418803418811,0
1961,4,0,0,40,0.0,0.0,1.0,40,1050,800,250,0.7619047619047619,13,8,5,319.90027447447915,0.7360309829059829,0.1258472042260539,0.21584125445880653,136530.33989800367,735.2186414930757,137265.55853949673,1948,80,872.9,39,1,19,30.36573058905611,0.6797542735042734,38.72395833333334,1045.1041666666683,26.79754273504278,0
1962,4,0,0,40,0.0,0.0,1.0,40,550,500,50,0.9090909090909091,6,5,1,318.42462690995046,0.7361912393162393,0.12654459392127504,0.21517785394217903,136584.77783203154,698.3913845486416,137283.1692165802,1949,81,873.9,39,1,19,30.350543929579803,0.6802884615384615,38.671875000000014,1045.3125000000023,26.802884615384674,0
1963,4,0,0,40,0.0,0.0,1.0,40,1350,900,450,0.6666666666666666,18,9,9,316.6492198505317,0.7355502136752137,0.1283369857555534,0.21464156097768347,136693.6862521703,656.7898220486317,137350.47607421892,1950,82,874.9,39,1,20,30.289475213334665,0.6813568376068375,38.56770833333334,1045.729166666668,26.813568376068414,0
1964,4,0,0,40,0.0,0.0,1.0,40,700,400,300,0.5714285714285714,10,4,6,324.5054843144483,0.7331997863247863,0.10145310097385973,0.2143230195996913,135772.82769239886,816.3654457530744,136589.19313815192,1951,83,875.9,38,2,20,30.99478899709551,0.6740679824561404,39.44978632478632,1042.2008547008536,27.42633828160141,2
1965,4,0,0,40,0.0,0.0,1.0,40,1200,900,300,0.75,15,9,6,323.14299157751753,0.7332264957264957,0.10218327183271891,0.213589635896359,135800.66568047326,776.6066732412827,136577.27235371454,1952,84,876.9,38,2,20,31.002716277162783,0.6743421052631579,39.42307692307692,1042.3076923076915,27.42914979757083,0
1966,4,0,0,40,0.0,0.0,1.0,40,900,600,300,0.6666666666666666,12,6,6,322.73127014115465,0.7328792735042735,0.09931587578149048,0.21348400018760968,135828.5065221162,767.2212862517239,136595.72780836793,1953,85,877.9,38,2,20,30.985873390044752,0.6746162280701755,39.396367521367516,1042.414529914529,27.43196131354024,0
1967,4,0,0,40,0.0,0.0,1.0,40,800,700,100,0.875,9,7,2,323.26973551081926,0.7327457264957264,0.09984627997540496,0.2140071966834852,135856.35021732765,783.6492804441372,136639.9994977718,1954,86,878.9,38,2,20,30.944267951082878,0.6748903508771931,39.36965811965811,1042.5213675213663,27.43477282950964,0
1968,4,0,0,40,0.0,0.0,1.0,40,900,600,300,0.6666666666666666,12,6,6,323.87555035379404,0.7321848290598291,0.10563210736604889,0.21491157355563426,135939.89842437344,805.5218834465499,136745.42030782,1955,87,879.9,38,2,14,30.845755216337125,0.6757127192982457,39.28952991452991,1042.8418803418792,27.443207377417874,0
1969,4,0,0,40,0.0,0.0,1.0,40,650,500,150,0.7692307692307693,8,5,3,323.5827880639687,0.730582264957265,0.10062199242346637,0.21572922123008767,136107.07188481637,808.3811591423816,136915.45304395875,1956,88,880.9,38,2,15,30.687945803897478,0.6773574561403508,39.129273504273506,1043.4829059829067,27.460076473234388,0
1970,4,0,0,40,0.0,0.0,1.0,40,800,600,200,0.75,10,6,4,323.9608225627509,0.7300213675213675,0.10201125895598806,0.21649091904501225,136190.69713821332,824.0900540580227,137014.78719227135,1957,89,881.9,38,2,16,30.595359945411122,0.6781798245614035,39.04914529914531,1043.80341880342,27.468511021142632,0
1971,4,0,0,40,0.0,0.0,1.0,40,1050,700,350,0.6666666666666666,14,7,7,347.8635508850194,0.7300213675213675,0.07708719851576995,0.2205864163847357,134301.497781065,1353.318586091017,135654.81636715602,1958,90,882.9,38,2,20,31.851035868893014,0.6595394736842106,40.86538461538461,1036.538461538461,27.277327935222658,5
1972,4,0,1,39,0.0,0.025,0.975,40,1350,1000,350,0.7407407407407407,17,10,7,347.6268062690412,0.7290865384615385,0.08088629107014067,0.22160923585463715,134495.3649485902,1350.8388350135226,135846.20378360373,1959,91,883.9,38,2,20,31.66370549661826,0.6614583333333333,40.67841880341881,1037.2863247863256,27.29700854700857,0
1973,4,0,0,39,0.0,0.0,1.0,39,1250,800,450,0.64,17,8,9,351.7685198625826,0.7249212775528565,0.08299866131191425,0.22459067037380295,134550.78125000015,1666.1458333333471,136216.9270833335,1960,92,904.6666666666666,37,2,21,31.501004016064254,0.6638513513513513,40.62500000000001,1037.5000000000011,28.040540540540572,0
1974,4,0,0,39,0.0,0.0,1.0,39,800,500,300,0.625,11,5,6,350.1600548069579,0.7259334233018444,0.08530127857311753,0.22392261658890494,134609.20538359325,1626.9533469280273,136236.15873052127,1961,93,905.6666666666666,36,3,21,31.484445650207988,0.6663773148148147,40.5686936936937,1037.7252252252267,28.825700700700743,0
1975,4,0,0,39,0.0,0.0,1.0,39,900,500,400,0.5555555555555556,13,5,8,353.16066591909055,0.7253148897885741,0.08988545265394898,0.22638630169973434,134696.86536198377,1713.9269336904658,136410.79229567424,1962,94,906.6666666666666,36,3,21,31.319158168800172,0.6672453703703702,40.48423423423424,1038.0630630630644,28.835085085085122,0
1976,4,0,0,39,0.0,0.0,1.0,39,1100,600,500,0.5454545454545454,16,6,10,351.8489976495838,0.7256522717049033,0.0864697778030401,0.22658501391804942,134863.805750327,1690.3389744921442,136554.14472481917,1963,95,907.6666666666666,37,2,13,31.186772053907575,0.6669481981981982,40.3234649122807,1038.7061403508771,28.073138928402084,0
1977,4,0,0,39,0.0,0.0,1.0,39,1150,900,250,0.782608695652174,14,9,5,351.35430431644636,0.7238529014844804,0.08182292892644227,0.22697919168418298,134977.72301333107,1685.0007935133904,136662.72380684444,1964,96,908.6666666666666,37,2,14,31.0861163870423,0.6680743243243243,40.213815789473685,1039.1447368421057,28.084992887624477,0
1978,4,0,0,39,0.0,0.0,1.0,39,600,300,300,0.5,9,3,6,351.45015025967666,0.7231219073324336,0.08127864257849482,0.22721995389912775,135006.2098434133,1689.5905470914015,136695.8003905047,1965,97,909.6666666666666,37,2,15,31.05525075613702,0.6683558558558559,40.186403508771924,1039.2543859649118,28.087956377430046,0
1979,4,0,0,39,0.0,0.0,1.0,39,1050,700,350,0.6666666666666666,14,7,7,349.43634764519015,0.7239091318038686,0.08396279738965107,0.2264529058116232,135091.68836805553,1641.1892361111063,136732.87760416663,1966,98,910.6666666666666,37,2,16,31.022461589846348,0.6692004504504505,40.104166666666664,1039.5833333333333,28.096846846846844,0
1980,4,0,0,39,0.0,0.0,1.0,39,1400,1100,300,0.7857142857142857,17,11,6,348.0029447362839,0.7230656770130455,0.09023997809044526,0.22665583096302305,135272.23186728387,1615.0270061728281,136887.2588734567,1967,99,911.6666666666666,38,1,17,30.880062305295937,0.6691337719298246,39.93055555555555,1040.2777777777771,27.37573099415203,0
1981,4,0,0,39,0.0,0.0,1.0,39,1000,700,300,0.7,13,7,6,349.83481226862267,0.719804318488529,0.09329416904863463,0.22873092222288055,135411.19352217103,1674.309892979761,137085.5034151508,1968,100,912.6666666666666,38,1,17,30.694202080339434,0.6705043859649124,39.797008547008545,1040.8119658119654,27.389788573999088,0
1982,4,1,1,39,0.025,0.025,0.975,40,900,600,300,0.6666666666666666,12,6,6,345.23368939195973,0.7265491452991453,0.08736796226028098,0.227304098937272,135661.504275787,1367.166954306363,137028.67123009337,1969,0,890.825,38,2,17,30.565241171845617,0.6729714912280702,39.556623931623925,1041.7735042735032,27.41509221772377,0
1983,4,0,0,39,0.0,0.0,1.0,39,1150,800,350,0.6956521739130435,15,8,7,334.41107781384335,0.7196918578497526,-0.0015168316289513317,0.19833817249693728,131806.2183195789,1015.4919061634115,132821.7102257423,1970,102,914.6666666666666,37,2,18,34.699123509521264,0.6365427927927929,43.283991228070164,1026.8640350877176,27.753082029397774,8
1984,4,1,0,40,0.025,0.0,1.0,40,700,600,100,0.8571428571428571,8,6,2,327.5235251387747,0.728525641025641,0.0034222014343625595,0.1955992449013128,132068.3478180472,651.0981673241131,132719.4459853713,1971,0,892.775,38,2,19,34.61243633717908,0.6373355263157896,43.028846153846146,1027.884615384614,27.049595141700372,0
1985,4,0,0,40,0.0,0.0,1.0,40,1050,700,350,0.6666666666666666,14,7,7,327.538750429582,0.7291933760683761,-0.0009505505921463264,0.19631930333967332,132205.65440317037,660.4949685879094,132866.14937175828,1972,1,893.775,38,2,19,34.47412390054713,0.6387061403508772,42.89529914529914,1028.4188034188028,27.06365272154744,0
1986,4,0,0,40,0.0,0.0,1.0,40,1050,800,250,0.7619047619047619,13,8,5,329.6260711755515,0.727056623931624,0.004221183800623196,0.19814600907743823,132315.55103550287,722.9310486521917,133038.48208415505,1973,2,894.775,38,2,19,34.31009865005191,0.6398026315789473,42.78846153846153,1028.8461538461531,27.07489878542508,0
1987,4,1,0,41,0.024390243902439025,0.0,1.0,41,650,400,250,0.6153846153846154,9,4,5,323.1625069592667,0.733790650406504,0.0024178069011113745,0.1955192499265185,132558.859592014,367.6106770833388,132926.47026909734,1974,0,873.9268292682926,39,2,20,34.23233191718929,0.6404914529914529,42.552083333333336,1029.7916666666674,26.40491452991455,0
1988,4,0,0,41,0.0,0.0,1.0,41,650,400,250,0.6153846153846154,9,4,5,322.49429169622823,0.7338414634146342,0.0011101051639630377,0.19525419853034945,132585.67843967007,351.62489149305145,132937.30333116313,1975,1,874.9268292682926,39,2,20,34.222653484373424,0.6407585470085471,42.526041666666664,1029.8958333333328,26.407585470085458,0
1989,4,0,1,40,0.0,0.024390243902439025,0.975609756097561,41,1050,700,350,0.6666666666666666,14,7,7,324.19985934815384,0.7322662601626017,0.0019476693301252457,0.19713025252189825,132746.64849175338,407.2889539930513,133153.93744574644,1976,2,875.9268292682926,39,2,16,34.017423936116444,0.6423611111111112,42.369791666666664,1030.5208333333328,26.423611111111097,0
1990,4,0,0,40,0.0,0.0,1.0,40,700,600,100,0.8571428571428571,8,6,2,328.5830842869429,0.7259348290598291,0.004364173840888164,0.19911184887557587,132618.00219382337,715.2064385637952,133333.20863238716,1977,6,898.775,38,2,20,34.033468174117495,0.6428179824561404,42.49465811965811,1030.0213675213663,27.105825461088585,0
1991,4,0,0,40,0.0,0.0,1.0,40,1500,1100,400,0.7333333333333333,19,11,8,335.3526294536216,0.7257745726495727,0.04619846812345152,0.19981615062343994,131981.4238790296,860.2903455278467,132841.71422455745,1978,7,899.775,35,5,16,34.498667117218595,0.6422619047619047,43.11342592592593,1027.5462962962972,29.358465608465636,2
1992,4,0,0,40,0.0,0.0,1.0,40,1000,600,400,0.6,14,6,8,343.7934239166227,0.7250534188034188,0.018552750225428127,0.20388604659012535,131803.09070644714,1062.6071673525262,132865.69787379965,1979,8,900.775,35,5,18,34.461414186955196,0.6404761904761905,43.28703703703703,1026.8518518518513,29.33862433862432,1
1993,4,0,0,40,0.0,0.0,1.0,40,900,600,300,0.6666666666666666,12,6,6,345.93654108686735,0.7249465811965812,0.013577222034471426,0.20596101108169795,131951.69331114946,1129.3824749228181,133081.07578607227,1980,9,901.775,35,5,20,34.25671679621496,0.6419642857142858,43.1423611111111,1027.4305555555536,29.355158730158674,0
1994,4,0,0,40,0.0,0.0,1.0,40,1250,1000,250,0.8,15,10,5,344.9809115791819,0.724732905982906,0.011262808242315181,0.20603735546299354,132070.63567654742,1112.369657707469,133183.00533425488,1981,10,902.775,35,5,20,34.16152929474909,0.643154761904762,43.02662037037037,1027.893518518518,29.36838624338623,0
1995,4,0,0,40,0.0,0.0,1.0,40,900,700,200,0.7777777777777778,11,7,4,346.5035789961711,0.7230769230769231,0.012799662352279029,0.20759840184632353,132189.63162562152,1160.8360928926545,133350.46771851418,1982,11,903.775,35,5,20,34.002649596698554,0.6443452380952381,42.910879629629626,1028.356481481481,29.381613756613746,0
1996,4,0,0,40,0.0,0.0,1.0,40,1100,800,300,0.7272727272727273,14,8,6,345.29676729459754,0.7246527777777778,0.004470452801228042,0.20517601397355212,131876.97991488117,1113.6953326340044,132990.67524751517,1983,12,904.775,36,4,19,34.34839016189746,0.6391782407407407,43.215090090090094,1027.13963963964,28.53165665665667,5
1997,4,0,0,40,0.0,0.0,1.0,40,1250,900,350,0.72,16,9,7,341.24677187922225,0.7230769230769231,-0.0018032437046520133,0.20344559453257413,132003.33275623253,1009.1422360726135,133012.47499230513,1984,13,905.775,37,3,20,34.32520628823445,0.6385135135135136,43.09210526315788,1027.631578947367,27.773826458036943,0
1998,4,1,0,41,0.024390243902439025,0.0,1.0,41,450,400,50,0.8888888888888888,5,4,1,334.104699211987,0.7334349593495935,0.003182437808171956,0.20025478422257678,132205.65440317022,634.1060796990052,132839.76048286923,1985,0,884.6585365853658,38,3,21,34.305310270794365,0.6387061403508772,42.895299145299134,1028.4188034188019,27.063652721547417,0
1999,4,0,0,41,0.0,0.0,1.0,41,550,400,150,0.7272727272727273,7,4,3,334.4743345613448,0.734400406504065,0.004788362000167412,0.20062208216959895,132233.12428090058,645.7172501643529,132878.84153106494,1986,1,885.6585365853658,38,3,21,34.268204009556456,0.6389802631578948,42.86858974358974,1028.5256410256397,27.066464237516836,0
2000,4,0,0,41,0.0,0.0,1.0,41,950,700,250,0.7368421052631579,12,7,5,331.6015849340725,0.7346544715447154,0.0025172777945201563,0.19947875480949717,132343.03232750736,577.0318549565188,132920.0641824639,1987,2,886.6585365853658,38,3,22,34.231691067040444,0.640076754385965,42.76175213675213,1028.9529914529905,27.07771030139449,0
2001,4,0,0,41,0.0,0.0,1.0,41,950,700,250,0.7368421052631579,12,7,5,331.46918388256057,0.7346544715447154,0.08660964097841295,0.18210251781958467,128830.99500868036,340.700954861092,129171.69596354145,1988,3,887.6585365853658,39,2,19,37.7851597236473,0.6030982905982907,46.19791666666666,1015.2083333333318,26.030982905982867,7
2002,4,2,1,42,0.046511627906976744,0.023255813953488372,0.9767441860465116,43,950,600,350,0.631578947368421,13,6,7,319.0318898877578,0.757890365448505,0.08022428294155715,0.1771677692706024,129257.13320444721,-350.44376635122023,128906.68943809599,1989,0,847.3255813953489,37,6,20,37.66803249227229,0.6109234234234235,45.77850877192981,1016.8859649122782,27.4834044570886,0
2003,4,1,0,43,0.023255813953488372,0.0,1.0,43,1250,900,350,0.72,16,9,7,309.05499328596073,0.7590439276485788,0.05694540557291372,0.16883841751435014,128607.98306439629,-646.7167021395238,127961.26636225676,1990,0,848.3023255813954,40,3,17,38.58059479678054,0.5992187499999999,46.41768292682927,1014.3292682926838,25.358231707317096,2
2004,4,2,1,44,0.044444444444444446,0.022222222222222223,0.9777777777777777,45,650,400,250,0.6153846153846154,9,4,5,299.2844994443251,0.7784090909090909,0.07172253808473394,0.16526111140186167,129032.96212300597,-1276.4869038395009,127756.47521916647,1991,0,811.5555555555555,43,2,19,38.397198403081994,0.599079457364341,45.999053030303045,1016.0037878787907,23.62799506694862,0
2005,4,2,0,46,0.043478260869565216,0.0,1.0,46,1100,900,200,0.8181818181818182,13,9,4,295.07250882859023,0.7864533011272142,0.08665977073865583,0.16447085057315347,129403.18720080634,-1563.005824232899,127840.18137657344,1992,0,794.8695652173913,41,5,22,38.12930642225691,0.6056910569105691,45.63492063492064,1017.4603174603182,24.8161053039102,0
2006,4,0,1,45,0.0,0.021739130434782608,0.9782608695652174,46,750,600,150,0.8,9,6,3,295.27334941773825,0.7871779388083736,0.0907245246552002,0.164794016231075,129453.66138353494,-1555.156761778781,127898.50462175616,1993,1,795.8695652173913,41,5,14,38.0731299148632,0.6061991869918699,45.58531746031746,1017.6587301587306,24.82094463801782,0
2007,4,0,1,44,0.0,0.022222222222222223,0.9777777777777777,45,1250,900,350,0.72,16,9,7,298.4355508674969,0.7787457912457912,0.07872243859704642,0.1691777621961303,130064.82600392099,-1236.806400606943,128828.01960331404,1994,2,814.5333333333333,42,3,17,37.37492479655488,0.6108630952380952,44.985465116279066,1020.0581395348834,24.287098560354366,1
2008,4,0,0,44,0.0,0.0,1.0,44,950,600,350,0.631578947368421,13,6,7,302.33311632273023,0.7697542283298098,0.0868942341704988,0.17114451738973913,130009.52695893154,-938.7629125724552,129070.7640463591,1995,3,833.9545454545455,41,3,17,37.3313878080415,0.6117886178861789,45.03968253968253,1019.8412698412684,24.874177313201667,0
2009,4,1,0,45,0.022222222222222223,0.0,1.0,45,1200,700,500,0.5833333333333334,17,7,10,297.99750836246864,0.7789141414141415,0.09922411975542933,0.170330463022799,130386.26359593752,-1229.0436647437268,129157.21993119379,1996,0,816.4,42,3,18,37.061788425047446,0.6140873015873016,44.670542635658904,1021.3178294573626,24.31709117755625,0
2010,4,1,0,46,0.021739130434782608,0.0,1.0,46,1150,500,650,0.43478260869565216,18,5,13,292.0707843758736,0.7855072463768116,0.10667434388010633,0.1682913729824269,130697.96419450172,-1565.3886162764134,129132.57557822531,1997,0,799.6304347826087,43,3,15,36.89919429523986,0.615794573643411,44.3655303030303,1022.537878787878,23.779950669485533,0
2011,4,2,0,48,0.041666666666666664,0.0,1.0,48,950,700,250,0.7368421052631579,12,7,5,290.4150495611099,0.7924239066193853,0.14004251024076853,0.16958619646802836,131212.09538601377,-1978.8065630907604,129233.288822923,1998,0,767.2708333333334,45,3,18,36.424627206554085,0.6182870370370372,43.86322463768115,1024.5471014492737,22.767713365539414,0
2012,4,0,3,45,0.0,0.0625,0.9375,48,1400,1000,400,0.7142857142857143,18,10,8,290.289167202243,0.7931257387706856,0.08960660974354329,0.16380284170832884,129884.77473422512,-2053.785007056418,127830.98972716871,1999,1,768.2708333333334,44,4,13,37.76436703303358,0.6062973484848484,45.162037037037045,1019.3518518518531,23.16708754208757,5
2013,4,0,0,45,0.0,0.0,1.0,45,700,500,200,0.7142857142857143,9,5,4,299.2422798397961,0.7853114478114479,0.10061393776087102,0.16835380270280662,129768.4664852623,-1233.5576475271905,128534.9088377351,2000,2,807.0888888888888,42,3,13,37.65374861309242,0.6078869047619047,45.276162790697676,1018.8953488372092,24.2594130675526,0
2014,4,0,0,45,0.0,0.0,1.0,45,1250,500,750,0.4,20,5,15,300.97021398237234,0.7823232323232323,0.10418805043401114,0.17007564938359426,129941.30179226017,-1178.307718887078,128762.99407337309,2001,3,808.0888888888888,42,3,14,37.43505670658303,0.6096230158730158,45.106589147286826,1019.5736434108535,24.275562938353655,0
2015,4,0,1,44,0.0,0.022222222222222223,0.9777777777777777,45,900,800,100,0.8888888888888888,10,8,2,300.874763739767,0.7824074074074074,0.0971063605172875,0.17034464165470933,130015.40927716176,-1176.3288902409722,128839.08038692079,2002,4,809.0888888888888,42,3,15,37.3626286619161,0.6103670634920635,45.03391472868217,1019.8643410852708,24.282484311554065,0
2016,4,1,1,44,0.022222222222222223,0.022222222222222223,0.9777777777777777,45,850,700,150,0.8235294117647058,10,7,3,305.60465461120697,0.7820286195286196,0.10842115256811913,0.17390242177308698,130213.13252095715,-1041.2521220179212,129171.88039893923,2003,0,809.8222222222222,42,3,16,37.0423114655527,0.6123511904761905,44.84011627906976,1020.63953488372,24.300941306755238,0
2017,4,0,0,44,0.0,0.0,1.0,44,1050,700,350,0.6666666666666666,14,7,7,315.3265942668874,0.7731016560958421,0.11646456790341686,0.17919609660934824,130161.33334120682,-591.3340104560409,129569.99933075078,2004,1,829.0909090909091,41,3,16,36.84660379804263,0.6133130081300813,44.89087301587301,1020.4365079365076,24.888695315524576,0
2018,4,3,2,45,0.06382978723404255,0.0425531914893617,0.9574468085106383,47,1200,800,400,0.6666666666666666,16,8,8,296.93552812071334,0.7967545482577859,0.11818754925137931,0.17130895853118094,130746.38429752082,-1635.3112981494808,129111.07299937135,2005,0,777.1063829787234,43,4,15,36.72608024691358,0.6162790697674418,44.31818181818183,1022.727272727274,23.784355179704047,0
2019,4,1,0,46,0.021739130434782608,0.0,1.0,46,1050,900,150,0.8571428571428571,12,9,3,311.74828731275574,0.7901972624798712,0.14940685259226583,0.18036987209508992,130856.77059859694,-1041.1251765218394,129815.6454220751,2006,0,794.9782608695652,42,4,16,36.23607033494331,0.6187996031746031,44.21027131782946,1023.1589147286829,24.360926541159117,0
2020,4,0,0,46,0.0,0.0,1.0,46,1650,1200,450,0.7272727272727273,21,12,9,312.70589811029413,0.7894726247987118,0.1545566781209491,0.18162384901238374,131005.52780970206,-1006.7597537707929,129998.76805593127,2007,1,795.9782608695652,42,4,17,36.061681653257615,0.6202876984126984,44.06492248062016,1023.7403100775203,24.374769287560007,0
2021,4,1,0,47,0.02127659574468085,0.0,1.0,47,1300,1100,200,0.8461538461538461,15,11,4,304.7953227617133,0.7925146469318531,0.15623544028575886,0.1784099393320726,131303.86002245464,-1395.8395209194214,129908.02050153521,2008,0,780.0212765957447,43,4,18,35.964015676491414,0.6218507751937985,43.77367424242424,1024.905303030303,23.835007047216347,0
2022,4,0,0,47,0.0,0.0,1.0,47,1500,1200,300,0.8,18,12,6,307.2386385878897,0.7905103299414122,0.16326942191619032,0.18079341402163865,131506.13667052472,-1319.2422369209694,130186.89443360375,2009,1,781.0212765957447,41,6,19,35.69806477093209,0.6267784552845528,43.57638888888889,1025.6944444444448,25.016937669376702,0
2023,4,0,0,47,0.0,0.0,1.0,47,1350,1100,250,0.8148148148148148,16,11,5,310.0546389863699,0.7897008942337341,0.16681789283311454,0.18269373343350725,131557.01929209183,-1242.0271754535129,130314.99211663833,2010,2,782.0212765957447,41,6,13,35.57471472778262,0.6272865853658536,43.526785714285715,1025.892857142857,25.02177700348432,0
2024,4,0,0,47,0.0,0.0,1.0,47,1350,900,450,0.6666666666666666,18,9,9,307.4499493393342,0.7881591119333949,0.15867389319757508,0.18200755582170658,131735.18597253718,-1299.6047493071346,130435.58122323004,2011,3,783.0212765957447,41,6,15,35.46256925653907,0.6290650406504066,43.3531746031746,1026.5873015873017,25.038714672861015,0
2025,4,0,1,46,0.0,0.02127659574468085,0.9787234042553191,47,1200,800,400,0.6666666666666666,16,8,8,309.11462297725984,0.787118408880666,0.16339389754434452,0.18360663750336026,131862.52170138882,-1247.8732638888941,130614.64843749993,2012,4,784.0212765957447,41,6,15,35.29200473292765,0.6303353658536586,43.229166666666664,1027.0833333333328,25.050813008130067,0
2026,4,0,0,46,0.0,0.0,1.0,46,1350,1100,250,0.8148148148148148,16,11,5,322.53375084282925,0.7799718196457327,0.17076627907476905,0.19164306994523678,131875.5693225759,-693.1355963712039,131182.4337262047,2013,7,801.9782608695652,40,6,16,34.93432769367764,0.63203125,43.21646341463415,1027.134146341464,25.6783536585366,0
2027,4,0,0,46,0.0,0.0,1.0,46,1250,800,450,0.64,17,8,9,323.5982590830215,0.7779589371980676,0.18044574568248373,0.19307074891484335,132032.19112507434,-654.9225618018405,131377.2685632725,2014,8,802.9782608695652,40,6,16,34.74962094993243,0.63359375,43.0640243902439,1027.7439024390242,25.693597560975604,0
2028,4,1,0,47,0.02127659574468085,0.0,1.0,47,1500,1100,400,0.7333333333333333,19,11,8,315.61670179366035,0.7837650323774282,0.18624584047595039,0.19027178308132106,132424.15229030346,-1040.4390987507352,131383.71319155273,2015,0,786.8723404255319,40,7,18,34.561570234333864,0.6375,42.6829268292683,1029.2682926829275,25.731707317073187,0
2029,4,0,0,47,0.0,0.0,1.0,47,1400,1000,400,0.7142857142857143,18,10,8,318.5340191577198,0.7837264878199198,0.1729931942697902,0.18848928690756467,131719.04047070205,-1008.6009278537795,130710.43954284827,2016,1,787.8723404255319,40,7,13,35.194328944328944,0.6304687499999999,43.368902439024396,1026.524390243903,25.663109756097576,2
2030,4,0,1,46,0.0,0.02127659574468085,0.9787234042553191,47,1200,1000,200,0.8333333333333334,14,10,4,316.4556937227339,0.7831868640148011,0.17009484341571035,0.18764485501024092,131797.29327781094,-1058.3992249983417,130738.8940528126,2017,2,788.8723404255319,40,7,13,35.16903371602005,0.6312499999999999,43.29268292682927,1026.8292682926838,25.670731707317096,0
2031,4,0,0,46,0.0,0.0,1.0,46,550,400,150,0.7272727272727273,7,4,3,332.7829898542562,0.7752012882447665,0.2021351919460117,0.19289633482702456,130928.03955078124,-485.87510850694383,130442.1644422743,2018,3,806.7608695652174,39,7,15,35.62606022052587,0.624198717948718,44.140625,1023.4374999999999,26.241987179487175,1
2032,4,1,1,46,0.02127659574468085,0.02127659574468085,0.9787234042553191,47,1350,1200,150,0.8888888888888888,15,12,3,325.57155072682457,0.7848828245451742,0.20139429606156645,0.19032167766369093,131253.64428407242,-853.5094983775051,130400.13478569491,2019,0,790.5744680851063,42,5,18,35.48226950354608,0.6227678571428572,43.82267441860465,1024.7093023255811,24.397840531561457,0
2033,4,0,0,46,0.0,0.0,1.0,46,1500,1200,300,0.8,18,12,6,334.1453243356456,0.7768921095008052,0.20592196641272742,0.19545420160743043,131277.28666698167,-426.8616937515679,130850.42497323011,2020,5,808.7608695652174,41,5,19,35.23878670538882,0.6244918699186992,43.79960317460318,1024.801587301588,24.99516066589239,0
2034,4,0,0,46,0.0,0.0,1.0,46,950,600,350,0.631578947368421,13,6,7,337.431423094719,0.7766908212560387,0.21032166843407585,0.19763840495547808,131328.12499999985,-337.12325207862534,130991.00174792123,2021,6,809.7608695652174,38,8,19,35.10331978319784,0.6299342105263158,43.74999999999999,1024.9999999999989,26.973684210526287,0
2035,4,1,1,46,0.02127659574468085,0.02127659574468085,0.9787234042553191,47,1350,900,450,0.6666666666666666,18,9,9,331.5738274403025,0.7877351218008016,0.20264288630663474,0.19543211409093597,131568.46923828122,-675.0678168402791,130893.40142144094,2022,0,793.5106382978723,39,8,13,35.01127441026162,0.6306089743589745,43.515625,1025.9374999999998,26.306089743589737,0
2036,4,0,0,46,0.0,0.0,1.0,46,700,600,100,0.8571428571428571,8,6,2,341.1312927305585,0.7768115942028986,0.21028833047282225,0.20080941394887156,131519.83486969475,-226.8937422382794,131292.94112745646,2023,8,811.7608695652174,38,8,20,34.8151668229004,0.6318530701754386,43.563034188034194,1025.747863247864,26.99336482231221,0
2037,4,0,0,46,0.0,0.0,1.0,46,1500,1200,300,0.8,18,12,6,342.7477431726685,0.7766706924315621,0.20054845599681426,0.20277834460609595,131711.68456424863,-171.22347322667986,131540.46109102195,2024,9,812.7608695652174,38,8,14,34.5803410352484,0.6337719298245614,43.376068376068375,1026.495726495726,27.013045434098057,0
2038,4,1,0,47,0.02127659574468085,0.0,1.0,47,1050,700,350,0.6666666666666666,14,7,7,338.65787147815206,0.7812596361393771,0.21737912005001214,0.20257898130238555,132130.126953125,-450.6184895833324,131679.50846354166,2025,0,796.4468085106383,39,8,17,34.26418439716312,0.6362179487179487,42.96875,1028.125,26.362179487179485,0
2039,4,0,0,47,0.0,0.0,1.0,47,1250,900,350,0.72,16,9,7,336.78183475165696,0.7817221708294788,0.21880804519929886,0.2020281796074032,132237.24500868042,-492.97960069445355,131744.26540798595,2026,1,797.4468085106383,39,8,18,34.20472959287017,0.6372863247863249,42.86458333333333,1028.5416666666656,26.372863247863222,0
2040,4,2,1,48,0.04081632653061224,0.02040816326530612,0.9795918367346939,49,1400,1200,200,0.8571428571428571,16,12,4,325.20550556508675,0.7928004535147393,0.2309946463792616,0.19769687208812825,132738.1395002974,-1166.467590957356,131571.67190934005,2027,0,765.8571428571429,40,9,13,34.00004109138724,0.640625,42.3780487804878,1030.4878048780486,25.762195121951216,0
2041,4,0,0,48,0.0,0.0,1.0,48,1000,800,200,0.8,12,8,4,330.9820802044385,0.7864952718676123,0.22842502696871625,0.20053620153563045,132612.50000000003,-821.5277777777787,131790.97222222225,2028,1,782.8125,39,9,20,33.97721143473569,0.6410256410256411,42.5,1030.0000000000002,26.410256410256416,0
2042,4,1,1,48,0.02040816326530612,0.02040816326530612,0.9795918367346939,49,1000,600,400,0.6,14,6,8,326.50628789804483,0.7884424603174603,0.23214580176048893,0.1996681981757688,132960.14817964207,-1117.5351158982282,131842.61306374383,2029,0,767.8163265306123,41,8,15,33.74414839040655,0.6412601626016261,42.162698412698404,1031.3492063492051,25.154858691444026,0
2043,4,1,0,49,0.02040816326530612,0.0,1.0,49,1350,1100,250,0.8148148148148148,16,11,5,333.8967978859019,0.7901431405895691,0.24379969170062843,0.20559349578702313,133216.0621771855,-903.9166824137255,132312.14549477177,2030,0,768.795918367347,41,8,17,33.2972964315459,0.6438008130081302,41.91468253968253,1032.3412698412683,25.179055361982154,0
2044,4,0,1,48,0.0,0.02040816326530612,0.9795918367346939,49,1550,1000,550,0.6451612903225806,21,10,11,336.1407243007277,0.7895762471655329,0.2442394416712237,0.20797583851119877,133395.34837372435,-832.0781958616881,132563.27017786267,2031,1,769.795918367347,41,8,19,33.05993709785845,0.645579268292683,41.74107142857142,1033.0357142857133,25.19599303135886,0
2045,4,0,0,48,0.0,0.0,1.0,48,1150,900,250,0.782608695652174,14,9,5,338.74836709556314,0.7853871158392435,0.23500984535587355,0.20930025221554344,133344.11144376732,-565.979997323007,132778.1314464443,2032,2,786.1041666666666,41,7,20,33.04387586847244,0.6450711382113821,41.7906746031746,1032.8373015873015,25.191153697251256,0
2046,4,1,0,49,0.02040816326530612,0.0,1.0,49,900,700,200,0.7777777777777778,11,7,4,333.265761516004,0.790249433106576,0.24068096088523294,0.20770633005237593,133665.4901403497,-890.5276805002288,132774.96245984946,2033,0,771.0408163265306,38,11,21,32.86410441850054,0.6532346491228072,41.479700854700845,1034.081196581195,27.212663067926183,0
2047,4,0,0,49,0.0,0.0,1.0,49,1400,1000,400,0.7142857142857143,18,10,8,336.3288276241417,0.7894345238095238,0.24168527032753007,0.20992903805475924,133720.73522764628,-805.1723783694929,132915.5628492768,2034,1,772.0408163265306,38,11,13,32.729702510071284,0.6537828947368421,41.42628205128205,1034.2948717948716,27.218286099865043,0
2048,4,0,0,49,0.0,0.0,1.0,49,900,600,300,0.6666666666666666,12,6,6,332.7516358113951,0.7893282312925171,0.24488152087254567,0.20811645131478448,133795.33420138896,-895.8767361111004,132899.45746527787,2035,2,773.0408163265306,39,10,13,32.74768425291985,0.6527777777777778,41.35416666666667,1034.583333333334,26.527777777777793,0
2049,4,0,0,49,0.0,0.0,1.0,49,1600,1000,600,0.625,22,10,12,331.9476493315715,0.7893282312925171,0.2429339764897298,0.20791727291676143,133849.22417534742,-913.8129340277566,132935.41124131967,2036,3,774.0408163265306,39,10,13,32.71466680088584,0.6533119658119657,41.30208333333334,1034.7916666666683,26.533119658119702,0
2050,4,0,0,49,0.0,0.0,1.0,49,1150,700,450,0.6086956521739131,16,7,9,329.1431300159451,0.7892573696145125,0.20151945850170172,0.19444950227141244,131656.85609796178,-1089.0802848660492,130567.77581309572,2037,4,775.0408163265306,38,11,20,34.984645013533196,0.6332236842105263,43.429487179487175,1026.2820512820506,27.007422402159225,7
2051,4,1,2,48,0.02,0.04,0.96,50,1350,1100,250,0.8148148148148148,16,11,5,321.8515404731933,0.7943367346938776,0.2094253783008604,0.19176434447404,131979.97352972772,-1504.408441569167,130475.56508815856,2038,0,760.52,40,10,20,34.846948867569964,0.6330729166666667,43.114837398373986,1027.5406504065045,25.68851626016261,0
2052,4,2,0,50,0.04,0.0,1.0,50,1050,600,450,0.5714285714285714,15,6,9,326.32167620054327,0.8041666666666667,0.2055848894612584,0.187002790826363,130486.54994806099,-1457.1019521244605,129029.44799593653,2039,0,761.02,37,13,21,36.23721113257495,0.6233108108108107,44.57236842105264,1021.7105263157898,27.61379800853486,6
2053,4,1,0,51,0.0196078431372549,0.0,1.0,51,1400,900,500,0.6428571428571429,19,9,10,320.3349637661934,0.8085620915032681,0.1986331992080217,0.18555251674758802,130901.38888888927,-1813.5416666666276,129087.84722222264,2040,0,747.0784313725491,39,12,18,35.97143051031487,0.6239316239316237,44.166666666666686,1023.3333333333363,26.239316239316317,0
2054,4,0,0,51,0.0,0.0,1.0,51,950,700,250,0.7368421052631579,12,7,5,321.16171992283813,0.8075490196078432,0.19597868651988204,0.18667643673102188,131034.66932508702,-1783.3360460069239,129251.33327908009,2041,1,748.0784313725491,39,12,18,35.81588920541257,0.6252670940170939,44.03645833333334,1023.8541666666683,26.252670940170983,0
2055,4,0,1,50,0.0,0.0196078431372549,0.9803921568627451,51,1600,1100,500,0.6875,21,11,10,323.6030982097287,0.8080392156862746,0.20558962599026342,0.18889651610030575,131197.94894118933,-1708.787448773851,129489.16149241549,2042,2,749.0784313725491,40,11,20,35.58881394041598,0.6252604166666667,43.877032520325216,1024.491869918701,25.612296747967527,0
2056,4,0,0,50,0.0,0.0,1.0,50,1300,900,400,0.6923076923076923,17,9,8,332.2370201689023,0.8051190476190476,0.21351919833316746,0.1936736221100272,131145.8965913975,-1285.6956218190048,129860.2009695785,2043,3,764.88,40,10,21,35.420180573469594,0.6247395833333333,43.92784552845529,1024.2886178861804,25.60721544715451,0
2057,4,1,0,51,0.0196078431372549,0.0,1.0,51,1250,900,350,0.72,16,9,7,324.3008148877318,0.8097058823529413,0.2061999260697931,0.19090203088516935,131519.8348696946,-1669.2225271877294,129850.61234250688,2044,0,750.8627450980392,38,13,22,35.246762490018405,0.6318530701754386,43.56303418803419,1025.7478632478628,26.99336482231218,0
2058,4,0,2,49,0.0,0.0392156862745098,0.9607843137254902,51,1250,800,450,0.64,17,8,9,326.40128514852614,0.8106209150326799,0.18950142402287407,0.18259701287382413,129546.4186722553,-1529.860827760548,128016.55784449475,2045,1,751.8627450980392,42,9,14,37.187083571292604,0.6056547619047619,45.49418604651163,1018.0232558139537,24.23864894795128,8
2059,4,0,0,49,0.0,0.0,1.0,49,1500,700,800,0.4666666666666667,23,7,16,335.5065361632455,0.8000283446712019,0.21082201646499943,0.18724842480753887,129453.66138353459,-1113.490095112144,128340.17128842245,2046,7,783.4285714285714,41,8,15,37.04953857152142,0.6061991869918699,45.58531746031745,1017.6587301587277,24.82094463801775,0
2060,4,0,0,49,0.0,0.0,1.0,49,1250,700,550,0.56,18,7,11,338.4584460132261,0.8002409297052154,0.2078681404348921,0.1893817106318277,129554.63927469113,-1030.2276234568135,128524.41165123432,2047,8,784.4285714285714,41,8,15,36.87187357889951,0.6072154471544717,45.4861111111111,1018.0555555555536,24.830623306233015,0
2061,4,2,1,50,0.0392156862745098,0.0196078431372549,0.9803921568627451,51,900,800,100,0.8888888888888888,10,8,2,330.4274210421971,0.8148039215686276,0.22486863491335463,0.18745100615521795,130093.46954093485,-1602.7100730314576,128490.7594679034,2048,0,754.6274509803922,43,8,17,36.53007905566385,0.6097383720930234,44.95738636363636,1020.170454545454,23.724894291754744,0
2062,4,2,0,52,0.038461538461538464,0.0,1.0,52,1050,800,250,0.7619047619047619,13,8,5,324.8844564884703,0.8229480894922071,0.2275036284470242,0.18574297935098855,130395.54172092024,-1926.7537995365547,128468.78792138369,2049,0,741.0769230769231,39,13,19,36.36590600033995,0.6188568376068376,44.661458333333336,1021.3541666666675,26.1885683760684,0
2063,4,1,3,50,0.018867924528301886,0.05660377358490566,0.9433962264150944,53,1750,1200,550,0.6857142857142857,23,12,11,321.04628504623,0.8244436381228833,0.2240861376447163,0.1850153333410746,130703.86860499684,-2207.601708639053,128496.26689635779,2050,0,728.0754716981132,40,13,14,36.152521036241964,0.6203125,44.35975609756097,1022.5609756097546,25.564024390243866,0
2064,4,1,1,50,0.0196078431372549,0.0196078431372549,0.9803921568627451,51,1600,1200,400,0.75,20,12,8,331.8862863295248,0.8093137254901962,0.22189032643749873,0.19000635201597485,130448.74267578125,-1541.1702473958326,128907.57242838542,2051,0,757.5686274509804,39,12,17,36.13331039053739,0.6193910256410258,44.609375,1021.5625,26.193910256410255,0
2065,4,0,0,50,0.0,0.0,1.0,50,1000,600,400,0.6,14,6,8,339.5898618721661,0.805391156462585,0.23158995815899575,0.19416740906087962,130398.95171305432,-1143.5675998977238,129255.3841131566,2052,4,773.72,38,12,17,35.986968270571815,0.6206140350877192,44.65811965811966,1021.3675213675217,26.87809266756636,0
2066,4,1,1,50,0.0196078431372549,0.0196078431372549,0.9803921568627451,51,1450,1200,250,0.8275862068965517,17,12,5,332.1761812202722,0.8111111111111112,0.2324707099995056,0.1912518281372134,130667.99433893907,-1519.0409265558314,129148.95341238324,2053,0,759.5294117647059,41,10,15,35.904246717122696,0.6183943089430894,44.39484126984126,1022.4206349206332,24.93708865660081,0
2067,4,0,0,50,0.0,0.0,1.0,50,550,500,50,0.9090909090909091,6,5,1,336.7224917510649,0.8051020408163265,0.23539073374428288,0.1935288469732694,130599.9704623572,-1204.8105046599085,129395.1599576973,2054,6,775.72,40,10,15,35.85682209849539,0.6192708333333332,44.461382113821145,1022.1544715447166,25.553861788617915,0
2068,4,0,0,50,0.0,0.0,1.0,50,950,600,350,0.631578947368421,13,6,7,337.8593567255424,0.8037925170068027,0.23571594877764812,0.19477932042096707,130718.714569161,-1167.0918367346947,129551.62273242632,2055,7,776.72,41,9,15,35.70770275514163,0.6189024390243902,44.345238095238095,1022.6190476190477,24.941927990708482,0
2069,4,0,0,50,0.0,0.0,1.0,50,1300,1000,300,0.7692307692307693,16,10,6,337.54564874307215,0.8045748299319727,0.24138688897309613,0.1949196864404742,130782.42368247098,-1170.9923907818059,129611.43129168918,2056,8,777.72,42,8,15,35.65132783882783,0.6180555555555556,44.28294573643411,1022.8682170542634,24.35400516795865,0
2070,4,1,0,51,0.0196078431372549,0.0,1.0,51,1200,800,400,0.6666666666666666,16,8,8,327.70779263357525,0.8118300653594772,0.23604115217383392,0.1907336958847947,131085.57610910252,-1608.4470414370885,129477.12906766543,2057,0,763.4509803921569,43,8,16,35.59698847173417,0.6196705426356589,43.98674242424243,1024.0530303030314,23.815186751233288,0
2071,4,0,0,51,0.0,0.0,1.0,51,1300,900,400,0.6923076923076923,17,9,8,327.67055961528513,0.811045751633987,0.2322423546425083,0.19121028858562852,131185.80246913584,-1602.854938271597,129582.94753086424,2058,1,764.4509803921569,44,7,16,35.49688177874189,0.6193181818181819,43.88888888888889,1024.4444444444448,23.28282828282829,0
2072,4,0,0,51,0.0,0.0,1.0,51,1450,900,550,0.6206896551724138,20,9,11,323.8845661996311,0.8104901960784314,0.2262240822091095,0.18958892222187415,131304.9149748609,-1694.4729146975376,129610.44206016336,2059,2,765.4509803921569,45,6,16,35.47383635292384,0.6192129629629629,43.772644927536234,1024.9094202898557,22.775764895330127,0
2073,4,0,0,51,0.0,0.0,1.0,51,1850,1500,350,0.8108108108108109,22,15,7,320.3304677905549,0.8107843137254903,0.2176840547539769,0.18799633075612626,131404.4009530895,-1781.4251499079546,129622.97580318154,2060,3,766.4509803921569,41,10,16,35.46474358974359,0.6257621951219512,43.675595238095234,1025.2976190476186,25.00725900116143,0
2074,4,0,1,50,0.0,0.0196078431372549,0.9803921568627451,51,1300,900,400,0.6923076923076923,17,9,8,343.4845484833223,0.8109477124183008,0.24000104267326572,0.19520970210889713,130163.68762581855,-1258.1569053843127,128905.53072043424,2061,4,767.4509803921569,42,9,18,36.12588231570285,0.6118551587301588,44.88856589147286,1020.4457364341068,24.296327057954926,2
2075,4,1,0,51,0.0196078431372549,0.0,1.0,51,800,300,500,0.375,13,3,10,344.44873211064476,0.8157516339869282,0.23838272301371055,0.19652424168501398,130315.76063368062,-1222.467621621668,129093.29301205896,2062,0,763.4117647058823,39,12,19,35.9471706454465,0.6180555555555556,44.739583333333336,1021.0416666666672,26.180555555555568,0
2076,4,0,0,51,0.0,0.0,1.0,51,1450,700,750,0.4827586206896552,22,7,15,342.67253625695207,0.8140522875816995,0.23635104961925135,0.19655290085930685,130522.0739659758,-1254.7339753123247,129267.33999066347,2063,1,764.4117647058823,40,11,15,35.78360682910659,0.6184895833333335,44.537601626016254,1021.8495934959338,25.546239837398346,0
2077,4,0,0,51,0.0,0.0,1.0,51,1400,800,600,0.5714285714285714,20,8,12,340.7049219822753,0.8150000000000001,0.23351247249073648,0.19594916010404245,130625.94112507421,-1299.0197840240717,129326.92134105014,2064,2,765.4117647058823,40,11,16,35.72878351062067,0.6195312500000001,44.43597560975609,1022.2560975609745,25.55640243902436,0
2078,4,1,1,51,0.019230769230769232,0.019230769230769232,0.9807692307692307,52,1000,500,500,0.5,15,5,10,336.1761602772402,0.820418552036199,0.23660261383302528,0.19431886573872748,130820.18455530345,-1604.2745338876407,129215.91002141581,2065,0,751.6730769230769,41,11,16,35.64819304370314,0.6199186991869918,44.24603174603174,1023.0158730158719,24.951606658923705,0
2079,4,0,0,51,0.0,0.0,1.0,51,1550,1200,350,0.7741935483870968,19,12,7,367.4763678133841,0.8154575163398694,0.2234685716472964,0.20014815265403854,128487.53390842018,-700.595982388902,127786.93792603129,2066,4,767.4117647058823,39,12,15,37.22227216685502,0.5996260683760684,46.536458333333336,1013.8541666666671,25.996260683760696,5
2080,4,1,1,51,0.019230769230769232,0.019230769230769232,0.9807692307692307,52,1000,600,400,0.6,14,6,8,358.0952945130184,0.8195701357466062,0.21619423535891324,0.19649283446955818,128783.0426826061,-1176.6796804579176,127606.36300214818,2067,0,753.6346153846154,42,10,17,37.15831344470963,0.5979662698412699,46.245155038759684,1015.0193798449603,24.167128091546676,0
2081,4,1,0,52,0.019230769230769232,0.0,1.0,52,1400,1000,400,0.7142857142857143,18,10,8,365.9395367237918,0.8182346656611361,0.1745670176124292,0.19367119346944878,127334.51727892832,-1052.3580105892654,126282.15926833906,2068,0,754.5192307692307,38,14,17,38.4427596062242,0.5896381578947368,47.67628205128205,1009.2948717948717,26.56039136302294,6
2082,4,4,2,54,0.07142857142857142,0.03571428571428571,0.9642857142857143,56,1050,500,550,0.47619047619047616,16,5,11,341.9194228522073,0.8435064935064935,0.18584656084656115,0.18463648834019214,128144.53125000013,-2431.8427432609988,125712.68850673913,2069,0,701.5535714285714,40,16,19,38.22016460905351,0.59453125,46.87500000000001,1012.500000000001,25.312500000000025,0
2083,4,1,2,53,0.01818181818181818,0.03636363636363636,0.9636363636363636,55,1450,1200,250,0.8275862068965517,17,12,5,346.0972549242631,0.8364758698092032,0.1850689127105667,0.18677810534342448,128120.00480740328,-2131.6036070548776,125988.40120034841,2070,0,715.290909090909,42,13,21,38.13947645482389,0.5912698412698414,46.899224806201545,1012.4031007751928,24.104835732742686,0
2084,4,1,1,53,0.018518518518518517,0.018518518518518517,0.9814814814814815,54,950,500,450,0.5263157894736842,14,5,9,351.379102683155,0.8293733985557885,0.19171131146826959,0.1895069959714012,128094.31295666403,-1798.0670508944409,126296.24590576958,2071,0,729.2777777777778,41,13,21,38.03206258983405,0.592479674796748,46.92460317460317,1012.3015873015863,24.690282617111862,0
2085,4,0,0,53,0.0,0.0,1.0,53,1450,800,650,0.5517241379310345,21,8,13,360.4832986564731,0.8262578616352201,0.17963173448511016,0.19428645317199528,128067.37061273056,-1366.7703582523598,126700.60025447821,2072,3,744.0377358490566,40,13,21,37.82923360107096,0.59375,46.951219512195124,1012.1951219512198,25.304878048780495,0
2086,4,1,1,53,0.018518518518518517,0.018518518518518517,0.9814814814814815,54,1000,900,100,0.9,11,9,2,358.86838619155895,0.8297373631493129,0.1772578401542575,0.19446246451752566,128283.34349270925,-1592.539758478178,126690.80373423107,2073,0,731.2407407407408,37,17,21,37.64916387054875,0.6010698198198199,46.737938596491226,1013.0482456140347,27.37968231389283,0
2087,4,0,0,53,0.0,0.0,1.0,53,1800,1500,300,0.8333333333333334,21,15,6,368.5672851945898,0.8258043057571359,0.18242211105888706,0.19916809065323032,128173.0379027677,-1151.922277006728,127021.11562576097,2074,5,746.0377358490566,36,17,21,37.51644980723607,0.6018518518518519,46.84684684684685,1012.6126126126131,28.128128128128143,0
2088,4,1,2,52,0.018518518518518517,0.037037037037037035,0.962962962962963,54,1100,900,200,0.8181818181818182,13,9,4,363.2465299969198,0.8321104122990916,0.1762814734691427,0.19765827956571666,128450.01737313422,-1468.195382232972,126981.82199090126,2075,0,733.2037037037037,37,17,14,37.367833964305035,0.6027590090090089,46.57346491228071,1013.7061403508786,27.39746325272645,0
2089,4,1,1,52,0.018867924528301886,0.018867924528301886,0.9811320754716981,53,1050,700,350,0.6666666666666666,14,7,7,369.33235623000485,0.8261369134010643,0.18679350046619803,0.20144384420661382,128543.91289515869,-1104.9147542813062,127438.99814087739,2076,0,747.3396226415094,36,17,15,37.117573570238754,0.6056134259259258,46.48085585585586,1014.0765765765767,28.168793793793796,0
2090,4,4,3,53,0.07142857142857142,0.05357142857142857,0.9464285714285714,56,1200,800,400,0.6666666666666666,16,8,8,348.98689913030444,0.8381628787878788,0.18785085777136534,0.19314986044284338,129123.91067031884,-2187.4893623173803,126936.42130800146,2077,0,708.2321428571429,40,16,16,37.04212912042128,0.6044270833333333,45.90955284552847,1016.3617886178882,25.409044715447205,0
2091,4,1,2,52,0.018518518518518517,0.037037037037037035,0.962962962962963,54,1350,700,650,0.5185185185185185,20,7,13,361.6582787710264,0.8296936873980899,0.2123720292682545,0.19986820972639346,129065.65176647305,-1464.4677067353382,127601.18405973772,2078,0,735.4444444444445,38,16,17,36.77956226124136,0.6071820175438596,45.96688034188034,1016.1324786324784,26.740328385065222,0
2092,4,0,0,52,0.0,0.0,1.0,52,1500,1100,400,0.7333333333333333,19,11,8,377.0197422904595,0.8198058069381597,0.20517947638553835,0.20707754862681796,128821.50472094401,-686.3498977280811,128135.15482321593,2079,1,764.3653846153846,38,14,17,36.63877780116467,0.6047149122807016,46.20726495726497,1015.1709401709417,26.71502474134057,0
2093,4,0,0,52,0.0,0.0,1.0,52,1350,900,450,0.6666666666666666,18,9,9,376.4358198243332,0.8201671694318752,0.20469752321737134,0.20722037309245817,128910.32036675386,-694.7075737846847,128215.61279296917,2080,2,765.3653846153846,39,13,18,36.562831230553556,0.6038995726495726,46.119791666666686,1015.5208333333364,26.038995726495806,0
2094,4,3,2,53,0.05454545454545454,0.03636363636363636,0.9636363636363636,55,1000,600,400,0.6,14,6,8,361.01378334470303,0.8320987654320988,0.2192625077087227,0.20233765877623752,129619.76431450056,-1639.4545301799687,127980.30978432059,2081,0,724.5636363636364,37,18,16,36.231537812713114,0.6145833333333333,45.422149122807014,1018.3114035087715,27.52192982456139,0
2095,4,1,1,53,0.018518518518518517,0.018518518518518517,0.9814814814814815,54,1600,1200,400,0.75,20,12,8,368.60469274402936,0.8289803167947822,0.21601387915954873,0.20635015647670432,129573.74762854094,-1247.7017135378337,128326.04591500311,2082,0,738.9629629629629,36,18,16,36.08514913542013,0.6160300925925926,45.467342342342356,1018.1306306306326,28.28140640640646,0
2096,4,1,0,54,0.018518518518518517,0.0,1.0,54,1600,1400,200,0.875,18,14,4,366.03110032621464,0.8299411833216865,0.21599752731619626,0.20581002887826402,129745.78622118762,-1301.8014213537597,128443.98479983387,2083,0,739.9444444444445,36,18,18,35.97555359050883,0.6177662037037036,45.298423423423436,1018.806306306308,28.300175175175223,0
2097,4,0,0,54,0.0,0.0,1.0,54,1950,1400,550,0.717948717948718,25,14,11,332.9655802966493,0.8297664803167948,0.09746627036162825,0.17560134960873106,127192.06664147155,-2309.6758138907303,124882.39082758082,2084,1,740.9444444444445,41,13,15,39.42064975085234,0.5833333333333333,47.81746031746032,1008.7301587301599,24.603174603174633,8
2098,4,5,4,55,0.0847457627118644,0.06779661016949153,0.9322033898305084,59,1700,1200,500,0.7058823529411765,22,12,10,315.9108115334315,0.8505990648743424,0.14514558032934932,0.17167198009944462,128396.86322627867,-3684.055622167907,124712.80760411077,2085,0,679.0677966101695,45,14,12,38.6215442249829,0.5900462962962962,46.62590579710145,1013.4963768115946,22.522141706924323,0
2099,4,1,1,55,0.017857142857142856,0.017857142857142856,0.9821428571428571,56,1850,1500,350,0.8108108108108109,22,15,7,337.17759826584705,0.8392721861471861,0.13940329218106995,0.1820759030635573,128144.53124999999,-2558.506944444446,125586.02430555553,2086,0,716.2857142857143,42,14,16,38.340192043895755,0.5915178571428572,46.875,1012.4999999999999,24.107142857142854,0
2100,4,0,0,55,0.0,0.0,1.0,55,1400,1100,300,0.7857142857142857,17,11,6,340.80996933745615,0.8348204264870932,0.12974986943948608,0.18393644943927578,128122.55953565048,-2266.910882643719,125855.64865300676,2087,2,730.3090909090909,47,8,17,38.270688645002714,0.5848847517730498,46.896701388888886,1012.4131944444438,21.540706264775398,0
2101,4,2,2,55,0.03508771929824561,0.03508771929824561,0.9649122807017544,57,1250,700,550,0.56,18,7,11,334.22191615063974,0.8407477025898078,0.13422601052926497,0.1821126746170433,128504.3360182077,-2810.1956136590775,125694.14040454863,2088,0,705.6491228070175,43,14,12,38.04802543507364,0.59375,46.51988636363637,1013.9204545454551,23.579545454545467,0
2102,4,0,1,54,0.0,0.01818181818181818,0.9818181818181818,55,1150,700,450,0.6086956521739131,16,7,9,346.27598228506446,0.8333052749719416,0.07251214185599264,0.18465845403308687,127640.61187250563,-2148.2773755923263,125492.3344969133,2089,4,732.3090909090909,45,10,15,38.62532867216445,0.5824074074074075,47.373188405797094,1010.5072463768104,22.455716586151343,3
2103,4,3,2,55,0.05263157894736842,0.03508771929824561,0.9649122807017544,57,1550,900,650,0.5806451612903226,22,9,13,344.55534017635756,0.848109857978279,0.1019876196846694,0.18627789201724299,128191.4105366942,-2563.214686716391,125628.1958499778,2090,0,707.4561403508771,44,13,17,38.10555149187774,0.5892518939393938,46.82870370370371,1012.6851851851859,23.015572390572405,0
2104,4,2,2,55,0.03508771929824561,0.03508771929824561,0.9649122807017544,57,1900,1500,400,0.7894736842105263,23,15,8,342.3709419727448,0.8427057226399332,0.09693013806854478,0.1863723532373041,128465.72411258183,-2603.4138048728873,125862.31030770893,2091,0,708.421052631579,45,12,15,37.88085239456756,0.5907407407407406,46.55797101449277,1013.7681159420325,22.528180354267388,0
2105,4,2,1,56,0.03508771929824561,0.017543859649122806,0.9824561403508771,57,1750,1300,450,0.7428571428571429,22,13,9,344.23788731216365,0.8478226817042606,0.10120264497300013,0.18814641776519922,128626.47130493895,-2544.379053113808,126082.09225182515,2092,0,709.3859649122807,45,12,17,37.66956499092182,0.5923611111111109,46.39945652173915,1014.4021739130467,22.542270531401037,0
2106,4,0,0,56,0.0,0.0,1.0,56,1400,900,500,0.6428571428571429,19,9,10,348.40097220506,0.8431277056277057,0.10204780159599447,0.1904731063612098,128637.19135802492,-2236.5354938271366,126400.65586419779,2093,1,723.0535714285714,44,12,17,37.55305312157722,0.59375,46.3888888888889,1014.4444444444464,23.0555555555556,0
2107,4,0,0,56,0.0,0.0,1.0,56,1300,900,400,0.6923076923076923,17,9,8,349.16387166688264,0.8426948051948052,0.10393870992424858,0.1911697795900503,128695.39372637088,-2212.843612161276,126482.5501142096,2094,2,724.0535714285714,45,11,17,37.47433494018926,0.5930555555555554,46.33152173913045,1014.6739130434812,22.548309178744027,0
2108,4,0,1,55,0.0,0.017857142857142856,0.9821428571428571,56,1550,1100,450,0.7096774193548387,20,11,9,358.49975262643613,0.8420725108225108,0.05944200109950537,0.19123491203152138,127652.81635802476,-2018.6568312562656,125634.1595267685,2095,3,725.0535714285714,44,12,13,38.30401319406267,0.5838068181818181,47.361111111111114,1010.5555555555561,22.96717171717173,4
2109,4,2,1,56,0.03508771929824561,0.017543859649122806,0.9824561403508771,57,1800,1400,400,0.7777777777777778,22,14,8,351.62679543662426,0.8450031328320802,0.08010041743293339,0.18966586571047767,128099.65486048242,-2391.345772974191,125708.30908750823,2096,0,713.2456140350877,46,11,15,38.0203316110576,0.5858242753623188,46.919326241134755,1012.3226950354614,22.00701510946655,0
2110,4,1,0,57,0.017543859649122806,0.0,1.0,57,1500,1000,500,0.6666666666666666,20,10,10,357.36719152232524,0.845734126984127,0.07674885071892601,0.19355730874502855,128264.41012576045,-2232.4780184300216,126031.93210733043,2097,0,714.2280701754386,43,14,16,37.70654155370665,0.5913275193798451,46.75662878787879,1012.9734848484849,23.557522903453137,0
2111,4,1,2,56,0.017241379310344827,0.034482758620689655,0.9655172413793104,58,1100,600,500,0.5454545454545454,16,6,10,352.9778979773908,0.8495790481952007,0.08730354315427635,0.19236779892691855,128511.64162597123,-2527.6461746481987,125983.99545132303,2098,0,702.8965517241379,45,13,11,37.56513906259307,0.5912037037037037,46.51268115942028,1013.9492753623172,22.532206119162602,0
2112,4,4,2,58,0.06666666666666667,0.03333333333333333,0.9666666666666667,60,1600,1100,500,0.6875,21,11,10,347.2023353092496,0.860581450094162,0.1074856100757966,0.1910429406607525,128892.69039954651,-3049.631377797079,125843.05902174943,2099,0,680.3833333333333,47,13,14,37.32297543739671,0.5926418439716312,46.13715277777777,1015.4513888888875,21.605348699763564,0
2113,4,2,1,59,0.03333333333333333,0.016666666666666666,0.9833333333333333,60,1600,1200,400,0.75,20,12,8,357.43079817253454,0.8592984934086629,0.14467213114754096,0.19821162444113252,129201.38888888879,-2761.3043137538684,126440.08457513493,2100,0,681.35,40,20,17,36.74863387978142,0.6052083333333333,45.83333333333333,1016.6666666666658,25.416666666666647,0
2114,4,0,0,59,0.0,0.0,1.0,59,1550,700,850,0.45161290322580644,24,7,17,367.09194328054934,0.8545684784726281,0.14069924118856791,0.20345545422425543,129179.3267520859,-2315.861982180737,126863.46476990516,2101,1,693.8983050847457,47,12,18,36.52557780434349,0.59552304964539,45.85503472222223,1016.5798611111123,21.629358747044943,0
2115,4,0,0,59,0.0,0.0,1.0,59,1500,1200,300,0.8,18,12,6,368.1391248370568,0.8535943892460549,0.1499695975528994,0.20455126164599827,129278.89034511537,-2281.463303080843,126997.42704203453,2102,2,694.8983050847457,40,19,18,36.39743845974483,0.6059895833333333,45.75711382113821,1016.9715447154474,25.424288617886184,0
2116,4,1,2,58,0.016666666666666666,0.03333333333333333,0.9666666666666667,60,1600,1200,400,0.75,20,12,8,358.4072982840922,0.8542961393596987,0.14265321659687902,0.2007539387190429,129595.74619914679,-2710.387747130571,126885.35845201621,2103,0,684.3,42,18,13,36.32232584697373,0.6061507936507936,45.44573643410853,1018.2170542635668,24.243263196751588,0
2117,4,0,0,58,0.0,0.0,1.0,58,1900,1500,400,0.7894736842105263,23,15,8,363.9253723516577,0.8517216172615446,0.14207316672902826,0.20358892236030438,129546.41867225533,-2170.954269575143,127375.46440268018,2104,4,707.5862068965517,42,16,13,36.23207373564313,0.6056547619047619,45.49418604651163,1018.0232558139539,24.238648947951283,0
2118,4,0,1,57,0.0,0.017241379310344827,0.9827586206896551,58,1400,800,600,0.5714285714285714,20,8,12,379.4340744363722,0.8519736842105263,0.2402818098137789,0.20762291488821727,128672.41753472232,-1825.5893998632787,126846.82813485904,2105,5,708.5862068965517,39,19,14,36.7299794661191,0.6014957264957265,46.35416666666667,1014.5833333333342,26.014957264957285,5
2119,4,1,1,57,0.017241379310344827,0.017241379310344827,0.9827586206896551,58,1300,900,400,0.6923076923076923,17,9,8,382.97961867192646,0.8568889897156685,0.24984969053934591,0.21096334926843396,128936.767578125,-1723.9691840277753,127212.79839409722,2106,0,707.6206896551724,39,19,15,36.36965811965812,0.6041666666666666,46.09375,1015.625,26.041666666666668,0
2120,4,0,1,56,0.0,0.017543859649122806,0.9824561403508771,57,1250,1000,250,0.8,15,10,5,386.5447090034805,0.8516081871345029,0.24929407465645004,0.21289073023100125,128929.98598327102,-1432.5592172547542,127497.42676601627,2107,1,720.7543859649123,38,19,16,36.28607370783365,0.605811403508772,46.10042735042734,1015.5982905982888,26.726270805218128,0
2121,4,1,0,57,0.017543859649122806,0.0,1.0,57,1450,1000,450,0.6896551724137931,19,10,9,390.0983804600072,0.850485588972431,0.2798991332890095,0.21681179437710835,129289.65627411265,-1312.0068248799184,127977.64944923273,2108,0,721.3508771929825,35,22,17,35.82814100375555,0.6151785714285714,45.74652777777778,1017.0138888888889,29.057539682539684,0
2122,4,1,1,57,0.017241379310344827,0.017241379310344827,0.9827586206896551,58,1550,1100,450,0.7096774193548387,20,11,9,379.3652703331304,0.8554774148013712,0.2816995259502344,0.21292592121597878,129675.59880203521,-1761.1162809710745,127914.48252106413,2109,0,709.8965517241379,37,21,17,35.707445186062365,0.6151463963963963,45.36732456140351,1018.5307017543857,27.527856804172586,0
2123,4,0,0,57,0.0,0.0,1.0,57,1400,900,500,0.6428571428571429,19,9,10,382.04305185988466,0.856203007518797,0.2860865033871809,0.21488765362482137,129759.3730763312,-1485.2666204986142,128274.10645583259,2110,1,717.5087719298245,37,20,17,35.553881475104035,0.6159909909909909,45.28508771929825,1018.8596491228072,27.536747273589384,0
2124,4,0,0,57,0.0,0.0,1.0,57,1400,800,600,0.5714285714285714,20,8,12,380.3577129535447,0.8560724728487886,0.28261389167742257,0.2147558163906938,129908.37191358031,-1517.6697530864108,128390.70216049391,2111,2,718.5087719298245,38,19,17,35.44504995458674,0.6156798245614035,45.13888888888889,1019.4444444444449,26.827485380116972,0
2125,4,2,1,58,0.03389830508474576,0.01694915254237288,0.9830508474576272,59,1200,700,500,0.5833333333333334,17,7,10,364.69928114384356,0.8648694720436392,0.2767839920222157,0.20839319659961733,130374.5443309481,-2289.0527213501405,128085.49160959797,2112,0,695.1186440677966,37,22,19,35.370589077374575,0.6221846846846846,44.68201754385966,1021.2719298245624,27.6019440493125,0
2126,4,0,1,57,0.0,0.017241379310344827,0.9827586206896551,58,1550,900,650,0.5806451612903226,22,9,13,375.8819129117062,0.8616278483565235,0.2843058947032109,0.2143236114753168,130291.3280679332,-1805.1692740036872,128486.15879392951,2113,1,708.1034482758621,36,22,19,35.16963563497318,0.6232638888888887,44.76351351351354,1020.9459459459492,28.359609609609702,0
2127,4,0,0,57,0.0,0.0,1.0,57,1600,1200,400,0.75,20,12,8,373.4725282302167,0.8580565998329156,0.27406536952083926,0.21371437794795475,130430.54112803958,-1657.5552092951475,128772.98591874444,2114,2,720.2280701754386,37,20,19,35.08972019464721,0.6227477477477475,44.62719298245615,1021.4912280701769,27.6078710289237,0
2128,4,1,1,57,0.017241379310344827,0.017241379310344827,0.9827586206896551,58,1550,1000,550,0.6451612903225806,21,10,11,367.42696868974826,0.8616656583988708,0.2694674974144238,0.2114196430181724,130644.58832137135,-1999.5309874716718,128645.05733389968,2115,0,708.7931034482758,38,20,13,35.02695335632425,0.623081140350877,44.41773504273505,1022.3290598290613,26.903396311291086,0
2129,4,1,1,57,0.017241379310344827,0.017241379310344827,0.9827586206896551,58,1350,1000,350,0.7407407407407407,17,10,7,366.67575315871994,0.8620059487799959,0.27487859705750983,0.21143495838766696,130726.51855504439,-2013.1510702023293,128713.36748484206,2116,0,709.7758620689655,38,20,14,34.963086780888716,0.6239035087719296,44.33760683760685,1022.6495726495741,26.91183085919932,0
2130,4,1,1,57,0.017241379310344827,0.017241379310344827,0.9827586206896551,58,1550,900,650,0.5806451612903226,22,9,13,367.3838667402821,0.8588803186126235,0.27523029903776597,0.21289595036328912,130917.78897518113,-1980.5832922419097,128937.20568293922,2117,0,710.7586206896551,38,20,14,34.75114834533878,0.6258223684210524,44.15064102564104,1023.3974358974385,26.931511470985225,0
2131,4,0,0,57,0.0,0.0,1.0,57,1950,1300,650,0.6666666666666666,26,13,13,378.6672769625641,0.8573256056808688,0.27253954743343267,0.22001346390786966,131019.23338190616,-1477.4607331101668,129541.77264879599,2118,6,724.2280701754386,37,20,15,34.359604262611114,0.6286599099099097,44.05153508771931,1023.7938596491243,27.670104314841197,0
2132,4,0,0,57,0.0,0.0,1.0,57,1800,1100,700,0.6111111111111112,25,11,14,382.2351525329086,0.8579260651629073,0.27049623448430893,0.22279302044197383,131141.3425021705,-1374.6337890624618,129766.70871310805,2119,7,725.2280701754386,39,18,15,34.14448371131226,0.62633547008547,43.932291666666686,1024.2708333333362,26.263354700854773,0
2133,4,2,3,56,0.03389830508474576,0.05084745762711865,0.9491525423728814,59,1600,1300,300,0.8125,19,13,6,372.26554210953316,0.8650642898889538,0.2744884298089183,0.22040046790699333,131739.10307774483,-1991.215512127107,129747.88756561773,2120,0,701.6101694915254,38,21,13,33.79513997294203,0.634046052631579,43.34935897435897,1026.6025641025635,27.015856950067462,0
2134,4,0,1,55,0.0,0.017857142857142856,0.9821428571428571,56,1500,900,600,0.6,21,9,12,386.1278567173607,0.8597402597402597,0.2803853905820557,0.22749447276118556,131553.00188519547,-1040.7442674669117,130512.25761772855,2121,1,723.1785714285714,37,19,17,33.627707709847506,0.634009009009009,43.530701754385966,1025.8771929824563,27.72641062114747,0
2135,4,2,1,56,0.03508771929824561,0.017543859649122806,0.9824561403508771,57,1400,1100,300,0.7857142857142857,17,11,6,383.4209905057674,0.8612416457811194,0.28219065604729443,0.22798966133042337,131903.67408366175,-1285.072526298521,130618.60155736323,2122,0,711.1929824561404,38,19,15,33.34243369734789,0.6356907894736843,43.18910256410255,1027.2435897435873,27.032726045883877,0
2136,4,0,0,56,0.0,0.0,1.0,56,1000,800,200,0.8,12,8,4,388.8807793606243,0.8586444805194805,0.29076272697554173,0.2310692096893102,131876.23844875433,-943.173122580187,130933.06532617414,2123,1,724.8928571428571,38,18,15,33.22996844878996,0.6354166666666667,43.21581196581196,1027.136752136751,27.029914529914503,0
2137,4,0,0,56,0.0,0.0,1.0,56,1450,1000,450,0.6896551724137931,19,10,9,395.5517480130244,0.8577380952380952,0.2952971179117112,0.23622615565693977,132068.34781804707,-752.0268326759017,131316.32098537116,2124,2,725.8928571428571,38,18,16,32.86430724456915,0.6373355263157896,43.02884615384614,1027.8846153846132,27.049595141700348,0
2138,4,0,1,55,0.0,0.017857142857142856,0.9821428571428571,56,1800,1500,300,0.8333333333333334,21,15,6,398.8388068836985,0.8567640692640692,0.2960517029655456,0.23927964223295292,132241.164784933,-651.4183232533421,131589.74646167966,2125,3,726.8928571428571,40,16,16,32.60506208213945,0.6356770833333333,42.86077235772358,1028.5569105691065,25.713922764227664,0
2139,4,0,0,55,0.0,0.0,1.0,55,900,500,400,0.5555555555555556,13,5,8,405.62864370619377,0.8507856341189675,0.29503789029768956,0.24315553122715564,132210.46142578128,-274.3299696180541,131936.13145616322,2126,4,740.8727272727273,39,16,16,32.46153229346028,0.6370192307692308,42.890625,1028.4375000000002,26.370192307692314,0
2140,4,0,0,55,0.0,0.0,1.0,55,1800,1400,400,0.7777777777777778,22,14,8,407.89152302066583,0.8504489337822672,0.3013963762589742,0.24523147740564205,132321.43964356574,-205.44129109977257,132115.99835246598,2127,5,741.8727272727273,41,14,17,32.291064024684225,0.6349085365853657,42.782738095238095,1028.8690476190475,25.09436701509872,0
2141,4,0,1,54,0.0,0.01818181818181818,0.9818181818181818,55,1250,1100,150,0.88,14,11,3,409.7650029614016,0.8503086419753086,0.2996918335901386,0.24669525688492605,132373.07328285597,-151.6294468481095,132221.44383600785,2128,6,742.8727272727273,42,13,17,32.190638731952305,0.6339285714285712,42.7325581395349,1029.0697674418634,24.501661129568177,0
2142,4,0,0,54,0.0,0.0,1.0,54,1400,1000,400,0.7142857142857143,18,10,8,414.52900391745425,0.8511239226648032,0.3017693807167485,0.24972844870149113,132398.00347222242,176.56719472990292,132574.57066695232,2129,7,755.3148148148148,39,15,17,32.04284750337381,0.6388888888888888,42.70833333333334,1029.1666666666683,26.388888888888932,0
2143,4,0,1,53,0.0,0.018518518518518517,0.9814814814814815,54,1450,1100,350,0.7586206896551724,18,11,7,408.27454007760457,0.8502649662240858,0.291524701873936,0.2470692319851068,132567.328408741,24.77300707909015,132592.1014158201,2130,8,756.3148148148148,37,17,18,32.03258091993186,0.6441441441441442,42.5438596491228,1029.8245614035077,27.833096254148856,0
2144,4,0,0,53,0.0,0.0,1.0,53,1300,900,400,0.6923076923076923,17,9,8,406.37201354218456,0.8509010643444606,0.2907210200655155,0.246430122929166,132645.514875082,180.68499342535867,132826.19986850736,2131,9,765.6037735849056,38,15,14,32.002566894835084,0.643092105263158,42.46794871794871,1030.1282051282037,27.108636977057994,0
2145,4,0,0,53,0.0,0.0,1.0,53,1750,1100,650,0.6285714285714286,24,11,13,405.6078015392582,0.8509917755200773,0.29090798193833245,0.24769349953344327,132907.71620008672,181.6813151041612,133089.39751519088,2132,10,766.6037735849056,39,14,15,31.7575218035492,0.6439636752136753,42.213541666666664,1031.1458333333328,26.43963675213674,0
2146,4,0,0,53,0.0,0.0,1.0,53,1800,1500,300,0.8333333333333334,21,15,6,405.3147202372991,0.8502660861151426,0.29778988182826005,0.24837170157617364,133036.89654391826,184.36250078732348,133221.2590447056,2133,11,767.6037735849056,41,12,16,31.634752540308355,0.6420223577235774,42.08829365079364,1031.6468253968235,25.162117692605452,0
2147,4,0,0,53,0.0,0.0,1.0,53,1400,1000,400,0.7142857142857143,18,10,8,404.2573964497048,0.8502963231736816,0.29891872278664744,0.24789368650217697,133062.48425296016,158.29868984628095,133220.78294280643,2134,12,768.6037735849056,41,12,16,31.636217948717935,0.6422764227642277,42.06349206349205,1031.7460317460295,25.164537359659256,0
2148,4,0,0,53,0.0,0.0,1.0,53,1200,800,400,0.6666666666666666,16,8,8,402.56010131849797,0.8500241896468311,0.3012992100280738,0.24753163676818232,133164.85969387728,121.3718820861393,133286.2315759634,2135,13,769.6037735849056,41,12,16,31.57679738562091,0.6432926829268294,41.9642857142857,1032.142857142855,25.174216027874515,0
2149,4,0,0,53,0.0,0.0,1.0,53,1500,1200,300,0.8,18,12,6,398.7841789057202,0.8489054184808902,0.2995663712963905,0.24588541078499576,133267.27450239332,28.97612748800833,133296.25062988134,2136,14,770.6037735849056,41,12,16,31.571067127850363,0.6443089430894309,41.86507936507935,1032.5396825396806,25.18389469608977,0
2150,4,0,0,53,0.0,0.0,1.0,53,1800,1200,600,0.6666666666666666,24,12,12,390.9635554009633,0.8485425737784228,0.30719627854751086,0.23982836090763102,133075.95245652492,-193.8006162632468,132882.15184026168,2137,15,771.6037735849056,37,16,16,31.965550832447743,0.6492117117117118,42.05043859649122,1031.7982456140337,27.88643907064956,1
2151,4,0,0,53,0.0,0.0,1.0,53,1450,1000,450,0.6896551724137931,19,10,9,389.3791308000984,0.8487844702467343,0.30776447569942866,0.23921908479703147,133132.5263542627,-232.19452139121108,132900.33183287148,2138,16,772.6037735849056,37,16,16,31.949461680124664,0.6497747747747749,41.99561403508771,1032.017543859648,27.892366050260755,0
2152,4,0,1,52,0.0,0.018867924528301886,0.9811320754716981,53,750,600,150,0.8,9,6,3,356.9456845772403,0.8487844702467343,0.26800899688644897,0.21072300555404996,131629.44614517127,-1056.7323185366947,130572.71382663457,2139,17,773.6037735849056,38,15,14,34.2989762276592,0.6329495614035088,43.45619658119658,1026.1752136752134,27.004610886189827,7
2153,4,0,1,51,0.0,0.019230769230769232,0.9807692307692307,52,1400,900,500,0.6428571428571429,19,9,10,355.9656624299425,0.8489819004524886,0.2661963860593999,0.2106931893842092,131728.82080078125,-1021.8126085069439,130707.00819227431,2140,18,773.0961538461538,39,13,15,34.22384999154405,0.6322115384615385,43.359375,1026.5625,26.322115384615383,0
2154,4,0,0,51,0.0,0.0,1.0,51,1700,1200,500,0.7058823529411765,22,12,10,362.82170453570177,0.8441503267973857,0.2770545822322277,0.21589687566926408,131931.11257213826,-626.5057710570459,131304.60680108122,2141,19,788.4509803921569,38,13,17,33.843767332224076,0.6359649122807017,43.162393162393165,1027.3504273504277,27.03553756185336,0
2155,4,0,0,51,0.0,0.0,1.0,51,1200,1000,200,0.8333333333333334,14,10,4,363.81941556416206,0.8441503267973857,0.27927977511828095,0.21696087776265813,132013.44515897808,-594.1891071298037,131419.25605184826,2142,20,789.4509803921569,38,13,17,33.73509893613334,0.6367872807017543,43.08226495726496,1027.6709401709406,27.043972109761597,0
2156,4,2,0,53,0.03773584905660377,0.0,1.0,53,900,700,200,0.7777777777777778,11,7,4,353.7930265554144,0.850598693759071,0.29403268993971854,0.21426034161412036,132595.55975155818,-1216.0452232248779,131379.5145283333,2143,0,760.622641509434,37,16,19,33.406858831044396,0.6444256756756757,42.516447368421055,1029.9342105263158,27.836059743954483,0
2157,4,0,0,53,0.0,0.0,1.0,53,1050,700,350,0.6666666666666666,14,7,7,354.48259961859617,0.8501753749395259,0.29665317762358545,0.2150009053206399,132652.0314543899,-1195.4326090720124,131456.59884531787,2144,1,761.622641509434,37,16,16,33.33233546212526,0.6449887387387387,42.46162280701755,1030.1535087719303,27.841986723565686,0
2158,4,0,0,53,0.0,0.0,1.0,53,1350,1000,350,0.7407407407407407,17,10,7,354.34503409126603,0.8490263667150459,0.30106517210011985,0.2153533619288131,132728.07004026973,-1193.6934993425273,131534.3765409272,2145,2,762.622641509434,38,15,17,33.2594608605495,0.6439144736842104,42.38782051282052,1030.4487179487191,27.117071524966292,0
2159,4,0,0,53,0.0,0.0,1.0,53,1250,1100,150,0.88,14,11,3,354.6073183172702,0.8479680696661829,0.30567992961188795,0.21630598114801897,132865.71905361983,-1176.968734019998,131688.75031959984,2146,3,763.622641509434,38,15,17,33.114421416234904,0.6452850877192982,42.25427350427351,1030.9829059829071,27.131129104813347,0
2160,4,0,1,52,0.0,0.018867924528301886,0.9811320754716981,53,1100,600,500,0.5454545454545454,16,6,10,356.8723273180617,0.8480890179003386,0.31133639327854623,0.21800833565024896,132920.79863393973,-1112.8490485060893,131807.94958543364,2147,4,764.622641509434,38,15,17,33.00071660450338,0.6458333333333333,42.200854700854705,1031.196581196582,27.136752136752158,0
2161,4,0,0,52,0.0,0.0,1.0,52,1250,800,450,0.64,17,8,9,360.3148816383852,0.847882101558572,0.31079121789560893,0.2207614528616909,133030.99203740238,-813.3907699612746,132217.60126744112,2148,5,777.9807692307693,38,14,17,32.80128072355702,0.6469298245614035,42.0940170940171,1031.6239316239323,27.147998200629797,0
2162,4,1,0,53,0.018867924528301886,0.0,1.0,53,1650,1200,450,0.7272727272727273,21,12,9,351.7295803835745,0.8517174649250121,0.31737763056006374,0.21759839355358174,133391.505262587,-1216.4523654513637,132175.0528971356,2149,0,764.2830188679245,39,14,18,32.66119206077108,0.6487713675213674,41.74479166666668,1033.0208333333348,26.487713675213715,0
2163,4,0,0,53,0.0,0.0,1.0,53,1000,600,400,0.6,14,6,8,361.0226946279803,0.8506894049346879,0.34243684042212963,0.21047765793528506,131150.233892747,-1130.3334177276156,130019.90047501939,2150,1,765.2830188679245,41,12,18,34.67867231638419,0.623221544715447,43.923611111111114,1024.305555555556,24.98306233062332,4
2164,4,1,0,54,0.018518518518518517,0.0,1.0,54,1150,800,350,0.6956521739130435,15,8,7,358.3424189721915,0.8552440018634987,0.3431020492089192,0.21002905172414296,131354.16795764773,-1385.8048158521706,129968.36314179556,2151,0,752.0925925925926,40,14,19,34.541158586960115,0.6268229166666666,43.72459349593497,1025.1016260162617,25.62754065040654,0
2165,4,0,0,54,0.0,0.0,1.0,54,1450,1000,450,0.6896551724137931,19,10,9,359.6586395254817,0.8560592825529932,0.3418108953186243,0.21151952156708403,131484.42147531235,-1342.0983706788202,130142.32310463353,2152,1,753.0925925925926,40,14,19,34.375825736557026,0.6281249999999999,43.59756097560976,1025.6097560975613,25.640243902439032,0
2166,4,0,0,54,0.0,0.0,1.0,54,1250,900,350,0.72,16,9,7,359.03872642897215,0.8565251572327044,0.34043946849851925,0.21129900092405937,131510.47992473075,-1356.5289551523451,130153.9509695784,2153,2,754.0925925925926,40,14,19,34.36540176359854,0.6283854166666667,43.57215447154472,1025.7113821138219,25.642784552845548,0
2167,4,0,0,54,0.0,0.0,1.0,54,1050,800,250,0.7619047619047619,13,8,5,363.71312550581246,0.8561757512229211,0.34055546383431423,0.21434232352487906,131562.6045694528,-1229.790778471807,130332.81379098097,2154,3,755.0925925925926,40,14,14,34.19287601122667,0.62890625,43.521341463414636,1025.914634146342,25.64786585365855,0
2168,4,0,0,54,0.0,0.0,1.0,54,1400,1000,400,0.7142857142857143,18,10,8,363.7219568650789,0.8551129746098299,0.3430427655103363,0.21493435005151754,131666.88484243842,-1221.972598155856,130444.91224428256,2155,4,756.0925925925926,40,14,14,34.08732712809849,0.6299479166666667,43.41971544715447,1026.3211382113825,25.658028455284562,0
2169,4,0,1,53,0.0,0.018518518518518517,0.9814814814814815,54,1750,1500,250,0.8571428571428571,20,15,5,364.5356307074676,0.8542249010016306,0.3468629952200817,0.21615422609555454,131797.29327781074,-1191.0381138872447,130606.25516392349,2156,5,757.0925925925926,40,14,14,33.93478655318026,0.6312500000000001,43.292682926829265,1026.8292682926822,25.670731707317053,0
2170,4,1,1,53,0.018518518518518517,0.018518518518518517,0.9814814814814815,54,1550,1200,350,0.7741935483870968,19,12,7,300.3558567250836,0.8557098765432098,0.21345400336425535,0.17175870687062758,130404.40779321027,-2926.0467732132975,127478.36101999697,2157,0,757.9814814814815,44,10,17,36.98327440848516,0.6115056818181817,44.65277777777779,1021.388888888892,23.21338383838391,7
2171,4,2,2,53,0.03636363636363636,0.03636363636363636,0.9636363636363636,55,1500,1100,400,0.7333333333333333,19,11,8,298.13431055958534,0.8581930415263749,0.22157691719211692,0.17180389136841076,130702.1742822546,-3206.63947634423,127495.53480591036,2158,0,744.9090909090909,45,10,12,36.7399496560073,0.6131944444444443,44.36141304347827,1022.5543478260897,22.723429951690882,0
2172,4,0,0,53,0.0,0.0,1.0,53,2200,1900,300,0.8636363636363636,25,19,6,311.2149685273132,0.8519593613933236,0.24207283294975324,0.1792100274767683,130673.75750581117,-2466.47413409663,128207.28337171454,2159,2,774.0188679245283,43,10,13,36.434213979191746,0.6155523255813953,44.389204545454554,1022.4431818181836,23.77774841437636,0
2173,4,1,1,53,0.018518518518518517,0.018518518518518517,0.9814814814814815,54,1700,1300,400,0.7647058823529411,21,13,8,305.69771509504915,0.8561611926391801,0.24683602377815772,0.17754345200432936,131003.37130461058,-2790.5137444864276,128212.85756012416,2160,0,760.6666666666666,45,9,14,36.24321653984546,0.6162037037037036,44.06702898550726,1023.7318840579727,22.749597423510505,0
2174,4,0,0,53,0.0,0.0,1.0,53,1000,600,400,0.6,14,6,8,311.8182370496104,0.8571298984034833,0.2522208852819947,0.1809527879571364,130972.4633487657,-2432.079475308616,128540.38387345707,2161,1,773.566037735849,44,9,14,36.11770691994575,0.6171875,44.097222222222236,1023.6111111111132,23.26388888888894,0
2175,4,0,0,53,0.0,0.0,1.0,53,1150,800,350,0.6956521739130435,15,8,7,315.0669241632077,0.856736816642477,0.2608348557655402,0.1835152842637835,131114.6701388892,-2338.020833333298,128776.6493055559,2162,2,774.566037735849,44,9,14,35.891307295904554,0.6186079545454544,43.95833333333335,1024.1666666666692,23.27651515151521,0
2176,4,1,1,53,0.018518518518518517,0.018518518518518517,0.9814814814814815,54,1350,900,450,0.6666666666666666,18,9,9,313.2228843689329,0.8585633589564408,0.2763548550397463,0.18392502125524982,131425.20732897165,-2566.576274104666,128858.63105486699,2163,0,761.2037037037037,43,11,15,35.626000492550205,0.623062015503876,43.65530303030304,1025.378787878789,23.846018322762532,0
2177,4,0,0,53,0.0,0.0,1.0,53,1450,1000,450,0.6896551724137931,19,10,9,313.0175048927734,0.857281083696178,0.28552715922075733,0.18427204418470233,131522.3255280074,-2366.241965105598,129156.08356290181,2164,1,775.0188679245283,43,10,16,35.53360413589363,0.624031007751938,43.56060606060606,1025.7575757575762,23.854827343199446,0
2178,4,1,1,53,0.018518518518518517,0.018518518518518517,0.9814814814814815,54,1400,900,500,0.6428571428571429,19,9,10,307.335440444313,0.8610965525273702,0.28651752961693466,0.18181006898429297,131708.02897805203,-2704.2909807956153,129003.73799725641,2165,0,761.6481481481482,44,10,15,35.492776174153605,0.6245265151515151,43.379629629629626,1026.4814814814806,23.32912457912456,0
2179,4,0,0,53,0.0,0.0,1.0,53,1300,700,600,0.5384615384615384,19,7,12,312.31516401134013,0.8575532172230285,0.2810864637700341,0.18456225450135774,131668.07008293143,-2375.6130193985414,129292.45706353289,2166,3,777.0188679245283,43,10,15,35.40513317340225,0.6254844961240311,43.4185606060606,1026.3257575757564,23.8680408738548,0
2180,4,0,1,52,0.0,0.018867924528301886,0.9811320754716981,53,1400,800,600,0.5714285714285714,20,8,12,312.41129618682817,0.8569484760522496,0.2827248449420221,0.18544611423897917,131838.20740250513,-2362.450947687103,129475.75645481802,2167,4,778.0188679245283,43,10,16,35.23176963270324,0.6271802325581396,43.25284090909091,1026.988636363636,23.883456659619444,0
2181,4,0,0,52,0.0,0.0,1.0,52,1300,800,500,0.6153846153846154,18,8,10,314.0358045403388,0.8550150829562594,0.28185395249911416,0.18700814924603024,131959.80131571376,-2111.979525367327,129847.82179034644,2168,5,777.6346153846154,43,9,16,35.06797235023041,0.6283914728682172,43.13446969696969,1027.4621212121197,23.894467935165572,0
2182,4,0,0,52,0.0,0.0,1.0,52,1350,900,450,0.6666666666666666,18,9,9,316.7806611204481,0.8543394922071392,0.2849821067923328,0.1892489860463653,132081.45127589797,-2031.8301086145673,130049.6211672834,2169,6,778.6346153846154,43,9,16,34.87534546292032,0.6296027131782946,43.01609848484848,1027.9356060606044,23.905479210711732,0
2183,4,0,0,52,0.0,0.0,1.0,52,1650,900,750,0.5454545454545454,24,9,15,317.35973328720814,0.8543394922071392,0.2885748689616092,0.19020566796352528,132203.15728305772,-2008.8082529844048,130194.34903007331,2170,7,779.6346153846154,43,9,17,34.73833640270105,0.6308139534883721,42.897727272727266,1028.4090909090899,23.916490486257903,0
2184,4,0,0,52,0.0,0.0,1.0,52,1400,900,500,0.6428571428571429,19,9,10,319.22542830257925,0.8528783308195073,0.29026657983591764,0.19218962489551952,132373.63985200008,-1948.5936244547872,130425.04622754529,2171,8,780.6346153846154,43,9,17,34.519359068740215,0.6325096899224807,42.73200757575757,1029.0719696969693,23.93190627202254,0
2185,4,0,0,52,0.0,0.0,1.0,52,1400,900,500,0.6428571428571429,19,9,10,320.971385542169,0.8536324786324786,0.29651297497683093,0.1937499999999999,132472.80812451153,-1896.001604043724,130576.80652046781,2172,9,781.6346153846154,42,10,17,34.37500000000001,0.634920634920635,42.63565891472867,1029.4573643410836,24.510889627168655,0
2186,4,0,0,52,0.0,0.0,1.0,52,1400,1100,300,0.7857142857142857,17,11,6,320.9090140317179,0.8529411764705882,0.2986306128948215,0.1942267084925451,132572.58052400674,-1891.252779280111,130681.32774472663,2173,10,782.6346153846154,42,10,18,34.276596411993474,0.6359126984126985,42.53875968992247,1029.8449612403083,24.520118124769244,0
2187,4,0,0,52,0.0,0.0,1.0,52,1550,1100,450,0.7096774193548387,20,11,9,319.33645450497846,0.8527212166918049,0.3023093888284112,0.19413515630855716,132739.3295526284,-1922.298625459156,130817.03092716924,2174,11,783.6346153846154,43,9,17,34.15004901059853,0.6361434108527133,42.37689393939393,1030.4924242424229,23.964940098660996,0
2188,4,0,0,52,0.0,0.0,1.0,52,1100,800,300,0.7272727272727273,14,8,6,315.0044210802864,0.852202740070387,0.30071202039674216,0.19195096988980961,132827.17013888864,-2031.7708333333564,130795.39930555529,2175,12,784.6346153846154,44,8,17,34.17374023174348,0.6356534090909092,42.29166666666666,1030.8333333333312,23.428030303030255,0
2189,4,0,0,52,0.0,0.0,1.0,52,1200,800,400,0.6666666666666666,16,8,8,315.2698572787859,0.8513229009552538,0.305697557942731,0.19235780059174135,132874.89819101503,-2021.7099622771025,130853.18822873793,2176,13,785.6346153846154,44,8,17,34.11914384074239,0.636126893939394,42.24537037037037,1031.018518518518,23.432239057239045,0
2190,4,0,0,52,0.0,0.0,1.0,52,1200,700,500,0.5833333333333334,17,7,10,313.02768288004233,0.8512129210658621,0.3020069591151979,0.19184567891361026,133042.013888889,-2070.8333333333285,130971.18055555566,2177,14,786.6346153846154,44,8,17,34.00982767905222,0.6377840909090909,42.083333333333336,1031.6666666666674,23.446969696969713,0
2191,4,0,0,52,0.0,0.0,1.0,52,1650,1300,350,0.7878787878787878,20,13,7,298.0908071937658,0.8512600553041728,0.2757064536870959,0.17991513668386339,132467.92891625964,-2501.8111839687126,129966.11773229092,2178,15,787.6346153846154,45,7,19,34.96874541721661,0.630787037037037,42.64039855072463,1029.4384057971008,22.87640901771335,3
2192,4,0,1,51,0.0,0.019230769230769232,0.9807692307692307,52,800,400,400,0.5,12,4,8,295.61454505128063,0.8502545248868777,0.27370142831045263,0.17886331892964402,132561.1915580367,-2562.596733223062,129998.59482481363,2179,16,788.6346153846154,45,7,19,34.93921702289851,0.631712962962963,42.54981884057971,1029.8007246376815,22.884460547504034,0
2193,4,0,0,51,0.0,0.0,1.0,51,1550,1300,250,0.8387096774193549,18,13,5,300.3891557595278,0.8480065359477125,0.2758755071811507,0.18197789505282824,132607.8351859507,-2233.2088682787453,130374.62631767197,2180,17,804.7254901960785,45,6,21,34.76964427051269,0.6321759259259261,42.504528985507235,1029.9818840579692,22.888486312399316,0
2194,4,0,1,50,0.0,0.0196078431372549,0.9803921568627451,51,1550,1000,550,0.6451612903225806,21,10,11,301.2288312453887,0.8466666666666668,0.28107332947243635,0.1830544436029667,132724.48015122855,-2203.911993278741,130520.5681579498,2181,18,805.7254901960785,45,6,15,34.631387716830744,0.6333333333333333,42.39130434782608,1030.4347826086941,22.898550724637648,0
2195,4,0,0,50,0.0,0.0,1.0,50,1250,1000,250,0.8,15,10,5,308.1708500531681,0.8441156462585033,0.28585317638601815,0.18730930585700223,132731.73975480115,-1819.189386145405,130912.55036865575,2182,19,819.34,44,6,15,34.44529307814419,0.6347064393939394,42.38425925925926,1030.4629629629633,23.419612794612803,0
2196,4,0,0,50,0.0,0.0,1.0,50,1750,1300,450,0.7428571428571429,22,13,9,308.9335268789445,0.8435204081632652,0.27944673971618506,0.1883716258636451,132851.03309327818,-1791.5723593964653,131059.46073388171,2183,20,820.34,44,6,15,34.306328962337595,0.6358901515151516,42.268518518518505,1030.9259259259236,23.43013468013463,0
2197,4,0,0,50,0.0,0.0,1.0,50,1450,1300,150,0.896551724137931,16,13,3,309.27577526438483,0.8436054421768707,0.2820107719928191,0.18930396354094733,132994.25582990373,-1773.619684499336,131220.6361454044,2184,21,821.34,44,6,15,34.15432375822861,0.6373106060606062,42.12962962962962,1031.4814814814795,23.4427609427609,0
2198,4,1,0,51,0.0196078431372549,0.0,1.0,51,1450,1000,450,0.6896551724137931,19,10,9,305.26008002462305,0.8435947712418301,0.2897557619539042,0.18830978962557895,133285.08979206026,-2062.676564797339,131222.4132272629,2185,0,806.2156862745098,45,6,16,33.96747076023389,0.6388888888888891,41.84782608695651,1032.608695652172,22.9468599033816,0
2199,4,0,0,51,0.0,0.0,1.0,51,1250,1000,250,0.8,15,10,5,315.9055009929808,0.8432026143790851,0.18730480386464587,0.1852762455880515,131378.97317491827,-1860.7453035124202,129518.22787140585,2186,1,807.2156862745098,41,10,18,35.60375137087927,0.6255081300813007,43.70039682539683,1025.198412698414,25.004839334107658,7
2200,4,0,1,50,0.0,0.0196078431372549,0.9803921568627451,51,1250,900,350,0.72,16,9,7,316.9347576963013,0.8427777777777778,0.18498559334733256,0.1862509715921925,131455.26389085726,-1867.451558169563,129587.8123326877,2187,2,808.2156862745098,41,10,18,35.50060865499341,0.626270325203252,43.62599206349206,1025.4960317460316,25.012098335269062,0
2201,4,0,0,50,0.0,0.0,1.0,50,1300,700,600,0.5384615384615384,19,7,12,321.50465083180126,0.8420408163265306,0.18132421449102964,0.1886946144410732,131406.26161882834,-1550.455148225235,129855.80647060311,2188,25,825.34,40,10,18,35.43277331747446,0.6273437499999999,43.67378048780489,1025.3048780487827,25.63262195121957,0
2202,4,0,0,50,0.0,0.0,1.0,50,950,700,250,0.7368421052631579,12,7,5,321.6973404724097,0.841156462585034,0.1819976218787156,0.18919403030580212,131484.42147531256,-1540.3622595676936,129944.05921574486,2189,26,826.34,40,10,19,35.349162703131185,0.6281249999999998,43.59756097560977,1025.609756097563,25.640243902439074,0
2203,4,1,1,50,0.0196078431372549,0.0196078431372549,0.9803921568627451,51,1400,1100,300,0.7857142857142857,17,11,6,317.0225867630368,0.8476797385620916,0.18033759063582955,0.1878000429542455,131760.64819735772,-1845.7796949798371,129914.86850237788,2190,0,811.1176470588235,41,10,15,35.191302702354484,0.6293191056910568,43.32837301587302,1026.6865079365084,25.04113433991484,0
2204,4,0,0,50,0.0,0.0,1.0,50,1650,1200,450,0.7272727272727273,21,12,9,324.1544946573862,0.8406972789115646,0.18433267326732627,0.19168386393674494,131692.9613655894,-1462.2269317205269,130230.73443386889,2191,28,828.34,40,10,15,35.0763201320132,0.6302083333333333,43.394308943089435,1026.4227642276433,25.66056910569108,0
2205,4,0,0,50,0.0,0.0,1.0,50,1300,1000,300,0.7692307692307693,16,10,6,325.4264431917388,0.8403741496598639,0.18759453573549778,0.1926997613788362,131745.12215777647,-1425.3306976667313,130319.79146010973,2192,29,829.34,40,10,15,34.99121461096813,0.6307291666666668,43.34349593495935,1026.6260162601627,25.665650406504067,0
2206,4,0,0,50,0.0,0.0,1.0,50,1200,400,800,0.3333333333333333,20,4,16,325.2664627781658,0.8398469387755102,0.1899661868418514,0.1929417281499593,131811.58002842325,-1425.22272219074,130386.35730623252,2193,30,830.34,41,9,16,34.928489195890904,0.6298272357723578,43.278769841269835,1026.8849206349194,25.045973674022424,0
2207,4,0,0,50,0.0,0.0,1.0,50,1450,1100,350,0.7586206896551724,18,11,7,321.81104633149255,0.8410204081632653,0.1789765376074155,0.19166170252186704,131964.43457301898,-1506.4774463025967,130457.95712671638,2194,31,831.34,41,9,16,34.86359869331531,0.6313516260162602,43.129960317460316,1027.4801587301583,25.060491676345325,0
2208,4,0,1,49,0.0,0.02,0.98,50,1250,900,350,0.72,16,9,7,317.5078321458762,0.8412074829931973,0.14228884895488525,0.18536776970062674,131204.00221027885,-1643.241033102113,129560.76117717674,2195,32,832.34,42,8,16,35.73883161512027,0.6222718253968255,43.87112403100775,1024.5155038759692,24.393226282761173,4
2209,4,0,1,48,0.0,0.02040816326530612,0.9795918367346939,49,1150,900,250,0.782608695652174,14,9,5,316.9739058509244,0.8377976190476191,0.14463453466492981,0.1852956912312615,131253.64428407224,-1479.2039428219646,129774.44034125029,2196,33,848.0816326530612,42,7,17,35.702521670606785,0.6227678571428572,43.82267441860464,1024.7093023255798,24.39784053156142,0
2210,4,1,0,49,0.02040816326530612,0.0,1.0,49,1100,800,300,0.7272727272727273,14,8,6,316.4176265549153,0.8454152494331066,0.15600096194512014,0.18584815726769582,131434.9175347221,-1482.2716905910188,129952.64584413108,2197,0,814.7551020408164,39,10,18,35.53433563592038,0.6292735042735043,43.64583333333333,1025.4166666666656,26.292735042735014,0
2211,4,0,0,49,0.0,0.0,1.0,49,1150,800,350,0.6956521739130435,15,8,7,312.1094574075606,0.8447066326530612,0.15020976481871018,0.18402713845547275,131582.46429358784,-1586.3736929957165,129996.09060059211,2198,1,815.7551020408164,41,8,16,35.49643847095982,0.627540650406504,43.50198412698413,1025.9920634920636,25.024196670538135,0
2212,4,1,1,49,0.02,0.02,0.98,50,1100,700,400,0.6363636363636364,15,7,8,307.49402425970334,0.848265306122449,0.15432210585904294,0.18258426684193818,131850.08154745816,-1891.377565200405,129958.70398225775,2199,0,800.42,42,8,16,35.3461018335063,0.628720238095238,43.241279069767444,1027.0348837209308,24.45321151716502,0
2213,4,0,0,49,0.0,0.0,1.0,49,1300,700,600,0.5384615384615384,19,7,12,312.7538629352697,0.8420847505668935,0.14181021650279346,0.18551949772166024,131811.58002842322,-1555.0838333018519,130256.49619512138,2200,3,817.7551020408164,41,8,17,35.24971419830614,0.6298272357723578,43.278769841269835,1026.8849206349191,25.045973674022417,0
2214,4,0,0,49,0.0,0.0,1.0,49,1400,900,500,0.6428571428571429,19,9,10,313.3316824241494,0.840844671201814,0.13811110212358568,0.18646930458692265,131935.47804931438,-1532.0869382747671,130403.39111103961,2201,4,818.7551020408164,43,6,17,35.110474851752876,0.6281492248062015,43.15814393939395,1027.3674242424258,23.892265680056415,0
2215,4,0,0,49,0.0,0.0,1.0,49,1350,1000,350,0.7407407407407407,17,10,7,314.76275170443205,0.840561224489796,0.1420973844753528,0.1876816143679396,132008.4545741507,-1489.731117998152,130518.72345615255,2202,5,819.7551020408164,43,6,17,35.00046074456321,0.6288759689922481,43.08712121212122,1027.6515151515162,23.898872445384097,0
2216,4,0,0,49,0.0,0.0,1.0,49,1400,1200,200,0.8571428571428571,16,12,4,317.7423143300913,0.840171485260771,0.14956713943636046,0.19018996962492474,132154.46815455705,-1401.7866879017297,130752.68146665533,2203,6,820.7551020408164,43,6,17,34.77735310370234,0.630329457364341,42.945075757575765,1028.219696969698,23.912085976039485,0
2217,4,1,0,50,0.02,0.0,1.0,50,1100,600,500,0.5454545454545454,16,6,10,313.0101160511713,0.8459013605442177,0.160396600566572,0.1891070896729693,132505.2300347223,-1703.783574380157,130801.44646034215,2204,0,805.32,39,11,18,34.5474167003912,0.6399572649572649,42.60416666666667,1029.5833333333342,26.399572649572672,0
2218,4,0,1,49,0.0,0.02,0.98,50,1450,800,650,0.5517241379310345,21,8,13,312.62567129376123,0.8469727891156462,0.16341996157346528,0.18954967893464172,132639.32427300356,-1706.7084418402737,130932.61583116328,2205,1,806.32,39,11,15,34.423033168166654,0.6412927350427351,42.473958333333336,1030.1041666666672,26.412927350427363,0
2219,4,0,0,49,0.0,0.0,1.0,49,1400,1000,400,0.7142857142857143,18,10,8,310.2286681549761,0.8458758503401361,0.17694254482795713,0.1857870556693348,132173.71627306077,-1599.184807102918,130574.53146595784,2206,2,805.4897959183673,42,7,16,34.95119518783767,0.6319444444444444,42.9263565891473,1028.2945736434128,24.48320413436697,3
2220,4,0,0,49,0.0,0.0,1.0,49,1550,900,650,0.5806451612903226,22,9,13,312.7024619048071,0.8449192176870749,0.1795049280311336,0.18751547630834034,132223.5414413197,-1530.6746139053998,130692.86682741431,2207,3,806.4897959183673,42,7,16,34.837635826895315,0.632440476190476,42.87790697674419,1028.488372093024,24.48781838316724,0
2221,4,0,0,49,0.0,0.0,1.0,49,1400,800,600,0.5714285714285714,20,8,12,313.6146585541685,0.8433956916099773,0.18231266889878972,0.18855948157011107,132323.21994621714,-1500.2997115557964,130822.92023466135,2208,4,807.4897959183673,42,7,16,34.71424310918566,0.6334325396825395,42.781007751937985,1028.8759689922479,24.497046880767805,0
2222,4,0,0,49,0.0,0.0,1.0,49,1750,1100,650,0.6285714285714286,24,11,13,313.6955110813196,0.842828798185941,0.17941888619854685,0.18885750156936582,132373.07328285556,-1495.032224625931,130878.04105822963,2209,5,808.4897959183673,42,7,16,34.662193973634636,0.6339285714285714,42.73255813953488,1029.0697674418602,24.5016611295681,0
2223,4,0,0,49,0.0,0.0,1.0,49,1550,1300,250,0.8387096774193549,18,13,5,314.7463134730186,0.8407383786848073,0.18205987214162778,0.18999232013280387,132472.80812451174,-1460.934401478281,131011.87372303345,2210,6,809.4897959183673,42,7,17,34.5352111571285,0.6349206349206349,42.63565891472868,1029.457364341085,24.510889627168687,0
2224,4,1,0,50,0.02,0.0,1.0,50,1400,1100,300,0.7857142857142857,17,11,6,307.6267164833544,0.8458163265306122,0.19078857553439899,0.18757480072977376,132851.03309327847,-1826.2945816186545,131024.73851165982,2211,0,794.28,44,6,15,34.34000958026465,0.6358901515151516,42.26851851851852,1030.925925925926,23.430134680134685,0
2225,4,0,0,50,0.0,0.0,1.0,50,1450,1000,450,0.6896551724137931,19,10,9,312.86563373290494,0.8449829931972789,0.18926391382405772,0.1915012725156351,132994.2558299039,-1678.1335733882097,131316.1222565157,2212,1,795.28,44,6,15,34.06175194494314,0.6373106060606061,42.129629629629626,1031.4814814814808,23.442760942760927,0
2226,4,0,0,50,0.0,0.0,1.0,50,700,200,500,0.2857142857142857,12,2,10,316.0950120307208,0.8444557823129252,0.18905599425699937,0.1939737232417595,133089.780521262,-1586.196844993138,131503.58367626887,2213,2,796.28,44,6,15,33.88295644891123,0.6382575757575758,42.03703703703704,1031.851851851852,23.451178451178453,0
2227,4,0,1,49,0.0,0.02,0.98,50,1300,1100,200,0.8461538461538461,15,11,4,321.4247756707102,0.8442857142857143,0.1656701030927834,0.19313931210655969,132300.5624426081,-1493.9668854651839,130806.59555714291,2214,3,797.28,43,7,16,34.536082474226816,0.631782945736434,42.80303030303031,1028.7878787878803,23.92529950669489,4
2228,4,0,0,49,0.0,0.0,1.0,49,1400,1100,300,0.7857142857142857,17,11,6,345.48740842721975,0.8378330498866213,0.17781680925433685,0.1958506165058346,130064.82600392126,-716.0706338484192,129348.75537007285,2215,11,814.4897959183673,42,7,13,36.175034039454104,0.6108630952380951,44.98546511627908,1020.0581395348855,24.287098560354416,7
2229,4,0,0,49,0.0,0.0,1.0,49,850,600,250,0.7058823529411765,11,6,5,345.81868214214876,0.8377621882086168,0.18045459566411348,0.19653624077922144,130163.68762581897,-797.3930164953804,129366.2946093236,2216,12,815.4897959183673,42,7,15,36.06633589719244,0.6118551587301586,44.88856589147288,1020.4457364341101,24.296327057955004,0
2230,4,0,2,47,0.0,0.04081632653061224,0.9591836734693877,49,1250,800,450,0.64,17,8,9,346.4799444080515,0.836592970521542,0.18898837715234995,0.19781845632103293,130342.35161675372,-767.6851780452572,129574.66643870846,2217,13,816.4897959183673,39,10,16,35.86837787752048,0.6183226495726495,44.71354166666668,1021.1458333333353,26.183226495726547,0
2231,4,1,0,48,0.020833333333333332,0.0,1.0,48,1200,900,300,0.75,15,9,6,347.80087721759304,0.8330562943262411,0.22249830105334722,0.19952787166693509,130528.5644531251,-520.4101562499857,130008.15429687512,2218,0,832.9375,39,9,12,35.646024464831825,0.6201923076923077,44.53125000000001,1021.8750000000008,26.201923076923098,0
2232,4,0,0,48,0.0,0.0,1.0,48,1450,800,650,0.5517241379310345,21,8,13,348.60805956755297,0.8342383274231678,0.22484761147551913,0.20089887144150712,130703.86860499685,-487.1155975279405,130216.75300746891,2219,1,833.9375,40,8,12,35.447931160140456,0.6203125,44.35975609756097,1022.5609756097547,25.564024390243866,0
2233,4,0,1,47,0.0,0.020833333333333332,0.9791666666666666,48,1400,1200,200,0.8571428571428571,16,12,4,348.90515649720174,0.8341459810874704,0.22105101973248598,0.20188374227665665,130859.79327781076,-468.468669442799,130391.32460836797,2220,2,834.9375,40,8,13,35.28257846642828,0.6218750000000001,44.20731707317073,1023.1707317073165,25.57926829268291,0
2234,4,0,0,47,0.0,0.0,1.0,47,1250,800,450,0.64,17,8,9,352.828677227345,0.83290934320074,0.23379998613902608,0.20437434699772597,130901.38888888869,-162.84722222224184,130738.54166666644,2221,3,850.6808510638298,39,8,14,35.14013300760044,0.623931623931624,44.16666666666666,1023.3333333333317,26.239316239316196,0
2235,4,0,0,47,0.0,0.0,1.0,47,900,500,400,0.5555555555555556,13,5,8,352.33649182863155,0.8318300955905026,0.23510129495592946,0.20451333167158647,130981.3490125866,-170.09819878474343,130811.25081380185,2222,4,851.6808510638298,39,8,14,35.0718471218751,0.6247329059829061,44.08854166666666,1023.6458333333317,26.247329059829017,0
2236,4,1,0,48,0.020833333333333332,0.0,1.0,48,800,400,400,0.5,12,4,8,344.3850382886709,0.8362145390070922,0.2390669377743353,0.20117696128084778,131226.4581758628,-561.5142353237773,130664.94394053901,2223,0,834.9166666666666,41,7,15,35.027756261296155,0.6239837398373984,43.84920634920634,1024.6031746031733,24.990321331784717,0
2237,4,0,0,48,0.0,0.0,1.0,48,1000,500,500,0.5,15,5,10,344.22847031473725,0.8365839243498818,0.24239398780133636,0.2012187815439115,131251.87119118462,-563.8738307823332,130687.99736040228,2224,1,835.9166666666666,41,7,15,35.00611143382709,0.6242378048780489,43.82440476190475,1024.7023809523794,24.99274099883852,0
2238,4,0,0,48,0.0,0.0,1.0,48,1200,800,400,0.6666666666666666,16,8,8,343.78539592499135,0.8360483156028369,0.240910553410554,0.20164099324754226,131381.5158420137,-566.5464232568233,130814.96941875688,2225,2,836.9166666666666,39,9,15,34.88662534715168,0.6287393162393163,43.69791666666666,1025.2083333333317,26.28739316239312,0
2239,4,0,0,48,0.0,0.0,1.0,48,1000,700,300,0.7,13,7,6,342.5052104995591,0.8351248522458629,0.24232188812135957,0.2011707214891204,131434.91753472216,-596.5711805555653,130838.3463541666,2226,3,837.9166666666666,39,9,16,34.86556955167276,0.6292735042735043,43.64583333333333,1025.416666666666,26.29273504273503,0
2240,4,0,0,48,0.0,0.0,1.0,48,1600,1100,500,0.6875,21,11,10,344.0316651515356,0.835438829787234,0.24455004568064198,0.20305907330184397,131621.90890842007,-543.5791015625055,131078.32980685757,2227,4,838.9166666666666,39,9,11,34.63787517341726,0.6311431623931625,43.463541666666664,1026.1458333333328,26.31143162393161,0
2241,4,0,0,48,0.0,0.0,1.0,48,1450,1100,350,0.7586206896551724,18,11,7,338.65539258675074,0.8358451536643026,0.23964568327077185,0.20072917647189453,131782.29302300356,-674.2431640624898,131108.04985894106,2228,5,839.9166666666666,39,9,12,34.614254675188526,0.6327457264957265,43.30729166666667,1026.7708333333342,26.327457264957285,0
2242,4,0,0,48,0.0,0.0,1.0,48,1100,700,400,0.6363636363636364,15,7,8,341.21227418081304,0.8351802600472813,0.24606906282740226,0.2031005829960992,131942.77479383702,-595.9011501735865,131346.87364366342,2229,6,840.9166666666666,39,9,12,34.387039947277714,0.6343482905982905,43.15104166666668,1027.395833333335,26.34348290598295,0
2243,4,0,0,48,0.0,0.0,1.0,48,1200,900,300,0.75,15,9,6,343.1310487581867,0.8350694444444444,0.2509647211808015,0.20510964992092975,132103.3542209204,-534.247504340254,131569.10671658014,2230,7,841.9166666666666,39,9,13,34.17614499949337,0.6359508547008547,42.99479166666668,1028.0208333333353,26.3595085470086,0
2244,4,0,1,47,0.0,0.020833333333333332,0.9791666666666666,48,1250,900,350,0.72,16,9,7,343.08001215030185,0.8345892434988179,0.2510314754422369,0.2055433181142042,132188.90587819772,-529.7257130345513,131659.18016516318,2231,8,842.9166666666666,40,8,13,34.09139572421516,0.6351562499999999,42.91158536585367,1028.353658536587,25.70884146341468,0
2245,4,0,0,47,0.0,0.0,1.0,47,1200,900,300,0.75,15,9,6,349.3735305077317,0.8334489670058587,0.24956289089196093,0.20884114915692378,132103.3542209205,-169.31694878468247,131934.0372721358,2232,9,860.1063829787234,39,8,13,34.0157099672375,0.6359508547008546,42.994791666666686,1028.0208333333362,26.35950854700862,0
2246,4,2,2,47,0.04081632653061224,0.04081632653061224,0.9591836734693877,49,1300,800,500,0.6153846153846154,18,8,10,332.7234584844625,0.8422264739229025,0.25204687815720406,0.19675099125837642,131692.96136558917,-1013.4123700885984,130679.54899550058,2233,0,825.9591836734694,40,9,12,34.85643564356436,0.6302083333333334,43.39430894308943,1026.4227642276414,25.660569105691035,3
2247,4,1,1,47,0.020833333333333332,0.020833333333333332,0.9791666666666666,48,1100,700,400,0.6363636363636364,15,7,8,338.2491747073745,0.8400930851063829,0.2573024490900475,0.2000664686414449,131702.08875868065,-690.3754340277692,131011.71332465288,2234,0,843.9375,39,9,12,34.705449563628974,0.6319444444444444,43.38541666666667,1026.4583333333342,26.319444444444464,0
2248,4,1,0,48,0.020833333333333332,0.0,1.0,48,900,700,200,0.7777777777777778,11,7,4,339.06081387284877,0.8368979018912529,0.2657291048222179,0.20132482873084664,131849.4747256924,-659.0019581598248,131190.47276753257,2235,0,844.9166666666666,40,8,13,34.53620786331551,0.6317708333333334,43.24186991869919,1027.0325203252034,25.675813008130085,0
2249,4,0,0,48,0.0,0.0,1.0,48,1750,1300,450,0.7428571428571429,22,13,9,329.9868577761422,0.8368055555555556,0.22358356104307897,0.1989383857038479,132424.80604383704,-794.5689611657199,131630.23708267132,2236,1,845.9166666666666,39,9,19,34.19114546435921,0.6391559829059827,42.68229166666668,1029.2708333333353,26.39155982905988,3
2250,4,0,0,48,0.0,0.0,1.0,48,1150,800,350,0.6956521739130435,15,8,7,329.7173949585636,0.8358451536643026,0.22823933569381216,0.19934290208962707,132532.04345703125,-860.375976562501,131671.66748046875,2237,2,846.9166666666666,39,9,19,34.09047799696509,0.640224358974359,42.578125,1029.6875,26.40224358974359,0
2251,4,0,0,48,0.0,0.0,1.0,48,1200,600,600,0.5,18,6,12,317.7699260847332,0.8351063829787234,0.17418664652948213,0.18807008921461835,131725.71228441817,-1192.4309202773645,130533.28136414081,2238,3,847.9166666666666,42,6,12,35.20723208105219,0.6274801587301586,43.362403100775204,1026.5503875969007,24.441675895164302,4
2252,4,0,1,47,0.0,0.020833333333333332,0.9791666666666666,48,1250,800,450,0.64,17,8,9,318.25339365653895,0.8347369976359338,0.17687968769211881,0.18879320573367123,131813.89534550055,-1209.9560950413152,130603.93925045924,2239,4,848.9166666666666,43,5,12,35.10620312307882,0.626937984496124,43.276515151515156,1026.89393939394,23.88125440451023,0
2253,4,0,0,47,0.0,0.0,1.0,47,1150,600,550,0.5217391304347826,17,6,11,321.31970146272084,0.8344896700585877,0.17322388904613684,0.1907936983643349,131850.0815474581,-926.7942318670729,130923.28731559103,2240,5,828.8510638297872,42,5,13,34.99111551404221,0.628720238095238,43.241279069767444,1027.0348837209303,24.45321151716501,0
2254,4,0,0,47,0.0,0.0,1.0,47,950,400,550,0.42105263157894735,15,4,11,320.37947343168196,0.8346053037311131,0.17550732869440244,0.1904847334744396,131899.84568422867,-948.3993787933437,130951.44630543533,2241,6,829.8510638297872,42,5,13,34.96525485017137,0.6292162698412698,43.19282945736434,1027.2286821705422,24.457825765965293,0
2255,4,0,1,46,0.0,0.02127659574468085,0.9787234042553191,47,1350,900,450,0.6666666666666666,18,9,9,321.0181108903771,0.8341042244835029,0.18267861226684223,0.19149145579883792,132024.29710504168,-923.5619103419319,131100.73519469975,2242,7,830.8510638297872,42,5,13,34.82384185052486,0.6304563492063493,43.07170542635659,1027.713178294573,24.469361387966025,0
2256,4,0,0,46,0.0,0.0,1.0,46,1800,1400,400,0.7777777777777778,22,14,8,319.0324459782313,0.831682769726248,0.1756086916482822,0.1910851258068182,132178.81159786787,-766.1340858872825,131412.67751198058,2243,8,816.0652173913044,43,3,15,34.71976010682383,0.6305717054263567,42.921401515151516,1028.3143939393938,23.914288231148692,0
2257,4,0,1,45,0.0,0.021739130434782608,0.9782608695652174,46,1150,900,250,0.782608695652174,14,9,5,323.3758384614744,0.8321859903381643,0.18909412052894115,0.1934709259441005,132136.6572993094,-653.4947542666166,131483.16254504278,2244,9,817.0652173913044,40,6,15,34.65042337978979,0.6346354166666666,42.962398373983746,1028.150406504066,25.70376016260165,1
2258,4,0,0,45,0.0,0.0,1.0,45,1300,900,400,0.6923076923076923,17,9,8,331.16669835094393,0.8332491582491582,0.18602891501148422,0.1978179769568474,132076.58420138908,-252.126736111092,131824.45746527798,2245,10,817.5555555555555,39,6,15,34.51053911633562,0.6356837606837606,43.02083333333334,1027.9166666666683,26.35683760683765,0
2259,4,0,0,45,0.0,0.0,1.0,45,1000,600,400,0.6,14,6,8,331.42775693544775,0.8326599326599327,0.18607102853001267,0.19842520974395622,132162.7802977725,-239.5172351113755,131923.2630626611,2246,11,818.5555555555555,40,5,15,34.41721025235554,0.6348958333333332,42.9369918699187,1028.2520325203252,25.70630081300813,0
2260,4,0,0,45,0.0,0.0,1.0,45,1200,900,300,0.75,15,9,6,335.06041942848,0.8324915824915825,0.1865517943442525,0.20117206074429142,132270.40939350295,-136.28423012721618,132134.12516337575,2247,12,819.5555555555555,41,4,15,34.215670910084555,0.6344004065040649,42.83234126984128,1028.6706349206363,25.08952768099113,0
2261,4,0,0,45,0.0,0.0,1.0,45,1300,1000,300,0.7692307692307693,16,10,6,329.4311046596023,0.8303451178451179,0.18451619812583675,0.1985966130646934,132423.5296693909,-275.1140676177861,132148.41560177313,2248,13,820.5555555555555,41,4,16,34.206726907630525,0.6359247967479674,42.68353174603175,1029.265873015873,25.104045683313977,0
2262,4,0,0,45,0.0,0.0,1.0,45,1050,600,450,0.5714285714285714,15,6,9,328.25487211298406,0.8284511784511785,0.18052263652032452,0.19842500394063262,132525.65906281496,-299.56134652934884,132226.0977162856,2249,14,821.5555555555555,41,4,16,34.13453046215115,0.6369410569105691,42.5843253968254,1029.6626984126985,25.113724351529232,0
2263,4,0,0,45,0.0,0.0,1.0,45,1300,900,400,0.6923076923076923,17,9,8,327.45582776979273,0.8284511784511785,0.17870682550385864,0.19821101738065416,132576.73852237655,-317.3948688271628,132259.34365354938,2250,15,822.5555555555555,41,4,17,34.10387165655203,0.6374491869918699,42.53472222222222,1029.861111111111,25.118563685636857,0
2264,4,0,0,45,0.0,0.0,1.0,45,1200,900,300,0.75,15,9,6,327.3437147585117,0.8280303030303031,0.17086115391200107,0.1985477297927797,132653.37616528096,-315.3502141597346,132338.02595112124,2251,16,823.5555555555555,41,4,13,34.02991782229071,0.6382113821138211,42.46031746031746,1030.1587301587306,25.12582268679831,0
2265,4,0,0,45,0.0,0.0,1.0,45,1300,1000,300,0.7692307692307693,16,10,6,331.46495075326646,0.8287878787878789,0.17971572496550858,0.2017334137888511,132781.15477962032,-197.54021400225008,132583.61456561807,2252,17,824.5555555555555,41,4,13,33.79566127634999,0.6394817073170731,42.33630952380953,1030.654761904763,25.137921022067392,0
2266,4,0,0,45,0.0,0.0,1.0,45,1150,700,450,0.6086956521739131,16,7,9,330.1800384487284,0.8277777777777778,0.1775425314641943,0.2012258521713045,132832.28344868062,-228.28630873642885,132603.9971399442,2253,18,825.5555555555555,41,4,13,33.77752782856961,0.6399898373983739,42.28670634920636,1030.8531746031765,25.142760356175035,0
2267,4,0,0,45,0.0,0.0,1.0,45,950,800,150,0.8421052631578947,11,8,3,326.1798534109293,0.8263468013468014,0.17310076525159257,0.19946857388588374,132960.14817964236,-326.2156714537552,132633.93250818862,2254,19,826.5555555555555,41,4,14,33.75256508913685,0.6412601626016259,42.16269841269842,1031.3492063492074,25.154858691444083,0
2268,4,0,0,45,0.0,0.0,1.0,45,1000,600,400,0.6,14,6,8,330.0612807921035,0.8247474747474748,0.1787946762374757,0.20267399308143225,133113.6670524692,-212.86651234567114,132900.8005401235,2255,20,827.5555555555555,41,4,14,33.49876626289817,0.6427845528455283,42.01388888888889,1031.944444444445,25.169376693766953,0
2269,4,0,0,45,0.0,0.0,1.0,45,1100,800,300,0.7272727272727273,14,8,6,337.9454911061849,0.8251683501683502,0.17897828121470294,0.19754606551419243,131251.87119118465,-128.32213325146824,131123.54905793318,2256,21,828.5555555555555,41,4,14,35.167066027689,0.6242378048780488,43.82440476190475,1024.7023809523796,24.992740998838528,4
2270,4,2,0,47,0.0425531914893617,0.0,1.0,47,1050,900,150,0.8571428571428571,12,9,3,332.8410991319019,0.8302883132901634,0.21056583017667285,0.19763489129966536,131850.08154745802,-622.9526431482652,131227.12890430976,2257,0,794.2553191489362,42,5,13,34.695293581155454,0.6287202380952381,43.24127906976744,1027.0348837209297,24.45321151716499,0
2271,4,1,0,48,0.020833333333333332,0.0,1.0,48,800,600,200,0.75,10,6,4,329.591252359024,0.8320220153664303,0.21750429949020322,0.1967757674975163,132057.11680010328,-895.0258981864091,131162.09090191688,2258,0,778.6875,43,5,14,34.57058841594497,0.6293604651162792,43.03977272727273,1027.840909090909,23.903276955602536,0
2272,4,1,0,49,0.02040816326530612,0.0,1.0,49,1200,800,400,0.6666666666666666,16,8,8,322.8332583622758,0.8332979024943311,0.2232869391795238,0.1942417975192187,132350.36115397798,-1254.5803326474677,131095.78082133053,2259,0,763.7755102040817,44,5,15,34.44989351810193,0.6309185606060606,42.754629629629626,1028.9814814814808,23.385942760942747,0
2273,4,0,0,49,0.0,0.0,1.0,49,1000,600,400,0.6,14,6,8,321.78672630008754,0.8315263605442177,0.22409212202248852,0.19411359417863905,132447.87089305045,-1275.9894972053112,131171.88139584515,2260,1,764.7755102040817,42,7,15,34.379020364617645,0.634672619047619,42.65988372093024,1029.3604651162802,24.508582502768576,0
2274,4,0,0,49,0.0,0.0,1.0,49,1300,900,400,0.6923076923076923,17,9,8,320.5674514466903,0.829719387755102,0.2194060520760026,0.19399950108418246,132568.61158638957,-1300.563608384975,131268.0479780046,2261,2,765.7755102040817,43,6,16,34.28936781609195,0.6344476744186045,42.54261363636364,1029.8295454545462,23.949524312896422,0
2275,4,0,0,49,0.0,0.0,1.0,49,1050,800,250,0.7619047619047619,13,8,5,323.6510596885813,0.8286918934240363,0.22378451380552233,0.19650242909663873,132690.54178145097,-1210.9131083562797,131479.6286730947,2262,3,766.7755102040817,43,6,11,34.08777573529412,0.6356589147286822,42.42424242424243,1030.3030303030312,23.960535588442585,0
2276,4,0,0,49,0.0,0.0,1.0,49,1050,600,450,0.5714285714285714,15,6,9,320.88612434312796,0.8279478458049887,0.21417847656443345,0.19553504227214266,132827.170138889,-1275.520833333323,131551.64930555568,2263,4,767.7755102040817,44,5,11,34.02216383724063,0.6356534090909091,42.29166666666667,1030.8333333333342,23.428030303030322,0
2277,4,0,1,48,0.0,0.02040816326530612,0.9795918367346939,49,1400,1000,400,0.7142857142857143,18,10,8,318.8766754215974,0.8258219954648526,0.20955654662655143,0.19493130685212698,132946.5063443074,-1321.2920096021821,131625.2143347052,2264,5,768.7755102040817,44,5,12,33.9545175674867,0.6368371212121211,42.17592592592593,1031.2962962962972,23.438552188552208,0
2278,4,0,0,48,0.0,0.0,1.0,48,1300,900,400,0.6923076923076923,17,9,8,323.83596920240575,0.8208850472813238,0.20666368309923877,0.19828809513894338,133007.82258845543,-985.4565721131909,132022.36601634225,2265,7,785.6875,43,5,13,33.76528122035558,0.6388081395348838,42.116477272727266,1031.5340909090896,23.989164904862548,0
2279,4,0,1,47,0.0,0.020833333333333332,0.9791666666666666,48,700,600,100,0.8571428571428571,8,6,2,327.52265831285024,0.8209958628841607,0.21184156189776981,0.2010712342329651,133105.52367603595,-880.9850099001344,132224.5386661358,2266,8,786.6875,43,5,13,33.572409072833494,0.6397771317829457,42.021780303030305,1031.912878787879,23.99797392529951,0
2280,4,0,0,47,0.0,0.0,1.0,47,1550,1200,350,0.7741935483870968,19,12,7,335.0424427948009,0.8189562133826703,0.20815815975830065,0.20550299141008282,133072.00588906906,-483.0460158644428,132588.9598732046,2267,10,804.2553191489362,42,5,13,33.41198660155272,0.6408730158730158,42.05426356589147,1031.7829457364332,24.56626061277222,0
2281,4,1,1,47,0.020833333333333332,0.020833333333333332,0.9791666666666666,48,850,600,250,0.7058823529411765,11,6,5,329.7209265542883,0.8235630910165485,0.20640152557400104,0.20321917819227855,133252.14256377704,-812.7960177054566,132439.34654607158,2268,0,788.4791666666666,43,5,14,33.36896954966523,0.6412306201550388,41.87973484848485,1032.4810606060612,24.01118745595491,0
2282,4,0,0,47,0.0,0.0,1.0,47,1100,700,400,0.6363636363636364,15,7,8,336.1801880514737,0.8176842429848905,0.20110897164452202,0.2067546976399709,133172.00363559872,-446.0421549185846,132725.96148068015,2269,12,806.2553191489362,42,5,14,33.282482162974084,0.6418650793650793,41.95736434108527,1032.1705426356582,24.575489110372814,0
2283,4,0,0,47,0.0,0.0,1.0,47,1650,1300,350,0.7878787878787878,20,13,7,335.14972420614686,0.8159111933395004,0.19835535507564583,0.20723295011818568,133372.11180217515,-460.0747025419353,132912.03709963322,2270,13,807.2553191489362,42,5,14,33.108778924327694,0.6438492063492064,41.76356589147286,1032.945736434107,24.593946105573973,0
2284,4,0,0,47,0.0,0.0,1.0,47,850,500,350,0.5882352941176471,12,5,7,309.53318171675176,0.8162966389145851,0.1505797677649945,0.18748970201769655,132602.28194286983,-1172.0250974340508,131430.25684543577,2271,14,808.2553191489362,41,6,17,34.53974828228345,0.6377032520325203,42.50992063492064,1029.9603174603183,25.12098335269069,4
2285,4,0,0,47,0.0,0.0,1.0,47,1350,800,550,0.5925925925925926,19,8,11,308.8045799554859,0.8157570151094665,0.15256216428826042,0.18755815014138472,132704.48022959195,-1204.0497448979477,131500.430484694,2272,15,809.2553191489362,41,6,12,34.456239168110926,0.6387195121951219,42.41071428571429,1030.3571428571438,25.130662020905945,0
2286,4,0,0,47,0.0,0.0,1.0,47,1550,1300,250,0.8387096774193549,18,13,5,307.9647339310574,0.8156028368794326,0.15183529064910828,0.1878151123833068,132857.8514739228,-1216.8934240362867,131640.95804988654,2273,16,810.2553191489362,41,6,14,34.32448036951503,0.6402439024390244,42.26190476190476,1030.9523809523803,25.145180023228786,0
2287,4,0,0,47,0.0,0.0,1.0,47,1300,1000,300,0.7692307692307693,16,10,6,307.5730876453653,0.8155642923219241,0.15639403043723843,0.18808998936242452,132960.14817964216,-1221.0073381204372,131739.14084152173,2274,17,811.2553191489362,41,6,15,34.232316916762855,0.641260162601626,42.16269841269841,1031.3492063492058,25.154858691444044,0
2288,4,0,0,47,0.0,0.0,1.0,47,850,600,250,0.7058823529411765,11,6,5,307.4408696620573,0.8149090348442799,0.15869365507730948,0.18839585171571793,133036.89654391847,-1219.804165879313,131817.09237803915,2275,18,812.2553191489362,41,6,15,34.15903372119114,0.6420223577235772,42.08829365079365,1031.6468253968253,25.162117692605495,0
2289,4,0,0,47,0.0,0.0,1.0,47,1450,1000,450,0.6896551724137931,19,10,9,308.6175152280486,0.8145621338267036,0.15444096005498653,0.18937644695498146,133088.0744224774,-1185.3378330498763,131902.7365894275,2276,19,813.2553191489362,41,6,16,34.077552639169305,0.6425304878048781,42.03869047619048,1031.8452380952388,25.166957026713142,0
2290,4,0,0,47,0.0,0.0,1.0,47,1550,1100,450,0.7096774193548387,20,11,9,309.56922209385823,0.8134057971014492,0.15401351641498073,0.19048301335816623,133190.45970529402,-1153.6665997417645,132036.79310555226,2277,20,814.2553191489362,41,6,16,33.95072481178921,0.6435467479674797,41.93948412698412,1032.2420634920622,25.176635694928347,0
2291,4,0,1,46,0.0,0.02127659574468085,0.9787234042553191,47,1350,1000,350,0.7407407407407407,17,10,7,310.11285827685043,0.8130974406413813,0.1574705264147933,0.19094878125614828,133216.06217718567,-1137.5972379692673,132078.4649392164,2278,21,815.2553191489362,41,6,16,33.91112499199179,0.6438008130081301,41.91468253968254,1032.3412698412696,25.179055361982186,0
2292,4,1,0,47,0.02127659574468085,0.0,1.0,47,950,700,250,0.7368421052631579,12,7,5,305.9963579604576,0.8140225100215849,0.165236787920384,0.1897177419354839,133472.2222222223,-1231.5972222222142,132240.6250000001,2279,0,809.7021276595744,41,6,17,33.76176075268816,0.646341463414634,41.66666666666667,1033.3333333333342,25.203252032520346,0
2293,4,0,0,47,0.0,0.0,1.0,47,950,600,350,0.631578947368421,13,6,7,305.9963579604576,0.8140225100215849,0.165236787920384,0.1897177419354839,133472.2222222223,-1231.5972222222142,132240.6250000001,2280,1,810.7021276595744,41,6,17,33.76176075268816,0.646341463414634,41.66666666666667,1033.3333333333342,25.203252032520346,0
2294,4,0,0,47,0.0,0.0,1.0,47,1300,1000,300,0.7692307692307693,16,10,6,307.12162127313087,0.8127119950662965,0.16135908849593616,0.1909431559466603,133574.75513353507,-1195.260928445441,132379.49420508964,2281,2,811.7021276595744,41,6,18,33.630438259756886,0.6473577235772356,41.56746031746032,1033.73015873016,25.21293070073561,0
2295,4,0,1,46,0.0,0.02127659574468085,0.9787234042553191,47,1250,800,450,0.64,17,8,9,306.9459700804797,0.8105534998458217,0.16677618555901552,0.19162986132090318,133728.62831475193,-1190.5072908793068,132538.12102387263,2282,3,812.7021276595744,41,6,15,33.481600485964584,0.648882113821138,41.4186507936508,1034.3253968253975,25.227448703058478,0
2296,4,0,1,45,0.0,0.021739130434782608,0.9782608695652174,46,1100,900,200,0.8181818181818182,13,9,4,316.7938955260821,0.8121779388083736,0.16886443756008962,0.19738995021297548,133656.05919302354,-731.7152695154792,132924.34392350807,2283,4,820.6739130434783,40,6,18,33.29934479934479,0.6497395833333333,41.48882113821139,1034.044715447156,25.8511178861789,0
2297,4,0,0,45,0.0,0.0,1.0,45,1200,700,500,0.5833333333333334,17,7,10,316.8096703970224,0.8130892255892256,0.15342664311274135,0.18199862329833683,130581.79253472263,-598.7995168632683,129982.99301785936,2284,5,789.9111111111112,39,6,16,36.38401956787606,0.6207264957264955,44.479166666666686,1022.0833333333366,26.20726495726504,7
2298,4,0,1,44,0.0,0.022222222222222223,0.9777777777777777,45,1300,1000,300,0.7692307692307693,16,10,6,315.4531318274468,0.8135942760942761,0.15219725591568944,0.1813044342811694,130599.97046235733,-760.3660602154505,129839.60440214188,2285,6,790.9111111111112,40,5,16,36.40033638231591,0.6192708333333332,44.46138211382115,1022.1544715447176,25.55386178861794,0
2299,4,0,0,44,0.0,0.0,1.0,44,1000,600,400,0.6,14,6,8,320.3630735262596,0.8128303382663848,0.15665468625525647,0.18429327101915094,130635.0314670141,-429.8719618055353,130205.15950520856,2286,7,788.0681818181819,39,5,16,36.23947082399293,0.6212606837606837,44.42708333333334,1022.2916666666683,26.21260683760688,0
2300,4,0,0,44,0.0,0.0,1.0,44,1250,900,350,0.72,16,9,7,317.6488833942892,0.8113768498942918,0.15681005203064036,0.18330380518808084,130755.83316808798,-493.1111193733668,130262.72204871461,2287,8,789.0681818181819,40,4,17,36.1869452172761,0.6208333333333333,44.308943089430905,1022.764227642278,25.56910569105695,0
2301,4,0,0,44,0.0,0.0,1.0,44,1150,900,250,0.782608695652174,14,9,5,317.9754992961909,0.812015503875969,0.15466237506658587,0.18411128823538528,130885.7897601463,-476.3051300482266,130409.48463009807,2288,9,790.0681818181819,40,4,19,36.047522097527086,0.6221354166666666,44.1819105691057,1023.272357723579,25.581808943089477,0
2302,4,0,0,44,0.0,0.0,1.0,44,1100,700,400,0.6363636363636364,15,7,8,320.76605224147744,0.8123458421423538,0.15831911609391525,0.18597783028922987,130937.79047070211,-399.9203722982177,130537.87009840389,2289,10,791.0681818181819,40,4,19,35.923691788303074,0.6226562499999999,44.13109756097562,1023.4756097560987,25.586890243902467,0
2303,4,1,0,45,0.022222222222222223,0.0,1.0,45,850,500,350,0.5882352941176471,12,5,7,323.63033821727214,0.8186447811447812,0.16005898701151366,0.18376574857032962,130129.69970703153,-519.3674003181725,129610.33230671336,2290,0,774.4666666666667,39,6,20,36.66677301344223,0.6161858974358974,44.921875000000014,1020.3125000000022,26.16185897435903,7
2304,4,1,1,45,0.021739130434782608,0.021739130434782608,0.9782608695652174,46,1250,1100,150,0.88,14,11,3,314.25221441554066,0.8215579710144928,0.1555162958213394,0.17980642860724036,130426.2332552598,-1002.517842650793,129423.715412609,2291,0,758.6086956521739,38,8,20,36.60639577450058,0.6208881578947367,44.63141025641026,1021.4743589743598,26.880904183535783,0
2305,4,0,0,45,0.0,0.0,1.0,45,850,600,250,0.7058823529411765,11,6,5,320.9120847651773,0.8172558922558923,0.1586292478045055,0.18310866013071903,130318.55955678683,-635.8398738073113,129682.71968297951,2292,2,776.4666666666667,37,8,21,36.54513888888891,0.6216216216216215,44.736842105263165,1021.0526315789484,27.596017069701308,0
2306,4,1,0,46,0.021739130434782608,0.0,1.0,46,1000,700,300,0.7,13,7,6,316.3767131379963,0.823389694041868,0.1694234404536863,0.18191661005434795,130617.28395061735,-935.1466049382614,129682.13734567909,2293,0,760.5652173913044,38,8,16,36.35926177536234,0.6228070175438596,44.44444444444445,1022.2222222222227,26.900584795321652,0
2307,4,0,0,46,0.0,0.0,1.0,46,1350,1100,250,0.8148148148148148,16,11,5,314.73567198406755,0.8219605475040258,0.1685651220143609,0.18161329643782267,130753.83434007234,-969.4208168967746,129784.41352317556,2294,1,761.5652173913044,38,8,17,36.26344928444585,0.6241776315789473,44.31089743589744,1022.7564102564104,26.914642375168693,0
2308,4,0,1,45,0.0,0.021739130434782608,0.9782608695652174,46,1600,1200,400,0.75,20,12,8,310.5893304958635,0.8203301127214171,0.16540304822762408,0.17995595846336876,130911.78882444323,-1068.0390310000535,129843.74979344317,2295,2,762.5652173913044,40,6,18,36.21027805362463,0.6223958333333333,44.15650406504066,1023.3739837398382,25.584349593495954,0
2309,4,1,0,46,0.021739130434782608,0.0,1.0,46,1250,900,350,0.72,16,9,7,308.3659102627726,0.8177133655394525,0.16994214420331022,0.17921860329133435,131030.32889399683,-1118.942671714432,129911.3862222824,2296,0,763.4347826086956,42,4,19,36.147785349233395,0.6205357142857142,44.04069767441861,1023.8372093023262,24.377076411960147,0
2310,4,0,0,46,0.0,0.0,1.0,46,900,500,400,0.5555555555555556,13,5,8,310.92518026797063,0.8175523349436393,0.17629513214626602,0.1809392789136518,131079.93810468138,-1048.7893230574919,130031.1487816239,2297,1,764.4347826086956,42,4,19,36.03232241988393,0.6210317460317459,43.99224806201551,1024.0310077519393,24.381690660760462,0
2311,4,0,0,46,0.0,0.0,1.0,46,1100,600,500,0.5454545454545454,16,6,10,312.3848477101753,0.8164452495974235,0.17954165004339218,0.18214121484524345,131154.36952594502,-1005.8724498227176,130148.4970761223,2298,2,765.4347826086956,42,4,19,35.92000914451487,0.6217757936507936,43.91957364341086,1024.321705426357,24.388612033960882,0
2312,4,0,0,46,0.0,0.0,1.0,46,1550,900,650,0.5806451612903226,22,9,13,309.3396787626415,0.817572463768116,0.17833156592435517,0.1811846689895471,131328.1250000001,-1074.7699582356686,130253.35504176441,2299,3,766.4347826086956,40,6,19,35.82317073170733,0.6265624999999999,43.75000000000001,1025.0000000000007,25.625000000000018,0
2313,4,1,1,46,0.02127659574468085,0.02127659574468085,0.9787234042553191,47,950,500,450,0.5263157894736842,14,5,9,301.88403627462736,0.82150015417823,0.18008780556047044,0.17799798763695526,131582.46429358778,-1455.4709152179398,130126.99337836984,2300,0,751.1063829787234,41,6,14,35.75871849416619,0.627540650406504,43.50198412698413,1025.9920634920632,25.024196670538124,0
2314,4,1,0,47,0.02127659574468085,0.0,1.0,47,1400,1100,300,0.7857142857142857,17,11,6,302.1784310329859,0.8238899167437558,0.18151313029961602,0.1788868652362321,131735.18597253715,-1438.4936381960242,130296.69233434112,2301,0,752.0851063829788,41,6,15,35.59786110037365,0.6290650406504066,43.3531746031746,1026.5873015873015,25.038714672861012,0
2315,4,1,1,47,0.020833333333333332,0.020833333333333332,0.9791666666666666,48,1500,900,600,0.6,21,9,12,296.4792457127339,0.8255023640661938,0.18558575803981614,0.17704228653346193,132064.68728566522,-1769.112225651586,130295.57506001364,2302,0,737.3958333333334,44,4,16,35.41385160496051,0.6280776515151516,43.032407407407405,1027.8703703703698,23.36069023569022,0
2316,4,0,0,47,0.0,0.0,1.0,47,1500,1000,500,0.6666666666666666,20,10,10,302.6229185108937,0.821345975948196,0.1855551264382238,0.18055890789437762,132032.7845661874,-1408.7706790920593,130624.01388709532,2303,2,754.0851063829788,43,4,16,35.28795801468104,0.6291182170542636,43.06344696969697,1027.7462121212118,23.901074700493297,0
2317,4,0,0,47,0.0,0.0,1.0,47,1050,700,350,0.6666666666666666,14,7,7,304.9527844648425,0.8221168670983656,0.19014095548691556,0.18229996851048091,132105.78799357222,-1342.7944214875893,130762.99357208463,2304,3,755.0851063829788,43,4,16,35.1549066568411,0.6298449612403101,42.99242424242425,1028.0303030303041,23.907681465821028,0
2318,4,0,1,46,0.0,0.02127659574468085,0.9787234042553191,47,1400,1000,400,0.7142857142857143,18,10,8,304.14777228497303,0.8225023126734504,0.18741111898988017,0.18252227085963435,132251.85537907504,-1355.1785611799667,130896.67681789507,2305,4,756.0851063829788,43,4,16,35.02923034431965,0.631298449612403,42.850378787878796,1028.5984848484866,23.92089499647643,0
2319,4,0,0,46,0.0,0.0,1.0,46,1600,1300,300,0.8125,19,13,6,307.0440683153921,0.8203502415458938,0.19814268050672545,0.185106921233947,132424.8060438369,-1067.626930706201,131357.1791131307,2306,5,770.0,39,7,16,34.78150406504065,0.639155982905983,42.68229166666667,1029.2708333333342,26.39155982905985,0
2320,4,2,2,46,0.041666666666666664,0.041666666666666664,0.9583333333333334,48,1250,900,350,0.72,16,9,7,292.6961413820077,0.8331117021276595,0.19015190686597072,0.1782145882015122,132797.20574372043,-1826.1540585000807,130971.05168522036,2307,0,738.875,42,6,14,34.778563818119146,0.6381448412698412,42.32073643410853,1030.7170542635668,24.540882244370636,0
2321,4,0,0,46,0.0,0.0,1.0,46,850,600,250,0.7058823529411765,11,6,5,306.15993954154226,0.8196859903381642,0.1986167958057672,0.1853419849052566,132581.09941998843,-1081.795723445009,131499.30369654341,2308,7,772.0,40,6,16,34.64780277613315,0.6390624999999999,42.530487804878064,1029.8780487804904,25.746951219512262,0
2322,4,0,0,46,0.0,0.0,1.0,46,1050,700,350,0.6666666666666666,14,7,7,302.975380856821,0.8181561996779388,0.1962397179788482,0.18392601264230288,132685.78247901413,-1159.894903827056,131525.88757518708,2309,8,773.0,40,6,14,34.62509041888604,0.6401041666666665,42.4288617886179,1030.284552845531,25.757113821138272,0
2323,4,0,1,45,0.0,0.021739130434782608,0.9782608695652174,46,1100,700,400,0.6363636363636364,15,7,8,303.19044559603543,0.817914653784219,0.19478638046907126,0.18482956010373702,132842.88452640633,-1144.661329235235,131698.2231971711,2310,9,774.0,40,6,14,34.46249014195583,0.6416666666666666,42.27642276422765,1030.89430894309,25.77235772357725,0
2324,4,0,0,45,0.0,0.0,1.0,45,1300,1200,100,0.9230769230769231,14,12,2,306.94265859811867,0.8175084175084175,0.19218378721680174,0.18751036464750845,132921.47040658692,-840.146097726201,132081.32430886073,2304,10,740.8666666666667,40,5,14,34.28722775204495,0.6424479166666666,42.20020325203253,1031.1991869918716,25.779979674796788,0
2325,4,0,0,45,0.0,0.0,1.0,45,900,800,100,0.8888888888888888,10,8,2,306.712305178033,0.8170454545454546,0.19421517449686498,0.18816012292885628,133078.71187991617,-836.6243018375192,132242.08757807864,2305,11,741.8666666666667,40,5,15,34.13605174168555,0.6440104166666667,42.04776422764228,1031.8089430894318,25.795223577235795,0
2326,4,0,1,44,0.0,0.022222222222222223,0.9777777777777777,45,950,700,250,0.7368421052631579,12,7,5,306.26500406639065,0.8170454545454546,0.19180180771671806,0.18801782655925836,133104.92782900407,-846.9237474386779,132258.0040815654,2306,12,742.8666666666667,40,5,15,34.121405357494595,0.6442708333333333,42.022357723577244,1031.9105691056923,25.797764227642308,0
2327,4,0,1,43,0.0,0.022727272727272728,0.9772727272727273,44,1150,800,350,0.6956521739130435,15,8,7,311.76720135219074,0.8093067300916138,0.19462858780950976,0.19059117827241184,132947.67086390397,-510.2553456936776,132437.4155182103,2307,18,760.4772727272727,40,4,15,34.13665254237288,0.6427083333333332,42.17479674796749,1031.3008130081319,25.782520325203297,0
2328,4,0,0,43,0.0,0.0,1.0,43,850,500,350,0.5882352941176471,12,5,7,311.8532418487265,0.8071705426356589,0.18991621895780852,0.19112589772709104,133042.01388888908,-302.0833333333152,132739.93055555577,2308,19,771.8139534883721,39,4,15,34.04011847065159,0.6452991452991452,42.08333333333334,1031.6666666666683,26.452991452991494,0
2329,4,0,0,43,0.0,0.0,1.0,43,1450,1000,450,0.6896551724137931,19,10,9,313.24298263251995,0.8062015503875969,0.18665202177020168,0.19267068373095242,133176.3793945314,-256.6867404513745,132919.69265408002,2309,20,772.8139534883721,39,4,17,33.869987721599905,0.6466346153846153,41.95312500000001,1032.1875000000011,26.46634615384618,0
2330,4,0,0,43,0.0,0.0,1.0,43,1150,1000,150,0.8695652173913043,13,10,3,314.9847535418267,0.8062476928755998,0.19105066649574054,0.1940527659934156,133236.04630387027,-206.53535841758674,133029.5109454527,2310,21,773.8139534883721,40,3,17,33.76542146536733,0.6455729166666666,41.89532520325204,1032.4186991869935,25.810467479674838,0
2331,4,0,0,43,0.0,0.0,1.0,43,1050,800,250,0.7619047619047619,13,8,5,313.5081264689516,0.8052325581395349,0.1871188258159644,0.19357174356712864,133318.49666950124,-240.7135770974919,133077.78309240376,2311,22,774.8139534883721,41,2,17,33.72118155619597,0.6448170731707317,41.8154761904762,1032.738095238096,25.188734030197466,0
2332,4,0,0,43,0.0,0.0,1.0,43,1050,700,350,0.6666666666666666,14,7,7,312.82518210197725,0.8032945736434108,0.1785446361590397,0.19395161290322593,133472.22222222228,-249.30555555554594,133222.91666666674,2312,23,775.8139534883721,41,2,17,33.585349462365606,0.646341463414634,41.66666666666667,1033.333333333334,25.20325203252034,0
2333,4,0,0,43,0.0,0.0,1.0,43,950,500,450,0.5263157894736842,14,5,9,314.83194703296107,0.803156146179402,0.17921250306376968,0.1960710156618402,133637.87187705454,-185.3057199211067,133452.56615713343,2313,24,776.8139534883721,38,5,18,33.36820624095887,0.6529605263157894,41.506410256410255,1033.974358974359,27.209851551956813,0
2334,4,0,0,43,0.0,0.0,1.0,43,1250,700,550,0.56,18,7,11,313.50829546272564,0.8032945736434108,0.1779711091788645,0.19583143978516837,133748.36205164727,-213.75579845131728,133534.60625319596,2314,25,777.8139534883721,38,5,16,33.29223473111617,0.6540570175438596,41.39957264957265,1034.401709401709,27.22109761583445,0
2335,4,0,0,43,0.0,0.0,1.0,43,800,600,200,0.75,10,6,4,311.0170504578129,0.8024178663713547,0.17668049714804845,0.1945227547321789,133795.334201389,-277.47395833332365,133517.86024305568,2315,26,778.8139534883721,39,4,16,33.30984024701302,0.6527777777777778,41.35416666666667,1034.5833333333342,26.5277777777778,0
2336,4,0,0,43,0.0,0.0,1.0,43,800,400,400,0.5,12,4,8,310.2641134467666,0.8019102990033222,0.1738768193104936,0.1947627602855668,133930.07948133693,-289.26052517359153,133640.81895616333,2316,27,779.8139534883721,39,4,17,33.195066418436156,0.6541132478632479,41.22395833333334,1035.1041666666679,26.54113247863251,0
2337,4,0,0,43,0.0,0.0,1.0,43,850,700,150,0.8235294117647058,10,7,3,309.90773615536284,0.8015411590992986,0.18043142576388593,0.1949672719863487,134010.95920138902,-293.7934027777582,133717.16579861127,2317,28,780.8139534883721,39,4,17,33.12374245472837,0.6549145299145298,41.14583333333334,1035.4166666666679,26.54914529914533,0
2338,4,0,1,42,0.0,0.023255813953488372,0.9767441860465116,43,900,400,500,0.4444444444444444,14,4,10,309.64066511806385,0.8016334440753045,0.1811820614043289,0.19537225722931661,134118.83680555568,-294.27083333332376,133824.56597222236,2318,29,781.8139534883721,39,4,18,33.02326360954679,0.655982905982906,41.04166666666667,1035.8333333333344,26.559829059829088,0
2339,4,0,0,42,0.0,0.0,1.0,42,1300,900,400,0.6923076923076923,17,9,8,315.51929411461197,0.7981755710414247,0.1857840176392307,0.19932186286836406,134163.10683988954,66.2097532690357,134229.31659315858,2319,30,790.547619047619,38,4,18,32.82694819703689,0.6581688596491229,40.99893162393162,1036.0042735042725,27.263270355375592,0
2340,4,0,0,42,0.0,0.0,1.0,42,1150,900,250,0.782608695652174,14,9,5,316.23681763293,0.7987562911343399,0.18329873431388388,0.20068318126176074,134329.1845300059,95.9667661991434,134425.15129620506,2320,31,791.547619047619,38,4,18,32.64303995327905,0.659813596491228,40.83867521367522,1036.6452991452998,27.2801394511921,0
2341,4,0,0,42,0.0,0.0,1.0,42,1150,1000,150,0.8695652173913043,13,10,3,318.5684891913291,0.7977158343012002,0.18623286163973352,0.20249238450897122,134388.72070312497,162.40234375000094,134551.12304687497,2321,32,792.547619047619,39,3,18,32.52335744424353,0.6586538461538461,40.78125,1036.8749999999998,26.586538461538456,0
2342,4,0,0,42,0.0,0.0,1.0,42,1000,600,400,0.6,14,6,8,317.22380264960407,0.7970141308555942,0.1787877918513523,0.20238512816062837,134523.76437717024,134.82801649306572,134658.5923936633,2322,33,793.547619047619,39,3,20,32.423875389095286,0.6599893162393162,40.65104166666667,1037.3958333333342,26.599893162393183,0
2343,4,0,0,42,0.0,0.0,1.0,42,1400,1200,200,0.8571428571428571,16,12,4,330.2980224200557,0.7984659310878823,0.15639404714868999,0.1985710913883989,132319.57250974915,345.538629827717,132665.11113957688,2323,34,794.547619047619,40,2,20,34.28877749242722,0.6364583333333336,42.78455284552844,1028.8617886178833,25.721544715447084,4
2344,4,0,0,42,0.0,0.0,1.0,42,1200,900,300,0.75,15,9,6,334.3805806722047,0.7981755710414247,0.15627853186438578,0.2017458156395026,132454.43309479853,458.10776313776347,132912.54085793628,2324,35,795.547619047619,37,5,20,34.048341854850165,0.6430180180180181,42.65350877192983,1029.3859649122817,27.82124229492653,0
2345,4,0,0,42,0.0,0.0,1.0,42,950,500,450,0.5263157894736842,14,5,9,336.15032419552244,0.7974738675958188,0.15784268979157212,0.20311785998686965,132510.87474030466,508.7147006771299,133019.5894409818,2325,36,796.547619047619,37,5,20,33.946130635427764,0.643581081081081,42.598684210526315,1029.6052631578943,27.827169274537685,0
2346,4,0,0,42,0.0,0.0,1.0,42,1550,1100,450,0.7096774193548387,20,11,9,331.607367297395,0.7962640340689121,0.15581900810116545,0.20079742592631195,132590.49236613335,393.59682043975846,132984.0891865731,2326,37,797.547619047619,38,4,20,33.98318637621023,0.6425438596491229,42.521367521367516,1029.9145299145293,27.103013945119194,0
2347,4,0,1,41,0.0,0.023809523809523808,0.9761904761904762,42,1050,800,250,0.7619047619047619,13,8,5,331.51555166357275,0.7953687572590011,0.15741342538430803,0.2012903819216941,132692.98095703125,397.95735677083326,133090.9383138021,2327,38,798.547619047619,39,3,16,33.88275957941564,0.6418269230769231,42.421875,1030.3125,26.41826923076923,0
2348,4,1,1,41,0.023809523809523808,0.023809523809523808,0.9761904761904762,42,1100,800,300,0.7272727272727273,14,8,6,327.55918114710283,0.799845141308556,0.15984539082831883,0.20003135929519858,132907.71620008672,307.0285373263843,133214.7447374131,2328,0,794.4285714285714,39,3,16,33.76950954641884,0.6439636752136753,42.213541666666664,1031.1458333333328,26.43963675213674,0
2349,4,0,0,41,0.0,0.0,1.0,41,900,600,300,0.6666666666666666,12,6,6,333.8571570702493,0.7946138211382113,0.1600620814996625,0.2034989076797749,132838.18354381263,669.7956616626568,133507.97920547528,2329,40,814.8048780487804,38,3,17,33.67684906898816,0.6450109649122806,42.28098290598291,1030.876068376069,27.128317588843924,0
2350,4,0,0,41,0.0,0.0,1.0,41,800,500,300,0.625,11,5,6,334.3539960804316,0.7946138211382113,0.1624213319853407,0.2039517106306047,132865.71905361972,684.8368215355431,133550.55587515526,2330,41,815.8048780487804,38,3,17,33.63644214162348,0.6452850877192982,42.254273504273506,1030.9829059829062,27.131129104813322,0
2351,4,0,0,41,0.0,0.0,1.0,41,1100,800,300,0.7272727272727273,14,8,6,342.04239605690697,0.7952235772357723,0.1002159036291641,0.19991033641570952,131246.00643080202,790.3389582876605,132036.3453890897,2331,42,816.8048780487804,38,3,17,35.068032530497334,0.6291118421052633,43.8301282051282,1024.6794871794864,26.965249662618064,4
2352,4,1,1,41,0.023809523809523808,0.023809523809523808,0.9761904761904762,42,1100,700,400,0.6363636363636364,15,7,8,339.4573423690382,0.8014663182346109,0.10087019579405365,0.20021885163682782,131595.18771701382,534.1905381944343,132129.37825520826,2332,0,798.3333333333334,39,3,16,34.7821489001692,0.6308760683760685,43.48958333333333,1026.041666666666,26.308760683760667,0
2353,4,1,1,41,0.023809523809523808,0.023809523809523808,0.9761904761904762,42,800,600,200,0.75,10,6,4,342.00194548007244,0.8014663182346109,0.10667401349496397,0.20200258794182668,131648.63281249985,604.817708333318,132253.45052083317,2333,0,799.3095238095239,39,3,16,34.6630125862769,0.6314102564102565,43.43749999999999,1026.2499999999989,26.314102564102534,0
2354,4,2,2,41,0.046511627906976744,0.046511627906976744,0.9534883720930233,43,750,400,350,0.5333333333333333,11,4,7,332.20947493182075,0.8074935400516795,0.09949023624040576,0.19712135902443012,131823.38271077056,158.59535081629502,131981.97806158685,2334,0,781.6744186046511,40,3,16,34.73837209302326,0.6315104166666667,43.26727642276422,1026.9308943089418,25.673272357723544,0
2355,4,0,0,41,0.0,0.0,1.0,41,1050,800,250,0.7619047619047619,13,8,5,345.50455427689536,0.7939532520325203,0.10912627868469404,0.20382221985720522,131602.03904594918,893.8207685002415,132495.85981444942,2335,46,820.8048780487804,38,3,17,34.62012355962793,0.6326754385964912,43.482905982905976,1026.068376068375,27.001799370220397,0
2356,4,0,0,41,0.0,0.0,1.0,41,1200,1000,200,0.8333333333333334,14,10,4,345.71350130788886,0.7935975609756097,0.1123200178712862,0.20453296308905136,131711.6845642485,906.9015267733048,132618.58609102183,2336,47,821.8048780487804,38,3,17,34.50423258395781,0.6337719298245614,43.37606837606837,1026.4957264957252,27.013045434098032,0
2357,4,0,0,41,0.0,0.0,1.0,41,750,500,250,0.6666666666666666,10,5,5,343.4786572963572,0.7942073170731707,0.11828202551688416,0.20379733666250507,131821.37573964478,855.565828402347,132676.94156804713,2337,48,822.8048780487804,38,3,17,34.4510767790262,0.6348684210526316,43.26923076923076,1026.9230769230755,27.02429149797567,0
2358,4,0,0,41,0.0,0.0,1.0,41,1100,600,500,0.5454545454545454,16,6,10,340.073499183379,0.7936991869918699,0.11057701817894094,0.20256551907879522,131969.53125,775.868055555555,132745.39930555556,2338,49,823.8048780487804,39,2,17,34.38936198972696,0.6346153846153847,43.125,1027.5,26.346153846153847,0
2359,4,1,0,42,0.023809523809523808,0.0,1.0,42,1200,900,300,0.75,15,9,6,332.7048925468681,0.7986837011227255,0.11772604350382143,0.20015668669263437,132345.71358194508,406.4132832639125,132752.126865209,2339,0,805.1666666666666,40,2,18,34.20061728395061,0.6367187500000002,42.759146341463406,1028.9634146341448,25.724085365853618,0
2360,4,0,0,42,0.0,0.0,1.0,42,950,500,450,0.5263157894736842,14,5,9,331.4958756484418,0.7979336043360433,0.11539836159626882,0.19956761217693922,132371.85723610263,376.14494513846154,132748.00218124109,2340,1,806.1666666666666,40,2,18,34.205469418658254,0.6369791666666667,42.73373983739837,1029.0650406504049,25.72662601626012,0
2361,4,0,0,42,0.0,0.0,1.0,42,750,400,350,0.5333333333333333,11,4,7,329.9063454921444,0.7980061943476577,0.11920083030617556,0.19903867494156632,132452.9860312113,339.42127813939493,132792.4073093507,2341,2,807.1666666666666,38,4,18,34.164936862134574,0.641173245614035,42.654914529914535,1029.3803418803427,27.08895636527218,0
2362,4,0,0,42,0.0,0.0,1.0,42,1250,900,350,0.72,16,9,7,329.5649142887478,0.7967963608207511,0.10983596840873067,0.19970680946937874,132618.00219382346,341.2481052304761,132959.25029905394,2342,3,808.1666666666666,38,4,20,34.008185527089175,0.6428179824561404,42.49465811965812,1030.0213675213672,27.10582546108861,0
2363,4,0,1,41,0.0,0.023809523809523808,0.9761904761904762,42,1050,700,350,0.6666666666666666,14,7,7,333.4907902530379,0.7954897406116919,0.10818315094255815,0.20297701284360006,132783.1210849042,456.38959657392405,133239.51068147813,2343,4,809.1666666666666,38,4,18,33.741491309906365,0.6444627192982455,42.334401709401725,1030.6623931623953,27.12269455690514,0
2364,4,0,1,40,0.0,0.024390243902439025,0.975609756097561,41,900,500,400,0.5555555555555556,13,5,8,338.62130946730366,0.7954776422764228,0.10396743814181364,0.20553525993247995,132680.27181440472,785.6734764543196,133465.94529085903,2344,5,823.8048780487804,37,4,18,33.712484035759886,0.6452702702702702,42.4342105263158,1030.2631578947392,27.844950213371327,0
2365,4,0,0,40,0.0,0.0,1.0,40,950,800,150,0.8421052631578947,11,8,3,338.62130946730366,0.7943376068376068,0.10113878246062091,0.20553525993247995,132680.27181440472,985.67347645432,133665.94529085903,2345,6,830.075,37,3,18,33.712484035759886,0.6452702702702702,42.4342105263158,1030.2631578947392,27.844950213371327,0
2366,4,0,0,40,0.0,0.0,1.0,40,1550,1100,450,0.7096774193548387,20,11,9,339.8927088712902,0.7931891025641026,0.09945089100704507,0.20763572316618323,132920.79863393973,1035.7620626050225,133956.56069654477,2346,7,831.075,38,2,18,33.43844971681171,0.6458333333333333,42.200854700854705,1031.196581196582,27.136752136752158,0
2367,4,0,0,40,0.0,0.0,1.0,40,1150,900,250,0.782608695652174,14,9,5,339.6432219710517,0.7928418803418803,0.10163386846193667,0.2079426320945151,133003.43940618375,1034.743338629554,134038.1827448133,2347,8,832.075,38,2,18,33.36203176247195,0.6466557017543859,42.120726495726494,1031.5170940170938,27.145186684660363,0
2368,4,0,0,40,0.0,0.0,1.0,40,800,600,200,0.75,10,6,4,339.6432219710517,0.7932959401709402,0.10163386846193667,0.2079426320945151,133003.43940618375,1034.743338629554,134038.1827448133,2348,9,833.075,38,2,18,33.36203176247195,0.6466557017543859,42.120726495726494,1031.5170940170938,27.145186684660363,0
2369,4,1,0,41,0.024390243902439025,0.0,1.0,41,850,400,450,0.47058823529411764,13,4,9,334.93246682412865,0.7980691056910569,0.10060176050620684,0.20675719029230463,133310.812717014,730.0238715277882,134040.83658854177,2349,0,813.7317073170732,39,2,19,33.17572792683747,0.6479700854700854,41.82291666666667,1032.7083333333342,26.479700854700877,0
2370,4,0,0,41,0.0,0.0,1.0,41,600,500,100,0.8333333333333334,7,5,2,334.75058990884446,0.7980182926829268,0.10155550526864654,0.20694431730274954,133364.60503472234,728.7760416666729,134093.38107638902,2350,1,814.7317073170732,39,2,19,33.12659674599972,0.6485042735042735,41.770833333333336,1032.9166666666674,26.485042735042754,0
2371,4,0,0,41,0.0,0.0,1.0,41,1050,700,350,0.6666666666666666,14,7,7,334.7756265379447,0.7974085365853658,0.09957753153389359,0.20818052457462385,133582.64391116935,744.0860647691368,134326.72997593848,2351,2,815.7317073170732,38,3,20,32.907882044922154,0.6524122807017545,41.55982905982905,1033.760683760682,27.20422852001795,0
2372,4,0,0,41,0.0,0.0,1.0,41,1150,1000,150,0.8695652173913043,13,10,3,333.0195724524353,0.7970528455284552,0.09822630154385825,0.20739790361613034,133637.87187705433,700.8053911899764,134338.6772682443,2352,3,816.7317073170732,38,3,20,32.89806778259969,0.6529605263157896,41.50641025641024,1033.974358974357,27.209851551956763,0
2373,4,1,1,41,0.023809523809523808,0.023809523809523808,0.9761904761904762,42,500,200,300,0.4,8,2,6,326.0220117223961,0.8036924119241192,0.09898866441392906,0.2043551221742588,133876.17323133672,329.3158637152736,134205.489095052,2353,0,798.2619047619048,39,3,16,32.8410711290052,0.6535790598290598,41.276041666666664,1034.8958333333328,26.535790598290586,0
2374,4,0,0,41,0.0,0.0,1.0,41,750,600,150,0.8,9,6,3,331.89300025941657,0.7945630081300813,0.09544008483563182,0.20747062114344259,133775.99172921665,679.8630515377079,134455.85478075437,2354,5,818.7317073170732,38,3,16,32.78920961134636,0.6543311403508772,41.372863247863236,1034.508547008545,27.22390913180382,0
2375,4,0,0,41,0.0,0.0,1.0,41,850,500,350,0.5882352941176471,12,5,7,331.7721025291404,0.7941056910569105,0.09299724967509926,0.20755045483799683,133803.62426035493,678.4619493753981,134482.08620973033,2355,6,819.7317073170732,38,3,16,32.764740809582825,0.6546052631578948,41.34615384615384,1034.6153846153836,27.226720647773252,0
2376,4,0,0,41,0.0,0.0,1.0,41,1200,800,400,0.6666666666666666,16,8,8,333.4503108530851,0.7941565040650407,0.08948797107215345,0.20891330601054214,133858.89788333693,727.0582219300088,134585.95610526693,2356,7,820.7317073170732,38,3,17,32.6661332507399,0.6551535087719298,41.29273504273504,1034.8290598290594,27.232343679712088,0
2377,4,0,0,41,0.0,0.0,1.0,41,850,600,250,0.7058823529411765,11,6,5,334.2760967045227,0.7933434959349593,0.0862609431297161,0.20958786723473863,133886.5389751808,751.0139299802788,134637.55290516108,2357,8,821.7317073170732,38,3,17,32.617167337669045,0.6554276315789473,41.26602564102564,1034.9358974358975,27.23515519568151,0
2378,4,0,1,40,0.0,0.024390243902439025,0.975609756097561,41,900,700,200,0.7777777777777778,11,7,4,333.1365200471586,0.7922256097560976,0.08757834327569292,0.20934454469889527,133969.4793721235,726.0252301117582,134695.50460223525,2358,9,822.7317073170732,38,3,17,32.56385448916408,0.65625,41.18589743589743,1035.2564102564095,27.243589743589723,0
2379,4,0,0,40,0.0,0.0,1.0,40,700,300,400,0.42857142857142855,11,3,8,339.45140053907363,0.7864850427350427,0.0797255774528507,0.21273189364460635,133869.08111149565,1088.409414435191,134957.49052593083,2359,20,844.075,37,3,17,32.50070636434274,0.6570945945945947,41.282894736842096,1034.8684210526299,27.969416785206214,0
2380,4,1,0,41,0.024390243902439025,0.0,1.0,41,700,300,400,0.42857142857142855,11,3,8,330.32224808253756,0.7909044715447154,0.08383809154801836,0.20872840402979131,134172.79188368045,664.051649305547,134836.84353298598,2360,0,824.4634146341464,39,2,18,32.43389302232054,0.6565170940170941,40.98958333333333,1036.0416666666658,26.56517094017092,0
2381,4,0,0,41,0.0,0.0,1.0,41,1200,900,300,0.75,15,9,6,330.37715385959604,0.7901930894308943,0.0837000409405042,0.20922484428702232,134253.74484592018,670.8740234375053,134924.61886935768,2361,1,825.4634146341464,39,2,18,32.35176483398667,0.6573183760683761,40.911458333333336,1036.354166666667,26.57318376068377,0
2382,4,0,0,41,0.0,0.0,1.0,41,1200,1000,200,0.8333333333333334,14,10,4,330.4419549134018,0.7897865853658537,0.08011801809970232,0.20988441463006322,134361.7201063369,679.7498914930661,135041.46999782996,2362,2,826.4634146341464,39,2,18,32.24247714257008,0.6583867521367521,40.80729166666667,1036.7708333333342,26.583867521367544,0
2383,4,1,2,40,0.023809523809523808,0.047619047619047616,0.9523809523809523,42,1150,900,250,0.782608695652174,14,9,5,314.83065354589036,0.792803910181959,0.048650489815107445,0.19604824762211526,133633.72938368097,20.39116753476233,133654.12055121572,2363,0,807.7619047619048,39,3,19,33.37237222110282,0.6511752136752136,41.510416666666686,1033.9583333333367,26.51175213675222,5
2384,4,0,2,38,0.0,0.05,0.95,40,1050,700,350,0.6666666666666666,14,7,7,335.62159301693237,0.7823985042735043,0.06938430311231425,0.19841948579161028,131684.26890432084,839.2168209876417,132523.48572530848,2364,1,848.475,38,2,14,34.790820929183575,0.6334978070175439,43.40277777777777,1026.3888888888878,27.010233918128627,4
2385,4,0,0,38,0.0,0.0,1.0,38,850,700,150,0.8235294117647058,10,7,3,345.84459620030555,0.7772641062114747,0.08336509476456122,0.20441165043901333,131674.6370525931,1507.7923362551726,133182.42938884828,2365,76,886.1052631578947,36,2,14,34.538210445468515,0.6371527777777778,43.41216216216216,1026.3513513513512,28.509759759759756,0
2386,4,1,1,38,0.02564102564102564,0.02564102564102564,0.9743589743589743,39,1000,800,200,0.8,12,8,4,338.9927067936307,0.7847503373819164,0.07640604354570013,0.20225198222639698,132031.50398439888,1151.5433835410672,133183.04736793996,2366,0,864.3589743589744,37,2,14,34.354773462783164,0.638795045045045,43.06469298245613,1027.741228070174,27.77678994784254,0
2387,4,0,0,38,0.0,0.0,1.0,38,650,500,150,0.7692307692307693,8,5,3,347.2973559564635,0.7787162162162162,0.0777645714813231,0.20652193487841336,131905.89871966562,1562.1139720801912,133468.01269174583,2367,78,888.1052631578947,36,2,14,34.26788715924871,0.6394675925925926,43.18693693693694,1027.2522522522524,28.53478478478479,0
2388,4,0,0,38,0.0,0.0,1.0,38,800,500,300,0.625,11,5,6,348.635466316382,0.7774419155998104,0.07689401586157163,0.20779220314415328,131992.67415641996,1603.465500973949,133596.1396573939,2368,79,889.1052631578947,36,2,16,34.14611872146118,0.6403356481481481,43.10247747747748,1027.5900900900904,28.544169169169177,0
2389,4,0,0,38,0.0,0.0,1.0,38,950,900,50,0.9473684210526315,10,9,1,349.5945642931193,0.7774122807017544,0.07361460391593289,0.2090432802813957,132116.03570329322,1637.4095875653907,133753.44529085862,2369,80,890.1052631578947,37,1,16,33.9972625142207,0.6396396396396395,42.98245614035087,1028.0701754385957,27.785680417259343,0
2390,4,0,0,38,0.0,0.0,1.0,38,950,700,250,0.7368421052631579,12,7,5,362.51386809620277,0.7770862968231389,0.06709583580240297,0.2023863137885656,129466.28146701382,1953.410514533312,131419.69198154713,2370,81,891.1052631578947,35,3,17,36.34958205390652,0.6169642857142856,45.572916666666664,1017.7083333333327,29.077380952380935,8
2391,4,0,0,38,0.0,0.0,1.0,38,1050,800,250,0.7619047619047619,13,8,5,359.74769731346424,0.7774715504978663,0.061694643519460746,0.2015961936919654,129613.56122470845,1725.6360382373107,131339.19726294576,2371,82,892.1052631578947,35,3,19,36.27008032128515,0.618452380952381,45.42824074074074,1018.2870370370366,29.09391534391533,0
2392,4,0,0,38,0.0,0.0,1.0,38,1200,900,300,0.75,15,9,6,358.77937918578175,0.7773530109056425,0.0669391636117902,0.2015071675950265,129701.96926708249,1706.8784025634395,131408.84766964594,2372,83,893.1052631578947,35,3,19,36.20481100632503,0.6193452380952381,45.34143518518518,1018.6342592592594,29.10383597883598,0
2393,4,1,0,39,0.02564102564102564,0.0,1.0,39,1150,800,350,0.6956521739130435,15,8,7,350.7070064241033,0.7826698155645524,0.06884230316209172,0.19850016563604256,130004.05811216628,1318.6668087006033,131322.7249208669,2373,0,871.1794871794872,36,3,20,36.103596142520615,0.6203703703703705,45.04504504504505,1019.8198198198203,28.32832832832834,0
2394,4,1,1,39,0.025,0.025,0.975,40,700,400,300,0.5714285714285714,10,4,6,344.35651811745146,0.7935630341880342,0.06459183673469471,0.1962031324157571,130262.58680555545,971.3541666666615,131233.9409722221,2374,0,850.375,37,3,20,36.003401360544224,0.6210585585585586,44.791666666666664,1020.8333333333325,27.590090090090065,0
2395,4,1,1,39,0.025,0.025,0.975,40,900,500,400,0.5555555555555556,13,5,8,343.3931451030033,0.7907318376068376,0.06025875026841376,0.19621863518339713,130374.54433094796,953.9449638350293,131328.48929478298,2375,0,851.35,37,3,21,35.91457304416293,0.6221846846846846,44.68201754385965,1021.2719298245612,27.601944049312465,0
2396,4,0,0,39,0.0,0.0,1.0,39,1250,700,550,0.56,18,7,11,347.10254551581625,0.7829509671614935,0.06331215198536277,0.1980603385897988,130320.07250071004,1246.8857793604268,131566.95828007048,2376,3,874.1794871794872,36,3,21,35.87505974045072,0.6235532407407408,44.73536036036035,1021.0585585585575,28.362737737737707,0
2397,4,0,0,39,0.0,0.0,1.0,39,900,700,200,0.7777777777777778,11,7,4,342.65047754355516,0.783344579397211,0.06209582598471508,0.19624527350221785,130463.84222059888,1140.6995678110438,131604.54178840993,2377,4,875.1794871794872,36,3,22,35.843116181657855,0.625,44.59459459459459,1021.6216216216208,28.378378378378354,0
2398,4,0,0,39,0.0,0.0,1.0,39,1050,800,250,0.7619047619047619,13,8,5,348.04672690298463,0.7821637426900585,0.0634388010462037,0.2002261208381045,130636.47050766961,1293.5191948705206,131929.98970254013,2378,5,876.1794871794872,36,3,16,35.53049496952339,0.6267361111111112,44.42567567567566,1022.2972972972956,28.3971471471471,0
2399,4,0,0,39,0.0,0.0,1.0,39,1400,1300,100,0.9285714285714286,15,13,2,348.73915116235906,0.7808704453441296,0.057419185460581446,0.2013730267010619,130780.41459956561,1321.6501552227694,132102.0647547884,2379,6,877.1794871794872,36,3,17,35.367123564167485,0.6281828703703705,44.2849099099099,1022.8603603603591,28.412787787787753,0
2400,4,2,3,38,0.04878048780487805,0.07317073170731707,0.926829268292683,41,700,400,300,0.5714285714285714,10,4,6,333.08897324180924,0.7878556910569106,0.04726976779673975,0.19453856597983823,131218.63928153968,541.4963656950578,131760.13564723474,2380,0,835.3414634146342,38,3,18,35.32499131039277,0.6288377192982457,43.856837606837594,1024.5726495726476,26.962438146648623,0
2401,4,0,0,38,0.0,0.0,1.0,38,1200,900,300,0.75,15,9,6,359.46663937795086,0.7733522996680892,0.028535460835484194,0.19981337174799818,129294.84941188476,1733.857448467975,131028.70686035273,2381,92,902.1052631578947,33,5,20,36.60167389645339,0.6196338383838385,45.741421568627445,1017.0343137254895,30.819221628045135,4
2402,4,0,0,38,0.0,0.0,1.0,38,1050,900,150,0.8571428571428571,12,9,3,359.42928022236947,0.7720187292555714,0.030589212460134796,0.2001088165745062,129357.17520004313,1698.951274750082,131056.12647479321,2382,93,903.1052631578947,33,5,20,36.53914688993295,0.6202651515151516,45.68014705882352,1017.279411764705,30.826648841354697,0
2403,4,2,2,38,0.05,0.05,0.95,40,850,500,350,0.5882352941176471,12,5,7,344.3176838311052,0.7880608974358975,0.032325383304940836,0.1939678314864285,129819.89354263099,939.8570119598594,130759.75055459085,2383,0,858.9,35,5,17,36.45336456558775,0.6205357142857144,45.225694444444436,1019.0972222222207,29.117063492063448,0
2404,4,1,1,38,0.02564102564102564,0.02564102564102564,0.9743589743589743,39,750,500,250,0.6666666666666666,10,5,5,352.98124437607805,0.7780589293747189,0.029620838877501443,0.19816978522845916,129685.9693877548,1355.3429705215071,131041.31235827631,2384,0,881.8974358974359,34,5,17,36.36872759856631,0.6213235294117648,45.35714285714284,1018.571428571426,29.957983193277236,0
2405,4,1,1,38,0.02564102564102564,0.02564102564102564,0.9743589743589743,39,950,500,450,0.5263157894736842,14,5,9,353.4193985471789,0.7790710751237068,0.02412039221855178,0.19864607573513837,129731.44531249991,1369.921874999985,131101.36718749988,2385,0,882.8717948717949,35,4,17,36.311349693251515,0.6196428571428572,45.31249999999999,1018.7499999999993,29.107142857142836,0
2406,4,0,0,38,0.0,0.0,1.0,38,1200,900,300,0.75,15,9,6,362.0776759586011,0.7734115694642011,0.03013011781352848,0.20311964051316914,129655.65653344657,1789.0837585033805,131444.74029194994,2386,97,907.1052631578947,34,4,17,36.1679329826612,0.6210171568627452,45.38690476190475,1018.4523809523798,29.954481792717054,0
2407,4,0,0,38,0.0,0.0,1.0,38,700,600,100,0.8571428571428571,8,6,2,358.8570212051544,0.7745673304883831,0.03149407756362188,0.20178044595753655,129746.60572562338,1712.096088435351,131458.70181405873,2387,98,908.1052631578947,34,4,18,36.15744527537587,0.621936274509804,45.29761904761904,1018.8095238095221,29.96498599439771,0
2408,4,1,0,39,0.02564102564102564,0.0,1.0,39,1150,700,450,0.6086956521739131,16,7,9,368.47249788564625,0.7858749437696806,0.07528033711877691,0.19673055731848182,127688.85598013572,1609.9663430322428,129298.82232316796,2388,0,885.7948717948718,36,3,18,38.01508820798515,0.5969328703703702,47.32545045045046,1010.6981981981996,28.07494994994999,4
2409,4,2,0,41,0.04878048780487805,0.0,1.0,41,650,400,250,0.6153846153846154,9,4,5,354.4513878304458,0.8051829268292683,0.08892903743852254,0.19140374942844085,128144.53125000012,884.2013888889031,129028.73263888902,2389,0,843.5365853658536,38,3,20,37.90294924554185,0.597861842105263,46.87500000000001,1012.5000000000009,26.64473684210529,0
2410,4,1,0,42,0.023809523809523808,0.0,1.0,42,850,700,150,0.8235294117647058,10,7,3,352.4722908389565,0.8110723964382501,0.08395502216455819,0.1923313402931864,128561.19340806789,662.8516707063723,129224.04507877426,2390,0,824.4285714285714,37,5,15,37.527367823548474,0.6038851351351351,46.463815789473685,1014.1447368421055,27.4093172119488,0
2411,4,0,1,41,0.0,0.023809523809523808,0.9761904761904762,42,1050,800,250,0.7619047619047619,13,8,5,348.09850323179563,0.8105884630274874,0.0762927749027158,0.19041148540836017,128658.86843450952,557.1919059098587,129216.06034041938,2391,1,825.4285714285714,38,4,15,37.538612749227745,0.6030701754385964,46.36752136752137,1014.529914529915,26.69815564552408,0
2412,4,0,0,41,0.0,0.0,1.0,41,1250,1000,250,0.8,15,10,5,352.9113907015165,0.8021341463414634,0.0707559604778929,0.19297495193678643,128644.60699445964,880.0294321329429,129524.63642659258,2392,2,846.5121951219512,37,4,16,37.431095979247715,0.6047297297297298,46.38157894736841,1014.4736842105248,27.418207681365534,0
2413,4,0,0,41,0.0,0.0,1.0,41,850,700,150,0.8235294117647058,10,7,3,354.2793899132015,0.8026422764227642,0.0684349922915759,0.19413000317623888,128728.04763244434,921.1388359879666,129649.18646843231,2393,3,847.5121951219512,37,4,17,37.31125067531064,0.6055743243243243,46.29934210526314,1014.8026315789454,27.427098150782307,0
2414,4,1,0,42,0.023809523809523808,0.0,1.0,42,1300,1000,300,0.7692307692307693,16,10,6,345.6058387859628,0.8069589624467673,0.08923878602213553,0.19125935685694354,129119.93805473349,524.9208990795272,129644.85895381302,2394,0,828.3095238095239,38,4,18,37.13208241353937,0.6077302631578949,45.913461538461526,1016.3461538461519,26.745951417003997,0
2415,4,1,1,42,0.023255813953488372,0.023255813953488372,0.9767441860465116,43,1400,900,500,0.6428571428571429,19,9,10,339.8186094584184,0.8161683277962347,0.0961002615454869,0.18935591678598704,129391.54071015041,193.95637007815472,129585.49708022857,2395,0,810.0232558139535,38,5,18,37.00295775140887,0.6104714912280702,45.646367521367516,1017.4145299145293,26.77406657669814,0
2416,4,2,1,43,0.045454545454545456,0.022727272727272728,0.9772727272727273,44,900,600,300,0.6666666666666666,12,6,6,331.50580668364546,0.8196573291050036,0.1134504554749951,0.1863291258256352,129731.44531250001,-198.6545138888884,129532.79079861112,2396,0,792.5681818181819,39,5,15,36.86946148602589,0.6121794871794872,45.3125,1018.7500000000001,26.121794871794876,0
2417,4,0,0,43,0.0,0.0,1.0,43,1000,800,200,0.8,12,8,4,338.1213472779897,0.813030638612034,0.11064994766160874,0.1894552945859209,129609.02829141993,164.7158530571823,129773.74414447711,2397,1,812.0,38,5,15,36.82522820270696,0.6126644736842106,45.4326923076923,1018.2692307692292,26.7965587044534,0
2418,4,0,0,43,0.0,0.0,1.0,43,1350,900,450,0.6666666666666666,18,9,9,340.0601444560049,0.8115540789959395,0.11329342719569158,0.1909383637952619,129690.63321827733,220.52309335961672,129911.15631163695,2398,2,813.0,38,5,15,36.69301971890076,0.6134868421052633,45.352564102564095,1018.5897435897426,26.804993252361648,0
2419,4,1,0,44,0.022727272727272728,0.0,1.0,44,750,700,50,0.9333333333333333,8,7,1,333.88520668942334,0.8184681113460184,0.12139089330324415,0.1888158456546947,129970.32470703126,-120.9662543402772,129849.35845269098,2399,0,795.5,39,5,16,36.56666070759697,0.6145833333333334,45.078125,1019.6875000000001,26.145833333333336,0
2420,4,0,0,44,0.0,0.0,1.0,44,1150,700,450,0.6086956521739131,16,7,9,334.8378621096349,0.8172788935870332,0.1222249561285409,0.1896123486359416,130023.43885633662,-92.64594184029727,129930.79291449633,2400,1,796.5,39,5,16,36.48854815647022,0.6151175213675215,45.02604166666666,1019.8958333333319,26.151175213675177,0
2421,4,0,0,44,0.0,0.0,1.0,44,1350,1100,250,0.8148148148148148,16,11,5,335.3827717020367,0.8172788935870332,0.11944042013763179,0.19045492239188042,130132.9400489126,-71.13077533215244,130061.80927358045,2401,2,797.5,40,4,16,36.36371181938911,0.6145833333333335,44.918699186991866,1020.3252032520318,25.508130081300795,0
2422,4,2,2,44,0.043478260869565216,0.043478260869565216,0.9565217391304348,46,1550,1300,250,0.8387096774193549,18,13,5,323.64466902216054,0.8231682769726248,0.11527240360485136,0.18629432094123335,130658.55910289314,-742.6107768463712,129915.94832604677,2402,0,763.7826086956521,42,4,15,36.13184374308912,0.6168154761904763,44.40406976744185,1022.3837209302301,24.342469545957858,0
2423,4,0,0,44,0.0,0.0,1.0,44,950,200,750,0.21052631578947367,17,2,15,334.66288210363876,0.813953488372093,0.11184151038935197,0.19183013778050037,130496.11363110556,-65.55890177807248,130430.55472932749,2403,4,799.5,40,4,15,36.01448014057421,0.6182291666666668,44.563008130081286,1021.7479674796728,25.54369918699182,0
2424,4,0,0,44,0.0,0.0,1.0,44,950,700,250,0.7368421052631579,12,7,5,337.0499775551309,0.8127422480620156,0.11123688420139333,0.19384709686832804,130625.94112507414,5.494104864802523,130631.43522993894,2404,5,800.5,40,4,16,35.822190741293014,0.6195312500000001,44.435975609756085,1022.2560975609739,25.556402439024346,0
2425,4,1,0,45,0.022222222222222223,0.0,1.0,45,1000,700,300,0.7,13,7,6,330.76866866276526,0.8203282828282829,0.12534927559648823,0.19157096110367328,130896.31287989713,-340.72017117034204,130555.59270872679,2405,0,783.6888888888889,41,4,17,35.709625949264804,0.6206808943089432,44.17162698412697,1023.3134920634906,24.958865660085134,0
2426,4,0,0,45,0.0,0.0,1.0,45,1500,1100,400,0.7333333333333333,19,11,8,322.2538593621467,0.8196969696969697,0.09776225585305931,0.18578259408864664,130718.7145691607,-566.5130346120243,130152.20153454867,2406,1,784.6888888888889,41,4,16,36.106664726426075,0.6189024390243905,44.34523809523808,1022.6190476190452,24.941927990708418,5
2427,4,0,0,45,0.0,0.0,1.0,45,1200,600,600,0.5,18,6,12,323.23696179584863,0.8186868686868687,0.09854322903197987,0.1868396608766137,130820.18455530348,-542.8162005543102,130277.36835474917,2407,2,785.6888888888889,41,4,17,35.97911817946728,0.6199186991869919,44.24603174603174,1023.0158730158721,24.95160665892371,0
2428,4,0,0,45,0.0,0.0,1.0,45,1250,900,350,0.72,16,9,7,336.4009504076391,0.8186868686868687,0.059032438478747284,0.189146194757503,129745.05077069197,-241.36993513708518,129503.68083555489,2408,3,786.6888888888889,38,7,16,36.730984340044735,0.6140350877192982,45.29914529914531,1018.8034188034203,26.810616284300533,5
2429,4,0,0,45,0.0,0.0,1.0,45,1100,800,300,0.7272727272727273,14,8,6,335.00257110082697,0.8191919191919192,0.055038434661076385,0.1888844283866364,129853.92011834319,-299.72057856672956,129554.19953977645,2409,4,787.6888888888889,38,7,16,36.656184486373185,0.6151315789473684,45.19230769230769,1019.230769230769,26.821862348178133,0
2430,4,0,0,45,0.0,0.0,1.0,45,1350,900,450,0.6666666666666666,18,9,9,340.7335431092164,0.8179713804713805,0.053503718445585546,0.19305537899487743,130044.5513391225,-137.89185203449273,129906.659487088,2410,5,788.6888888888889,38,7,16,36.31681854683846,0.6170504385964912,45.005341880341874,1019.9786324786312,26.841542959963977,0
2431,4,1,2,44,0.021739130434782608,0.043478260869565216,0.9565217391304348,46,1550,1200,350,0.7741935483870968,19,12,7,335.5499066699921,0.8259460547504026,0.049269450621410416,0.19199237927419452,130426.23325525955,-446.9152923880646,129979.31796287149,2411,0,772.5217391304348,38,8,18,36.06251961091935,0.620888157894737,44.63141025641025,1021.4743589743578,26.88090418353573,0
2432,4,2,1,45,0.043478260869565216,0.021739130434782608,0.9782608695652174,46,800,500,300,0.625,11,5,6,335.317225897921,0.8264291465378422,0.06811200378071858,0.19280740489130432,130617.28395061709,-440.35493827162276,130176.92901234547,2412,0,773.0217391304348,38,8,14,35.87522644927538,0.6228070175438598,44.444444444444436,1022.2222222222206,26.900584795321596,0
2433,4,0,0,45,0.0,0.0,1.0,45,1100,700,400,0.6363636363636364,15,7,8,336.31409499054826,0.8195286195286196,0.06702898550724656,0.19338060461956522,130617.28395061726,-214.31327160494135,130402.97067901232,2413,1,791.2,38,7,14,35.849750905797116,0.6228070175438596,44.44444444444444,1022.2222222222221,26.900584795321635,0
2434,4,0,0,45,0.0,0.0,1.0,45,1450,900,550,0.6206896551724138,20,9,11,335.46662163585137,0.8182239057239058,0.07155592700933244,0.19343894592158845,130726.51855504418,-229.1232924245797,130497.3952626196,2414,2,792.2,38,7,14,35.76098690625435,0.6239035087719298,44.337606837606835,1022.6495726495725,26.911830859199277,0
2435,4,1,0,46,0.021739130434782608,0.0,1.0,46,1450,900,550,0.6206896551724138,20,9,11,326.2770878781367,0.8253623188405798,0.08884416083116542,0.18994189569890133,131093.85456945264,-645.4157784718134,130448.43879098083,2415,0,775.9565217391304,40,6,16,35.625268763851686,0.62421875,43.978658536585364,1024.085365853658,25.60213414634145,0
2436,4,0,0,46,0.0,0.0,1.0,46,1400,700,700,0.5,21,7,14,324.0722248953151,0.826388888888889,0.0886987571479092,0.18929873530675353,131223.97898902764,-694.7906338819487,130529.1883551457,2416,1,776.9565217391304,40,6,16,35.550568670237396,0.6255208333333333,43.85162601626016,1024.593495934959,25.614837398373975,0
2437,4,1,0,47,0.02127659574468085,0.0,1.0,47,1300,1000,300,0.7692307692307693,16,10,6,317.75192639936967,0.8313675609004008,0.10055119930684109,0.18702350384068114,131515.0404188369,-1042.0858885072694,130472.95453032963,2417,0,761.4042553191489,39,8,17,35.419522866524474,0.6300747863247864,43.567708333333336,1025.7291666666674,26.30074786324788,0
2438,4,0,1,46,0.0,0.02127659574468085,0.9787234042553191,47,1050,800,250,0.7619047619047619,13,8,5,316.23121676909585,0.8307123034227567,0.10142209259196822,0.18648775493579403,131588.6707647565,-1077.5109062066147,130511.15985854989,2418,1,762.4042553191489,40,7,15,35.384475699947174,0.6291666666666667,43.4959349593496,1026.0162601626023,25.650406504065057,0
2439,4,0,1,45,0.0,0.021739130434782608,0.9782608695652174,46,850,500,350,0.5882352941176471,12,5,7,316.29189317854474,0.8329710144927537,0.07748221726503601,0.1850110564288996,131277.28666698164,-893.1304284663543,130384.1562385153,2419,2,776.804347826087,41,5,16,35.69619232010325,0.6244918699186992,43.79960317460318,1024.8015873015877,24.99516066589238,2
2440,4,1,1,45,0.021739130434782608,0.021739130434782608,0.9782608695652174,46,900,600,300,0.6666666666666666,12,6,6,310.1614341962749,0.8359702093397746,0.07717865957850756,0.18255586626005513,131515.04041883696,-1041.791763363311,130473.24865547365,2420,0,762.8913043478261,39,7,17,35.61416759757625,0.6300747863247863,43.56770833333334,1025.729166666668,26.3007478632479,0
2441,4,1,2,44,0.021739130434782608,0.043478260869565216,0.9565217391304348,46,1150,700,450,0.6086956521739131,16,7,9,310.6284528102535,0.8369363929146538,0.08247543233356369,0.18360060861064373,131675.35942925356,-1019.5773654513844,130655.78206380217,2421,0,763.8695652173913,39,7,14,35.441088162657714,0.6316773504273505,43.411458333333336,1026.3541666666672,26.316773504273517,0
2442,4,0,0,44,0.0,0.0,1.0,44,1100,900,200,0.8181818181818182,13,9,4,323.7718109985507,0.8340821000704722,0.07425473201445887,0.19075623826841528,131553.00188519515,-281.36926746693996,131271.6326177282,2422,5,784.6136363636364,37,7,18,35.22694883853499,0.6340090090090091,43.53070175438595,1025.8771929824538,27.7264106211474,0
2443,4,0,1,43,0.0,0.022727272727272728,0.9772727272727273,44,800,600,200,0.75,10,6,4,324.9850860616416,0.8344564834390417,0.07724455798502161,0.19189497920825882,131637.38031173046,-243.96292609264978,131393.41738563782,2423,6,785.6136363636364,37,7,17,35.11092264130782,0.6348536036036037,43.4484649122807,1026.2061403508767,27.735301090564235,0
2444,4,0,0,43,0.0,0.0,1.0,43,950,800,150,0.8421052631578947,11,8,3,331.0655072287146,0.8283499446290143,0.07584627521464848,0.1949370203843801,131530.201548677,109.0225783215592,131639.22412699857,2424,7,804.6279069767442,36,7,20,35.06284992864201,0.6357060185185186,43.552927927927925,1025.788288288288,28.49411911911911,0
2445,4,0,1,42,0.0,0.023255813953488372,0.9767441860465116,43,950,700,250,0.7368421052631579,12,7,5,330.52378483983045,0.8264581026208933,0.06711396068677744,0.19661443429615053,131918.8371061287,120.46266639733807,132039.29977252602,2425,8,805.6279069767442,37,6,19,34.68564325612837,0.637668918918919,43.17434210526315,1027.3026315789464,27.764935988620174,1
2446,4,0,0,42,0.0,0.0,1.0,42,950,400,550,0.42105263157894735,15,4,11,333.2599220270663,0.8195654277971351,0.0746579888456318,0.19801983253202798,131876.23844875421,389.8129885309095,132266.05143728512,2426,11,825.6190476190476,38,4,20,34.65822411760626,0.6354166666666667,43.21581196581195,1027.1367521367501,27.02991452991448,0
2447,4,0,0,42,0.0,0.0,1.0,42,1100,900,200,0.8181818181818182,13,9,4,330.710400931317,0.8181862175764615,0.07008175007551132,0.19693138859173187,131958.5539141827,328.0132542552146,132286.5671684379,2427,12,826.6190476190476,38,4,20,34.640913659838475,0.6362390350877194,43.13568376068375,1027.457264957263,27.038349077822712,0
2448,4,0,0,42,0.0,0.0,1.0,42,1400,800,600,0.5714285714285714,20,8,12,334.9140061347837,0.8171699574138599,0.07232424300906137,0.2003031374167197,132123.26189139072,449.98618872816576,132573.24808011888,2428,13,827.6190476190476,38,4,20,34.36731442031246,0.6378837719298246,42.975427350427346,1028.0982905982894,27.055218173639194,0
2449,4,0,0,42,0.0,0.0,1.0,42,750,600,150,0.8,9,6,3,334.432996651107,0.8167828106852497,0.06968230882629389,0.20045155826672198,132205.6544031704,442.7866352545756,132648.44103842496,2429,14,828.6190476190476,38,4,21,34.29686958930673,0.6387061403508772,42.89529914529914,1028.418803418803,27.06365272154745,0
2450,4,0,0,42,0.0,0.0,1.0,42,1600,1100,500,0.6875,21,11,10,335.187237992822,0.8158875338753387,0.07224950422582643,0.20134235275314297,132288.07259706684,468.25473464094586,132756.32733170778,2430,15,829.6190476190476,38,4,21,34.19466368954894,0.6395285087719298,42.81517094017094,1028.7393162393153,27.072087269455665,0
2451,4,0,0,42,0.0,0.0,1.0,42,1350,900,450,0.6666666666666666,18,9,9,333.88516448392835,0.8158875338753387,0.0704646230962016,0.2011454527500742,132398.00347222242,441.1458333333534,132839.14930555577,2431,16,830.6190476190476,39,3,21,34.11774628879892,0.6388888888888888,42.70833333333334,1029.1666666666683,26.388888888888932,0
2452,4,0,0,42,0.0,0.0,1.0,42,900,700,200,0.7777777777777778,11,7,4,343.53136801993963,0.8155245838172668,0.07077411185567728,0.19521213731116122,130158.86423631792,542.7305382047969,130701.59477452272,2432,17,831.6190476190476,40,2,18,36.12957706735717,0.6148437499999999,44.89329268292684,1020.4268292682947,25.510670731707368,7
2453,4,1,0,43,0.023255813953488372,0.0,1.0,43,1400,1000,400,0.7142857142857143,18,10,8,337.18450804645636,0.8203211517165006,0.08309468125969399,0.19360786338369776,130562.68376981535,204.8667933962298,130767.55056321158,2433,0,813.2558139534884,38,5,17,35.88272701930448,0.6222587719298245,44.49786324786326,1022.0085470085484,26.894961763382852,0
2454,4,0,1,42,0.0,0.023255813953488372,0.9767441860465116,43,650,300,350,0.46153846153846156,10,3,7,337.18450804645636,0.8203211517165006,0.08309468125969399,0.19360786338369776,130562.68376981535,204.7428592300589,130767.42662904541,2434,1,814.2558139534884,38,5,17,35.88272701930448,0.6222587719298245,44.49786324786326,1022.0085470085484,26.894961763382852,0
2455,4,2,0,44,0.045454545454545456,0.0,1.0,44,700,300,400,0.42857142857142855,11,3,8,328.2883753931169,0.8291710711768852,0.11687684328282355,0.1913491164932138,131141.34250217007,-189.56434461805964,130951.778157552,2435,0,792.0227272727273,39,5,19,35.52588647072783,0.6263354700854702,43.932291666666664,1024.2708333333328,26.263354700854688,0
2456,4,0,0,44,0.0,0.0,1.0,44,850,500,350,0.5882352941176471,12,5,7,327.9925115460073,0.8281360112755461,0.11885321652018832,0.19170899204266623,131248.05908203113,-190.3238932291792,131057.73518880195,2436,1,793.0227272727273,39,5,20,35.425879333130005,0.6274038461538463,43.82812499999999,1024.687499999999,26.27403846153844,0
2457,4,1,1,44,0.022222222222222223,0.022222222222222223,0.9777777777777777,45,1250,800,450,0.64,17,8,9,324.9608336266661,0.8324915824915825,0.1257322732585726,0.1912905557111966,131519.8348696944,-452.19213633554693,131067.64273335885,2437,0,776.3777777777777,38,7,20,35.22983716973925,0.6318530701754387,43.56303418803417,1025.7478632478612,26.993364822312138,0
2458,4,0,0,44,0.0,0.0,1.0,44,1100,700,400,0.6363636363636364,15,7,8,330.73011026044145,0.8255813953488372,0.12703507868161013,0.1944260667043308,131468.6505102528,-103.87174419055322,131364.77876606226,2438,3,795.0227272727273,37,7,20,35.133446487757936,0.6331644144144146,43.61293859649121,1025.5482456140323,27.717520151730604,0
2459,4,0,0,44,0.0,0.0,1.0,44,700,600,100,0.8571428571428571,8,6,2,333.13910223870477,0.8257795983086681,0.12637141052427037,0.19613066717703423,131524.88175448176,-36.783794052060614,131488.0979604297,2439,4,796.0227272727273,37,7,20,35.01503206841261,0.6337274774774777,43.5581140350877,1025.767543859646,27.723447131341782,0
2460,4,0,0,44,0.0,0.0,1.0,44,1200,900,300,0.75,15,9,6,333.2013796509609,0.8251849894291755,0.13216891583355284,0.19645654123465878,131581.12502164097,-31.39752135274972,131549.72750028822,2440,5,797.0227272727273,37,7,19,34.95678369135408,0.6342905405405406,43.5032894736842,1025.9868421052608,27.729374110952996,0
2461,4,0,0,44,0.0,0.0,1.0,44,1400,1100,300,0.7857142857142857,17,11,6,331.08517788005,0.8247665609584215,0.13071095571095603,0.19564124147457462,131665.51246537364,-81.50007694678646,131584.01238842687,2441,6,798.0227272727273,37,7,19,34.92610398860398,0.6351351351351353,43.42105263157893,1026.3157894736817,27.738264580369776,0
2462,4,0,0,44,0.0,0.0,1.0,44,900,500,400,0.5555555555555556,13,5,8,331.7182037536829,0.8241499295278365,0.13355246547940403,0.1963050457359021,131721.78578985808,-61.09716451220265,131660.68862534588,2442,7,799.0227272727273,37,7,19,34.85321868546606,0.6356981981981984,43.36622807017542,1026.5350877192955,27.74419155998096,0
2463,4,0,0,44,0.0,0.0,1.0,44,1200,900,300,0.75,15,9,6,327.90976359322946,0.8233791402396053,0.13088871266678392,0.19463349544043612,131835.7760959199,-153.95236545141347,131681.8237304685,2443,8,800.0227272727273,39,5,19,34.83629593941238,0.6332799145299146,43.25520833333332,1026.9791666666647,26.332799145299095,0
2464,4,0,0,44,0.0,0.0,1.0,44,1500,1200,300,0.8,18,12,6,332.0016313117617,0.8223000352360817,0.13563778308278018,0.1976181104180991,131942.7747938367,-38.956705729170835,131903.81808810754,2444,9,801.0227272727273,39,5,19,34.623614349927344,0.6343482905982907,43.151041666666664,1027.3958333333326,26.343482905982885,0
2465,4,0,0,44,0.0,0.0,1.0,44,1050,700,350,0.6666666666666666,14,7,7,333.32251754661104,0.8223440803382664,0.13209089987746103,0.19896511074606246,132049.81689453125,3.0354817708340533,132052.8523763021,2445,10,802.0227272727273,39,5,20,34.48204874835311,0.6354166666666667,43.046875,1027.8125,26.354166666666668,0
2466,4,1,1,44,0.022222222222222223,0.022222222222222223,0.9777777777777777,45,1450,1000,450,0.6896551724137931,19,10,9,323.39490894786036,0.8284511784511785,0.12739541160593815,0.19482571343932065,132398.00347222213,-435.71506076389795,131962.28841145823,2446,0,785.1777777777778,38,7,20,34.387651821862356,0.640625,42.70833333333333,1029.1666666666658,27.08333333333331,0
2467,4,0,0,44,0.0,0.0,1.0,44,1200,1000,200,0.8333333333333334,14,10,4,331.494731779543,0.8217494714587739,0.12801174326786824,0.1994217393738322,132344.40646701382,-25.70529513889238,132318.7011718749,2447,12,804.0227272727273,39,5,20,34.23305999865021,0.6383547008547009,42.760416666666664,1028.9583333333328,26.383547008546994,0
2468,4,0,1,43,0.0,0.022727272727272728,0.9772727272727273,44,1450,1100,350,0.7586206896551724,18,11,7,334.166242743371,0.8211548625792812,0.13304948813511341,0.2016087507096045,132452.9860312113,52.274187132472775,132505.26021834378,2448,13,805.0227272727273,38,6,20,34.05531049991352,0.641173245614035,42.654914529914535,1029.3803418803427,27.08895636527218,0
2469,4,0,0,43,0.0,0.0,1.0,43,950,500,450,0.5263157894736842,14,5,9,344.2110053919376,0.813953488372093,0.13400580652193206,0.20767692279045724,132454.43309479856,518.4547168359596,132972.88781163451,2449,14,823.7441860465116,37,6,20,33.795359323959644,0.6430180180180181,42.65350877192983,1029.385964912282,27.821242294926538,0
2470,4,1,2,42,0.022727272727272728,0.045454545454545456,0.9545454545454546,44,650,400,250,0.6153846153846154,9,4,5,336.6867497563179,0.8174991190979564,0.1290894952636783,0.20462153127912347,132728.07004026973,137.556500657474,132865.6265409272,2450,0,806.0,38,6,17,33.71435977190254,0.6439144736842104,42.38782051282052,1030.4487179487191,27.117071524966292,0
2471,4,0,0,42,0.0,0.0,1.0,42,450,300,150,0.6666666666666666,6,3,3,344.8153322331819,0.8117015098722415,0.131497308312297,0.20898033748377487,132623.79410010777,746.1435249307556,133369.93762503852,2451,16,841.547619047619,37,5,20,33.609662195727765,0.6447072072072071,42.4890350877193,1030.043859649123,27.839023233760084,0
2472,4,1,0,43,0.023255813953488372,0.0,1.0,43,1350,1000,350,0.7407407407407407,17,10,7,334.0549884558494,0.8189830195644149,0.029415685607505848,0.199998128591496,132162.78029777238,306.15258637214464,132468.9328841445,2452,0,822.953488372093,40,3,16,34.349673848586676,0.6348958333333334,42.93699186991869,1028.2520325203243,25.706300813008106,7
2473,4,0,1,42,0.0,0.023255813953488372,0.9767441860465116,43,1050,900,150,0.8571428571428571,12,9,3,335.49441540972447,0.8183831672203765,0.031663384673359385,0.2012767622028348,132241.1647849329,273.2344545244211,132514.3992394573,2453,1,823.953488372093,40,3,16,34.23389487204822,0.6356770833333334,42.860772357723576,1028.5569105691056,25.71392276422764,0
2474,4,0,0,42,0.0,0.0,1.0,42,450,300,150,0.6666666666666666,6,3,3,336.6146863472388,0.816831204026326,0.042189820440124315,0.20221451595896178,132290.8203125,506.2065972222222,132797.02690972222,2454,2,839.7380952380952,39,3,16,34.15519103550696,0.6378205128205128,42.8125,1028.75,26.378205128205128,0
2475,4,0,0,42,0.0,0.0,1.0,42,1200,1000,200,0.8333333333333334,14,10,4,335.14929595519305,0.8154761904761905,0.04470556255714575,0.20220184511761308,132452.986031211,478.34840588244197,132931.33443709346,2455,3,840.7380952380952,38,4,17,34.03001210863172,0.6411732456140352,42.65491452991452,1029.3803418803404,27.088956365272118,0
2476,4,0,0,42,0.0,0.0,1.0,42,1450,1200,250,0.8275862068965517,17,12,5,334.2968753708213,0.8160569105691057,0.038111540912661335,0.20227793984302225,132562.98539201167,463.0783612754552,133026.06375328713,2456,4,841.7380952380952,38,4,18,33.94153957879447,0.6422697368421053,42.54807692307691,1029.807692307691,27.100202429149764,0
2477,4,0,0,42,0.0,0.0,1.0,42,950,800,150,0.8421052631578947,11,8,3,356.4812659586524,0.8144115369725126,0.06709956709956777,0.21014669103750383,131574.63480029578,980.7784763313518,132555.41327662714,2457,5,842.7380952380952,38,4,14,34.36621368322399,0.6324013157894737,43.50961538461538,1025.9615384615377,26.99898785425099,4
2478,4,0,1,41,0.0,0.023809523809523808,0.9761904761904762,42,800,600,200,0.75,10,6,4,355.18673720867014,0.8133710801393729,0.07397162487730924,0.2098354119081478,131656.85609796178,952.5538297172834,132609.40992767905,2458,6,843.7380952380952,38,4,14,34.316442848219864,0.6332236842105263,43.429487179487175,1026.2820512820506,27.007422402159225,0
2479,4,1,2,40,0.023809523809523808,0.047619047619047616,0.9523809523809523,42,850,600,250,0.7058823529411765,11,6,5,353.34182980138,0.8107094463801781,0.07449581289331597,0.20934740964187787,131766.5244448096,911.7249707794467,132678.24941558903,2459,0,844.5714285714286,38,4,14,34.253165105792576,0.6343201754385965,43.32264957264957,1026.7094017094007,27.01866846603686,0
2480,4,0,0,40,0.0,0.0,1.0,40,900,800,100,0.8888888888888888,10,8,2,365.7137599722498,0.8010683760683761,0.0709161269074543,0.21533850288217335,131530.20154867697,1620.4809116548927,133150.68246033185,2460,25,886.175,36,4,19,34.17430563179274,0.6357060185185186,43.552927927927925,1025.7882882882877,28.494119119119105,0
2481,4,0,0,40,0.0,0.0,1.0,40,1050,900,150,0.8571428571428571,12,9,3,367.9292297804963,0.8013087606837607,0.07850010972130805,0.217464786006449,131674.6370525931,1689.389558477395,133364.0266110705,2461,26,887.175,36,4,16,33.97154560749031,0.6371527777777779,43.41216216216216,1026.3513513513512,28.509759759759756,0
2482,4,1,2,39,0.024390243902439025,0.04878048780487805,0.9512195121951219,41,750,700,50,0.9333333333333333,8,7,1,361.19134046874126,0.8094512195121951,0.08146393523700457,0.21501670013926935,131946.99931709733,1331.6227108340763,133278.62202793141,2462,0,866.5121951219512,37,4,17,33.86961935254358,0.6379504504504505,43.14692982456139,1027.4122807017525,27.767899478425743,0
2483,4,0,0,39,0.0,0.0,1.0,39,950,600,350,0.631578947368421,13,6,7,377.04098542264444,0.7964462438146649,0.08937927205856844,0.22290663058186727,131684.2689043209,2130.073302469124,133814.34220679002,2463,28,911.2051282051282,35,4,17,33.728010825439775,0.6392857142857145,43.40277777777777,1026.3888888888882,29.32539682539681,0
2484,4,0,0,39,0.0,0.0,1.0,39,950,800,150,0.8421052631578947,11,8,3,378.04027394760845,0.7958839406207827,0.0910218442301367,0.22395017398182882,131761.3363997443,2162.2183416524636,133923.55474139674,2464,29,912.2051282051282,36,3,18,33.624456144199485,0.6380208333333335,43.3277027027027,1026.689189189189,28.519144144144136,0
2485,4,0,0,39,0.0,0.0,1.0,39,1250,900,350,0.72,16,9,7,379.8260041551248,0.7962213225371121,0.09021592442645088,0.2255216899671052,131848.0642804966,2215.864682249802,134063.9289627464,2465,30,913.2051282051282,36,3,18,33.49095394736842,0.6388888888888891,43.243243243243235,1027.027027027026,28.528528528528497,0
2486,4,0,0,39,0.0,0.0,1.0,39,1000,700,300,0.7,13,7,6,381.8561200055119,0.7947031039136303,0.0849829696826625,0.22741874927743433,131963.74584043512,2278.232793604423,134241.97863403955,2466,31,914.2051282051282,36,3,18,33.321916557065606,0.6400462962962963,43.130630630630634,1027.4774774774783,28.541041041041062,0
2487,4,0,0,39,0.0,0.0,1.0,39,900,400,500,0.4444444444444444,14,4,10,377.5285263117344,0.794646873594242,0.07919023017083737,0.22535662914631796,132050.54029959018,2170.56917559452,134221.1094751847,2467,32,915.2051282051282,36,3,18,33.345431138380626,0.6409143518518519,43.046171171171174,1027.8153153153157,28.550425425425438,0
2488,4,0,0,39,0.0,0.0,1.0,39,600,300,300,0.5,9,3,6,373.1244803969438,0.7943657219973009,0.07236217597663397,0.22323895845505226,132137.36329234645,2060.7370038957943,134198.10029624225,2468,33,916.2051282051282,36,3,18,33.37098393574298,0.6417824074074074,42.961711711711715,1028.1531531531534,28.559809809809817,0
2489,4,0,0,39,0.0,0.0,1.0,39,750,500,250,0.6666666666666666,10,5,5,370.03661104021825,0.79408457040036,0.07806305243887435,0.22173059921386315,132195.26113951797,1983.4172855287836,134178.67842504676,2469,34,917.2051282051282,36,3,18,33.391964155351154,0.6423611111111112,42.90540540540541,1028.378378378379,28.566066066066085,0
2490,4,0,0,39,0.0,0.0,1.0,39,1450,900,550,0.6206896551724138,20,9,11,372.94461241070877,0.793578497525866,0.07761911176972469,0.22415934072264723,132311.09487866252,2068.9419994318705,134380.0368780944,2470,35,918.2051282051282,36,3,19,33.20038857267949,0.6435185185185186,42.792792792792795,1028.8288288288295,28.578578578578597,0
2491,4,1,0,40,0.025,0.0,1.0,40,1400,800,600,0.5714285714285714,20,8,12,355.75114216608404,0.802457264957265,0.0743852459016392,0.19728017883755591,129201.38888888907,1288.866569271994,130490.25545816106,2471,0,896.225,34,6,17,36.791325136612016,0.6164215686274509,45.83333333333334,1016.6666666666681,29.90196078431377,7
2492,4,1,1,40,0.024390243902439025,0.024390243902439025,0.975609756097561,41,700,500,200,0.7142857142857143,9,5,4,349.77460087645295,0.8065548780487805,0.06975060538732247,0.1952741628893113,129466.281467014,856.8033854166756,130323.08485243068,2472,0,875.3414634146342,35,6,14,36.67370351415898,0.6169642857142856,45.57291666666667,1017.7083333333343,29.07738095238098,0
2493,4,4,2,42,0.09090909090909091,0.045454545454545456,0.9545454545454546,44,500,300,200,0.6,7,3,4,328.9788294487515,0.8297656800563777,0.0857126541799913,0.18704796302943294,130180.80210387892,-234.6544214332744,129946.14768244565,2473,0,816.5681818181819,38,6,17,36.47861704355109,0.618421052631579,44.87179487179487,1020.5128205128196,26.855600539811043,0
2494,4,1,1,42,0.023255813953488372,0.023255813953488372,0.9767441860465116,43,1450,1100,350,0.7586206896551724,18,11,7,335.4102803888336,0.8198135843484681,0.09332803713335713,0.19096845872413765,130234.60493853869,136.40507175283977,130371.01001029153,2474,0,836.5348837209302,37,6,18,36.26004851935406,0.620777027027027,44.81907894736842,1020.7236842105256,27.587126600284474,0
2495,4,0,0,42,0.0,0.0,1.0,42,850,600,250,0.7058823529411765,11,6,5,345.1573761384732,0.8147018970189702,0.09109639440765238,0.19593520224402058,130118.92804967136,582.3015583150764,130701.22960798643,2475,2,857.452380952381,36,6,18,36.12858719646799,0.6215277777777778,44.932432432432435,1020.2702702702709,28.34084084084086,0
2496,4,0,0,42,0.0,0.0,1.0,42,1100,900,200,0.8181818181818182,13,9,4,345.90446228345394,0.8141695702671312,0.09885037541442765,0.19679423362680118,130205.11379200144,607.705974555641,130812.81976655709,2476,3,858.452380952381,36,6,18,36.02215050204128,0.6223958333333334,44.847972972972975,1020.608108108108,28.350225225225223,0
2497,4,0,0,42,0.0,0.0,1.0,42,1200,1100,100,0.9166666666666666,13,11,2,343.31177065477095,0.8144357336430507,0.0996804525482824,0.19590533251723086,130321.66950660144,548.2053041999575,130869.8748108014,2477,4,859.452380952381,35,7,18,35.97020705811228,0.6255952380952381,44.73379629629629,1021.0648148148143,29.17328042328041,0
2498,4,0,0,42,0.0,0.0,1.0,42,900,500,400,0.5555555555555556,13,5,8,343.006363906299,0.8143389469608981,0.10104680965870783,0.1961782995121897,130410.31867551855,546.3138449502576,130956.6325204688,2478,5,860.452380952381,35,7,18,35.88822001888573,0.6264880952380952,44.64699074074073,1021.4120370370359,29.183201058201025,0
2499,4,1,1,42,0.023255813953488372,0.023255813953488372,0.9767441860465116,43,1350,900,450,0.6666666666666666,18,9,9,333.8523407247895,0.8201365817644887,0.0994746705170344,0.19292078009821806,130809.2129291454,134.19238495252222,130943.40531409792,2479,0,841.4186046511628,36,7,14,35.71870871862615,0.6284722222222222,44.25675675675676,1022.9729729729734,28.415915915915928,0
2500,4,1,1,42,0.023255813953488372,0.023255813953488372,0.9767441860465116,43,600,300,300,0.5,9,3,6,334.27124846692783,0.8206902916205241,0.0963144384643535,0.19359610164556856,130895.62694028477,150.9289272380363,131046.55586752281,2480,0,842.3953488372093,36,7,14,35.62071273981147,0.6293402777777779,44.17229729729729,1023.3108108108099,28.425300300300275,0
2501,4,1,2,41,0.023255813953488372,0.046511627906976744,0.9534883720930233,43,900,800,100,0.8888888888888888,10,8,2,331.9558358476112,0.8226744186046512,0.09277764985800885,0.19268700816441794,130982.06948502558,96.05247139031025,131078.12195641588,2481,0,843.3720930232558,36,7,15,35.59268426842682,0.6302083333333334,44.08783783783784,1023.6486486486488,28.434684684684687,0
2502,4,0,1,40,0.0,0.024390243902439025,0.975609756097561,41,1400,1200,200,0.8571428571428571,16,12,4,338.125787244066,0.8203252032520325,0.08924148051704428,0.1959179692537374,130913.2332926098,653.0280135459585,131566.26130615576,2482,1,865.5365853658536,35,6,15,35.5043165196411,0.631547619047619,44.155092592592595,1023.3796296296302,29.23941798941801,0
2503,4,0,0,40,0.0,0.0,1.0,40,950,700,250,0.7368421052631579,12,7,5,347.2276952559516,0.8152510683760684,0.09465376782077417,0.20057505690667288,130794.81336805534,1083.1163194444193,131877.92968749977,2483,2,887.95,35,5,15,35.391208418194154,0.6303571428571428,44.27083333333332,1022.9166666666649,29.226190476190425,0
2504,4,1,1,40,0.024390243902439025,0.024390243902439025,0.975609756097561,41,950,800,150,0.8421052631578947,11,8,3,338.53797201177036,0.8203760162601627,0.09009796873155729,0.19680225329482204,131039.71370018671,672.3837858128452,131712.09748599955,2484,0,867.2682926829268,36,5,15,35.36602691010413,0.630787037037037,44.031531531531535,1023.8738738738741,28.440940940940948,0
2505,4,2,1,41,0.047619047619047616,0.023809523809523808,0.9761904761904762,42,1000,800,200,0.8,12,8,4,333.8631737608918,0.8226626016260162,0.1030630178257601,0.19584344935046108,131385.84530476408,373.296100154197,131759.14140491828,2485,0,847.5714285714286,36,6,16,35.13657000585824,0.6342592592592593,43.69369369369369,1025.2252252252242,28.47847847847845,0
2506,4,0,1,40,0.0,0.024390243902439025,0.975609756097561,41,800,500,300,0.625,11,5,6,344.3717364002909,0.8189532520325203,0.10549276224469595,0.2017034456058846,131328.12499999997,845.138888888888,132173.26388888885,2486,1,869.2439024390244,35,6,16,34.925474254742554,0.6357142857142857,43.75,1024.9999999999998,29.285714285714278,0
2507,4,0,0,40,0.0,0.0,1.0,40,1350,1100,250,0.8148148148148148,16,11,5,345.95614896234156,0.8163728632478633,0.11410393860738055,0.20341854253187203,131476.45968632132,1097.0179344564647,132573.4776207778,2487,2,889.8,35,5,16,34.73519260429598,0.6372023809523808,43.60532407407408,1025.578703703705,29.302248677248716,0
2508,4,0,0,40,0.0,0.0,1.0,40,1050,900,150,0.8571428571428571,12,9,3,346.3121802118912,0.817815170940171,0.11012294157455438,0.20442102461775175,131624.87809713668,1116.659700788774,132741.53779792544,2488,3,890.8,35,5,15,34.576377923152116,0.6386904761904759,43.46064814814816,1026.157407407409,29.318783068783112,0
2509,4,0,0,40,0.0,0.0,1.0,40,550,300,250,0.5454545454545454,8,3,5,347.6737144704565,0.818215811965812,0.10981448065862187,0.20538459868151512,131654.5718262391,1154.5668027692304,132809.13862900832,2489,4,891.8,35,5,15,34.51150802601405,0.6389880952380951,43.431712962962976,1026.27314814815,29.322089947090003,0
2510,4,0,0,40,0.0,0.0,1.0,40,950,800,150,0.8421052631578947,11,8,3,350.3803530642412,0.817548076923077,0.11173055242390095,0.20746820638717095,131743.67310742463,1232.0789394718872,132975.75204689652,2490,5,892.8,35,5,15,34.3522172115746,0.6398809523809523,43.34490740740741,1026.620370370371,29.332010582010597,0
2511,4,0,0,40,0.0,0.0,1.0,40,900,800,100,0.8888888888888888,10,8,2,349.11480349208597,0.8170138888888889,0.11168567668348306,0.206971962174307,131790.2425229284,1201.9849241133093,132992.22744704172,2491,6,893.8,36,4,16,34.33775681801565,0.6383101851851851,43.29954954954955,1026.8018018018024,28.52227227227229,0
2512,4,0,0,40,0.0,0.0,1.0,40,1200,600,600,0.5,18,6,12,351.26608369300044,0.8147435897435897,0.11444109589041074,0.20936009233825156,131992.6741564201,1272.909945418406,133265.58410183853,2492,7,894.8,36,4,17,34.07853881278538,0.6403356481481481,43.102477477477485,1027.5900900900913,28.5441691691692,0
2513,4,0,1,39,0.0,0.025,0.975,40,850,600,250,0.7058823529411765,11,6,5,348.2465947348488,0.8152510683760684,0.1130148992112181,0.20803631654055643,132079.4781267756,1199.2456984011183,133278.7238251767,2493,8,895.8,36,4,17,34.06870800467425,0.6412037037037036,43.018018018018026,1027.9279279279292,28.553553553553588,0
2514,4,0,0,39,0.0,0.0,1.0,39,800,500,300,0.625,11,5,6,354.87080421636136,0.8047121007647323,0.11585260165701805,0.21111482963970687,131921.9660922498,1563.0508401920597,133485.01693244185,2494,9,919.4615384615385,35,4,17,34.057195433378396,0.6416666666666666,43.171296296296305,1027.314814814816,29.351851851851883,0
2515,4,0,0,39,0.0,0.0,1.0,39,650,500,150,0.7692307692307693,8,5,3,357.38592797127114,0.8039248762932973,0.1211291524425111,0.21294444755227837,131981.4238790296,1633.6607295953454,133615.08460862495,2495,10,920.4615384615385,35,4,17,33.93266126004355,0.6422619047619047,43.11342592592593,1027.5462962962972,29.358465608465636,0
2516,4,0,0,39,0.0,0.0,1.0,39,900,500,400,0.5555555555555556,13,5,8,355.8258027189085,0.8024628879892038,0.12519380180679596,0.2125143882949986,132070.63567654765,1598.8279910408303,133669.46366758848,2496,11,921.4615384615385,35,4,17,33.882844461959984,0.6431547619047618,43.02662037037038,1027.8935185185198,29.368386243386283,0
2517,4,0,0,39,0.0,0.0,1.0,39,850,600,250,0.7058823529411765,11,6,5,355.6970214986781,0.8011133603238867,0.13261763560019046,0.21310640836249212,132189.63162562175,1603.8916484482374,133793.52327407,2497,12,922.4615384615385,35,4,17,33.76629619208404,0.6443452380952379,42.91087962962964,1028.356481481483,29.381613756613795,0
2518,4,0,0,39,0.0,0.0,1.0,39,1100,700,400,0.6363636363636364,15,7,8,371.01207830070797,0.8011133603238867,0.16368393511250656,0.21139060275272903,130262.58680555563,1865.798611111121,132128.38541666674,2498,13,923.4615384615385,37,2,18,35.32312925170068,0.6210585585585584,44.79166666666667,1020.833333333334,27.590090090090108,5
2519,4,0,0,39,0.0,0.0,1.0,39,900,700,200,0.7777777777777778,11,7,4,353.1002315479582,0.801450742240216,0.10573525414514795,0.18854219910957026,127692.92091836745,1326.1869331065852,129019.10785147404,2499,14,924.4615384615385,34,5,20,38.39934236356497,0.6011029411764706,47.32142857142858,1010.7142857142866,29.726890756302545,7
2520,4,3,2,40,0.07142857142857142,0.047619047619047616,0.9523809523809523,42,900,600,300,0.6666666666666666,12,6,6,332.6945106872599,0.8214285714285714,0.1119299980429116,0.1811598024625681,128477.80687326878,148.77221837489316,128626.57909164368,2500,0,859.3571428571429,37,5,14,38.11377893142982,0.6030405405405406,46.54605263157895,1013.815789473685,27.400426742532026,0
2521,4,1,1,40,0.024390243902439025,0.024390243902439025,0.975609756097561,41,1350,1100,250,0.8148148148148148,16,11,5,340.4627324734907,0.8160060975609756,0.11843128541273229,0.18516646857969143,128429.74044568233,545.108072599649,128974.84851828197,2501,0,881.2926829268292,36,5,14,37.96592045328298,0.6044560185185184,46.59346846846848,1013.6261261261274,28.156281281281316,0
2522,4,3,3,40,0.06976744186046512,0.06976744186046512,0.9302325581395349,43,950,700,250,0.7368421052631579,12,7,5,325.6038520775279,0.8361018826135105,0.11147520122164578,0.17895971117945347,128848.62075617301,-209.27854938269869,128639.34220679032,2502,0,841.2325581395348,38,5,15,37.91609667122662,0.6049890350877192,46.180555555555564,1015.2777777777792,26.71783625730998,0
2523,4,0,0,40,0.0,0.0,1.0,40,1000,700,300,0.7,13,7,6,349.68406772146125,0.8065705128205128,0.12295067930128978,0.19035940019715836,128466.99948827579,984.5725898062246,129451.57207808201,2503,3,905.325,35,5,17,37.69420500818203,0.6068452380952382,46.556712962962955,1013.7731481481474,28.964947089947067,0
2524,4,2,1,41,0.047619047619047616,0.023809523809523808,0.9761904761904762,42,1050,700,350,0.6666666666666666,14,7,7,333.62089458490726,0.8163956639566395,0.12628069688417298,0.18383880705175473,128950.68825263547,204.12879443675132,129154.81704707223,2504,0,863.1666666666666,37,5,19,37.60874356759868,0.6078265765765766,46.08004385964912,1015.6798245614038,27.45080606922713,0
2525,4,0,0,41,0.0,0.0,1.0,41,1200,800,400,0.6666666666666666,16,8,8,336.60989488981255,0.8100101626016261,0.12344170515771236,0.18535557945716072,128922.84765504772,479.3412396121877,129402.1888946599,2505,1,885.219512195122,37,4,20,37.56118189016051,0.607545045045045,46.10745614035088,1015.5701754385966,27.44784257942153,0
2526,4,3,2,42,0.06818181818181818,0.045454545454545456,0.9545454545454546,44,550,300,250,0.5454545454545454,8,3,5,318.5300985733999,0.8265724101479915,0.12556382236689112,0.17843161682263536,129598.8294813369,-543.4738408091862,129055.35564052772,2506,0,825.7954545454545,39,5,17,37.334292412617195,0.610844017094017,45.442708333333336,1018.2291666666674,26.10844017094019,0
2527,4,2,2,42,0.045454545454545456,0.045454545454545456,0.9545454545454546,44,950,600,350,0.631578947368421,13,6,7,320.98932986466014,0.829369274136716,0.12284999721080725,0.18017414853138067,129678.39084201408,-474.9240451388696,129203.4667968752,2507,0,826.75,39,5,17,37.19105815776915,0.6116452991452991,45.36458333333334,1018.5416666666682,26.11645299145303,0
2528,4,1,1,42,0.023255813953488372,0.023255813953488372,0.9767441860465116,43,1200,900,300,0.75,15,9,6,325.942528284257,0.8169988925802879,0.12792649484234242,0.1827578929179729,129636.22708013744,-149.20807765358202,129487.01900248385,2508,0,846.953488372093,38,5,17,37.10768114421596,0.612938596491228,45.40598290598291,1018.3760683760692,26.799370220422873,0
2529,4,0,0,42,0.0,0.0,1.0,42,700,500,200,0.7142857142857143,9,5,4,333.34368670313034,0.8140001935733643,0.13065226090436188,0.18616703369304774,129480.23069598332,232.28349107417307,129712.5141870575,2509,3,868.1190476190476,37,5,18,37.07758744523452,0.6131756756756757,45.55921052631579,1017.7631578947363,27.507112375533413,0
2530,4,1,2,41,0.023255813953488372,0.046511627906976744,0.9534883720930233,43,950,700,250,0.7368421052631579,12,7,5,325.5029058926723,0.8211978589885567,0.14067585457010012,0.1834006036213941,129826.69850107754,-148.20647508948088,129678.49202598806,2510,0,848.9069767441861,38,5,20,36.92582206380824,0.6148574561403508,45.2190170940171,1019.1239316239319,26.819050832208735,0
2531,4,0,0,41,0.0,0.0,1.0,41,700,400,300,0.5714285714285714,10,4,6,341.2400060457614,0.8202235772357723,0.14827886745511987,0.1907525302812393,129516.42679419302,639.2372524551806,130155.66404664819,2511,1,835.4878048780488,36,5,20,36.83989748128482,0.6154513888888888,45.52364864864866,1017.9054054054068,28.27515015015019,0
2532,4,0,0,41,0.0,0.0,1.0,41,900,700,200,0.7777777777777778,11,7,4,341.90954635207504,0.8182926829268292,0.14247333581497745,0.19154560830950831,129602.41280131499,662.4604334064012,130264.8732347214,2512,2,836.4878048780488,36,5,20,36.735512054855135,0.6163194444444444,45.4391891891892,1018.2432432432445,28.28453453453457,0
2533,4,0,0,41,0.0,0.0,1.0,41,1250,800,450,0.64,17,8,9,342.08575070895233,0.8196646341463415,0.13887120958781463,0.19192453656400535,129659.75265806356,670.9507649541554,130330.70342301771,2513,3,837.4878048780488,36,5,20,36.672794117647065,0.6168981481481481,45.38288288288289,1018.4684684684692,28.29079079079081,0
2534,4,1,1,41,0.023809523809523808,0.023809523809523808,0.9761904761904762,42,1250,1000,250,0.8,15,10,5,337.4586657417043,0.8268486256291134,0.13510496671786987,0.1908981503283363,129982.9033933517,372.77142967065674,130355.67482302236,2514,0,818.5238095238095,37,5,20,36.462813620071685,0.6182432432432433,45.065789473684205,1019.7368421052624,27.56045519203412,0
2535,4,1,2,40,0.023809523809523808,0.047619047619047616,0.9523809523809523,42,1000,700,300,0.7,13,7,6,337.4837908858932,0.8217673248161053,0.12792470593050775,0.1918730385934642,130178.65022170288,386.6368738458028,130565.28709554867,2515,0,819.5,37,5,20,36.26381128899395,0.6202139639639639,44.87390350877193,1020.5043859649127,27.581199620673317,0
2536,4,1,1,40,0.024390243902439025,0.024390243902439025,0.975609756097561,41,1250,800,450,0.64,17,8,9,337.4872072833953,0.8217987804878049,0.14537245340240368,0.1927049884383972,130346.55044100096,598.0586574715162,130944.60909847247,2516,0,837.390243902439,37,4,21,36.09369966713196,0.6219031531531531,44.7094298245614,1021.1622807017534,27.59898055950685,0
2537,4,1,4,37,0.024390243902439025,0.0975609756097561,0.9024390243902439,41,950,800,150,0.8421052631578947,11,8,3,340.96662728058266,0.8227134146341464,0.14426246677925714,0.1949726294118247,130402.54122662733,692.5829341720438,131095.12416079937,2517,0,838.3658536585366,37,4,21,35.94817945965289,0.6224662162162162,44.65460526315789,1021.3815789473678,27.60490753911805,0
2538,4,0,0,37,0.0,0.0,1.0,37,1000,700,300,0.7,13,7,6,363.55817284475796,0.8173173173173173,0.14694444624783354,0.2064792187657199,130137.51471789692,2062.5114138792774,132200.0261317762,2518,8,860.3513513513514,33,4,21,35.64036351989752,0.6281565656565657,44.91421568627451,1020.3431372549016,30.91948900772429,0
2539,4,0,0,37,0.0,0.0,1.0,37,900,400,500,0.4444444444444444,14,4,10,366.0192300729332,0.8170045045045045,0.1486470265728459,0.2087136348896377,130293.86421388402,2138.0119725586246,132431.87618644265,2519,9,861.3513513513514,33,4,21,35.41879226183331,0.6297348484848485,44.7610294117647,1020.9558823529406,30.938057040998203,0
2540,4,0,0,37,0.0,0.0,1.0,37,750,500,250,0.6666666666666666,10,5,5,364.6074384403264,0.8158158158158159,0.14555359198430606,0.20857947833906115,130419.01139285373,2110.348333573629,132529.35972642736,2520,10,862.3513513513514,33,4,21,35.32780943811238,0.6309974747474747,44.638480392156865,1021.4460784313727,30.952911467617355,0
2541,4,1,1,37,0.02631578947368421,0.02631578947368421,0.9736842105263158,38,800,600,200,0.75,10,6,4,359.7518990544864,0.8212422949265055,0.14201214245017701,0.2075640406163259,130749.15143140589,1807.4511054421757,132556.60253684808,2521,0,840.6315789473684,34,4,14,35.11717689054436,0.632046568627451,44.31547619047619,1022.7380952380952,30.080532212885153,0
2542,4,0,0,37,0.0,0.0,1.0,37,350,300,50,0.8571428571428571,4,3,1,364.85119698748963,0.8132507507507507,0.14565626650508534,0.20973286244470407,130606.84479827492,2130.4127318819947,132737.2575301569,2522,12,864.3513513513514,33,4,14,35.13105442992446,0.632891414141414,44.45465686274511,1022.1813725490214,30.9751931075461,0
2543,4,0,0,37,0.0,0.0,1.0,37,1250,1000,250,0.8,15,10,5,363.9030859113929,0.8116241241241241,0.1448218702650903,0.21037832141193297,130826.15460399872,2121.608275663239,132947.76287966195,2523,13,865.3513513513514,33,4,17,34.933017888516204,0.6351010101010099,44.24019607843139,1023.0392156862765,31.001188354129592,0
2544,4,0,0,37,0.0,0.0,1.0,37,1050,900,150,0.8571428571428571,12,9,3,363.8739287891282,0.8109984984984985,0.1444893995792198,0.21070369662893365,130888.84833958105,2125.407896001554,133014.2562355826,2524,14,866.3513513513514,33,4,18,34.870259481037934,0.6357323232323231,44.17892156862746,1023.2843137254912,31.008615567439126,0
2545,4,0,0,37,0.0,0.0,1.0,37,850,700,150,0.8235294117647058,10,7,3,356.0551363746354,0.8109984984984985,0.14709132924746338,0.2043457523900952,130544.21864487206,1896.187914504022,132440.40655937608,2525,15,867.3513513513514,33,4,18,35.419289882879646,0.632260101010101,44.51593137254901,1021.9362745098031,30.967765894236457,1
2546,4,0,0,37,0.0,0.0,1.0,37,1050,900,150,0.8571428571428571,12,9,3,354.7414685946564,0.8088088088088088,0.13794309588198117,0.20458310680182507,130732.14215986647,1875.22242046329,132607.36458032977,2526,16,868.3513513513514,33,4,18,35.262507489514675,0.6341540404040404,44.33210784313726,1022.6715686274516,30.9900475341652,0
2547,4,0,0,37,0.0,0.0,1.0,37,1250,1000,250,0.8,15,10,5,379.8054285441641,0.8092467467467468,0.12957160493427144,0.21832922670481533,130606.84479827459,2521.0377318819515,133127.88253015652,2527,17,869.3513513513514,33,4,16,34.74890600647404,0.6328914141414143,44.45465686274509,1022.1813725490186,30.97519310754602,5
2548,4,0,0,37,0.0,0.0,1.0,37,1250,900,350,0.72,16,9,7,380.9060095108088,0.8096221221221221,0.13210621624861152,0.2193166899481486,130669.48596993917,2554.5584931276103,133224.0444630668,2528,18,870.3513513513514,33,4,17,34.65717267969156,0.6335227272727274,44.39338235294116,1022.4264705882331,30.98262032085555,0
2549,4,1,0,38,0.02631578947368421,0.0,1.0,38,950,600,350,0.631578947368421,13,6,7,374.05094188944054,0.8158783783783784,0.13137079642225258,0.21683856691999462,130931.84700963715,2195.036139455777,133126.88314909293,2529,0,848.421052631579,34,4,18,34.56632158504904,0.6338848039215685,44.13690476190476,1023.4523809523806,30.10154061624649,0
2550,4,1,1,38,0.02564102564102564,0.02564102564102564,0.9743589743589743,39,950,600,350,0.631578947368421,13,6,7,364.2343470545104,0.8211313540260909,0.12052324840395379,0.21267826122206637,131209.51753257884,1758.2025891632375,132967.72012174208,2530,0,827.6410256410256,35,4,18,34.53645127278205,0.6345238095238095,43.86574074074074,1024.537037037037,29.27248677248677,0
2551,4,0,1,37,0.0,0.02631578947368421,0.9736842105263158,38,550,300,250,0.5454545454545454,8,3,5,372.5897974663057,0.8139521100047415,0.12926002520833602,0.2168482704874941,131084.19075963722,2168.1264172335664,133252.3171768708,2531,2,850.421052631579,34,4,18,34.449352863675124,0.6354166666666666,43.98809523809524,1024.0476190476193,30.119047619047624,0
2552,4,1,0,38,0.02631578947368421,0.0,1.0,38,900,800,100,0.8888888888888888,10,8,2,371.3218969983605,0.8206792318634424,0.11425987800018356,0.21323066794186799,130566.58340419506,2096.446286848076,132663.02969104314,2532,0,844.0,34,4,16,35.0065521258008,0.6302083333333333,44.49404761904762,1022.0238095238099,30.05952380952382,2
2553,4,1,1,38,0.02564102564102564,0.02564102564102564,0.9743589743589743,39,1050,700,350,0.6666666666666666,14,7,7,361.4472558366948,0.8274291497975709,0.11342980451891349,0.20980559103164448,130982.06948502548,1668.6219158347415,132650.69140086023,2533,0,823.3333333333334,36,3,17,34.83796296296295,0.6302083333333335,44.08783783783783,1023.648648648648,28.434684684684665,0
2554,4,0,0,38,0.0,0.0,1.0,38,750,500,250,0.6666666666666666,10,5,5,370.721320202289,0.8221017069701281,0.12157656584901111,0.21447489990760685,130854.01663237301,2102.074759945114,132956.09139231814,2534,1,845.8947368421053,35,3,17,34.73039215686273,0.630952380952381,44.212962962962955,1023.1481481481474,29.23280423280421,0
2555,4,1,1,38,0.02564102564102564,0.02564102564102564,0.9743589743589743,39,700,400,300,0.5714285714285714,10,4,6,361.90235559473757,0.8300157444894287,0.11755684301038882,0.21085854735004106,131126.2038009294,1690.9764071504,132817.18020807978,2535,0,825.1794871794872,36,3,17,34.6804562946674,0.6316550925925926,43.947072072072075,1024.2117117117123,28.45032532532534,0
2556,4,0,0,38,0.0,0.0,1.0,38,850,600,250,0.7058823529411765,11,6,5,371.6186875697398,0.8206792318634424,0.1185846710377576,0.21598810185557932,131031.70680084013,2138.7661822702253,133170.47298311035,2536,3,847.8947368421053,35,3,17,34.527375838420376,0.6327380952380952,44.03935185185185,1023.842592592592,29.252645502645485,0
2557,4,1,0,39,0.02564102564102564,0.0,1.0,39,950,700,250,0.7368421052631579,12,7,5,363.2097296582722,0.822199730094467,0.12320200125078196,0.21273712737127373,131328.125,1740.2654535322367,133068.39045353225,2537,0,827.1282051282051,35,4,19,34.442750677506766,0.6357142857142857,43.75,1025.0,29.285714285714285,0
2558,4,0,0,39,0.0,0.0,1.0,39,700,500,200,0.7142857142857143,9,5,4,363.4524158051701,0.8215249662618084,0.1239427164266349,0.21370616167548848,131476.45968632106,1757.0873789008815,133233.54706522194,2538,1,828.1282051282051,35,4,20,34.28659763758794,0.637202380952381,43.60532407407407,1025.578703703703,29.302248677248656,0
2559,4,1,0,40,0.025,0.0,1.0,40,900,400,500,0.4444444444444444,14,4,10,351.2617559652703,0.8229967948717949,0.12580565603419958,0.20903855183764913,131934.8206948502,1268.7313580472342,133203.55205289743,2539,0,808.4,36,4,19,34.13693412254741,0.6397569444444444,43.15878378378378,1027.3648648648646,28.537912912912905,0
2560,4,0,0,40,0.0,0.0,1.0,40,850,400,450,0.47058823529411764,13,4,9,351.92373803715526,0.8224626068376069,0.13257260273972626,0.2097520646367761,131992.6741564199,1290.271056529504,133282.94521294942,2540,1,809.4,36,4,19,34.061643835616444,0.6403356481481481,43.10247747747748,1027.59009009009,28.544169169169166,0
2561,4,0,1,39,0.0,0.025,0.975,40,1000,600,400,0.6,14,6,8,351.92373803715526,0.8224626068376069,0.13257260273972626,0.2097520646367761,131992.6741564199,1290.271056529504,133282.94521294942,2541,2,810.4,36,4,19,34.061643835616444,0.6403356481481481,43.10247747747748,1027.59009009009,28.544169169169166,0
2562,4,0,0,39,0.0,0.0,1.0,39,1050,700,350,0.6666666666666666,14,7,7,356.1544357837487,0.8168578497525866,0.15121882208921966,0.21271066201718034,132070.63567654745,1607.5085465963573,133678.1442231438,2542,3,830.7435897435897,35,4,19,33.87439946702698,0.643154761904762,43.02662037037037,1027.8935185185182,29.368386243386237,0
2563,4,0,0,39,0.0,0.0,1.0,39,750,600,150,0.8,9,6,3,356.9298550867458,0.8161268556005399,0.15046891642636373,0.21350894967916248,132130.12695312497,1632.237413194444,133762.3643663194,2543,4,831.7435897435897,35,4,19,33.794537318473495,0.64375,42.96875,1028.1249999999998,29.374999999999993,0
2564,4,0,0,39,0.0,0.0,1.0,39,1150,800,350,0.6956521739130435,15,8,7,361.4902444339842,0.8140463337831759,0.15659258233515638,0.21708954679251719,132278.91375171483,1763.507373113873,134042.42112482872,2544,5,832.7435897435897,35,4,19,33.52741524152417,0.6452380952380952,42.82407407407408,1028.7037037037048,29.391534391534424,0
2565,4,0,0,39,0.0,0.0,1.0,39,950,400,550,0.42105263157894735,15,4,11,364.5116194190974,0.8123031938821412,0.16514860409402532,0.220132436084941,132489.9092970522,1858.8758625878363,134348.78515964,2545,6,833.7435897435897,34,5,20,33.237212843046564,0.6495098039215685,42.61904761904762,1029.5238095238096,30.28011204481793,0
2566,4,0,1,38,0.0,0.02564102564102564,0.9743589743589743,39,1050,800,250,0.7619047619047619,13,8,5,364.21117296376207,0.8113472784525416,0.1646255236265639,0.22013014919382104,132520.5516581633,1853.0931122448994,134373.64477040822,2546,7,834.7435897435897,34,5,21,33.21409989594172,0.6498161764705883,42.589285714285715,1029.6428571428576,30.283613445378165,0
2567,4,0,0,38,0.0,0.0,1.0,38,950,800,150,0.8421052631578947,11,8,3,389.11423702763256,0.8069582740635373,0.1360511104350477,0.2353732972230081,132551.19756235802,2718.916524943284,135270.1140873013,2547,8,856.7631578947369,34,4,21,32.54214836223507,0.6501225490196079,42.559523809523796,1029.7619047619028,30.287114845938316,3
2568,4,1,0,39,0.02564102564102564,0.0,1.0,39,1100,500,600,0.45454545454545453,17,5,12,382.4911493005806,0.8094916779127306,0.14050902141596966,0.23355816649204023,132904.7325772674,2366.97678219304,135271.70935946042,2548,0,835.7692307692307,35,4,18,32.35644198750327,0.6514880952380953,42.21643518518517,1031.134259259257,29.460978835978775,0
2569,4,0,0,39,0.0,0.0,1.0,39,1100,800,300,0.7272727272727273,14,8,6,382.4911493005806,0.8094354475933424,0.14050902141596966,0.23355816649204023,132904.7325772674,2366.97678219304,135271.70935946042,2549,1,836.7692307692307,35,4,18,32.35644198750327,0.6514880952380953,42.21643518518517,1031.134259259257,29.460978835978775,0
2570,4,0,0,39,0.0,0.0,1.0,39,1000,600,400,0.6,14,6,8,391.23891656001376,0.8094354475933424,0.13483394019640316,0.2225862084609796,130205.1137920015,2388.261530111198,132593.3753221127,2550,2,837.7692307692307,36,3,20,34.86543271175843,0.6223958333333334,44.847972972972975,1020.6081081081085,28.350225225225234,6
2571,4,1,2,38,0.025,0.05,0.95,40,900,700,200,0.7777777777777778,11,7,4,380.5311969227546,0.8127938034188035,0.13016538287267831,0.21813827314506976,130498.99798525359,1931.8133433107607,132430.81132856436,2551,0,817.8,35,5,17,34.83990333786438,0.6273809523809524,44.560185185185176,1021.7592592592578,29.19312169312165,0
2572,4,0,0,38,0.0,0.0,1.0,38,1100,1000,100,0.9090909090909091,12,10,2,395.1887425279263,0.8048245614035088,0.14319262835624058,0.2249948044127683,130233.05047850216,2693.32709083504,132926.3775693372,2552,13,861.7631578947369,35,3,20,34.73619930453189,0.6247023809523811,44.82060185185185,1020.717592592592,29.163359788359774,0
2573,4,0,1,37,0.0,0.02631578947368421,0.9736842105263158,38,800,600,200,0.75,10,6,4,396.6533829282103,0.8043800379326695,0.14705510776461028,0.2263641086683458,130325.14537677824,2738.788656821518,133063.93403359974,2553,14,862.7631578947369,33,5,20,34.60503680588894,0.630050505050505,44.73039215686275,1021.0784313725496,30.94177064765302,0
2574,4,0,0,37,0.0,0.0,1.0,37,400,200,200,0.5,6,2,4,390.9251199460991,0.8013013013013013,0.14074214074214075,0.22360916860916857,130414.54081632647,2796.4640022675662,133211.00481859402,2554,15,874.5405405405405,34,3,20,34.66030497280497,0.6286764705882353,44.64285714285714,1021.4285714285709,30.04201680672267,0
2575,4,0,0,37,0.0,0.0,1.0,37,850,600,250,0.7058823529411765,11,6,5,391.9578854770765,0.8017392392392393,0.13447071678459288,0.22472775758515354,130505.75573979596,2830.5520124716604,133336.30775226763,2555,16,875.5405405405405,34,3,17,34.5411472290186,0.6295955882352942,44.55357142857143,1021.7857142857147,30.052521008403374,0
2576,4,0,0,37,0.0,0.0,1.0,37,1100,800,300,0.7272727272727273,14,8,6,390.43419289831,0.8018018018018018,0.1329544703627834,0.22491209140198426,130688.28125000001,2805.034722222224,133493.31597222225,2556,17,876.5405405405405,34,3,17,34.39452594403694,0.6314338235294117,44.375,1022.5000000000001,30.07352941176471,0
2577,4,0,2,35,0.0,0.05405405405405406,0.9459459459459459,37,950,700,250,0.7368421052631579,12,7,5,390.53776368125574,0.8001126126126126,0.13439906386833766,0.22550406354498295,130779.59183673456,2814.873866213136,133594.4657029477,2557,18,877.5405405405405,34,3,17,34.29910575729361,0.6323529411764707,44.28571428571428,1022.8571428571418,30.084033613445346,0
2578,4,2,2,35,0.05405405405405406,0.05405405405405406,0.9459459459459459,37,900,600,300,0.6666666666666666,12,6,6,382.3320473954298,0.8125,0.1127702152925909,0.22269482760615295,131114.6701388887,2625.8680555555325,133740.53819444423,2558,0,819.2972972972973,34,3,18,34.16903986981285,0.6357230392156864,43.95833333333332,1024.1666666666652,30.1225490196078,0
2579,4,0,0,35,0.0,0.0,1.0,35,500,100,400,0.2,9,1,8,401.1481633684694,0.7960084033613445,0.12858377272647137,0.2316251797183156,130778.66934815311,3492.324603356781,134270.99395150988,2559,20,867.1142857142858,32,3,18,34.02872073406574,0.6370442708333335,44.28661616161615,1022.8535353535343,31.964172979797947,0
2580,4,0,0,35,0.0,0.0,1.0,35,800,500,300,0.625,11,5,6,401.1481633684694,0.7960084033613445,0.12858377272647137,0.2316251797183156,130778.66934815311,3492.324603356781,134270.99395150988,2560,21,868.1142857142858,32,3,18,34.02872073406574,0.6370442708333335,44.28661616161615,1022.8535353535343,31.964172979797947,0
2581,4,0,0,35,0.0,0.0,1.0,35,900,700,200,0.7777777777777778,11,7,4,397.83289621252686,0.7943277310924369,0.12828592576927145,0.2306747823103535,130940.15438475659,3418.460169880618,134358.6145546372,2561,22,869.1142857142858,32,3,19,33.94938934122873,0.638671875,44.128787878787875,1023.4848484848479,31.983901515151498,0
2582,4,0,0,35,0.0,0.0,1.0,35,1050,900,150,0.8571428571428571,12,9,3,399.85713470393205,0.7936974789915966,0.12971506105834463,0.23204307738330546,130972.46334876539,3474.0547839506153,134446.518132716,2562,23,870.1142857142858,32,3,19,33.8647670737223,0.6389973958333334,44.09722222222222,1023.6111111111109,31.987847222222214,0
2583,4,0,0,35,0.0,0.0,1.0,35,1150,900,250,0.782608695652174,14,9,5,403.1885700780787,0.7936274509803921,0.1305790363482675,0.23496161497653545,131134.06795224972,3574.3514692378294,134708.41942148755,2563,24,871.1142857142858,32,3,19,33.61532297830375,0.640625,43.93939393939394,1024.2424242424238,32.007575757575744,0
2584,4,0,0,35,0.0,0.0,1.0,35,750,400,350,0.5333333333333333,11,4,7,401.4640529850202,0.7923669467787114,0.12818348059405626,0.23418269496872163,131171.1560006968,3532.100784554009,134703.2567852508,2564,25,872.1142857142858,33,2,19,33.62181979503129,0.6385732323232323,43.9031862745098,1024.3872549019602,31.042038027332126,0
2585,4,0,0,35,0.0,0.0,1.0,35,1100,800,300,0.7272727272727273,14,8,6,399.5158077882834,0.7925070028011204,0.1273547505126451,0.2332368822004222,131202.5422914262,3483.497933487095,134686.04022491327,2565,26,873.1142857142858,33,2,19,33.63985247208931,0.6388888888888891,43.87254901960783,1024.5098039215673,31.045751633986885,0
2586,4,0,1,34,0.0,0.02857142857142857,0.9714285714285714,35,650,400,250,0.6153846153846154,9,4,5,401.8743806405225,0.7924369747899159,0.12662725937062236,0.23499815181231098,131265.326136582,3550.4343281430097,134815.76046472503,2566,27,874.1142857142858,33,2,19,33.51570597145817,0.6395202020202021,43.811274509803916,1024.7549019607836,31.053178847296472,0
2587,4,2,2,34,0.05555555555555555,0.05555555555555555,0.9444444444444444,36,900,700,200,0.7777777777777778,11,7,4,384.7778431279141,0.8037367724867726,0.13336450333585348,0.22779392168781176,131736.68368235772,2937.8864198865813,134674.5701022443,2567,0,848.9444444444445,33,3,15,33.47645835820302,0.6442550505050505,43.35171568627451,1026.5931372549019,31.10888294711824,0
2588,4,0,0,34,0.0,0.0,1.0,34,900,600,300,0.6666666666666666,12,6,6,401.70783072550694,0.7868761140819965,0.1438385845891761,0.23549112072240658,131361.4930046931,3753.788079155839,135115.28108384894,2568,29,899.8823529411765,31,3,20,33.42237711164741,0.6454973118279569,43.71744791666668,1025.1302083333348,33.068716397849514,0
2589,4,1,0,35,0.02857142857142857,0.0,1.0,35,850,600,250,0.7058823529411765,11,6,5,388.16911515817816,0.7977591036414565,0.13525402290773658,0.23007224813894359,131781.48275686157,3230.700311192738,135012.18306805432,2569,0,875.1428571428571,32,3,17,33.34409329398262,0.6471354166666666,43.30808080808081,1026.7676767676771,32.08648989898991,0
2590,4,0,0,35,0.0,0.0,1.0,35,550,300,250,0.5454545454545454,8,3,5,388.3582281031715,0.7977591036414565,0.13387193087217675,0.23057706769278813,131846.31191970207,3240.720015814712,135087.03193551677,2570,1,876.1428571428571,32,3,17,33.27365584788133,0.6477864583333334,43.244949494949495,1027.020202020202,32.094381313131315,0
2591,4,0,0,35,0.0,0.0,1.0,35,1350,800,550,0.5925925925925926,19,8,11,388.6778670562456,0.7978991596638655,0.13830115830115863,0.23195292066259815,132040.8950617284,3264.2746913580286,135305.16975308643,2571,2,877.1428571428571,32,3,18,33.06869369369371,0.6497395833333334,43.05555555555556,1027.7777777777778,32.11805555555556,0
2592,4,0,0,35,0.0,0.0,1.0,35,800,600,200,0.75,10,6,4,390.1861684967574,0.7953781512605042,0.1497889146125566,0.233888737573199,132208.8860053825,3317.2157343329472,135526.10173971544,2572,3,878.1428571428571,33,2,20,32.86016444232603,0.648989898989899,42.8921568627451,1028.4313725490192,31.164587046939975,0
2593,4,0,0,35,0.0,0.0,1.0,35,500,400,100,0.8,6,4,2,390.2250757920127,0.7947478991596638,0.15243315007404123,0.23410715233183446,132240.39619677525,3320.703725730485,135561.09992250573,2573,4,879.1428571428571,33,2,20,32.827331307835884,0.6493055555555556,42.861519607843135,1028.5539215686274,31.16830065359477,0
2594,4,1,0,36,0.027777777777777776,0.0,1.0,36,800,300,500,0.375,13,3,10,381.9739692861828,0.797718253968254,0.1579890025643058,0.2316647320216199,132650.37035034603,2933.8915621395586,135584.26191248558,2574,0,855.6944444444445,33,3,17,32.62600126893489,0.6534090909090909,42.463235294117645,1030.1470588235293,31.216577540106947,0
2595,4,0,0,36,0.0,0.0,1.0,36,1300,1000,300,0.7692307692307693,16,10,6,379.77385499274493,0.7955026455026456,0.15898345153664306,0.23169234532661087,132871.38848339583,2892.215884515574,135763.6043679114,2575,1,856.6944444444445,33,3,18,32.46005685645232,0.6556186868686869,42.24877450980392,1031.0049019607845,31.24257278669044,0
2596,4,0,1,35,0.0,0.027777777777777776,0.9722222222222222,36,700,500,200,0.7142857142857143,9,5,4,379.9337459741025,0.7956349206349207,0.16133824578084166,0.23198567043730775,132902.97752066524,2898.8652201076675,135801.8427407729,2576,2,857.6944444444445,33,3,18,32.424134379209264,0.6559343434343433,42.21813725490197,1031.1274509803932,31.246286393345247,0
2597,4,0,0,35,0.0,0.0,1.0,35,750,500,250,0.6666666666666666,10,5,5,381.7685042838383,0.7926470588235294,0.1431194585803477,0.2336080083516612,132983.40292125818,3153.7749655647544,136137.17788682293,2559,3,809.6,32,3,18,32.29587464805975,0.6591796875,42.14015151515152,1031.439393939395,32.23248106060609,0
2598,4,0,1,34,0.0,0.02857142857142857,0.9714285714285714,35,550,400,150,0.7272727272727273,7,4,3,379.92899359799543,0.7925070028011204,0.1428361653031256,0.23309157174795953,133081.09504132243,3112.2733011937735,136193.36834251622,2560,4,810.6,32,3,18,32.24501346059717,0.66015625,42.045454545454554,1031.818181818183,32.244318181818215,0
2599,4,0,0,34,0.0,0.0,1.0,34,850,400,450,0.47058823529411764,13,4,9,387.16866998741693,0.7815656565656566,0.14597458728473045,0.23681567837608744,132968.14176771385,3496.219719780826,136464.36148749467,2561,5,835.1764705882352,31,3,19,32.17199532887262,0.6616263440860215,42.15494791666667,1031.3802083333342,33.27032930107529,0
2600,4,0,0,34,0.0,0.0,1.0,34,1000,800,200,0.8,12,8,4,390.0559551778915,0.7795231729055259,0.14310030876415158,0.23951369809683773,133113.66705246922,3584.355709876552,136698.02276234576,2562,6,836.1764705882352,32,2,19,31.950986989681468,0.6604817708333333,42.01388888888889,1031.9444444444453,32.248263888888914,0
2601,4,0,0,34,0.0,0.0,1.0,34,650,500,150,0.7692307692307693,8,5,3,355.664041964268,0.7799688057040999,0.07894964682794559,0.21463574642003505,132462.98408644513,2630.1801155494213,135093.16420199454,2563,7,837.1764705882352,32,2,19,33.492017253362796,0.6539713541666667,42.645202020202014,1029.4191919191908,32.16934974747471,4
2602,4,0,0,34,0.0,0.0,1.0,34,600,600,0,1.0,6,6,0,357.1941018398047,0.7794860368389781,0.08037917153616436,0.21574523751124203,132495.48037190083,2665.320821854919,135160.80119375576,2564,8,838.1764705882352,32,2,19,33.41994726514596,0.654296875,42.61363636363637,1029.5454545454547,32.17329545454546,0
2603,4,0,0,34,0.0,0.0,1.0,34,500,400,100,0.8,6,4,2,357.1941018398047,0.7794860368389781,0.08037917153616436,0.21574523751124203,132495.48037190083,2665.320821854919,135160.80119375576,2565,9,839.1764705882352,32,2,19,33.41994726514596,0.654296875,42.61363636363637,1029.5454545454547,32.17329545454546,0
2604,4,0,0,34,0.0,0.0,1.0,34,800,700,100,0.875,9,7,2,359.42191517268714,0.779077540106952,0.0858566928793334,0.21840969841580782,132723.0659658453,2740.715711407,135463.78167725232,2566,10,840.1764705882352,32,2,17,33.13370501980967,0.6565755208333334,42.39267676767677,1030.4292929292928,32.2009154040404,0
2605,4,0,0,34,0.0,0.0,1.0,34,1050,500,550,0.47619047619047616,16,5,11,358.60004672460855,0.7799688057040999,0.07991426821800363,0.21866836306993506,132853.20255905017,2728.232929037861,135581.43548808803,2567,11,841.1764705882352,32,2,19,33.02408654827516,0.6578776041666666,42.266414141414145,1030.934343434344,32.21669823232325,0
2606,4,0,0,34,0.0,0.0,1.0,34,600,400,200,0.6666666666666666,8,4,4,360.0877056931835,0.7793003565062389,0.07421185689899823,0.2199578378755594,132918.29476902867,2772.4487616059637,135690.74353063465,2568,12,842.1764705882352,32,2,19,32.920339986123004,0.6585286458333333,42.20328282828283,1031.1868686868688,32.22458964646465,0
2607,4,0,0,34,0.0,0.0,1.0,34,600,300,300,0.5,9,3,6,360.2821919162713,0.7794860368389781,0.07944416444668434,0.22065258680329364,133015.96297571683,2784.6565401489706,135800.6195158658,2569,13,843.1764705882352,32,2,20,32.81721746226029,0.6595052083333333,42.10858585858586,1031.565656565657,32.23642676767678,0
2608,4,0,0,34,0.0,0.0,1.0,34,600,500,100,0.8333333333333334,7,5,2,362.68027509569947,0.7776292335115865,0.08609795765627037,0.22289838861896608,133146.2430491788,2857.9032114070123,136004.1462605858,2570,14,844.1764705882352,32,2,20,32.62453103335779,0.6608072916666666,41.98232323232324,1032.070707070708,32.25220959595963,0
2609,4,0,0,34,0.0,0.0,1.0,34,1000,700,300,0.7,13,7,6,364.17315774056846,0.7782234105763518,0.09321875449446315,0.22499519866448986,133341.78272625222,2911.8996148351944,136253.6823410874,2571,15,845.1764705882352,32,2,21,32.38972086389568,0.6627604166666667,41.79292929292928,1032.828282828281,32.275883838383784,0
2610,4,0,0,34,0.0,0.0,1.0,34,950,800,150,0.8421052631578947,11,8,3,362.74486548116624,0.7784462269756388,0.09416653486131676,0.22450669359810158,133406.99450311193,2878.540455055605,136285.53495816753,2572,16,846.1764705882352,32,2,21,32.36117901083679,0.6634114583333334,41.72979797979798,1033.080808080808,32.28377525252525,0
2611,4,0,0,34,0.0,0.0,1.0,34,950,700,250,0.7368421052631579,12,7,5,364.7551710613862,0.7787061794414736,0.09297854755830248,0.2263473142636426,133504.84206012142,2939.3163006325894,136444.158360754,2573,17,847.1764705882352,32,2,21,32.211107717369174,0.6643880208333334,41.63510101010101,1033.459595959596,32.29561237373738,0
2612,4,0,0,34,0.0,0.0,1.0,34,950,700,250,0.7368421052631579,12,7,5,370.6020475251245,0.7777035056446822,0.09368670545141145,0.2309916871560707,133668.00103305784,3107.5269742883356,136775.52800734618,2574,18,848.1764705882352,32,2,21,31.89636752136753,0.666015625,41.47727272727273,1034.090909090909,32.31534090909091,0
2613,4,1,1,34,0.02857142857142857,0.02857142857142857,0.9714285714285714,35,900,600,300,0.6666666666666666,12,6,6,365.1799306746963,0.7838935574229692,0.09806931530008445,0.22993818287639228,134042.68340301808,2789.939566512883,136832.62296953096,2575,0,824.9142857142857,33,2,16,31.661242603550303,0.6672979797979798,41.115196078431374,1035.5392156862747,31.379976232917414,0
2614,4,0,0,34,0.0,0.0,1.0,34,850,500,350,0.5882352941176471,12,5,7,372.50347737292464,0.7755496137849079,0.10173377634572178,0.2336198166813973,133896.59098880214,3175.389150341794,137071.98013914394,2576,20,850.1764705882352,32,2,16,31.618020820625436,0.6682942708333334,41.25631313131313,1034.9747474747471,32.34296085858585,0
2615,4,0,0,34,0.0,0.0,1.0,34,850,600,250,0.7058823529411765,11,6,5,370.2702803944369,0.7742498514557339,0.1017255475708938,0.23325321350193343,134059.9890955005,3127.6859504132294,137187.67504591373,2577,21,851.1764705882352,32,2,16,31.51213118751525,0.669921875,41.09848484848485,1035.606060606061,32.362689393939405,0
2616,4,0,0,34,0.0,0.0,1.0,34,550,300,250,0.5454545454545454,8,3,5,366.8178453090301,0.7732843137254902,0.09817063554644423,0.23190348525469168,134190.7793209875,3044.7145061728243,137235.49382716033,2578,22,852.1764705882352,32,2,17,31.470621090259165,0.6712239583333335,40.972222222222214,1036.11111111111,32.378472222222186,0
2617,4,0,0,34,0.0,0.0,1.0,34,850,600,250,0.7058823529411765,11,6,5,369.6730614309813,0.7730614973262032,0.09603783047932946,0.23454527313356685,134321.63331547793,3131.0178808284786,137452.6511963064,2579,23,853.1764705882352,32,2,17,31.26573284612261,0.6725260416666667,40.84595959595959,1036.616161616161,32.39425505050503,0
2618,4,0,0,34,0.0,0.0,1.0,34,900,700,200,0.7777777777777778,11,7,4,369.13317479128006,0.7718731431966727,0.09390710265114088,0.2350434029252383,134452.5510789715,3126.1794077134973,137578.730486685,2580,24,854.1764705882352,32,2,17,31.148800827854892,0.673828125,40.71969696969697,1037.121212121212,32.410037878787875,0
2619,4,0,0,34,0.0,0.0,1.0,34,950,800,150,0.8421052631578947,11,8,3,370.25506077864566,0.770907605466429,0.08776275846268411,0.2361813338010366,134518.03387409443,3161.196561575345,137679.23043566977,2581,25,855.1764705882352,32,2,18,31.054243752028555,0.6744791666666667,40.656565656565654,1037.373737373737,32.41792929292928,0
2620,4,0,0,34,0.0,0.0,1.0,34,750,600,150,0.8,9,6,3,369.187593748488,0.7699420677361855,0.08965272856130402,0.23571207908557315,134550.78125,3134.895833333334,137685.67708333334,2582,26,856.1764705882352,32,2,18,31.049196787148585,0.6748046875,40.625,1037.5,32.421875,0
2621,4,0,0,34,0.0,0.0,1.0,34,1050,900,150,0.8571428571428571,12,9,3,368.95849700055345,0.7705362448009507,0.08870765729335939,0.23598987446284425,134616.28795849907,3133.5646553923034,137749.8526138914,2583,27,857.1764705882352,32,2,19,30.989678387476175,0.6754557291666667,40.561868686868685,1037.752525252525,32.429766414141405,0
2622,4,0,0,34,0.0,0.0,1.0,34,1200,800,400,0.6666666666666666,16,8,8,366.7557640625362,0.7702391562685681,0.09248552845295843,0.23500382980187906,134681.81060924896,3079.066071064169,137760.87668031314,2584,28,858.1764705882352,32,2,19,30.98137898876861,0.6761067708333334,40.49873737373737,1038.0050505050497,32.4376578282828,0
2623,4,0,0,34,0.0,0.0,1.0,34,650,400,250,0.6153846153846154,9,4,5,364.9903267839027,0.7702020202020202,0.09059567406729196,0.23450628495865747,134780.12447709416,3038.6883353739368,137818.8128124681,2585,29,859.1764705882352,32,2,17,30.929038991569385,0.6770833333333334,40.4040404040404,1038.3838383838383,32.44949494949495,0
2624,4,0,0,34,0.0,0.0,1.0,34,1000,700,300,0.7,13,7,6,360.77248765829984,0.7696078431372549,0.09157228706806864,0.2160390543742052,132170.69686766647,2736.7102208958086,134907.40708856226,2586,30,860.1764705882352,32,2,18,33.654889079895206,0.6510416666666667,42.92929292929292,1028.2828282828275,32.13383838383836,8
2625,4,0,0,34,0.0,0.0,1.0,34,850,700,150,0.8235294117647058,10,7,3,361.3470829949897,0.7695707070707071,0.09681297337886918,0.21694139168461168,132268.09007052841,2758.9377040607937,135027.0277745892,2587,31,861.1764705882352,32,2,18,33.541999099873145,0.6520182291666667,42.83459595959595,1028.6616161616153,32.14567550505048,0
2626,4,0,0,34,0.0,0.0,1.0,34,700,400,300,0.5714285714285714,10,4,6,362.4055467226151,0.7673425430778372,0.09490354846392068,0.21832724400118494,132398.0034722221,2796.354166666657,135194.35763888876,2588,32,862.1764705882352,32,2,18,33.383940620782745,0.6533203125,42.70833333333333,1029.1666666666656,32.1614583333333,0
2627,4,0,0,34,0.0,0.0,1.0,34,900,700,200,0.7777777777777778,11,7,4,363.0905293844054,0.766971182412359,0.10442366792191482,0.2193066797481808,132495.48037190075,2821.570821854905,135317.05119375564,2589,33,863.1764705882352,32,2,19,33.26818126073094,0.654296875,42.61363636363636,1029.545454545454,32.17329545454544,0
2628,4,0,0,34,0.0,0.0,1.0,34,1000,800,200,0.8,12,8,4,364.31370582887,0.7664512774806893,0.03831421656319067,0.2171123257551581,131988.41979346875,2817.0380682910327,134805.4578617598,2590,34,864.1764705882352,33,1,19,33.74763963426755,0.6467803030303031,43.10661764705882,1027.573529411764,31.138591800356483,3
2629,4,0,0,34,0.0,0.0,1.0,34,800,600,200,0.75,10,6,4,363.64254496227227,0.7661913250148544,0.04370389071222225,0.2172531101954086,132082.88278546702,2806.1911284121375,134889.07391387917,2591,35,865.1764705882352,33,1,20,33.66962724527102,0.6477272727272728,43.014705882352935,1027.9411764705874,31.14973262032083,0
2630,4,0,0,34,0.0,0.0,1.0,34,950,700,250,0.7368421052631579,12,7,5,365.23617299511716,0.7639631610219846,0.04294005495429798,0.21893299741250144,132208.88600538232,2857.493512110696,135066.379517493,2592,36,866.1764705882352,33,1,20,33.501648395297096,0.6489898989898992,42.89215686274508,1028.4313725490179,31.164587046939936,0
2631,4,0,0,34,0.0,0.0,1.0,34,800,600,200,0.75,10,6,4,366.6284431468999,0.7642602495543672,0.044941064345681125,0.22013441715129292,132271.91014273342,2898.928897539389,135170.8390402728,2593,37,867.1764705882352,33,1,20,33.402331030100854,0.6496212121212122,42.83088235294117,1028.6764705882342,31.172014260249522,0
2632,4,1,1,34,0.02857142857142857,0.02857142857142857,0.9714285714285714,35,800,500,300,0.625,11,5,6,354.89837958695034,0.770658263305322,0.04385144896745152,0.21506278878358429,132618.81134960096,2413.300323192984,135032.11167279395,2594,0,843.3714285714286,33,2,20,33.35502181241323,0.6530934343434345,42.4938725490196,1030.0245098039204,31.212863933452134,0
2633,4,0,0,34,0.0,0.0,1.0,34,950,600,350,0.631578947368421,13,6,7,365.7111638486725,0.7609551396316103,0.053001774661299406,0.22088954296459812,132495.48037190075,2891.0152662993496,135386.49563820008,2595,39,869.1764705882352,32,2,20,33.200729703213156,0.654296875,42.61363636363636,1029.545454545454,32.17329545454544,0
2634,4,2,2,34,0.05555555555555555,0.05555555555555555,0.9444444444444444,36,750,400,350,0.5333333333333333,11,4,7,347.4718728711754,0.7809854497354498,0.0372037550015385,0.21260567136693928,132980.6122448978,2041.4044784580276,135022.01672335583,2596,0,821.8333333333334,34,2,16,33.18304670667897,0.6544117647058825,42.14285714285713,1031.4285714285702,30.336134453781476,0
2635,4,0,0,34,0.0,0.0,1.0,34,700,500,200,0.7142857142857143,9,5,4,363.2045599051005,0.7602495543672014,0.04635651760091153,0.22013542345511217,132625.50536935008,2834.037661973267,135459.54303132335,2597,41,871.1764705882352,32,2,16,33.13439772820136,0.6555989583333334,42.48737373737374,1030.050505050505,32.189078282828284,0
2636,4,0,0,34,0.0,0.0,1.0,34,1250,700,550,0.56,18,7,11,366.4242485887204,0.7612150920974451,0.0485175202156336,0.22285802660068044,132755.59413580227,2928.973765432077,135684.56790123435,2598,42,872.1764705882352,32,2,16,32.92059748427673,0.6569010416666667,42.3611111111111,1030.5555555555538,32.20486111111106,0
2637,4,0,0,34,0.0,0.0,1.0,34,500,300,200,0.6,7,3,4,366.3365605767701,0.7613636363636365,0.04828947747643908,0.22319191645886186,132820.6624324048,2931.412929803071,135752.07536220786,2599,43,873.1764705882352,32,2,16,32.85741262453047,0.6575520833333335,42.29797979797979,1030.8080808080801,32.212752525252505,0
2638,4,0,0,34,0.0,0.0,1.0,34,950,700,250,0.7368421052631579,12,7,5,368.49444561714745,0.7593211527035056,0.05020097679042235,0.22489728272867143,132885.7466712579,2993.531910009169,135879.27858126705,2600,44,874.1764705882352,32,2,16,32.73634582414891,0.658203125,42.23484848484848,1031.060606060605,32.22064393939391,0
2639,4,0,0,34,0.0,0.0,1.0,34,1250,900,350,0.72,16,9,7,368.11333220472557,0.7564245395127749,0.046655626754986024,0.2254487199484711,133015.9629757166,2992.989873482276,136008.95284919886,2601,45,875.1764705882352,32,2,16,32.615259077927384,0.6595052083333335,42.10858585858585,1031.5656565656552,32.236426767676726,0
2640,4,0,0,34,0.0,0.0,1.0,34,500,300,200,0.6,7,3,4,397.3655563125247,0.7564245395127749,0.06449454033110258,0.23009725348194043,130888.84833958093,3602.14400711265,134490.9923466936,2602,46,876.1764705882352,33,1,17,34.01347305389221,0.6357323232323232,44.17892156862745,1023.2843137254903,31.0086155674391,6
2641,4,0,0,34,0.0,0.0,1.0,34,550,300,250,0.5454545454545454,8,3,5,398.3822648799042,0.756833036244801,0.06423546313054174,0.23124996932187933,130982.91710219646,3636.2542351499683,134619.17133734643,2603,47,877.1764705882352,33,1,17,33.89189013927132,0.6366792929292928,44.08700980392158,1023.6519607843152,31.01975638740349,0
2642,4,0,0,34,0.0,0.0,1.0,34,1050,800,250,0.7619047619047619,13,8,5,399.7625749962446,0.7576871657754011,0.07058401249947188,0.2329996932927906,131139.77346453306,3684.9547049212047,134824.72816945426,2604,48,878.1764705882352,33,1,18,33.697256121879235,0.6382575757575757,43.933823529411775,1024.2647058823545,31.03832442067741,0
2643,4,0,0,34,0.0,0.0,1.0,34,850,700,150,0.8235294117647058,10,7,3,397.57971147790516,0.756387403446227,0.07129089144372647,0.2321282901613877,131206.12953514748,3632.979024943327,134839.1085600908,2605,49,879.1764705882352,34,0,18,33.685800604229634,0.636642156862745,43.86904761904763,1024.5238095238103,30.133053221288538,0
2644,4,1,1,34,0.02857142857142857,0.02857142857142857,0.9714285714285714,35,700,600,100,0.8571428571428571,8,6,2,385.5654964846723,0.7672268907563025,0.07586971728856362,0.22750809739719288,131610.9057363757,3149.0382212934524,134759.94395766914,2606,0,855.0285714285715,33,2,16,33.58351745690514,0.6429924242424241,43.47426470588237,1026.1029411764728,31.094028520499176,0
2645,4,1,1,34,0.02857142857142857,0.02857142857142857,0.9714285714285714,35,900,700,200,0.7777777777777778,11,7,4,383.501419738629,0.7774509803921568,0.07341482959098422,0.22741389922080518,131799.59518274243,3109.0663747116755,134908.6615574541,2607,0,850.6,33,2,17,33.44559314954052,0.6448863636363635,43.2904411764706,1026.8382352941194,31.11631016042786,0
2646,4,0,1,33,0.0,0.029411764705882353,0.9705882352941176,34,950,700,250,0.7368421052631579,12,7,5,390.6945244986849,0.7679367201426025,0.08174596858790273,0.2313719722286094,131749.0741537853,3494.7283759310244,135243.80252971634,2608,2,876.6176470588235,32,2,17,33.31206698643054,0.6468098958333334,43.339646464646464,1026.641414141414,32.08254419191919,0
2647,4,0,0,33,0.0,0.0,1.0,33,700,400,300,0.5714285714285714,10,4,6,391.6456952038517,0.7657828282828284,0.0758747613064843,0.23242359654422703,131829.0901184082,3726.0591295030376,135555.14924791123,2609,3,862.6060606060606,31,2,17,33.206674485440175,0.6502016129032258,43.26171875,1026.953125,33.12752016129032,0
2648,4,0,0,33,0.0,0.0,1.0,33,750,600,150,0.8,9,6,3,390.6553216730145,0.764993686868687,0.07680813714531554,0.23224414714984265,131895.95752292217,3705.171542697486,135601.12906561967,2610,4,863.6060606060606,31,2,17,33.164453669666614,0.6508736559139785,43.196614583333336,1027.2135416666672,33.13592069892475,0
2649,4,1,1,33,0.029411764705882353,0.029411764705882353,0.9705882352941176,34,1050,900,150,0.8571428571428571,12,9,3,379.3949188449284,0.773135769459299,0.06785969573787543,0.2277767430972462,132268.0900705285,3236.368259616363,135504.45833014487,2611,0,839.1764705882352,32,2,19,33.07787120003273,0.6520182291666667,42.83459595959596,1028.661616161616,32.1456755050505,0
2650,4,0,0,33,0.0,0.0,1.0,33,1200,1000,200,0.8333333333333334,14,10,4,388.90723766864835,0.766177398989899,0.07562518946588859,0.23284309748819698,132163.59668307842,3679.875861273881,135843.4725443523,2612,6,865.6060606060606,31,2,19,32.93880059938374,0.6535618279569892,42.93619791666667,1028.255208333334,33.16952284946238,0
2651,4,0,0,33,0.0,0.0,1.0,33,700,500,200,0.7142857142857143,9,5,4,389.1340342725024,0.765546085858586,0.07547748950635746,0.2331851747104875,132197.07065158425,3688.4758843316013,135885.54653591584,2613,7,866.6060606060606,31,2,19,32.89915168397063,0.6538978494623656,42.903645833333336,1028.385416666667,33.17372311827958,0
2652,4,0,0,33,0.0,0.0,1.0,33,900,500,400,0.5555555555555556,13,5,8,390.91820895568264,0.7654671717171718,0.0795502481151682,0.23508642976923952,132331.00891113293,3746.1201985677226,136077.12910970065,2614,8,867.6060606060606,31,2,19,32.7179827891673,0.6552419354838709,42.77343750000001,1028.906250000001,33.19052419354842,0
2653,4,0,0,33,0.0,0.0,1.0,33,1000,600,400,0.6,14,6,8,391.42130630108574,0.7627840909090909,0.07735580346546356,0.2364579815667443,132501.77043588858,3772.820168454494,136274.59060434307,2615,9,868.6060606060606,30,3,19,32.53263707571801,0.6597222222222222,42.60752688172043,1029.5698924731187,34.31899641577062,0
2654,4,1,0,34,0.029411764705882353,0.0,1.0,34,850,700,150,0.8235294117647058,10,7,3,379.40765267431647,0.7690136660724897,0.07335648615154056,0.23115552809202394,132820.6624324049,3278.635152025306,136099.2975844302,2616,0,844.0294117647059,32,2,18,32.52056794055203,0.6575520833333334,42.2979797979798,1030.808080808081,32.21275252525253,0
2655,4,0,0,34,0.0,0.0,1.0,34,750,500,250,0.6666666666666666,10,5,5,379.9260495346108,0.7677881758764112,0.07021221420235979,0.23187414951417284,132885.74667125806,3297.3513544536263,136183.0980257117,2617,1,845.0294117647059,32,2,18,32.44167891256428,0.658203125,42.234848484848484,1031.0606060606062,32.220643939393945,0
2656,4,1,0,35,0.02857142857142857,0.0,1.0,35,1100,600,500,0.5454545454545454,16,6,10,372.40712621350394,0.772689075630252,0.06189323186901885,0.2295584225763834,133257.03124999977,2925.173611111082,136182.20486111086,2618,0,821.8571428571429,34,1,19,32.26224105461394,0.657169117647059,41.874999999999986,1032.4999999999982,30.367647058823476,0
2657,4,0,0,35,0.0,0.0,1.0,35,1200,1000,200,0.8333333333333334,14,10,4,376.6177651857424,0.7721288515406162,0.06219455970493315,0.2327304651532405,133349.23469387728,3044.3381519274067,136393.57284580468,2619,1,822.8571428571429,34,1,19,32.06090556323958,0.6580882352941178,41.78571428571427,1032.8571428571408,30.378151260504143,0
2658,4,0,0,35,0.0,0.0,1.0,35,1150,800,350,0.6956521739130435,15,8,7,379.8126951092611,0.7705182072829131,0.07258064516129048,0.23548387096774193,133472.2222222222,3139.0022675736914,136611.2244897959,2620,2,823.8571428571429,32,3,19,31.854838709677413,0.6640625,41.666666666666664,1033.3333333333333,32.291666666666664,0
2659,4,0,0,35,0.0,0.0,1.0,35,1100,800,300,0.7272727272727273,14,8,6,380.24702839533035,0.7698179271708683,0.07168336183728341,0.23616860200638642,133537.46588358324,3155.4449163350605,136692.9107999183,2621,3,824.8571428571429,32,3,19,31.77808657056763,0.6647135416666667,41.60353535353535,1033.585858585858,32.29955808080806,0
2660,4,1,2,34,0.027777777777777776,0.05555555555555555,0.9444444444444444,36,1050,700,350,0.6666666666666666,14,7,7,368.0007758341711,0.7753968253968254,0.017391161167094493,0.22874624496398177,133567.21460796322,2634.39784610041,136201.61245406364,2622,0,802.9166666666666,33,3,21,32.06468583283935,0.6625631313131313,41.57475490196078,1033.7009803921565,31.32427213309565,6
2661,4,0,0,34,0.0,0.0,1.0,34,700,400,300,0.5714285714285714,10,4,6,384.1818831296968,0.7633689839572193,0.04347101067969117,0.2384090388116031,133505.8614942763,3458.106655544711,136963.968149821,2623,1,850.8529411764706,31,3,21,31.708165343748696,0.667002688172043,41.634114583333336,1033.463541666667,33.33753360215055,0
2662,4,0,0,34,0.0,0.0,1.0,34,750,500,250,0.6666666666666666,10,5,5,387.14286620687903,0.7622177658942365,0.04864424359164299,0.24090237912873202,133606.80474175353,3544.9842664930607,137151.7890082466,2624,2,851.8529411764706,31,3,21,31.53022670025189,0.668010752688172,41.536458333333336,1033.854166666667,33.35013440860216,0
2663,4,0,0,34,0.0,0.0,1.0,34,800,500,300,0.625,11,5,6,384.28814208444555,0.7616607248960191,0.04706992929330367,0.24021788267985195,133775.1282585991,3481.639099121089,137256.7673577202,2625,3,852.8529411764706,31,3,19,31.434995804489198,0.6696908602150538,41.373697916666664,1034.505208333333,33.37113575268816,0
2664,4,0,0,34,0.0,0.0,1.0,34,750,600,150,0.8,9,6,3,381.50326332028,0.7628862150920975,0.04170921198668154,0.23956958478643173,133943.5577392578,3419.980875651041,137363.53861490884,2626,4,853.8529411764706,31,3,20,31.3380503144654,0.6713709677419355,41.2109375,1035.15625,33.39213709677419,0
2665,4,0,0,34,0.0,0.0,1.0,34,850,500,350,0.5882352941176471,12,5,7,379.21695160905097,0.7628862150920975,0.04041898449520698,0.23857066449328893,134010.9592013888,3363.845486111101,137374.80468749988,2627,5,854.8529411764706,31,3,20,31.329644533869885,0.6720430107526882,41.14583333333333,1035.4166666666658,33.40053763440857,0
2666,4,0,0,34,0.0,0.0,1.0,34,550,400,150,0.7272727272727273,7,4,3,379.21695160905097,0.7628862150920975,0.04041898449520698,0.23857066449328893,134010.9592013888,3363.845486111101,137374.80468749988,2628,6,855.8529411764706,31,3,20,31.329644533869885,0.6720430107526882,41.14583333333333,1035.4166666666658,33.40053763440857,0
2667,4,1,1,34,0.02857142857142857,0.02857142857142857,0.9714285714285714,35,650,500,150,0.7692307692307693,8,5,3,374.58487937486643,0.7693977591036414,0.018729976176784735,0.23516357589635112,133933.9303429705,3033.925028344672,136967.85537131518,2629,0,832.3714285714286,34,1,15,31.526739505462906,0.6639093137254901,41.220238095238095,1035.1190476190475,30.444677871148457,7
2668,4,0,0,34,0.0,0.0,1.0,34,950,700,250,0.7368421052631579,12,7,5,385.57508961458586,0.7630347593582888,0.04182362026431097,0.236028038493525,132997.76715986637,3456.1251982410595,136453.89235810743,2630,8,857.8529411764706,33,1,15,32.18325511860917,0.6568813131313131,42.12622549019608,1031.4950980392155,31.25742721330956,1
2669,4,0,0,34,0.0,0.0,1.0,34,500,200,300,0.4,8,2,6,377.7598770677431,0.7625148544266191,-0.04627528081765975,0.22505196775822045,131976.01807213543,3180.063584453674,135156.08165658911,2631,9,858.8529411764706,32,2,19,33.41474154173835,0.6490885416666667,43.118686868686865,1027.5252525252517,32.11016414141412,6
2670,4,0,0,34,0.0,0.0,1.0,34,1050,900,150,0.8571428571428571,12,9,3,374.87216946676403,0.7621434937611409,-0.04578696343402211,0.22371403661726239,132040.89506172843,3099.691358024694,135140.58641975312,2632,10,859.8529411764706,32,2,19,33.42342342342343,0.6497395833333334,43.05555555555556,1027.777777777778,32.118055555555564,0
2671,4,0,0,34,0.0,0.0,1.0,34,800,700,100,0.875,9,7,2,375.2008655277786,0.7603980986333928,-0.05421947784638692,0.22487204192227786,132203.15728305787,3120.5478076216723,135323.70509067955,2633,11,860.8529411764706,32,2,19,33.2512277470841,0.6513671875,42.89772727272727,1028.409090909091,32.13778409090909,0
2672,4,0,0,34,0.0,0.0,1.0,34,650,400,250,0.6153846153846154,9,4,5,376.7181226832322,0.7593211527035056,-0.048362644026682555,0.22636425247957054,132300.562442608,3168.00390266301,135468.566345271,2634,12,861.8529411764706,32,2,19,33.11395434462445,0.65234375,42.80303030303031,1028.7878787878797,32.14962121212124,0
2673,4,1,1,34,0.02857142857142857,0.02857142857142857,0.9714285714285714,35,1200,1000,200,0.8333333333333334,14,10,4,367.334817063439,0.7650560224089635,-0.054137843120591445,0.2225990726328914,132618.81134960108,2743.101361255283,135361.91271085636,2635,0,838.2,33,2,20,33.03477592702755,0.6530934343434345,42.493872549019606,1030.0245098039213,31.212863933452162,0
2674,4,0,1,33,0.0,0.029411764705882353,0.9705882352941176,34,800,400,400,0.5,12,4,8,369.7512856658054,0.7570929887106358,-0.005010411244143587,0.21990471200124193,131911.15702479324,2954.863980716237,134866.02100550948,2636,1,863.0,32,2,19,33.68593289085546,0.6484375,43.18181818181817,1027.2727272727261,32.10227272727269,3
2675,4,2,3,32,0.05714285714285714,0.08571428571428572,0.9142857142857143,35,800,500,300,0.625,11,5,6,359.44038309486245,0.7689775910364145,-0.006575596202824441,0.21531525861119416,132183.68055555547,2502.4305555555507,134686.11111111104,2637,0,839.2571428571429,34,1,19,33.67605348460291,0.6464460784313726,42.916666666666664,1028.3333333333328,30.24509803921567,0
2676,4,1,1,32,0.030303030303030304,0.030303030303030304,0.9696969696969697,33,950,600,350,0.631578947368421,13,6,7,367.0057588521531,0.7520517676767677,0.01465086933702553,0.21920718142445914,132073.33953486886,3094.335240026523,135167.6747748954,2638,0,887.5151515151515,32,1,19,33.59282233959791,0.6500651041666667,43.023989898989896,1027.9040404040402,32.122001262626256,0
2677,4,0,0,32,0.0,0.0,1.0,32,950,500,450,0.5263157894736842,14,5,9,379.09267833102126,0.7422715053763441,0.020871680252432245,0.21810733066458007,130640.1841975952,3505.3460212946397,134145.53021888985,2639,17,916.25,30,2,19,34.73326978701025,0.6409722222222222,44.422043010752695,1022.3118279569901,34.07706093189967,2
2678,4,0,1,31,0.0,0.03125,0.96875,32,850,700,150,0.8235294117647058,10,7,3,373.4598127861161,0.7409274193548387,-0.018432425353588133,0.22072284291290878,131672.7728639148,3446.6450239912006,135119.41788790602,2640,18,917.25,30,2,20,33.83152173913042,0.6513888888888889,43.41397849462365,1026.3440860215046,34.21146953405015,3
2679,4,0,0,31,0.0,0.0,1.0,31,600,400,200,0.6666666666666666,8,4,4,377.88307471749005,0.7376344086021506,0.0021470465018846863,0.22382305194805188,131755.55555555565,3757.638888888895,135513.19444444455,2641,19,940.6451612903226,29,2,20,33.63433441558439,0.6551724137931034,43.333333333333336,1026.6666666666674,35.40229885057474,0
2680,4,0,0,31,0.0,0.0,1.0,31,650,400,250,0.6153846153846154,9,4,5,377.3733012822721,0.73584229390681,0.010954746257201053,0.22457202812429325,131933.856577932,3757.6630015431947,135691.5195794752,2642,20,941.6451612903226,29,2,21,33.46725586949663,0.6569683908045978,43.159722222222214,1027.3611111111104,35.42624521072794,0
2681,4,0,0,31,0.0,0.0,1.0,31,1150,800,350,0.6956521739130435,15,8,7,378.2740700869836,0.7351254480286739,0.010393732370111097,0.2255318166457368,132005.21074459885,3786.8296682098935,135792.04041280874,2643,21,942.6451612903226,29,2,21,33.37204915078616,0.6576867816091954,43.090277777777786,1027.6388888888896,35.4358237547893,0
2682,4,0,0,31,0.0,0.0,1.0,31,750,600,150,0.8,9,6,3,379.27988603982584,0.7344086021505376,0.01214851869120226,0.22698536753054416,132147.9769483025,3824.2139274691444,135972.19087577166,2644,22,943.6451612903226,29,2,21,33.20205209599712,0.6591235632183907,42.95138888888889,1028.1944444444448,35.45498084291189,0
2683,4,2,1,32,0.06060606060606061,0.030303030303030304,0.9696969696969697,33,550,400,150,0.7272727272727273,7,4,3,362.35967798502446,0.749368686868687,0.02651419473849348,0.2210449869249173,132867.44011773012,3029.160563151052,135896.60068088118,2645,0,887.3939393939394,31,2,18,32.91287783110213,0.6606182795698924,42.25260416666667,1030.9895833333342,33.257728494623684,0
2684,4,1,1,32,0.030303030303030304,0.030303030303030304,0.9696969696969697,33,800,500,300,0.625,11,5,6,363.97223344167094,0.748263888888889,0.03470198067521957,0.22282751416730434,133001.71746148012,3081.7864312066026,136083.5038926867,2646,0,888.3636363636364,31,2,18,32.73636707902043,0.6619623655913978,42.122395833333336,1031.5104166666672,33.27452956989249,0
2685,4,0,0,32,0.0,0.0,1.0,32,1000,900,100,0.9,11,9,2,373.7103445169334,0.7376512096774194,0.03634904861201593,0.2284844201974845,132951.89698592326,3537.0998453578486,136488.9968312811,2647,2,917.125,30,2,18,32.53535123159128,0.664236111111111,42.170698924731184,1031.3172043010757,34.377240143369185,0
2686,4,0,0,32,0.0,0.0,1.0,32,900,700,200,0.7777777777777778,11,7,4,373.6950996874185,0.7376092069892474,0.0333588457529963,0.22911210744413926,133055.88073765746,3544.4661232512303,136600.3468609087,2648,3,918.125,30,2,18,32.43117074865381,0.6652777777777779,42.06989247311827,1031.7204301075262,34.390681003584206,0
2687,4,0,1,31,0.0,0.03125,0.96875,32,900,800,100,0.8888888888888888,10,8,2,382.5825253863921,0.7376512096774194,0.008075199528980503,0.22755472696717466,131914.2950955312,3693.6208304428146,135607.91592597403,2649,4,919.125,30,2,19,33.353231715295024,0.6538194444444445,43.17876344086021,1027.2849462365587,34.24283154121862,2
2688,4,0,0,31,0.0,0.0,1.0,31,1300,1000,300,0.7692307692307693,16,10,6,390.4217566985316,0.7289426523297491,0.021220344307066874,0.23168366525111905,131826.86149691363,4093.6149691358105,135920.47646604944,2650,5,948.9032258064516,29,2,20,33.240352538093944,0.6558908045977011,43.26388888888889,1026.9444444444448,35.41187739463603,0
2689,4,0,0,31,0.0,0.0,1.0,31,800,600,200,0.75,10,6,4,389.340447770128,0.7269713261648746,0.017999633728383424,0.2319114841065545,131969.53125,4076.2152777777787,136045.74652777778,2651,6,949.9032258064516,29,2,20,33.123817247904846,0.6573275862068966,43.125,1027.5,35.43103448275862,0
2690,4,1,0,32,0.03125,0.0,1.0,32,1050,600,450,0.5714285714285714,15,6,9,378.52054314888454,0.7439516129032259,0.019311797752809,0.2274094377756328,132294.2771563186,3615.2203289397553,135909.49748525835,2652,0,921.1875,30,2,21,33.073937374793125,0.6576388888888889,42.80913978494623,1028.7634408602146,34.29211469534049,0
2691,4,1,1,32,0.030303030303030304,0.030303030303030304,0.9696969696969697,33,950,700,250,0.7368421052631579,12,7,5,364.93191278315714,0.7554450757575758,0.01621064647230752,0.2212242423009622,132632.61795043945,3080.374993218317,135712.99294365777,2653,0,894.2424242424242,31,2,17,33.08275923819155,0.658266129032258,42.48046875,1030.078125,33.228326612903224,0
2692,4,0,0,32,0.0,0.0,1.0,32,750,500,250,0.6666666666666666,10,5,5,378.3187560076079,0.7405493951612904,0.02218505221932121,0.22854271853456434,132501.77043588847,3625.5809920221886,136127.35142791065,2654,2,923.1875,30,2,21,32.869886858137505,0.6597222222222222,42.607526881720425,1029.5698924731178,34.31899641577059,0
2693,4,0,0,32,0.0,0.0,1.0,32,850,700,150,0.8235294117647058,10,7,3,376.76658977689243,0.7396253360215055,0.025109277139874875,0.2284445525356094,132640.18961729674,3594.8783818938527,136235.0679991906,2655,3,924.1875,30,2,17,32.77036577940153,0.6611111111111112,42.47311827956989,1030.10752688172,34.336917562724004,0
2694,4,0,0,32,0.0,0.0,1.0,32,500,400,100,0.8,6,4,2,376.08982752319974,0.7384492607526882,0.022273675971823392,0.22845519950814988,132709.42630650947,3582.133050063593,136291.55935657307,2656,4,925.1875,30,2,17,32.7180624402122,0.6618055555555555,42.405913978494624,1030.3763440860218,34.34587813620073,0
2695,4,0,0,32,0.0,0.0,1.0,32,700,500,200,0.7142857142857143,9,5,4,376.30147917756597,0.7379032258064516,0.026107543356369778,0.22921811309076673,132813.31521346397,3595.5693938605623,136408.88460732452,2657,5,926.1875,30,2,18,32.6080106054679,0.6628472222222221,42.30510752688172,1030.779569892473,34.35931899641577,0
2696,4,0,1,31,0.0,0.03125,0.96875,32,1100,700,400,0.6363636363636364,15,7,8,377.93569475156016,0.737189180107527,0.024272081813444757,0.23171201221349644,133055.88073765754,3657.313345473466,136713.194083131,2658,6,927.1875,30,2,18,32.32179303456662,0.6652777777777779,42.06989247311828,1031.720430107527,34.39068100358423,0
2697,4,0,0,31,0.0,0.0,1.0,31,700,300,400,0.42857142857142855,11,3,8,389.06234057749214,0.7187275985663082,0.0291951775822743,0.23776031924180072,132934.5703125,4143.96701388889,137078.53732638888,2659,14,957.9032258064516,29,2,19,32.15698653198653,0.6670258620689655,42.1875,1031.25,35.560344827586206,0
2698,4,0,0,31,0.0,0.0,1.0,31,850,700,150,0.8235294117647058,10,7,3,390.29879607860937,0.7183691756272401,0.02367994718485744,0.23897354975068696,133006.1945408951,4182.431520061733,137188.62606095686,2660,15,958.9032258064516,29,2,19,32.05295431084781,0.6677442528735632,42.11805555555556,1031.527777777778,35.56992337164752,0
2699,4,0,0,31,0.0,0.0,1.0,31,800,600,200,0.75,10,6,4,390.41029749896234,0.7172043010752688,0.020532596800250102,0.23927126153649297,133042.01388888896,4188.194444444451,137230.2083333334,2661,16,959.9032258064516,29,2,19,32.014001077005915,0.6681034482758621,42.083333333333336,1031.6666666666672,35.57471264367818,0
2700,4,1,0,32,0.03125,0.0,1.0,32,700,400,300,0.5714285714285714,10,4,6,378.8194321183901,0.7311827956989247,0.02127798021863625,0.23399103829563592,133333.36946467805,3701.85426060817,137035.22372528623,2662,0,930.875,30,2,20,32.019998264792655,0.6680555555555556,41.80107526881721,1032.7956989247316,34.42652329749105,0
2701,4,0,0,32,0.0,0.0,1.0,32,700,300,400,0.42857142857142855,11,3,8,381.1134235171697,0.7288306451612904,0.03150201612903247,0.23629032258064503,133472.22222222207,3773.6111111110913,137245.83333333317,2663,1,931.875,30,2,21,31.82123655913978,0.6694444444444445,41.66666666666666,1033.3333333333321,34.44444444444441,0
2702,4,0,0,32,0.0,0.0,1.0,32,600,400,200,0.6666666666666666,8,4,4,380.28008123752636,0.7308887768817205,0.0378404953842153,0.23643768025851378,133576.40921277023,3759.2895493698625,137335.6987621401,2664,2,932.875,30,2,22,31.738124647856804,0.6704861111111112,41.56586021505376,1033.7365591397847,34.45788530465949,0
2703,4,0,0,32,0.0,0.0,1.0,32,850,600,250,0.7058823529411765,11,6,5,379.66866242688997,0.7285366263440861,0.0372197855750489,0.23694650100364284,133715.38843002068,3753.5085342235916,137468.89696424428,2665,3,933.875,30,2,20,31.614414121724064,0.671875,41.43145161290322,1034.2741935483862,34.475806451612875,0
2704,4,0,0,32,0.0,0.0,1.0,32,1100,800,300,0.7272727272727273,14,8,6,383.5039869007741,0.7285366263440861,0.04266176853903314,0.23447219852507073,132951.89698592311,3797.5165120245,136749.41349794762,2666,4,934.875,30,2,20,32.282842434510634,0.6642361111111111,42.17069892473118,1031.3172043010745,34.37724014336915,1
2705,4,0,0,32,0.0,0.0,1.0,32,900,700,200,0.7777777777777778,11,7,4,400.5220258983761,0.7283266129032259,0.04009257451516346,0.24716552007849196,133298.66756633722,4277.810476644717,137576.47804298194,2667,5,935.875,30,2,20,31.494587617684065,0.6677083333333333,41.83467741935485,1032.6612903225814,34.422043010752716,5
2706,4,0,0,32,0.0,0.0,1.0,32,700,500,200,0.7142857142857143,9,5,4,406.74060939175655,0.7269825268817205,0.04199053596981939,0.251943196163935,133437.50225820908,4454.890196843572,137892.39245505264,2668,6,936.875,30,2,20,31.194169810502572,0.6690972222222221,41.700268817204304,1033.198924731183,34.4399641577061,0
2707,4,0,0,32,0.0,0.0,1.0,32,1050,800,250,0.7619047619047619,13,8,5,405.17689906347533,0.7259744623655915,0.04007056451612878,0.25120967741935507,133472.22222222242,4415.972222222247,137888.19444444467,2669,7,937.875,30,2,20,31.19959677419354,0.6694444444444443,41.66666666666668,1033.3333333333348,34.44444444444449,0
2708,4,0,0,32,0.0,0.0,1.0,32,500,200,300,0.4,8,2,6,398.3621024103962,0.7259744623655915,0.035646200368130376,0.22919380869390893,130640.18419759528,4008.4196872471093,134648.6038848424,2670,8,938.875,30,2,16,34.240785783153655,0.640972222222222,44.4220430107527,1022.3118279569908,34.077060931899695,5
2709,4,0,0,32,0.0,0.0,1.0,32,650,400,250,0.6153846153846154,9,4,5,395.77998432467086,0.7259744623655915,0.0064038919777600345,0.21759257653482972,128859.99284599358,3800.0411897328927,132660.03403572648,2671,9,939.875,30,2,19,36.123245962404035,0.6229166666666668,46.169354838709666,1015.3225806451599,33.844086021505326,5
2710,4,2,1,33,0.058823529411764705,0.029411764705882353,0.9705882352941176,34,750,500,250,0.6666666666666666,10,5,5,373.98723230286146,0.7534907902554961,0.0027011572088542213,0.20914393291443267,129532.54699707021,2889.155390723218,132421.70238779343,2672,0,885.5294117647059,31,3,17,35.99012961541741,0.6270161290322582,45.50781249999999,1017.9687499999992,32.8377016129032,0
2711,4,1,0,34,0.029411764705882353,0.0,1.0,34,850,800,50,0.9411764705882353,9,8,1,376.64915264819894,0.7568701723113488,0.02034954284327184,0.19987148465346027,127442.37075617282,2800.2121913580204,130242.58294753084,2673,0,886.5,32,2,18,38.061668959193035,0.6031901041666667,47.56944444444444,1009.7222222222222,31.553819444444443,8
2712,4,1,1,34,0.02857142857142857,0.02857142857142857,0.9714285714285714,35,450,200,250,0.4444444444444444,7,2,5,367.061689624701,0.7679971988795518,0.021590535086351892,0.19593254073365096,127679.65032980098,2373.261636149545,130052.91196595052,2674,0,862.1428571428571,33,2,19,38.06017844872882,0.603219696969697,47.334558823529406,1010.6617647058818,30.626114081996416,0
2713,4,2,1,35,0.05555555555555555,0.027777777777777776,0.9722222222222222,36,1250,1100,150,0.88,14,11,3,357.8785666401592,0.7805555555555556,0.021599853560314797,0.19224096455803233,127933.68055555549,1956.944444444433,129890.62499999993,2675,0,838.8055555555555,34,2,21,38.03198791872597,0.6035539215686274,47.08333333333333,1011.6666666666661,29.754901960784295,0
2714,4,2,1,36,0.05405405405405406,0.02702702702702703,0.972972972972973,37,1300,1100,200,0.8461538461538461,15,11,4,350.2403601103221,0.7882257257257257,0.03527036289202168,0.1899630800747059,128320.37278163552,1588.5947145061357,129908.96749614166,2676,0,817.081081081081,35,2,23,37.82984921178889,0.6053571428571429,46.70138888888887,1013.1944444444421,28.948412698412632,0
2715,4,0,0,36,0.0,0.0,1.0,36,950,800,150,0.8421052631578947,11,8,3,358.5744841556418,0.7735449735449736,0.0463833398616007,0.19436107389582866,128295.24518140574,2000.6802721088234,130295.92545351456,2677,1,840.7777777777778,34,2,23,37.64443791617704,0.6072303921568629,46.72619047619047,1013.0952380952369,29.79691876750697,0
2716,4,3,0,39,0.07692307692307693,0.0,1.0,39,850,700,150,0.8235294117647058,10,7,3,358.9741852064188,0.8034188034188035,0.1420966461764286,0.18539395879456597,126338.19792005765,1418.5312387894792,127756.72915884713,2678,0,777.025641025641,31,8,19,39.64309998704832,0.5944220430107525,48.66536458333334,1005.3385416666678,32.430275537634444,8
2717,4,4,2,41,0.09302325581395349,0.046511627906976744,0.9534883720930233,43,850,400,450,0.47058823529411764,13,4,9,326.42433790306853,0.8290420819490587,0.13790233518462158,0.1724707501720579,127267.13204089525,-291.38213734566125,126975.74990354959,2679,0,705.6511627906976,35,8,21,39.50877494838264,0.594642857142857,47.743055555555564,1009.0277777777793,28.82936507936512,0
2718,4,4,3,42,0.08888888888888889,0.06666666666666667,0.9333333333333333,45,1050,800,250,0.7619047619047619,13,8,5,311.1418130704252,0.8460016835016836,0.15103116986311216,0.1674360229053621,128005.79415060439,-1034.4090248922416,126971.38512571214,2680,0,675.2,37,8,21,39.14054881352257,0.5982545045045043,47.01206140350879,1011.9517543859678,27.35004741583697,0
2719,4,1,1,42,0.023255813953488372,0.023255813953488372,0.9767441860465116,43,850,400,450,0.47058823529411764,13,4,9,326.53815964255523,0.8339793281653747,0.1565934065934067,0.17479395604395628,127793.20987654343,-254.12808641972677,127539.0817901237,2681,0,707.3953488372093,35,8,21,38.96806318681319,0.5999999999999999,47.222222222222236,1011.1111111111129,28.88888888888894,0
2720,4,2,0,44,0.045454545454545456,0.0,1.0,44,1400,1000,400,0.7142857142857143,18,10,8,319.11434955062725,0.8321000704721635,0.17175956339380427,0.1728135806266043,128258.5768834716,-614.1695327083471,127644.40735076326,2682,0,692.2727272727273,36,8,24,38.68121178432464,0.6027199074074072,46.762387387387406,1012.9504504504529,28.13751251251258,0
2721,4,1,2,43,0.022222222222222223,0.044444444444444446,0.9555555555555556,45,1350,700,650,0.5185185185185185,20,7,13,313.137002969313,0.8364478114478114,0.16752210688196856,0.17074829029836144,128533.39489073583,-950.2875884887397,127583.1073022471,2683,0,677.8666666666667,37,8,13,38.55293036332181,0.6036036036036034,46.49122807017545,1014.0350877193,27.406353722143244,0
2722,4,0,0,43,0.0,0.0,1.0,43,1250,800,450,0.64,17,8,9,326.83350317532637,0.8302879291251384,0.17057984070923427,0.17687816860156336,128232.43694540892,-217.86868248457273,128014.56826292434,2684,2,710.3720930232558,35,8,23,38.512384298937256,0.6044642857142857,46.78819444444444,1012.8472222222221,28.93849206349206,0
2723,4,2,1,44,0.044444444444444446,0.022222222222222223,0.9777777777777777,45,1500,1100,400,0.7333333333333333,19,11,8,311.4592518068844,0.8379208754208755,0.16797166696680454,0.17066639286398572,128728.04763244474,-981.2917195675459,127746.7559128772,2685,0,679.7555555555556,37,8,16,38.397600396182234,0.6055743243243243,46.299342105263165,1014.8026315789485,27.427098150782392,0
2724,4,1,2,43,0.022222222222222223,0.044444444444444446,0.9555555555555556,45,950,500,450,0.5263157894736842,14,5,9,317.5513609890505,0.8366582491582492,0.19743174705945843,0.17547695064314417,129062.08070031145,-803.2321243074996,128258.84857600395,2686,0,680.7333333333333,37,8,18,37.90365004855939,0.6089527027027027,45.970394736842096,1016.11842105263,27.46266002844946,0
2725,4,2,3,42,0.044444444444444446,0.06666666666666667,0.9333333333333333,45,1250,1000,250,0.8,15,10,5,318.2395583075488,0.8371212121212122,0.1982527377876213,0.17673451485345418,129258.63997443386,-772.8823581070159,128485.75761632684,2687,0,681.3555555555556,36,9,20,37.68664636397193,0.6128472222222223,45.777027027027025,1016.8918918918916,28.24699699699699,0
2726,4,0,0,42,0.0,0.0,1.0,42,1050,800,250,0.7619047619047619,13,8,5,341.52909140705196,0.8201703445605885,0.2033442964603216,0.18799098168164807,128907.381955161,405.124206961574,129312.50616212258,2688,1,730.6666666666666,35,7,22,37.45203631942863,0.6113095238095239,46.122685185185176,1015.5092592592578,29.014550264550223,0
2727,4,1,0,43,0.023255813953488372,0.0,1.0,43,750,400,350,0.5333333333333333,11,4,7,335.1018156953718,0.8278423772609819,0.21570570586922067,0.18611441545317733,129261.91184807262,63.85006806221003,129325.76191613483,2689,0,714.6511627906976,34,9,23,37.254643721220624,0.6170343137254901,45.773809523809526,1016.9047619047623,29.908963585434183,0
2728,4,2,2,43,0.044444444444444446,0.044444444444444446,0.9555555555555556,45,1250,1000,250,0.8,15,10,5,321.5397175031647,0.8404040404040405,0.21178782407919083,0.1807936497359312,129745.78622118742,-656.3153102426757,129089.47091094474,2690,0,683.8444444444444,36,9,15,37.10875612541909,0.6177662037037037,45.29842342342342,1018.8063063063064,28.300175175175177,0
2729,4,1,0,44,0.022727272727272728,0.0,1.0,44,950,700,250,0.7368421052631579,12,7,5,330.6591970359472,0.8300299506694856,0.22745603255088742,0.18599315728482063,129760.92470689726,-218.67136595507068,129542.25334094219,2691,0,700.3636363636364,35,9,16,36.861131621795636,0.6199404761904761,45.28356481481482,1018.8657407407405,29.11044973544973,0
2730,4,1,0,45,0.022222222222222223,0.0,1.0,45,1600,1500,100,0.9375,17,15,2,302.0341788670673,0.8352693602693603,0.13179694937017072,0.17128921398122146,130081.099419988,-1142.2123901117213,128938.88702987628,2692,0,685.7777777777778,40,5,18,37.26671979810053,0.6140625000000002,44.96951219512194,1020.1219512195113,25.50304878048778,4
2731,4,0,2,43,0.0,0.044444444444444446,0.9555555555555556,45,1050,700,350,0.6666666666666666,14,7,7,303.84962535984664,0.8350589225589226,0.13494450530602253,0.1726629365160284,130158.86423631784,-1090.255572906328,129068.6086634115,2693,1,686.7777777777778,40,5,19,37.14188493841914,0.61484375,44.893292682926834,1020.426829268294,25.51067073170735,0
2732,4,0,0,43,0.0,0.0,1.0,43,1200,900,300,0.75,15,9,6,318.89476713905884,0.8186138796603912,0.14025082186777094,0.18106094091426944,130126.29323727079,-300.6812038863293,129825.61203338446,2694,2,719.2790697674419,38,5,22,36.791012216404894,0.6178728070175439,44.925213675213676,1020.2991452991453,26.849977507872243,0
2733,4,0,0,43,0.0,0.0,1.0,43,750,500,250,0.6666666666666666,10,5,5,318.7005414410662,0.8171834625322997,0.13383958234456572,0.18158519221642155,130262.58680555563,-297.0486111111011,129965.53819444454,2695,3,720.2790697674419,38,5,22,36.65816326530612,0.6192434210526315,44.79166666666667,1020.833333333334,26.864035087719316,0
2734,4,1,2,42,0.022727272727272728,0.045454545454545456,0.9545454545454546,44,1150,800,350,0.6956521739130435,15,8,7,313.1560836329726,0.8211328400281889,0.13205193990706654,0.17993779291991907,130589.9824334321,-620.9905078895295,129968.99192554258,2696,0,704.8863636363636,38,6,15,36.469112574474764,0.622532894736842,44.471153846153854,1022.1153846153859,26.89777327935226,0
2735,4,3,2,43,0.06666666666666667,0.044444444444444446,0.9555555555555556,45,1000,900,100,0.9,11,9,2,307.9204138582956,0.8306397306397307,0.1449137687305615,0.178484841661225,130928.03955078174,-936.9167751735654,129991.12277560818,2697,0,689.9555555555555,39,6,16,36.262192536047486,0.6241987179487177,44.14062500000002,1023.437500000004,26.241987179487282,0
2736,4,0,0,43,0.0,0.0,1.0,43,900,500,400,0.5555555555555556,13,5,8,324.8407695296706,0.8182447397563676,0.146745756879876,0.1873710486953148,130738.73842191843,-106.14552073713304,130632.5929011813,2698,1,723.046511627907,37,6,16,36.020312890890246,0.6258445945945945,44.32565789473685,1022.6973684210539,27.64046941678524,0
2737,4,0,0,43,0.0,0.0,1.0,43,900,600,300,0.6666666666666666,12,6,6,324.8407695296706,0.8182447397563676,0.146745756879876,0.1873710486953148,130738.73842191843,-106.14552073713304,130632.5929011813,2699,2,724.046511627907,37,6,16,36.020312890890246,0.6258445945945945,44.32565789473685,1022.6973684210539,27.64046941678524,0
2738,4,0,1,42,0.0,0.023255813953488372,0.9767441860465116,43,950,900,50,0.9473684210526315,10,9,1,324.85051505533056,0.8175064599483204,0.15023305665644626,0.18778533491116714,130822.85534972312,-100.42561172667615,130722.42973799644,2700,3,725.046511627907,37,6,16,35.93515541264736,0.6266891891891891,44.24342105263158,1023.0263157894747,27.649359886202017,0
2739,4,0,1,41,0.0,0.023809523809523808,0.9761904761904762,42,1300,800,500,0.6153846153846154,18,8,10,330.5324688415952,0.8136614401858304,0.14958905690263768,0.19029196478204466,130665.25298524888,237.82173220519275,130903.07471745407,2701,4,743.0952380952381,36,6,16,35.949030730256624,0.6270254629629629,44.39752252252253,1022.4099099099109,28.400275275275302,0
2740,4,1,0,42,0.023809523809523808,0.0,1.0,42,1050,700,350,0.6666666666666666,14,7,7,336.26357135163437,0.8129355400696864,0.1784902299753781,0.1951874753247993,130982.06948502551,408.89969361251946,131390.96917863804,2702,0,743.8571428571429,36,6,17,35.48244407774108,0.6302083333333335,44.08783783783783,1023.6486486486482,28.434684684684672,0
2741,4,0,0,42,0.0,0.0,1.0,42,1000,700,300,0.7,13,7,6,334.4293528604813,0.8126451800232288,0.18429540040315162,0.194851695340556,131126.2038009293,370.49029603927386,131496.69409696857,2703,1,744.8571428571429,36,6,17,35.38391057357521,0.6316550925925927,43.94707207207207,1024.2117117117116,28.450325325325323,0
2742,4,1,0,43,0.023255813953488372,0.0,1.0,43,1400,1100,300,0.7857142857142857,17,11,6,338.0305063752102,0.8164913252122554,0.21097438115482614,0.1923066454978455,130203.51750042877,325.5637155392544,130529.08121596804,2704,0,728.5116279069767,35,8,21,36.2246730173131,0.6244047619047619,44.849537037037045,1020.6018518518526,29.160052910052933,7
2743,4,1,1,43,0.022727272727272728,0.022727272727272728,0.9772727272727273,44,1350,1100,250,0.8148148148148148,16,11,5,329.64479087731945,0.8248546511627908,0.2076347983688267,0.1889678060951285,130498.99798525395,-196.3236239711678,130302.67436128278,2705,0,712.9318181818181,35,9,15,36.13974475154813,0.6273809523809522,44.5601851851852,1021.7592592592607,29.193121693121736,0
2744,4,0,0,43,0.0,0.0,1.0,43,1250,800,450,0.64,17,8,9,332.9706997691776,0.8171834625322997,0.20954468340691834,0.19087437256898096,130498.9979852541,90.46853566533525,130589.46652091944,2706,2,730.5116279069767,35,8,17,36.0547877964054,0.6273809523809522,44.560185185185205,1021.759259259262,29.19312169312177,0
2745,4,0,0,43,0.0,0.0,1.0,43,1400,800,600,0.5714285714285714,20,8,12,343.73324338541096,0.8171834625322997,0.23965340326074558,0.18878423780422304,128819.24518014854,255.89139124659982,129075.13657139514,2707,3,731.5116279069767,35,8,15,37.48586725192872,0.6104166666666665,46.209490740740755,1015.1620370370389,29.004629629629683,3
2746,4,1,1,43,0.022727272727272728,0.022727272727272728,0.9772727272727273,44,1400,900,500,0.6428571428571429,19,9,10,335.8718241879664,0.8263301620859761,0.22804583228405928,0.1858518217839608,129115.53603857252,-126.74587594349208,128988.79016262903,2708,0,715.8636363636364,36,8,15,37.38388734995383,0.6114004629629628,45.9177927927928,1016.3288288288302,28.231356356356393,0
2747,4,1,1,43,0.022727272727272728,0.022727272727272728,0.9772727272727273,44,1350,1100,250,0.8148148148148148,16,11,5,332.00663716000156,0.8267045454545455,0.21899728178797906,0.18438006971431856,129258.63997443412,-217.05472364253816,129041.58525079158,2709,0,716.8409090909091,36,8,16,37.33665559246954,0.6128472222222221,45.77702702702704,1016.8918918918937,28.246996996997048,0
2748,4,0,0,43,0.0,0.0,1.0,43,1150,700,450,0.6086956521739131,16,7,9,339.0716981070495,0.8175526024363233,0.22217281872533667,0.1884518033691742,129289.65627411268,167.69266010802585,129457.3489342207,2710,6,734.5116279069767,35,8,18,37.12551212017752,0.6151785714285715,45.74652777777778,1017.0138888888891,29.05753968253969,0
2749,4,0,0,43,0.0,0.0,1.0,43,1250,800,450,0.64,17,8,9,338.4505189900138,0.8168143226282761,0.21491397411554392,0.18909363811932534,129495.73072059327,165.5794538751707,129661.31017446844,2711,7,735.5116279069767,35,8,16,36.93190432870897,0.6172619047619048,45.54398148148148,1017.824074074074,29.08068783068783,0
2750,4,0,0,43,0.0,0.0,1.0,43,1200,800,400,0.6666666666666666,16,8,8,335.32969353404576,0.8174141749723145,0.20829534011528827,0.18805391799911214,129643.02722318676,94.63131751543585,129737.65854070219,2712,8,736.5116279069767,35,8,17,36.86178827139447,0.6187499999999999,45.39930555555556,1018.4027777777779,29.09722222222223,0
2751,4,1,0,44,0.022727272727272728,0.0,1.0,44,1200,1000,200,0.8333333333333334,14,10,4,319.57954427058775,0.8245463354474982,0.20784563446337945,0.17294214327133997,128230.06071950342,-593.1782914319014,127636.88242807152,2713,0,720.75,36,8,19,38.698484174634935,0.6024305555555556,46.79054054054055,1012.837837837839,28.134384384384415,5
2752,4,1,1,44,0.022222222222222223,0.022222222222222223,0.9777777777777777,45,600,400,200,0.6666666666666666,8,4,4,311.4116520633015,0.8321127946127946,0.20777273055014756,0.16957079711291462,128477.80687326893,-998.10278162509,127479.70409164384,2714,0,705.7111111111111,37,8,16,38.65320138438243,0.6030405405405403,46.54605263157896,1013.8157894736861,27.400426742532055,0
2753,4,2,2,44,0.043478260869565216,0.043478260869565216,0.9565217391304348,46,1200,800,400,0.6666666666666666,16,8,8,306.12003781896294,0.8379227053140097,0.19084718771021802,0.1680211715377219,128794.39153928334,-1314.6911982248537,127479.70034105849,2715,0,691.3260869565217,38,8,19,38.46568782233448,0.6044407894736842,46.23397435897436,1015.0641025641024,26.712213225371116,0
2754,4,1,1,44,0.022222222222222223,0.022222222222222223,0.9777777777777777,45,1950,1700,250,0.8717948717948718,22,17,5,312.34321401277276,0.831439393939394,0.20017044158774766,0.17139070137025714,128783.68975309713,-955.0576860187703,127828.63206707836,2716,0,706.7333333333333,37,8,20,38.3186372474884,0.6061373873873874,46.24451754385965,1015.0219298245615,27.433025130393556,0
2755,4,2,2,44,0.043478260869565216,0.043478260869565216,0.9565217391304348,46,1150,800,350,0.6956521739130435,15,8,7,308.6300964840127,0.8362520128824477,0.20574362771310684,0.17079686491288038,129119.93805473374,-1229.9402120315533,127889.99784270219,2717,0,692.3260869565217,38,8,20,38.0715862503942,0.6077302631578947,45.91346153846154,1016.3461538461539,26.74595141700405,0
2756,4,2,0,46,0.043478260869565216,0.0,1.0,46,1150,800,350,0.6956521739130435,15,8,7,310.23837374038254,0.8327697262479872,0.2075448259697643,0.17240628618586243,129285.0098708254,-1178.1400756161527,128106.86979520925,2718,0,693.2826086956521,37,9,23,37.86331985624437,0.611204954954955,45.751096491228054,1016.9956140350857,27.48636794689421,0
2757,4,1,2,45,0.02127659574468085,0.0425531914893617,0.9574468085106383,47,800,500,300,0.625,11,5,6,311.0188321064425,0.8373034227567067,0.17405086247260426,0.16351717957405,127065.75656467021,-1387.2418752043866,125678.51468946582,2719,0,679.5106382978723,39,8,20,40.10325188552535,0.5852029914529915,47.942708333333336,1008.2291666666673,25.852029914529933,8
2758,4,2,2,45,0.0425531914893617,0.0425531914893617,0.9574468085106383,47,1050,700,350,0.6666666666666666,14,7,7,313.44766004642327,0.844395621338267,0.18961777801801372,0.16589019856910692,127334.51727892831,-1417.4559904822063,125917.0612884461,2720,0,680.4255319148937,38,9,15,39.767254154758135,0.5896381578947368,47.67628205128205,1009.2948717948716,26.560391363022937,0
2759,4,2,0,47,0.0425531914893617,0.0,1.0,47,1050,900,150,0.8571428571428571,12,9,3,309.3866937965776,0.8421985815602836,0.20283762953294993,0.1646173995411729,127550.26989051435,-1507.5287411425154,126042.74114937184,2721,0,681.2765957446809,38,9,17,39.64943592455491,0.5918311403508771,47.46260683760684,1010.1495726495732,26.582883490778244,0
2760,4,3,1,49,0.06,0.02,0.98,50,1100,600,500,0.5454545454545454,16,6,10,291.0299444946425,0.8582312925170068,0.2020170597089812,0.15735829608730942,128195.98458465537,-2536.8448171959312,125659.13976745943,2722,0,641.34,40,10,20,39.45601271115571,0.5950520833333333,46.82418699186992,1012.7032520325208,25.31758130081302,0
2761,4,1,1,49,0.02,0.02,0.98,50,1400,900,500,0.6428571428571429,19,9,10,289.14969582770374,0.8552551020408163,0.19870812437311924,0.15684561846584377,128324.66310562508,-2578.992539163186,125745.6705664619,2723,0,642.32,40,10,23,39.37291039786023,0.5963541666666666,46.69715447154472,1013.2113821138221,25.33028455284555,0
2762,4,2,2,49,0.0392156862745098,0.0392156862745098,0.9607843137254902,51,1050,700,350,0.6666666666666666,14,7,7,283.60469674550575,0.8576470588235295,0.1970719619159409,0.1547939570117088,128571.78411005615,-2907.287631487774,125664.49647856837,2724,0,630.6862745098039,41,10,12,39.26267159020508,0.5973069105691056,46.45337301587302,1014.1865079365086,24.736256291134357,0
2763,4,3,5,47,0.057692307692307696,0.09615384615384616,0.9038461538461539,52,1100,500,600,0.45454545454545453,17,5,12,281.9072924360972,0.8627450980392156,0.20373972573187293,0.1526866990981738,128264.4101257606,-3168.265485106735,125096.14464065386,2725,0,619.5,43,9,16,39.61751347729893,0.591327519379845,46.756628787878796,1012.9734848484861,23.557522903453165,1
2764,4,1,1,47,0.020833333333333332,0.020833333333333332,0.9791666666666666,48,950,400,550,0.42105263157894735,15,4,11,306.7561917784143,0.8482380319148936,0.21088307207931445,0.16448478559152913,127861.72251966437,-1755.524985127883,126106.19753453649,2726,0,671.9375,40,8,17,39.39827840300108,0.5916666666666666,47.154471544715456,1011.3821138211393,25.284552845528484,0
2765,4,2,0,49,0.04081632653061224,0.0,1.0,49,1600,1400,200,0.875,18,14,4,304.96857441336283,0.8526077097505669,0.22031563151893319,0.16531983242668924,128298.92223750749,-1974.2596999140628,126324.66253759342,2727,0,659.1836734693877,40,9,19,38.9983950245762,0.5960937499999999,46.72256097560976,1013.1097560975613,25.327743902439032,0
2766,4,0,1,48,0.0,0.02040816326530612,0.9795918367346939,49,1300,800,500,0.6153846153846154,18,8,10,304.93459855459776,0.8529265873015873,0.21389080998350862,0.1658352064331276,128427.65239771307,-1967.5930745587825,126460.05932315429,2728,1,660.1836734693877,40,9,14,38.86834937504179,0.5973958333333333,46.59552845528456,1013.6178861788624,25.34044715447156,0
2767,4,1,2,47,0.02040816326530612,0.04081632653061224,0.9591836734693877,49,1600,1000,600,0.625,22,10,12,303.2944774446937,0.857922335600907,0.21566166037643253,0.16579876636653568,128633.75491605564,-1997.2185041971975,126636.53641185844,2729,0,660.1836734693877,40,9,15,38.70049422293462,0.5994791666666666,46.39227642276425,1014.4308943089461,25.360772357723654,0
2768,4,2,1,48,0.04081632653061224,0.02040816326530612,0.9795918367346939,49,1450,1200,250,0.8275862068965517,17,12,5,304.32574355546217,0.8553358843537415,0.2050501418028161,0.16701129267208573,128788.44024720755,-1961.272432084058,126827.16781512348,2730,0,661.1020408163265,40,9,16,38.5172623815245,0.6010416666666666,46.23983739837399,1015.0406504065056,25.37601626016264,0
2769,4,1,0,49,0.02040816326530612,0.0,1.0,49,1100,800,300,0.7272727272727273,14,8,6,307.3411013717496,0.856186224489796,0.21666902572301772,0.16924426329976344,128924.17332963285,-1875.2605150856548,127048.91281454719,2731,0,662.0816326530612,41,8,17,38.302949268991576,0.6008638211382114,46.1061507936508,1015.5753968253973,24.77013162988774,0
2770,4,2,1,50,0.0392156862745098,0.0196078431372549,0.9803921568627451,51,1300,900,400,0.6923076923076923,17,9,8,294.5063548579797,0.8664379084967321,0.22070436832235107,0.16426055909615528,129428.42306193306,-2575.905946869496,126852.51711506357,2732,0,637.0784313725491,41,10,11,38.11817539241491,0.6059451219512195,45.610119047619044,1017.5595238095234,24.818524970963985,0
2771,4,0,0,50,0.0,0.0,1.0,50,1050,700,350,0.6666666666666666,14,7,7,300.7522039922019,0.8613435374149659,0.22089928057553965,0.16721822541966427,129304.72932778113,-2222.2635336109433,127082.46579417019,2733,1,650.82,40,10,19,38.084532374100725,0.60625,45.73170731707317,1017.0731707317077,25.426829268292693,0
2772,4,1,2,49,0.0196078431372549,0.0392156862745098,0.9607843137254902,51,1100,800,300,0.7272727272727273,14,8,6,294.23643514012025,0.8623529411764707,0.21924404140919673,0.16463763889901373,129554.63927469128,-2576.0609567901324,126978.57831790115,2734,0,639.0392156862745,41,10,11,37.99738517507958,0.6072154471544715,45.48611111111111,1018.0555555555549,24.830623306233047,0
2773,4,0,0,49,0.0,0.0,1.0,49,1150,900,250,0.782608695652174,14,9,5,307.64996137971747,0.8558319160997733,0.2289994023413171,0.1712947276416375,129360.29188368063,-1840.462239583328,127519.8296440973,2735,3,665.8367346938776,39,10,19,37.852839784285614,0.608440170940171,45.677083333333336,1017.2916666666673,26.084401709401725,0
2774,4,0,0,49,0.0,0.0,1.0,49,550,200,350,0.36363636363636365,9,2,7,310.3550277997451,0.8562570861678005,0.23239566096708963,0.17303355659520037,129413.28125000001,-1767.1875000000007,127646.09375000001,2736,4,666.8367346938776,39,10,19,37.730343980343974,0.608974358974359,45.625,1017.5000000000001,26.08974358974359,0
2775,4,1,1,49,0.02,0.02,0.98,50,1400,900,500,0.6428571428571429,19,9,10,303.7540313804019,0.8601360544217687,0.22810773067331702,0.17078710962358548,129744.3870732533,-2117.9238755040033,127626.4631977493,2737,0,654.48,40,10,12,37.563175394846226,0.6106770833333334,45.29979674796748,1018.8008130081297,25.470020325203244,0
2776,4,0,0,49,0.0,0.0,1.0,49,1300,700,600,0.5384615384615384,19,7,12,311.6178550191842,0.8556193310657597,0.22982037977801073,0.17491385685290362,129678.39084201379,-1717.979600694456,127960.41124131934,2738,6,668.8367346938776,39,10,12,37.42968909797504,0.6116452991452992,45.36458333333333,1018.5416666666658,26.11645299145297,0
2777,4,1,0,50,0.02,0.0,1.0,50,1550,1100,450,0.7096774193548387,20,11,9,307.76031094559266,0.8603231292517006,0.23087654441093464,0.17410392053988707,129984.23450688148,-1999.2023140274634,127985.032192854,2739,0,656.44,41,9,13,37.21858076336868,0.6115345528455285,45.06448412698413,1019.7420634920636,24.87175764614789,0
2778,4,0,3,47,0.0,0.06,0.94,50,1350,1200,150,0.8888888888888888,15,12,3,308.5850753421951,0.8601700680272109,0.2362660443407234,0.17513735732997454,130110.72137188222,-1969.954648526066,128140.76672335615,2740,1,657.44,41,9,14,37.06971995332555,0.6128048780487805,44.9404761904762,1020.2380952380963,24.883855981416982,0
2779,4,0,1,46,0.0,0.02127659574468085,0.9787234042553191,47,950,400,550,0.42105263157894735,15,4,11,324.3718134642797,0.8484042553191489,0.23795156480105772,0.18244282389270391,129757.97661675354,-982.0339626736054,128775.94265407993,2741,2,699.3404255319149,39,8,14,37.02426899090072,0.6124465811965811,45.286458333333336,1018.8541666666672,26.124465811965827,0
2780,4,0,0,46,0.0,0.0,1.0,46,1100,700,400,0.6363636363636364,15,7,8,330.6297897278756,0.8452697262479871,0.2412468755131454,0.18538606798153587,129636.22708013728,-627.6802998758192,129008.54678026146,2742,3,715.1304347826087,38,8,15,36.98834627220591,0.6129385964912281,45.4059829059829,1018.3760683760679,26.79937022042284,0
2781,4,0,0,46,0.0,0.0,1.0,46,1050,800,250,0.7619047619047619,13,8,5,331.0616184241657,0.8451288244766506,0.23750350057564962,0.18620550257658236,129757.97661675357,-608.4228515624941,129149.55376519107,2743,4,716.1304347826087,39,7,15,36.85387059946152,0.6124465811965811,45.286458333333336,1018.8541666666674,26.12446581196583,0
2782,4,0,0,46,0.0,0.0,1.0,46,800,600,200,0.75,10,6,4,331.8747031540928,0.8444041867954911,0.24344049232409826,0.18716968128892228,129864.12896050357,-580.2761501735997,129283.85281032998,2744,5,717.1304347826087,39,7,15,36.725536535513534,0.6135149572649572,45.18229166666667,1019.2708333333342,26.135149572649595,0
2783,4,1,0,47,0.02127659574468085,0.0,1.0,47,1400,900,500,0.6428571428571429,19,9,10,329.7943705156544,0.8457061362935553,0.2513871204882834,0.18765579960842593,130210.72035701307,-811.4474890937904,129399.27286791928,2745,0,702.8510638297872,40,7,16,36.427528294998176,0.6153645833333334,44.84247967479675,1020.6300813008133,25.515752032520332,0
2784,4,1,1,47,0.020833333333333332,0.020833333333333332,0.9791666666666666,48,900,600,300,0.6666666666666666,12,6,6,321.560361110629,0.850639036643026,0.25116297302947954,0.18463663951886422,130562.68376981525,-1203.212268339523,129359.47150147572,2746,0,689.1875,38,10,15,36.281927312007795,0.6222587719298245,44.49786324786325,1022.0085470085476,26.89496176338283,0
2785,4,1,1,47,0.020833333333333332,0.020833333333333332,0.9791666666666666,48,1150,1000,150,0.8695652173913043,13,10,3,325.31392365103216,0.8456338652482269,0.2543686657611539,0.18745211097315037,130699.20562358458,-1096.3457201037347,129602.85990348084,2747,0,689.6666666666666,38,10,15,36.04813150837601,0.6236293859649124,44.36431623931624,1022.5427350427346,26.909019343229858,0
2786,4,0,0,47,0.0,0.0,1.0,47,1350,1000,350,0.7407407407407407,17,10,7,333.0976336518968,0.8438945420906567,0.2584949594016668,0.19139609976863028,130589.98243343181,-700.1571745562264,129889.82525887559,2748,2,705.3404255319149,38,9,15,35.95954844778929,0.6225328947368423,44.47115384615384,1022.1153846153835,26.897773279352197,0
2787,4,1,0,48,0.020833333333333332,0.0,1.0,48,1350,900,450,0.6666666666666666,18,9,9,329.140865372284,0.8487551713947991,0.2685988433228186,0.19104945564166764,130981.34901258672,-977.7370876736161,130003.61192491312,2749,0,691.625,39,9,16,35.665449781215024,0.6247329059829061,44.088541666666664,1023.6458333333327,26.247329059829042,0
2788,4,0,0,48,0.0,0.0,1.0,48,1550,1200,350,0.7741935483870968,19,12,7,330.733743911497,0.8481826241134751,0.27420768823607267,0.19240607411387065,131067.8374314229,-930.2886839844227,130137.54874743847,2750,1,692.625,40,8,16,35.53741564112742,0.6239583333333334,44.004065040650396,1023.9837398373968,25.59959349593492,0
2789,4,0,1,47,0.0,0.020833333333333332,0.9791666666666666,48,1400,900,500,0.6428571428571429,19,9,10,332.86603095818623,0.847868646572104,0.27404482028899224,0.19430355866181082,131197.94894118895,-865.7318932183407,130332.21704797061,2751,2,693.625,40,8,16,35.35156895810599,0.6252604166666668,43.877032520325194,1024.491869918698,25.612296747967452,0
2790,4,0,0,47,0.0,0.0,1.0,47,1450,1200,250,0.8275862068965517,17,12,5,339.0746503892781,0.8414662349676225,0.27076550314227377,0.19791093095421633,131194.69536675324,-503.0409071180798,130691.65445963516,2752,3,709.1276595744681,39,8,16,35.195835451618386,0.6268696581196582,43.88020833333332,1024.4791666666647,26.26869658119653,0
2791,4,0,0,47,0.0,0.0,1.0,47,1350,1000,350,0.7407407407407407,17,10,7,347.37303202865326,0.8422371261177921,0.18399395183065104,0.2048876865558223,131595.18771701382,-215.09060329862075,131380.0971137152,2753,4,710.1276595744681,39,8,13,34.579103214890026,0.6308760683760685,43.48958333333333,1026.041666666666,26.308760683760667,6
2792,4,0,0,47,0.0,0.0,1.0,47,1300,900,400,0.6923076923076923,17,9,8,356.5394529396594,0.8425069380203515,0.26446734842853226,0.1997752807741267,129609.02829142023,-117.97728930390002,129491.05100211632,2754,5,711.1276595744681,38,9,15,36.35636344559857,0.6126644736842104,45.432692307692314,1018.2692307692316,26.796558704453464,4
2793,4,0,0,47,0.0,0.0,1.0,47,1200,700,500,0.5833333333333334,17,7,10,354.4506937048724,0.8419287696577242,0.25947002664595686,0.1990184283735131,129690.63321827745,-206.2130177514802,129484.42020052597,2755,6,712.1276595744681,38,9,15,36.326568072162786,0.6134868421052632,45.3525641025641,1018.5897435897435,26.804993252361673,0
2794,4,0,0,47,0.0,0.0,1.0,47,1050,800,250,0.7619047619047619,13,8,5,355.77227440991095,0.8416589577551649,0.25903535631100993,0.19676384972466507,129095.5078125,-204.00666707758023,128891.50114542241,2756,7,713.1276595744681,39,8,16,36.8986606532732,0.6057692307692308,45.9375,1016.25,26.057692307692307,3
2795,4,0,0,47,0.0,0.0,1.0,47,1200,700,500,0.5833333333333334,17,7,10,352.6097024436605,0.8405797101449275,0.2587053671132704,0.19541024119356992,129175.56023407033,-290.28882857426146,128885.27140549607,2757,8,714.1276595744681,40,7,16,36.89747242493919,0.6049479166666667,45.858739837398375,1016.5650406504066,25.414126016260163,0
2796,4,1,0,48,0.020833333333333332,0.0,1.0,48,1300,900,400,0.6923076923076923,17,9,8,349.4688567617328,0.8417183806146572,0.2681925175499891,0.19571428037427624,129589.1285465827,-542.5244976535107,129046.60404892918,2758,0,700.2291666666666,40,8,14,36.55658415676881,0.6091145833333333,45.452235772357724,1018.1910569105688,25.45477642276422,0
2797,4,0,0,48,0.0,0.0,1.0,48,1100,900,200,0.8181818181818182,13,9,4,354.9949793281442,0.8429188829787234,0.2629397778664544,0.1994657888332577,129718.50419723711,-390.1164568048051,129328.3877404323,2759,1,701.2291666666666,40,8,14,36.28437583133814,0.6104166666666666,45.32520325203252,1018.69918699187,25.46747967479675,0
2798,4,2,0,50,0.04,0.0,1.0,50,800,700,100,0.875,9,7,2,348.88190330766355,0.8489625850340136,0.28399124116651686,0.1990469325685463,130314.46358194547,-904.8510930993284,129409.61248884615,2760,0,674.14,40,10,16,35.83532397730665,0.6164062499999999,44.740853658536594,1021.0365853658552,25.525914634146382,0
2799,4,1,1,50,0.0196078431372549,0.0196078431372549,0.9803921568627451,51,1550,1200,350,0.7741935483870968,19,12,7,346.43037996139566,0.850686274509804,0.2949567599965748,0.1993280326913559,130642.63791454092,-1148.2842616213075,129494.35365291961,2761,0,661.9019607843137,41,10,16,35.565562833575925,0.6181402439024389,44.41964285714286,1022.3214285714294,24.934668989547056,0
2800,4,0,0,50,0.0,0.0,1.0,50,1000,700,300,0.7,13,7,6,349.13646351469913,0.849234693877551,0.28962646744930565,0.20114866011436605,130693.35322381287,-874.0369701121004,129819.31625370077,2762,1,650.3,41,9,16,35.44506565117557,0.6186483739837398,44.37003968253969,1022.5198412698428,24.939508323654703,0
2801,4,0,0,50,0.0,0.0,1.0,50,1550,1000,550,0.6451612903225806,21,10,11,349.7994449998132,0.8497108843537414,0.29160896130346203,0.20206062058224505,130794.81336805563,-849.609374999993,129945.20399305563,2763,2,651.3,41,9,16,35.325441276306854,0.6196646341463414,44.270833333333336,1022.9166666666673,24.949186991869933,0
2802,4,1,3,48,0.0196078431372549,0.058823529411764705,0.9411764705882353,51,900,700,200,0.7777777777777778,11,7,4,343.14634396185556,0.8520588235294119,0.2901389213644954,0.19943257812436568,131030.32889399682,-1207.4843383810949,129822.84455561572,2764,0,639.5098039215686,42,9,16,35.257547794813576,0.6205357142857142,44.04069767441861,1023.8372093023261,24.377076411960143,0
2803,4,1,0,49,0.02040816326530612,0.0,1.0,49,1000,700,300,0.7,13,7,6,351.59603212488605,0.8498441043083901,0.3059077541298374,0.20454281868881952,131067.83743142318,-583.4136839843925,130484.42374743878,2765,0,663.530612244898,40,9,17,35.00334954346963,0.6239583333333333,44.00406504065041,1023.983739837399,25.599593495934975,0
2804,4,0,1,48,0.0,0.02040816326530612,0.9795918367346939,49,1600,1200,400,0.75,20,12,8,353.7076296422153,0.8489937641723356,0.30767517799699995,0.20646940442519843,131197.9489411893,-518.8568932182961,130679.092047971,2766,1,664.530612244898,40,9,17,34.817767747908626,0.6252604166666667,43.877032520325216,1024.4918699187008,25.61229674796752,0
2805,4,2,1,49,0.04,0.02,0.98,50,1050,700,350,0.6666666666666666,14,7,7,356.1729276523149,0.8544727891156463,0.30485934042777396,0.1941664133456702,128523.41666894937,-757.7711027156533,127765.64556623372,2767,0,652.04,38,12,17,37.472122712745396,0.6016995614035088,46.50106837606837,1013.9957264957253,26.68409806567698,8
2806,4,3,2,50,0.057692307692307696,0.038461538461538464,0.9615384615384616,52,1650,1200,450,0.7272727272727273,21,12,9,338.61613928000753,0.8641905480140774,0.3061724003901527,0.18742716015345637,129127.51379311639,-1655.0679609098006,127472.44583220659,2768,0,626.9807692307693,42,10,18,37.301975085009715,0.6014384920634921,45.906007751937985,1016.375968992248,24.19942783314876,0
2807,4,0,0,50,0.0,0.0,1.0,50,950,600,350,0.631578947368421,13,6,7,348.1747324969616,0.8560884353741496,0.30762286057451727,0.19144819770925348,128865.81776926738,-1026.435674036646,127839.38209523073,2769,1,653.06,40,10,18,37.32567644213125,0.6018229166666668,46.16361788617885,1015.3455284552825,25.383638211382063,0
2808,4,1,0,51,0.0196078431372549,0.0,1.0,51,1700,1300,400,0.7647058823529411,21,13,8,339.4098046338469,0.8597385620915033,0.30510559003889437,0.18810080614969285,129176.76150959973,-1431.2281225587462,127745.53338704098,2770,0,641.2352941176471,42,9,19,37.231714485431965,0.601934523809524,45.85755813953488,1016.5697674418601,24.20404208194905,0
2809,4,0,0,51,0.0,0.0,1.0,51,850,400,450,0.47058823529411764,13,4,9,337.38816657593947,0.8586274509803923,0.3024452559142894,0.18734830956281676,129254.34570312487,-1478.2156141551889,127776.13008896969,2771,1,642.2352941176471,39,12,19,37.204210202827284,0.6073717948717949,45.78124999999999,1016.874999999999,26.073717948717924,0
2810,4,2,1,52,0.03773584905660377,0.018867924528301886,0.9811320754716981,53,1450,900,550,0.6206896551724138,20,9,11,329.239074681743,0.8641146589259796,0.31782623872425675,0.1851744412366646,129756.71315980068,-2055.803965104594,127700.90919469608,2772,0,618.9622641509434,41,12,18,36.90157416423239,0.6092479674796749,45.2876984126984,1018.8492063492041,24.849980642663514,0
2811,4,0,1,51,0.0,0.019230769230769232,0.9807692307692307,52,1200,900,300,0.75,15,9,6,335.24951657050497,0.8615196078431372,0.3188756013127729,0.18806948290233858,129655.65653344638,-1706.6007653061602,127949.05576814023,2773,1,631.8653846153846,41,11,18,36.85101305279562,0.6082317073170733,45.386904761904745,1018.4523809523783,24.840301974448252,0
2812,4,0,0,51,0.0,0.0,1.0,51,1550,900,650,0.5806451612903226,22,9,13,340.74684961414533,0.8582352941176471,0.32239442683261,0.19095544928041008,129614.99851278975,-1366.819518804969,128248.17899398478,2774,2,645.1960784313726,40,11,18,36.752328675981374,0.6093750000000002,45.42682926829267,1018.2926829268272,25.457317073170678,0
2813,4,0,0,51,0.0,0.0,1.0,51,1000,700,300,0.7,13,7,6,341.0286234781586,0.8584967320261438,0.31675803428535665,0.191365557922626,129666.74619108983,-1355.9856071121853,128310.76058397764,2775,3,646.1960784313726,40,11,18,36.692609592230404,0.6098958333333334,45.376016260162594,1018.4959349593486,25.462398373983714,0
2814,4,1,0,52,0.019230769230769232,0.0,1.0,52,1550,1300,250,0.8387096774193549,18,13,5,338.5424667433166,0.8613624937154348,0.32724097107528616,0.19179214235415207,130040.11646685879,-1595.1796391443008,128444.93682771448,2776,0,634.75,42,10,19,36.377185065551956,0.6106150793650794,45.00968992248061,1019.9612403100762,24.284791435954194,0
2815,4,1,0,53,0.018867924528301886,0.0,1.0,53,1350,800,550,0.5925925925925926,19,8,11,328.9309456439585,0.8650520077406869,0.31961465004344003,0.18790317172357981,130363.87963750312,-2023.4768854835793,128340.40275201954,2777,0,623.7547169811321,41,12,21,36.294605271679295,0.6153455284552845,44.692460317460316,1021.2301587301585,24.908052651955085,0
2816,4,0,1,52,0.0,0.018867924528301886,0.9811320754716981,53,1550,1000,550,0.6451612903225806,21,10,11,329.4568430720185,0.8642356071601355,0.3233653386388493,0.18881892191423028,130490.55103812355,-2001.7990008503436,128488.75203727321,2778,1,624.7547169811321,41,12,15,36.15308525099523,0.6166158536585367,44.56845238095238,1021.7261904761903,24.92015098722415,0
2817,4,1,2,51,0.018867924528301886,0.03773584905660377,0.9622641509433962,53,1450,800,650,0.5517241379310345,21,8,13,327.4530363894138,0.8691340106434445,0.32265176374077087,0.188285495923913,130617.28395061727,-2045.7947530864237,128571.48919753086,2779,0,623.8490566037735,41,12,17,36.07620018115942,0.6178861788617886,44.44444444444444,1022.2222222222222,24.932249322493224,0
2818,4,2,2,51,0.03773584905660377,0.03773584905660377,0.9622641509433962,53,800,600,200,0.75,10,6,4,325.5752216060165,0.8740626511852927,0.3135687660915347,0.18806756918653408,130794.81336805545,-2083.2899305555684,128711.52343749988,2780,0,622.7924528301887,41,12,17,35.94492532247113,0.6196646341463414,44.27083333333333,1022.9166666666657,24.949186991869894,0
2819,4,0,0,51,0.0,0.0,1.0,51,1600,1000,600,0.625,22,10,12,339.67245681474253,0.8638888888888889,0.31747906398420644,0.1956178928456278,130677.89019639412,-1322.4639971247486,129355.42619926936,2781,2,648.2156862745098,40,11,17,35.702630619885376,0.6200520833333334,44.38516260162601,1022.4593495934942,25.561483739837353,0
2820,4,0,0,51,0.0,0.0,1.0,51,1800,1300,500,0.7222222222222222,23,13,10,336.4519780416863,0.8639215686274511,0.31266971322604165,0.19441593633568396,130807.80805902567,-1397.8908470487177,129409.91721197695,2782,3,649.2156862745098,40,11,17,35.65364428107823,0.6213541666666667,44.25813008130081,1022.9674796747964,25.57418699186991,0
2821,4,0,1,50,0.0,0.0196078431372549,0.9803921568627451,51,1050,400,650,0.38095238095238093,17,4,13,337.0443754469961,0.863562091503268,0.31614847190490325,0.19488947315479102,130833.79937743745,-1380.6407602947934,129453.15861714266,2783,4,650.2156862745098,40,11,17,35.612231383066764,0.6216145833333333,44.232723577235774,1023.0691056910575,25.57672764227644,0
2822,4,0,1,49,0.0,0.02,0.98,50,1450,1100,350,0.7586206896551724,18,11,7,321.0340384556156,0.8600510204081633,0.23384921763869193,0.1840839551666374,130509.99907044334,-1620.369587915397,128889.62948252795,2784,5,663.92,42,8,17,36.34858542753281,0.615327380952381,44.54941860465116,1021.8023255813943,24.328626799557007,2
2823,4,0,1,48,0.0,0.02040816326530612,0.9795918367346939,49,1600,1200,400,0.75,20,12,8,325.95282350723846,0.857249149659864,0.24534174411440146,0.18705515515030996,130541.23682169632,-1289.9430547681998,129251.29376692812,2785,6,677.7551020408164,41,8,17,36.1913689609423,0.6171239837398375,44.51884920634921,1021.9246031746036,24.924990321331794,0
2824,4,0,0,48,0.0,0.0,1.0,48,1450,1200,250,0.8275862068965517,17,12,5,329.07881552851455,0.8559581855791962,0.24610591900311474,0.18913569866204594,130599.9704623572,-1004.4632824376886,129595.50717991951,2786,7,690.7291666666666,40,8,17,36.0521475442434,0.6192708333333332,44.461382113821145,1022.1544715447166,25.553861788617915,0
2825,4,1,2,47,0.02040816326530612,0.04081632653061224,0.9591836734693877,49,1750,1300,450,0.7428571428571429,22,13,9,323.5135759828974,0.8570365646258503,0.24323586328073876,0.18724573640222258,130870.93431122467,-1332.2952097505577,129538.63910147411,2787,0,677.6122448979592,41,8,17,35.920835757223166,0.6204268292682926,44.19642857142858,1023.2142857142871,24.956445993031394,0
2826,4,1,1,47,0.020833333333333332,0.020833333333333332,0.9791666666666666,48,1100,700,400,0.6363636363636364,15,7,8,334.9748527652011,0.8543144208037825,0.24507515560852866,0.19382338032414093,130859.79327781117,-833.052002776087,130026.74127503508,2788,0,692.2916666666666,40,8,17,35.638905442987685,0.6218749999999998,44.20731707317075,1023.1707317073198,25.579268292682993,0
2827,4,0,0,47,0.0,0.0,1.0,47,1400,1100,300,0.7857142857142857,17,11,6,343.1634924088189,0.8475177304964538,0.25270235727870993,0.19850128518488958,130848.09570312526,-419.54210069441535,130428.55360243085,2789,10,708.0212765957447,39,8,18,35.44127129573067,0.6233974358974358,44.218750000000014,1023.125000000002,26.23397435897441,0
2828,4,2,2,47,0.04081632653061224,0.04081632653061224,0.9591836734693877,49,1450,1100,350,0.7586206896551724,18,11,7,329.7546209726702,0.8578869047619048,0.24496742721294296,0.1928918623565797,131278.46884201674,-1142.0636530256522,130136.40518899109,2790,0,680.0816326530612,42,7,19,35.35008509833586,0.623015873015873,43.798449612403104,1024.8062015503879,24.400147655961614,0
2829,4,0,0,47,0.0,0.0,1.0,47,1050,900,150,0.8571428571428571,12,9,3,341.2839094335032,0.8501773049645389,0.2532704793042124,0.19827532316223279,131015.81090124954,-457.282371604176,130558.52852964537,2791,12,710.0212765957447,40,7,19,35.3198828667858,0.6234374999999999,44.0548780487805,1023.7804878048803,25.594512195122007,0
2830,4,1,1,47,0.020833333333333332,0.020833333333333332,0.9791666666666666,48,1200,1000,200,0.8333333333333334,14,10,4,341.18432017324784,0.8526152482269503,0.26800589191385615,0.20039489545259268,131434.9175347223,-630.5497977807483,130804.36773694155,2792,0,696.2083333333334,39,9,21,34.89943112555872,0.6292735042735043,43.645833333333336,1025.4166666666672,26.292735042735057,0
2831,4,0,0,47,0.0,0.0,1.0,47,850,300,550,0.35294117647058826,14,3,11,351.60566068848,0.8439330866481652,0.28001472244640957,0.20623520293194691,131382.88498064133,-161.00678464461237,131221.87819599672,2793,1,711.7446808510638,38,9,21,34.68480790607196,0.6304824561403508,43.69658119658119,1025.2136752136746,26.979307242465122,0
2832,4,2,1,48,0.04081632653061224,0.02040816326530612,0.9795918367346939,49,1250,1000,250,0.8,15,10,5,341.0296823957242,0.8509070294784581,0.28408324754234027,0.2030512419918003,131953.8686049969,-799.9628197501618,131153.90578524675,2794,0,683.6530612244898,40,9,17,34.38056379821956,0.6328125,43.14024390243902,1027.439024390243,25.685975609756078,0
2833,4,0,0,48,0.0,0.0,1.0,48,1100,800,300,0.7272727272727273,14,8,6,347.3336556862658,0.8449505023640662,0.28235833586908754,0.20616270387783814,131835.77609592007,-441.79958767361995,131393.97650824644,2795,1,698.8958333333334,39,9,17,34.33759762653412,0.6332799145299146,43.25520833333333,1026.979166666666,26.33279914529913,0
2834,4,1,1,48,0.02040816326530612,0.02040816326530612,0.9795918367346939,49,2200,1600,600,0.7272727272727273,28,16,12,341.4505255339518,0.8478599773242631,0.2826945871197155,0.2052758385098415,132319.57250974956,-763.8824856236293,131555.69002412594,2796,0,685.6122448979592,40,9,19,34.001917884893984,0.6364583333333333,42.78455284552846,1028.8617886178868,25.72154471544717,0
2835,4,0,1,47,0.0,0.020833333333333332,0.9791666666666666,48,1200,900,300,0.75,15,9,6,345.14547886267644,0.8448212174940898,0.2892256141737466,0.207210114890155,132267.29811124338,-469.7080111044993,131797.59010013888,2797,3,700.8958333333334,40,8,20,33.95944477376011,0.6359375,42.83536585365854,1028.6585365853664,25.71646341463416,0
2836,4,0,0,47,0.0,0.0,1.0,47,1350,1100,250,0.8148148148148148,16,11,5,350.51321939259594,0.84431853222325,0.2916990599299889,0.2110164601408695,132371.85723610272,-120.38283263931362,132251.4744034634,2798,4,709.4893617021277,40,7,21,33.7162173283297,0.6369791666666667,42.73373983739837,1029.0650406504055,25.726626016260138,0
2837,4,0,0,47,0.0,0.0,1.0,47,1150,800,350,0.6956521739130435,15,8,7,347.8898402472671,0.8444341658957755,0.2888238255478126,0.2100417606906431,132480.48159105846,-182.27212075754795,132298.2094703009,2799,5,710.4893617021277,38,9,21,33.67450186799501,0.6414473684210527,42.628205128205124,1029.487179487179,27.09176788124155,0
2838,4,0,1,46,0.0,0.02127659574468085,0.9787234042553191,47,1500,1300,200,0.8666666666666667,17,13,4,348.1696359202548,0.8438559975331482,0.2910325672993497,0.21036431231119074,132507.9800044743,-172.94896906276364,132335.03103541152,2800,6,711.4893617021277,38,9,21,33.639661374563325,0.6417214912280702,42.60149572649572,1029.5940170940162,27.094579397210953,0
2839,4,1,1,46,0.02127659574468085,0.02127659574468085,0.9787234042553191,47,1550,1300,250,0.8387096774193549,18,13,5,339.8183673970569,0.8450508788159111,0.2785182509064166,0.20677508776300624,132773.486328125,-376.22612847222206,132397.26019965278,2801,0,709.1702127659574,39,8,18,33.58811737753521,0.6426282051282051,42.34375,1030.625,26.42628205128205,0
2840,4,0,0,46,0.0,0.0,1.0,46,1200,800,400,0.6666666666666666,16,8,8,349.3145211092622,0.8412842190016103,0.29245283018867885,0.21245194644514173,132755.59413580268,74.69135802471163,132830.2854938274,2802,8,725.5869565217391,38,8,19,33.36141060197664,0.644188596491228,42.36111111111112,1030.5555555555572,27.11988304093572,0
2841,4,0,0,46,0.0,0.0,1.0,46,1400,900,500,0.6428571428571429,19,9,10,354.6073183172702,0.8411634460547505,0.30004505519261104,0.21630598114801886,132865.71905361972,223.0312659799891,133088.7503195997,2803,9,726.5869565217391,38,8,19,33.1144214162349,0.6452850877192982,42.254273504273506,1030.9829059829062,27.131129104813322,0
2842,4,0,0,46,0.0,0.0,1.0,46,1350,1100,250,0.8148148148148148,16,11,5,352.4413592131797,0.8406199677938808,0.29299969822402594,0.21546019255762022,132948.34270445252,171.2989215793765,133119.6416260319,2804,10,727.5869565217391,38,8,19,33.0872958320384,0.6461074561403508,42.1741452991453,1031.3034188034192,27.139563652721556,0
2843,4,0,0,46,0.0,0.0,1.0,46,1050,700,350,0.6666666666666666,14,7,7,345.43195277346706,0.8406199677938808,0.2763039700462564,0.20586790373001002,131989.918942114,-70.66336780163562,131919.25557431235,2805,11,728.5869565217391,41,5,17,34.23119006243162,0.6316056910569106,43.105158730158735,1027.579365079366,25.06291134339917,4
2844,4,0,0,46,0.0,0.0,1.0,46,1050,800,250,0.7619047619047619,13,8,5,349.3772956568174,0.8401972624798713,0.279429058442223,0.20909433075095843,132148.80720997852,33.9585774592957,132182.76578743782,2806,12,729.5869565217391,42,4,17,33.96985832312379,0.6316964285714286,42.95058139534884,1028.1976744186059,24.480897009966807,0
2845,4,0,1,45,0.0,0.021739130434782608,0.9782608695652174,46,1450,900,550,0.6206896551724138,20,9,11,328.1105848299162,0.8394927536231884,0.21192353924184304,0.198607345837863,132576.73852237617,-499.56428472768,132077.1742376485,2807,13,730.5869565217391,41,5,17,34.0870139357159,0.63744918699187,42.53472222222221,1029.8611111111081,25.118563685636783,3
2846,4,0,0,45,0.0,0.0,1.0,45,1300,900,400,0.6923076923076923,17,9,8,328.9796617291986,0.8385521885521886,0.20667693888032934,0.1995400004320089,132653.3761652806,-271.94743638198685,132381.42872889864,2808,14,733.8666666666667,41,4,16,33.98778569594248,0.6382113821138213,42.46031746031745,1030.1587301587278,25.12582268679824,0
2847,4,0,0,45,0.0,0.0,1.0,45,1300,800,500,0.6153846153846154,18,8,10,332.74968940940596,0.837962962962963,0.2057502246181495,0.20237727011621218,132755.59413580224,-165.12345679014706,132590.4706790121,2809,15,734.8666666666667,41,4,16,33.788185085354904,0.6392276422764228,42.3611111111111,1030.5555555555536,25.135501355013503,0
2848,4,0,0,45,0.0,0.0,1.0,45,1250,900,350,0.72,16,9,7,333.446228845426,0.8373316498316499,0.21236848858096002,0.20335523533812572,132857.85147392267,-139.81009070296858,132718.0413832197,2810,16,735.8666666666667,41,4,16,33.66772517321016,0.6402439024390245,42.26190476190475,1030.9523809523791,25.14518002322876,0
2849,4,1,1,45,0.021739130434782608,0.021739130434782608,0.9782608695652174,46,1300,900,400,0.6923076923076923,17,9,8,325.75090223334223,0.8379227053140097,0.21121977501673506,0.20034056643126794,133172.00363559872,-523.8199326963611,132648.18370290237,2811,0,720.8478260869565,42,4,16,33.55160220302917,0.6418650793650793,41.95736434108527,1032.1705426356582,24.575489110372814,0
2850,4,0,0,45,0.0,0.0,1.0,45,1250,800,450,0.64,17,8,9,364.4725314856262,0.8352272727272728,0.19318932832446345,0.2118095978912527,131027.14913662433,634.5729610483814,131661.7220976727,2812,18,737.8666666666667,38,7,16,34.71490312706529,0.6269188596491228,44.04380341880342,1023.8247863247865,26.942757534862803,6
2851,4,0,1,44,0.0,0.022222222222222223,0.9777777777777777,45,1000,500,500,0.5,15,5,10,361.05359586452414,0.8333754208754209,0.20019209690723994,0.21044694772589637,131141.34250217036,469.81065538196924,131611.15315755233,2813,19,738.8666666666667,39,6,17,34.68687497881285,0.62633547008547,43.93229166666668,1024.270833333335,26.263354700854745,0
2852,4,1,0,45,0.022222222222222223,0.0,1.0,45,1050,800,250,0.7619047619047619,13,8,5,375.2343963138833,0.8364478114478114,0.22101600556715417,0.21961467786833802,131299.26960321824,897.6189878909938,132196.88859110925,2814,0,739.4222222222222,36,9,18,34.16382815075267,0.6333912037037036,43.77815315315316,1024.8873873873886,28.469094094094128,4
2853,4,0,1,44,0.0,0.022222222222222223,0.9777777777777777,45,1250,900,350,0.72,16,9,7,376.6571454978704,0.8366582491582492,0.22218209632722652,0.22147040253859526,131476.45968632118,904.3127715232474,132380.77245784443,2815,1,740.4222222222222,35,10,19,33.948035398562986,0.637202380952381,43.605324074074076,1025.578703703704,29.302248677248684,0
2854,4,0,0,44,0.0,0.0,1.0,44,1400,1100,300,0.7857142857142857,17,11,6,383.58962858653814,0.833377378435518,0.22933744395768985,0.2255466289917263,131476.45968632118,1286.6012677897832,132763.06095411096,2816,2,757.1590909090909,35,9,19,33.77029022307489,0.637202380952381,43.605324074074076,1025.578703703704,29.302248677248684,0
2855,4,1,0,45,0.022222222222222223,0.0,1.0,45,1250,1000,250,0.8,15,10,5,377.8508771929826,0.8365740740740741,0.23847953216374274,0.22434895833333338,131848.06428049668,963.7813489164818,132811.84562941315,2817,0,741.3111111111111,36,9,15,33.54166666666667,0.6388888888888888,43.24324324324324,1027.0270270270266,28.52852852852852,0
2856,4,1,2,44,0.021739130434782608,0.043478260869565216,0.9565217391304348,46,1050,600,450,0.5714285714285714,15,6,9,370.94837301541077,0.8403784219001611,0.2385925211455704,0.22181198631329666,132116.03570329328,601.6456986765147,132717.6814019698,2818,0,726.1739130434783,37,9,15,33.4484321672355,0.6396396396396395,42.98245614035088,1028.0701754385964,27.78568041725936,0
2857,4,0,0,44,0.0,0.0,1.0,44,1300,800,500,0.6153846153846154,18,8,10,383.82310501646924,0.830822762508809,0.23846736859355122,0.22833873191194246,131921.9660922497,1326.9397290809356,133248.90582133064,2819,2,760.0909090909091,35,9,15,33.31361724500525,0.6416666666666666,43.1712962962963,1027.3148148148152,29.351851851851865,0
2858,4,0,0,44,0.0,0.0,1.0,44,1500,1000,500,0.6666666666666666,20,10,10,385.9173807265586,0.8296555673009162,0.23840983321217624,0.23012494449100818,132011.15779588892,1389.0800486539642,133400.2378445429,2820,3,761.0909090909091,35,9,16,33.169674700604425,0.6425595238095239,43.08449074074073,1027.662037037036,29.36177248677246,0
2859,4,0,0,44,0.0,0.0,1.0,44,1000,600,400,0.6,14,6,8,388.79290964914725,0.8295234319943623,0.24815787049829607,0.23256884959012614,132130.12695312488,1474.2513020833194,133604.3782552082,2821,4,762.0909090909091,35,9,16,32.97555724417427,0.64375,42.96874999999999,1028.124999999999,29.374999999999975,0
2860,4,1,1,44,0.022222222222222223,0.022222222222222223,0.9777777777777777,45,1050,700,350,0.6666666666666666,14,7,7,384.06802106434486,0.8349747474747475,0.2433334548858015,0.23173371488773428,132455.95838659588,1174.419563144206,133630.3779497401,2822,0,746.1333333333333,36,9,17,32.76811435656201,0.6449652777777779,42.65202702702702,1029.3918918918905,28.59421921921918,0
2861,4,0,0,44,0.0,0.0,1.0,44,1350,1100,250,0.8148148148148148,16,11,5,395.58356667733744,0.8292591613812544,0.255808364863483,0.23793896534245804,132338.45191400888,1670.1833633401893,134008.63527734907,2823,6,764.0909090909091,35,9,17,32.590457442819655,0.6458333333333334,42.7662037037037,1028.935185185185,29.39814814814814,0
2862,4,0,0,44,0.0,0.0,1.0,44,1500,900,600,0.6,21,9,12,396.392885873847,0.8285103946441156,0.25707320563403324,0.2391803478264585,132457.56842635467,1701.0475608710694,134158.61598722573,2824,7,765.0909090909091,35,9,17,32.449310396522,0.6470238095238094,42.65046296296297,1029.398148148149,29.411375661375683,0
2863,4,2,2,44,0.043478260869565216,0.043478260869565216,0.9565217391304348,46,1650,1200,450,0.7272727272727273,21,12,9,382.605571725993,0.8354669887278583,0.25460621804768446,0.23399141792293157,132962.84072983987,974.4647391504968,133937.30546899035,2825,0,732.7826086956521,37,9,15,32.29498901410447,0.6480855855855856,42.16008771929824,1031.3596491228063,27.874585111427198,0
2864,4,0,1,43,0.0,0.022727272727272728,0.9772727272727273,44,1050,700,350,0.6666666666666666,14,7,7,397.85466215325084,0.8245243128964059,0.2617657872966266,0.24139770605494806,132666.15125868062,1756.3693576388991,134422.52061631953,2826,9,767.0909090909091,35,9,15,32.20108695652174,0.6491071428571428,42.44791666666667,1030.208333333334,29.434523809523828,0
2865,4,0,1,42,0.0,0.023255813953488372,0.9767441860465116,43,1300,1100,200,0.8461538461538461,15,11,4,404.81875975324937,0.8199520118124769,0.27067810641980894,0.2452725426740275,132612.5,2136.8055555555557,134749.30555555556,2827,10,783.7441860465116,34,9,18,32.07591693635382,0.650735294117647,42.5,1030.0,30.294117647058822,0
2866,4,0,0,42,0.0,0.0,1.0,42,1500,1000,500,0.6666666666666666,20,10,10,407.4157032745326,0.8174119241192412,0.27062730789761846,0.2470475179001073,132643.15653344675,2408.1809807256222,135051.33751417237,2828,11,801.452380952381,34,8,17,31.978071189182934,0.6510416666666666,42.470238095238095,1030.1190476190477,30.29761904761905,0
2867,4,0,0,42,0.0,0.0,1.0,42,900,600,300,0.6666666666666666,12,6,6,409.67468284476195,0.8167828106852497,0.27395534132303245,0.24862024581616907,132673.81660997734,2470.6207482993177,135144.43735827666,2829,12,802.452380952381,34,8,17,31.888914567444726,0.6513480392156863,42.44047619047619,1030.2380952380954,30.301120448179276,0
2868,4,0,0,42,0.0,0.0,1.0,42,750,600,150,0.8,9,6,3,408.71955973490475,0.8149922570654278,0.2751857412326286,0.24905718984831418,132827.17013888908,2457.8125000000246,135284.9826388891,2830,13,803.452380952381,34,8,17,31.75862301266506,0.6528799019607842,42.29166666666668,1030.8333333333348,30.318627450980436,0
2869,4,0,0,42,0.0,0.0,1.0,42,1150,600,550,0.5217391304347826,17,6,11,407.3744625756142,0.8146535036778939,0.27454329660459686,0.24835621753326473,132845.06715374245,2423.537567515449,135268.6047212579,2831,14,804.452380952381,35,7,17,31.775218928932308,0.6508928571428569,42.274305555555564,1030.902777777779,29.454365079365115,0
2870,4,0,0,42,0.0,0.0,1.0,42,900,700,200,0.7777777777777778,11,7,4,409.59650879905536,0.8142663569492837,0.27875235850317237,0.2501093418019729,132904.7325772677,2487.462893304195,135392.1954705719,2832,15,805.452380952381,35,7,17,31.65771036779288,0.6514880952380953,42.21643518518519,1031.1342592592598,29.460978835978853,0
2871,4,0,0,42,0.0,0.0,1.0,42,1050,800,250,0.7619047619047619,13,8,5,409.1678503420412,0.8133710801393729,0.2823823952204598,0.250246720274395,132964.4113967123,2480.9524766375343,135445.36387334982,2833,16,806.452380952381,35,7,17,31.608522238431895,0.6520833333333332,42.158564814814824,1031.3657407407422,29.467592592592634,0
2872,4,0,0,42,0.0,0.0,1.0,42,650,400,250,0.6153846153846154,9,4,5,411.34340801076945,0.8133710801393729,0.2801073849133,0.2403205007924688,131231.07854109266,2415.990240286902,133647.06878137955,2834,17,807.452380952381,32,10,16,33.30791743684533,0.6416015625,43.84469696969696,1024.6212121212113,32.019412878787854,4
2873,4,1,1,42,0.023255813953488372,0.023255813953488372,0.9767441860465116,43,1000,600,400,0.6,14,6,8,401.18833850792777,0.8192137320044296,0.2710830957370065,0.23617783058249303,131522.32552800726,1953.0805211202835,133475.40604912754,2835,0,789.6511627906976,32,11,16,33.27255662235353,0.64453125,43.560606060606055,1025.757575757575,32.05492424242422,0
2874,4,1,1,42,0.023255813953488372,0.023255813953488372,0.9767441860465116,43,1100,700,400,0.6363636363636364,15,7,8,396.73232296715605,0.8143687707641196,0.27070774088012883,0.23514775877324437,131781.48275686154,1856.3947556371845,133637.87751249873,2836,0,790.6279069767442,32,11,16,33.124282669290054,0.6471354166666666,43.30808080808081,1026.767676767677,32.0864898989899,0
2875,4,0,0,42,0.0,0.0,1.0,42,1100,700,400,0.6363636363636364,15,7,8,406.43069205607355,0.8105884630274874,0.28855866023689836,0.2361141864698496,131014.28086553245,2249.644968281427,133263.92583381388,2837,20,810.452380952381,33,9,17,33.65403798579522,0.6369949494949496,44.056372549019606,1023.7745098039213,31.02346999405822,1
2876,4,0,0,42,0.0,0.0,1.0,42,1000,600,400,0.6,14,6,8,405.5985431450296,0.810322299651568,0.2864779229068366,0.23601541967408535,131077.0196559015,2232.929642445207,133309.9492983467,2838,21,811.452380952381,33,9,17,33.61157651188767,0.6376262626262627,43.995098039215684,1024.0196078431368,31.030897207367783,0
2877,4,1,0,43,0.023255813953488372,0.0,1.0,43,1200,1000,200,0.8333333333333334,14,10,4,374.79727060591176,0.8176910299003322,0.2776305746234322,0.21104794659072157,129803.15778193738,1136.5969041729493,130939.75468611033,2839,0,793.5581395348837,36,7,20,35.6938612001326,0.6183449074074074,45.24211711711712,1019.0315315315318,28.306431431431438,5
2878,4,1,0,44,0.022727272727272728,0.0,1.0,44,1050,400,650,0.38095238095238093,17,4,13,373.34443981674315,0.8244802677942213,0.29897959183673506,0.2127195064072141,130262.58680555549,928.185744866484,131190.77255042197,2840,0,776.5,35,9,21,35.26360544217687,0.625,44.791666666666664,1020.8333333333328,29.16666666666665,0
2879,4,0,0,44,0.0,0.0,1.0,44,1050,800,250,0.7619047619047619,13,8,5,373.77800202976994,0.8236654334038055,0.29595074128650056,0.21359752365519746,130377.57087746532,946.4535904147433,131324.02446788005,2841,1,777.5,36,8,21,35.1357187488514,0.6241319444444444,44.679054054054056,1021.283783783784,28.368993993994,0
2880,4,2,2,44,0.043478260869565216,0.043478260869565216,0.9565217391304348,46,1000,600,400,0.6,14,6,8,359.6349363477005,0.8300322061191626,0.2917192479141508,0.2082577642284326,130890.4560687413,214.55616736065107,131105.01223610196,2842,0,744.6521739130435,38,8,20,34.977074197814424,0.6255482456140351,44.177350427350426,1023.2905982905982,26.92869995501574,0
2881,4,0,0,44,0.0,0.0,1.0,44,750,700,50,0.9333333333333333,8,7,1,386.43489580443736,0.8245463354474982,0.31426142007203683,0.2195289398673359,130147.65346004792,1258.7189808051303,131406.37244085304,2843,1,770.7045454545455,36,8,21,35.04649045359232,0.6218171296296295,44.90427927927928,1020.3828828828831,28.343968968968976,1
2882,4,1,1,44,0.022222222222222223,0.022222222222222223,0.9777777777777777,45,1250,900,350,0.72,16,9,7,375.41038785733826,0.8293771043771044,0.2999320384876776,0.21528919411954073,130514.55886667052,799.3042330332408,131313.86309970377,2844,0,754.5555555555555,37,8,18,34.954908430804444,0.6235923423423423,44.54495614035088,1021.8201754385965,27.616761498340445,0
2883,4,1,1,44,0.022222222222222223,0.022222222222222223,0.9777777777777777,45,950,600,350,0.631578947368421,13,6,7,373.6091836651556,0.8291666666666667,0.2959689146344371,0.2147216282445489,130598.60365689447,758.5675400123173,131357.1711969068,2845,0,755.5333333333333,37,8,18,34.91561181434599,0.6244369369369369,44.46271929824562,1022.1491228070179,27.62565196775724,0
2884,4,2,1,45,0.043478260869565216,0.021739130434782608,0.9782608695652174,46,1150,700,450,0.6086956521739131,16,7,9,366.5104813585204,0.8366545893719807,0.29481439436939505,0.21178864568544556,130808.47447083434,388.53538881584683,131197.0098596502,2846,0,740.0652173913044,38,8,19,34.88424717145344,0.6247258771929824,44.25747863247864,1022.9700854700861,26.92026540710753,0
2885,4,0,0,45,0.0,0.0,1.0,45,1350,1000,350,0.7407407407407407,17,10,7,371.76291377479157,0.8323232323232324,0.30144844673146576,0.2145918601294092,130766.77439212053,722.8474145890937,131489.62180670962,2847,1,757.5111111111111,37,8,19,34.79220268724986,0.6261261261261262,44.29824561403508,1022.8070175438586,27.64343290659077,0
2886,4,1,1,45,0.021739130434782608,0.021739130434782608,0.9782608695652174,46,750,600,150,0.8,9,6,3,364.7160122160799,0.8336553945249597,0.2990389589175355,0.21180053509421082,130999.80481591064,355.5452827087528,131355.35009861938,2848,0,742.0217391304348,38,8,21,34.736354623251934,0.6266447368421052,44.070512820512825,1023.7179487179492,26.939946018893398,0
2887,4,1,1,45,0.021739130434782608,0.021739130434782608,0.9782608695652174,46,700,300,400,0.42857142857142855,11,3,8,366.46003307123374,0.8383856682769727,0.29989474114033476,0.21296461473145137,131027.14913662431,403.2426811673639,131430.39181779168,2849,0,742.8695652173913,38,8,21,34.66403179241017,0.6269188596491228,44.04380341880342,1023.8247863247864,26.9427575348628,0
2888,4,0,1,44,0.0,0.022222222222222223,0.9777777777777777,45,950,500,450,0.5263157894736842,14,5,9,374.6203404836178,0.8311447811447812,0.3060834374814023,0.2173449893358961,130963.11034404805,812.2889975761641,131775.3993416242,2850,2,760.3777777777777,37,8,22,34.520063381539,0.6280968468468469,44.1063596491228,1023.5745614035078,27.66417733522994,0
2889,4,0,0,44,0.0,0.0,1.0,44,1000,500,500,0.5,15,5,10,374.0656013298154,0.8304263565891473,0.29947969901391036,0.21765723681116184,131075.368442694,1006.1573032086891,132081.52574590268,2851,3,764.0681818181819,37,7,22,34.42050808437735,0.6292229729729729,43.996710526315795,1024.0131578947373,27.67603129445236,0
2890,4,0,0,44,0.0,0.0,1.0,44,1300,1000,300,0.7692307692307693,16,10,6,375.3762734585249,0.8309108527131783,0.3054095872014948,0.21889919766851063,131159.5935768698,1046.8398930440158,132206.4334699138,2852,4,765.0681818181819,37,7,23,34.30163062870192,0.6300675675675675,43.91447368421053,1024.342105263158,27.684921763869134,0
2891,4,1,0,45,0.022222222222222223,0.0,1.0,45,1600,1200,400,0.75,20,12,8,364.48878933886664,0.8329966329966331,0.3060704317358509,0.2145873268889301,131524.88175448228,587.9771900969677,132112.85894457926,2853,0,749.0444444444445,37,8,24,34.21109477997505,0.6337274774774774,43.558114035087726,1025.7675438596502,27.7234471313419,0
2892,4,1,1,45,0.021739130434782608,0.021739130434782608,0.9782608695652174,46,1400,800,600,0.5714285714285714,20,8,12,359.58932194827713,0.8333937198067634,0.2956919709481649,0.21366450810943977,131876.23844875442,284.25743297538116,132160.4958817298,2854,0,733.7391304347826,38,8,18,33.982126759586734,0.6354166666666666,43.215811965811966,1027.1367521367517,27.02991452991452,0
2893,4,0,0,45,0.0,0.0,1.0,45,950,600,350,0.631578947368421,13,6,7,357.2346191458911,0.833922558922559,0.24604168165575446,0.19726674499438773,129034.22807979377,221.1589414732112,129255.38702126699,2855,2,751.0444444444445,37,8,19,36.923969350312966,0.6086711711711712,45.997807017543856,1016.0087719298244,27.459696538643904,7
2894,4,3,1,47,0.0625,0.020833333333333332,0.9791666666666666,48,900,700,200,0.7777777777777778,11,7,4,333.7375404081208,0.8477393617021276,0.24339493235183896,0.1877105740501338,129757.97661675338,-938.8702007468728,128819.10641600651,2856,0,705.0416666666666,39,9,15,36.78571124288587,0.6124465811965812,45.28645833333333,1018.8541666666658,26.12446581196579,0
2895,4,0,0,47,0.0,0.0,1.0,47,1150,800,350,0.6956521739130435,15,8,7,341.7533275528131,0.8432392846130126,0.2519277452520352,0.19215564454856285,129745.05077069183,-531.8394331214786,129213.21133757035,2857,1,721.0425531914893,38,9,17,36.59465883668905,0.6140350877192982,45.2991452991453,1018.803418803419,26.8106162843005,0
2896,4,0,0,47,0.0,0.0,1.0,47,1150,800,350,0.6956521739130435,15,8,7,338.01075906807495,0.8419673142152327,0.2507292921182931,0.19058053436816988,129853.9201183432,-621.5955785667281,129232.32453977647,2858,2,722.0425531914893,38,9,17,36.57953354297695,0.6151315789473684,45.19230769230769,1019.2307692307693,26.82186234817814,0
2897,4,0,0,47,0.0,0.0,1.0,47,1500,900,600,0.6,21,9,12,342.9943178967487,0.8410422448350292,0.2554528798962252,0.1942006974283726,130017.30974687697,-480.9603057199299,129536.34944115704,2859,3,723.0425531914893,38,9,17,36.286795516446695,0.6167763157894737,45.03205128205128,1019.8717948717941,26.838731443994583,0
2898,4,0,1,46,0.0,0.02127659574468085,0.9787234042553191,47,1150,800,350,0.6956521739130435,15,8,7,341.6163458915832,0.8394233734196731,0.25634388289518517,0.19409742531888827,130153.54624379064,-507.48422547300754,129646.06201831764,2860,4,724.0425531914893,38,9,17,36.183820193348005,0.6181469298245614,44.89850427350427,1020.4059829059829,26.852789023841655,0
2899,4,0,1,45,0.0,0.021739130434782608,0.9782608695652174,46,900,500,400,0.5555555555555556,13,5,8,345.5269667466574,0.83756038647343,0.2585029086746258,0.1961640284062018,130122.70752779712,-207.81911261155966,129914.88841518556,2861,5,740.5217391304348,37,9,17,36.115327780763046,0.6196509009009008,44.928728070175445,1020.2850877192991,27.57527264106214,0
2900,4,1,1,45,0.021739130434782608,0.021739130434782608,0.9782608695652174,46,1150,800,350,0.6956521739130435,15,8,7,340.8951683376433,0.8380636070853462,0.266126923651576,0.19451077252206722,130318.55955678686,-315.0065404739778,130003.55301631289,2862,0,739.5652173913044,37,9,17,36.03504438717069,0.6216216216216215,44.736842105263165,1021.0526315789486,27.596017069701315,0
2901,4,0,0,45,0.0,0.0,1.0,45,1600,1200,400,0.75,20,12,8,349.7669257264723,0.8345959595959597,0.2761369067313699,0.19958066177230532,130320.07250071043,116.33022380491548,130436.40272451536,2863,7,757.0,36,9,20,35.80704753501709,0.6235532407407407,44.735360360360374,1021.0585585585607,28.362737737737795,0
2902,4,2,2,45,0.0425531914893617,0.0425531914893617,0.9574468085106383,47,950,600,350,0.631578947368421,13,6,7,334.16132203675164,0.8458603145235892,0.264070687900297,0.19295901671772395,130781.15297866917,-659.5994046314411,130121.55357403772,2864,0,725.7446808510638,38,9,16,35.73915465496832,0.6244517543859648,44.28418803418804,1022.8632478632492,26.917453891138138,0
2903,4,1,1,45,0.021739130434782608,0.021739130434782608,0.9782608695652174,46,1250,900,350,0.72,16,9,7,340.1777630831816,0.8370571658615137,0.26742277654738245,0.1959331464330246,130682.67549871118,-308.93195502462606,130373.74354368655,2865,0,742.5,37,9,16,35.68487488829311,0.6252815315315314,44.38048245614035,1022.4780701754389,27.634542437174026,0
2904,4,0,0,45,0.0,0.0,1.0,45,1050,600,450,0.5714285714285714,15,6,9,349.27608018499006,0.8348484848484848,0.2770469930104178,0.2007839759239491,130607.69120049107,123.62848490383251,130731.3196853949,2866,10,760.0,36,9,16,35.528212331533936,0.6264467592592593,44.45382882882883,1022.184684684685,28.394019019019026,0
2905,4,0,0,45,0.0,0.0,1.0,45,1600,1200,400,0.75,20,12,8,347.35782974383824,0.8361531986531987,0.26790476889574033,0.200425909131737,130751.61944038642,83.51975286098195,130835.1391932474,2867,11,761.0,36,9,17,35.43157711223667,0.6278935185185185,44.31306306306307,1022.7477477477485,28.40965965965968,0
2906,4,2,0,47,0.0425531914893617,0.0,1.0,47,1200,800,400,0.6666666666666666,16,8,8,333.7960208870382,0.8433934628430465,0.261373464798478,0.19550909794812243,131328.12500000012,-632.638888888875,130695.48611111124,2868,0,729.5744680851063,38,9,21,35.19647696476965,0.6299342105263157,43.75000000000001,1025.000000000001,26.97368421052634,0
2907,4,0,1,46,0.0,0.02127659574468085,0.9787234042553191,47,1300,1000,300,0.7692307692307693,16,10,6,336.05081925707253,0.8435090965155719,0.26034731598305294,0.19725258179878466,131410.26925131507,-567.894271860602,130842.37497945447,2869,1,730.5744680851063,38,9,21,35.0558768365114,0.6307565789473684,43.6698717948718,1025.320512820514,26.98211875843458,0
2908,4,0,0,46,0.0,0.0,1.0,46,850,600,250,0.7058823529411765,11,6,5,341.7257726587555,0.8402777777777778,0.2652663451426911,0.1998679031306577,131273.37643363306,-228.10080173859905,131045.27563189446,2870,2,747.1739130434783,38,8,21,35.04852133722547,0.6293859649122806,43.803418803418815,1024.7863247863265,26.96806117858754,0
2909,4,0,0,46,0.0,0.0,1.0,46,1200,800,400,0.6666666666666666,16,8,8,342.38958231648616,0.8388083735909823,0.2617993826012568,0.20113237272762452,131440.53939673764,-199.2143090252202,131241.32508771244,2871,3,748.1739130434783,37,9,22,34.8628635585971,0.6328828828828827,43.64035087719299,1025.4385964912296,27.714556661925126,0
2910,4,1,0,47,0.02127659574468085,0.0,1.0,47,1200,800,400,0.6666666666666666,16,8,8,349.87893760329484,0.8456290471785384,0.2636698977663272,0.19853501244998062,130103.13042534702,-280.34927213183084,129822.78115321518,2872,0,733.2340425531914,39,8,20,36.024181471649314,0.6159188034188036,44.94791666666666,1020.2083333333317,26.15918803418799,4
2911,4,1,0,48,0.020833333333333332,0.0,1.0,48,1500,1200,300,0.8,18,12,6,342.91832250836006,0.849715573286052,0.26684100418410095,0.19607052411363116,130398.95171305387,-656.5667318422134,129742.38498121165,2873,0,718.9375,38,10,22,35.90197873082289,0.6206140350877194,44.65811965811964,1021.3675213675181,26.878092667566264,0
2912,4,0,0,48,0.0,0.0,1.0,48,1150,800,350,0.6956521739130435,15,8,7,343.5044563727085,0.8505651595744681,0.2682421755530642,0.196927832411449,130501.95448133658,-634.3994140625223,129867.55506727405,2874,1,719.9375,39,9,16,35.78272080062527,0.6199252136752138,44.55729166666666,1021.7708333333316,26.19925213675209,0
2913,4,1,1,48,0.02040816326530612,0.02040816326530612,0.9795918367346939,49,1100,700,400,0.6363636363636364,15,7,8,336.19405925809247,0.8532100340136055,0.268589716945842,0.19420150952437987,130794.81336805511,-1005.5121527778199,129789.30121527729,2875,0,706.2244897959183,41,8,18,35.67337067209778,0.6196646341463417,44.270833333333314,1022.9166666666631,24.949186991869833,0
2914,4,1,1,48,0.02040816326530612,0.02040816326530612,0.9795918367346939,49,1050,700,350,0.6666666666666666,14,7,7,335.7423891010485,0.8514739229024944,0.27206267868271894,0.19445158582691255,130896.31287989713,-1010.5118378370124,129885.80104206012,2876,0,707.1632653061224,41,8,20,35.58238406850863,0.6206808943089432,44.17162698412697,1023.3134920634906,24.958865660085134,0
2915,4,0,0,48,0.0,0.0,1.0,48,800,400,400,0.5,12,4,8,343.25803549030405,0.843676122931442,0.27457816396754775,0.19860063543792394,130856.77059859657,-616.4723987440918,130240.29819985248,2877,1,722.8125,42,6,21,35.43008334122548,0.6187996031746033,44.210271317829445,1023.15891472868,24.360926541159046,0
2916,4,1,0,49,0.02040816326530612,0.0,1.0,49,1350,900,450,0.6666666666666666,18,9,9,336.38089585709974,0.8486394557823129,0.22525811755118252,0.1945058287532123,130833.79937743752,-987.2838030806702,129846.51557435685,2878,0,709.0408163265306,40,9,18,35.6292010198338,0.6216145833333333,44.23272357723578,1023.0691056910581,25.576727642276452,4
2917,4,1,0,50,0.02,0.0,1.0,50,1300,800,500,0.6153846153846154,18,8,10,320.53914692377293,0.8518877551020408,0.23403752605976313,0.18609745400364083,130989.8015091052,-1601.5960655033266,129388.20544360187,2879,0,695.84,40,10,16,35.877055825804945,0.6231770833333332,44.080284552845534,1023.6788617886192,25.59197154471548,1
2918,4,1,2,49,0.0196078431372549,0.0392156862745098,0.9607843137254902,51,1000,600,400,0.6,14,6,8,316.04794410370636,0.8512091503267974,0.2341588960358607,0.18523972179977255,131354.16795764756,-1896.7207019631128,129457.44725568444,2880,0,683.1764705882352,40,11,18,35.62506196093983,0.6268229166666668,43.72459349593496,1025.1016260162603,25.62754065040651,0
2919,4,0,0,49,0.0,0.0,1.0,49,1100,600,500,0.5454545454545454,16,6,10,325.2838427427255,0.8431122448979592,0.23392935620214095,0.18936367899008943,131093.85456945284,-1271.4574451384633,129822.39712431438,2881,1,711.9387755102041,40,9,18,35.65069795904865,0.6242187499999999,43.97865853658537,1024.0853658536596,25.60213414634149,0
2920,4,0,1,48,0.0,0.02040816326530612,0.9795918367346939,49,1200,800,400,0.6666666666666666,16,8,8,326.9112884770351,0.8436791383219955,0.234140199081319,0.19082760272941476,131197.94894118918,-1221.9818932183118,129975.96704797087,2882,2,712.9387755102041,40,9,18,35.50408358959099,0.6252604166666667,43.87703252032521,1024.4918699186999,25.6122967479675,0
2921,4,2,1,49,0.04,0.02,0.98,50,1300,1000,300,0.7692307692307693,16,10,6,320.1223712965717,0.8517176870748299,0.23482198142414923,0.18799913805235013,131429.8311917359,-1585.2741559586773,129844.55703577722,2883,0,699.5,41,9,19,35.44448206914346,0.6260162601626016,43.65079365079365,1025.396825396825,25.009678668215244,0
2922,4,3,4,48,0.057692307692307696,0.07692307692307693,0.9230769230769231,52,2150,1700,450,0.7906976744186046,26,17,9,310.1068091156647,0.8595556812468577,0.2277671383480515,0.1840781797952591,131838.20740250518,-2223.214836575977,129614.9925659292,2884,0,673.5384615384615,43,9,16,35.29093668357156,0.6271802325581395,43.252840909090914,1026.9886363636367,23.88345665961946,0
2923,4,0,0,48,0.0,0.0,1.0,48,1100,800,300,0.7272727272727273,14,8,6,333.5091773857316,0.839594414893617,0.2407000474206551,0.19547729688225016,131354.81906466992,-838.3924696180798,130516.42659505185,2885,5,730.6458333333334,39,9,19,35.176917149341186,0.6284722222222223,43.72395833333332,1025.104166666665,26.28472222222218,0
2924,4,0,0,48,0.0,0.0,1.0,48,1350,900,450,0.6666666666666666,18,9,9,337.9900493794811,0.8389110520094563,0.2616530325566022,0.1978310881016871,131302.08462431433,-720.1144102773342,130581.97021403699,2886,6,731.6458333333334,40,8,18,35.115270203272196,0.6263020833333333,43.775406504065046,1024.8983739837406,25.622459349593516,2
2925,4,0,0,48,0.0,0.0,1.0,48,900,600,300,0.6666666666666666,12,6,6,340.85409759167044,0.8383015661938534,0.26485676554246296,0.2002009389434607,131434.91753472213,-639.9713763715466,130794.94615835059,2887,7,732.6458333333334,39,9,18,34.9078965190302,0.6292735042735043,43.64583333333333,1025.4166666666658,26.29273504273502,0
2926,4,0,0,48,0.0,0.0,1.0,48,1300,1000,300,0.7692307692307693,16,10,6,338.873296007982,0.8387263593380615,0.2594466165668057,0.19945519102155373,131515.04041883658,-686.6129557291899,130828.4274631074,2888,8,733.6458333333334,39,9,18,34.877902745336975,0.6300747863247864,43.56770833333332,1025.729166666665,26.300747863247818,0
2927,4,0,0,48,0.0,0.0,1.0,48,1150,900,250,0.782608695652174,14,9,5,338.6405669174049,0.8389295212765957,0.25488484398216893,0.19956663882260384,131562.6045694528,-689.513000694026,130873.09156875875,2889,9,734.6458333333334,40,8,16,34.83593363051015,0.62890625,43.521341463414636,1025.914634146342,25.64786585365855,0
2928,4,0,1,47,0.0,0.020833333333333332,0.9791666666666666,48,1200,600,600,0.5,18,6,12,337.0210517422226,0.838670951536643,0.2572222497276959,0.1991559743443364,131666.88484243842,-725.0975981558545,130941.78724428256,2890,10,735.6458333333334,40,8,16,34.77241971152258,0.6299479166666667,43.41971544715447,1026.3211382113825,25.658028455284562,0
2929,4,0,0,47,0.0,0.0,1.0,47,1750,1200,550,0.6857142857142857,23,12,11,341.7660851864256,0.8367252543940795,0.2576520142563987,0.2015805951548679,131595.187717014,-405.0455729166614,131190.14214409734,2891,11,751.5106382978723,39,8,16,34.72292724196276,0.6308760683760684,43.489583333333336,1026.0416666666674,26.308760683760703,0
2930,4,0,1,46,0.0,0.02127659574468085,0.9787234042553191,47,1250,700,550,0.56,18,7,11,343.3721582633934,0.8369565217391304,0.2598548154739666,0.20266981012898053,131621.90890842007,-360.9402126736145,131260.96869574644,2892,12,752.5106382978723,39,8,16,34.6547939295503,0.6311431623931625,43.463541666666664,1026.1458333333328,26.31143162393161,0
2931,4,0,0,46,0.0,0.0,1.0,46,750,500,250,0.6666666666666666,10,5,5,348.3914988588371,0.8320048309178745,0.2594679902002963,0.20508318703517428,131519.83486969452,-35.92152001608599,131483.91334967842,2893,13,769.0869565217391,38,8,19,34.628988299829864,0.6318530701754387,43.56303418803418,1025.7478632478621,26.993364822312163,0
2932,4,0,0,46,0.0,0.0,1.0,46,1200,1000,200,0.8333333333333334,14,10,4,347.5747240421294,0.832145732689211,0.26204446979883955,0.20489625997400668,131574.63480029584,-53.59652366864782,131521.0382766272,2894,14,770.0869565217391,38,8,16,34.59465791940018,0.6324013157894737,43.50961538461538,1025.961538461538,26.998987854251002,0
2933,4,0,0,46,0.0,0.0,1.0,46,800,500,300,0.625,11,5,6,298.86228870953056,0.8328502415458937,0.14112583104551035,0.17063174235407835,130342.35161675335,-1395.5314560989939,128946.82016065436,2895,15,771.0869565217391,39,7,20,37.08399214526169,0.6183226495726496,44.713541666666664,1021.1458333333323,26.18322649572647,6
2934,4,1,0,47,0.02127659574468085,0.0,1.0,47,1200,700,500,0.5833333333333334,17,7,10,290.40124708244264,0.8350678384212149,0.1461336855356299,0.16763924173684108,130769.44464128232,-1804.8780391786406,128964.56660210367,2896,0,755.6595744680851,41,6,17,36.869948270287765,0.619410569105691,44.29563492063492,1022.8174603174593,24.946767324816083,0
2935,4,0,0,47,0.0,0.0,1.0,47,1150,800,350,0.6956521739130435,15,8,7,290.0424884946799,0.8347980265186555,0.15103020150151347,0.16776265753480818,130845.55820302642,-1809.8457380637597,129035.71246496266,2897,1,756.6595744680851,41,6,17,36.80255906784316,0.6201727642276423,44.22123015873015,1023.115079365078,24.954026325977512,0
2936,4,0,1,46,0.0,0.02127659574468085,0.9787234042553191,47,1550,1200,350,0.7741935483870968,19,12,7,293.15001408401434,0.8330635214307739,0.15329541845896277,0.17011933888182568,130972.4633487654,-1721.084104938272,129251.37924382713,2898,2,757.6595744680851,41,6,17,36.595431931252826,0.6214430894308942,44.09722222222222,1023.611111111111,24.96612466124661,0
2937,4,0,0,46,0.0,0.0,1.0,46,1500,1100,400,0.7333333333333333,19,11,8,301.32115375095253,0.8327898550724638,0.14538434644486498,0.17493994131027948,130989.80150910528,-1306.0003759336128,129683.80113317167,2899,3,772.1304347826087,40,6,18,36.368882160230335,0.6231770833333332,44.08028455284554,1023.6788617886199,25.5919715447155,0
2938,4,2,0,48,0.041666666666666664,0.0,1.0,48,750,200,550,0.26666666666666666,13,2,11,290.9338327143733,0.843214391252955,0.15099782293178543,0.1707439614482141,131404.40095308973,-1953.5664474928676,129450.83450559687,2900,0,740.9166666666666,41,7,20,36.218251088534124,0.6257621951219511,43.67559523809525,1025.2976190476204,25.007259001161472,0
2939,4,0,1,47,0.0,0.020833333333333332,0.9791666666666666,48,800,400,400,0.5,12,4,8,293.37680131687466,0.8426418439716312,0.15014951478221672,0.17263646834463106,131506.13667052472,-1883.8300540123378,129622.30661651239,2901,1,741.9166666666666,41,7,21,36.05351500789892,0.6267784552845528,43.57638888888889,1025.6944444444448,25.016937669376702,0
2940,4,0,0,47,0.0,0.0,1.0,47,1150,800,350,0.6956521739130435,15,8,7,295.75329564776,0.8416975023126734,0.150894165006902,0.174292441305554,131562.60456945281,-1617.9852229162495,129944.61934653656,2902,2,755.7021276595744,40,7,15,35.93590061086345,0.62890625,43.521341463414636,1025.9146341463422,25.647865853658555,0
2941,4,0,0,47,0.0,0.0,1.0,47,1300,900,400,0.6923076923076923,17,9,8,299.76590530340144,0.839577551649707,0.15109753528544334,0.17726204002133228,131692.96136558938,-1504.5880428316398,130188.37332275773,2903,3,756.7021276595744,40,7,15,35.70214521452144,0.6302083333333333,43.394308943089435,1026.422764227643,25.660569105691074,0
2942,4,1,1,47,0.020833333333333332,0.020833333333333332,0.9791666666666666,48,1550,1100,450,0.7096774193548387,20,11,9,297.50209955998247,0.8400930851063829,0.15722986010612594,0.17814033864466877,132168.3784190759,-1735.9259849773366,130432.45243409855,2904,0,741.9166666666666,41,7,17,35.28370718765073,0.6333841463414633,42.93154761904761,1028.2738095238087,25.079849012775824,0
2943,4,0,1,46,0.0,0.02127659574468085,0.9787234042553191,47,1350,800,550,0.5925925925925926,19,8,11,320.381201236439,0.8334489670058587,0.14579582244989386,0.18537919161198124,130859.79327781107,-993.7157995448104,129866.07747826626,2905,1,758.6170212765958,40,7,20,36.01220037081181,0.6218749999999998,44.20731707317074,1023.170731707319,25.579268292682976,4
2944,4,0,0,46,0.0,0.0,1.0,46,700,400,300,0.5714285714285714,10,4,6,327.59138595771543,0.8314412238325282,0.150048486297639,0.18910169422215245,130768.17626953141,-632.2943793402621,130135.88189019114,2906,2,775.304347826087,39,7,20,35.92026088875309,0.6225961538461537,44.29687500000001,1022.8125000000013,26.225961538461572,0
2945,4,0,0,46,0.0,0.0,1.0,46,1450,1400,50,0.9655172413793104,15,14,1,329.76134052418297,0.8302938808373591,0.15412142752811686,0.19088070995692713,130874.74093967034,-568.5139973958123,130306.22694227453,2907,3,776.304347826087,39,7,20,35.75717279174725,0.6236645299145298,44.19270833333334,1023.2291666666683,26.23664529914534,0
2946,4,0,0,46,0.0,0.0,1.0,46,1000,600,400,0.6,14,6,8,329.76134052418297,0.8302938808373591,0.15412142752811686,0.19088070995692713,130874.74093967034,-568.5139973958123,130306.22694227453,2908,4,777.304347826087,39,7,20,35.75717279174725,0.6236645299145298,44.19270833333334,1023.2291666666683,26.23664529914534,0
2947,4,0,0,46,0.0,0.0,1.0,46,1550,1000,550,0.6451612903225806,21,10,11,333.4486245713199,0.8313607085346216,0.16119962304387658,0.19354988976150972,130981.34901258672,-464.8898654513927,130516.45914713533,2909,5,778.304347826087,39,7,20,35.55520928733761,0.6247329059829061,44.088541666666664,1023.6458333333327,26.247329059829042,0
2948,4,0,0,46,0.0,0.0,1.0,46,1200,900,300,0.75,15,9,6,333.93414345795287,0.831400966183575,0.15889826759391967,0.19396600247664078,131008.00781250003,-450.39062499999875,130557.61718750003,2910,6,779.304347826087,39,7,20,35.515873015873005,0.625,44.0625,1023.7500000000002,26.250000000000007,0
2949,4,0,0,46,0.0,0.0,1.0,46,1550,1300,250,0.8387096774193549,18,13,5,332.8660309581863,0.8309983896940419,0.1483828812704051,0.19430355866181093,131197.94894118907,-465.7318932183259,130732.21704797074,2911,7,780.304347826087,40,6,21,35.35156895810602,0.6252604166666667,43.8770325203252,1024.491869918699,25.612296747967473,0
2950,4,0,0,46,0.0,0.0,1.0,46,650,400,250,0.6153846153846154,9,4,5,334.9037855909607,0.830817230273752,0.15217822465205333,0.19589151820761286,131276.04683059014,-407.0309918038281,130869.01583878632,2912,8,781.304347826087,40,6,21,35.220605249239725,0.6260416666666667,43.80081300813008,1024.796747967479,25.619918699186975,0
2951,4,4,3,47,0.08,0.06,0.94,50,1650,1300,350,0.7878787878787878,20,13,7,306.1283573474681,0.8473469387755102,0.1609047940580688,0.18355307580226732,132219.38898533946,-1904.7481445448789,130314.64084079459,2913,0,719.72,41,9,21,35.01083164528472,0.6338922764227642,42.88194444444444,1028.472222222222,25.08468834688346,0
2952,4,0,0,47,0.0,0.0,1.0,47,1300,900,400,0.6923076923076923,17,9,8,323.96447691997975,0.8357616404563675,0.17114439877335008,0.19324265594271572,132023.05230034707,-845.8441840277956,131177.20811631926,2914,1,762.7872340425532,39,8,21,34.74939185080072,0.6351495726495728,43.07291666666666,1027.7083333333321,26.351495726495695,0
2953,4,0,0,47,0.0,0.0,1.0,47,1350,1000,350,0.7407407407407407,17,10,7,322.6819406777571,0.8350678384212149,0.1726191352636175,0.19278959420883104,132084.419048268,-875.7486656421687,131208.67038262583,2915,2,763.7872340425532,40,7,21,34.72071181413742,0.6341145833333335,43.01321138211381,1027.947154471543,25.698678861788572,0
2954,4,0,0,47,0.0,0.0,1.0,47,800,600,200,0.75,10,6,4,325.1747801090475,0.8345282146160962,0.18310907408964816,0.19495075679523427,132215.03404058397,-801.4010757485971,131413.63296483536,2916,3,764.7872340425532,40,7,21,34.52548583662712,0.6354166666666669,42.8861788617886,1028.4552845528428,25.71138211382107,0
2955,4,1,2,46,0.020833333333333332,0.041666666666666664,0.9583333333333334,48,1000,600,400,0.6,14,6,8,301.7536892796687,0.8395390070921985,0.12884231772060462,0.18059269018311136,132148.80720997832,-1624.5954619683084,130524.21174801001,2917,0,749.8333333333334,42,6,16,35.1940203562341,0.6316964285714286,42.950581395348834,1028.1976744186043,24.480897009966768,4
2956,4,0,0,46,0.0,0.0,1.0,46,1300,700,600,0.5384615384615384,19,7,12,314.6275365192677,0.8343397745571659,0.13803464121597742,0.1842818428184282,131328.125,-935.8763746169102,130392.24862538309,2918,1,782.8913043478261,40,6,18,35.68766937669376,0.6265625,43.75,1025.0,25.625,1
2957,4,0,0,46,0.0,0.0,1.0,46,1300,900,400,0.6923076923076923,17,9,8,315.4743909482887,0.8339170692431562,0.14440270699882385,0.18566081794991718,131510.47992473075,-902.36228848568,130608.11763624508,2919,2,783.8913043478261,40,6,20,35.4825126325176,0.6283854166666667,43.57215447154472,1025.7113821138219,25.642784552845548,0
2958,4,0,0,46,0.0,0.0,1.0,46,1150,700,450,0.6086956521739131,16,7,9,315.57154329530016,0.8335547504025765,0.14599410873010377,0.186098732541434,131588.67076475636,-894.8720173177423,130693.79874743862,2920,3,784.8913043478261,40,6,14,35.401396592709986,0.6291666666666667,43.49593495934959,1026.0162601626012,25.650406504065028,0
2959,4,0,1,45,0.0,0.021739130434782608,0.9782608695652174,46,1350,1100,250,0.8148148148148148,16,11,5,313.9376531712575,0.8341988727858294,0.14229014205768387,0.18564228905326127,131692.96136558938,-931.3241539427529,130761.63721164662,2921,4,785.8913043478261,40,6,14,35.338490099009896,0.6302083333333333,43.394308943089435,1026.422764227643,25.660569105691074,0
2960,4,0,0,45,0.0,0.0,1.0,45,1050,600,450,0.5714285714285714,15,6,9,321.56138210517696,0.8306397306397307,0.14138133261153984,0.1899294206534894,131648.63281249997,-533.3767361111113,131115.25607638885,2922,5,804.1777777777778,39,6,15,35.187440790364064,0.6314102564102564,43.4375,1026.2499999999998,26.31410256410256,0
2961,4,0,0,45,0.0,0.0,1.0,45,1250,900,350,0.72,16,9,7,324.06572188949986,0.8288720538720539,0.14467663037352607,0.1922165996622558,131809.03320312515,-457.04210069443036,131351.9911024307,2923,6,805.1777777777778,39,6,15,34.96187529586799,0.6330128205128205,43.28125000000001,1026.8750000000011,26.330128205128233,0
2962,4,0,0,45,0.0,0.0,1.0,45,1500,1200,300,0.8,18,12,6,327.24699053929896,0.8293771043771044,0.14057853473911908,0.19492538132123455,131969.53124999997,-362.67361111111205,131606.85763888885,2924,7,806.1777777777778,39,6,17,34.71884293052177,0.6346153846153846,43.125,1027.4999999999998,26.34615384615384,0
2963,4,0,0,45,0.0,0.0,1.0,45,1150,800,350,0.6956521739130435,15,8,7,327.4893781263826,0.8273569023569024,0.14387031408307993,0.19589819164287248,132130.126953125,-345.75737847222257,131784.36957465278,2925,8,807.1777777777778,39,6,19,34.55124957784533,0.6362179487179487,42.96875,1028.125,26.362179487179485,0
2964,4,0,0,45,0.0,0.0,1.0,45,1400,1000,400,0.7142857142857143,18,10,8,329.2327974980197,0.8262626262626263,0.14516237931267328,0.19749967451369643,132237.24500868042,-292.6323784722322,131944.6126302082,2926,9,808.1777777777778,39,6,21,34.39884207683478,0.6372863247863249,42.86458333333333,1028.5416666666656,26.372863247863222,0
2965,4,0,0,45,0.0,0.0,1.0,45,1450,1200,250,0.8275862068965517,17,12,5,329.19905905294274,0.8245370370370371,0.14555353085419975,0.19804070068970547,132344.4064670137,-286.46918402779806,132057.9372829859,2927,10,809.1777777777778,39,6,22,34.292113788216255,0.638354700854701,42.76041666666666,1028.9583333333317,26.383547008546966,0
2966,4,0,0,45,0.0,0.0,1.0,45,900,700,200,0.7777777777777778,11,7,4,330.23524314209027,0.8250000000000001,0.14187220928793964,0.1988052386959603,132371.2036132811,-257.27267795140307,132113.9309353297,2928,11,810.1777777777778,39,6,22,34.23855737760233,0.6386217948717949,42.73437499999999,1029.0624999999989,26.38621794871792,0
2967,4,0,0,45,0.0,0.0,1.0,45,1100,700,400,0.6363636363636364,15,7,8,329.8442476514581,0.8234848484848485,0.14562068630310132,0.1994772354844535,132542.91453615797,-256.2882766370444,132286.62625952094,2929,12,811.1777777777778,36,9,23,34.07630686789152,0.6458333333333333,42.56756756756758,1029.7297297297314,28.60360360360365,0
2968,4,0,0,45,0.0,0.0,1.0,45,1350,1200,150,0.8888888888888888,15,12,3,328.06110677396975,0.8227693602693603,0.1471133825477946,0.1985277006972373,132567.32840874107,-301.9631040320208,132265.36530470906,2930,13,812.1777777777778,37,8,23,34.09772501419647,0.6441441441441442,42.5438596491228,1029.8245614035081,27.83309625414887,0
2969,4,0,0,45,0.0,0.0,1.0,45,1550,1200,350,0.7741935483870968,19,12,7,331.0457220461748,0.8202441077441078,0.15408037825059107,0.20154338000220484,132793.26331178827,-207.87165281624567,132585.39165897202,2931,14,813.1777777777778,37,8,16,33.794326241134755,0.6463963963963963,42.324561403508774,1030.7017543859652,27.85680417259365,0
2970,4,0,0,45,0.0,0.0,1.0,45,550,400,150,0.7272727272727273,7,4,3,331.077571811359,0.8194444444444445,0.15691445992413766,0.20201962412344,132878.03849501783,-201.41233360263482,132676.6261614152,2932,15,814.1777777777778,37,8,16,33.70854603140842,0.6472409909909909,42.242324561403514,1031.0307017543869,27.865694642010457,0
2971,4,0,1,44,0.0,0.022222222222222223,0.9777777777777777,45,1250,800,450,0.64,17,8,9,331.6828229627453,0.8191498316498317,0.15669430859734912,0.20284841565588968,132962.84072983998,-179.7019275161561,132783.13880232384,2933,16,815.1777777777778,37,8,16,33.60798072152525,0.6480855855855856,42.16008771929825,1031.3596491228072,27.874585111427223,0
2972,4,0,0,44,0.0,0.0,1.0,44,850,800,50,0.9411764705882353,9,8,1,330.08327284767813,0.8164200140944328,0.14131294303708097,0.20238820100889066,133058.5475221894,-15.91983070348104,133042.62769148592,2934,17,786.3181818181819,38,6,16,33.553380967174085,0.647203947368421,42.06730769230769,1031.7307692307695,27.1508097165992,0
2973,4,1,1,44,0.022222222222222223,0.022222222222222223,0.9777777777777777,45,1400,1200,200,0.8571428571428571,16,12,4,323.7469972232674,0.8202861952861953,0.13724132522156118,0.2002868977831035,133391.50526258702,-362.9801432291407,133028.5251193579,2935,0,769.8222222222222,39,6,18,33.38385684514807,0.6487713675213674,41.74479166666668,1033.020833333335,26.48771367521372,0
2974,4,0,0,44,0.0,0.0,1.0,44,1100,700,400,0.6363636363636364,15,7,8,330.3324591615283,0.8160896758280479,0.14121478624841277,0.203743664186099,133279.0941289539,5.282183687630436,133284.37631264154,2936,19,788.3181818181819,38,6,18,33.326220037937574,0.6493969298245614,41.85363247863248,1032.58547008547,27.173301844354473,0
2975,4,0,0,44,0.0,0.0,1.0,44,1450,1100,350,0.7586206896551724,18,11,7,331.3789468145776,0.8148343904157858,0.14315761273159655,0.20530210087404108,133444.62393390678,44.14778745708361,133488.77172136385,2937,20,789.3181818181819,38,6,18,33.133638369006995,0.6510416666666666,41.69337606837607,1033.2264957264958,27.190170940170944,0
2976,4,0,0,44,0.0,0.0,1.0,44,1300,900,400,0.6923076923076923,17,9,8,331.0845419406952,0.8135791050035236,0.14597577557692132,0.20574383499505156,133557.21381819394,43.74864554299995,133600.96246373694,2938,21,790.3181818181819,37,7,18,33.02868975637353,0.6539977477477478,41.5844298245614,1033.6622807017536,27.93681839734469,0
2977,4,0,0,44,0.0,0.0,1.0,44,850,700,150,0.8235294117647058,10,7,3,331.5682816695821,0.8123017970401691,0.14852613720708252,0.2066768317531941,133670.57802641185,64.18477319942707,133734.7627996113,2939,22,791.3181818181819,37,7,18,32.902904428657244,0.6551238738738739,41.474780701754376,1034.1008771929814,27.948672356567066,0
2978,4,0,0,44,0.0,0.0,1.0,44,950,600,350,0.631578947368421,13,6,7,331.2703611871453,0.811531007751938,0.1459552056127904,0.2068082936517763,133727.27816491603,59.97674765310853,133787.25491256913,2940,23,792.3181818181819,37,7,16,32.85396568783348,0.6556869369369369,41.41995614035087,1034.3201754385957,27.954599336178262,0
2979,4,0,0,44,0.0,0.0,1.0,44,1150,600,550,0.5217391304347826,17,6,11,331.34594829098705,0.8116190979563073,0.13816004931707404,0.20765226161821584,133869.08111149567,71.39552554630274,133940.47663704198,2941,24,793.3181818181819,37,7,16,32.7104082785901,0.6570945945945947,41.282894736842096,1034.86842105263,27.969416785206217,0
2980,4,0,0,44,0.0,0.0,1.0,44,750,300,450,0.4,12,3,9,330.60183855214046,0.8108483086680761,0.13778890600924543,0.20750540930400282,133925.8233302553,55.22468451829752,133981.0480147736,2942,25,794.3181818181819,37,7,16,32.67302259887006,0.6576576576576577,41.22807017543859,1035.0877192982443,27.975343764817413,0
2981,4,0,0,44,0.0,0.0,1.0,44,1300,1100,200,0.8461538461538461,15,11,4,331.40000042139786,0.8092847075405215,0.13923642523049695,0.20897225660751137,134096.12212411492,87.89098568788626,134184.0131098028,2943,26,795.3181818181819,37,7,18,32.48244406803585,0.6593468468468469,41.06359649122806,1035.7456140350862,27.993124703650977,0
2982,4,0,0,44,0.0,0.0,1.0,44,900,700,200,0.7777777777777778,11,7,4,328.2381908945658,0.8093727977448908,0.13582659170894518,0.20725897196485432,134145.81298828125,6.355794270833712,134152.1687825521,2944,27,796.3181818181819,39,5,18,32.514768728004,0.65625,41.015625,1035.9375,26.5625,0
2983,4,0,0,44,0.0,0.0,1.0,44,800,600,200,0.75,10,6,4,328.38134290339747,0.8097031360112755,0.13589291263733205,0.2075019591179919,134172.79188368062,11.96831597222706,134184.76019965284,2945,28,797.3181818181819,39,5,19,32.48416448823647,0.656517094017094,40.989583333333336,1036.0416666666672,26.565170940170955,0
2984,4,0,0,44,0.0,0.0,1.0,44,1400,1000,400,0.7142857142857143,18,10,8,331.45627635665807,0.8089103241719521,0.13688899040657865,0.2100630541241237,134280.7345920137,101.63845486109216,134382.3730468748,2946,29,798.3181818181819,39,5,19,32.29690117252931,0.6575854700854702,40.88541666666666,1036.4583333333317,26.57585470085466,0
2985,4,0,0,44,0.0,0.0,1.0,44,1200,900,300,0.75,15,9,6,333.5883624032011,0.8092626849894292,0.13957907044723772,0.21172649123958262,134334.72222222213,162.49999999999153,134497.22222222213,2947,30,799.3181818181819,39,5,19,32.18783494105038,0.6581196581196582,40.83333333333333,1036.6666666666658,26.58119658119656,0
2986,4,0,1,43,0.0,0.022727272727272728,0.9772727272727273,44,1200,900,300,0.75,15,9,6,331.7426128318999,0.8073026779422129,0.15154177582634265,0.21164796163951893,134523.7643771701,125.45301649304986,134649.21739366316,2948,31,800.3181818181819,39,5,20,32.0473315593935,0.6599893162393162,40.651041666666664,1037.395833333333,26.599893162393155,0
2987,4,0,0,43,0.0,0.0,1.0,43,900,600,300,0.6666666666666666,12,6,6,346.9801407327015,0.8056478405315615,0.1571793752727726,0.21936202117508055,134190.7793209875,712.3098114390272,134903.0891324265,2949,32,778.8837209302326,38,5,17,31.984472743520996,0.6584429824561404,40.972222222222214,1036.11111111111,27.266081871344998,3
2988,4,0,0,43,0.0,0.0,1.0,43,1300,900,400,0.6923076923076923,17,9,8,345.17589541927975,0.8056939830195644,0.15953967873411679,0.21855131759575777,134246.132843889,667.705822192976,134913.83866608198,2950,33,779.8837209302326,38,5,18,31.97594501718212,0.6589912280701755,40.91880341880341,1036.3247863247843,27.271704903283798,0
2989,4,0,0,43,0.0,0.0,1.0,43,1200,700,500,0.5833333333333334,17,7,10,349.5663017278654,0.8054632705795496,0.16160454333057772,0.2221703312553329,134384.566588593,795.2631903353015,135179.8297789283,2951,34,780.8837209302326,38,5,19,31.72398248325606,0.6603618421052632,40.78525641025641,1036.8589743589741,27.2857624831309,0
2990,4,0,0,43,0.0,0.0,1.0,43,1500,1000,500,0.6666666666666666,20,10,10,353.4946241860452,0.8054632705795496,0.13753143107029597,0.21427536961098476,132629.89921932088,788.348228736116,133418.247448057,2952,35,781.8837209302326,36,7,17,33.38002441601983,0.6467013888888888,42.48310810810812,1030.0675675675693,28.612987987988035,3
2991,4,0,0,43,0.0,0.0,1.0,43,950,700,250,0.7368421052631579,12,7,5,347.8394754366298,0.8052325581395349,0.1415776756381819,0.2118279919275766,132803.95418645014,638.8915520250205,133442.84573847515,2953,36,782.8837209302326,36,7,17,33.350859463199676,0.6484375,42.3141891891892,1030.7432432432447,28.631756756756797,0
2992,4,0,0,43,0.0,0.0,1.0,43,1000,700,300,0.7,13,7,6,347.6710943614884,0.8039405684754521,0.14021559125036842,0.21221843599825266,132891.02447041642,640.473581689806,133531.49805210624,2954,37,783.8837209302326,36,7,17,33.26780253385759,0.6493055555555556,42.22972972972973,1031.0810810810815,28.64114114114115,0
2993,4,1,1,43,0.022727272727272728,0.022727272727272728,0.9772727272727273,44,850,600,250,0.7058823529411765,11,6,5,339.7343351767685,0.8083377378435518,0.13614951670133335,0.20861372812920592,133113.66705246922,244.6566358024771,133358.3236882717,2955,0,767.0454545454545,38,6,17,33.24921489457155,0.6477521929824561,42.01388888888889,1031.9444444444453,27.156432748538034,0
2994,4,0,0,43,0.0,0.0,1.0,43,1150,900,250,0.782608695652174,14,9,5,344.4859525671171,0.804032853451458,0.14176973604515175,0.2108379541834011,132991.1141529126,562.7141283856764,133553.82828129828,2956,39,785.8837209302326,37,6,17,33.24950834484958,0.648367117117117,42.1326754385965,1031.4692982456154,27.87754860123285,0
2995,4,0,0,43,0.0,0.0,1.0,43,1400,900,500,0.6428571428571429,19,9,10,344.3894990598038,0.804078995939461,0.14547485150080575,0.211579240545096,133132.5263542628,569.8888119421365,133702.41516620494,2957,40,786.8837209302326,37,6,17,33.11021391131889,0.6497747747747746,41.99561403508772,1032.0175438596489,27.89236605026078,0
2996,4,0,0,43,0.0,0.0,1.0,43,800,500,300,0.625,11,5,6,345.7231541883139,0.804125138427464,0.15071071783242207,0.21272142310645675,133189.11227493075,609.3119998461115,133798.42427477686,2958,41,787.8837209302326,37,6,17,33.019085050633805,0.6503378378378377,41.94078947368421,1032.2368421052633,27.898293029871983,0
2997,4,0,0,43,0.0,0.0,1.0,43,600,300,300,0.5,9,3,6,345.7231541883139,0.804125138427464,0.15071071783242207,0.21272142310645675,133189.11227493075,609.3119998461115,133798.42427477686,2959,42,788.8837209302326,37,6,17,33.019085050633805,0.6503378378378377,41.94078947368421,1032.2368421052633,27.898293029871983,0
2998,4,0,0,43,0.0,0.0,1.0,43,1200,900,300,0.75,15,9,6,344.42152145887565,0.8043558508674787,0.15295236448517313,0.21208166282114563,133217.40974386354,576.588589758394,133793.99833362194,2960,43,789.8837209302326,37,6,17,33.02431846344487,0.6506193693693694,41.91337719298246,1032.3464912280706,27.901256519677585,0
2999,4,0,0,43,0.0,0.0,1.0,43,1150,800,350,0.6956521739130435,15,8,7,341.0790182976583,0.8028331487633813,0.14675826225050792,0.21037196629526936,133279.09412895402,491.74051702097756,133770.834645975,2961,44,790.8837209302326,38,5,17,33.048801517503016,0.6493969298245613,41.853632478632484,1032.5854700854711,27.1733018443545,0
3000,4,0,0,43,0.0,0.0,1.0,43,1150,600,550,0.5217391304347826,17,6,11,339.85002881765575,0.8018641565153193,0.15021394194344428,0.21023735947779373,133389.43591798167,466.48072813939075,133855.91664612107,2962,45,791.8837209302326,38,5,17,32.97005895128763,0.6504934210526315,41.746794871794876,1033.012820512821,27.184547908232133,0
3001,4,0,0,43,0.0,0.0,1.0,43,1000,600,400,0.6,14,6,8,341.473592353241,0.8023255813953488,0.14709121954738902,0.21139882445940097,133417.0284991601,511.6784005405985,133928.70689970072,2963,46,792.8837209302326,38,5,17,32.900508445363684,0.650767543859649,41.72008547008548,1033.1196581196596,27.187359424201567,0
3002,4,1,1,43,0.022727272727272728,0.022727272727272728,0.9772727272727273,44,1100,700,400,0.6363636363636364,15,7,8,335.86345686622184,0.8075669485553206,0.14126882003212216,0.20932533155236074,133665.49014034998,178.68213072540934,133844.1722710754,2964,0,775.8409090909091,38,6,18,32.79694872059786,0.6532346491228069,41.47970085470086,1034.0811965811972,27.212663067926243,0
3003,4,1,1,43,0.022727272727272728,0.022727272727272728,0.9772727272727273,44,950,600,350,0.631578947368421,13,6,7,333.6279603389434,0.807588971106413,0.1389222737601168,0.2083990910968809,133748.36205164745,124.4386459931429,133872.8006976406,2965,0,776.8181818181819,38,6,16,32.77193933760242,0.6540570175438596,41.399572649572654,1034.4017094017104,27.221097615834484,0
3004,4,0,0,43,0.0,0.0,1.0,43,1150,800,350,0.6956521739130435,15,8,7,340.01047021162043,0.8018180140273163,0.14846140757965443,0.21193911067850565,133670.57802641185,489.87921764387113,134160.45724405572,2966,49,795.8837209302326,37,6,18,32.68465256423848,0.6551238738738739,41.474780701754376,1034.1008771929814,27.948672356567066,0
3005,4,0,0,43,0.0,0.0,1.0,43,1400,1000,400,0.7142857142857143,18,10,8,339.86407595171664,0.8015411590992986,0.1443280667495117,0.2120104473794041,133698.92659279777,487.89242843951763,134186.8190212373,2967,50,796.8837209302326,37,6,19,32.66009329940627,0.6554054054054055,41.44736842105263,1034.2105263157891,27.951635846372678,0
3006,4,0,0,43,0.0,0.0,1.0,43,950,600,350,0.631578947368421,13,6,7,339.86407595171664,0.8008028792912514,0.1443280667495117,0.2120104473794041,133698.92659279777,487.89242843951763,134186.8190212373,2968,51,797.8837209302326,37,6,19,32.66009329940627,0.6554054054054055,41.44736842105263,1034.2105263157891,27.951635846372678,0
3007,4,0,0,43,0.0,0.0,1.0,43,600,500,100,0.8333333333333334,7,5,2,340.02149535676136,0.8008490217792543,0.14279833869437142,0.21259793298151383,133783.99032635035,497.88648911202426,134281.87681546237,2969,52,798.8837209302326,37,6,17,32.57099010775481,0.65625,41.36513157894736,1034.53947368421,27.96052631578946,0
3008,4,0,0,43,0.0,0.0,1.0,43,1150,800,350,0.6956521739130435,15,8,7,323.91815748145905,0.8008490217792543,0.11247677167518821,0.1893551418113007,131253.64428407242,-96.91227615528456,131156.73200791713,2970,53,799.8837209302326,42,1,19,35.52462568951929,0.6227678571428572,43.82267441860465,1024.7093023255811,24.397840531561457,7
3009,4,0,0,43,0.0,0.0,1.0,43,800,500,300,0.625,11,5,6,326.6560581425381,0.7999723145071982,0.11986517476490244,0.19120316142632116,131303.29574732587,-21.796598010934588,131281.49914931494,2971,54,800.8837209302326,42,1,20,35.40445463426933,0.6232638888888888,43.77422480620155,1024.9031007751937,24.402454780361754,0
3010,4,1,2,42,0.022727272727272728,0.045454545454545456,0.9545454545454546,44,1400,1000,400,0.7142857142857143,18,10,8,320.68561706744015,0.8058491895701199,0.11943794940313968,0.1890838455935843,131582.46429358792,-360.6745538213755,131221.78973976654,2972,0,783.6590909090909,41,3,13,35.276461677302905,0.627540650406504,43.501984126984134,1025.9920634920645,25.02419667053816,0
3011,4,1,0,43,0.023255813953488372,0.0,1.0,43,900,800,100,0.8888888888888888,10,8,2,318.9219971398277,0.8026024363233665,0.11542939862164436,0.18854668470906638,131684.26890432116,-200.59799382714323,131483.67091049402,2973,0,792.2325581395348,41,2,15,35.21932792061346,0.6285569105691056,43.402777777777786,1026.3888888888903,25.033875338753422,0
3012,4,0,0,43,0.0,0.0,1.0,43,1050,800,250,0.7619047619047619,13,8,5,319.66729678638933,0.8014488741232927,0.11952814290529146,0.18949350067234424,131786.1128826531,-174.45790816326004,131611.65497448985,2974,1,793.2325581395348,41,2,17,35.097826086956516,0.6295731707317073,43.30357142857143,1026.7857142857147,25.04355400696865,0
3013,4,0,0,43,0.0,0.0,1.0,43,1400,1200,200,0.8571428571428571,16,12,4,319.8376610969837,0.7996493170911775,0.11363171969974206,0.1904864091996241,131964.43457301919,-158.560779635915,131805.87379338327,2975,2,794.2325581395348,41,2,18,34.91428904766503,0.63135162601626,43.12996031746032,1027.48015873016,25.060491676345364,0
3014,4,0,0,43,0.0,0.0,1.0,43,800,500,300,0.625,11,5,6,334.4027393964843,0.799234034699151,0.0888759773402319,0.18728973691409845,129591.85157933203,143.89410313280445,129735.74568246483,2976,3,795.2325581395348,37,6,13,36.937325005384444,0.6143018018018018,45.44956140350877,1018.2017543859643,27.518966334755792,7
3015,4,3,0,46,0.06521739130434782,0.0,1.0,46,1300,1000,300,0.7692307692307693,16,10,6,314.87659971425234,0.8144927536231884,0.1050236815496779,0.17989802934723376,130368.94531250001,-988.2426563942746,129380.70265610574,2977,0,744.304347826087,39,7,18,36.64830681354548,0.6185897435897436,44.6875,1021.2500000000001,26.185897435897438,0
3016,4,0,0,46,0.0,0.0,1.0,46,800,600,200,0.75,10,6,4,314.9124839133942,0.8133856682769727,0.1006171908946607,0.18016521687600584,130422.14084201372,-985.6879340277959,129436.45290798592,2978,1,745.304347826087,39,7,18,36.59366714256577,0.6191239316239316,44.63541666666666,1021.4583333333319,26.19123931623928,0
3017,4,0,0,46,0.0,0.0,1.0,46,900,500,400,0.5555555555555556,13,5,8,314.5848973076782,0.8138888888888889,0.1022273353992933,0.1801012310505779,130448.74267578126,-992.559136284722,129456.18353949655,2979,2,746.304347826087,39,7,18,36.57517164610312,0.6193910256410258,44.609375,1021.5625000000001,26.19391025641026,0
3018,4,0,0,46,0.0,0.0,1.0,46,850,400,450,0.47058823529411764,13,4,9,315.9121694445259,0.8140901771336554,0.10507837435279144,0.18098519613971426,130475.34722222213,-956.2500000000095,129519.09722222212,2980,3,747.304347826087,39,7,18,36.51441000543774,0.6196581196581197,44.58333333333333,1021.6666666666658,26.196581196581175,0
3019,4,1,4,43,0.02127659574468085,0.0851063829787234,0.9148936170212766,47,800,500,300,0.625,11,5,6,309.0592864279298,0.8205750847980264,0.10481202467011008,0.1782271403624215,130729.8495955614,-1319.3451938330468,129410.50440172837,2981,0,732.3829787234042,40,7,13,36.43276524561927,0.6205729166666667,44.33434959349593,1022.6626016260154,25.566565040650385,0
3020,4,1,1,43,0.022727272727272728,0.022727272727272728,0.9772727272727273,44,1050,800,250,0.7619047619047619,13,8,5,326.36401499375285,0.8006738900634249,0.08988868274582584,0.18595158993830088,130262.58680555537,-297.39583333335275,129965.19097222202,2982,0,783.0227272727273,37,7,17,36.4625850340136,0.6210585585585586,44.79166666666666,1020.8333333333319,27.59009009009005,0
3021,4,2,1,44,0.044444444444444446,0.022222222222222223,0.9777777777777777,45,850,400,450,0.47058823529411764,13,4,9,320.3641895085068,0.813510101010101,0.10688405797101486,0.18420940896739113,130617.28395061698,-630.9799382716375,129986.30401234534,2983,0,766.5777777777778,38,7,14,36.25735960144928,0.6228070175438598,44.44444444444443,1022.2222222222198,26.900584795321574,0
3022,4,3,3,44,0.06382978723404255,0.06382978723404255,0.9361702127659575,47,800,400,400,0.5,12,4,8,306.91820312772944,0.8253546099290779,0.10184813771729484,0.17879315902434975,131119.8742894438,-1351.3847577500462,129768.48953169376,2984,0,734.8936170212766,40,7,15,36.09471125223259,0.6244791666666669,43.95325203252031,1024.1869918699163,25.604674796747908,0
3023,4,0,0,44,0.0,0.0,1.0,44,950,500,450,0.5263157894736842,14,5,9,321.87494111217916,0.811046511627907,0.08452950558213757,0.18612768333878177,130835.79881656794,-377.4469921104635,130458.35182445748,2985,1,726.8409090909091,38,6,16,35.99819862155389,0.625,44.230769230769226,1023.0769230769222,26.9230769230769,0
3024,4,0,0,44,0.0,0.0,1.0,44,650,400,250,0.6153846153846154,9,4,5,325.07071534730096,0.8125,0.09398842285063624,0.1885095310549116,130945.12473518866,-286.714926218144,130658.40980897051,2986,2,727.8409090909091,38,6,16,35.80614996520531,0.6260964912280702,44.12393162393162,1023.5042735042721,26.934322986954527,0
3025,4,0,0,44,0.0,0.0,1.0,44,1050,800,250,0.7619047619047619,13,8,5,323.28837438902883,0.8115530303030304,0.09102469249976908,0.18804288285468335,131061.33355034702,-325.87890625002046,130735.454644097,2987,3,728.8409090909091,39,5,16,35.73457104103085,0.6255341880341881,44.01041666666666,1023.9583333333317,26.255341880341838,0
3026,4,0,0,44,0.0,0.0,1.0,44,800,500,300,0.625,11,5,6,322.53328884396296,0.8119053911205074,0.09244581041734068,0.18825607690091242,131194.6953667534,-337.0686848958438,130857.62668185757,2988,4,729.8409090909091,39,5,17,35.619492458905256,0.6268696581196582,43.88020833333333,1024.479166666666,26.268696581196565,0
3027,4,0,0,44,0.0,0.0,1.0,44,1200,900,300,0.75,15,9,6,322.6707635237272,0.8109804439746301,0.08812339980527195,0.18873619369914518,131276.04683059017,-328.2115473593836,130947.83528323079,2989,5,730.8409090909091,40,4,18,35.5340142800476,0.6260416666666667,43.80081300813008,1024.7967479674792,25.61991869918698,0
3028,4,0,0,44,0.0,0.0,1.0,44,1400,1200,200,0.8571428571428571,16,12,4,321.4418550583254,0.8116190979563073,0.0684943507372926,0.18894797101683183,131465.0463533676,-348.3056692745984,131116.740684093,2990,6,731.8409090909091,38,6,18,35.375212695766926,0.6313048245614036,43.61645299145299,1025.5341880341875,26.987741790373356,0
3029,4,0,0,44,0.0,0.0,1.0,44,1600,1200,400,0.75,20,12,8,322.174585983898,0.8111346018322763,0.05966175342932534,0.18992280842255202,131574.63480029584,-321.9993014464256,131252.6354988494,2991,7,732.8409090909091,38,6,16,35.24614703738413,0.6324013157894738,43.50961538461538,1025.961538461538,26.998987854251002,0
3030,4,0,0,44,0.0,0.0,1.0,44,600,300,300,0.5,9,3,6,322.4183280567708,0.8109363988724454,0.058469955700276355,0.19020304807476812,131602.0390459492,-313.8181203886464,131288.22092556057,2992,8,733.8409090909091,38,6,17,35.21232472580867,0.6326754385964912,43.482905982905976,1026.0683760683753,27.001799370220404,0
3031,4,0,0,44,0.0,0.0,1.0,44,700,300,400,0.42857142857142855,11,3,8,325.6122517247285,0.8110244890768147,0.07160226326546049,0.19264054892679736,131711.68456424854,-222.61236211558293,131489.07220213296,2993,9,734.8409090909091,38,6,17,35.02007875381624,0.6337719298245614,43.37606837606837,1026.4957264957254,27.013045434098036,0
3032,4,0,0,44,0.0,0.0,1.0,44,1550,1200,350,0.7741935483870968,19,12,7,324.7646976289352,0.8100995419309374,0.0733157899587995,0.19331045339252778,131942.7747938367,-229.9289279513929,131712.8458658853,2994,10,735.8409090909091,39,5,17,34.80949423772349,0.6343482905982907,43.151041666666664,1027.3958333333326,26.343482905982885,0
3033,4,0,0,44,0.0,0.0,1.0,44,950,600,350,0.631578947368421,13,6,7,322.97822239045166,0.8106501057082452,0.0686793947994031,0.19265436167498176,132023.05230034728,-271.8858506944345,131751.16644965284,2995,11,736.8409090909091,39,5,17,34.774731400770335,0.6351495726495726,43.07291666666667,1027.708333333334,26.35149572649574,0
3034,4,0,0,44,0.0,0.0,1.0,44,950,600,350,0.631578947368421,13,6,7,323.93709654919576,0.8099233615221988,0.06405461178464811,0.19349947147381766,132076.58420138908,-243.09895833331245,131833.48524305577,2996,12,737.8409090909091,39,5,17,34.696324820970126,0.6356837606837606,43.02083333333334,1027.9166666666683,26.35683760683765,0
3035,4,0,0,44,0.0,0.0,1.0,44,1050,800,250,0.7619047619047619,13,8,5,324.54212456467167,0.8097471811134602,0.06585223244293448,0.1945479293155437,132210.46142578137,-218.42719184026242,131992.0342339411,2997,13,738.8409090909091,39,5,17,34.54634271920053,0.6370192307692307,42.89062500000001,1028.437500000001,26.37019230769233,0
3036,4,0,0,44,0.0,0.0,1.0,44,800,400,400,0.5,12,4,8,327.9400351500858,0.8094829105003524,0.06395798249730844,0.1974234983088178,132371.20361328137,-118.03656684026305,132253.1670464411,2998,14,739.8409090909091,39,5,18,34.29760518945913,0.6386217948717948,42.73437500000001,1029.062500000001,26.386217948717974,0
3037,4,0,0,44,0.0,0.0,1.0,44,950,500,450,0.5263157894736842,14,5,9,329.46536831233817,0.8085139182522904,0.06478289499167156,0.1987802620640253,132454.43309479853,-72.16485781681894,132382.2682369817,2999,15,740.8409090909091,37,7,18,34.17483312029542,0.6430180180180181,42.65350877192983,1029.3859649122817,27.82124229492653,0
3038,4,0,0,44,0.0,0.0,1.0,44,1000,800,200,0.8,12,8,4,328.71784830431983,0.8075449260042283,0.06262405716554165,0.19847793425911625,132482.65241468523,-90.11751211911724,132392.5349025661,3000,16,741.8409090909091,37,7,18,34.16575691411935,0.6432995495495495,42.62609649122807,1029.4956140350873,27.82420578473209,0
3039,4,1,0,45,0.022222222222222223,0.0,1.0,45,1400,1000,400,0.7142857142857143,18,10,8,323.6238538597697,0.8105639730639731,0.05218330296281315,0.19468674959968396,132344.4064670141,-434.0386284721966,131910.36783854192,3001,0,726.3333333333334,39,6,19,34.435530134305196,0.6383547008547008,42.76041666666668,1028.958333333335,26.383547008547055,1
3040,4,0,0,45,0.0,0.0,1.0,45,1250,1000,250,0.8,15,10,5,323.0486741270766,0.8099747474747475,0.0484960359720743,0.19520122587215227,132510.87474030457,-438.48582015621685,132072.38892014834,3002,1,727.3333333333334,37,8,21,34.283368832090886,0.6435810810810811,42.59868421052631,1029.6052631578937,27.827169274537667,0
3041,4,2,1,46,0.0425531914893617,0.02127659574468085,0.9787234042553191,47,1400,1200,200,0.8571428571428571,16,12,4,309.0821664979345,0.8179925994449583,0.058771091325034996,0.18956401604718515,133068.88156467007,-1174.1563585069478,131894.72520616313,3003,0,697.3404255319149,39,8,14,34.084742554265524,0.6455662393162394,42.057291666666664,1031.7708333333328,26.45566239316238,0
3042,4,0,0,46,0.0,0.0,1.0,46,1400,900,500,0.6428571428571429,19,9,10,315.269667832912,0.8143921095008052,0.05459259161694474,0.19308073720156635,133015.14892578128,-812.8716362847205,132202.27728949656,3004,1,713.4565217391304,39,7,14,33.97886583190277,0.6450320512820513,42.109375,1031.5625000000002,26.450320512820518,0
3043,4,0,0,46,0.0,0.0,1.0,46,1150,800,350,0.6956521739130435,15,8,7,324.95463363382294,0.8161835748792271,0.060607667643003404,0.2006585449171078,133322.0706763414,-534.4911109397683,132787.57956540163,3005,2,714.4565217391304,42,4,18,33.42207731281667,0.6433531746031746,41.81201550387596,1032.7519379844948,24.589331856773686,3
3044,4,0,0,46,0.0,0.0,1.0,46,1300,800,500,0.6153846153846154,18,8,10,329.0842872008327,0.8146537842190016,0.06065918653576419,0.20403225806451605,133472.22222222204,-414.93975722614715,133057.2824649959,3006,3,715.4565217391304,38,8,18,33.16532258064516,0.6513157894736843,41.66666666666666,1033.333333333332,27.192982456140314,0
3045,4,0,0,46,0.0,0.0,1.0,46,1100,700,400,0.6363636363636364,15,7,8,328.4863174057323,0.8136674718196457,0.06440696528310186,0.2044029279154789,133606.80474175324,-422.39854600696805,133184.40619574627,3007,4,716.4565217391304,39,7,19,33.04628463476071,0.6509081196581198,41.53645833333332,1033.8541666666647,26.509081196581146,0
3046,4,0,0,46,0.0,0.0,1.0,46,1350,1000,350,0.7407407407407407,17,10,7,325.9269344438886,0.813244766505636,0.06628533836834793,0.20351437661165,133734.88519565063,-482.4397679952522,133252.4454276554,3008,5,717.4565217391304,40,6,12,32.98454182223096,0.6505208333333334,41.412601626016254,1034.349593495934,25.85873983739835,0
3047,4,0,0,46,0.0,0.0,1.0,46,600,400,200,0.6666666666666666,8,4,4,325.27522549237335,0.8132850241545894,0.06709252211501071,0.2032520884153999,133761.16569378323,-498.16133336640513,133263.00436041682,3009,6,718.4565217391304,40,6,12,32.975161279758986,0.6507812500000001,41.38719512195121,1034.4512195121933,25.861280487804834,0
3048,4,0,0,46,0.0,0.0,1.0,46,900,600,300,0.6666666666666666,12,6,6,327.16444427776685,0.8127012882447665,0.07371491037038913,0.20487013355696293,133840.02267995218,-442.46067155796044,133397.56200839422,3010,7,719.4565217391304,40,6,12,32.847590519216894,0.6515625000000002,41.310975609756085,1034.7560975609738,25.868902439024346,0
3049,4,0,1,45,0.0,0.021739130434782608,0.9782608695652174,46,1500,1100,400,0.7333333333333333,19,11,8,327.80237232991885,0.8118558776167472,0.07609975930762491,0.20615126970970435,133997.80636525864,-415.0402372926351,133582.766127966,3011,8,720.4565217391304,40,6,13,32.673652008899346,0.6531250000000002,41.158536585365844,1035.3658536585353,25.884146341463385,0
3050,4,0,0,45,0.0,0.0,1.0,45,1200,900,300,0.75,15,9,6,335.4938484022848,0.806523569023569,0.08137715179968663,0.21106385146320966,134010.95920138896,-8.029513888884026,134002.9296875001,3012,9,736.8666666666667,39,6,15,32.46143527833668,0.65491452991453,41.145833333333336,1035.4166666666672,26.549145299145312,0
3051,4,0,0,45,0.0,0.0,1.0,45,1100,900,200,0.8181818181818182,13,9,4,334.971391915349,0.8067340067340067,0.08386920921510277,0.2111127677804157,134076.73306439628,-17.626020391294333,134059.10704400498,3013,10,737.8666666666667,40,5,17,32.409315409021026,0.65390625,41.082317073170735,1035.6707317073176,25.89176829268294,0
3052,4,0,0,45,0.0,0.0,1.0,45,950,500,450,0.5263157894736842,14,5,9,334.48422749999355,0.8065656565656566,0.08846166421448487,0.2114114506734304,134182.0048107111,-23.647155297779477,134158.35765541333,3014,11,738.8666666666667,40,5,17,32.31690371096944,0.6549479166666667,40.980691056910565,1036.077235772357,25.901930894308926,0
3053,4,0,1,44,0.0,0.022222222222222223,0.9777777777777777,45,1550,1300,250,0.8387096774193549,18,13,5,337.96888948715275,0.8055555555555556,0.08674137236324841,0.21484713890575818,134392.67223750742,84.10843826425366,134476.78067577168,3015,12,739.8666666666667,40,5,19,32.01652291809598,0.6570312500000001,40.77743902439024,1036.8902439024387,25.922256097560968,0
3054,4,0,0,44,0.0,0.0,1.0,44,1250,1000,250,0.8,15,10,5,344.3322165367829,0.8024136715997181,0.08186887461980441,0.21870699114170997,134361.7201063366,453.0137803819257,134814.73388671855,3016,13,757.4090909090909,39,5,19,31.882451689607834,0.6583867521367522,40.80729166666666,1036.7708333333317,26.583867521367477,0
3055,4,0,1,43,0.0,0.022727272727272728,0.9772727272727273,44,1250,800,450,0.64,17,8,9,343.0027727219539,0.8019511980267795,0.07595081159049832,0.21866975741134517,134496.75021701367,426.5516493055323,134923.3018663192,3017,14,758.4090909090909,39,5,19,31.782235388632248,0.6597222222222223,40.67708333333332,1037.291666666665,26.59722222222218,0
3056,4,0,0,43,0.0,0.0,1.0,43,1100,800,300,0.7272727272727273,14,8,6,345.0240284416993,0.803063861203396,0.07972600771202076,0.22011716926208247,134523.07167251056,682.7384213601916,135205.81009387076,3018,15,764.7441860465116,38,5,20,31.703570202540327,0.661732456140351,40.65170940170939,1037.3931623931608,27.299820062977915,0
3057,4,0,0,43,0.0,0.0,1.0,43,1350,1100,250,0.8148148148148148,16,11,5,340.2080171985247,0.8024640088593576,0.08105546353653081,0.21803833081140267,134689.37194097444,564.4808331506985,135253.85277412515,3019,16,765.7441860465116,38,5,20,31.662764169068208,0.6633771929824561,40.49145299145299,1038.0341880341875,27.316689158794407,0
3058,4,0,0,43,0.0,0.0,1.0,43,1000,600,400,0.6,14,6,8,340.36279132453086,0.8016795865633075,0.0792583410310288,0.2184706476943056,134744.82819234405,572.425168018101,135317.25336036214,3020,17,766.7441860465116,38,5,20,31.603510667489875,0.6639254385964912,40.43803418803418,1038.247863247862,27.322312190733207,0
3059,4,0,1,42,0.0,0.023255813953488372,0.9767441860465116,43,1150,700,450,0.6086956521739131,16,7,9,340.16156073769287,0.8018641565153193,0.07951478610393359,0.21867528904565928,134800.29585798792,570.7758053911658,135371.0716633791,3021,18,767.7441860465116,38,5,16,31.55349794238683,0.6644736842105264,40.38461538461537,1038.4615384615365,27.327935222672014,0
3060,4,0,0,42,0.0,0.0,1.0,42,1050,600,450,0.5714285714285714,15,6,9,345.12223940285486,0.7980061943476577,0.08186644946226829,0.2219044622800025,134806.86515322013,904.969437711593,135711.8345909317,3022,19,782.6904761904761,37,5,16,31.418166860240028,0.6663851351351351,40.378289473684205,1038.4868421052624,28.067211948790877,0
3061,4,0,0,42,0.0,0.0,1.0,42,850,600,250,0.7058823529411765,11,6,5,343.78876142907365,0.7963366240805265,0.08010305541677698,0.221345320437977,134855.7749379063,872.3799674921431,135728.15490539843,3023,20,783.6904761904761,38,4,17,31.404074950284574,0.6650219298245614,40.33119658119658,1038.6752136752134,27.333558254610878,0
3062,4,0,2,40,0.0,0.047619047619047616,0.9523809523809523,42,450,300,150,0.6666666666666666,6,3,3,342.3707414289742,0.7955865272938444,0.08203670236993288,0.22060110794658158,134883.51875821818,836.0340647600183,135719.5528229782,3024,21,784.6904761904761,38,4,17,31.413272652473513,0.665296052631579,40.304487179487175,1038.7820512820506,27.33636977058028,0
3063,4,0,0,40,0.0,0.0,1.0,40,1000,700,300,0.7,13,7,6,351.107462030027,0.7939636752136752,0.07421392171744534,0.2259779568948317,134843.0287339704,1468.8787182452668,136311.90745221567,3025,22,749.05,36,4,17,31.2267338899129,0.6686921296296295,40.343468468468465,1038.6261261261257,28.850725725725713,0
3064,4,0,0,40,0.0,0.0,1.0,40,850,400,450,0.47058823529411764,13,4,9,345.94163106611524,0.7926549145299145,0.06630364109232789,0.22355387755448952,134989.2713659605,1339.681742553363,136328.95310851387,3026,23,750.05,36,4,18,31.21523262534317,0.670138888888889,40.2027027027027,1039.189189189189,28.86636636636636,0
3065,4,0,0,40,0.0,0.0,1.0,40,850,400,450,0.47058823529411764,13,4,9,363.4021424772997,0.7926549145299145,0.09383642495784184,0.21944752595625133,132487.35592689048,1630.772272659768,134118.12819955024,3027,24,751.05,35,5,20,33.268338954468796,0.6473214285714286,42.62152777777778,1029.5138888888891,29.41468253968255,7
3066,4,0,0,40,0.0,0.0,1.0,40,1050,500,550,0.47619047619047616,16,5,11,359.39798328667274,0.792094017094017,0.0879163108454315,0.21363199920238235,131890.67790089242,1480.248730378561,133370.926631271,3028,25,752.05,37,3,17,33.972477227440926,0.6373873873873874,43.201754385964904,1027.1929824561391,27.761972498814572,1
3067,4,0,0,40,0.0,0.0,1.0,40,550,500,50,0.9090909090909091,6,5,1,358.29209514054577,0.7924946581196581,0.0953233379575289,0.2134491559797873,131975.16453379884,1457.1316414666092,133432.29617526545,3029,26,753.05,37,3,17,33.91569291786719,0.6382319819819819,43.11951754385965,1027.5219298245613,27.770862968231388,0
3068,4,0,0,40,0.0,0.0,1.0,40,1050,700,350,0.6666666666666666,14,7,7,357.15862895251627,0.7900641025641025,0.09512903913831705,0.21372536462589323,132144.21895438986,1439.2896131502016,133583.50856754006,3030,27,754.05,37,3,18,33.774461448224365,0.6399211711711712,42.95504385964912,1028.1798245614038,27.78864390706497,0
3069,4,0,1,39,0.0,0.025,0.975,40,750,400,350,0.5333333333333333,11,4,7,354.805096148762,0.7895833333333333,0.09344686067583385,0.21295115847546636,132256.98201610122,1385.0902441135827,133642.0722602148,3031,28,755.05,37,3,18,33.72141829229293,0.6410472972972973,42.84539473684211,1028.6184210526324,27.800497866287362,0
3070,4,0,0,39,0.0,0.0,1.0,39,1000,700,300,0.7,13,7,6,356.63904169473847,0.7879554655870445,0.09982075327343876,0.2145321004656043,132341.58587257622,1639.6352723915059,133981.22114496774,3032,29,767.025641025641,37,2,19,33.58908780903665,0.6418918918918919,42.76315789473684,1028.947368421053,27.809388335704135,0
3071,4,0,0,39,0.0,0.0,1.0,39,1150,700,450,0.6086956521739131,16,7,9,355.7614254870686,0.7866059379217274,0.09760541534771394,0.21466364438819457,132457.56842635458,1624.68271784243,134082.251144197,3033,30,768.025641025641,35,4,20,33.49495914848962,0.6470238095238094,42.65046296296296,1029.398148148148,29.411375661375658,0
3072,4,0,0,39,0.0,0.0,1.0,39,1100,700,400,0.6363636363636364,15,7,8,353.8218714962915,0.786493477282951,0.10034956115638272,0.2144737348294621,132629.8992193209,1585.4718316289502,134215.37105094985,3034,31,769.025641025641,36,3,17,33.37159724499836,0.6467013888888888,42.48310810810812,1030.0675675675695,28.612987987988042,0
3073,4,0,0,39,0.0,0.0,1.0,39,550,300,250,0.5454545454545454,8,3,5,353.8218714962915,0.786493477282951,0.10034956115638272,0.2144737348294621,132629.8992193209,1585.4718316289502,134215.37105094985,3035,32,770.025641025641,36,3,17,33.37159724499836,0.6467013888888888,42.48310810810812,1030.0675675675695,28.612987987988042,0
3074,4,1,1,39,0.025,0.025,0.975,40,850,700,150,0.8235294117647058,10,7,3,347.5077168353384,0.7951388888888888,0.1043917481922585,0.21220536163113785,132906.3029008926,1237.1931748230215,134143.4960757156,3036,0,751.75,37,3,17,33.25668155394867,0.6475225225225225,42.21491228070175,1031.140350877193,27.868658131816026,0
3075,4,0,0,39,0.0,0.0,1.0,39,900,400,500,0.4444444444444444,14,4,10,359.0107160132143,0.7858187134502924,0.10486658487532385,0.21880053890712176,132832.97444403885,1737.6922530638922,134570.66669710274,3037,34,772.025641025641,36,3,18,33.03382856310536,0.6487268518518519,42.286036036036045,1030.8558558558575,28.63488488488493,0
3076,4,0,0,39,0.0,0.0,1.0,39,1200,700,500,0.5833333333333334,17,7,10,362.0731665416207,0.784919028340081,0.10851723355818588,0.22118105310351058,132920.05423920558,1825.3569870546391,134745.4112262602,3038,35,773.025641025641,36,3,18,32.86738742674093,0.6495949074074073,42.201576576576585,1031.193693693695,28.644269269269305,0
3077,4,0,0,39,0.0,0.0,1.0,39,1200,900,300,0.75,15,9,6,360.47693571090895,0.7853126405757985,0.11205455751803584,0.2205483135722258,132978.12328798417,1787.1092798880172,134765.23256787218,3039,36,774.025641025641,36,3,18,32.85020198711649,0.650173611111111,42.14527027027028,1031.4189189189208,28.650525525525577,0
3078,4,0,0,39,0.0,0.0,1.0,39,700,500,200,0.7142857142857143,9,5,4,358.83267547624746,0.785425101214575,0.10824531649678981,0.22005521905712067,133065.25063915286,1749.6319799529465,134814.8826191058,3040,37,775.025641025641,36,3,18,32.80510987411773,0.6510416666666665,42.06081081081082,1031.7567567567583,28.659909909909953,0
3079,4,0,0,39,0.0,0.0,1.0,39,500,300,200,0.6,7,3,4,360.7353923776277,0.7856500224921278,0.10660443877379722,0.22156696620298807,133123.35139193258,1804.4608797987285,134927.8122717313,3041,38,776.025641025641,36,3,18,32.6976938745817,0.6516203703703705,42.00450450450451,1031.9819819819827,28.666166166166185,0
3080,4,0,0,39,0.0,0.0,1.0,39,900,600,300,0.6666666666666666,12,6,6,358.81299757236087,0.7844129554655871,0.10819623536386569,0.2212479068420293,133268.65875588424,1763.705386129374,135032.36414201363,3042,39,777.025641025641,36,3,20,32.601474170211226,0.6530671296296295,41.86373873873874,1032.5450450450448,28.6818068068068,0
3081,4,0,2,37,0.0,0.05128205128205128,0.9487179487179487,39,800,500,300,0.625,11,5,6,359.05309737670484,0.7837944219523167,0.10913513966949084,0.2215691051779531,133297.72973987498,1772.1925472770022,135069.92228715197,3043,40,778.025641025641,36,3,20,32.56611232279172,0.6533564814814815,41.835585585585584,1032.6576576576574,28.68493493493493,0
3082,4,0,0,37,0.0,0.0,1.0,37,900,500,400,0.5555555555555556,13,5,8,368.61078528699903,0.7792167167167167,0.09540160404813336,0.22740611319910609,133287.7621882087,2426.2613378684805,135714.0235260772,3044,41,773.3783783783783,34,3,20,32.32937514410881,0.6574754901960784,41.845238095238095,1032.6190476190482,30.371148459383768,0
3083,4,0,0,37,0.0,0.0,1.0,37,800,700,100,0.875,9,7,2,369.38569233457986,0.7792167167167167,0.026292225081438136,0.2136135591890298,130838.01442912508,2265.9381087168235,133103.9525378419,3045,42,774.3783783783783,36,1,17,34.780774169877084,0.6287615740740742,44.2286036036036,1023.0855855855856,28.419044044044043,7
3084,4,0,0,37,0.0,0.0,1.0,37,1200,800,400,0.6666666666666666,16,8,8,366.43832100215764,0.7792167167167167,0.02691401789113068,0.21238465951961766,130924.4379514648,2195.1462442171733,133119.58419568196,3046,43,775.3783783783783,36,1,17,34.76860512030517,0.6296296296296298,44.144144144144136,1023.423423423422,28.42842842842839,0
3085,4,0,0,37,0.0,0.0,1.0,37,1200,900,300,0.75,15,9,6,366.0291077433225,0.7788413413413413,0.02040998323444443,0.21278367312035085,131039.71370018662,2192.8698969239435,133232.58359711056,3047,44,776.3783783783783,36,1,17,34.66234051913769,0.6307870370370371,44.03153153153153,1023.8738738738734,28.44094094094093,0
3086,4,2,1,38,0.05128205128205128,0.02564102564102564,0.9743589743589743,39,950,600,350,0.631578947368421,13,6,7,351.67329615992645,0.7950404858299596,0.0325000068507606,0.20734763907803586,131581.12502164117,1455.0306297713632,133036.15565141253,3048,0,737.5128205128206,37,2,17,34.48298510918744,0.6342905405405406,43.503289473684205,1025.9868421052624,27.72937411095304,0
3087,4,0,0,38,0.0,0.0,1.0,38,1150,1000,150,0.8695652173913043,13,10,3,360.29173366631125,0.7888809862494073,0.03602963271155479,0.21198560143622494,131501.3239590942,1875.7679977274574,133377.09195682168,3049,1,757.921052631579,36,2,19,34.342519396867225,0.6354166666666666,43.58108108108108,1025.6756756756756,28.49099099099099,0
3088,4,0,0,38,0.0,0.0,1.0,38,550,400,150,0.7272727272727273,7,4,3,358.7841094235427,0.788436462778568,0.032053319158033444,0.2112582063826147,131530.201548677,1838.1892449882262,133368.39079366522,3050,2,758.921052631579,36,2,19,34.352014491162585,0.6357060185185186,43.552927927927925,1025.788288288288,28.49411911911911,0
3089,4,1,0,39,0.02564102564102564,0.0,1.0,39,1200,1100,100,0.9166666666666666,13,11,2,376.8228575912498,0.7967836257309941,0.035702990476859764,0.20468119981817498,128379.01341735243,1923.7523121219185,130302.76572947434,3051,0,740.4358974358975,35,4,18,37.0964671844069,0.605952380952381,46.64351851851851,1013.425925925925,28.955026455026427,6
3090,4,2,1,40,0.04878048780487805,0.024390243902439025,0.975609756097561,41,1200,800,400,0.6666666666666666,16,8,8,357.722187149271,0.8173272357723578,0.04086597684158688,0.19674720293209869,128875.73964497015,1020.3422912557231,129896.08193622588,3052,0,705.2682926829268,38,3,19,37.07320601851851,0.605263157894737,46.15384615384614,1015.3846153846132,26.720647773279296,0
3091,4,2,0,42,0.047619047619047616,0.0,1.0,42,1100,700,400,0.6363636363636364,15,7,8,347.6886187399281,0.8200735578784359,0.06107225407498573,0.19307469505056168,129255.70371283483,588.5583315070168,129844.26204434184,3053,0,689.4285714285714,38,4,22,36.94097149261048,0.6091008771929827,45.779914529914514,1016.8803418803395,26.76000899685104,0
3092,4,1,1,42,0.023255813953488372,0.023255813953488372,0.9767441860465116,43,750,400,350,0.5333333333333333,11,4,7,341.7504707730102,0.8247046880767811,0.059651769588257686,0.19118072987204476,129545.80213758652,254.4677734374659,129800.26991102399,3054,0,674.3720930232558,39,4,17,36.79706419045667,0.6103098290598292,45.49479166666665,1018.0208333333311,26.103098290598233,0
3093,4,0,0,42,0.0,0.0,1.0,42,650,500,150,0.7692307692307693,8,5,3,347.1408732262148,0.8198073945025165,0.06025379492410177,0.19356965319709973,129418.71667031899,585.3052633501047,130004.0219336691,3055,2,691.4285714285714,38,4,22,36.78907671846561,0.6107456140350879,45.619658119658105,1017.5213675213655,26.776878092667513,0
3094,4,0,2,40,0.0,0.047619047619047616,0.9523809523809523,42,650,300,350,0.46153846153846156,10,3,7,337.1643514540592,0.8198073945025165,0.040240508538977204,0.18723725720867943,129257.13320444764,318.9217769226211,129576.05498137027,3056,3,692.4285714285714,37,5,18,37.2070663503702,0.6109234234234233,45.77850877192983,1016.8859649122817,27.483404457088692,1
3095,4,4,2,42,0.09090909090909091,0.045454545454545456,0.9545454545454546,44,1150,800,350,0.6956521739130435,15,8,7,323.6615723837672,0.823907681465821,0.06007953616293715,0.18241387236191137,129837.58680555577,-395.31249999998,129442.27430555578,3057,0,661.7045454545455,39,5,18,36.96170618697191,0.6132478632478632,45.20833333333334,1019.1666666666683,26.132478632478676,0
3096,4,1,0,43,0.023255813953488372,0.0,1.0,43,1200,800,400,0.6666666666666666,16,8,8,326.44411393560785,0.8162606127722406,0.06256961997547905,0.18418706629566167,129881.14458917758,-120.21296752865919,129760.93162164892,3058,0,678.0697674418604,38,5,20,36.846679243964644,0.6154057017543859,45.1655982905983,1019.337606837608,26.824673864147577,0
3097,4,1,0,44,0.022727272727272728,0.0,1.0,44,1550,1100,450,0.7096774193548387,20,11,9,319.3669304456472,0.8219917195207893,0.07745825602968437,0.181964878974846,130262.58680555594,-479.68749999995975,129782.89930555598,3059,0,663.6363636363636,39,5,21,36.64115646258503,0.6175213675213673,44.791666666666686,1020.8333333333364,26.175213675213755,0
3098,4,0,0,44,0.0,0.0,1.0,44,1450,1000,450,0.6896551724137931,19,10,9,317.84275286908036,0.8206703664552502,0.0792962265725703,0.18146840456468283,130342.35161675386,-514.325629340238,129828.02598741362,3060,1,664.6363636363636,39,5,21,36.5994465979802,0.6183226495726494,44.713541666666686,1021.1458333333364,26.183226495726576,0
3099,4,1,1,44,0.022222222222222223,0.022222222222222223,0.9777777777777777,45,1400,900,500,0.6428571428571429,19,9,10,312.462169590706,0.8271464646464647,0.07997702444466515,0.17970594419170488,130625.94112507468,-836.8670062462494,129789.07411882843,3061,0,650.8444444444444,40,5,17,36.45056665672531,0.6195312499999999,44.43597560975611,1022.2560975609781,25.556402439024453,0
3100,4,0,1,43,0.0,0.022727272727272728,0.9772727272727273,44,750,500,250,0.6666666666666666,10,5,5,319.4687104935191,0.819547216349542,0.0792443390282771,0.1835261702202821,130581.7925347226,-456.6406249999607,130125.15190972264,3062,3,666.6363636363636,39,5,17,36.316075553743715,0.6207264957264955,44.479166666666686,1022.0833333333363,26.207264957265036,0
3101,4,0,1,42,0.0,0.023255813953488372,0.9767441860465116,43,1200,800,400,0.6666666666666666,16,8,8,317.15682722662444,0.8189368770764119,0.0829979319216072,0.18282610527796703,130714.91021050377,-308.57476128468704,130406.33544921908,3063,4,678.6279069767442,39,4,17,36.2408110081152,0.6220619658119657,44.34895833333335,1022.604166666669,26.22061965811972,0
3102,4,0,0,42,0.0,0.0,1.0,42,1300,900,400,0.6923076923076923,17,9,8,319.702490202431,0.8166376306620209,0.08861259863661397,0.1850024621552076,130863.12601587061,-32.546547410312655,130830.5794684603,3064,5,691.9047619047619,38,4,18,36.02619992342765,0.6252741228070174,44.20405982905984,1023.1837606837623,26.92588843904638,0
3103,4,0,1,41,0.0,0.023809523809523808,0.9761904761904762,42,1100,700,400,0.6363636363636364,15,7,8,316.0120592422627,0.8157181571815718,0.08690401645943302,0.18351682131268857,130999.80481591068,-120.49638395791271,130879.30843195277,3065,6,692.9047619047619,38,4,18,35.98283239407222,0.6266447368421052,44.070512820512825,1023.7179487179495,26.93994601889341,0
3104,4,0,1,40,0.0,0.024390243902439025,0.975609756097561,41,1250,1000,250,0.8,15,10,5,322.4587083739928,0.8076727642276422,0.08613548044834363,0.1868098774211343,130906.99932912047,242.42038415666354,131149.41971327714,3066,7,710.6341463414634,37,4,18,35.91143880138577,0.6275337837837838,44.161184210526315,1023.3552631578945,27.65825035561877,0
3105,4,1,1,40,0.024390243902439025,0.024390243902439025,0.975609756097561,41,1000,600,400,0.6,14,6,8,320.6949784300955,0.8082317073170732,0.08603588659855776,0.18633036799015562,131019.23338190601,203.44204466759868,131222.6754265736,3067,0,711.390243902439,37,4,18,35.84339634429332,0.6286599099099099,44.0515350877193,1023.7938596491231,27.670104314841165,0
3106,4,0,0,40,0.0,0.0,1.0,40,1150,900,250,0.782608695652174,14,9,5,354.9409927162969,0.8030181623931624,0.10130234933605764,0.2008596716007249,129996.88042534702,1330.8540548533942,131327.73448020042,3068,9,730.175,35,5,17,36.00293667007151,0.6223214285714287,45.05208333333332,1019.7916666666649,29.136904761904713,8
3107,4,3,2,41,0.06976744186046512,0.046511627906976744,0.9534883720930233,43,550,400,150,0.7272727272727273,7,4,3,332.19330738842285,0.8247046880767811,0.1090838300499235,0.1912481317551992,130665.25298524875,81.76704470517743,130747.02002995393,3069,0,680.1627906976744,36,7,16,35.9065792855307,0.627025462962963,44.39752252252252,1022.4099099099099,28.400275275275273,0
3108,4,1,0,42,0.023809523809523808,0.0,1.0,42,950,600,350,0.631578947368421,13,6,7,344.91656601935364,0.8153552071234998,0.13298569003153093,0.1987826393203511,130706.03358892715,616.535252700583,131322.56884162774,3070,0,697.3333333333334,35,7,17,35.54011035653651,0.6294642857142858,44.35763888888887,1022.5694444444418,29.216269841269767,0
3109,4,0,0,42,0.0,0.0,1.0,42,950,700,250,0.7368421052631579,12,7,5,344.37029504505705,0.8152584204413472,0.1296337077002132,0.1987020978144349,130751.61944038619,605.3947528609538,131357.01419324713,3071,1,698.3333333333334,36,6,17,35.50796447184907,0.6278935185185186,44.313063063063055,1022.7477477477466,28.409659659659628,0
3110,4,0,0,42,0.0,0.0,1.0,42,1000,600,400,0.6,14,6,8,347.78803092463903,0.8154761904761905,0.13452747897926254,0.2009736942060699,130809.21292914524,698.7757182858427,131507.98864743108,3072,2,699.3333333333334,36,6,17,35.36231285777192,0.6284722222222223,44.25675675675675,1022.972972972972,28.41591591591589,0
3111,4,0,0,42,0.0,0.0,1.0,42,1400,1100,300,0.7857142857142857,17,11,6,344.55865225463714,0.814121176926055,0.12899270623742476,0.1997033821230957,130924.43795146495,622.229577550522,131546.66752901548,3073,3,700.3333333333334,36,6,17,35.328409257629104,0.6296296296296295,44.14414414414414,1023.4234234234232,28.428428428428422,0
3112,4,0,1,41,0.0,0.023809523809523808,0.9761904761904762,42,1100,700,400,0.6363636363636364,15,7,8,349.76056463793265,0.812693573364305,0.14237796735322328,0.20347874691316203,131068.54056336741,768.5213507426362,131837.06191411003,3074,4,701.3333333333334,36,6,17,35.04962608600022,0.6310763888888888,44.00337837837838,1023.9864864864865,28.44406906906907,0
3113,4,0,0,41,0.0,0.0,1.0,41,1250,1100,150,0.88,14,11,3,359.69409284264134,0.8081808943089431,0.1428342974363499,0.20905742084664955,131031.70680084023,1226.2661822702394,132257.97298311046,3075,5,718.9268292682926,35,6,17,34.8325985379456,0.6327380952380952,44.039351851851855,1023.8425925925928,29.25264550264551,0
3114,4,0,0,41,0.0,0.0,1.0,41,1050,800,250,0.7619047619047619,13,8,5,349.47579055343454,0.8072154471544716,0.08856610389576258,0.19476191354626526,129396.54659366334,844.1920831409568,130240.73867680429,3076,6,719.9268292682926,37,4,19,36.75223174192621,0.612331081081081,45.64144736842105,1017.434210526315,27.498221906116623,6
3115,4,3,1,43,0.06818181818181818,0.022727272727272728,0.9772727272727273,44,1150,800,350,0.6956521739130435,15,8,7,331.8928873875599,0.8250308315715292,0.09554781805503998,0.18834780647166274,130107.0184434695,-163.68119588207833,129943.33724758742,3077,0,671.7727272727273,40,4,19,36.478981970315786,0.6143229166666667,44.94410569105691,1020.2235772357724,25.50558943089431,0
3116,4,0,1,42,0.0,0.023255813953488372,0.9767441860465116,43,1300,1100,200,0.8461538461538461,15,11,4,337.6372335426546,0.8184293097083795,0.09587323301413586,0.1913277656741709,130050.0,181.94444444444423,130231.94444444444,3078,1,688.3953488372093,39,4,20,36.390250544662315,0.6153846153846154,45.0,1020.0,26.153846153846153,0
3117,4,0,0,42,0.0,0.0,1.0,42,900,700,200,0.7777777777777778,11,7,4,336.8557178515423,0.8196622144792877,0.106226530825966,0.19112508911255935,130099.04308431939,364.92130999341754,130463.9643943128,3079,2,701.047619047619,38,4,20,36.360482773065264,0.6175986842105263,44.95192307692307,1020.1923076923066,26.847165991902806,0
3118,4,1,0,43,0.023255813953488372,0.0,1.0,43,800,400,400,0.5,12,4,8,329.64028545344104,0.8232281284606866,0.10622401389655933,0.18834617385830474,130371.6730244172,-4.7461693695882445,130366.92685504761,3080,0,685.7209302325581,38,5,21,36.26861247689786,0.6203399122807018,44.68482905982905,1021.260683760682,26.875281151596894,0
3119,4,1,1,43,0.022727272727272728,0.022727272727272728,0.9772727272727273,44,900,700,200,0.7777777777777778,11,7,4,323.40952308733813,0.8290609584214236,0.11122305290755286,0.18591784710345907,130608.41064453112,-351.9992404514037,130256.41140407971,3081,0,671.1136363636364,39,5,14,36.18849570297903,0.6209935897435899,44.45312499999999,1022.187499999999,26.209935897435873,0
3120,4,1,1,43,0.022727272727272728,0.022727272727272728,0.9772727272727273,44,700,500,200,0.7142857142857143,9,5,4,320.6213542624301,0.8297216349541932,0.11204853299262107,0.1850782526456673,130768.17626953125,-414.5860460069441,130353.59022352431,3082,0,672.0681818181819,39,5,14,36.098486777336454,0.622596153846154,44.296875,1022.8125,26.22596153846154,0
3121,4,0,0,43,0.0,0.0,1.0,43,750,400,350,0.5333333333333333,11,4,7,327.3064121701794,0.8249354005167958,0.11050824559655759,0.18860022100426163,130699.20562358461,-44.26238677040175,130654.94323681422,3083,2,688.6976744186046,38,5,15,35.99719639187825,0.6236293859649124,44.36431623931624,1022.5427350427349,26.909019343229865,0
3122,4,2,1,44,0.044444444444444446,0.022222222222222223,0.9777777777777777,45,950,700,250,0.7368421052631579,12,7,5,320.52744679023556,0.8309343434343435,0.15788267166822978,0.18814078940953466,131410.26925131504,-572.8613074366128,130837.40794387842,3084,0,659.0444444444445,38,7,18,35.45378764197146,0.6307565789473684,43.6698717948718,1025.3205128205138,26.982118758434574,0
3123,4,0,0,44,0.0,0.0,1.0,44,800,400,400,0.5,12,4,8,328.11170305968744,0.8237094785059902,0.15980561849103947,0.19232077190627073,131356.22409058557,-180.09712122960752,131176.12696935597,3085,1,674.8636363636364,37,7,18,35.31382589938318,0.6320382882882882,43.72258771929825,1025.109649122807,27.705666192508296,0
3124,4,2,0,46,0.043478260869565216,0.0,1.0,46,1150,800,350,0.6956521739130435,15,8,7,313.5350512662328,0.8333132045088567,0.18051579539444385,0.1868582313587824,131989.91894211384,-923.3067995716859,131066.61214254216,3086,0,646.4782608695652,41,5,14,35.05060500740168,0.6316056910569106,43.10515873015873,1027.5793650793648,25.062911343399144,0
3125,4,1,2,45,0.02127659574468085,0.0425531914893617,0.9574468085106383,47,1150,800,350,0.6956521739130435,15,8,7,311.3014071707289,0.8381128584643848,0.1899720387648951,0.1867984418947026,132248.45754649668,-1166.1738139234312,131082.28373257324,3087,0,633.7021276595744,42,5,14,34.84868111163448,0.6326884920634921,42.85368217054264,1028.5852713178301,24.490125507567384,0
3126,4,0,1,44,0.0,0.022222222222222223,0.9777777777777777,45,1650,1300,350,0.7878787878787878,20,13,7,312.8539630073877,0.8322811447811448,0.16144202751236691,0.1829879481609204,131274.74500868062,-785.9506511120815,130488.79435756853,3088,2,662.2,39,6,17,35.78682997899303,0.6276709401709402,43.802083333333336,1024.7916666666672,26.276709401709414,2
3127,4,0,1,43,0.0,0.022727272727272728,0.9772727272727273,44,1300,900,400,0.6923076923076923,17,9,8,315.91726251806483,0.833861874559549,0.15826627235760826,0.18464122271851058,131246.006430802,-507.424186390547,130738.58224441145,3089,3,657.9090909090909,38,6,17,35.73727974142425,0.6291118421052633,43.8301282051282,1024.6794871794862,26.965249662618056,0
3128,4,0,0,43,0.0,0.0,1.0,43,1150,800,350,0.6956521739130435,15,8,7,320.7643608611406,0.8289036544850498,0.16305205488999386,0.18718934562933365,131187.67463305994,-183.9338786934689,131003.74075436647,3090,4,674.0232558139535,37,6,17,35.67187109779157,0.6303490990990992,43.88706140350876,1024.451754385963,27.68788525367468,0
3129,4,0,0,43,0.0,0.0,1.0,43,1150,900,250,0.782608695652174,14,9,5,337.18814975568245,0.8289497969730527,0.18103295302600486,0.1914298800168777,130122.70752779701,180.72459795321626,130303.43212575023,3091,5,675.0232558139535,37,6,16,36.328027046390844,0.6196509009009008,44.92872807017544,1020.2850877192983,27.575272641062117,3
3130,4,0,0,43,0.0,0.0,1.0,43,1100,1000,100,0.9090909090909091,12,10,2,336.3006381899541,0.8268733850129198,0.17941769300127675,0.19175108647805628,130290.5716783047,163.3604811095554,130453.93215941425,3092,6,676.0232558139535,37,6,17,36.180659972076036,0.6213400900900901,44.764254385964904,1020.942982456139,27.59305357989565,0
3131,4,0,0,43,0.0,0.0,1.0,43,1050,500,550,0.47619047619047616,16,5,11,338.2960904265453,0.8273348098929494,0.18540758821385928,0.19386488134037796,130486.5499480608,228.6179401354093,130715.16788819621,3093,7,677.0232558139535,37,6,17,35.93135150604563,0.6233108108108109,44.57236842105262,1021.7105263157883,27.613798008534822,0
3132,4,0,0,43,0.0,0.0,1.0,43,900,600,300,0.6666666666666666,12,6,6,341.2045576716045,0.8269656699889257,0.18794728715429931,0.19623998094832623,130626.62459843411,314.07993324868596,130940.7045316828,3094,8,678.0232558139535,37,6,16,35.71532321498801,0.6247184684684685,44.435307017543856,1022.2587719298243,27.62861545756282,0
3133,4,0,0,43,0.0,0.0,1.0,43,1200,1000,200,0.8333333333333334,14,10,4,344.49536760847843,0.8260889627168697,0.19271525656212973,0.198419969298892,130682.67549871112,403.91526719759605,131086.5907659087,3095,9,679.0232558139535,37,6,16,35.57450848972297,0.6252815315315315,44.38048245614035,1022.4780701754385,27.634542437174012,0
3134,4,0,0,43,0.0,0.0,1.0,43,1450,1000,450,0.6896551724137931,19,10,9,345.0883354068805,0.8253968253968254,0.20074279019915742,0.19948414927795502,130822.85534972296,429.0882771621982,131251.94362688516,3096,10,680.0232558139535,37,6,16,35.417559842801005,0.6266891891891893,44.243421052631575,1023.0263157894733,27.64935988620198,0
3135,4,0,0,43,0.0,0.0,1.0,43,1200,900,300,0.75,15,9,6,345.78747558947447,0.824750830564784,0.20270300569250477,0.20061691016953045,130963.11034404821,457.0806642428472,131420.19100829106,3097,11,681.0232558139535,37,6,16,35.257878057489734,0.6280968468468469,44.10635964912281,1023.574561403509,27.664177335229976,0
3136,4,0,0,43,0.0,0.0,1.0,43,1350,1100,250,0.8148148148148148,16,11,5,348.89984249730605,0.8241971207087486,0.2071084748379508,0.2030140578867504,131075.36844269405,546.4350809864686,131621.80352368052,3098,12,682.0232558139535,37,6,17,35.06475978869971,0.6292229729729729,43.996710526315795,1024.0131578947378,27.676031294452372,0
3137,4,0,0,43,0.0,0.0,1.0,43,1500,1100,400,0.7333333333333333,19,11,8,350.7797400313733,0.8248892580287929,0.20896268298245002,0.20428764203771255,131109.19922017696,598.0901636350565,131707.28938381202,3099,13,683.0232558139535,38,5,17,34.98243966896168,0.6277412280701753,43.963675213675224,1024.1452991453007,26.95119208277107,0
3138,4,0,0,43,0.0,0.0,1.0,43,900,800,100,0.8888888888888888,10,8,2,348.2741249350817,0.8251661129568106,0.21093452526756606,0.20326236056010374,131191.27498584654,538.1052989626933,131729.38028480925,3100,14,684.0232558139535,38,5,17,34.96367365383947,0.628563596491228,43.88354700854702,1024.4658119658138,26.95962663067931,0
3139,4,0,0,43,0.0,0.0,1.0,43,1500,1300,200,0.8666666666666667,17,13,4,349.7197778608294,0.8264581026208933,0.21549433931417816,0.20514490062145557,131385.84530476414,589.7884052358141,131975.63370999997,3101,15,685.0232558139535,36,7,17,34.73015524311657,0.6342592592592593,43.69369369369369,1025.2252252252247,28.478478478478465,0
3140,4,0,0,43,0.0,0.0,1.0,43,1150,900,250,0.782608695652174,14,9,5,352.1844422342977,0.8268733850129198,0.21405356828283795,0.20737220971636824,131530.20154867703,664.5781338771161,132194.77968255413,3102,16,686.0232558139535,36,7,17,34.52126102389578,0.6357060185185186,43.552927927927925,1025.7882882882882,28.494119119119116,0
3141,4,0,0,43,0.0,0.0,1.0,43,900,600,300,0.6666666666666666,12,6,6,353.5507017923857,0.8270579549649317,0.21624946403413814,0.20864987012514383,131616.85333982643,706.646173200236,132323.49951302668,3103,17,687.0232558139535,36,7,15,34.39877816798361,0.6365740740740741,43.46846846846847,1026.126126126127,28.503503503503527,0
3142,4,1,0,44,0.022727272727272728,0.0,1.0,44,800,600,200,0.75,10,6,4,349.2774244837506,0.8291930937279774,0.22199177170358775,0.2077701707929054,131918.83710612878,415.2543330640192,132334.0914391928,3104,0,672.3863636363636,37,7,16,34.20400167218131,0.637668918918919,43.17434210526316,1027.3026315789473,27.7649359886202,0
3143,4,0,1,43,0.0,0.022727272727272728,0.9772727272727273,44,1250,700,550,0.56,18,7,11,360.63983995221554,0.8289068005637773,0.21561707565441335,0.2118700892003146,131443.57829112906,775.6972753219553,132219.27556645102,3105,1,673.3863636363636,36,8,18,34.39193022915292,0.6348379629629629,43.63738738738739,1025.4504504504512,28.484734734734754,5
3144,4,1,2,42,0.022727272727272728,0.045454545454545456,0.9545454545454546,44,1150,900,250,0.782608695652174,14,9,5,357.61069789495116,0.8305144467935166,0.21955123534155296,0.21084834909912145,131581.12502164126,610.9635897583912,132192.08861139964,3106,0,674.3409090909091,37,7,15,34.33069270777673,0.6342905405405406,43.50328947368421,1025.9868421052631,27.729374110953056,0
3145,4,2,1,43,0.045454545454545456,0.022727272727272728,0.9772727272727273,44,1050,800,250,0.7619047619047619,13,8,5,353.1484785132434,0.8362403100775194,0.21051623883137127,0.209989030358988,131903.67408366204,516.3163625903969,132419.99044625243,3107,0,645.25,38,6,17,34.11986479459178,0.6356907894736842,43.18910256410256,1027.2435897435896,27.032726045883937,0
3146,4,0,0,43,0.0,0.0,1.0,43,1400,1200,200,0.8571428571428571,16,12,4,364.0829294657929,0.8299187892211147,0.2254987377968416,0.21657733118508016,131918.83710612875,1005.8793330640184,132924.71643919277,3108,1,661.2558139534884,37,6,17,33.82375831643365,0.637668918918919,43.17434210526316,1027.302631578947,27.76493598862019,0
3147,4,0,0,43,0.0,0.0,1.0,43,1750,1200,550,0.6857142857142857,23,12,11,362.66130031634987,0.8288113695090439,0.21949736874099046,0.21637328885201426,132031.50398439897,976.5433835410818,133008.04736794005,3109,2,662.2558139534884,37,6,18,33.74664372843986,0.638795045045045,43.06469298245614,1027.7412280701747,27.77678994784256,0
3148,4,0,0,43,0.0,0.0,1.0,43,1350,1000,350,0.7407407407407407,17,10,7,364.69932618350356,0.8285806570690292,0.22718244866686277,0.21856325752556444,132200.59447378057,1042.6935451292893,133243.28801890987,3110,3,663.2558139534884,37,6,18,33.523807619859966,0.6404842342342342,42.900219298245624,1028.399122807019,27.79457088667619,0
3149,4,0,0,43,0.0,0.0,1.0,43,1350,900,450,0.6666666666666666,18,9,9,366.4130379557487,0.8270579549649317,0.22092155963871063,0.2205764182947213,132369.7931695331,1100.4036097645608,133470.19677929766,3111,4,664.2558139534884,37,6,18,33.3092479133369,0.6421734234234233,42.735745614035096,1029.0570175438609,27.812351825509754,0
3150,4,0,0,43,0.0,0.0,1.0,43,1150,900,250,0.782608695652174,14,9,5,363.24537926853594,0.8259966777408637,0.21417017640236802,0.21967696746240065,132542.91453615797,1029.1232577413216,133572.0377938993,3112,5,665.2558139534884,36,7,18,33.2164534120735,0.6458333333333333,42.56756756756758,1029.7297297297314,28.60360360360365,0
3151,4,0,0,43,0.0,0.0,1.0,43,1100,700,400,0.6363636363636364,15,7,8,363.966538113931,0.8253506829088224,0.21669323529636086,0.22062305660226184,132629.89921932085,1054.5690538511717,133684.46827317204,3113,6,666.2558139534884,36,7,17,33.110354943332986,0.6467013888888888,42.48310810810812,1030.067567567569,28.61298798798803,0
3152,4,0,0,43,0.0,0.0,1.0,43,700,400,300,0.5714285714285714,10,4,6,363.966538113931,0.8253506829088224,0.21669323529636086,0.22062305660226184,132629.89921932085,1054.5690538511717,133684.46827317204,3114,7,667.2558139534884,36,7,17,33.110354943332986,0.6467013888888888,42.48310810810812,1030.067567567569,28.61298798798803,0
3153,4,0,0,43,0.0,0.0,1.0,43,1150,700,450,0.6086956521739131,16,7,9,364.9478244994494,0.8245662606127722,0.2204612555714216,0.22168162293609095,132708.51518015168,1086.336781509707,133794.8519616614,3115,8,668.2558139534884,37,6,17,33.00599038700295,0.6455518018018017,42.40679824561404,1030.3728070175446,27.84791370317688,0
3154,4,0,0,43,0.0,0.0,1.0,43,1550,1200,350,0.7741935483870968,19,12,7,367.5135190286704,0.8245662606127722,0.22147051914493776,0.2245915949619654,132934.57031250012,1171.0503472222365,134105.62065972236,3116,9,669.2558139534884,37,6,17,32.7125420875421,0.647804054054054,42.18750000000001,1031.250000000001,27.871621621621646,0
3155,4,0,0,43,0.0,0.0,1.0,43,1100,500,600,0.45454545454545453,17,5,12,364.9042964923665,0.8230897009966777,0.22518428459521633,0.2240126767312239,133104.2379025278,1114.0616583949018,134218.2995609227,3117,10,670.2558139534884,37,6,18,32.60933570644282,0.6494932432432432,42.02302631578948,1031.9078947368428,27.88940256045521,0
3156,4,0,0,43,0.0,0.0,1.0,43,900,600,300,0.6666666666666666,12,6,6,364.62380656232136,0.8223052787006275,0.22863523401564212,0.22435088333187536,133189.11227493064,1112.784222068318,134301.89649699896,3118,11,671.2558139534884,37,6,18,32.53133630762694,0.6503378378378378,41.940789473684205,1032.2368421052624,27.898293029871958,0
3157,4,0,1,42,0.0,0.023255813953488372,0.9767441860465116,43,950,600,350,0.631578947368421,13,6,7,365.27298361475033,0.8215208564045773,0.23216292655213722,0.22492119952471373,133217.40974386342,1132.1441453139346,134349.55388917736,3119,12,672.2558139534884,37,6,18,32.48617011860506,0.6506193693693694,41.91337719298245,1032.3464912280697,27.90125651967756,0
3158,4,0,1,41,0.0,0.023809523809523808,0.9761904761904762,42,1200,1100,100,0.9166666666666666,13,11,2,362.57049492151873,0.8175087108013938,0.2166770307231083,0.22393780273218244,133330.62967691966,1268.3504780316875,134598.98015495136,3120,13,645.9047619047619,37,5,18,32.44229306012669,0.6517454954954955,41.80372807017543,1032.785087719297,27.91311047889992,0
3159,4,0,0,41,0.0,0.0,1.0,41,1300,900,400,0.6923076923076923,17,9,8,367.60632535805263,0.8173272357723578,0.208725583820349,0.22666996618749044,133268.65875588416,1598.0803861293598,134866.7391420135,3121,14,657.7073170731708,36,5,18,32.37448649434689,0.6530671296296298,41.86373873873873,1032.5450450450442,28.681806806806783,0
3160,4,0,0,41,0.0,0.0,1.0,41,1200,700,500,0.5833333333333334,17,7,10,371.1437127084651,0.8153455284552845,0.21383871135161114,0.23029480269450192,133502.12358807,1709.8501101944817,135211.97369826448,3122,15,658.7073170731708,35,6,18,32.04877832530704,0.6574404761904763,41.637731481481474,1033.449074074073,29.52711640211637,0
3161,4,0,0,41,0.0,0.0,1.0,41,1250,1000,250,0.8,15,10,5,369.6201261773484,0.8153455284552845,0.21013301286428354,0.22953461243141285,133532.02830289755,1671.2250300068324,135203.2533329044,3123,16,659.7073170731708,35,6,18,32.05813736468831,0.6577380952380953,41.60879629629628,1033.564814814813,29.53042328042323,0
3162,4,0,1,40,0.0,0.024390243902439025,0.975609756097561,41,950,800,150,0.8421052631578947,11,8,3,369.0628261978048,0.8148373983739837,0.2109506214309711,0.229373702211036,133561.93636670493,1658.549141589469,135220.4855082944,3124,17,660.7073170731708,35,6,18,32.04253443063486,0.6580357142857145,41.57986111111109,1033.680555555553,29.533730158730084,0
3163,4,0,0,40,0.0,0.0,1.0,40,1200,900,300,0.75,15,9,6,364.59083941180825,0.8133279914529915,0.2039066753784171,0.22729380029318602,133675.94103816632,1747.4047104536721,135423.34574862,3125,18,669.925,36,4,18,32.04381284257142,0.6571180555555557,41.46959459459458,1034.1216216216199,28.72560060060055,0
3164,4,0,0,40,0.0,0.0,1.0,40,900,500,400,0.5555555555555556,13,5,8,366.42818682919227,0.8127938034188035,0.2106614044638,0.22879965302692912,133734.17494775163,1800.7942486405132,135534.96919639214,3126,19,670.925,36,4,17,31.937942297223735,0.6576967592592593,41.41328828828828,1034.3468468468454,28.73185685685682,0
3165,4,0,0,40,0.0,0.0,1.0,40,1200,800,400,0.6666666666666666,16,8,8,366.4803371218899,0.8129540598290599,0.21445048966267755,0.22973767381651855,133879.81520371692,1812.8639619348776,135692.6791656518,3127,20,671.925,36,4,17,31.790669205658325,0.6591435185185187,41.27252252252251,1034.9099099099076,28.747497497497434,0
3166,4,0,0,40,0.0,0.0,1.0,40,1250,700,550,0.56,18,7,11,365.66312565498845,0.8128472222222223,0.20651913875598105,0.2303176783235117,134054.6881340799,1803.7712543624534,135858.45938844234,3128,21,672.925,36,4,17,31.63671705089168,0.6608796296296298,41.103603603603595,1035.5855855855843,28.766266266266232,0
3167,4,0,0,40,0.0,0.0,1.0,40,650,400,250,0.6153846153846154,9,4,5,364.995633025908,0.8122596153846153,0.20763209393346438,0.23026267713115903,134113.00447406853,1790.132193003803,135903.13666707234,3129,22,673.925,36,4,18,31.59563673262303,0.6614583333333335,41.04729729729729,1035.8108108108097,28.772522522522493,0
3168,4,0,0,40,0.0,0.0,1.0,40,450,300,150,0.6666666666666666,6,3,3,366.2664099205593,0.8115918803418803,0.2081883900423962,0.23124809230330984,134142.16739966313,1826.3540144874578,135968.5214141506,3130,23,674.925,36,4,18,31.53354531289632,0.6617476851851851,41.01914414414414,1035.9234234234232,28.775650650650643,0
3169,4,0,0,40,0.0,0.0,1.0,40,1350,800,550,0.5925925925925926,19,8,11,367.37485351739315,0.8105769230769231,0.20960827990872533,0.23268759648455395,134258.85080604246,1864.6651296566752,136123.51593569914,3131,24,675.925,36,4,18,31.38808902893983,0.6629050925925927,40.90653153153153,1036.3738738738734,28.78816316316315,0
3170,4,0,1,39,0.0,0.025,0.975,40,1500,900,600,0.6,21,9,12,396.9195099104807,0.810443376068376,0.22654934321320308,0.24198234598033203,132845.06715374222,2552.7632036245036,135397.8303573667,3132,25,676.925,35,5,16,32.044669922532826,0.6508928571428572,42.27430555555555,1030.9027777777771,29.45436507936506,5
3171,4,0,0,39,0.0,0.0,1.0,39,700,500,200,0.7142857142857143,9,5,4,400.7901796905419,0.8101664417453891,0.2186889323147987,0.24442556029014742,132857.85147392284,2849.624433106571,135707.4759070294,3133,26,675.7435897435897,34,5,16,31.932015011547342,0.6531862745098038,42.26190476190476,1030.9523809523805,30.322128851540604,0
3172,4,0,0,39,0.0,0.0,1.0,39,750,400,350,0.5333333333333333,11,4,7,400.7901796905419,0.8101664417453891,0.2186889323147987,0.24442556029014742,132857.85147392284,2849.624433106571,135707.4759070294,3134,27,676.7435897435897,34,5,16,31.932015011547342,0.6531862745098038,42.26190476190476,1030.9523809523805,30.322128851540604,0
3173,4,0,0,39,0.0,0.0,1.0,39,450,300,150,0.6666666666666666,6,3,3,396.81665136210603,0.8094354475933424,0.21238021238021254,0.2424990647212869,132934.5703125,2750.130208333334,135684.70052083334,3135,28,677.7435897435897,35,4,16,31.95707070707071,0.6517857142857143,42.1875,1031.25,29.464285714285715,0
3174,4,0,0,39,0.0,0.0,1.0,39,700,400,300,0.5714285714285714,10,4,6,396.76373755554096,0.8089856050382367,0.21440512878061968,0.2426603751103242,132964.41139671204,2751.0913655263953,135715.50276223844,3136,29,678.7435897435897,35,4,17,31.928351662738944,0.6520833333333333,42.15856481481481,1031.36574074074,29.46759259259257,0
3175,4,0,0,39,0.0,0.0,1.0,39,950,700,250,0.7368421052631579,12,7,5,397.3215202586199,0.8081983805668016,0.21888066092388314,0.2436586190501656,133065.2506391526,2773.9375355084735,135839.18817466107,3137,30,679.7435897435897,36,3,17,31.81233173251838,0.6510416666666667,42.06081081081081,1031.7567567567562,28.659909909909896,0
3176,4,0,0,39,0.0,0.0,1.0,39,1850,1600,250,0.8648648648648649,21,16,5,399.7519221321345,0.8074673864147549,0.217224189731281,0.24591450458141917,133181.46482631285,2847.909311338367,136029.3741376512,3138,31,680.7435897435897,36,3,17,31.632527820205105,0.6521990740740742,41.9481981981982,1032.2072072072076,28.672422422422432,0
3177,4,0,0,39,0.0,0.0,1.0,39,1450,900,550,0.6206896551724138,20,9,11,399.32507119095715,0.8052744039586145,0.22234524099097186,0.24661348335974861,133326.80389426585,2848.147091348096,136174.95098561395,3139,32,681.7435897435897,36,3,18,31.49715588994293,0.6536458333333335,41.80743243243243,1032.77027027027,28.688063063063055,0
3178,4,0,0,39,0.0,0.0,1.0,39,1200,800,400,0.6666666666666666,16,8,8,397.9849594371715,0.8050494826810617,0.22570475088460795,0.24636396881758493,133414.0453798392,2819.3566877688418,136233.40206760803,3140,33,682.7435897435897,36,3,18,31.443935760482535,0.654513888888889,41.72297297297297,1033.1081081081072,28.697447447447423,0
3179,4,0,0,39,0.0,0.0,1.0,39,700,400,300,0.5714285714285714,10,4,6,397.37458533606707,0.8047121007647323,0.2300428561051786,0.24675940082641573,133530.4117462057,2812.318399480562,136342.73014568628,3141,34,683.7435897435897,36,3,19,31.34261276966659,0.6556712962962963,41.61036036036036,1033.5585585585588,28.709959959959967,0
3180,4,0,0,39,0.0,0.0,1.0,39,700,600,100,0.8571428571428571,8,6,2,396.3658327044204,0.8043747188484031,0.22849002849002886,0.24652021302348112,133588.61395178965,2789.9924417660945,136378.60639355573,3142,35,684.7435897435897,36,3,19,31.310139796659413,0.65625,41.554054054054056,1033.783783783784,28.71621621621622,0
3181,4,0,0,39,0.0,0.0,1.0,39,900,600,300,0.6666666666666666,12,6,6,396.7348061318413,0.8024628879892038,0.2233726199750372,0.2473330430895248,133675.9410381666,2806.7797104537012,136482.7207486203,3143,36,685.7435897435897,36,3,19,31.21279356782459,0.6571180555555556,41.4695945945946,1034.1216216216221,28.725600600600615,0
3182,4,0,0,39,0.0,0.0,1.0,39,1050,900,150,0.8571428571428571,12,9,3,400.34386335066836,0.8013382816014395,0.22295718866960845,0.25037161828472376,133792.42153893766,2912.594985187905,136705.01652412556,3144,37,686.7435897435897,36,3,16,31.002367475781,0.6582754629629629,41.35698198198199,1034.5720720720728,28.738113113113133,0
3183,4,0,0,39,0.0,0.0,1.0,39,950,700,250,0.7368421052631579,12,7,5,404.1796850026438,0.8005510571300045,0.23048752255757599,0.25397292168347946,133967.23740209805,3029.3671627708777,136996.60456486893,3145,38,687.7435897435897,36,3,16,30.72741034845354,0.6600115740740742,41.18806306306306,1035.2477477477478,28.75688188188188,0
3184,4,0,0,39,0.0,0.0,1.0,39,900,600,300,0.6666666666666666,12,6,6,401.2821115573074,0.8001574448942871,0.22769900029280143,0.2525522940293935,134025.5347196858,2956.4099149825383,136981.94463466833,3146,39,688.7435897435897,36,3,16,30.743837230378826,0.6605902777777779,41.13175675675675,1035.4729729729722,28.763138138138117,0
3185,4,0,0,39,0.0,0.0,1.0,39,1300,1200,100,0.9230769230769231,14,12,2,400.9406700912456,0.7999325236167342,0.23089468973996552,0.25273826887108847,134083.8447188741,2951.9333099991672,137035.7780288733,3147,40,689.7435897435897,36,3,16,30.694112210503416,0.6611689814814816,41.07545045045044,1035.698198198197,28.769394394394357,0
3186,4,1,0,40,0.025,0.0,1.0,40,500,200,300,0.4,8,2,6,393.126956584899,0.8012286324786325,0.23824944485566246,0.2500202843593402,134408.61761551627,2567.9301563942663,136976.54777191053,3148,0,673.475,37,3,17,30.570719220330602,0.6624436936936937,40.76206140350877,1036.9517543859645,28.025723091512553,0
3187,4,0,0,40,0.0,0.0,1.0,40,1000,500,500,0.5,15,5,10,393.0581764810248,0.8,0.2396586345381535,0.25095252806096174,134550.78124999985,2577.407231071085,137128.18848107095,3149,1,674.475,35,5,17,30.430053547523435,0.6678571428571429,40.62499999999999,1037.4999999999989,29.64285714285711,0
3188,4,0,0,40,0.0,0.0,1.0,40,800,500,300,0.625,11,5,6,393.88546385534886,0.7992788461538461,0.24038032567477163,0.2518956539890911,134610.82845721874,2604.249721364877,137215.07817858362,3150,2,675.475,35,5,18,30.348445981113837,0.668452380952381,40.567129629629626,1037.731481481481,29.649470899470888,0
3189,4,0,0,40,0.0,0.0,1.0,40,800,500,300,0.625,11,5,6,398.97092873681504,0.7989583333333333,0.24984949832775905,0.255992076592935,134730.96305941354,2750.7474922839438,137481.71055169747,3151,3,676.475,35,5,18,30.09615384615384,0.6696428571428572,40.451388888888886,1038.1944444444441,29.662698412698404,0
3190,4,0,0,40,0.0,0.0,1.0,40,1050,700,350,0.6666666666666666,14,7,7,403.2578269876863,0.7974358974358975,0.24984122562674127,0.25981615198955377,134881.20666420183,2878.38046017661,137759.58712437845,3152,4,677.475,35,5,16,29.83437790157846,0.6711309523809523,40.30671296296296,1038.773148148148,29.6792328042328,0
3191,4,0,0,40,0.0,0.0,1.0,40,1100,600,500,0.5454545454545454,16,6,10,405.82933942202527,0.7954594017094017,0.2493070243793838,0.2632176863558161,135121.7705788109,2967.2757791066533,138089.04635791754,3153,5,678.475,35,5,17,29.526721770752157,0.6735119047619047,40.07523148148148,1039.6990740740741,29.705687830687832,0
3192,4,0,2,38,0.0,0.05,0.95,40,750,500,250,0.6666666666666666,10,5,5,406.6198254742878,0.7944978632478632,0.24962437395659443,0.2641705807582413,135181.9450472609,2993.531780478403,138175.4768277393,3154,6,679.475,35,5,17,29.445951585976626,0.6741071428571428,40.017361111111114,1039.930555555556,29.712301587301603,0
3193,4,0,0,38,0.0,0.0,1.0,38,800,600,200,0.75,10,6,4,415.53377925102563,0.7919926505452821,0.2532747801240589,0.26894184037366237,135045.2823837869,3623.1753117913877,138668.45769557828,3155,7,707.4473684210526,34,4,17,29.351114801664576,0.6749387254901961,40.148809523809526,1039.4047619047622,30.570728291316534,0
3194,4,0,0,38,0.0,0.0,1.0,38,1100,600,500,0.5454545454545454,16,6,10,417.69395134779757,0.7904812707444286,0.25341599190283404,0.2715010683760684,135200.0,3694.4444444444443,138894.44444444444,3156,8,708.4473684210526,34,4,17,29.139957264957264,0.6764705882352942,40.0,1040.0,30.58823529411765,0
3195,4,0,0,38,0.0,0.0,1.0,38,1400,1100,300,0.7857142857142857,17,11,6,413.93400437325454,0.7899774774774775,0.24481603941195207,0.26975162298418154,135292.87308673482,3600.4641439909433,138893.33723072577,3157,9,709.4473684210526,34,4,17,29.1447343326849,0.6773897058823529,39.91071428571429,1040.3571428571438,30.59873949579835,0
3196,4,0,2,36,0.0,0.05263157894736842,0.9473684210526316,38,900,400,500,0.4444444444444444,14,4,10,413.84145643402957,0.7886142721669037,0.2476562358877401,0.27015595001417864,135354.80619331062,3603.0860260770946,138957.89221938772,3158,10,710.4473684210526,34,4,17,29.08515425389926,0.6780024509803921,39.851190476190474,1040.5952380952378,30.60574229691876,0
3197,4,0,0,36,0.0,0.0,1.0,36,1200,700,500,0.5833333333333334,17,7,10,421.88780590172746,0.7870039682539683,0.24053468869788208,0.2758347294475268,135410.37589208485,4225.59727628798,139635.97316837282,3159,11,729.3888888888889,33,3,17,28.82018034459752,0.680871212121212,39.797794117647065,1040.8088235294124,31.539661319073105,0
3198,4,0,0,36,0.0,0.0,1.0,36,1050,700,350,0.6666666666666666,14,7,7,422.5405589480499,0.7873346560846561,0.23844418285265867,0.27675266370575835,135474.15845167733,4248.665327037689,139722.823778715,3160,12,730.3888888888889,33,3,17,28.739331959976468,0.6815025252525253,39.73651960784314,1041.053921568628,31.54708853238267,0
3199,4,0,0,36,0.0,0.0,1.0,36,650,400,250,0.6153846153846154,9,4,5,420.2069632964577,0.7849537037037038,0.2389333385627066,0.2762056443199223,135601.76862564884,4196.161482362559,139797.9301080114,3161,13,731.3888888888889,33,3,17,28.67236831784132,0.6827651515151514,39.6139705882353,1041.5441176470592,31.561942959001794,0
3200,4,0,0,36,0.0,0.0,1.0,36,400,200,200,0.5,6,2,4,420.79999999999995,0.7847222222222223,0.238,0.27684210526315794,135633.6805555556,4214.9343101211125,139848.6148656767,3162,14,732.3888888888889,32,4,17,28.625000000000007,0.685546875,39.583333333333336,1041.666666666667,32.55208333333334,0
3201,4,0,0,36,0.0,0.0,1.0,36,700,500,200,0.7142857142857143,9,5,4,418.29738372695476,0.7828042328042328,0.24137791777723905,0.2762101284225829,135765.23600908084,4158.048604734224,139923.28461381505,3163,15,733.3888888888889,32,4,18,28.558628139891763,0.6868489583333333,39.45707070707071,1042.1717171717182,32.567866161616195,0
3202,4,0,1,35,0.0,0.027777777777777776,0.9722222222222222,36,950,500,450,0.5263157894736842,14,5,9,415.83956149874547,0.782175925925926,0.2452969197852326,0.27534781550081344,135863.94444763302,4099.520616518737,139963.46506415177,3164,16,734.3888888888889,32,4,17,28.524030115861297,0.6878255208333333,39.362373737373744,1042.550505050506,32.57970328282831,0
3203,4,0,1,34,0.0,0.02857142857142857,0.9714285714285714,35,1400,1100,300,0.7857142857142857,17,11,6,415.05391078404386,0.7810224089635854,0.2372523494480805,0.27593335097850413,136006.92960951058,4290.041605631505,140296.97121514208,3165,17,746.4571428571429,31,4,17,28.401702866891362,0.6918682795698925,39.225260416666664,1043.098958333333,33.64835349462365,0
3204,4,0,0,34,0.0,0.0,1.0,34,750,400,350,0.5333333333333333,11,4,7,434.26148695289476,0.7748068924539513,0.2578244147032791,0.26231517015557965,132498.52710300012,4719.707573784713,137218.23467678484,3166,18,755.2941176470588,31,3,19,31.433250073774296,0.6569220430107527,42.61067708333333,1029.5572916666658,33.21152553763438,7
3205,4,0,0,34,0.0,0.0,1.0,34,600,500,100,0.8333333333333334,7,5,2,437.3179781958893,0.7742498514557339,0.2609271326132887,0.26439683268907416,132532.04345703113,4791.729058159708,137323.77251519085,3167,19,756.2941176470588,31,3,19,31.320603608160507,0.6572580645161291,42.57812499999999,1029.687499999999,33.21572580645158,0
3206,4,0,0,34,0.0,0.0,1.0,34,900,700,200,0.7777777777777778,11,7,4,455.2002671432555,0.7742498514557339,0.2554093726215072,0.2546297506161755,129543.23657359234,4996.9462041538445,134540.18277774617,3168,20,757.2941176470588,30,4,16,33.91234266349794,0.6298611111111111,45.49731182795699,1018.0107526881721,33.9336917562724,6
3207,4,0,0,34,0.0,0.0,1.0,34,900,700,200,0.7777777777777778,11,7,4,457.704551123493,0.7745469399881165,0.25574030087094224,0.2569248213639874,129680.10210718005,5071.03458492312,134751.13669210317,3169,21,758.2941176470588,30,4,16,33.70804741796429,0.6312499999999999,45.362903225806456,1018.5483870967745,33.951612903225815,0
3208,4,0,0,34,0.0,0.0,1.0,34,1000,700,300,0.7,13,7,6,454.2259472554021,0.7723559120617944,0.25651418420460614,0.2560888742035477,129851.28564357164,4996.364644756634,134847.65028832827,3170,22,759.2941176470588,30,4,16,33.62098333992703,0.632986111111111,45.19489247311829,1019.2204301075278,33.97401433691759,0
3209,4,1,0,35,0.02857142857142857,0.0,1.0,35,600,500,100,0.8333333333333334,7,5,2,439.7964156639183,0.7794817927170867,0.24629469256464165,0.25016709555323413,130198.14822785964,4452.135783338462,134650.2840111981,3171,0,738.5714285714286,32,3,18,33.63360344756485,0.6311848958333333,44.85479797979799,1020.5808080808099,31.89315025252531,0
3210,4,0,0,35,0.0,0.0,1.0,35,1050,700,350,0.6666666666666666,14,7,7,441.39485672580395,0.7799019607843136,0.24734572700925983,0.25128422688530994,130230.36552392624,4496.6027063565125,134726.96823028277,3172,1,739.5714285714286,32,3,18,33.559861042388256,0.6315104166666665,44.82323232323233,1020.7070707070717,31.89709595959599,0
3211,4,0,0,35,0.0,0.0,1.0,35,1000,800,200,0.8,12,8,4,437.9957209404782,0.776610644257703,0.24080384447356895,0.25127122938164304,130528.56445312515,4434.194523757157,134962.7589768823,3173,2,740.5714285714286,31,4,15,33.3418280665987,0.6370967741935483,44.53125000000001,1021.8750000000011,32.963709677419395,0
3212,4,0,0,35,0.0,0.0,1.0,35,500,400,100,0.8,6,4,2,436.41139555355244,0.776610644257703,0.23738055803287028,0.2505773989539015,130561.83073255759,4395.734151204437,134957.56488376204,3174,3,741.5714285714286,31,4,15,33.348329935872925,0.6374327956989246,44.49869791666667,1022.005208333334,32.96790994623658,0
3213,4,1,1,35,0.027777777777777776,0.027777777777777776,0.9722222222222222,36,750,400,350,0.5333333333333333,11,4,7,424.92391604112004,0.7827380952380953,0.22271580563781956,0.24597024397123113,130875.54841342717,3922.430109172531,134797.9785225997,3175,0,721.9444444444445,32,4,16,33.3220220467259,0.6380208333333334,44.19191919191919,1023.232323232323,31.976010101010093,0
3214,4,0,1,34,0.0,0.02857142857142857,0.9714285714285714,35,850,600,250,0.7058823529411765,11,6,5,432.32054640523387,0.7738095238095237,0.23290550121804876,0.2501601512262393,130861.41798231343,4314.815945095495,135176.23392740893,3176,5,743.5714285714286,31,4,16,33.14721727326716,0.6404569892473118,44.20572916666667,1023.1770833333339,33.005712365591414,0
3215,4,2,1,35,0.05555555555555555,0.027777777777777776,0.9722222222222222,36,750,400,350,0.5333333333333333,11,4,7,416.63517618157636,0.781712962962963,0.21220989936331902,0.24341212776915008,131231.07854109284,3735.0967056933096,134966.17524678615,3177,0,723.7222222222222,32,4,17,33.172365988909434,0.6416015625,43.844696969696976,1024.621212121213,32.019412878787904,0
3216,4,0,0,35,0.0,0.0,1.0,35,1050,800,250,0.7619047619047619,13,8,5,422.2983756641419,0.7738795518207282,0.21968189410995675,0.24648691540990145,131194.6953667536,4080.6613498264082,135275.35671658002,3178,1,745.4,31,4,17,33.064311133706155,0.6438172043010751,43.88020833333334,1024.4791666666679,33.04771505376348,0
3217,4,1,1,35,0.027777777777777776,0.027777777777777776,0.9722222222222222,36,650,400,250,0.6153846153846154,9,4,5,411.69414641443404,0.7830026455026455,0.2037333442775453,0.24195223279146433,131457.5760764209,3624.0629144985433,135081.63899091945,3179,0,725.6666666666666,32,4,17,33.06887671345318,0.6438802083333333,43.623737373737384,1025.5050505050517,32.047032828282866,0
3218,4,0,0,35,0.0,0.0,1.0,35,850,400,450,0.47058823529411764,13,4,9,419.1703300579487,0.7725490196078431,0.21392834467120148,0.24615707302060771,131428.24172973647,4018.1638929579144,135446.40562269438,3180,3,747.4,31,4,18,32.907010582010585,0.6461693548387096,43.65234375000001,1025.3906250000011,33.07711693548391,0
3219,4,0,0,35,0.0,0.0,1.0,35,950,700,250,0.7368421052631579,12,7,5,417.2020107863497,0.7712184873949579,0.21090196931781047,0.24564405388451918,131528.39660644546,3974.7823079427226,135503.17891438818,3181,4,748.4,31,4,18,32.8557374968266,0.6471774193548386,43.55468750000001,1025.7812500000011,33.08971774193552,0
3220,4,0,0,35,0.0,0.0,1.0,35,1000,800,200,0.8,12,8,4,417.1419886801643,0.7711484593837534,0.21016818093949374,0.24661434370771323,131684.2689043211,3986.207561728411,135670.4764660495,3182,5,749.4,32,3,15,32.699030221019406,0.6461588541666665,43.402777777777786,1026.3888888888898,32.07465277777781,0
3221,4,0,0,35,0.0,0.0,1.0,35,700,500,200,0.7142857142857143,9,5,4,416.3395652933838,0.7705882352941176,0.21494959429554927,0.24719022073696248,131846.31191970222,3978.567238036949,135824.87915773917,3183,6,750.4,32,3,15,32.55522088353413,0.6477864583333333,43.2449494949495,1027.020202020203,32.09438131313134,0
3222,4,0,0,35,0.0,0.0,1.0,35,650,500,150,0.7692307692307693,8,5,3,399.0449880130181,0.7705882352941176,0.12095549443896703,0.21498451115456715,128051.48748378019,3247.117399027177,131298.60488280735,3184,7,751.4,33,2,18,36.86975319853089,0.6070075757575759,46.96691176470588,1012.1323529411758,30.670677361853812,7
3223,4,0,0,35,0.0,0.0,1.0,35,550,0,550,0.0,11,0,11,399.1319633232585,0.7698879551820728,0.12395593753782896,0.21536441208448315,128113.51290669451,3226.8395869377155,131340.35249363224,3185,8,752.4,33,2,18,36.80383226405199,0.6076388888888888,46.90563725490196,1012.3774509803919,30.678104575163392,0
3224,4,0,0,35,0.0,0.0,1.0,35,750,600,150,0.8,9,6,3,401.6600198369965,0.7692577030812324,0.12345336040175248,0.21741677996844727,128240.42986685042,3301.814475410379,131542.2443422608,3186,9,753.4,32,3,18,36.60948017950637,0.611328125,46.78030303030304,1012.8787878787887,31.652462121212146,0
3225,4,2,2,35,0.05405405405405406,0.05405405405405406,0.9459459459459459,37,1100,800,300,0.7272727272727273,14,8,6,386.0127949658685,0.7919169169169169,0.10309206437784546,0.21146356454299925,128717.71541950136,2537.3370181406194,131255.05243764198,3187,0,713.6216216216217,34,3,13,36.516746832473025,0.6115196078431371,46.309523809523824,1014.7619047619066,29.845938375350194,0
3226,4,3,2,36,0.07894736842105263,0.05263157894736842,0.9473684210526316,38,700,400,300,0.5714285714285714,10,4,6,376.4846023530972,0.7912517780938834,0.10220304669222102,0.20772278885793827,129001.10995708557,2113.3863170603136,131114.49627414587,3188,0,695.7631578947369,36,2,14,36.46884122233308,0.6102430555555556,46.03040540540541,1015.8783783783792,28.218843843843867,0
3227,4,2,1,37,0.05263157894736842,0.02631578947368421,0.9736842105263158,38,1100,800,300,0.7272727272727273,14,8,6,373.9104015157754,0.792111190137506,0.1436144696867201,0.21024475796136663,129746.60572562338,2103.0317876480776,131849.63751327145,3189,0,696.7105263157895,34,4,17,35.77403209472618,0.621936274509804,45.29761904761904,1018.8095238095221,29.96498599439771,2
3228,4,1,1,37,0.02631578947368421,0.02631578947368421,0.9736842105263158,38,650,400,250,0.6153846153846154,9,4,5,372.35312635774903,0.7980381697486961,0.1485410664977227,0.20991943858555281,129849.38298396766,2069.964741941001,131919.34772590865,3190,0,697.6842105263158,35,3,17,35.70908092966916,0.6208333333333333,45.19675925925925,1019.212962962962,29.120370370370342,0
3229,4,2,1,38,0.05128205128205128,0.02564102564102564,0.9743589743589743,39,500,300,200,0.6,7,3,4,363.75766106047894,0.802519118308592,0.1512993132019731,0.20664628005448274,130147.65346004788,1668.441203027351,131816.09466307523,3191,0,680.7435897435897,36,3,19,35.62497700768863,0.6218171296296295,44.90427927927928,1020.3828828828828,28.343968968968966,0
3230,4,0,0,38,0.0,0.0,1.0,38,900,700,200,0.7777777777777778,11,7,4,368.4110960710705,0.7917852062588905,0.1548878152490043,0.20879787714947554,130055.90284475735,1982.807543509942,132038.7103882673,3192,1,699.6578947368421,35,3,20,35.599516812284875,0.6229166666666666,44.99421296296296,1020.0231481481479,29.143518518518512,0
3231,4,0,0,38,0.0,0.0,1.0,38,750,500,250,0.6666666666666666,10,5,5,370.1745537476424,0.7923482693219536,0.15275357267340506,0.2101366827665191,130118.92804967146,2033.343224981759,132152.27127465323,3193,2,700.6578947368421,36,2,20,35.49048013245035,0.6215277777777777,44.93243243243244,1020.2702702702717,28.34084084084088,0
3232,4,0,0,38,0.0,0.0,1.0,38,1000,700,300,0.7,13,7,6,346.92634979483717,0.7928224276908488,0.07588482999431556,0.1989892350213875,130521.37230135534,1456.3399125476772,131977.71221390303,3194,3,701.6578947368421,36,2,13,35.675648372639785,0.6255787037037037,44.538288288288285,1021.8468468468463,28.384634634634622,5
3233,4,0,3,35,0.0,0.07894736842105263,0.9210526315789473,38,750,500,250,0.6666666666666666,10,5,5,346.17570523900736,0.792674253200569,0.07441836190299478,0.19885384181957133,130578.91506371221,1440.6496023049924,132019.5646660172,3195,4,702.6578947368421,36,2,13,35.636568973115914,0.6261574074074074,44.481981981981974,1022.0720720720708,28.390890890890855,0
3234,4,1,2,34,0.027777777777777776,0.05555555555555555,0.9444444444444444,36,650,500,150,0.7692307692307693,8,5,3,361.9991976213129,0.7767526455026456,0.0925526680392077,0.2072258248691451,130444.94224773238,2244.19288548752,132689.1351332199,3196,0,742.1944444444445,34,2,18,35.368109777415214,0.6289828431372548,44.613095238095234,1021.5476190476187,30.045518207282903,0
3235,4,0,0,34,0.0,0.0,1.0,34,1250,900,350,0.72,16,9,7,376.67638483964987,0.765857100415924,0.10984393757502975,0.21461794019933564,130262.58680555565,3013.368055555565,133275.9548611112,3197,20,785.4411764705883,32,2,18,35.17857142857142,0.6318359375,44.79166666666667,1020.8333333333342,31.901041666666693,0
3236,4,0,0,34,0.0,0.0,1.0,34,950,700,250,0.7368421052631579,12,7,5,376.47204063917235,0.7650029708853239,0.06508228291316542,0.21082434275793646,129586.77685950411,2957.1596648301165,132543.93652433422,3198,21,786.4411764705883,32,2,18,35.871620783730165,0.625,45.45454545454545,1018.181818181818,31.818181818181813,4
3237,4,0,0,34,0.0,0.0,1.0,34,900,700,200,0.7777777777777778,11,7,4,392.33812916252725,0.765188651218063,0.061067254496396606,0.20499854313965724,126814.13286055827,3150.8039275759083,129964.93678813418,3199,22,787.4411764705883,33,1,17,38.313029768422744,0.5943813131313131,48.1924019607843,1007.2303921568614,30.52213309566247,8
3238,4,4,1,37,0.10526315789473684,0.02631578947368421,0.9736842105263158,38,600,400,200,0.6666666666666666,8,4,4,333.808644616717,0.8010609293504031,0.07668992860989832,0.1744235614021139,126815.75701177288,912.699194991196,127728.45620676407,3200,0,705.4473684210526,37,1,18,39.78518034690472,0.5861486486486486,48.19078947368421,1007.2368421052633,27.222617354196306,6
3239,4,2,1,38,0.05128205128205128,0.02564102564102564,0.9743589743589743,39,800,500,300,0.625,11,5,6,326.6436672967865,0.8126968061178588,0.08541806020066911,0.17231202632628642,127202.60080024623,510.28537626962435,127712.88617651585,3201,0,688.3076923076923,37,2,19,39.56929347826088,0.5900900900900901,47.80701754385965,1008.7719298245614,27.264106211474633,0
3240,4,5,2,41,0.11627906976744186,0.046511627906976744,0.9534883720930233,43,1050,700,350,0.6666666666666666,14,7,7,304.2811014381489,0.8413159837578442,0.10347971155862212,0.1641059386403209,128094.31295666425,-804.6642731166477,127289.6486835476,3202,0,625.1627906976744,41,2,21,39.22399712531033,0.5924796747967478,46.92460317460318,1012.3015873015881,24.690282617111905,0
3241,4,1,0,42,0.023809523809523808,0.0,1.0,42,900,600,300,0.6666666666666666,12,6,6,312.0197658102286,0.8308894696089818,0.11383629757123703,0.1681664971574612,128067.37061273083,-408.0898026967752,127659.28081003405,3203,0,641.0238095238095,40,2,22,39.05559738955822,0.5937499999999998,46.95121951219514,1012.1951219512221,25.30487804878055,0
3242,4,1,0,43,0.023255813953488372,0.0,1.0,43,700,300,400,0.42857142857142855,11,3,8,305.37190529778377,0.8391934293097083,0.11788555691554414,0.16577332001879697,128355.55555555568,-760.7174135765649,127594.83814197911,3204,0,627.0930232558139,39,4,23,38.93057839912281,0.5982905982905983,46.66666666666667,1013.3333333333344,25.98290598290601,0
3243,4,2,2,43,0.044444444444444446,0.044444444444444446,0.9555555555555556,45,1300,800,500,0.6153846153846154,18,8,10,296.7469557097171,0.8533670033670034,0.12907736738106146,0.16309926663443824,128848.6207561727,-1352.912808641987,127495.70794753073,3205,0,600.1777777777778,41,4,19,38.648540811673506,0.6001016260162602,46.18055555555555,1015.2777777777767,24.76287262872626,0
3244,4,1,1,43,0.022727272727272728,0.022727272727272728,0.9772727272727273,44,1100,800,300,0.7272727272727273,14,8,6,302.36911949610635,0.8459082100070473,0.13057433508339344,0.1662614129271104,128865.8177692675,-1006.991229592187,127858.82653967531,3206,0,614.75,40,4,20,38.48838955059555,0.6018229166666667,46.163617886178855,1015.3455284552834,25.383638211382085,0
3245,4,0,0,43,0.0,0.0,1.0,43,1650,1300,350,0.7878787878787878,20,13,7,309.44204503300296,0.8388242894056848,0.1270026745000734,0.17015054881258831,128865.81776926751,-624.69956292552,128241.11820634198,3207,1,629.953488372093,40,3,20,38.30885296767091,0.6018229166666667,46.163617886178855,1015.3455284552836,25.383638211382088,0
3246,4,0,1,42,0.0,0.023255813953488372,0.9767441860465116,43,600,200,400,0.3333333333333333,10,2,8,307.07117486421384,0.8392395717977112,0.12558232613986986,0.16917691960269868,128943.21852898407,-681.0508791063551,128262.16764987771,3208,2,630.953488372093,40,3,20,38.290474284570735,0.6026041666666667,46.08739837398374,1015.650406504065,25.391260162601625,0
3247,4,0,0,42,0.0,0.0,1.0,42,1100,800,300,0.7272727272727273,14,8,6,314.98224852071,0.8339140534262486,0.12559218559218555,0.17350717079530623,128936.76757812488,-277.44140625001506,128659.32617187487,3209,3,646.7857142857143,39,3,21,38.09615384615384,0.6041666666666667,46.09374999999999,1015.6249999999991,26.041666666666643,0
3248,4,0,1,41,0.0,0.023809523809523808,0.9761904761904762,42,900,600,300,0.6666666666666666,12,6,6,313.3821733008388,0.83454316686024,0.12499107053562564,0.17321770872499068,129072.27143441375,-310.2102130015488,128762.0612214122,3210,4,647.7857142857143,40,2,21,37.999216588325496,0.6039062500000001,45.96036585365852,1016.1585365853634,25.403963414634084,0
3249,4,0,0,41,0.0,0.0,1.0,41,1800,1500,300,0.8333333333333334,21,15,6,321.94680000000017,0.8313516260162601,0.1306243902439026,0.17806792035398214,129098.08976138517,112.54337695813572,129210.6331383433,3211,5,664.3414634146342,40,1,21,37.75541666666666,0.6041666666666667,45.934959349593484,1016.2601626016241,25.4065040650406,0
3250,4,1,1,41,0.023809523809523808,0.023809523809523808,0.9761904761904762,42,1250,900,350,0.72,16,9,7,320.250976501953,0.8393583042973287,0.13428571428571434,0.1786989192256064,129445.89548405648,-108.8411792460629,129337.05430481042,3212,0,649.5,38,4,17,37.44553805774278,0.6110197368421053,45.592948717948715,1017.6282051282047,26.779689608636968,0
3251,4,2,1,42,0.046511627906976744,0.023255813953488372,0.9767441860465116,43,800,500,300,0.625,11,5,6,312.10140472815016,0.8385935769656699,0.1378227992580967,0.17542251369202924,129731.4453125,-502.1267361111113,129229.31857638889,3213,0,635.3488372093024,39,4,18,37.36366734832991,0.6121794871794872,45.3125,1018.75,26.121794871794872,0
3252,4,0,0,42,0.0,0.0,1.0,42,1000,800,200,0.8,12,8,4,323.2458955649833,0.8321476964769647,0.14731939287342866,0.17766372154737034,128848.62075617275,-70.04243827161585,128778.57831790113,3214,1,651.4761904761905,38,4,18,37.975946192430456,0.6049890350877194,46.18055555555555,1015.277777777777,26.717836257309923,1
3253,4,0,1,41,0.0,0.023809523809523808,0.9761904761904762,42,1000,600,400,0.6,14,6,8,321.7614588976641,0.831833139759969,0.1379239537632473,0.177454057494141,128984.24373584626,-99.56831214844468,128884.67542369782,3215,2,652.4761904761905,38,4,19,37.875780044874496,0.606359649122807,46.047008547008545,1015.8119658119655,26.731893837156985,0
3254,4,1,0,42,0.023809523809523808,0.0,1.0,42,1050,500,550,0.47619047619047616,16,5,11,324.46153370061734,0.8288085559427023,0.13495144633934708,0.18005576313619523,129229.25954380188,-13.832621496831308,129215.42692230505,3216,0,653.1904761904761,37,5,20,37.55830098134369,0.6106418918918919,45.805921052631575,1016.7763157894731,27.480440967283055,0
3255,4,1,1,42,0.023255813953488372,0.023255813953488372,0.9767441860465116,43,950,700,250,0.7368421052631579,12,7,5,319.6815378563408,0.8360095976375046,0.13580048034678716,0.1787515077872778,129527.44904667977,-318.49317882972105,129208.95586785005,3217,0,638.9767441860465,38,5,18,37.37733522250211,0.6118421052631579,45.51282051282051,1017.9487179487176,26.788124156545198,0
3256,4,1,1,42,0.023255813953488372,0.023255813953488372,0.9767441860465116,43,600,300,300,0.5,9,3,6,318.6416525507136,0.8404392764857881,0.1334904210634158,0.17891222116716737,129690.63321827743,-335.03246219592484,129355.6007560815,3218,0,612.1860465116279,38,5,18,37.23843612334803,0.6134868421052632,45.3525641025641,1018.5897435897434,26.80499325236167,0
3257,4,0,0,42,0.0,0.0,1.0,42,950,700,250,0.7368421052631579,12,7,5,327.6928837185385,0.8346157568718544,0.13614821197759586,0.1832711284604166,129536.03512619282,89.60737919361264,129625.64250538642,3219,2,627.7619047619048,37,5,18,37.16474579922447,0.6137387387387387,45.50438596491229,1017.9824561403519,27.513039355144645,0
3258,4,1,1,42,0.023255813953488372,0.023255813953488372,0.9767441860465116,43,1250,900,350,0.72,16,9,7,335.5799999999999,0.8386397194536729,0.14129715762273887,0.18238043478260865,128401.20525931337,162.0744996325202,128563.2797589459,3220,0,614.1395348837209,36,7,15,38.11875,0.6041666666666667,46.62162162162162,1013.5135135135135,28.153153153153156,8
3259,4,0,0,42,0.0,0.0,1.0,42,1500,1300,200,0.8666666666666667,17,13,4,348.2600659868425,0.8357771970576848,0.14727759110038163,0.18944482347284253,128437.66744898829,545.9421081961536,128983.60955718443,3221,1,629.5952380952381,35,7,16,37.760238258354256,0.6065476190476191,46.585648148148145,1013.657407407407,28.9616402116402,0
3260,4,3,4,41,0.06666666666666667,0.08888888888888889,0.9111111111111111,45,1100,700,400,0.6363636363636364,15,7,8,335.9769847195272,0.8569865319865321,0.14198903642928262,0.18513710942635198,128950.68825263533,-290.0702367703964,128660.61801586494,3222,0,588.5555555555555,37,8,19,37.54891773723415,0.6078265765765766,46.080043859649116,1015.6798245614027,27.4508060692271,4
3261,4,2,2,41,0.046511627906976744,0.046511627906976744,0.9534883720930233,43,1550,1300,250,0.8387096774193549,18,13,5,353.4501956542487,0.8394702842377261,0.1591321222918587,0.19426473159643284,128848.62075617276,508.31404320986593,129356.93479938262,3223,0,616.7441860465116,35,8,20,37.209302325581376,0.6107142857142858,46.18055555555555,1015.2777777777771,29.00793650793649,0
3262,4,2,1,42,0.046511627906976744,0.023255813953488372,0.9767441860465116,43,1350,900,450,0.6666666666666666,18,9,9,352.5887358675069,0.8382244370616463,0.16916498434246297,0.19465559266949542,129024.94454089514,498.54841820988895,129523.49295910503,3224,0,617.6976744186046,35,8,21,37.05143540669857,0.6124999999999999,46.00694444444445,1015.972222222223,29.0277777777778,0
3263,4,1,0,43,0.023255813953488372,0.0,1.0,43,1250,700,550,0.56,18,7,11,355.5210812302947,0.8374400147655962,0.17003769054593376,0.19700974832816895,129172.76810171662,584.7284362064872,129757.4965379231,3225,0,618.6744186046511,36,7,22,36.82632657582809,0.6119791666666666,45.86148648648649,1016.5540540540543,28.23761261261262,0
3264,4,2,2,43,0.044444444444444446,0.044444444444444446,0.9555555555555556,45,1800,1200,600,0.6666666666666666,24,12,12,341.36264179041405,0.8477693602693603,0.16595857472831188,0.1920137594684354,129760.92470689715,-140.8840769769323,129620.04062992021,3226,0,592.1333333333333,35,10,18,36.58849729258963,0.6199404761904763,45.2835648148148,1018.8657407407396,29.110449735449702,0
3265,4,1,2,42,0.022727272727272728,0.045454545454545456,0.9545454545454546,44,1050,700,350,0.6666666666666666,14,7,7,355.83848053647137,0.8402484143763214,0.19309689609783054,0.20101588042970556,129928.59977324243,446.719104308365,130375.31887755079,3227,0,606.5681818181819,34,10,19,36.04940253775494,0.6237745098039217,45.119047619047606,1019.5238095238078,29.985994397759054,0
3266,4,0,0,42,0.0,0.0,1.0,42,1650,1300,350,0.7878787878787878,20,13,7,365.6946622233011,0.8361401471157569,0.18543488093806748,0.20620220377703005,129856.32216274974,1097.5527741733772,130953.87493692312,3228,1,623.5,33,9,19,35.87168349965934,0.6253156565656567,45.18995098039215,1019.2401960784301,30.886066547831216,0
3267,4,0,0,42,0.0,0.0,1.0,42,800,400,400,0.5,12,4,8,368.0785410502958,0.8363579171506,0.19049908424908435,0.2080443927675586,129950.01922337568,1166.362697039608,131116.3819204153,3229,2,624.5,33,9,19,35.715645032051285,0.6262626262626263,45.09803921568628,1019.6078431372554,30.897207367795616,0
3268,4,1,0,43,0.023255813953488372,0.0,1.0,43,1250,900,350,0.72,16,9,7,359.9356411841259,0.8408084163898117,0.1860410900603695,0.20572204301922833,130384.14292800457,785.9800170068107,131170.1229450114,3230,0,610.953488372093,34,9,20,35.482476590123184,0.6283700980392157,44.67261904761905,1021.3095238095241,30.038515406162475,0
3269,4,2,2,43,0.044444444444444446,0.044444444444444446,0.9555555555555556,45,800,400,400,0.5,12,4,8,337.3570542115995,0.8503367003367004,0.16413190084182117,0.19234988126766372,130289.85407991812,-209.15972678794094,130080.69435313018,3231,0,584.7555555555556,38,7,18,36.15442305009068,0.6195175438596492,44.76495726495726,1020.9401709401704,26.866846603688696,3
3270,4,0,0,43,0.0,0.0,1.0,43,1100,1000,100,0.9090909090909091,12,10,2,349.1023504421643,0.8420542635658914,0.16836895836845933,0.19795942778692052,130076.5638563369,482.00683593750495,130558.5706922744,3232,1,612.9302325581396,39,4,18,36.07093927635385,0.6156517094017094,44.973958333333336,1020.1041666666674,26.156517094017115,0
3271,4,1,1,43,0.022727272727272728,0.022727272727272728,0.9772727272727273,44,1100,600,500,0.5454545454545454,16,6,10,342.72732835172707,0.8499823819591262,0.16806078825619375,0.19583818013914014,130374.54433094797,136.98261574475129,130511.52694669273,3233,0,599.9772727272727,37,7,19,35.93157254312506,0.6221846846846846,44.68201754385965,1021.2719298245613,27.60194404931247,0
3272,4,1,1,43,0.022727272727272728,0.022727272727272728,0.9772727272727273,44,1050,700,350,0.6666666666666666,14,7,7,341.3114930672147,0.8493217054263567,0.1810334743532256,0.1967287382166155,130710.70545744819,122.61320791009655,130833.31866535828,3234,0,600.7727272727273,37,7,17,35.62754664379154,0.6255630630630632,44.35307017543858,1022.5877192982435,27.637505926979554,0
3273,4,1,2,42,0.022727272727272728,0.045454545454545456,0.9545454545454546,44,1150,600,550,0.5217391304347826,17,6,11,339.12514682696724,0.8465248414376322,0.1782581453634089,0.19610280229559401,130835.79881656796,73.94189677842544,130909.74071334639,3235,0,601.0227272727273,38,6,17,35.55699143692564,0.625,44.230769230769226,1023.0769230769223,26.923076923076902,0
3274,4,0,1,41,0.0,0.023809523809523808,0.9761904761904762,42,1200,800,400,0.6666666666666666,16,8,8,344.5463077651824,0.8440766550522648,0.1835130278526509,0.19888168062089207,130766.77439212042,611.0418590335219,131377.81625115394,3236,2,627.047619047619,37,5,18,35.48813607775872,0.6261261261261262,44.298245614035075,1022.8070175438578,27.64343290659075,0
3275,4,0,0,41,0.0,0.0,1.0,41,1100,700,400,0.6363636363636364,15,7,8,351.99015893996585,0.8369410569105691,0.18941938454133567,0.20258989147878032,130654.64854570634,997.8301015697077,131652.47864727606,3237,3,643.219512195122,37,4,18,35.41130416130416,0.625,44.4078947368421,1022.3684210526313,27.631578947368414,0
3276,4,0,0,41,0.0,0.0,1.0,41,900,500,400,0.5555555555555556,13,5,8,355.70489690277543,0.8351117886178862,0.19030141426816183,0.20562123222446665,130822.85534972283,1106.8660549399588,131929.7214046628,3238,4,644.219512195122,37,4,18,35.146034297963546,0.6266891891891893,44.24342105263157,1023.0263157894723,27.649359886201953,0
3277,4,0,0,41,0.0,0.0,1.0,41,1450,1100,350,0.7586206896551724,18,11,7,358.0936111533322,0.8346544715447154,0.19475620206073518,0.20790808169947156,130991.17036011047,1181.4202446906345,132172.5906048011,3239,5,645.219512195122,37,4,19,34.91457797772064,0.6283783783783785,44.078947368421034,1023.6842105263131,27.66714082503549,0
3278,4,0,0,41,0.0,0.0,1.0,41,1500,1200,300,0.8,18,12,6,363.47431480181496,0.8342987804878049,0.19975403479546006,0.21180371644190574,131131.5155264117,1332.5875509771934,132464.1030773889,3240,6,646.219512195122,37,4,21,34.63483121007743,0.6297860360360361,43.94188596491227,1024.2324561403489,27.681958274063483,0
3279,4,1,1,41,0.023809523809523808,0.023809523809523808,0.9761904761904762,42,1400,1000,400,0.7142857142857143,18,10,8,357.0830934170364,0.8384630274874177,0.18979898957325592,0.20979815700762222,131446.7860510974,987.926839253008,132434.71289035043,3241,0,631.8095238095239,35,7,21,34.47987208427389,0.6369047619047619,43.63425925925926,1025.462962962963,29.2989417989418,0
3280,4,0,0,41,0.0,0.0,1.0,41,1100,900,200,0.8181818181818182,13,9,4,366.28558162079884,0.8326219512195122,0.21082867057397614,0.20775039359110162,130085.41907793208,1329.6826774691385,131415.1017554012,3242,8,648.219512195122,35,6,21,35.62372362151125,0.6232142857142856,44.96527777777778,1020.1388888888887,29.146825396825392,3
3281,4,1,1,41,0.023809523809523808,0.023809523809523808,0.9761904761904762,42,1250,1100,150,0.88,14,11,3,360.1290754781212,0.8372048006194348,0.2071341934061086,0.2057977684632062,130377.57087746535,990.5508126369654,131368.1216901023,3243,0,633.7619047619048,36,6,21,35.484204432682766,0.6241319444444444,44.679054054054056,1021.2837837837842,28.368993993994007,0
3282,4,0,0,41,0.0,0.0,1.0,41,1000,900,100,0.9,11,9,2,374.1875984806953,0.8314024390243903,0.22187824779426402,0.2138491819296408,130380.76560356647,1557.3731138545904,131938.13871742107,3244,10,650.219512195122,35,6,21,35.122015714717435,0.6261904761904762,44.675925925925924,1021.2962962962958,29.179894179894166,0
3283,4,0,0,41,0.0,0.0,1.0,41,950,700,250,0.7368421052631579,12,7,5,379.2651614103231,0.8307418699186991,0.23206782526540848,0.2175784347038169,130528.5644531249,1700.98741319443,132229.55186631932,3245,11,651.219512195122,35,6,14,34.84221032959565,0.6276785714285715,44.53124999999999,1021.8749999999992,29.196428571428548,0
3284,4,0,0,41,0.0,0.0,1.0,41,1000,600,400,0.6,14,6,8,378.4305965727133,0.8297256097560975,0.23293469887036733,0.21776400387796574,130646.86381440745,1688.1541227280375,132335.01793713548,3246,12,652.219512195122,35,6,14,34.743410128684104,0.6288690476190477,44.41550925925925,1022.3379629629619,29.209656084656054,0
3285,4,0,0,41,0.0,0.0,1.0,41,1350,900,450,0.6666666666666666,18,9,9,375.7658214459045,0.8283028455284552,0.22661566737867034,0.2170600215646339,130794.81336805533,1629.6440972221972,132424.45746527752,3247,13,653.219512195122,35,6,14,34.66140529531568,0.6303571428571428,44.27083333333332,1022.9166666666648,29.226190476190425,0
3286,4,0,0,41,0.0,0.0,1.0,41,450,300,150,0.6666666666666666,6,3,3,377.0454683871058,0.8280487804878048,0.22361078678465862,0.21836916323987446,130895.62694028488,1670.7205939047162,132566.3475341896,3248,14,654.219512195122,36,5,15,34.52642969810353,0.6293402777777778,44.1722972972973,1023.3108108108108,28.4253003003003,0
3287,4,0,0,41,0.0,0.0,1.0,41,1000,700,300,0.7,13,7,6,377.32623443757893,0.827489837398374,0.22287386882228755,0.2191867602090753,131010.890007406,1686.7691593620616,132697.65916676805,3249,15,655.219512195122,36,5,16,34.40238514281525,0.6304976851851851,44.05968468468468,1023.7612612612608,28.437812812812798,0
3288,4,0,0,41,0.0,0.0,1.0,41,1100,800,300,0.7272727272727273,14,8,6,375.47335694539424,0.8265243902439025,0.2207484680674181,0.21876554653544927,131126.20380092936,1646.879184928177,132773.08298585753,3250,16,656.219512195122,36,5,18,34.33296683159245,0.6316550925925926,43.947072072072075,1024.211711711712,28.450325325325334,0
3289,4,0,0,41,0.0,0.0,1.0,41,1250,1000,250,0.8,15,10,5,377.666706919454,0.8256605691056911,0.21720182256767617,0.22087191728579914,131270.41737683647,1715.2932493304372,132985.7106261669,3251,17,657.219512195122,36,5,18,34.13072344322345,0.6331018518518517,43.80630630630632,1024.7747747747762,28.465965965966006,0
3290,4,0,0,41,0.0,0.0,1.0,41,850,500,350,0.5882352941176471,12,5,7,379.92670610513096,0.8256097560975609,0.20741617446357852,0.22323933467869014,131450.17715419497,1788.3119278268869,133238.48908202187,3252,18,658.219512195122,34,7,19,33.890807600030946,0.639093137254902,43.63095238095238,1025.4761904761904,30.161064425770306,0
3291,4,0,0,41,0.0,0.0,1.0,41,1000,700,300,0.7,13,7,6,381.2846519054186,0.8254573170731707,0.21128020472405318,0.22439539349843488,131511.22448979586,1828.6422902494296,133339.8667800453,3253,19,659.219512195122,34,7,19,33.794200711853925,0.6397058823529411,43.57142857142857,1025.714285714285,30.168067226890738,0
3292,4,0,0,41,0.0,0.0,1.0,41,850,600,250,0.7058823529411765,11,6,5,383.5921523226551,0.8244918699186992,0.2099915661491265,0.22611471742247877,131572.28599773237,1894.019274376412,133466.3052721088,3254,20,660.219512195122,34,7,16,33.67322271215285,0.6403186274509804,43.51190476190476,1025.9523809523805,30.17507002801119,0
3293,4,1,0,42,0.023809523809523808,0.0,1.0,42,1300,1000,300,0.7692307692307693,16,10,6,374.8823192622024,0.8279374758033294,0.21922625082476377,0.22319452368146006,131951.69331114966,1493.2713638117202,133444.96467496137,3255,0,645.4761904761905,35,7,17,33.5132223724231,0.6419642857142858,43.14236111111111,1027.4305555555552,29.35515873015872,0
3294,4,0,0,42,0.0,0.0,1.0,42,1000,600,400,0.6,14,6,8,371.3659605551499,0.8284456058846302,0.21769626769626793,0.22162162162162163,132040.89506172828,1407.098765432087,133447.99382716036,3256,1,646.4761904761905,35,7,17,33.513513513513516,0.6428571428571428,43.05555555555555,1027.777777777777,29.36507936507934,0
3295,4,0,0,42,0.0,0.0,1.0,42,900,700,200,0.7777777777777778,11,7,4,371.8249240549399,0.8280100658149439,0.21834957806585797,0.22224421099972924,132100.3796403464,1423.642725480106,133524.0223658265,3257,2,647.4761904761905,35,7,18,33.441698566388936,0.6434523809523809,42.99768518518518,1028.0092592592594,29.371693121693124,0
3296,4,0,0,42,0.0,0.0,1.0,42,1250,1100,150,0.88,14,11,3,368.45852622988684,0.8255420054200542,0.2050746735475799,0.22129313853451793,132282.1316882762,1348.0958576820167,133630.22754595822,3258,3,648.4761904761905,36,6,19,33.34496442255063,0.6432291666666666,42.82094594594595,1028.7162162162167,28.575450450450465,0
3297,4,2,0,44,0.045454545454545456,0.0,1.0,44,1100,800,300,0.7272727272727273,14,8,6,365.3731795413893,0.8337297392529951,0.20811070741611415,0.21558399837000758,131609.2511638196,822.6782799775806,132431.92944379718,3259,0,619.9545454545455,37,7,15,34.103173755075865,0.6345720720720721,43.47587719298245,1026.09649122807,27.732337600758648,2
3298,4,1,0,45,0.022222222222222223,0.0,1.0,45,1050,700,350,0.6666666666666666,14,7,7,358.0101132174819,0.8356902356902357,0.20978129007660096,0.2131878178831281,131958.55391418276,448.49936536634067,132407.05327954912,3260,0,607.1555555555556,38,7,16,33.93968146684691,0.6362390350877194,43.135683760683754,1027.4572649572638,27.03834907782273,0
3299,4,1,0,46,0.021739130434782608,0.0,1.0,46,950,500,450,0.5263157894736842,14,5,9,348.4257855324207,0.8391505636070854,0.21060277880500822,0.2093097967103519,132290.82031249997,18.706597222221546,132309.5269097222,3261,0,594.9347826086956,39,7,17,33.85142432833808,0.6378205128205128,42.8125,1028.7499999999998,26.37820512820512,0
3300,4,0,0,46,0.0,0.0,1.0,46,750,300,450,0.4,12,3,9,346.9574727981223,0.8378623188405797,0.20709057860987512,0.20887220437371418,132371.20361328122,-14.564344618056111,132356.63926866316,3262,1,595.9347826086956,39,7,17,33.80835189121707,0.6386217948717949,42.734375,1029.0624999999998,26.386217948717942,0
3301,4,0,0,46,0.0,0.0,1.0,46,950,700,250,0.7368421052631579,12,7,5,346.1905545540476,0.8381038647342995,0.19925877227502786,0.2093416289643952,132539.10007165652,-23.23766387255361,132515.86240778398,3263,2,596.9347826086956,37,9,18,33.65933251694885,0.6438626126126126,42.571271929824555,1029.7149122807007,27.83013276434326,0
3302,4,0,0,46,0.0,0.0,1.0,46,1100,800,300,0.7272727272727273,14,8,6,351.3791091777321,0.837097423510467,0.20075147611379496,0.21327894766369326,132680.27181440452,124.21514312096977,132804.48695752549,3264,3,597.9347826086956,37,9,16,33.38388676032355,0.6452702702702702,42.434210526315795,1030.2631578947376,27.844950213371284,0
3303,4,1,0,47,0.02127659574468085,0.0,1.0,47,1200,800,400,0.6666666666666666,16,8,8,342.804803067682,0.8397702744372494,0.20540276152895398,0.21018831639521293,133058.54752218936,-277.37816403681677,132781.16935815255,3265,0,586.1914893617021,38,9,17,33.22525111318216,0.647203947368421,42.06730769230769,1031.7307692307693,27.15080971659919,0
3304,4,0,0,47,0.0,0.0,1.0,47,1500,1100,400,0.7333333333333333,19,11,8,340.14312719416694,0.8389993832870798,0.2034756178141932,0.20901924991702622,133141.2310979619,-342.5850591715962,132798.6460387903,3266,1,587.1914893617021,38,9,17,33.211050724637694,0.6480263157894737,41.98717948717949,1032.0512820512822,27.159244264507425,0
3305,4,0,0,47,0.0,0.0,1.0,47,850,700,150,0.8235294117647058,10,7,3,339.89132534863353,0.8384212149244527,0.20586829696939035,0.2090191021128675,133168.79799702312,-347.4161507414726,132821.38184628164,3267,2,588.1914893617021,38,9,17,33.1899303039713,0.6483004385964912,41.960470085470085,1032.1581196581194,27.162055780476827,0
3306,4,0,1,46,0.0,0.02127659574468085,0.9787234042553191,47,1100,500,600,0.45454545454545453,17,5,12,340.0583767366829,0.8378430465618254,0.19786182339545544,0.20976967570570884,133283.9206271703,-335.1372612847026,132948.7833658856,3268,3,589.1914893617021,39,8,17,33.07031591512828,0.6477029914529913,41.84895833333334,1032.604166666668,26.47702991452995,0
3307,4,0,0,46,0.0,0.0,1.0,46,1150,700,450,0.6086956521739131,16,7,9,349.96556630777053,0.8325684380032207,0.2040354809982754,0.21556921862500447,133230.14458550388,125.19259982642848,133355.3371853303,3269,4,602.804347826087,39,7,17,32.868466855009586,0.6471688034188032,41.901041666666686,1032.3958333333364,26.471688034188112,0
3308,4,0,1,45,0.0,0.021739130434782608,0.9782608695652174,46,1400,1000,400,0.7142857142857143,18,10,8,348.0938145854785,0.831340579710145,0.20159776908641192,0.21519315869261899,133364.60503472242,84.67881944446435,133449.2838541669,3270,5,603.804347826087,39,7,17,32.782035767110386,0.6485042735042734,41.77083333333334,1032.9166666666683,26.48504273504278,0
3309,4,0,1,44,0.0,0.022222222222222223,0.9777777777777777,45,1450,1200,250,0.8275862068965517,17,12,5,350.24696233761875,0.8322811447811448,0.19753341838787164,0.21634743673595908,133334.25931633054,339.9838602162204,133674.24317654676,3271,6,613.3555555555556,38,7,17,32.7568445915658,0.6499451754385965,41.80021367521367,1032.7991452991446,27.17892487629328,0
3310,4,1,1,44,0.022222222222222223,0.022222222222222223,0.9777777777777777,45,1000,600,400,0.6,14,6,8,340.35358452016123,0.8337962962962964,0.19230318690783843,0.21149138922495542,133555.03420857972,91.25826393452732,133646.29247251424,3272,0,610.6888888888889,38,7,17,32.791343669250644,0.652138157894737,41.58653846153845,1033.6538461538448,27.201417004048547,0
3311,4,0,0,44,0.0,0.0,1.0,44,1200,1000,200,0.8333333333333334,14,10,4,348.0875902971,0.8290829809725159,0.19003047663136763,0.21614450765088666,133528.88028047068,495.9492343797803,134024.82951485045,3273,8,625.5681818181819,37,7,18,32.617670980974594,0.6537162162162163,41.61184210526314,1033.5526315789455,27.933854907539068,0
3312,4,0,0,44,0.0,0.0,1.0,44,900,600,300,0.6666666666666666,12,6,6,347.98325059088285,0.828466349541931,0.19257789521394075,0.21624509580225754,133557.21381819382,495.1346808633143,134052.34849905715,3274,9,626.5681818181819,37,7,19,32.59200081326684,0.6539977477477479,41.58442982456139,1033.6622807017525,27.936818397344663,0
3313,4,0,1,43,0.0,0.022727272727272728,0.9772727272727273,44,900,700,200,0.7777777777777778,11,7,4,349.49470330840967,0.8283562367864694,0.1892621591391217,0.21735066377253828,133585.55036164954,537.4884579870469,134123.0388196366,3275,10,627.5681818181819,37,7,19,32.52457219629472,0.6542792792792793,41.55701754385964,1033.7719298245597,27.939781887150264,0
3314,4,0,1,42,0.0,0.023255813953488372,0.9767441860465116,43,1200,800,400,0.6666666666666666,16,8,8,349.3978420719209,0.8292727943890734,0.18187713250063986,0.21747942969913914,133617.71981018168,737.1485928495915,134354.86840303126,3276,11,631.2093023255813,36,7,20,32.49487165523001,0.6565393518518519,41.52590090090089,1033.8963963963952,28.71934434434431,0
3315,4,0,0,42,0.0,0.0,1.0,42,1450,1300,150,0.896551724137931,16,13,3,357.77509085414016,0.8272599690282617,0.18829036316721015,0.2225380996872687,133591.84777949244,1159.1670953360717,134751.0148748285,3277,12,645.4761904761905,35,7,20,32.30426183012389,0.6583333333333334,41.550925925925924,1033.796296296296,29.53703703703703,0
3316,4,0,0,42,0.0,0.0,1.0,42,1050,700,350,0.6666666666666666,14,7,7,357.00315247000896,0.8276955090979481,0.18478162389746067,0.22259756924769925,133681.6021117327,1144.9506762260014,134826.5527879587,3278,13,646.4761904761905,35,7,20,32.23430796493193,0.6592261904761905,41.464120370370374,1034.1435185185187,29.546957671957678,0
3317,4,0,0,42,0.0,0.0,1.0,42,1050,500,550,0.47619047619047616,16,5,11,356.442732561972,0.8268244289585753,0.18436196230758162,0.22260857448681645,133741.455078125,1134.233940972221,134875.68901909722,3279,14,647.4761904761905,35,7,16,32.188863712655255,0.6598214285714286,41.40625,1034.375,29.553571428571427,0
3318,4,0,0,42,0.0,0.0,1.0,42,500,200,300,0.4,8,2,6,355.82434794460085,0.8259049554781263,0.18491939178893735,0.22240265887614286,133771.38658479083,1119.823281035669,134891.2098658265,3280,15,648.4761904761905,35,7,16,32.174889982844775,0.6601190476190476,41.37731481481482,1034.490740740741,29.556878306878318,0
3319,4,1,0,43,0.023255813953488372,0.0,1.0,43,1200,900,300,0.75,15,9,6,347.14792060491476,0.8295957918050941,0.1793933265925176,0.21935170807453416,134171.3334956579,715.4598855612437,134886.79338121915,3281,0,634.3720930232558,36,7,18,31.99954710144926,0.662037037037037,40.990990990990994,1036.0360360360366,28.778778778778797,0
3320,4,0,1,42,0.0,0.023255813953488372,0.9767441860465116,43,700,200,500,0.2857142857142857,12,2,10,399.67007519248256,0.8290882244370616,0.26332544026094196,0.24192274347365375,132576.73852237655,2021.1690117764147,134597.90753415297,3282,1,635.3720930232558,35,8,18,32.24460552933244,0.6482142857142856,42.53472222222222,1029.861111111111,29.424603174603174,6
3321,4,0,0,42,0.0,0.0,1.0,42,1100,700,400,0.6363636363636364,15,7,8,409.40856505418674,0.8242595818815331,0.27087909970324153,0.24744756667740464,132520.55165816325,2451.009778911566,134971.56143707482,3283,2,651.0,34,8,19,32.05067059775696,0.6498161764705883,42.589285714285715,1029.642857142857,30.28361344537815,0
3322,4,0,0,42,0.0,0.0,1.0,42,1300,700,600,0.5384615384615384,19,7,12,406.45521098438417,0.8240418118466899,0.2638310987825552,0.24626403959642107,132612.50000000003,2380.208333333334,134992.70833333337,3284,3,652.0,34,8,20,32.033778317152084,0.650735294117647,42.5,1030.0000000000002,30.29411764705883,0
3323,4,0,0,42,0.0,0.0,1.0,42,1300,800,500,0.6153846153846154,18,8,10,411.5447470966682,0.8230013550135501,0.2737600123228583,0.2501637170553904,132735.14739229024,2525.290532879816,135260.43792517006,3285,4,653.0,34,8,16,31.778775800985823,0.6519607843137255,42.38095238095238,1030.4761904761906,30.308123249299722,0
3324,4,0,0,42,0.0,0.0,1.0,42,1350,1000,350,0.7407407407407407,17,10,7,410.5907546576065,0.8226626016260162,0.26751347190146246,0.2504025306573854,132857.85147392287,2510.0410997732365,135367.8925736961,3286,5,654.0,34,8,17,31.67941685912239,0.6531862745098038,42.26190476190476,1030.9523809523807,30.32212885154061,0
3325,4,0,0,42,0.0,0.0,1.0,42,1250,900,350,0.72,16,9,7,408.1793439106344,0.8217915214866435,0.2651200369344415,0.24975041212159144,132980.6122448979,2455.987811791374,135436.60005668926,3287,6,655.0,34,8,18,31.617661203447216,0.6544117647058822,42.14285714285714,1031.4285714285709,30.336134453781497,0
3326,4,0,0,42,0.0,0.0,1.0,42,1050,700,350,0.6666666666666666,14,7,7,408.55363063309176,0.8207510646535037,0.2586909706199043,0.2508033194283033,133103.42970521556,2475.9778911564786,135579.40759637204,3288,7,656.0,34,8,18,31.484098600215358,0.6556372549019607,42.02380952380953,1031.904761904763,30.350140056022443,0
3327,4,0,0,42,0.0,0.0,1.0,42,1100,800,300,0.7272727272727273,14,8,6,409.4254337665605,0.8198315911730546,0.2643757687576871,0.2521688467062227,133226.30385487544,2509.247448979607,135735.55130385506,3289,8,657.0,34,8,18,31.337686423739232,0.6568627450980391,41.90476190476191,1032.3809523809537,30.364145658263343,0
3328,4,0,0,42,0.0,0.0,1.0,42,1150,900,250,0.782608695652174,14,9,5,405.1847331432492,0.8191298877274487,0.25842588698329605,0.25023226852907376,133326.8038942662,2404.397091348139,135731.20098561433,3290,9,658.0,36,6,19,31.345863773488915,0.6536458333333333,41.80743243243245,1032.7702702702727,28.68806306306313,0
3329,4,0,0,42,0.0,0.0,1.0,42,1200,1000,200,0.8333333333333334,14,10,4,407.95104120702587,0.8175329074719319,0.2616823846923608,0.2525436734725755,133415.57618690372,2485.404643736539,135900.98083064027,3291,10,659.0,37,5,20,31.184992570579492,0.6525900900900901,41.72149122807018,1033.11403508772,27.922000948316754,0
3330,4,0,0,42,0.0,0.0,1.0,42,1250,900,350,0.72,16,9,7,407.7783558792921,0.8165166473093303,0.261328725038402,0.2528225806451613,133472.2222222223,2485.416666666675,135957.638888889,3292,11,660.0,37,5,20,31.132392473118276,0.653153153153153,41.66666666666667,1033.3333333333342,27.92792792792795,0
3331,4,0,0,42,0.0,0.0,1.0,42,1750,1500,250,0.8571428571428571,20,15,5,418.45996190490064,0.8170247773906311,0.2910078153398765,0.24917388640700908,131956.93963860057,2643.7391868512177,134600.6788254518,3293,12,661.0,33,9,17,32.38857744910941,0.6464646464646464,43.13725490196079,1027.4509803921571,31.13487819370173,2
3332,4,0,0,42,0.0,0.0,1.0,42,1250,1000,250,0.8,15,10,5,416.19825085075627,0.8162504839334107,0.28795099645325517,0.2483095714992798,132030.6990504535,2590.189200680271,134620.88825113376,3294,13,662.0,34,8,17,32.371906251206596,0.6449142156862745,43.06547619047619,1027.7380952380952,30.227591036414566,0
3333,4,0,0,42,0.0,0.0,1.0,42,1300,900,400,0.6923076923076923,17,9,8,409.56682956104254,0.8159843205574913,0.2805610670194003,0.24574009773662547,132244.89795918364,2432.6247165532823,134677.52267573692,3295,14,663.0,34,8,18,32.32542438271604,0.6470588235294117,42.857142857142854,1028.5714285714282,30.252100840336123,0
3334,4,1,1,42,0.023255813953488372,0.023255813953488372,0.9767441860465116,43,1100,800,300,0.7272727272727273,14,8,6,399.2649269938857,0.8222591362126246,0.2695254738540127,0.24151339989490275,132551.19756235817,1984.6974206349068,134535.89498299308,3296,0,648.5581395348837,34,9,18,32.280828516377646,0.6501225490196079,42.5595238095238,1029.761904761904,30.28711484593835,0
3335,4,0,0,42,0.0,0.0,1.0,42,1000,700,300,0.7,13,7,6,404.919599572103,0.8143389469608981,0.27673292861960874,0.24455280776457486,132492.61289227704,2329.7711517204925,134822.38404399753,3297,16,665.0,33,9,18,32.194456017140816,0.6518308080808082,42.61642156862745,1029.5343137254904,31.198009506833042,0
3336,4,0,0,42,0.0,0.0,1.0,42,1250,800,450,0.64,17,8,9,403.4184215897735,0.8135162601626016,0.27575304276874957,0.24425997226516258,132587.25610342177,2297.628316032293,134884.88441945406,3298,17,666.0,33,9,18,32.13747421862605,0.6527777777777778,42.52450980392157,1029.9019607843136,31.20915032679738,0
3337,4,0,1,41,0.0,0.023809523809523808,0.9761904761904762,42,1250,800,450,0.64,17,8,9,399.735239167367,0.8131533101045296,0.19448764166725563,0.2275675826358447,130230.36552392608,2043.3419412661342,132273.70746519222,3299,18,667.0,32,10,18,34.622917697509465,0.6315104166666667,44.82323232323232,1020.7070707070703,31.897095959595948,8
3338,4,0,0,41,0.0,0.0,1.0,41,950,700,250,0.7368421052631579,12,7,5,402.8288672244739,0.8142784552845529,0.18560599980094805,0.22992418514683183,130331.20022907287,2300.2379360194154,132631.4381650923,3300,19,665.2926829268292,30,11,18,34.441226800052654,0.637847222222222,44.72446236559141,1021.1021505376357,34.03673835125452,0
3339,4,2,1,42,0.046511627906976744,0.023255813953488372,0.9767441860465116,43,1200,1000,200,0.8333333333333334,14,10,4,385.51917860925425,0.8246585455887782,0.17858054890033426,0.22334760133152323,130907.84940631081,1493.4973153249978,132401.3467216358,3301,0,635.3023255813954,32,11,18,34.29724449928028,0.6383463541666665,44.16035353535355,1023.3585858585877,31.979955808080867,0
3340,4,1,1,42,0.023255813953488372,0.023255813953488372,0.9767441860465116,43,1000,700,300,0.7,13,7,6,383.6668236564268,0.8259966777408637,0.1796281478804771,0.2230218116867362,131037.09323347136,1454.9170684114242,132492.01030188278,3302,0,636.2790697674419,32,11,18,34.213528178567024,0.6396484374999998,44.03409090909093,1023.8636363636386,31.995738636363708,0
3341,4,0,0,42,0.0,0.0,1.0,42,1000,700,300,0.7,13,7,6,392.8053920711687,0.821694734804491,0.18411486732097404,0.2276880812447929,130928.03955078148,1885.8479817708621,132813.88753255235,3303,2,652.4285714285714,31,11,18,34.09033078880409,0.6411290322580643,44.140625000000014,1023.4375000000018,33.014112903225865,0
3342,4,0,0,42,0.0,0.0,1.0,42,1150,700,450,0.6086956521739131,16,7,9,393.9806396805238,0.8209204413472706,0.17800366999146044,0.22896302807154187,131028.0036926271,1924.4993421766628,132952.50303480375,3304,3,653.4285714285714,31,11,18,33.95875725973971,0.6421370967741935,44.04296875000001,1023.8281250000011,33.02671370967746,0
3343,4,0,0,42,0.0,0.0,1.0,42,1000,600,400,0.6,14,6,8,394.39598786927394,0.81937185443283,0.17693388059520765,0.22980139559849705,131128.00598144543,1943.2718912760558,133071.2778727215,3305,4,654.4285714285714,31,11,18,33.84661835748793,0.6431451612903225,43.94531250000001,1024.218750000001,33.03931451612906,0
3344,4,0,0,42,0.0,0.0,1.0,42,900,500,400,0.5555555555555556,13,5,8,394.17806103710706,0.8177748741773132,0.16899072796378367,0.23007366351928496,131194.69536675359,1942.8141276041856,133137.50949435777,3306,5,655.4285714285714,31,11,18,33.78452804609388,0.6438172043010751,43.88020833333334,1024.4791666666677,33.047715053763476,0
3345,4,0,0,42,0.0,0.0,1.0,42,850,400,450,0.47058823529411764,13,4,9,395.2403171614982,0.8173151374370886,0.16802202456586235,0.23109519287228764,131261.40170627178,1975.9596082899393,133237.3613145617,3307,6,656.4285714285714,31,11,18,33.68964421855145,0.644489247311828,43.81510416666667,1024.739583333334,33.05611559139787,0
3346,4,0,1,41,0.0,0.023809523809523808,0.9761904761904762,42,850,600,250,0.7058823529411765,11,6,5,394.6839333305703,0.8173393341076268,0.16012973958430887,0.23138004300632264,131362.56946251006,1969.3560757848065,133331.92553829486,3308,7,657.4285714285714,30,12,19,33.601295834972255,0.648263888888889,43.71639784946236,1025.13440860215,34.171146953405,0
3347,4,0,0,41,0.0,0.0,1.0,41,1350,800,550,0.5925925925925926,19,8,11,405.82655081637586,0.8148373983739837,0.1643573975368533,0.2379194417454857,131363.71768904297,2462.1768904320716,133825.89457947505,3309,8,673.4146341463414,29,12,20,33.31456329314005,0.6512212643678161,43.715277777777764,1025.138888888887,35.34961685823749,0
3348,4,0,0,41,0.0,0.0,1.0,41,1000,700,300,0.7,13,7,6,404.718292252054,0.8150406504065041,0.16367624131279213,0.23793311066792716,131470.524691358,2441.7052469135724,133912.22993827157,3310,9,674.4146341463414,29,12,20,33.23458378475985,0.6522988505747127,43.61111111111111,1025.5555555555552,35.36398467432949,0
3349,4,0,0,41,0.0,0.0,1.0,41,900,500,400,0.5555555555555556,13,5,8,403.923553529489,0.8133130081300813,0.1661944482970421,0.2379090403802875,131541.75347222216,2426.562499999996,133968.31597222216,3311,10,675.4146341463414,29,12,20,33.18271053344165,0.6530172413793103,43.541666666666664,1025.833333333333,35.37356321839079,0
3350,4,0,1,40,0.0,0.024390243902439025,0.975609756097561,41,1050,700,350,0.6666666666666666,14,7,7,402.97746477340894,0.8123475609756098,0.16234415693730653,0.23801762487695588,131648.6328125,2410.2864583333335,134058.91927083334,3312,11,676.4146341463414,29,12,19,33.09860941940723,0.6540948275862069,43.4375,1026.25,35.38793103448276,0
3351,4,0,0,40,0.0,0.0,1.0,40,1000,700,300,0.7,13,7,6,412.4157980510436,0.806517094017094,0.1695309327196428,0.2431377095134126,131577.3750964507,2852.917631172851,134430.29272762354,3313,12,692.35,29,11,19,32.92876562429494,0.6533764367816092,43.50694444444445,1025.9722222222229,35.37835249042148,0
3352,4,1,0,41,0.024390243902439025,0.0,1.0,41,1300,900,400,0.6923076923076923,17,9,8,403.40587747413093,0.8091971544715447,0.17342117436870885,0.24037707975757847,131983.3420951844,2448.5711859752537,134431.91328115965,3314,0,676.439024390244,30,11,20,32.74852844996729,0.654513888888889,43.111559139784944,1027.5537634408602,34.25179211469534,0
3353,4,0,0,41,0.0,0.0,1.0,41,1000,700,300,0.7,13,7,6,407.07233895864226,0.8080284552845528,0.1778666590118234,0.24300407306922236,132052.40716050993,2550.9764495895524,134603.3836100995,3315,1,677.439024390244,30,11,20,32.584401290266335,0.6552083333333334,43.04435483870968,1027.8225806451617,34.260752688172055,0
3354,4,0,0,41,0.0,0.0,1.0,41,1500,1100,400,0.7333333333333333,19,11,8,402.31011076299905,0.8094004065040651,0.22040331364071375,0.23784573748308532,131684.26890432113,2403.17466052596,134087.44356484708,3316,2,678.439024390244,32,9,19,33.079612088407764,0.6461588541666665,43.402777777777786,1026.38888888889,32.074652777777814,4
3355,4,0,0,41,0.0,0.0,1.0,41,1350,1000,350,0.7407407407407407,17,10,7,400.78122098025096,0.8092479674796748,0.22117659760146036,0.23775008535611875,131813.8953455008,2365.7067837465943,134179.6021292474,3317,3,679.439024390244,32,9,20,32.98751998032706,0.6474609374999998,43.27651515151517,1026.893939393942,32.09043560606069,0
3356,4,0,0,41,0.0,0.0,1.0,41,600,300,300,0.5,9,3,6,401.0941171560946,0.8081808943089431,0.21821440834308126,0.23843765177321893,131893.9905925606,2380.380742983476,134274.3713355441,3318,4,680.439024390244,33,8,20,32.8983734987672,0.6458333333333333,43.19852941176471,1027.2058823529417,31.127450980392172,0
3357,4,0,0,41,0.0,0.0,1.0,41,1400,1100,300,0.7857142857142857,17,11,6,401.34574949344795,0.8063008130081301,0.21830533316660183,0.23957913174388257,132051.39136690227,2399.652927960417,134451.0442948627,3319,5,681.439024390244,33,8,21,32.73257720281388,0.6474116161616161,43.04534313725491,1027.8186274509815,31.146019013666105,0
3358,4,0,0,41,0.0,0.0,1.0,41,750,400,350,0.5333333333333333,11,4,7,397.96113484325656,0.8057926829268293,0.22187854298090048,0.23815220551604305,132145.87688629385,2317.784626105358,134463.6615123992,3320,6,682.439024390244,33,8,21,32.723976956694486,0.6483585858585857,42.953431372549026,1028.1862745098047,31.157159833630445,0
3359,4,1,0,42,0.023809523809523808,0.0,1.0,42,750,600,150,0.8,9,6,3,388.89897709190365,0.8112417731320171,0.21946960181573805,0.2340976850962686,132367.37528344675,1895.5073696145182,134262.88265306127,3321,0,667.1666666666666,34,8,22,32.733206077433294,0.6482843137254901,42.73809523809524,1029.0476190476193,30.266106442577037,0
3360,4,0,0,42,0.0,0.0,1.0,42,1200,900,300,0.75,15,9,6,386.1617299997878,0.8113869531552458,0.21430378603054123,0.2328458028717258,132431.50711059582,1828.0066077130866,134259.5137183089,3322,1,668.1666666666666,31,11,22,32.73890470166562,0.65625,42.67578125000001,1029.296875000001,33.20312500000003,0
3361,4,0,0,42,0.0,0.0,1.0,42,1150,900,250,0.782608695652174,14,9,5,386.4360077260232,0.811604723190089,0.21241275060675568,0.23342624240562787,132498.52710300035,1840.4403686523626,134338.96747165272,3323,2,669.1666666666666,31,11,22,32.664226845411235,0.6569220430107525,42.61067708333334,1029.5572916666679,33.21152553763445,0
3362,4,0,0,42,0.0,0.0,1.0,42,650,500,150,0.7692307692307693,8,5,3,386.4360077260232,0.8117015098722415,0.21241275060675568,0.23342624240562787,132498.52710300035,1840.4403686523626,134338.96747165272,3324,3,670.1666666666666,31,11,22,32.664226845411235,0.6569220430107525,42.61067708333334,1029.5572916666679,33.21152553763445,0
3363,4,0,0,42,0.0,0.0,1.0,42,850,400,450,0.47058823529411764,13,4,9,388.82047674833285,0.8096447928765002,0.21055973900115,0.2357056545253687,132632.61795043945,1914.055548773872,134546.67349921333,3325,4,671.1666666666666,31,11,20,32.46758205873678,0.658266129032258,42.48046875,1030.078125,33.228326612903224,0
3364,4,0,1,41,0.0,0.023809523809523808,0.9761904761904762,42,600,500,100,0.8333333333333334,7,5,2,385.44279844290656,0.8106610530391019,0.20917366946778726,0.23401884191176472,132690.54178145083,1828.9227502295648,134519.4645316804,3326,5,672.1666666666666,32,10,20,32.49617034313725,0.65625,42.42424242424242,1030.30303030303,32.19696969696969,0
3365,4,0,0,41,0.0,0.0,1.0,41,1200,700,500,0.5833333333333334,17,7,10,387.6751839931416,0.8068089430894309,0.20912497534678853,0.23578277583845178,132755.59413580253,2093.209876543218,134848.80401234576,3327,6,682.780487804878,32,9,20,32.37309074573227,0.6569010416666666,42.361111111111114,1030.5555555555559,32.20486111111112,0
3366,4,0,0,41,0.0,0.0,1.0,41,900,600,300,0.6666666666666666,12,6,6,385.48512880066943,0.8057926829268293,0.20902775361562442,0.2349783263384951,132839.80320069205,2041.553729334876,134881.35693002693,3328,7,683.780487804878,33,8,20,32.344666349659214,0.6553030303030303,42.279411764705884,1030.8823529411766,31.238859180035654,0
3367,4,0,1,40,0.0,0.024390243902439025,0.975609756097561,41,1000,800,200,0.8,12,8,4,388.8385111520021,0.8048780487804879,0.21978168456984548,0.23802572715391998,132997.7671598663,2142.9307537965997,135140.69791366288,3329,8,684.780487804878,33,8,20,32.099100035642145,0.6568813131313131,42.12622549019607,1031.4950980392148,31.25742721330954,0
3368,4,0,0,40,0.0,0.0,1.0,40,1250,1000,250,0.8,15,10,5,399.43720471341044,0.79866452991453,0.2248591549295773,0.24357018495033575,132853.20255905006,2613.302373482291,135466.50493253235,3330,16,702.7,32,8,21,31.971575831802408,0.6578776041666667,42.26641414141414,1030.9343434343432,32.216698232323225,0
3369,4,0,0,40,0.0,0.0,1.0,40,1300,900,400,0.6923076923076923,17,9,8,401.2314023491102,0.797676282051282,0.22723460266927886,0.2450902664910385,132918.2947690287,2666.1987616059628,135584.49353063465,3331,17,703.7,32,8,21,31.859668993102318,0.6585286458333334,42.20328282828283,1031.186868686869,32.22458964646466,0
3370,4,0,0,40,0.0,0.0,1.0,40,750,400,350,0.5333333333333333,11,4,7,412.63836529969984,0.7966346153846153,0.14384912832612384,0.2423416542626182,131431.47193678463,2885.305821573823,134316.77775835845,3332,18,704.7,30,10,22,33.07117577664176,0.6489583333333333,43.649193548387096,1025.4032258064517,34.18010752688172,6
3371,4,0,0,40,0.0,0.0,1.0,40,850,600,250,0.7058823529411765,11,6,5,410.39641307489853,0.796340811965812,0.14577709343467404,0.24145990965108338,131500.3924767315,2793.4578780783977,134293.8503548099,3333,19,705.7,30,10,22,33.058686061241424,0.6496527777777779,43.58198924731183,1025.6720430107532,34.18906810035844,0
3372,4,0,0,40,0.0,0.0,1.0,40,1200,800,400,0.6666666666666666,16,8,8,410.3098967908641,0.7968482905982905,0.14559495116072507,0.2426461302627445,131695.40617201073,2807.1857028537383,134502.59187486448,3334,20,706.7,31,9,20,32.863043891919304,0.6488575268817204,43.391927083333336,1026.4322916666674,33.11071908602153,0
3373,4,0,1,39,0.0,0.025,0.975,40,1050,600,450,0.5714285714285714,15,6,9,407.6959573283755,0.7966880341880341,0.14519549981556645,0.2418520219512531,131813.89534550055,2747.998450413233,134561.89379591378,3335,21,707.7,32,8,20,32.810002459117186,0.6474609375,43.276515151515156,1026.89393939394,32.09043560606062,0
3374,4,1,2,38,0.025,0.05,0.95,40,800,400,400,0.5,12,4,8,399.3736637473536,0.8004807692307693,0.13579647072850887,0.23840191586114248,132051.391366902,2547.569594627055,134598.96096152905,3336,0,692.725,33,7,20,32.78325086443305,0.6474116161616161,43.045343137254896,1027.8186274509794,31.14601901366604,0
3375,4,1,1,38,0.02564102564102564,0.02564102564102564,0.9743589743589743,39,1150,800,350,0.6956521739130435,15,8,7,402.7783713019206,0.7948717948717949,0.138470982669878,0.24140028213790618,132203.15728305798,2849.714474288354,135052.87175734632,3337,0,709.3846153846154,32,7,20,32.54220380601597,0.6513671875,42.89772727272728,1028.409090909092,32.13778409090912,0
3376,4,1,0,39,0.02564102564102564,0.0,1.0,39,950,800,150,0.8421052631578947,11,8,3,400.5209078249082,0.7939158794421952,0.14007236117665545,0.24108163949579078,132365.519143455,2803.031578410395,135168.55072186538,3338,0,710.3589743589744,32,7,22,32.43609406952964,0.6529947916666665,42.739898989899004,1029.040404040406,32.15751262626269,0
3377,4,0,0,39,0.0,0.0,1.0,39,1150,900,250,0.782608695652174,14,9,5,378.5061552903708,0.7936909581646424,0.11360823278483045,0.21173404929273457,129544.24267409157,2006.6626324773238,131550.9053065689,3339,1,711.3589743589744,33,6,17,35.86320272059706,0.622159090909091,45.496323529411754,1018.0147058823519,30.84893048128339,5
3378,4,1,0,40,0.025,0.0,1.0,40,800,600,200,0.75,10,6,4,367.92092685239135,0.7994925213675214,0.11089533932951778,0.20735819978823705,129837.58680555545,1553.9930555555463,131391.57986111098,3340,0,694.55,34,6,19,35.834014717906776,0.6228553921568627,45.20833333333333,1019.1666666666657,29.975490196078404,0
3379,4,0,0,40,0.0,0.0,1.0,40,900,400,500,0.4444444444444444,14,4,10,365.13640002824326,0.7983173076923077,0.10576966738562854,0.2063172897914554,129937.87140185597,1489.0093182012865,131426.88072005726,3341,1,695.55,35,5,19,35.80299031293754,0.6217261904761906,45.109953703703695,1019.5601851851839,29.130291005290967,0
3380,4,2,2,40,0.047619047619047616,0.047619047619047616,0.9523809523809523,42,1100,1000,100,0.9090909090909091,12,10,2,348.6024715609129,0.8075396825396826,0.10618810278982505,0.19983523499608674,130498.9979852536,699.2650998799539,131198.26308513357,3342,0,663.3809523809524,35,7,15,35.65549010723457,0.6273809523809524,44.560185185185176,1021.7592592592579,29.193121693121654,0
3381,4,1,0,41,0.024390243902439025,0.0,1.0,41,1250,1000,250,0.8,15,10,5,357.03765042052464,0.7999491869918699,0.12011832806199485,0.2047063562831905,130505.7557397958,1119.0936791383115,131624.8494189341,3343,0,680.5365853658536,34,7,17,35.43317216202572,0.6295955882352942,44.55357142857142,1021.7857142857133,30.052521008403332,0
3382,4,1,0,42,0.023809523809523808,0.0,1.0,42,1100,900,200,0.8181818181818182,13,9,4,350.5258346403244,0.8035230352303523,0.12671864520456055,0.20316191232214706,130924.43795146483,778.4795775505063,131702.91752901534,3344,0,665.3095238095239,36,6,18,35.175735401995304,0.6296296296296298,44.144144144144136,1023.4234234234223,28.428428428428397,0
3383,4,0,0,42,0.0,0.0,1.0,42,1100,600,500,0.5454545454545454,16,6,10,351.1242751177823,0.8019744483159117,0.12978442586889583,0.2041190479137387,131039.71370018648,802.2448969239284,131841.9585971104,3345,1,666.3095238095239,36,6,18,35.04385723713153,0.6307870370370372,44.03153153153152,1023.8738738738723,28.440940940940898,0
3384,4,1,2,41,0.023255813953488372,0.046511627906976744,0.9534883720930233,43,950,700,250,0.7368421052631579,12,7,5,345.6933199823877,0.8037098560354374,0.1240665671004908,0.20218843446774745,131273.37643363263,476.06586492802444,131749.44229856067,3346,0,651.7906976744187,38,5,18,34.94687413122046,0.6293859649122808,43.80341880341879,1024.7863247863231,26.96806117858745,0
3385,4,0,0,41,0.0,0.0,1.0,41,1000,800,200,0.8,12,8,4,360.1161414321745,0.7961382113821138,0.12872991533813827,0.20923487321420087,131019.23338190565,1236.4281557786642,132255.66153768433,3347,3,684.439024390244,37,4,19,34.83441772874941,0.6286599099099102,44.05153508771928,1023.7938596491202,27.670104314841087,0
3386,4,0,1,40,0.0,0.024390243902439025,0.975609756097561,41,900,800,100,0.8888888888888888,10,8,2,359.4959514794157,0.7966463414634146,0.13130355524563964,0.2091796069075551,131075.36844269373,1224.2128587642164,132299.58130145795,3348,4,685.439024390244,37,4,20,34.79349591319556,0.629222972972973,43.99671052631578,1024.0131578947353,27.676031294452304,0
3387,4,0,0,40,0.0,0.0,1.0,40,950,600,350,0.631578947368421,13,6,7,362.8953556935664,0.7973290598290599,0.13423584387025844,0.21143710826604645,131126.20380092924,1517.0180738170513,132643.2218747463,3349,5,696.975,36,4,20,34.65503023639362,0.6316550925925927,43.94707207207207,1024.2117117117111,28.45032532532531,0
3388,4,0,0,40,0.0,0.0,1.0,40,800,600,200,0.75,10,6,4,366.42506943605844,0.7965544871794872,0.14247802197802173,0.2142974377807282,131270.4173768363,1620.1543604415183,132890.57173727782,3350,6,697.975,36,4,20,34.418727106227095,0.6331018518518519,43.806306306306304,1024.7747747747746,28.465965965965964,0
3389,4,0,0,40,0.0,0.0,1.0,40,1250,900,350,0.72,16,9,7,365.58918725634703,0.7959668803418803,0.14271571246080583,0.21430146299961916,131358.63272392293,1604.6845185298362,132963.31724245276,3351,7,698.975,34,6,20,34.350927108736876,0.6381740196078431,43.720238095238095,1025.1190476190477,30.150560224089638,0
3390,4,2,1,41,0.047619047619047616,0.023809523809523808,0.9761904761904762,42,1100,700,400,0.6363636363636364,15,7,8,354.5120054549053,0.807805845915602,0.13866221853284677,0.21065172649864455,131876.9799148812,950.3945245921664,132827.37443947338,3352,0,666.6428571428571,36,6,17,34.11175675181815,0.6391782407407407,43.215090090090094,1027.1396396396403,28.531656656656676,0
3391,4,0,0,41,0.0,0.0,1.0,41,1150,600,550,0.5217391304347826,17,6,11,362.94675820868474,0.8016768292682926,0.14285867140312103,0.21517220684959612,131790.24252292837,1366.5682574466432,133156.810780375,3353,1,683.9024390243902,36,5,18,33.98268991737955,0.6383101851851851,43.29954954954955,1026.8018018018022,28.522272272272282,0
3392,4,0,0,41,0.0,0.0,1.0,41,900,700,200,0.7777777777777778,11,7,4,364.0249884579868,0.801270325203252,0.13725395806589602,0.2161398368969299,131848.06428049685,1399.1980155831634,133247.26229608,3354,2,684.9024390243902,36,5,19,33.89665570175439,0.6388888888888888,43.24324324324325,1027.027027027028,28.528528528528554,0
3393,4,0,1,40,0.0,0.024390243902439025,0.975609756097561,41,1000,700,300,0.7,13,7,6,363.7666609455654,0.7995934959349593,0.13792089477229696,0.21664536647959137,131963.7458404351,1400.8022380488674,133364.54807848396,3355,3,685.9024390243902,36,5,19,33.78657935116177,0.6400462962962963,43.130630630630634,1027.477477477478,28.541041041041055,0
3394,4,0,0,40,0.0,0.0,1.0,40,950,700,250,0.7368421052631579,12,7,5,369.29052120560334,0.795352564102564,0.14977188239270012,0.21986532238377876,131951.69331114978,1745.7019193672913,133697.39523051708,3356,4,703.025,35,5,19,33.65685197701925,0.6419642857142855,43.142361111111114,1027.430555555556,29.355158730158745,0
3395,4,0,0,40,0.0,0.0,1.0,40,950,600,350,0.631578947368421,13,6,7,370.0511322132945,0.7945245726495727,0.14614864864864918,0.22083696599825636,132040.8950617284,1772.3765432098799,133813.2716049383,3357,5,704.025,35,5,19,33.54729729729731,0.6428571428571428,43.05555555555556,1027.7777777777778,29.365079365079367,0
3396,4,0,0,40,0.0,0.0,1.0,40,750,500,250,0.6666666666666666,10,5,5,400.86846981975907,0.7946047008547008,0.22622490643075865,0.22788248216639695,130173.98787133487,2436.5294656635774,132610.51733699845,3358,6,705.025,35,5,20,34.651454576386534,0.6241071428571429,44.87847222222222,1020.4861111111111,29.15674603174603,4
3397,4,1,1,40,0.024390243902439025,0.024390243902439025,0.975609756097561,41,900,400,500,0.4444444444444444,14,4,10,390.9465956698744,0.798729674796748,0.21727526213614357,0.22379671363863812,130444.94224773212,1999.461500456627,132444.40374818875,3359,0,688.8048780487804,34,7,20,34.62883113856193,0.628982843137255,44.61309523809522,1021.5476190476165,30.04551820728284,0
3398,4,0,0,40,0.0,0.0,1.0,40,1200,1000,200,0.8333333333333334,14,10,4,400.9593241043937,0.7950053418803419,0.22433997359894442,0.2290057606416662,130356.4302942376,2453.5252366877903,132809.9555309254,3360,8,707.025,33,7,20,34.46325353014121,0.6303661616161618,44.69975490196077,1021.2009803921553,30.945484254307736,0
3399,4,0,0,40,0.0,0.0,1.0,40,1150,800,350,0.6956521739130435,15,8,7,404.09092974981627,0.7948985042735043,0.22910219503418516,0.23153993686077087,130481.60750973175,2545.2868187716144,133026.89432850337,3361,9,708.025,33,7,20,34.255802446923354,0.631628787878788,44.577205882352935,1021.6911764705875,30.960338680926895,0
3400,4,0,0,40,0.0,0.0,1.0,40,900,500,400,0.5555555555555556,13,5,8,406.4820945782721,0.7957532051282051,0.23165228335131305,0.2340427960708434,130669.48596993928,2622.9612709053995,133292.4472408447,3362,10,709.025,33,7,19,34.00343102001678,0.6335227272727273,44.39338235294117,1022.426470588234,30.982620320855574,0
3401,4,0,0,40,0.0,0.0,1.0,40,900,600,300,0.6666666666666666,12,6,6,406.6786842659233,0.796340811965812,0.22728906999041243,0.2343457832537887,130700.81218761996,2630.646866589752,133331.4590542097,3363,11,710.025,33,7,19,33.96652285075103,0.6338383838383839,44.362745098039206,1022.5490196078416,30.98633392751035,0
3402,4,1,0,41,0.024390243902439025,0.0,1.0,41,1150,900,250,0.782608695652174,14,9,5,393.91806763720024,0.8005081300813008,0.22957391494175328,0.2294432725716202,131114.6701388888,2129.68749999999,133244.3576388888,3364,0,693.6829268292682,34,7,20,33.8723894765392,0.6357230392156863,43.95833333333333,1024.1666666666658,30.122549019607817,0
3403,4,0,1,40,0.0,0.024390243902439025,0.975609756097561,41,1300,900,400,0.6923076923076923,17,9,8,393.91806763720024,0.7997967479674797,0.22957391494175328,0.2294432725716202,131114.6701388888,2129.68749999999,133244.3576388888,3365,1,694.6829268292682,34,7,20,33.8723894765392,0.6357230392156863,43.95833333333333,1024.1666666666658,30.122549019607817,0
3404,4,0,0,40,0.0,0.0,1.0,40,1000,800,200,0.8,12,8,4,400.763926446728,0.7933760683760683,0.23575581395348877,0.2328763356379635,131023.24263038543,2501.8778344671127,133525.12046485255,3366,2,712.375,34,6,20,33.78997093023255,0.6348039215686274,44.047619047619044,1023.8095238095233,30.112044817927156,0
3405,4,0,0,40,0.0,0.0,1.0,40,1100,600,500,0.5454545454545454,16,6,10,402.76638752721715,0.7938301282051282,0.2413567693201626,0.23496981455401372,131175.6395266439,2566.627692743753,133742.26721938766,3367,3,713.375,34,6,20,33.58391439085802,0.6363357843137255,43.89880952380952,1024.4047619047612,30.12955182072827,0
3406,4,2,2,40,0.047619047619047616,0.047619047619047616,0.9523809523809523,42,950,700,250,0.7368421052631579,12,7,5,384.7886659154046,0.8013937282229965,0.23189846571892536,0.2275478653993565,131694.45153061225,1735.0836167800505,133429.5351473923,3368,0,680.3571428571429,34,8,16,33.51890512642079,0.6415441176470588,43.392857142857146,1026.4285714285716,30.189075630252105,0
3407,4,1,1,40,0.024390243902439025,0.024390243902439025,0.975609756097561,41,1550,1300,250,0.8387096774193549,18,13,5,394.46958382791576,0.7979166666666667,0.24745625456971165,0.23276207367097523,131610.90573637543,2183.299842608615,133794.20557898405,3369,0,697.9268292682926,33,8,16,33.3551047016203,0.6429924242424242,43.474264705882355,1026.1029411764707,31.094028520499112,0
3408,4,2,2,40,0.047619047619047616,0.047619047619047616,0.9523809523809523,42,1100,900,200,0.8181818181818182,13,9,4,384.95594289203586,0.8055313588850174,0.2297651251663877,0.2282974014263465,131803.0907064472,1747.676611796985,133550.76731824418,3370,0,682.2619047619048,35,7,17,33.40471896603547,0.6404761904761904,43.28703703703704,1026.851851851852,29.338624338624342,0
3409,4,1,0,41,0.024390243902439025,0.0,1.0,41,1100,800,300,0.7272727272727273,14,8,6,391.771283475501,0.7933434959349593,0.242885606320852,0.23288480514702414,131892.24222232937,2134.3186031807263,134026.5608255101,3371,0,699.8780487804878,35,6,19,33.13955399061033,0.6413690476190477,43.20023148148148,1027.199074074074,29.348544973544968,0
3410,4,0,0,41,0.0,0.0,1.0,41,1250,1000,250,0.8,15,10,5,392.493003348532,0.7920731707317074,0.24475399613777649,0.23404602933053148,132011.15779588904,2162.6911597650897,134173.84895565413,3372,1,700.8780487804878,35,6,20,33.00073675714233,0.6425595238095239,43.08449074074074,1027.662037037037,29.361772486772484,0
3411,4,0,0,41,0.0,0.0,1.0,41,1300,900,400,0.6923076923076923,17,9,8,386.52674985539153,0.792530487804878,0.239302723768668,0.23143447560193983,132166.3106307322,2017.1628976950092,134183.4735284272,3373,2,701.8780487804878,36,5,20,32.997252947833395,0.6420717592592593,42.933558558558566,1028.2657657657667,28.562937937937964,0
3412,4,2,2,41,0.046511627906976744,0.046511627906976744,0.9534883720930233,43,900,800,100,0.8888888888888888,10,8,2,368.634658859905,0.8014027316352897,0.22079303397037053,0.22331380729709255,132606.5394188312,1177.282001075593,133783.8214199068,3374,0,670.1860465116279,35,8,20,33.01365790163689,0.6485119047619048,42.505787037037024,1029.97685185185,29.427910052909997,0
3413,4,0,0,41,0.0,0.0,1.0,41,700,300,400,0.42857142857142855,11,3,8,385.5201234058602,0.7942073170731707,0.23893628098842545,0.23154019245973267,132282.13168827622,1999.4847465709072,134281.61643484712,3375,4,703.8780487804878,36,5,20,32.90617588031381,0.6432291666666666,42.82094594594595,1028.716216216217,28.57545045045047,0
3414,4,0,0,41,0.0,0.0,1.0,41,900,700,200,0.7777777777777778,11,7,4,385.16248581309213,0.7926321138211382,0.23940233492945606,0.23185868217128033,132369.03077063555,1996.7169872575391,134365.74775789308,3376,5,704.8780487804878,36,5,21,32.82766104909901,0.6440972222222222,42.73648648648649,1029.0540540540546,28.58483483483485,0
3415,4,0,0,41,0.0,0.0,1.0,41,950,600,350,0.631578947368421,13,6,7,385.1558202983927,0.7921239837398374,0.23535148596755517,0.2330067932301938,132555.70461180783,2010.9297401988374,134566.63435200666,3377,6,705.8780487804878,33,8,21,32.639508707207746,0.6524621212121213,42.55514705882352,1029.779411764705,31.205436720142576,0
3416,4,0,0,41,0.0,0.0,1.0,41,1300,900,400,0.6923076923076923,17,9,8,380.541821425996,0.7890752032520325,0.22907688292102835,0.23157429219917708,132776.64389898116,1905.4131824298267,134682.05708141098,3378,7,706.8780487804878,33,8,19,32.53567181926275,0.6546717171717171,42.3406862745098,1030.6372549019607,31.23143196672608,0
3417,4,0,0,41,0.0,0.0,1.0,41,950,600,350,0.631578947368421,13,6,7,379.930715105043,0.7879573170731707,0.23272212750658117,0.23159254894663928,132839.803200692,1893.9842848904168,134733.7874855824,3379,8,707.8780487804878,33,8,19,32.48781502615311,0.6553030303030304,42.27941176470588,1030.8823529411761,31.23885918003564,0
3418,4,0,0,41,0.0,0.0,1.0,41,1050,800,250,0.7619047619047619,13,8,5,383.19949506321007,0.7874491869918699,0.23577429023636554,0.23397972071566386,132902.97752066507,1985.6707756631943,134888.64829632826,3380,9,708.8780487804878,33,8,19,32.33994929086443,0.6559343434343434,42.218137254901954,1031.1274509803916,31.2462863933452,0
3419,4,0,0,41,0.0,0.0,1.0,41,1250,900,350,0.72,16,9,7,378.4011600024826,0.7865345528455284,0.22463356700075288,0.23222578478286457,133092.5905901576,1872.478133410222,134965.06872356782,3381,10,709.8780487804878,33,8,20,32.2728622327791,0.6578282828282829,42.03431372549019,1031.8627450980389,31.268568033273905,0
3420,4,0,0,41,0.0,0.0,1.0,41,950,600,350,0.631578947368421,13,6,7,376.0983631987114,0.7864329268292682,0.22640307599657206,0.2315974131276276,133219.0743944637,1820.6951653210353,135039.76955978473,3382,11,710.8780487804878,33,8,20,32.20510842038619,0.6590909090909091,41.911764705882355,1032.352941176471,31.28342245989306,0
3421,4,0,0,41,0.0,0.0,1.0,41,1050,700,350,0.6666666666666666,14,7,7,372.0146351495421,0.7860772357723578,0.22482549457673007,0.22986358834606607,133345.61827181853,1721.3043060361404,135066.92257785468,3383,12,711.8780487804878,33,8,20,32.18339661445974,0.6603535353535354,41.78921568627451,1032.843137254902,31.298276886512184,0
3422,4,0,0,41,0.0,0.0,1.0,41,1300,800,500,0.6153846153846154,18,8,10,374.2578497913445,0.7858739837398374,0.22555986499032543,0.23223814917515856,133503.88259623686,1792.9752078527283,135296.85780408958,3384,13,712.8780487804878,33,8,20,31.966555002173994,0.6619318181818183,41.636029411764696,1033.4558823529399,31.316844919786057,0
3423,4,0,0,41,0.0,0.0,1.0,41,1150,900,250,0.782608695652174,14,9,5,373.84989084561346,0.7859756097560976,0.2297858805499733,0.2323820065794215,133567.21460796322,1786.8177203479345,135354.03232831115,3385,14,713.8780487804878,33,8,20,31.913529934795488,0.6625631313131313,41.57475490196078,1033.7009803921565,31.32427213309565,0
3424,4,0,0,41,0.0,0.0,1.0,41,950,700,250,0.7368421052631579,12,7,5,371.15918929300943,0.785670731707317,0.22817585688810227,0.2310765275275832,133626.0363520408,1719.3062641723275,135345.34261621314,3386,15,714.8780487804878,34,7,20,31.92405488389944,0.6608455882352942,41.51785714285714,1033.928571428571,30.409663865546207,0
3425,4,0,0,41,0.0,0.0,1.0,41,900,500,400,0.5555555555555556,13,5,8,369.84418352021726,0.785010162601626,0.22393427802126542,0.23064152349175362,133687.58680555562,1688.7152777777842,135376.3020833334,3387,16,715.8780487804878,34,7,20,31.896320171904364,0.6614583333333333,41.458333333333336,1034.1666666666672,30.416666666666682,0
3426,4,0,0,41,0.0,0.0,1.0,41,1250,800,450,0.64,17,8,9,375.23300158955294,0.7863821138211382,0.23290649237717242,0.2355704656188565,133933.9303429705,1851.2861394557824,135785.21648242627,3388,17,716.8780487804878,34,7,17,31.50996741422273,0.6639093137254901,41.220238095238095,1035.1190476190475,30.444677871148457,0
3427,4,0,0,41,0.0,0.0,1.0,41,1000,700,300,0.7,13,7,6,403.0209373528777,0.7867378048780488,0.30998569910389806,0.22717280853214056,129843.17440221985,2265.9035712911605,132109.077973511,3389,18,717.8780487804878,37,4,14,34.93399228976151,0.6168355855855856,45.20285087719298,1019.1885964912276,27.54563774300615,8
3428,4,1,0,42,0.023809523809523808,0.0,1.0,42,900,400,500,0.4444444444444444,14,4,10,398.24057450982787,0.7973770809136663,0.31366784854061014,0.22595360938766157,130099.04308431946,1962.1435322156403,132061.1866165351,3390,0,701.7619047619048,38,4,15,34.79487380877579,0.6175986842105263,44.95192307692307,1020.1923076923072,26.84716599190282,0
3429,4,1,0,43,0.023255813953488372,0.0,1.0,43,1450,1200,250,0.8275862068965517,17,12,5,394.0517704094427,0.8032484311554079,0.327502760442254,0.2256241334524008,130453.51765103375,1681.1906457739885,132134.70829680774,3391,0,686.4186046511628,38,5,16,34.540803876455406,0.6211622807017543,44.60470085470086,1021.5811965811972,26.88371569950519,0
3430,4,0,0,43,0.0,0.0,1.0,43,1000,600,400,0.6,14,6,8,390.80656765865064,0.8030177187153931,0.3185450832127794,0.22423904137102535,130535.38795976693,1602.817385309369,132138.2053450763,3392,1,687.4186046511628,38,5,16,34.5404251611779,0.621984649122807,44.52457264957265,1021.901709401709,26.892150247413394,0
3431,4,0,0,43,0.0,0.0,1.0,43,1050,800,250,0.7619047619047619,13,8,5,388.9205596697011,0.8024178663713547,0.3176269934596059,0.2242619034432758,130726.51855504415,1568.4461520198656,132294.964707064,3393,2,688.4186046511628,38,5,16,34.39437073408552,0.6239035087719298,44.337606837606835,1022.6495726495723,26.91183085919927,0
3432,4,0,0,43,0.0,0.0,1.0,43,800,600,200,0.75,10,6,4,388.688904119236,0.8016334440753045,0.32481890964544435,0.22492287823262375,130863.12601587042,1573.0090081452295,132436.13502401565,3394,3,689.4186046511628,38,5,16,34.261555462740596,0.6252741228070176,44.20405982905983,1023.1837606837607,26.925888439046336,0
3433,4,0,0,43,0.0,0.0,1.0,43,1300,900,400,0.6923076923076923,17,9,8,388.3225505129158,0.8003414544112218,0.31905336242231286,0.22566979997363695,131027.14913662434,1576.1593478340333,132603.30848445836,3395,4,690.4186046511628,38,5,16,34.10444711120387,0.6269188596491228,44.04380341880342,1023.8247863247866,26.942757534862807,0
3434,4,1,0,44,0.022727272727272728,0.0,1.0,44,750,500,250,0.6666666666666666,10,5,5,380.7257584770966,0.8046379492600423,0.318366592756836,0.22299651567944256,131328.12500000017,1200.000000000016,132528.1250000002,3396,0,675.7045454545455,39,5,17,33.99390243902439,0.6282051282051282,43.75000000000001,1025.0000000000014,26.282051282051317,0
3435,4,1,1,44,0.022222222222222223,0.022222222222222223,0.9777777777777777,45,1200,700,500,0.5833333333333334,17,7,10,372.6627905424151,0.8085437710437711,0.3103351829295804,0.22011233887433296,131648.6328125,812.1093750000016,132460.7421875,3397,0,661.6666666666666,39,6,16,33.87637028014617,0.6314102564102565,43.4375,1026.25,26.314102564102566,0
3436,4,0,0,44,0.0,0.0,1.0,44,1350,900,450,0.6666666666666666,18,9,9,393.24675185847786,0.804197498238196,0.32429424342275137,0.22086564538011894,129701.96926708249,1430.3159025634404,131132.28516964594,3398,2,677.7045454545455,35,9,14,35.327069840548404,0.6193452380952381,45.34143518518518,1018.6342592592594,29.10383597883598,7
3437,4,0,0,44,0.0,0.0,1.0,44,1200,900,300,0.75,15,9,6,391.40564918443687,0.8039332276250881,0.3174849792496859,0.22066057277324885,129849.38298396762,1364.7564086076695,131214.13939257528,3399,3,678.7045454545455,35,9,15,35.223616473616474,0.6208333333333333,45.19675925925925,1019.2129629629617,29.120370370370335,0
3438,4,1,0,45,0.022222222222222223,0.0,1.0,45,1250,900,350,0.72,16,9,7,384.0075487722551,0.8113636363636364,0.3243630299909266,0.21831094146638508,130176.38204082471,997.74267510755,131174.12471593227,3400,0,664.6,36,9,17,35.07917678216729,0.6221064814814814,44.87612612612613,1020.4954954954964,28.34709709709712,0
3439,4,0,0,45,0.0,0.0,1.0,45,1150,900,250,0.782608695652174,14,9,5,386.00583090379047,0.8115319865319865,0.3225396825396829,0.2199335548172757,130262.58680555537,1056.4521447122604,131319.03895026763,3401,1,665.6,35,10,17,34.940476190476176,0.625,44.79166666666666,1020.8333333333319,29.166666666666625,0
3440,4,1,1,45,0.021739130434782608,0.021739130434782608,0.9782608695652174,46,1150,900,250,0.782608695652174,14,9,5,380.5122712287171,0.8141304347826087,0.31795574551274,0.21825337225849428,130521.37230135538,732.9967636555428,131254.36906501092,3402,0,652.1086956521739,36,10,13,34.81765667474835,0.6255787037037037,44.538288288288285,1021.8468468468467,28.38463463463463,0
3441,4,1,1,45,0.021739130434782608,0.021739130434782608,0.9782608695652174,46,1150,800,350,0.6956521739130435,15,8,7,379.1688165295639,0.8171296296296297,0.3114457802482973,0.21861790621618823,130722.82745160678,713.203955644808,131436.03140725158,3403,0,653.0869565217391,36,10,15,34.64743236794773,0.6276041666666667,44.3412162162162,1022.6351351351332,28.406531531531478,0
3442,4,0,0,45,0.0,0.0,1.0,45,1100,900,200,0.8181818181818182,13,9,4,384.7478753068043,0.8093013468013468,0.3169904316447263,0.2220781825007334,130765.2167593663,1062.3278624399723,131827.54462180627,3404,4,668.6,35,10,15,34.46175644072272,0.6300595238095239,44.29976851851851,1022.800925925925,29.22288359788357,0
3443,4,1,0,46,0.021739130434782608,0.0,1.0,46,1200,1000,200,0.8333333333333334,14,10,4,379.50910193942934,0.8106078904991949,0.3194222659947794,0.22095107381800042,131097.3705969481,750.5290763736523,131847.89967332175,3405,0,655.0434782608696,36,10,16,34.25885199032329,0.6313657407407409,43.975225225225216,1024.0990990990977,28.447197197197156,0
3444,4,0,0,46,0.0,0.0,1.0,46,1000,800,200,0.8,12,8,4,381.027082177868,0.8102858293075684,0.32276968375970316,0.22216809868524906,131155.04017531034,794.7244541838986,131949.76462949422,3406,1,656.0434782608696,36,10,16,34.16153620639109,0.6319444444444446,43.91891891891891,1024.3243243243235,28.45345345345343,0
3445,4,1,1,46,0.02127659574468085,0.02127659574468085,0.9787234042553191,47,1600,1200,400,0.75,20,12,8,373.01521053535186,0.8154486586493986,0.322099670816697,0.21930597303714966,131472.44953991144,408.35882335036604,131880.8083632618,3407,0,643.063829787234,36,11,18,34.045468687090505,0.6351273148148149,43.60923423423423,1025.5630630630624,28.487862862862844,0
3446,4,0,1,45,0.0,0.021739130434782608,0.9782608695652174,46,800,300,500,0.375,13,3,10,370.25624801523173,0.8155394524959743,0.3116323793980518,0.21834334470335115,131587.9662390431,544.2533327246163,132132.21957176772,3408,1,654.1304347826087,36,10,13,33.99942377346065,0.6362847222222223,43.49662162162162,1026.0135135135135,28.500375375375377,0
3447,4,0,0,45,0.0,0.0,1.0,45,1050,700,350,0.6666666666666666,14,7,7,385.08866072889566,0.8076178451178452,0.33497288434859485,0.21775552638135845,129967.37423911154,1012.2780105399163,130979.65224965145,3409,2,669.2666666666667,35,10,18,35.26437760121074,0.6220238095238096,45.081018518518505,1019.6759259259238,29.133597883597822,3
3448,4,0,0,45,0.0,0.0,1.0,45,1000,600,400,0.6,14,6,8,382.71092790328964,0.8071969696969697,0.32599462662397416,0.21677378824390825,130032.77084094225,952.9924772745628,130985.7633182168,3410,3,670.2666666666667,36,9,18,35.258409701519994,0.6206597222222223,45.01689189189189,1019.932432432432,28.331456456456447,0
3449,4,1,0,46,0.021739130434782608,0.0,1.0,46,1000,600,400,0.6,14,6,8,374.25512614739574,0.813768115942029,0.3222672724484321,0.2143461177025991,130463.84222059874,565.5552511971177,131029.39747179586,3411,0,656.6739130434783,36,10,19,35.03591637272193,0.6250000000000002,44.59459459459458,1021.6216216216197,28.378378378378326,0
3450,4,1,1,46,0.02127659574468085,0.02127659574468085,0.9787234042553191,47,1150,900,250,0.782608695652174,14,9,5,368.7757253103221,0.8221554116558741,0.3257271632422174,0.21286757213457191,130766.77439212055,244.7224145890906,131011.49680670965,3412,0,643.6808510638298,37,10,15,34.86858562035448,0.6261261261261262,44.29824561403508,1022.8070175438588,27.64343290659078,0
3451,4,0,0,46,0.0,0.0,1.0,46,1000,500,500,0.5,15,5,10,374.71077418721126,0.8208735909822866,0.33050230584674645,0.21572600626795732,130665.2529852486,592.3356210940497,131257.58860634264,3413,1,658.5217391304348,36,10,16,34.81982230054706,0.627025462962963,44.397522522522515,1022.4099099099086,28.400275275275238,0
3452,4,0,0,46,0.0,0.0,1.0,46,750,300,450,0.4,12,3,9,376.2847937311318,0.8206320450885669,0.33730236610198694,0.21727875279465164,130780.41459956572,642.1362663338942,131422.5508658996,3414,2,659.5217391304348,36,10,16,34.662739917061174,0.6281828703703705,44.284909909909906,1022.8603603603599,28.412787787787774,0
3453,4,0,1,45,0.0,0.021739130434782608,0.9782608695652174,46,1000,800,200,0.8,12,8,4,377.0454683871059,0.8209742351046699,0.32780943631848647,0.21836916323987443,130895.62694028478,670.7205939047019,131566.3475341895,3415,3,660.5217391304348,36,10,17,34.52642969810352,0.6293402777777779,44.17229729729729,1023.31081081081,28.42530030030028,0
3454,4,2,1,46,0.0425531914893617,0.02127659574468085,0.9787234042553191,47,1400,1000,400,0.7142857142857143,18,10,8,363.93541137761576,0.8248149861239592,0.3129551181514614,0.21300590420454404,131300.0289151467,156.9460074253289,131456.974922572,3416,0,647.2553191489362,37,10,18,34.45256499411575,0.6314752252252254,43.77741228070174,1024.8903508771907,27.699739212897047,0
3455,4,0,0,46,0.0,0.0,1.0,46,1150,1000,150,0.8695652173913043,13,10,3,369.60647503037336,0.8219806763285025,0.32194844542995593,0.21583310075907147,131212.72243527306,499.4143636880025,131712.13679896106,3417,1,662.3260869565217,36,10,18,34.39560892503846,0.6325231481481483,43.86261261261261,1024.549549549549,28.459709709709696,0
3456,4,0,0,46,0.0,0.0,1.0,46,1200,800,400,0.6666666666666666,16,8,8,368.5632769912752,0.821658615136876,0.3144580218717006,0.21571452411004652,131300.0289151467,478.4737852031077,131778.50270034978,3418,2,663.3260869565217,37,9,18,34.33398862380085,0.6314752252252254,43.77741228070174,1024.8903508771907,27.699739212897047,0
3457,4,0,0,46,0.0,0.0,1.0,46,1100,700,400,0.6363636363636364,15,7,8,370.62099679488813,0.8212962962962963,0.3169398370792029,0.21775212411158545,131446.7860510974,543.3937858134888,131990.17983691092,3419,3,664.3260869565217,35,11,18,34.13280662151995,0.6369047619047619,43.63425925925926,1025.462962962963,29.2989417989418,0
3458,4,0,0,46,0.0,0.0,1.0,46,1600,1400,200,0.875,18,14,4,363.77345121215194,0.8217391304347826,0.31155762110165286,0.21468288131121294,131616.85333982625,375.74339542244206,131992.5967352487,3420,4,665.3260869565217,36,10,17,34.13653241147205,0.6365740740740742,43.468468468468465,1026.1261261261257,28.50350350350349,0
3459,4,0,0,46,0.0,0.0,1.0,46,1250,1100,150,0.88,14,11,3,363.31453022642637,0.8203502415458938,0.3067139899438036,0.21473726514161176,131674.63705259323,367.8617806996306,132042.49883329286,3421,5,666.3260869565217,36,10,17,34.08995318557531,0.6371527777777777,43.41216216216217,1026.3513513513522,28.50975975975978,0
3460,4,0,0,46,0.0,0.0,1.0,46,1200,800,400,0.6666666666666666,16,8,8,362.1604415691585,0.8192431561996779,0.3036371787778771,0.21438016787950978,131732.43344696064,341.65525322621653,132074.08870018687,3422,6,667.3260869565217,36,10,17,34.061220198917646,0.6377314814814814,43.355855855855864,1026.5765765765777,28.51601601601605,0
3461,4,0,0,46,0.0,0.0,1.0,46,700,500,200,0.7142857142857143,9,5,4,362.835046678622,0.8177133655394525,0.30742556332339954,0.21535570641267238,131834.36850761762,366.8258502616117,132201.19435787923,3423,7,668.3260869565217,37,9,17,33.941027831162366,0.6368243243243243,43.25657894736842,1026.9736842105256,27.756045519203393,0
3462,4,0,1,45,0.0,0.021739130434782608,0.9782608695652174,46,900,400,500,0.4444444444444444,14,4,10,364.48075045929863,0.8185185185185185,0.30587443738109554,0.21697488130899797,131946.99931709756,418.4282663896592,132365.4275834872,3424,8,669.3260869565217,37,9,17,33.78512984702951,0.6379504504504505,43.146929824561404,1027.4122807017545,27.767899478425797,0
3463,4,0,0,45,0.0,0.0,1.0,45,1100,700,400,0.6363636363636364,15,7,8,376.2049380578636,0.8146885521885522,0.31441520467836215,0.22337168197185672,131848.06428049688,920.3785711387192,132768.4428516356,3425,13,685.0222222222222,36,9,17,33.58392726608185,0.6388888888888888,43.24324324324325,1027.0270270270282,28.52852852852856,0
3464,4,0,0,45,0.0,0.0,1.0,45,1050,700,350,0.6666666666666666,14,7,7,379.55329317455653,0.8141414141414142,0.31838941868537374,0.22587506155456508,131934.82069485035,1015.2591358250263,132950.0798306754,3426,14,686.0222222222222,36,9,17,33.41029084000145,0.6397569444444444,43.15878378378379,1027.3648648648657,28.537912912912937,0
3465,4,0,0,45,0.0,0.0,1.0,45,1200,900,300,0.75,15,9,6,378.21246455916605,0.8143097643097643,0.31551367277862985,0.22559261121352636,132021.60564280508,986.4433690447327,133008.0490118498,3427,15,687.0222222222222,36,9,17,33.35707502374169,0.640625,43.07432432432433,1027.7027027027036,28.547297297297323,0
3466,4,0,0,45,0.0,0.0,1.0,45,850,700,150,0.8235294117647058,10,7,3,378.21246455916605,0.8143097643097643,0.31551367277862985,0.22559261121352636,132021.60564280508,986.4433690447327,133008.0490118498,3428,16,688.0222222222222,36,9,17,33.35707502374169,0.640625,43.07432432432433,1027.7027027027036,28.547297297297323,0
3467,4,0,0,45,0.0,0.0,1.0,45,1200,900,300,0.75,15,9,6,380.94403200012994,0.8132575757575758,0.31456698183234155,0.22809180040611074,132166.31063073222,1069.5934532505635,133235.90408398278,3429,17,689.0222222222222,36,9,17,33.14076588909575,0.6420717592592593,42.933558558558566,1028.265765765767,28.56293793793797,0
3468,4,0,0,45,0.0,0.0,1.0,45,1600,1200,400,0.75,20,12,8,379.98305533479004,0.8131734006734007,0.3087048681421489,0.228403652031155,132313.3815813518,1055.3685989919823,133368.75018034378,3430,18,690.0222222222222,37,8,18,33.01704767487299,0.6416103603603605,42.79057017543859,1028.8377192982443,27.806424845898494,0
3469,4,0,0,45,0.0,0.0,1.0,45,950,600,350,0.631578947368421,13,6,7,381.21032859028253,0.8130471380471381,0.3114409585566684,0.22983752217989017,132427.78427479844,1096.621934761378,133524.40620955982,3431,19,691.0222222222222,35,10,18,32.87007102964879,0.6467261904761905,42.679398148148145,1029.2824074074067,29.408068783068764,0
3470,4,0,0,45,0.0,0.0,1.0,45,1200,900,300,0.75,15,9,6,379.30010367169734,0.8120791245791246,0.3016097810747693,0.2294108104940237,132546.94097490126,1055.0136906292669,133601.95466553053,3432,20,692.0222222222222,35,10,19,32.79909426398411,0.6479166666666667,42.5636574074074,1029.745370370369,29.42129629629626,0
3471,4,0,1,44,0.0,0.022222222222222223,0.9777777777777777,45,1100,700,400,0.6363636363636364,15,7,8,379.5688149465048,0.8119107744107744,0.3005666641703486,0.23048578380994433,132695.96220207465,1073.449824245526,133769.41202632018,3433,21,693.0222222222222,35,10,17,32.6420092863027,0.649404761904762,42.418981481481474,1030.3240740740732,29.437830687830665,0
3472,4,0,0,44,0.0,0.0,1.0,44,1600,1200,400,0.75,20,12,8,380.8623439241772,0.8104959478505991,0.2972916229267273,0.23227238721009652,132857.85147392272,1320.1105442176688,134177.9620181404,3434,22,704.5909090909091,34,10,17,32.445631254811396,0.653186274509804,42.26190476190475,1030.9523809523796,30.322128851540576,0
3473,4,0,0,44,0.0,0.0,1.0,44,900,700,200,0.7777777777777778,11,7,4,379.5824159915188,0.8102977448907682,0.2964138465934605,0.23159727134605798,132874.89819101492,1287.3949759944917,134162.2931670094,3435,23,705.5909090909091,35,9,17,32.461457865588976,0.6511904761904763,42.24537037037036,1031.018518518517,29.457671957671916,0
3474,4,0,0,44,0.0,0.0,1.0,44,1250,1100,150,0.88,14,11,3,378.5328027752275,0.8104739252995067,0.2933425160697891,0.23132560169597197,132934.57031249974,1264.019097222194,134198.58940972193,3436,24,706.5909090909091,35,9,18,32.428451178451176,0.6517857142857144,42.187499999999986,1031.249999999998,29.464285714285655,0
3475,4,0,0,44,0.0,0.0,1.0,44,950,500,450,0.5263157894736842,14,5,9,353.8644687884988,0.8105399929527837,0.27786521014626975,0.20440876961782678,130794.81336805545,466.4930555555454,131261.30642361098,3437,25,707.5909090909091,35,9,19,35.22148676171079,0.6303571428571428,44.27083333333333,1022.9166666666657,29.22619047619045,4
3476,4,1,1,44,0.022222222222222223,0.022222222222222223,0.9777777777777777,45,1600,1200,400,0.75,20,12,8,349.5478702664903,0.8120791245791246,0.2781119554746869,0.20398661785757766,131187.6746330602,171.27445463989284,131358.9490877001,3438,0,692.8444444444444,37,8,21,34.93468818009918,0.6303490990990991,43.887061403508774,1024.4517543859652,27.687885253674732,0
3477,4,0,0,44,0.0,0.0,1.0,44,1650,1400,250,0.8484848484848485,19,14,5,358.92551727434943,0.8098132487667372,0.2805178391231806,0.2097535826383626,131241.56832085463,621.1895594919242,131862.75788034656,3439,27,709.5909090909091,36,8,22,34.640024544821785,0.6328125,43.83445945945946,1024.662162162162,28.462837837837835,0
3478,4,0,0,44,0.0,0.0,1.0,44,1350,1100,250,0.8148148148148148,16,11,5,358.92551727434943,0.8093948202959831,0.2805178391231806,0.2097535826383626,131241.56832085463,621.1895594919242,131862.75788034656,3440,28,710.5909090909091,36,8,22,34.640024544821785,0.6328125,43.83445945945946,1024.662162162162,28.462837837837835,0
3479,4,1,0,45,0.022222222222222223,0.0,1.0,45,1000,700,300,0.7,13,7,6,350.31108754004146,0.8115319865319865,0.2730924902572587,0.20694259914840424,131654.57182623885,224.06831441598484,131878.64014065484,3441,0,695.7777777777778,35,10,16,34.44384139693997,0.6389880952380952,43.43171296296296,1026.273148148148,29.322089947089943,0
3480,4,0,0,45,0.0,0.0,1.0,45,1450,1100,350,0.7586206896551724,18,11,7,349.3964728805359,0.8106060606060607,0.2698831398188857,0.20704716839834547,131773.38023244584,208.23085455245206,131981.61108699828,3442,1,696.7777777777778,35,10,18,34.34752282718972,0.6401785714285715,43.315972222222214,1026.73611111111,29.335317460317427,0
3481,4,0,0,45,0.0,0.0,1.0,45,1250,700,550,0.56,18,7,11,351.85726844091266,0.8086700336700338,0.269941046149224,0.20948604774983104,131951.6933111497,285.6324749228315,132237.32578607253,3443,2,697.7777777777778,35,10,18,34.104638391348416,0.6419642857142858,43.14236111111111,1027.4305555555554,29.355158730158728,0
3482,4,0,0,45,0.0,0.0,1.0,45,1100,600,500,0.5454545454545454,16,6,10,351.31482834185556,0.8067340067340067,0.26726726726726735,0.20965562336530078,132040.89506172828,277.5848765431987,132318.47993827148,3444,3,698.7777777777778,35,10,18,34.02871621621621,0.6428571428571428,43.05555555555555,1027.777777777777,29.36507936507934,0
3483,4,0,0,45,0.0,0.0,1.0,45,1000,700,300,0.7,13,7,6,349.58556337007417,0.805976430976431,0.2622642453349342,0.20928019844876944,132159.87761488336,240.23705418380263,132400.11466906714,3445,4,699.7777777777778,35,10,20,33.95336184901696,0.644047619047619,42.93981481481481,1028.2407407407402,29.378306878306862,0
3484,4,0,0,45,0.0,0.0,1.0,45,850,400,450,0.47058823529411764,13,4,9,352.9477263036159,0.8052609427609428,0.2693463317085365,0.21229399775636973,132338.45191400888,341.71114111796754,132680.16305512685,3446,5,700.7777777777778,35,10,21,33.687195350581185,0.6458333333333334,42.7662037037037,1028.935185185185,29.39814814814814,0
3485,4,1,0,46,0.021739130434782608,0.0,1.0,46,800,400,400,0.5,12,4,8,361.9922800870228,0.8106280193236716,0.299040374710827,0.21724293602594408,132253.17166829002,379.7613589722259,132632.93302726225,3447,0,686.5217391304348,36,10,21,33.54043500474418,0.6429398148148147,42.84909909909911,1028.6036036036046,28.57232232232235,2
3486,4,0,0,46,0.0,0.0,1.0,46,1150,800,350,0.6956521739130435,15,8,7,360.25583527989954,0.810024154589372,0.29702053735037226,0.21636667030124157,132282.13168827622,331.08196879312663,132613.21365706934,3448,1,687.5217391304348,36,10,21,33.55592045247218,0.6432291666666665,42.82094594594595,1028.716216216217,28.57545045045047,0
3487,4,0,0,46,0.0,0.0,1.0,46,1250,1000,250,0.8,15,10,5,361.7499057516103,0.8098429951690822,0.2995071290265796,0.21793226029426302,132398.00347222236,378.9930555555743,132776.99652777793,3449,2,688.5217391304348,36,10,21,33.400809716599206,0.644386574074074,42.70833333333334,1029.1666666666679,28.587962962962997,0
3488,4,0,0,46,0.0,0.0,1.0,46,1050,700,350,0.6666666666666666,14,7,7,357.6798422934278,0.8092592592592592,0.2936918823825081,0.2163587857229475,132551.19756235817,282.17828798184684,132833.37585034,3450,3,689.5217391304348,34,12,22,33.35139691714836,0.6501225490196079,42.5595238095238,1029.761904761904,30.28711484593835,0
3489,4,0,1,45,0.0,0.021739130434782608,0.9782608695652174,46,850,600,250,0.7058823529411765,11,6,5,356.37980331165363,0.8100644122383253,0.29442802870409435,0.21592423377117842,132612.5,252.08333333333303,132864.58333333334,3451,4,690.5217391304348,34,12,22,33.323220064724914,0.650735294117647,42.5,1030.0,30.294117647058822,0
3490,4,0,0,45,0.0,0.0,1.0,45,1150,800,350,0.6956521739130435,15,8,7,358.6504412448694,0.80993265993266,0.2868456180695982,0.21770211260257158,132681.9331056564,517.2867707131813,133199.2198763696,3452,5,693.2888888888889,33,12,16,33.19493180286269,0.6537247474747474,42.432598039215684,1030.2696078431368,31.22029114676172,0
3491,4,0,0,45,0.0,0.0,1.0,45,1500,1000,500,0.6666666666666666,20,10,10,359.8318251090231,0.8087121212121212,0.2866941331998516,0.21890822979401328,132765.8180980724,554.6733276643818,133320.49142573678,3453,6,694.2888888888889,34,11,16,33.08016633937853,0.6522671568627452,42.35119047619047,1030.595238095237,30.31162464985991,0
3492,4,0,0,45,0.0,0.0,1.0,45,900,500,400,0.5555555555555556,13,5,8,363.2997400940681,0.8090488215488216,0.28861941974310623,0.22138018645140986,132827.17013888876,651.2152777777592,133478.3854166665,3454,7,695.2888888888889,34,11,16,32.92912961465913,0.6528799019607844,42.29166666666666,1030.8333333333321,30.318627450980358,0
3493,4,0,0,45,0.0,0.0,1.0,45,900,700,200,0.7777777777777778,11,7,4,359.7703880584476,0.8098484848484849,0.28432232740706587,0.21976947118210646,132919.22477324243,564.0802154194812,133483.3049886619,3455,8,696.2888888888889,34,11,17,32.92758600785038,0.6537990196078433,42.20238095238094,1031.1904761904748,30.329131652661022,0
3494,4,0,1,44,0.0,0.022222222222222223,0.9777777777777777,45,650,400,250,0.6153846153846154,9,4,5,361.2450118879534,0.8096380471380472,0.2863758750673131,0.22139669540459705,133042.0138888888,612.1527777777696,133654.16666666657,3456,9,697.2888888888889,34,11,18,32.76622240172322,0.6550245098039216,42.08333333333333,1031.6666666666658,30.343137254901936,0
3495,4,0,0,44,0.0,0.0,1.0,44,1750,1400,350,0.8,21,14,7,371.73670647255295,0.8028761451726568,0.2942447286553751,0.2273645437262358,132966.1668589004,1085.6809880815058,134051.8478469819,3457,16,713.9318181818181,33,11,18,32.57188688212928,0.6565656565656566,42.15686274509804,1031.3725490196075,31.253713606654774,0
3496,4,0,0,44,0.0,0.0,1.0,44,1000,500,500,0.5,15,5,10,367.6394450450956,0.8030082804792108,0.29201643150562595,0.22545599702163072,133065.2506391525,984.0069799529037,134049.25761910542,3458,17,714.9318181818181,36,8,18,32.57794877392126,0.6510416666666667,42.0608108108108,1031.7567567567555,28.659909909909874,0
3497,4,0,0,44,0.0,0.0,1.0,44,1650,1000,650,0.6060606060606061,23,10,13,369.56039819931783,0.8013125440451022,0.30043179091603167,0.22787486826425957,133268.658755884,1050.1637194626783,134318.82247534668,3459,18,715.9318181818181,36,8,19,32.32404478859926,0.6530671296296298,41.863738738738725,1032.545045045043,28.68180680680675,0
3498,4,1,0,45,0.022222222222222223,0.0,1.0,45,1350,900,450,0.6666666666666666,18,9,9,359.92003414030023,0.8065656565656566,0.2951650725897821,0.2235320742223338,133535.54672481734,613.0451056534354,134148.59183047077,3460,0,701.0,33,12,20,32.30525254920559,0.6622474747474747,41.60539215686274,1033.5784313725487,31.32055852644087,0
3499,4,0,0,45,0.0,0.0,1.0,45,850,700,150,0.8235294117647058,10,7,3,356.54283866763853,0.8056397306397307,0.28665003518198673,0.22197667052533593,133626.03635204068,528.6812641723143,134154.717616213,3461,1,702.0,34,11,21,32.30186144693916,0.6608455882352942,41.51785714285713,1033.9285714285702,30.409663865546182,0
3500,4,1,1,45,0.021739130434782608,0.021739130434782608,0.9782608695652174,46,1350,1200,150,0.8888888888888888,15,12,3,350.0244134831579,0.8111111111111111,0.28256493048632825,0.21931102179067347,133861.20119866662,170.9376875428391,134032.13888620946,3462,0,687.7173913043479,35,11,16,32.23504548335384,0.6610119047619047,41.290509259259245,1034.8379629629612,29.566798941798893,0
3501,4,0,0,45,0.0,0.0,1.0,45,800,700,100,0.875,9,7,2,360.3794824550736,0.8044612794612795,0.2922366721653178,0.2251141138067675,133749.15143140592,640.089994331068,134389.24142573698,3463,3,704.0,34,11,17,32.07935320520199,0.6620710784313726,41.398809523809526,1034.4047619047622,30.42366946778712,0
3502,4,0,1,44,0.0,0.022222222222222223,0.9777777777777777,45,1000,500,500,0.5,15,5,10,360.34037774726175,0.8044612794612795,0.2876358521928142,0.2252775455124968,133779.93905895698,641.2627551020443,134421.20181405902,3464,4,705.0,34,11,18,32.049530111238965,0.6623774509803921,41.36904761904762,1034.5238095238099,30.42717086834735,0
3503,4,0,0,44,0.0,0.0,1.0,44,800,700,100,0.875,9,7,2,369.895237754787,0.7991323114869627,0.2893012629854739,0.23012066561204908,133598.88624567486,1083.5183583237429,134682.4046039986,3465,24,721.9318181818181,33,11,20,31.98395764185239,0.6628787878787878,41.54411764705883,1033.8235294117658,31.327985739750478,0
3504,4,0,0,44,0.0,0.0,1.0,44,1400,1000,400,0.7142857142857143,18,10,8,371.84811661912363,0.7984716349541932,0.2978026712623869,0.23213003729773699,133725.6103421762,1145.1232698962083,134870.7336120724,3466,25,722.9318181818181,33,11,18,31.806378357030013,0.6641414141414141,41.42156862745099,1034.313725490197,31.342840166369605,0
3505,4,0,0,44,0.0,0.0,1.0,44,1500,1100,400,0.7333333333333333,19,11,8,369.7489476184503,0.7978990486257929,0.29439946600060285,0.2316142517574328,133852.39451172622,1098.3564013840783,134950.7509131103,3467,26,723.9318181818181,33,11,19,31.733578083057015,0.6654040404040404,41.299019607843135,1034.8039215686272,31.357694592988704,0
3506,4,0,0,44,0.0,0.0,1.0,44,1500,1100,400,0.7333333333333333,19,11,8,371.0082980287806,0.7964896053558844,0.2854599246906939,0.23360805650843494,134042.68340301808,1146.1895665128834,135188.87296953096,3468,27,724.9318181818181,33,11,19,31.510355029585806,0.6672979797979798,41.115196078431374,1035.5392156862747,31.379976232917414,0
3507,4,0,1,43,0.0,0.022727272727272728,0.9772727272727273,44,1300,1100,200,0.8461538461538461,15,11,4,371.7769909607616,0.7958949964763918,0.2874458106087501,0.23429435873299,134074.41135921283,1169.1562439926981,135243.56760320553,3469,28,725.9318181818181,33,11,19,31.458678460142774,0.6676136363636364,41.08455882352941,1035.6617647058824,31.383689839572195,0
3508,4,0,1,42,0.0,0.023255813953488372,0.9767441860465116,43,1300,1100,200,0.8461538461538461,15,11,4,379.28598052696873,0.7994647471391657,0.28433288056192807,0.23872020923266843,134027.3015030353,1566.9352935924767,135594.23679662778,3470,29,712.7209302325581,32,11,19,31.311476242734617,0.6695963541666667,41.1300505050505,1035.4797979797972,32.358743686868664,0
3509,4,0,0,42,0.0,0.0,1.0,42,1050,700,350,0.6666666666666666,14,7,7,383.6942310175619,0.7968205574912892,0.2907309704184704,0.2411792309253247,133979.2387543253,1881.4121972318408,135860.65095155715,3471,30,727.8809523809524,33,9,19,31.245561079545467,0.6666666666666666,41.1764705882353,1035.2941176470592,31.372549019607856,0
3510,4,0,0,42,0.0,0.0,1.0,42,950,600,350,0.631578947368421,13,6,7,379.1080957609618,0.7977158343012002,0.2928095407096949,0.2393279113866622,134137.8785352988,1770.5511401864528,135908.42967548527,3472,31,728.8809523809524,33,9,20,31.205267360700336,0.6682449494949496,41.02328431372548,1035.906862745097,31.391117052881725,0
3511,4,0,0,42,0.0,0.0,1.0,42,1150,800,350,0.6956521739130435,15,8,7,378.6602865446355,0.798054587688734,0.2885725226334075,0.2397263850451673,134242.1786422902,1766.4363662131464,136008.61500850334,3473,32,729.8809523809524,34,8,20,31.11238751675283,0.6669730392156863,40.922619047619044,1036.3095238095234,30.47969187675069,0
3512,4,0,0,42,0.0,0.0,1.0,42,1100,800,300,0.7272727272727273,14,8,6,382.46172911433274,0.7988772744870306,0.26642150130720954,0.22633417875906342,131721.7857898584,1676.062699433421,133397.84848929182,3474,33,730.8809523809524,37,5,19,33.55096845403403,0.6356981981981982,43.36622807017544,1026.5350877192982,27.744191559981033,6
3513,4,1,0,43,0.023255813953488372,0.0,1.0,43,1000,500,500,0.5,15,5,10,376.2359669849655,0.80218715393134,0.263041028856444,0.22442225213262812,132023.05230034713,1334.3641493055516,133357.4164496527,3475,0,714.8604651162791,39,4,20,33.40639570241233,0.6351495726495726,43.072916666666664,1027.7083333333328,26.351495726495713,0
3514,4,0,0,43,0.0,0.0,1.0,43,800,500,300,0.625,11,5,6,377.5018735348756,0.8014488741232927,0.26624937547722904,0.22549567118899258,132076.58420138908,1371.8315972222429,133448.41579861133,3476,1,715.8604651162791,39,4,21,33.31982164572354,0.6356837606837606,43.02083333333334,1027.9166666666683,26.35683760683765,0
3515,4,1,0,44,0.022727272727272728,0.0,1.0,44,1250,800,450,0.64,17,8,9,359.29164020541685,0.8094829105003524,0.28879382119873465,0.200516278577659,129452.33298947733,510.7351540858514,129963.06814356319,3477,0,700.5681818181819,37,7,20,36.44576284883095,0.6128941441441442,45.586622807017534,1017.6535087719283,27.50414888572779,7
3516,4,0,0,44,0.0,0.0,1.0,44,1350,1000,350,0.7407407407407407,17,10,7,357.7489452230965,0.8088883016208598,0.28066226681417605,0.2005919379921501,129636.22708013718,475.44470012416673,130111.67178026134,3478,1,701.5681818181819,38,6,21,36.29790879843333,0.6129385964912282,45.405982905982896,1018.3760683760671,26.79937022042282,0
3517,4,1,0,45,0.022222222222222223,0.0,1.0,45,1200,800,400,0.6666666666666666,16,8,8,354.0645694414158,0.8160774410774411,0.29272500283736225,0.2003637072156913,129996.88042534715,205.45789930554662,130202.3383246527,3479,0,686.9555555555555,39,6,22,36.02528089887639,0.6148504273504274,45.05208333333333,1019.791666666666,26.148504273504255,0
3518,4,0,0,45,0.0,0.0,1.0,45,1450,1000,450,0.6896551724137931,19,10,9,360.0756369088237,0.8140572390572391,0.30158341273081946,0.20459982245700928,130156.27170138896,373.2204861111161,130529.49218750007,3480,1,687.9555555555555,39,6,22,35.710153804273844,0.6164529914529915,44.895833333333336,1020.4166666666673,26.164529914529933,0
3519,4,0,0,45,0.0,0.0,1.0,45,1300,800,500,0.6153846153846154,18,8,10,356.95426022537134,0.8134680134680136,0.2887958090192002,0.20352731885844677,130290.571678305,301.64173110958313,130592.21340941459,3481,2,688.9555555555555,37,8,22,35.653505710091984,0.6213400900900901,44.76425438596492,1020.9429824561415,27.593053579895717,0
3520,4,2,3,44,0.0425531914893617,0.06382978723404255,0.9361702127659575,47,1300,1100,200,0.8461538461538461,15,11,4,341.75235709159983,0.8249306197964846,0.28357238809204,0.19741224391997142,130794.81336805571,-460.1128472222031,130334.7005208335,3482,0,660.5957446808511,39,8,19,35.531228784792944,0.6228632478632479,44.27083333333334,1022.9166666666679,26.22863247863251,0
3521,4,1,1,44,0.022222222222222223,0.022222222222222223,0.9777777777777777,45,1000,700,300,0.7,13,7,6,355.97649497263393,0.8151936026936027,0.3005386338719671,0.20488424932869373,130654.64854570632,301.9967682363745,130956.6453139427,3483,0,689.3555555555556,37,8,20,35.309416559416555,0.625,44.4078947368421,1022.3684210526312,27.63157894736841,0
3522,4,1,2,43,0.022222222222222223,0.044444444444444446,0.9555555555555556,45,900,600,300,0.6666666666666666,12,6,6,357.379416109355,0.8133838383838384,0.301490458281098,0.20607444403606912,130726.51855504425,343.79337424210064,131070.31192928636,3484,0,690.3333333333334,38,7,20,35.2007591586572,0.6239035087719298,44.33760683760684,1022.6495726495731,26.91183085919929,0
3523,4,0,0,43,0.0,0.0,1.0,43,1400,1100,300,0.7857142857142857,17,11,6,369.21492637950007,0.807124400147656,0.3076316065906417,0.21224597129491587,130607.691200491,1044.4618182371505,131652.15301872816,3485,6,698.1627906976744,36,7,20,35.01868275127611,0.6264467592592593,44.453828828828826,1022.1846846846844,28.394019019019012,0
3524,4,1,0,44,0.022727272727272728,0.0,1.0,44,1000,700,300,0.7,13,7,6,336.57797577877477,0.8149004580690627,0.25356851652389323,0.18705450456972994,129287.27027280643,10.123468062647248,129297.39374086908,3486,0,683.2727272727273,36,8,19,37.19134093677336,0.6131365740740742,45.74887387387387,1017.0045045045032,28.250125125125088,7
3525,4,0,0,44,0.0,0.0,1.0,44,1200,1000,200,0.8333333333333334,14,10,4,333.5384259182597,0.8152968639887245,0.24602890914966768,0.1864080197350512,129508.13140822161,-160.81234129733969,129347.31906692428,3487,1,684.2727272727273,37,7,16,37.04430589967324,0.6134572072072073,45.53179824561403,1017.8728070175426,27.51007586533899,0
3526,4,0,1,43,0.0,0.022727272727272728,0.9772727272727273,44,800,400,400,0.5,12,4,8,333.3979822937304,0.81553911205074,0.24171773735633262,0.1867270002158976,129591.85157933217,-158.8676323484106,129432.98394698376,3488,2,685.2727272727273,37,7,16,36.96290114150332,0.6143018018018017,45.449561403508774,1018.2017543859654,27.51896633475582,0
3527,4,0,0,43,0.0,0.0,1.0,43,1050,800,250,0.7619047619047619,13,8,5,337.45287065654185,0.8125692137320044,0.2351561233965167,0.1889109228238885,129573.7476285409,145.00661979549852,129718.75424833641,3489,3,622.5116279069767,36,7,16,36.87806474210081,0.6160300925925926,45.467342342342356,1018.1306306306324,28.281406406406454,0
3528,4,2,1,44,0.044444444444444446,0.022222222222222223,0.9777777777777777,45,1250,800,450,0.64,17,8,9,321.85629647687415,0.8235690235690236,0.22900188323917114,0.18263386834846512,130103.13042534729,-625.0976562499898,129478.0327690973,3490,0,595.8,39,6,19,36.738904771628896,0.6159188034188035,44.94791666666667,1020.2083333333339,26.15918803418805,0
3529,4,2,1,45,0.043478260869565216,0.021739130434782608,0.9782608695652174,46,800,400,400,0.5,12,4,8,314.8765997142525,0.8276570048309179,0.22979972681957683,0.17989802934723373,130368.9453125,-989.8763020833334,129379.06901041667,3491,0,583.804347826087,39,7,20,36.64830681354548,0.6185897435897436,44.6875,1021.25,26.185897435897434,0
3530,4,0,0,45,0.0,0.0,1.0,45,600,500,100,0.8333333333333334,7,5,2,321.6923217418311,0.82243265993266,0.2328857265762152,0.18354707575442852,130317.12420784925,-615.5963501716838,129701.52785767756,3492,1,597.7777777777778,38,7,20,36.5266732935719,0.6197916666666667,44.73824786324786,1021.0470085470076,26.869658119658094,0
3531,4,1,1,45,0.021739130434782608,0.021739130434782608,0.9782608695652174,46,1200,800,400,0.6666666666666666,16,8,8,317.1420504090854,0.8283011272141707,0.2389886385792026,0.18218956666357977,130581.79253472212,-917.4045138888945,129664.38802083323,3493,0,585.7608695652174,39,7,14,36.37552656610954,0.6207264957264957,44.479166666666664,1022.0833333333325,26.207264957264936,0
3532,4,0,1,44,0.0,0.022222222222222223,0.9777777777777777,45,600,400,200,0.6666666666666666,8,4,4,338.60949396348315,0.8228956228956229,0.21328147607968417,0.19903934675783672,131465.0463533676,-96.93743608007235,131368.10891728752,3494,3,599.7777777777778,38,7,17,34.93506268014029,0.6313048245614036,43.61645299145299,1025.5341880341875,26.987741790373356,7
3533,4,0,0,44,0.0,0.0,1.0,44,1300,1000,300,0.7692307692307693,16,10,6,345.78813710484155,0.8175211416490487,0.22030944672908115,0.20297959008583608,131412.4312889541,288.17196156507447,131700.60325051917,3495,5,614.3409090909091,37,7,17,34.80409849213986,0.6326013513513514,43.667763157894726,1025.3289473684197,27.71159317211945,0
3534,4,0,0,44,0.0,0.0,1.0,44,800,700,100,0.875,9,7,2,344.70104151955206,0.8169705778717407,0.22039038805505906,0.20249020981726412,131440.5393967371,261.53816558937694,131702.07756232648,3496,6,615.3409090909091,37,7,17,34.80360707157114,0.632882882882883,43.640350877192965,1025.4385964912253,27.71455666192501,0
3535,4,0,0,44,0.0,0.0,1.0,44,1300,1100,200,0.8461538461538461,15,11,4,355.0133480744954,0.8163759689922481,0.2994601719624772,0.19673908369443507,129174.91455078126,371.7637803819444,129546.6783311632,3497,7,616.3409090909091,39,5,20,36.83704358370051,0.6065705128205128,45.859375,1016.5625000000001,26.06570512820513,4
3536,4,0,0,44,0.0,0.0,1.0,44,800,400,400,0.5,12,4,8,371.9567213197505,0.8164640591966174,0.31303992410786385,0.2033122661194365,128629.57552146743,808.6487148307547,129438.22423629818,3498,8,617.3409090909091,36,8,14,36.9634399052694,0.6064814814814815,46.3963963963964,1014.4144144144145,28.178178178178182,6
3537,4,2,1,45,0.043478260869565216,0.021739130434782608,0.9782608695652174,46,1200,1000,200,0.8333333333333334,14,10,4,362.44077247788914,0.8277777777777778,0.31309009148988687,0.2007137083442744,129147.08547921675,161.63388487104805,129308.7193640878,3499,0,591.4565217391304,38,8,16,36.67665195151005,0.6080043859649124,45.88675213675213,1016.4529914529903,26.74876293297343,0
3538,4,0,0,45,0.0,0.0,1.0,45,1450,1200,250,0.8275862068965517,17,12,5,370.9876862146484,0.8196127946127947,0.32550556814231446,0.20529461871782526,129117.79495854478,580.2224001615715,129698.01735870635,3500,1,605.6,37,8,17,36.48935070306038,0.6095157657657657,45.91557017543859,1016.3377192982443,27.46858700806066,0
3539,4,0,0,45,0.0,0.0,1.0,45,1000,600,400,0.6,14,6,8,375.9070142434829,0.8196548821548822,0.3295081967213114,0.20845752608047693,129201.38888888893,713.5687182594692,129914.9576071484,3501,2,606.6,36,9,17,36.279030054644814,0.6122685185185186,45.833333333333336,1016.6666666666671,28.24074074074075,0
3540,4,1,1,45,0.021739130434782608,0.021739130434782608,0.9782608695652174,46,1250,1000,250,0.8,15,10,5,370.55174779042625,0.8259661835748793,0.32678021041192395,0.20694713134721632,129480.23069598334,395.82515774083896,129876.05585372417,3502,0,594.3913043478261,37,9,14,36.13086260145084,0.6131756756756757,45.55921052631579,1017.7631578947364,27.507112375533417,0
3541,4,0,1,44,0.0,0.022222222222222223,0.9777777777777777,45,1550,1200,350,0.7741935483870968,19,12,7,380.6619451073805,0.8205808080808081,0.33681001204789673,0.21263428058593972,129487.77113261909,858.2133653924172,130345.9844980115,3503,4,608.6,36,9,14,35.865927196282364,0.6151620370370371,45.5518018018018,1017.7927927927926,28.272022022022018,0
3542,4,1,1,44,0.022222222222222223,0.022222222222222223,0.9777777777777777,45,1200,800,400,0.6666666666666666,16,8,8,377.0703156131371,0.8236952861952862,0.3286786288886434,0.21201710039478247,129745.78622118737,784.6569119795435,130530.44313316692,3504,0,600.3111111111111,36,9,15,35.69438303673408,0.6177662037037037,45.29842342342342,1018.806306306306,28.30017517517517,0
3543,4,0,0,44,0.0,0.0,1.0,44,1200,800,400,0.6666666666666666,16,8,8,375.93610993609576,0.819965644820296,0.3229379858247552,0.20682220276350088,128886.7346020008,890.6355257284476,129777.37012772924,3505,6,614.9545454545455,36,8,16,36.599617389375624,0.6090856481481481,46.143018018018026,1015.4279279279292,28.206331331331366,2
3544,4,0,0,44,0.0,0.0,1.0,44,1500,1000,500,0.6666666666666666,20,10,10,378.08933546626315,0.8200757575757576,0.32041382964111254,0.20878282374436175,129034.22807979358,957.2931094182613,129991.52118921184,3506,7,615.9545454545455,37,7,16,36.39425498237283,0.6086711711711712,45.99780701754385,1016.0087719298228,27.45969653864386,0
3545,4,3,1,46,0.06382978723404255,0.02127659574468085,0.9787234042553191,47,800,500,300,0.625,11,5,6,360.61240961688856,0.836840888066605,0.3218030718357048,0.20268904402604423,129731.4453125,-43.337974184364356,129688.10733831563,3507,0,577.5744680851063,39,8,16,36.12815269256986,0.6121794871794872,45.3125,1018.75,26.121794871794872,0
3546,4,0,1,45,0.0,0.021739130434782608,0.9782608695652174,46,1050,900,150,0.8571428571428571,12,9,3,367.16792327363936,0.8284822866344606,0.32534818179330727,0.20615895055894431,129690.6332182773,323.6480933596172,130014.28131163692,3508,1,591.1304347826087,38,8,16,36.002727082022226,0.6134868421052633,45.352564102564095,1018.5897435897424,26.80499325236164,0
3547,4,1,1,45,0.021739130434782608,0.021739130434782608,0.9782608695652174,46,1050,800,250,0.7619047619047619,13,8,5,370.30087340914554,0.8306360708534621,0.3328463926124785,0.20864146671292585,129826.69850107734,414.9879693549348,130241.68647043227,3509,0,591.6304347826087,38,8,17,35.78445504420448,0.614857456140351,45.21901709401708,1019.1239316239303,26.819050832208692,0
3548,4,1,1,45,0.021739130434782608,0.021739130434782608,0.9782608695652174,46,1650,1300,350,0.7878787878787878,20,13,7,367.7675477160848,0.8307367149758454,0.32671087206998806,0.20837250908281651,130044.55133912252,365.2331479655049,130409.78448708804,3510,0,592.3913043478261,38,8,18,35.627465870605086,0.6170504385964912,45.005341880341874,1019.9786324786314,26.841542959963984,0
3549,4,1,1,45,0.021739130434782608,0.021739130434782608,0.9782608695652174,46,750,500,250,0.6666666666666666,10,5,5,370.59400783969744,0.8330515297906602,0.3322695196904162,0.21041455260815148,130126.2932372707,444.8049072247664,130571.09814449547,3511,0,593.3695652173913,38,8,19,35.47229493891796,0.6178728070175439,44.92521367521367,1020.2991452991446,26.849977507872225,0
3550,4,0,0,45,0.0,0.0,1.0,45,1250,800,450,0.64,17,8,9,369.1558265597114,0.8303030303030303,0.30950887402536953,0.21049279548049177,130292.12648158838,619.8335467485251,130911.9600283369,3512,1,593.5333333333333,35,10,20,35.34049899860182,0.6252976190476192,44.76273148148147,1020.9490740740719,29.16997354497348,0
3551,4,1,1,45,0.021739130434782608,0.021739130434782608,0.9782608695652174,46,900,500,400,0.5555555555555556,13,5,8,360.46836070741756,0.8375805152979067,0.30053461590051156,0.20706397732788098,130578.91506371224,213.91349119387957,130792.82855490611,3513,0,581.6086956521739,36,10,14,35.271365873365646,0.6261574074074074,44.481981981981974,1022.072072072071,28.390890890890862,0
3552,4,0,0,45,0.0,0.0,1.0,45,750,500,250,0.6666666666666666,10,5,5,370.297362148802,0.8308922558922559,0.30709222536984626,0.2117870525575612,130410.31867551833,658.1194005057846,131068.43807602412,3514,3,595.5333333333333,35,10,21,35.1913361661945,0.6264880952380953,44.64699074074072,1021.412037037034,29.18320105820097,0
3553,4,0,0,45,0.0,0.0,1.0,45,1000,800,200,0.8,12,8,4,374.7281516349584,0.8308080808080809,0.27122230794665536,0.2147762804664544,130492.60567577697,830.413481901868,131323.01915767885,3515,4,596.5333333333333,36,9,17,34.99462691502259,0.6252893518518519,44.566441441441434,1021.734234234233,28.381506506506472,4
3554,4,0,0,45,0.0,0.0,1.0,45,750,600,150,0.8,9,6,3,378.08488954057447,0.8303030303030303,0.27623524802899024,0.21718344667533238,130578.91506371221,873.9829356383254,131452.89799935053,3516,5,597.5333333333333,36,9,17,34.82123182018511,0.6261574074074074,44.481981981981974,1022.0720720720708,28.390890890890855,0
3555,4,1,0,46,0.021739130434782608,0.0,1.0,46,1050,600,450,0.5714285714285714,15,6,9,374.0656013298161,0.834621578099839,0.291836012607253,0.21765723681116145,131075.3684426935,606.1573032086314,131681.52574590212,3517,0,585.5217391304348,37,9,19,34.42050808437734,0.6292229729729731,43.996710526315766,1024.0131578947335,27.676031294452255,0
3556,4,1,1,46,0.02127659574468085,0.02127659574468085,0.9787234042553191,47,900,700,200,0.7777777777777778,11,7,4,366.74591897584156,0.8379201356768424,0.2904326688091774,0.21450929553414544,131274.74500868042,228.89539930554744,131503.64040798595,3518,0,574.0425531914893,39,8,20,34.406129294572075,0.6276709401709402,43.80208333333333,1024.7916666666656,26.276709401709375,0
3557,4,1,1,46,0.02127659574468085,0.02127659574468085,0.9787234042553191,47,950,700,250,0.7368421052631579,12,7,5,359.0048407884883,0.8440872648781992,0.2764638179593215,0.21120322520349125,131496.76462950095,41.61671139191816,131538.38134089287,3519,0,568.6170212765958,37,10,21,34.38012258570307,0.633445945945946,43.58552631578945,1025.6578947368387,27.72048364153618,0
3558,4,0,1,45,0.0,0.021739130434782608,0.9782608695652174,46,1050,1000,50,0.9523809523809523,11,10,1,366.5674197170139,0.8385869565217392,0.28175861541988256,0.21502769259688714,131385.845304764,432.354060141196,131818.1993649052,3520,1,581.7608695652174,36,10,21,34.298339557703564,0.6342592592592595,43.69369369369368,1025.2252252252233,28.478478478478426,0
3559,4,1,2,44,0.021739130434782608,0.043478260869565216,0.9565217391304348,46,950,800,150,0.8421052631578947,11,8,3,365.51575390910716,0.8420893719806763,0.29139502696511244,0.21538476831254622,131559.0823086599,417.383430728014,131976.46573938793,3521,0,581.8478260869565,36,10,18,34.150201244054166,0.6359953703703705,43.52477477477477,1025.9009009009,28.497247247247223,0
3560,4,1,1,44,0.022222222222222223,0.022222222222222223,0.9777777777777777,45,1000,700,300,0.7,13,7,6,366.5058240702802,0.8373737373737374,0.3084428301819613,0.2167315868049203,131693.64762474972,653.2977695059833,132346.94539425572,3522,0,593.9777777777778,37,8,18,33.988867820389565,0.6354166666666667,43.393640350877185,1026.4254385964896,27.741228070175396,0
3561,4,0,1,43,0.0,0.022727272727272728,0.9772727272727273,44,900,600,300,0.6666666666666666,12,6,6,377.9231442723526,0.8352933403805497,0.3159737123124984,0.22252759671472902,131530.20154867697,1141.6614672104479,132671.86301588741,3523,4,608.4772727272727,36,8,21,33.86119954623632,0.6357060185185186,43.552927927927925,1025.7882882882877,28.494119119119105,0
3562,4,1,2,42,0.022727272727272728,0.045454545454545456,0.9545454545454546,44,950,700,250,0.7368421052631579,12,7,5,371.509234654209,0.8367248062015504,0.3211040347947658,0.22017800463936738,131778.07113727272,991.3540704831992,132769.42520775594,3524,0,606.9318181818181,37,7,18,33.77518510608001,0.6362612612612613,43.31140350877192,1026.7543859649102,27.750118539592165,0
3563,4,2,2,42,0.045454545454545456,0.045454545454545456,0.9545454545454546,44,1500,1100,400,0.7333333333333333,19,11,8,371.7757978900368,0.8356897463002114,0.32398065598897996,0.22148194545629551,131975.16453379864,1013.0344192443545,132988.198953043,3525,0,607.7727272727273,37,7,19,33.56932291110874,0.638231981981982,43.11951754385964,1027.5219298245595,27.770862968231338,0
3564,4,0,0,42,0.0,0.0,1.0,42,1150,800,350,0.6956521739130435,15,8,7,390.20118968686063,0.8270180023228804,0.3521517927581266,0.2315889736516063,131832.8045294282,1888.2634334276463,133721.06796285583,3526,1,637.547619047619,35,7,19,33.24000244186484,0.6407738095238094,43.258101851851855,1026.9675925925928,29.341931216931226,0
3565,4,0,0,42,0.0,0.0,1.0,42,1300,800,500,0.6153846153846154,18,8,10,388.23902762027336,0.8266066589237321,0.3335741440970623,0.21868445592138294,129815.23762119106,1679.868324869183,131495.10594606024,3527,2,638.547619047619,37,5,18,35.339107668029555,0.6165540540540541,45.23026315789473,1019.0789473684205,27.542674253200552,6
3566,4,0,0,42,0.0,0.0,1.0,42,1450,1100,350,0.7586206896551724,18,11,7,386.1422470461457,0.8263888888888888,0.33246781181820984,0.2181257966606962,129927.00277970133,1634.0609610649278,131561.06374076626,3528,3,639.547619047619,37,5,18,35.27864415286441,0.6176801801801801,45.12061403508771,1019.5175438596483,27.554528212422927,0
3567,4,0,0,42,0.0,0.0,1.0,42,1000,500,500,0.5,15,5,10,385.8758237946584,0.8281552458381727,0.3316231438812085,0.21828741856997086,129982.90339335172,1631.4519852262126,131614.35537857792,3529,4,640.547619047619,37,5,18,35.22849462365591,0.6182432432432433,45.065789473684205,1019.7368421052626,27.560455192034123,0
3568,4,0,0,42,0.0,0.0,1.0,42,1650,1200,450,0.7272727272727273,21,12,9,388.90529799219155,0.8280584591560202,0.3307128526389065,0.2206326153975211,130094.74068944273,1718.9067790089077,131813.64746845164,3530,5,641.547619047619,37,5,18,35.03734952708513,0.6193693693693694,44.956140350877185,1020.1754385964898,27.57230915125648,0
3569,4,1,0,43,0.023255813953488372,0.0,1.0,43,1150,800,350,0.6956521739130435,15,8,7,385.4520844483129,0.8308416389811738,0.3346580526625862,0.22056950974941514,130430.5411280392,1455.052997076001,131885.5941251152,3531,0,627.6046511627907,37,6,19,34.78379490482324,0.6227477477477479,44.62719298245613,1021.4912280701739,27.60787102892362,0
3570,4,0,1,42,0.0,0.023255813953488372,0.9767441860465116,43,1450,1100,350,0.7586206896551724,18,11,7,380.7556817833249,0.8315337763012182,0.3177521126338878,0.2186705921073549,130570.58572108713,1343.0984774161157,131913.68419850324,3532,1,628.6046511627907,37,6,16,34.76144816364481,0.6241554054054055,44.49013157894736,1022.0394736842096,27.622688477951613,0
3571,4,0,0,42,0.0,0.0,1.0,42,1000,600,400,0.6,14,6,8,392.68893943486813,0.8280826558265583,0.3297407798124212,0.22507054627242964,130492.60567577725,1848.6005853826925,132341.20626115994,3533,8,644.547619047619,36,6,16,34.53584812079798,0.6252893518518519,44.56644144144145,1021.7342342342351,28.381506506506533,0
3572,4,1,0,43,0.023255813953488372,0.0,1.0,43,750,400,350,0.5333333333333333,11,4,7,395.49931161385905,0.8298265042451088,0.3500703777979852,0.2294584259736093,130963.11034404815,1759.163997576178,132722.27434162432,3534,0,630.5348837209302,37,6,18,33.98578378860918,0.6280968468468469,44.10635964912281,1023.5745614035086,27.66417733522996,0
3573,4,3,3,43,0.06521739130434782,0.06521739130434782,0.9347826086956522,46,650,200,450,0.3076923076923077,11,2,9,376.8358612899216,0.8434178743961352,0.33512304655668834,0.22230538156194138,131602.03904594926,719.489483874216,132321.52852982347,3535,0,590.3478260869565,38,8,15,33.816421976954054,0.6326754385964912,43.48290598290598,1026.0683760683758,27.001799370220414,0
3574,4,0,1,42,0.0,0.023255813953488372,0.9767441860465116,43,1500,900,600,0.6,21,9,12,397.8512308777673,0.8271040974529347,0.3479286818386609,0.23217514366589484,131187.67463306006,1838.6355657509894,133026.31019881106,3536,2,632.5348837209302,37,6,19,33.69757661707518,0.6303490990990992,43.88706140350877,1024.451754385964,27.687885253674704,0
3575,4,0,0,42,0.0,0.0,1.0,42,1500,1200,300,0.8,18,12,6,398.1005932218904,0.8192992644212156,0.3363752399784481,0.23334898262066128,131356.9835671821,2058.7337596999932,133415.7173268821,3537,3,614.0238095238095,36,6,20,33.51939836683877,0.6339699074074073,43.72184684684685,1025.112612612613,28.47535035035036,0
3576,4,2,2,42,0.045454545454545456,0.045454545454545456,0.9545454545454546,44,1250,900,350,0.72,16,9,7,383.9769576418995,0.8316816420014095,0.32865168539325884,0.22782632820085996,131821.37573964475,1323.274161735681,133144.64990138044,3538,0,587.0681818181819,38,6,17,33.411360799001244,0.6348684210526316,43.26923076923076,1026.9230769230753,27.024291497975668,0
3577,4,0,0,42,0.0,0.0,1.0,42,900,600,300,0.6666666666666666,12,6,6,399.81483204963683,0.8215737514518002,0.3454902206685371,0.2361317280925691,131645.7436110097,2126.784174377082,133772.52778538677,3539,1,614.8809523809524,36,6,17,33.1826785910238,0.6368634259259258,43.44031531531532,1026.2387387387391,28.50663163163164,0
3578,4,0,0,42,0.0,0.0,1.0,42,1100,700,400,0.6363636363636364,15,7,8,398.51697385590245,0.8200735578784359,0.34246658936962215,0.23618436349282737,131778.07113727304,2103.1596260387846,133881.23076331182,3540,2,615.8809523809524,37,5,17,33.08192723907162,0.6362612612612613,43.31140350877193,1026.7543859649127,27.750118539592233,0
3579,4,1,1,42,0.023255813953488372,0.023255813953488372,0.9767441860465116,43,1100,900,200,0.8181818181818182,13,9,4,392.18407596785966,0.8271502399409376,0.33632935260842234,0.23404533565823896,132040.89506172854,1756.867283950636,133797.7623456792,3541,0,602.5348837209302,38,5,17,32.97860360360361,0.6370614035087718,43.055555555555564,1027.777777777779,27.046783625731024,0
3580,4,0,0,42,0.0,0.0,1.0,42,1050,800,250,0.7619047619047619,13,8,5,400.10208302935234,0.8205332946186604,0.34586305713066356,0.2385341426304763,132003.3327562326,2162.9616805170745,134166.29443674965,3542,4,617.8809523809524,37,5,17,32.81316688006829,0.6385135135135136,43.09210526315789,1027.6315789473676,27.773826458036964,0
3581,4,0,0,42,0.0,0.0,1.0,42,1300,800,500,0.6153846153846154,18,8,10,400.5140380048349,0.8202187379016648,0.3499367753926783,0.23966944061080622,132144.21895438968,2185.122946483519,134329.3419008732,3543,5,618.8809523809524,37,5,17,32.66003252639436,0.6399211711711712,42.955043859649116,1028.1798245614025,27.78864390706493,0
3582,4,0,0,42,0.0,0.0,1.0,42,1200,800,400,0.6666666666666666,16,8,8,400.70335204215775,0.8198315911730546,0.34513404594410857,0.24067854346091672,132285.18029586007,2201.4230340104473,134486.60332987053,3544,6,619.8809523809524,37,5,18,32.51261280466141,0.6413288288288289,42.81798245614034,1028.728070175437,27.803461356092896,0
3583,4,0,0,42,0.0,0.0,1.0,42,1150,800,350,0.6956521739130435,15,8,7,401.9713219929026,0.8183072009291521,0.33915746991571316,0.24277218375718,132492.61289227701,2251.8385186026107,134744.4514108796,3545,7,620.8809523809524,33,9,18,32.270339840495176,0.651830808080808,42.61642156862745,1029.5343137254902,31.198009506833035,0
3584,4,0,0,42,0.0,0.0,1.0,42,1100,800,300,0.7272727272727273,14,8,6,363.7725459410532,0.8196380178087496,0.18253138856127693,0.20931686663318938,130644.58832137124,1104.982901417204,131749.57122278845,3546,8,621.8809523809524,38,4,14,35.12035392064653,0.6230811403508771,44.417735042735046,1022.3290598290604,26.90339631129106,8
3585,4,0,0,42,0.0,0.0,1.0,42,750,500,250,0.6666666666666666,10,5,5,363.9744106288264,0.8192750677506775,0.18493805045529177,0.209580933196021,130671.89554569364,1112.2452333990832,131784.14077909273,3547,9,622.8809523809524,38,4,15,35.08751306165101,0.6233552631578947,44.39102564102564,1022.4358974358976,26.906207827260463,0
3586,4,0,1,41,0.0,0.023809523809523808,0.9761904761904762,42,1300,800,500,0.6153846153846154,18,8,10,363.6980491128026,0.8204365079365079,0.19320182637500372,0.21001478421025188,130781.15297866914,1112.970039813004,131894.12301848215,3548,10,623.8809523809524,38,4,17,34.98385384026181,0.6244517543859648,44.28418803418804,1022.863247863249,26.91745389113813,0
3587,4,0,0,41,0.0,0.0,1.0,41,1250,900,350,0.72,16,9,7,369.17427098562695,0.8140752032520325,0.20285712101871844,0.2130262384656667,130753.83434007247,1454.1902942143524,132208.02463428682,3549,15,639.8536585365854,38,3,17,34.87151363209027,0.6241776315789472,44.310897435897445,1022.7564102564115,26.914642375168725,0
3588,4,0,0,41,0.0,0.0,1.0,41,1200,700,500,0.5833333333333334,17,7,10,374.095624252219,0.8148882113821139,0.20527839819486182,0.21647817483163193,130863.1260158707,1591.0645637008126,132454.1905795715,3550,16,640.8536585365854,38,3,18,34.63484563711672,0.6252741228070173,44.204059829059844,1023.183760683763,26.925888439046396,0
3589,4,2,0,43,0.046511627906976744,0.0,1.0,43,900,400,500,0.4444444444444444,14,4,10,360.3204169165058,0.8244278331487633,0.20809613696333895,0.2115101204385592,131412.43128895437,872.5904499499381,132285.0217389043,3551,0,612.0,37,6,20,34.43158931308593,0.6326013513513513,43.66776315789474,1025.3289473684217,27.711593172119507,0
3590,4,0,0,43,0.0,0.0,1.0,43,1200,900,300,0.75,15,9,6,362.1788123946444,0.8251661129568106,0.2130386685393959,0.21322736248910606,131524.88175448202,927.1050948368584,132451.98684931887,3552,1,613.0,37,6,20,34.270332264386234,0.6337274774774775,43.55811403508771,1025.7675438596482,27.723447131341842,0
3591,4,0,0,43,0.0,0.0,1.0,43,750,300,450,0.4,12,3,9,363.8701103803249,0.8250276854928017,0.2140842342287812,0.2148108426676718,131629.44614517124,979.2042196288949,132608.65036480012,3553,2,614.0,38,5,15,34.12133437445777,0.6329495614035088,43.45619658119658,1026.1752136752132,27.00461088618982,0
3592,4,0,1,42,0.0,0.023255813953488372,0.9767441860465116,43,1600,1300,300,0.8125,19,13,6,361.33018140668474,0.8252583979328165,0.20813796141863605,0.21361840324763184,131684.26890432087,916.3001543209746,132600.56905864185,3554,3,615.0,38,5,15,34.13114569237708,0.6334978070175439,43.40277777777777,1026.388888888888,27.01023391812863,0
3593,4,0,0,42,0.0,0.0,1.0,42,650,500,150,0.7692307692307693,8,5,3,373.92244563577617,0.8229529616724739,0.22835831863609668,0.21415558250048997,130463.84222059899,1358.60080237896,131822.44302297794,3555,4,630.5714285714286,36,6,18,35.04441321281599,0.625,44.5945945945946,1021.6216216216217,28.37837837837838,3
3594,4,1,1,42,0.023255813953488372,0.023255813953488372,0.9767441860465116,43,1100,700,400,0.6363636363636364,15,7,8,359.95236664986817,0.8256736803248431,0.19512304775796596,0.2052367719459228,130290.57167830481,779.6799255540136,131070.25160385882,3556,0,616.8837209302326,37,6,18,35.57698331722335,0.6213400900900901,44.76425438596491,1020.9429824561399,27.593053579895674,1
3595,4,2,1,43,0.045454545454545456,0.022727272727272728,0.9772727272727273,44,850,500,350,0.5882352941176471,12,5,7,356.2514768431,0.8328488372093024,0.20405138339920947,0.20484459918478268,130617.28395061739,506.52006172840566,131123.8040123458,3557,0,603.8181818181819,38,6,15,35.34024003623186,0.6228070175438596,44.44444444444445,1022.2222222222231,26.90058479532166,0
3596,4,0,1,42,0.0,0.023255813953488372,0.9767441860465116,43,1100,900,200,0.8181818181818182,13,9,4,361.29786881320337,0.8254429678848283,0.20067871045014463,0.20734582126472031,130542.57079101274,832.9505232379349,131375.52131425068,3558,1,618.8604651162791,37,6,16,35.28701716738198,0.6238738738738738,44.51754385964913,1021.9298245614044,27.619724988146064,0
3597,4,0,0,42,0.0,0.0,1.0,42,1100,900,200,0.8181818181818182,13,9,4,368.54105170773005,0.8220092915214866,0.21742393232364576,0.2113869471046742,130521.3723013556,1220.4967636555712,131741.86906501118,3559,2,633.6190476190476,36,6,17,35.12347549775916,0.6255787037037036,44.5382882882883,1021.8468468468484,28.38463463463468,0
3598,4,1,1,42,0.023255813953488372,0.023255813953488372,0.9767441860465116,43,1150,900,250,0.782608695652174,14,9,5,358.26657215532384,0.8284883720930232,0.22198301102115714,0.20755443314249789,130906.99932912063,779.920384156678,131686.9197132773,3560,0,619.8604651162791,37,6,18,34.99533465480909,0.6275337837837838,44.16118421052632,1023.3552631578958,27.658250355618804,0
3599,4,1,0,43,0.023255813953488372,0.0,1.0,43,1100,600,500,0.5454545454545454,16,6,10,357.8403094509607,0.8263658176448874,0.21947970127771255,0.20821623987305451,131075.36844269402,780.8100809864684,131856.1785236805,3561,0,620.6279069767442,37,6,19,34.83588089374309,0.6292229729729729,43.996710526315795,1024.0131578947376,27.676031294452365,0
3600,4,0,0,43,0.0,0.0,1.0,43,1050,600,450,0.5714285714285714,15,6,9,356.84499039129696,0.8256275378368402,0.2193644107879893,0.20809275282368894,131159.5935768698,760.7287819329058,131920.32235880272,3562,1,621.6279069767442,37,6,20,34.776189966459725,0.6300675675675675,43.91447368421053,1024.342105263158,27.684921763869134,0
3601,4,1,1,43,0.022727272727272728,0.022727272727272728,0.9772727272727273,44,1100,700,400,0.6363636363636364,15,7,8,350.95683435040826,0.8277616279069768,0.23317111965310278,0.2067415658547619,131547.23340821092,433.48012089998804,131980.71352911092,3563,0,608.4772727272727,38,6,21,34.53555682843852,0.6321271929824561,43.53632478632478,1025.8547008547002,26.996176338281586,0
3602,4,0,0,43,0.0,0.0,1.0,43,1400,900,500,0.6428571428571429,19,9,10,361.70301419406735,0.8271040974529347,0.2282060581370513,0.21404953343140654,131721.7857898581,928.8333910433678,132650.61918090147,3564,1,612.3255813953489,37,6,17,34.08370718507442,0.6356981981981983,43.366228070175424,1026.535087719296,27.74419155998097,0
3603,4,0,0,43,0.0,0.0,1.0,43,1150,800,350,0.6956521739130435,15,8,7,361.1889365531252,0.8283499446290143,0.22591362126245862,0.2143786805929381,131834.36850761742,923.4230724838058,132757.7915801012,3565,2,613.3255813953489,37,6,17,33.983290625667294,0.6368243243243243,43.2565789473684,1026.9736842105237,27.756045519203344,0
3604,4,0,0,43,0.0,0.0,1.0,43,900,600,300,0.6666666666666666,12,6,6,362.4378733566772,0.8279808047249907,0.22763840175541827,0.21559875780817184,131918.83710612866,962.4765552862283,132881.3136614149,3566,3,614.3255813953489,37,6,17,33.86600757818337,0.637668918918919,43.17434210526315,1027.3026315789461,27.764935988620167,0
3605,4,0,1,42,0.0,0.023255813953488372,0.9767441860465116,43,1050,800,250,0.7619047619047619,13,8,5,360.4431296382981,0.8269656699889257,0.22569820763818438,0.2156908249277805,132144.21895438983,926.0951687057583,133070.3141230956,3567,4,615.3255813953489,37,6,18,33.69003501475241,0.6399211711711712,42.95504385964912,1028.1798245614036,27.788643907064962,0
3606,4,1,0,43,0.023255813953488372,0.0,1.0,43,900,600,300,0.6666666666666666,12,6,6,359.7746761147346,0.8264119601328903,0.22822882391884902,0.21561192889968647,132200.59447378034,912.485211795929,133113.07968557626,3568,0,616.1627906976744,37,6,19,33.650420265131324,0.6404842342342343,42.90021929824561,1028.399122807017,27.794570886676134,0
3607,4,0,1,42,0.0,0.023255813953488372,0.9767441860465116,43,800,500,300,0.625,11,5,6,360.34704262996996,0.8268272425249169,0.2226034018630425,0.21643892150796287,132285.18029586028,933.7147006771288,133218.89499653742,3569,1,617.1627906976744,37,6,20,33.55050451218644,0.6413288288288288,42.81798245614035,1028.7280701754387,27.80346135609294,0
3608,4,1,1,42,0.023255813953488372,0.023255813953488372,0.9767441860465116,43,850,300,550,0.35294117647058826,14,3,11,361.7499057516101,0.8271040974529347,0.2216363807551074,0.217932260294263,132398.0034722224,979.0411472761037,133377.04461949848,3570,0,617.8604651162791,36,7,20,33.40080971659919,0.6443865740740741,42.70833333333334,1029.166666666668,28.587962962963005,0
3609,4,0,1,41,0.0,0.023809523809523808,0.9761904761904762,42,900,600,300,0.6666666666666666,12,6,6,370.14215097748723,0.8231949283778552,0.22549139020416864,0.2224883922243281,132313.38158135198,1394.9519323253296,133708.3335136773,3571,3,633.5714285714286,37,5,20,33.270165014742965,0.6416103603603605,42.790570175438596,1028.8377192982457,27.806424845898533,0
3610,4,0,0,41,0.0,0.0,1.0,41,950,500,450,0.5263157894736842,14,5,9,370.14968098243025,0.8212906504065041,0.22459228638942008,0.22374083594348018,132524.1568747595,1610.83603270993,134134.99290746942,3572,4,638.1951219512196,33,8,20,33.05760533206378,0.6521464646464648,42.585784313725476,1029.6568627450963,31.201723113487766,0
3611,4,0,0,41,0.0,0.0,1.0,41,1150,800,350,0.6956521739130435,15,8,7,370.3558129772526,0.8207317073170731,0.22530502315970335,0.22424137264126986,132587.25610342153,1620.8922049211537,134208.14830834267,3573,5,639.1951219512196,33,8,20,32.98875535459304,0.6527777777777779,42.52450980392155,1029.9019607843118,31.209150326797328,0
3612,4,0,0,41,0.0,0.0,1.0,41,1150,900,250,0.782608695652174,14,9,5,365.4799938992669,0.8204268292682927,0.21803271758887477,0.22198100682092284,132704.48022959154,1500.1665249432804,134204.64675453483,3574,6,640.1951219512196,34,7,16,32.996341228576924,0.6516544117647061,42.41071428571427,1030.3571428571406,30.30462184873943,0
3613,4,0,0,41,0.0,0.0,1.0,41,950,600,350,0.631578947368421,13,6,7,366.24059172548914,0.8198678861788617,0.21448429520673518,0.22317222264257638,132827.17013888885,1529.340277777773,134356.51041666663,3575,7,641.1951219512196,34,7,17,32.853341417407705,0.6528799019607843,42.291666666666664,1030.833333333333,30.318627450980383,0
3614,4,0,0,41,0.0,0.0,1.0,41,1050,800,250,0.7619047619047619,13,8,5,364.85633709675324,0.8189024390243902,0.21695243779242213,0.22278993195304805,132904.73257726748,1498.2267821930543,134402.95935946054,3576,8,642.1951219512196,35,6,17,32.811038462977514,0.6514880952380953,42.216435185185176,1031.1342592592578,29.460978835978793,0
3615,4,0,0,41,0.0,0.0,1.0,41,950,600,350,0.631578947368421,13,6,7,364.3285293119023,0.8176321138211382,0.2167456141071007,0.2231793939351879,133024.1036120756,1492.895206404318,134516.99881847991,3577,9,643.1951219512196,35,6,17,32.7046869740828,0.6526785714285714,42.10069444444444,1031.597222222222,29.47420634920634,0
3616,4,0,0,41,0.0,0.0,1.0,41,1350,800,550,0.5925925925925926,19,8,11,363.27635815404403,0.8173780487804878,0.2149208972457688,0.22271289247490694,133053.9547432269,1467.071223422483,134521.02596664938,3578,10,644.1951219512196,35,6,17,32.70183606312169,0.6529761904761905,42.07175925925925,1031.712962962962,29.477513227513196,0
3617,4,0,1,40,0.0,0.024390243902439025,0.975609756097561,41,1000,600,400,0.6,14,6,8,361.34658019952417,0.8161077235772358,0.2122177424720233,0.22211545322123696,133152.40652392278,1422.833348551275,134575.23987247405,3579,11,645.1951219512196,36,5,18,32.652755046372064,0.6519097222222221,41.97635135135136,1032.0945945945962,28.66929429429434,0
3618,4,0,0,40,0.0,0.0,1.0,40,850,700,150,0.8235294117647058,10,7,3,368.9617049531183,0.8125267094017093,0.21768402154398547,0.22583699962515033,132994.25582990394,1813.9574759945053,134808.21330589845,3580,17,662.05,35,5,18,32.61520047875524,0.6523809523809523,42.129629629629626,1031.481481481481,29.470899470899457,0
3619,4,0,0,40,0.0,0.0,1.0,40,1450,1100,350,0.7586206896551724,18,11,7,375.0550048413305,0.8094818376068376,0.23189307330195041,0.2314136067216011,133292.8843557099,1998.4326774691376,135291.31703317902,3581,18,663.05,35,5,20,32.15786819098857,0.6553571428571429,41.84027777777778,1032.638888888889,29.503968253968253,0
3620,4,0,0,40,0.0,0.0,1.0,40,900,600,300,0.6666666666666666,12,6,6,356.72510371183,0.8093482905982906,0.17257412398921845,0.21695903848703096,132755.59413580244,1477.3582175925842,134232.95235339503,3582,19,664.05,35,5,18,33.170485175202145,0.65,42.36111111111111,1030.5555555555552,29.444444444444436,4
3621,4,0,1,39,0.0,0.025,0.975,40,1350,1100,250,0.8148148148148148,16,11,5,355.7374097419331,0.808974358974359,0.16530085316569387,0.2170485510945985,132874.89819101506,1453.7144204389497,134328.612611454,3583,20,665.05,35,5,18,33.07607394102678,0.6511904761904762,42.24537037037037,1031.0185185185182,29.45767195767195,0
3622,4,0,0,39,0.0,0.0,1.0,39,450,300,150,0.6666666666666666,6,3,3,383.36662669894764,0.807242465137202,0.16450084814228538,0.2229436346340531,131053.7149234692,2260.166113770589,133313.8810372398,3584,21,673.3076923076923,34,5,16,34.204356082626035,0.6351102941176472,44.01785714285713,1023.92857142857,30.115546218487353,6
3623,4,2,2,39,0.04878048780487805,0.04878048780487805,0.9512195121951219,41,1050,800,250,0.7619047619047619,13,8,5,365.9026826667316,0.8150914634146341,0.1578778238375269,0.2152869272434489,131501.3239590941,1423.3374421718868,132924.66140126597,3585,0,641.4146341463414,36,5,17,34.198644049187514,0.6354166666666667,43.581081081081074,1025.6756756756747,28.490990990990966,0
3624,4,1,2,38,0.025,0.05,0.95,40,1150,700,450,0.6086956521739131,16,7,9,369.76171392822846,0.8181891025641026,0.15596312168715443,0.2184328525917122,131654.57182623874,1736.1640249914105,133390.73585123016,3586,0,635.675,35,5,16,33.94480000751851,0.6389880952380953,43.431712962962955,1026.2731481481471,29.322089947089918,0
3625,4,0,0,38,0.0,0.0,1.0,38,850,700,150,0.8235294117647058,10,7,3,385.7282934682853,0.8048245614035088,0.16452272538133217,0.22557716713132056,131268.8145683297,2526.8191658093065,133795.633734139,3587,24,670.1052631578947,35,3,17,33.92581507416611,0.6351190476190478,43.80787037037036,1024.7685185185169,29.279100529100482,0
3626,4,0,0,38,0.0,0.0,1.0,38,850,600,250,0.7058823529411765,11,6,5,384.92376493900116,0.8040540540540541,0.17259987923920717,0.22619677422819945,131453.7677816224,2519.962633821982,133973.73041544436,3588,25,671.1052631578947,33,5,18,33.75906230082856,0.6414141414141414,43.627450980392155,1025.490196078431,31.07546048722518,0
3627,4,0,0,38,0.0,0.0,1.0,38,1050,700,350,0.6666666666666666,14,7,7,384.66560548448444,0.8047652916073968,0.17874116729951983,0.2267901724729649,131579.47063629364,2522.8193483275577,134102.2899846212,3589,26,672.1052631578947,33,5,16,33.638417741678616,0.6426767676767677,43.50490196078431,1025.980392156862,31.090314913844306,0
3628,4,0,0,38,0.0,0.0,1.0,38,850,600,250,0.7058823529411765,11,6,5,381.0711695255067,0.8030464675201517,0.17586488609583628,0.22522731438081298,131673.7872002355,2435.416816849291,134109.2040170848,3590,27,673.1052631578947,33,5,16,33.63519900497512,0.6436237373737373,43.41299019607843,1026.3480392156864,31.101455733808677,0
3629,4,0,0,38,0.0,0.0,1.0,38,1250,900,350,0.72,16,9,7,379.70653922098984,0.8015350877192983,0.18191689237000697,0.22562727413214206,131877.8061224491,2414.973072562376,134292.77919501148,3591,28,674.1052631578947,34,4,17,33.46396422500386,0.6433823529411764,43.21428571428572,1027.1428571428582,30.210084033613477,0
3630,4,1,0,39,0.02564102564102564,0.0,1.0,39,1100,800,300,0.7272727272727273,14,8,6,371.1678059165072,0.8072986954565903,0.17961997471117064,0.22185144361712084,132100.37964034636,2006.2816143689956,134106.66125471535,3592,0,657.7948717948718,35,4,18,33.45858665465735,0.6434523809523809,42.99768518518518,1028.0092592592591,29.371693121693117,0
3631,4,0,0,39,0.0,0.0,1.0,39,750,600,150,0.8,9,6,3,370.1438597169042,0.8061740890688259,0.17815678974936167,0.2217618471736138,132189.63162562152,1985.836092892654,134175.46771851418,3593,1,658.7948717948718,35,4,18,33.39488369911836,0.6443452380952381,42.910879629629626,1028.356481481481,29.381613756613746,0
3632,4,0,0,39,0.0,0.0,1.0,39,1500,1400,100,0.9333333333333333,16,14,2,380.46655676183724,0.8069050832208727,0.13134275758970948,0.21007155906397187,129029.71172185717,2018.2980277575084,131048.00974961468,3594,2,659.7948717948718,36,3,18,36.33848740116752,0.6105324074074073,46.00225225225226,1015.9909909909925,28.221971971972014,7
3633,4,0,0,39,0.0,0.0,1.0,39,850,400,450,0.47058823529411764,13,4,9,378.22730028161226,0.8047121007647323,0.12966830030541976,0.20928886480941472,129115.53603857249,1967.0041240565092,131082.540162629,3595,3,660.7948717948718,36,3,18,36.30771006463529,0.6114004629629629,45.9177927927928,1016.32882882883,28.231356356356386,0
3634,4,0,0,39,0.0,0.0,1.0,39,1350,900,450,0.6666666666666666,18,9,9,374.18706549940885,0.8047683310841206,0.12751055000087574,0.2078133727862078,129260.23046339174,1873.529798175942,131133.7602615677,3596,4,661.7948717948718,35,4,18,36.262709613779506,0.6148809523809522,45.77546296296297,1016.898148148149,29.05423280423283,0
3635,4,0,0,39,0.0,0.0,1.0,39,1000,700,300,0.7,13,7,6,372.4303157634783,0.8042060278902384,0.12597598123315046,0.20714668448920576,129319.0854338136,1832.4695644719004,131151.5549982855,3597,5,662.7948717948718,35,4,18,36.24734486420879,0.6154761904761903,45.7175925925926,1017.1296296296309,29.0608465608466,0
3636,4,0,0,39,0.0,0.0,1.0,39,1100,600,500,0.5454545454545454,16,6,10,372.544803668245,0.8039248762932973,0.1269944073448448,0.20736518552502906,129348.51794249415,1837.6236443330008,131186.14158682714,3598,6,663.7948717948718,35,4,18,36.214420487730855,0.6157738095238094,45.68865740740741,1017.2453703703716,29.064153439153472,0
3637,4,3,4,38,0.07142857142857142,0.09523809523809523,0.9047619047619048,42,850,500,350,0.5882352941176471,12,5,7,346.49045072225573,0.8203397212543554,0.10365525086815985,0.1959066861192663,129962.83512309178,606.1762637884722,130569.01138688024,3599,0,617.3095238095239,38,4,16,36.25292504889635,0.6162280701754383,45.0854700854701,1019.6581196581216,26.833108412055832,0
3638,4,1,1,38,0.02564102564102564,0.02564102564102564,0.9743589743589743,39,850,500,350,0.5882352941176471,12,5,7,369.1431631008184,0.805161943319838,0.12163969681869391,0.20701661517680725,129643.02722318693,1771.367428626561,131414.3946518135,3600,0,665.5897435897435,35,4,17,36.00089498806681,0.6187499999999999,45.399305555555564,1018.4027777777794,29.097222222222268,0
3639,4,0,0,38,0.0,0.0,1.0,38,1050,700,350,0.6666666666666666,14,7,7,371.1685118169078,0.7970009483167378,0.11956240847618216,0.2080586795597533,129625.34722222244,2022.569444444469,131647.91666666692,3601,38,684.1052631578947,34,4,17,35.96733496999455,0.6207107843137254,45.41666666666668,1018.3333333333351,29.950980392156914,0
3640,4,0,0,38,0.0,0.0,1.0,38,900,700,200,0.7777777777777778,11,7,4,369.38036697315874,0.7969416785206259,0.1263994488324598,0.2073765367337498,129685.96938775519,1980.690192743773,131666.65958049896,3602,39,685.1052631578947,34,4,17,35.951135655290635,0.6213235294117647,45.35714285714286,1018.5714285714292,29.95798319327733,0
3641,4,0,0,38,0.0,0.0,1.0,38,1400,1000,400,0.7142857142857143,18,10,8,366.02541706699265,0.7970009483167378,0.12650639449089995,0.20613010329562226,129807.25623582772,1902.551020408169,131709.8072562359,3603,40,686.1052631578947,34,4,17,35.91316199376947,0.6225490196078431,45.23809523809524,1019.0476190476195,29.97198879551822,0
3642,4,0,1,37,0.0,0.02631578947368421,0.9736842105263158,38,800,500,300,0.625,11,5,6,365.24664561561593,0.7964675201517307,0.12981451994663606,0.20585098967184262,129837.58680555565,1884.5486111111163,131722.13541666677,3604,41,687.1052631578947,34,4,17,35.902153175252096,0.6228553921568627,45.208333333333336,1019.1666666666674,29.975490196078454,0
3643,4,1,0,38,0.02631578947368421,0.0,1.0,38,850,700,150,0.8235294117647058,10,7,3,364.0532422841782,0.8035502607871029,0.10716409304672148,0.19876626555366084,128584.36113522388,1770.8176601080374,130355.17879533191,3605,0,672.2631578947369,35,3,14,37.21007360492983,0.6080357142857142,46.44097222222223,1014.236111111112,28.97817460317463,8
3644,4,1,1,38,0.02564102564102564,0.02564102564102564,0.9743589743589743,39,1050,900,150,0.8571428571428571,12,9,3,356.7412847977846,0.812471884840306,0.11164666171874815,0.1962621211117527,128886.73460200078,1395.843859061781,130282.57846106257,3606,0,656.0,36,3,15,37.086891427303975,0.6090856481481481,46.143018018018026,1015.4279279279291,28.206331331331363,0
3645,4,0,0,38,0.0,0.0,1.0,38,700,500,200,0.7142857142857143,9,5,4,353.6443271610759,0.8031353722143196,0.1370648224123785,0.1894824616889294,127831.16731596446,1441.353431133818,129272.52074709827,3607,2,674.2631578947369,36,2,17,38.24401447661471,0.5983796296296298,47.184684684684676,1011.26126126126,28.090590590590555,5
3646,4,0,0,38,0.0,0.0,1.0,38,850,500,350,0.5882352941176471,12,5,7,354.9337042443713,0.8026612138454243,0.1389897830060458,0.19071318175427227,127945.07345183018,1482.403772015251,129427.47722384543,3608,3,675.2631578947369,36,2,17,38.09480743544077,0.5995370370370372,47.07207207207207,1011.7117117117115,28.103103103103095,0
3647,4,1,0,39,0.02564102564102564,0.0,1.0,39,1050,700,350,0.6666666666666666,14,7,7,346.0920683935783,0.8089293747188484,0.14367634242065952,0.18740905790268889,128255.57503270218,1077.647449215123,129333.2224819173,3609,0,658.9230769230769,37,2,18,38.00110052680956,0.6007882882882885,46.76535087719297,1012.9385964912266,27.376718824087206,0
3648,4,0,0,39,0.0,0.0,1.0,39,1200,1000,200,0.8333333333333334,14,10,4,343.4452014999477,0.8094354475933424,0.15500005547604045,0.18675337898032413,128422.23087873169,1021.1997922437449,129443.43067097543,3610,1,659.9230769230769,37,2,17,37.89800591374588,0.6024774774774776,46.600877192982445,1013.5964912280683,27.394499762920766,0
3649,4,1,0,40,0.025,0.0,1.0,40,1600,1000,600,0.625,22,10,12,335.9152784017691,0.8148504273504273,0.1590086297621558,0.18450098123546832,128821.5047209435,654.6223244940838,129476.12704543758,3611,0,644.4,38,2,18,37.68197923244227,0.6047149122807018,46.20726495726494,1015.1709401709376,26.71502474134046,0
3650,4,2,1,41,0.047619047619047616,0.023809523809523808,0.9761904761904762,42,1150,900,250,0.782608695652174,14,9,5,318.4511124015925,0.825687185443283,0.15100144184784914,0.17694282519726476,129278.89034511537,-166.19871191089737,129112.69163320448,3612,0,614.6666666666666,40,2,19,37.66072082875319,0.6059895833333333,45.75711382113821,1016.9715447154474,25.424288617886184,0
3651,4,1,1,41,0.023809523809523808,0.023809523809523808,0.9761904761904762,42,1350,1100,250,0.8148148148148148,16,11,5,318.3639537285888,0.8237272551296941,0.15036392179249303,0.17724266834389193,129356.41503899811,-163.5160536056454,129192.89898539246,3613,0,615.6428571428571,40,2,19,37.58429070929071,0.6067708333333333,45.680894308943095,1017.2764227642289,25.43191056910572,0
3652,4,1,1,41,0.023809523809523808,0.023809523809523808,0.9761904761904762,42,1250,900,350,0.72,16,9,7,298.94882089980456,0.826413085559427,0.055370540499158016,0.16029841948248144,127861.72251966425,-752.0148597065207,127109.70765995773,3614,0,616.6190476190476,40,2,15,39.595684284565905,0.5916666666666668,47.15447154471545,1011.3821138211384,25.28455284552846,7
3653,4,4,2,43,0.08888888888888889,0.044444444444444446,0.9555555555555556,45,1400,1200,200,0.8571428571428571,16,12,4,282.53898989885766,0.8429713804713805,0.08485311435755483,0.15484201157565322,128733.87008180087,-1725.2200588862295,127008.65002291463,3615,0,576.3777777777777,42,3,14,39.12540978388875,0.5974702380952381,46.29360465116279,1014.825581395348,24.16251384274638,0
3654,4,0,0,43,0.0,0.0,1.0,43,750,400,350,0.5333333333333333,11,4,7,294.4579910172706,0.831626061277224,0.08666253188522743,0.16013762281386365,128427.65239771306,-1036.6902967810058,127390.96210093205,3616,1,604.1860465116279,40,3,14,39.13383129469956,0.5973958333333333,46.59552845528456,1013.6178861788622,25.340447154471555,0
3655,4,2,1,44,0.044444444444444446,0.022222222222222223,0.9777777777777777,45,1350,800,550,0.5925925925925926,19,8,11,298.7050399686742,0.8433501683501684,0.12481989999152421,0.16523304109659578,129102.8934559222,-1287.2630100354506,127815.63044588675,3617,0,578.2888888888889,42,3,16,38.34104055428425,0.601190476190476,45.93023255813954,1016.2790697674425,24.19712070874863,0
3656,4,0,0,44,0.0,0.0,1.0,44,800,500,300,0.625,11,5,6,304.0542602539064,0.8375616631430586,0.12209694602272747,0.16775407462284497,128999.74804736719,-955.4154069034864,128044.3326404637,3618,1,592.3636363636364,41,3,17,38.30973307291669,0.6016260162601625,46.03174603174604,1015.8730158730166,24.777390631049187,0
3657,4,0,1,43,0.0,0.022727272727272728,0.9772727272727273,44,900,700,200,0.7777777777777778,11,7,4,301.3699638089554,0.8370331219168429,0.12216103236800313,0.16659107065812895,129075.34490937582,-1020.1135952065946,128055.23131416923,3619,2,593.3636363636364,41,3,18,38.30125858309741,0.6023882113821137,45.95734126984127,1016.1706349206352,24.784649632210613,0
3658,4,0,0,43,0.0,0.0,1.0,43,1400,1100,300,0.7857142857142857,17,11,6,307.75888942721946,0.8343484680693982,0.1287958424244351,0.1701227363412307,129075.3449093757,-655.1830396510546,128420.16186972464,3620,3,605.5581395348837,41,2,18,38.13895261804811,0.6023882113821138,45.957341269841265,1016.1706349206341,24.784649632210588,0
3659,4,5,4,44,0.10416666666666667,0.08333333333333333,0.9166666666666666,48,600,400,200,0.6666666666666666,8,4,4,280.55969019847566,0.8616282505910166,0.13786547716335207,0.15869562753753558,129979.17631172869,-2306.4934885991192,127672.68282312957,3621,0,543.375,44,4,14,37.91712067556524,0.6072443181818181,45.06944444444446,1019.7222222222246,23.175505050505105,0
3660,4,1,1,44,0.022222222222222223,0.022222222222222223,0.9777777777777777,45,1050,500,550,0.47619047619047616,16,5,11,296.7751395203977,0.8425505050505051,0.1361600813826389,0.16659323988277358,129680.91699932309,-1302.7855528785374,128378.13144644455,3622,0,580.5777777777778,41,4,15,37.805083438849394,0.6084857723577235,45.362103174603185,1018.551587301589,24.842721641502173,0
3661,4,0,1,43,0.0,0.022727272727272728,0.9772727272727273,44,700,300,400,0.42857142857142855,11,3,8,299.65118209562627,0.8381122269203665,0.13684860885971672,0.16777523632555447,129579.88989866784,-1034.2465632086146,128545.64333545923,3623,1,594.6136363636364,41,3,15,37.8340275747832,0.6074695121951219,45.461309523809526,1018.1547619047622,24.833042973286883,0
3662,4,1,2,42,0.022727272727272728,0.045454545454545456,0.9545454545454546,44,1150,700,450,0.6086956521739131,16,7,9,301.1045864401998,0.8386627906976745,0.13858190319324182,0.1689147368521908,129655.65653344679,-992.0174319727787,128663.63910147401,3624,0,595.3181818181819,41,3,16,37.72038768751218,0.6082317073170731,45.386904761904766,1018.4523809523815,24.84030197444833,0
3663,4,0,0,42,0.0,0.0,1.0,42,1050,800,250,0.7619047619047619,13,8,5,311.9320809951642,0.8287843592721641,0.1485116915895588,0.17449984130313367,129545.80213758703,-318.1016710069209,129227.7004665801,3625,3,624.2142857142857,39,3,16,37.55595774071422,0.610309829059829,45.49479166666668,1018.0208333333352,26.10309829059834,0
3664,4,0,1,41,0.0,0.023809523809523808,0.9761904761904762,42,1050,700,350,0.6666666666666666,14,7,7,314.87561372828947,0.8273325590398761,0.15216523259267967,0.1768620693078082,129704.91672092007,-231.81694878472726,129473.09977213533,3626,4,625.2142857142857,39,3,17,37.319873368101725,0.6119123931623932,45.338541666666664,1018.6458333333327,26.119123931623914,0
3665,4,0,0,41,0.0,0.0,1.0,41,900,400,500,0.4444444444444444,14,4,10,317.6139008242965,0.8179369918699188,0.048354654235666095,0.17344961033797984,128593.16541883704,-30.208333333308758,128562.95708550373,3627,5,641.2439024390244,39,2,13,38.378628769983905,0.6006944444444444,46.43229166666668,1014.2708333333353,26.006944444444496,6
3666,4,2,2,41,0.046511627906976744,0.046511627906976744,0.9534883720930233,43,1400,900,500,0.6428571428571429,19,9,10,309.8259912583286,0.8289036544850498,0.02549119573316605,0.16855670900567807,128442.17985243647,-618.0866541023797,127824.09319833409,3628,0,612.3720930232558,38,5,12,38.72962338392356,0.600877192982456,46.58119658119659,1013.6752136752153,26.675663517768825,2
3667,4,0,1,40,0.0,0.024390243902439025,0.975609756097561,41,1100,700,400,0.6363636363636364,15,7,8,323.07308641975266,0.8236788617886179,0.027138211382113475,0.17558319914117024,128401.20525931365,96.59473662854774,128497.7999959422,3629,1,635.2682926829268,36,5,12,38.43564814814814,0.6041666666666665,46.621621621621635,1013.5135135135158,28.153153153153216,0
3668,4,2,1,41,0.047619047619047616,0.023809523809523808,0.9761904761904762,42,1400,1200,200,0.8571428571428571,16,12,4,321.07095061463747,0.8305991095625241,0.06338665473748151,0.17667487068580853,128895.01006319256,-123.11131790549928,128771.89874528706,3630,0,620.9285714285714,37,5,13,37.98399650865639,0.6072635135135135,46.13486842105264,1015.4605263157898,27.44487908961594,0
3669,4,3,0,44,0.06818181818181818,0.0,1.0,44,1000,700,300,0.7,13,7,6,319.2902673374384,0.8496300211416491,0.04092933148276656,0.16730810008481756,126930.47337278088,-694.1033510709476,126236.37002170992,3631,0,593.6363636363636,38,6,15,40.03326441899915,0.5855263157894738,48.076923076923066,1007.6923076923061,26.51821862348174,8
3670,4,1,1,44,0.022222222222222223,0.022222222222222223,0.9777777777777777,45,1050,900,150,0.8571428571428571,12,9,3,310.9999778264809,0.8532828282828283,0.04010694573536666,0.1639310171635172,127170.80213758664,-1089.9766710069625,126080.82546657967,3632,0,581.4222222222222,39,6,16,39.996320871630694,0.5862713675213677,47.83854166666666,1008.645833333332,25.86271367521364,0
3671,4,3,2,45,0.06382978723404255,0.0425531914893617,0.9574468085106383,47,1050,500,550,0.47619047619047616,16,5,11,296.2884346719833,0.8619333950046253,0.058090870360624214,0.1582068434191907,127692.92091836703,-1833.2128684807578,125859.70804988628,3633,0,557.6170212765958,41,6,12,39.83485473105614,0.5884146341463415,47.321428571428555,1010.7142857142832,24.651567944250807,0
3672,4,2,1,46,0.0425531914893617,0.02127659574468085,0.9787234042553191,47,1200,1000,200,0.8333333333333334,14,10,4,299.20575161325326,0.8633980881899476,0.07686947378084241,0.16076397549799537,127943.71712805466,-1743.700790501405,126200.01633755326,3634,0,558.468085106383,41,6,14,39.50570373275808,0.5909552845528456,47.07341269841269,1011.706349206347,24.67576461478895,0
3673,4,2,0,48,0.041666666666666664,0.0,1.0,48,1150,800,350,0.6956521739130435,15,8,7,292.12550158714004,0.8715093085106382,0.08799787789748592,0.15814429327702514,128244.99736237068,-2107.115693499648,126137.88166887102,3635,0,546.25,41,7,16,39.378468821416895,0.5940040650406505,46.77579365079364,1012.8968253968238,24.704800619434728,0
3674,4,0,0,48,0.0,0.0,1.0,48,1350,900,450,0.6666666666666666,18,9,9,290.3687285985256,0.8704380910165485,0.0861836954394215,0.1579865638349163,128446.04768990901,-2140.6568877551226,126305.3908021539,3636,1,547.25,41,7,10,39.21878058328442,0.5960365853658538,46.57738095238094,1013.6904761904739,24.724157955865216,0
3675,4,1,2,47,0.02040816326530612,0.04081632653061224,0.9591836734693877,49,900,500,400,0.5555555555555556,13,5,8,287.59625778222784,0.8724489795918368,0.09634492582481347,0.15761358491644534,128733.87008180088,-2395.3241429301165,126338.54593887077,3637,0,537.0612244897959,42,7,12,38.997103663388415,0.5974702380952381,46.29360465116279,1014.8255813953481,24.16251384274638,0
3676,4,0,4,43,0.0,0.0851063829787234,0.9148936170212766,47,1150,900,250,0.782608695652174,14,9,5,310.3082025727349,0.8646315140302189,0.031196017747181726,0.17040509266075057,128814.23017259919,-1405.5775538700282,127408.65261872916,3638,1,560.8297872340426,40,7,14,38.3392565155004,0.6013020833333333,46.214430894308954,1015.1422764227658,25.378556910569145,6
3677,4,3,5,41,0.06521739130434782,0.10869565217391304,0.8913043478260869,46,1350,1100,250,0.8148148148148148,16,11,5,308.83499999999987,0.8553341384863125,0.06285652173913014,0.17081581858407108,129098.08976138574,-1225.9982897084742,127872.09147167727,3639,0,573.0652173913044,40,6,15,38.08854166666668,0.6041666666666665,45.93495934959351,1016.2601626016285,25.406504065040714,0
3678,4,2,1,42,0.046511627906976744,0.023255813953488372,0.9767441860465116,43,700,400,300,0.5714285714285714,10,4,6,328.7605638221821,0.8403469915097822,0.06717452915519284,0.1802729726740589,128755.86718990444,-134.02970144661262,128621.83748845782,3640,0,613.1627906976744,37,6,16,37.930351483722276,0.6058558558558559,46.2719298245614,1014.9122807017533,27.430061640587926,0
3679,4,0,0,42,0.0,0.0,1.0,42,1050,800,250,0.7619047619047619,13,8,5,336.43754374746004,0.8369628339140535,0.07054086614672528,0.18442671193747603,128743.8367421474,262.8520412304021,129006.6887833778,3641,1,628.7619047619048,36,6,18,37.74781772451546,0.6076388888888891,46.283783783783775,1014.8648648648636,28.19069069069066,0
3680,4,1,1,42,0.023255813953488372,0.023255813953488372,0.9767441860465116,43,1200,800,400,0.6666666666666666,16,8,8,325.2833339138817,0.840531561461794,0.07226666399012349,0.17987624932660207,129089.93632656173,-201.83902739307678,128888.09729916866,3642,0,615.1162790697674,37,6,19,37.67893108905193,0.6092342342342343,45.942982456140335,1016.2280701754362,27.465623518255033,0
3681,4,1,1,42,0.023255813953488372,0.023255813953488372,0.9767441860465116,43,850,600,250,0.7058823529411765,11,6,5,318.7178295342342,0.8391472868217054,0.06204224045879947,0.17749483928082968,129368.65790435509,-353.5323368728964,129015.12556748219,3643,0,600.7674418604652,37,6,19,37.56287274556299,0.6120495495495495,45.6688596491228,1017.3245614035079,27.495258416311025,0
3682,4,2,1,43,0.045454545454545456,0.022727272727272728,0.9772727272727273,44,1150,800,350,0.6956521739130435,15,8,7,316.1421365608721,0.8471634954193094,0.08941522362740528,0.17812639342316328,129826.69850107729,-591.2620306450663,129235.43647043222,3644,0,588.0681818181819,38,6,15,37.16431666491946,0.614857456140351,45.21901709401708,1019.1239316239299,26.81905083220868,0
3683,4,1,3,41,0.022727272727272728,0.06818181818181818,0.9318181818181819,44,900,400,500,0.4444444444444444,14,4,10,317.08726863199036,0.8478682170542636,0.08508494440262626,0.17890772501583777,129881.14458917727,-563.2685230842453,129317.87606609303,3645,0,589.0454545454545,38,6,15,37.08512385144813,0.615405701754386,45.16559829059828,1019.3376068376054,26.824673864147513,0
3684,4,2,2,41,0.046511627906976744,0.046511627906976744,0.9534883720930233,43,950,700,250,0.7368421052631579,12,7,5,321.1568344171937,0.846391657438169,0.07680586673557999,0.18095186317221532,129826.69850107716,-261.05369731174767,129565.64480376542,3646,0,600.7906976744187,38,5,15,37.03655170003843,0.614857456140351,45.219017094017076,1019.1239316239289,26.819050832208656,0
3685,4,0,0,41,0.0,0.0,1.0,41,1200,600,600,0.5,18,6,12,334.5419280302237,0.8341971544715447,0.08641515744951711,0.18741809871432952,129602.41280131465,471.4882111841355,130073.90101249878,3647,3,631.0975609756098,36,5,16,36.923062744230634,0.6163194444444446,45.43918918918918,1018.2432432432417,28.284534534534494,0
3686,4,1,1,41,0.023809523809523808,0.023809523809523808,0.9761904761904762,42,1000,800,200,0.8,12,8,4,321.6536800005343,0.8390195509097949,0.0714285714285714,0.18040575965247327,129647.68005540136,-57.99217966097905,129589.68787574038,3648,0,617.047619047619,37,5,15,37.20526485788112,0.6148648648648649,45.394736842105246,1018.4210526315766,27.524893314366935,3
3687,4,1,1,41,0.023809523809523808,0.023809523809523808,0.9761904761904762,42,750,500,250,0.6666666666666666,10,5,5,323.6139285051323,0.8402051877661634,0.08817440674752675,0.182152891435384,129787.30384589464,0.19585353183117604,129787.49969942647,3649,0,618.0238095238095,37,5,16,37.01385899781198,0.6162725225225226,45.25767543859648,1018.9692982456121,27.539710763394922,0
3688,4,2,1,42,0.046511627906976744,0.023255813953488372,0.9767441860465116,43,1400,1200,200,0.8571428571428571,16,12,4,312.97544569581606,0.8438076781100037,0.0992316232324415,0.1779488962670494,130180.80210387881,-451.32108809995486,129729.48101577886,3650,0,604.2558139534884,38,5,19,36.88690850083752,0.618421052631579,44.87179487179486,1020.5128205128188,26.85560053981102,0
3689,4,0,0,42,0.0,0.0,1.0,42,1450,1200,250,0.8275862068965517,17,12,5,318.9767146031669,0.8429394115369725,0.09478942330701168,0.18136104630294317,130180.80210387883,-95.07108809995418,130085.73101577887,3651,1,617.5714285714286,38,4,19,36.733799204355115,0.618421052631579,44.87179487179486,1020.512820512819,26.855600539811025,0
3690,4,1,1,42,0.023255813953488372,0.023255813953488372,0.9767441860465116,43,1500,1100,400,0.7333333333333333,19,11,8,317.0032320812589,0.8451919527500923,0.11320249947449867,0.17300131544524333,128566.75347222241,-448.78472222220205,128117.9687500002,3652,0,604.1860465116279,39,4,15,38.42098055327308,0.6004273504273503,46.45833333333334,1014.1666666666682,26.004273504273545,5
3691,4,0,0,42,0.0,0.0,1.0,42,1000,600,400,0.6,14,6,8,326.7927433673525,0.8396970576848626,0.11603223103591853,0.17814990966683208,128523.41666894969,0.10398403829111658,128523.52065298798,3653,1,619.5238095238095,38,4,16,38.21690724546058,0.6016995614035088,46.50106837606838,1013.9957264957279,26.684098065677052,0
3692,4,1,2,41,0.023255813953488372,0.046511627906976744,0.9534883720930233,43,950,800,150,0.8421052631578947,11,8,3,321.6395555447704,0.8470837947582134,0.11715736815977396,0.17646710750159036,128778.12500000012,-315.9722222222074,128462.15277777791,3654,0,606.0930232558139,39,4,16,38.08839627805146,0.6025641025641024,46.25000000000001,1015.0000000000009,26.02564102564105,0
3693,4,3,1,43,0.06818181818181818,0.022727272727272728,0.9772727272727273,44,1350,1000,350,0.7407407407407407,17,10,7,315.11464710086875,0.8509073291050036,0.1369964752070456,0.17486566160110592,129228.5448740776,-654.2496484403673,128574.29522563724,3655,0,592.9772727272727,38,6,19,37.79661833210744,0.6088267543859649,45.806623931623925,1016.7735042735034,26.75719748088167,0
3694,4,0,0,43,0.0,0.0,1.0,43,1450,1000,450,0.6896551724137931,19,10,9,321.57789727500295,0.8456533776301218,0.135892895023489,0.1779713864839595,129121.97401258688,-295.44542100693945,128826.52859157995,3656,1,607.7674418604652,39,4,19,37.74053243824947,0.6060363247863249,45.911458333333336,1016.3541666666673,26.060363247863265,0
3695,4,1,0,44,0.022727272727272728,0.0,1.0,44,1350,900,450,0.6666666666666666,18,9,9,321.1445378106239,0.8484848484848485,0.15938848385656867,0.18001771798375354,129625.34722222234,-474.2811414930442,129151.06608072929,3657,0,594.9318181818181,39,5,14,37.24086197490453,0.611111111111111,45.41666666666667,1018.3333333333343,26.111111111111136,0
3696,4,0,2,42,0.0,0.045454545454545456,0.9545454545454546,44,1100,700,400,0.6363636363636364,15,7,8,325.04079396026816,0.8479783298097252,0.16849690029835163,0.1828190917610918,129757.97661675369,-364.67285156248045,129393.3037651912,3658,1,595.9318181818181,39,5,14,37.00722915175682,0.6124465811965811,45.28645833333334,1018.8541666666684,26.12446581196586,0
3697,4,0,0,42,0.0,0.0,1.0,42,1150,900,250,0.782608695652174,14,9,5,336.8897813355474,0.836527293844367,0.1615061838588716,0.18828102589632065,129508.13140822176,325.9932142582324,129834.12462247998,3659,2,624.5952380952381,37,5,15,36.95902456102553,0.6134572072072071,45.531798245614034,1017.8728070175438,27.510075865339022,0
3698,4,0,0,42,0.0,0.0,1.0,42,1000,400,600,0.4,16,4,12,338.7499742437455,0.836866047231901,0.16475862210459402,0.18945510607704424,129536.03512619277,376.065712526948,129912.10083871972,3660,3,625.5952380952381,37,5,15,36.88334769495907,0.6137387387387387,45.50438596491229,1017.9824561403516,27.513039355144638,0
3699,4,1,0,43,0.023255813953488372,0.0,1.0,43,1450,1100,350,0.7586206896551724,18,11,7,330.78836354085905,0.8415928386858619,0.17505843812383737,0.18663818903272267,129881.1445891776,-7.365745306436622,129873.77884387116,3661,0,612.0232558139535,38,5,17,36.735972819061594,0.6154057017543859,45.1655982905983,1019.3376068376081,26.82467386414758,0
3700,4,2,3,42,0.044444444444444446,0.06666666666666667,0.9333333333333333,45,950,500,450,0.5263157894736842,14,5,9,316.25902169464064,0.8490740740740741,0.1375871348442106,0.17914374666901406,130034.82187145716,-775.0628897392061,129259.75898171795,3662,0,585.7777777777778,41,4,15,36.95074652271181,0.6120426829268292,45.01488095238096,1019.9404761904781,24.876596980255563,2
3701,4,1,1,42,0.023255813953488372,0.023255813953488372,0.9767441860465116,43,900,700,200,0.7777777777777778,11,7,4,326.7099664686125,0.8412698412698413,0.14356532112795195,0.18438199145685374,129890.67382812516,-112.68446180554099,129777.98936631961,3663,0,613.7674418604652,39,4,16,36.83025069827645,0.6137820512820513,45.15625000000001,1019.3750000000013,26.137820512820547,0
3702,4,0,0,42,0.0,0.0,1.0,42,1300,1000,300,0.7692307692307693,16,10,6,333.12757486676384,0.8347125435540069,0.14618363853244887,0.18795802435267847,129881.14458917743,253.39814358243592,130134.54273275987,3664,1,629.047619047619,38,4,16,36.676361667190726,0.6154057017543859,45.16559829059829,1019.3376068376068,26.82467386414755,0
3703,4,1,0,43,0.023255813953488372,0.0,1.0,43,1100,900,200,0.8181818181818182,13,9,4,329.02957101207835,0.8401162790697674,0.1653535832937827,0.1874703369719981,130262.58680555549,-27.951388888893803,130234.6354166666,3665,0,615.3953488372093,39,4,17,36.39455782312925,0.6175213675213675,44.791666666666664,1020.8333333333328,26.175213675213662,0
3704,4,0,0,43,0.0,0.0,1.0,43,1050,800,250,0.7619047619047619,13,8,5,327.8605839696736,0.8400701365817644,0.1645460324689496,0.18731615182043576,130368.94531249999,-51.4322916666672,130317.51302083331,3666,1,616.3953488372093,39,4,17,36.316809465524265,0.6185897435897436,44.6875,1021.2499999999999,26.185897435897434,0
3705,4,1,1,43,0.022727272727272728,0.022727272727272728,0.9772727272727273,44,1500,1300,200,0.8666666666666667,17,13,4,320.01540449199626,0.845335623678647,0.15291165656364858,0.18454527308899488,130729.84959556158,-432.8868604996986,130296.96273506188,3667,0,603.3636363636364,40,4,14,36.15265494054124,0.6205729166666667,44.334349593495936,1022.6626016260169,25.566565040650424,0
3706,4,0,0,43,0.0,0.0,1.0,43,1050,800,250,0.7619047619047619,13,8,5,325.01449728346444,0.8413159837578442,0.15712721740655167,0.18696906660843624,130635.03146701399,-108.34418402777277,130526.68728298623,3668,3,618.3953488372093,39,4,14,36.12059303036477,0.6212606837606838,44.427083333333336,1022.2916666666675,26.21260683760686,0
3707,4,0,0,43,0.0,0.0,1.0,43,1000,800,200,0.8,12,8,4,325.6991650151312,0.841500553709856,0.1553766930223086,0.1878798121103736,130741.54188368063,-83.51779513887845,130658.02408854176,3669,4,619.3953488372093,39,4,14,35.995535411149596,0.6223290598290598,44.32291666666667,1022.708333333334,26.223290598290617,0
3708,4,0,0,43,0.0,0.0,1.0,43,1400,1000,400,0.7142857142857143,18,10,8,329.09806849069287,0.8412236987818383,0.15659972205715533,0.19049677824302177,130874.74093967033,14.124891493076575,130888.8658311634,3670,5,620.3953488372093,39,4,15,35.7741397739998,0.6236645299145298,44.19270833333334,1023.2291666666682,26.23664529914534,0
3709,4,0,0,43,0.0,0.0,1.0,43,1400,900,500,0.6428571428571429,19,9,10,341.0869271379726,0.8408545588778147,0.1717618048243108,0.19543524770643705,130480.80490037627,309.87283535423643,130790.67773573051,3671,6,621.3953488372093,38,5,18,35.865880651120634,0.6214364035087719,44.577991452991455,1021.6880341880346,26.886527215474597,2
3710,4,0,1,42,0.0,0.023255813953488372,0.9767441860465116,43,900,600,300,0.6666666666666666,12,6,6,339.60184928880926,0.8409468438538206,0.16776766068150528,0.19485852960092764,130535.38795976713,266.011829753828,130801.39978952096,3672,7,622.3953488372093,38,5,13,35.84857989196722,0.6219846491228069,44.524572649572654,1021.9017094017107,26.89215024741344,0
3711,4,1,0,43,0.023255813953488372,0.0,1.0,43,1150,900,250,0.782608695652174,14,9,5,331.4569858011382,0.8449150978220745,0.1626841824960057,0.19212772185818205,130928.03955078138,79.40266927085014,131007.44222005222,3673,0,577.3953488372093,39,4,15,35.6599872773537,0.6241987179487178,44.14062500000001,1023.437500000001,26.241987179487207,0
3712,4,1,0,44,0.022727272727272728,0.0,1.0,44,1850,1500,350,0.8108108108108109,22,15,7,326.855707581466,0.8497401338971107,0.1651884700665185,0.1914440572977159,131328.12500000015,-214.9305555555392,131113.1944444446,3674,0,565.25,40,4,18,35.374322493224945,0.6265624999999999,43.75000000000001,1025.0000000000011,25.62500000000003,0
3713,4,0,1,43,0.0,0.022727272727272728,0.9772727272727273,44,1350,700,650,0.5185185185185185,20,7,13,311.0932747059969,0.8483086680761099,0.06720675691107636,0.18428759587477736,131760.64819735757,-602.0296949798503,131158.6185023777,3675,1,566.25,41,3,13,35.3434913196122,0.629319105691057,43.32837301587301,1026.6865079365073,25.041134339914812,4
3714,4,0,0,43,0.0,0.0,1.0,43,1300,1000,300,0.7692307692307693,16,10,6,316.7347502387715,0.8461148025101514,0.07318044256239631,0.1879392044135519,131823.3827107709,-249.3907602947864,131573.99195047613,3676,2,579.6046511627907,40,3,13,35.13565891472866,0.6315104166666666,43.26727642276423,1026.9308943089445,25.67327235772361,0
3715,4,0,2,41,0.0,0.046511627906976744,0.9534883720930233,43,1250,900,350,0.72,16,9,7,313.1941636581677,0.8447305278700628,0.07219145569620289,0.1867346334263795,132006.08103642028,-331.29317040119315,131674.7878660191,3677,3,580.6046511627907,40,3,14,35.04314181170888,0.6333333333333333,43.089430894308954,1027.6422764227657,25.69105691056914,0
3716,4,0,0,41,0.0,0.0,1.0,41,850,500,350,0.5882352941176471,12,5,7,327.0159335786571,0.835010162601626,0.08315824731281052,0.19402945392333676,131821.37573964518,421.53805062461373,132242.91379026978,3678,4,609.4878048780488,38,3,14,34.87372555139409,0.6348684210526314,43.26923076923078,1026.9230769230785,27.02429149797575,0
3717,4,0,0,41,0.0,0.0,1.0,41,1200,700,500,0.5833333333333334,17,7,10,328.07910336156584,0.8344512195121951,0.08749749554270014,0.19536450384075435,131958.55391418305,458.56880981081434,132417.12272399387,3679,5,610.4878048780488,38,3,15,34.7085023049461,0.6362390350877192,43.13568376068377,1027.457264957266,27.03834907782279,0
3718,4,0,0,41,0.0,0.0,1.0,41,1450,1200,250,0.8275862068965517,17,12,5,352.5228028846421,0.8322154471544716,0.07266022051035859,0.20781316612039397,131574.63480029593,1127.0885838994852,132701.72338419541,3680,6,611.4878048780488,38,3,15,34.46774445485786,0.6324013157894737,43.50961538461539,1025.9615384615388,26.99898785425102,4
3719,4,0,1,40,0.0,0.024390243902439025,0.975609756097561,41,850,700,150,0.8235294117647058,10,7,3,356.17573495016575,0.8317073170731707,0.06608674456513453,0.2104196869576441,131656.85609796192,1178.5954963839636,132835.45159434588,3681,7,612.4878048780488,38,3,15,34.29106808244847,0.6332236842105262,43.42948717948718,1026.2820512820517,27.007422402159257,0
3720,4,0,0,40,0.0,0.0,1.0,40,800,500,300,0.625,11,5,6,357.7863613120022,0.8261752136752136,0.08084401709401678,0.21141921350254678,131665.51246537396,1421.6249230532424,133087.13738842722,3682,8,628.3,37,3,15,34.24100783475782,0.6351351351351351,43.421052631578945,1026.3157894736842,27.738264580369844,0
3721,4,0,0,40,0.0,0.0,1.0,40,1400,800,600,0.5714285714285714,20,8,12,355.4857874382616,0.8257478632478632,0.08288574479444777,0.21083751737551087,131806.21831957897,1371.0474617189811,133177.26578129796,3683,9,629.3,37,3,15,34.15810197544047,0.6365427927927929,43.28399122807017,1026.8640350877183,27.753082029397792,0
3722,4,0,0,40,0.0,0.0,1.0,40,1200,1100,100,0.9166666666666666,13,11,2,353.88358158927497,0.8248931623931623,0.08253015263101737,0.21051017624824853,131918.8371061287,1336.7821108417827,133255.61921697046,3684,10,630.3,37,3,17,34.08570373928203,0.637668918918919,43.17434210526315,1027.3026315789464,27.764935988620174,0
3723,4,0,0,40,0.0,0.0,1.0,40,1250,800,450,0.64,17,8,9,353.4123948543887,0.8242254273504274,0.08586214255228342,0.21069853464219654,132003.33275623262,1330.322791628185,133333.6555478608,3685,11,631.3,37,3,17,34.01266182956323,0.6385135135135136,43.09210526315789,1027.6315789473679,27.773826458036968,0
3724,4,0,0,40,0.0,0.0,1.0,40,950,500,450,0.5263157894736842,14,5,9,353.21728965405987,0.8237446581196581,0.09191192151844785,0.2115243769077761,132172.40521121884,1337.1157471529737,133509.5209583718,3686,12,632.3,37,3,17,33.84739105708397,0.6402027027027026,42.92763157894737,1028.2894736842106,27.791607396870557,0
3725,4,0,1,39,0.0,0.025,0.975,40,1150,1000,150,0.8695652173913043,13,10,3,352.75655327958634,0.8227029914529914,0.08300916551209636,0.21203809989893393,132313.38158135198,1334.8824878808857,133648.26406923286,3687,13,633.3,37,3,17,33.71733898184659,0.6416103603603605,42.790570175438596,1028.8377192982457,27.806424845898533,0
3726,4,0,0,39,0.0,0.0,1.0,39,750,500,250,0.6666666666666666,10,5,5,360.1512156446581,0.8193319838056681,0.09652992949840566,0.21646983592957875,132311.09487866246,1730.400332765203,134041.49521142768,3688,14,649.7179487179487,36,3,17,33.529443957968475,0.6435185185185186,42.792792792792795,1028.828828828829,28.578578578578586,0
3727,4,0,0,39,0.0,0.0,1.0,39,850,700,150,0.8235294117647058,10,7,3,359.9067889214363,0.8182073774179037,0.09248414915793779,0.21699329314429366,132427.78427479847,1732.3602540658403,134160.1445288643,3689,15,650.7179487179487,35,4,18,33.41825499456502,0.6467261904761905,42.679398148148145,1029.282407407407,29.40806878306877,0
3728,4,0,0,39,0.0,0.0,1.0,39,1050,800,250,0.7619047619047619,13,8,5,363.25494943827124,0.8163517768780927,0.09908266399218446,0.21970627363373876,132546.94097490126,1829.6664684070442,134376.6074433083,3690,16,651.7179487179487,35,4,18,33.21215484620283,0.6479166666666667,42.5636574074074,1029.745370370369,29.42129629629626,0
3729,4,0,0,39,0.0,0.0,1.0,39,1150,900,250,0.782608695652174,14,9,5,365.1388734113676,0.8152834008097166,0.10214928314018357,0.2215474514134,132666.1512586804,1888.3138020833146,134554.4650607637,3691,17,652.7179487179487,35,4,15,33.04368891135827,0.6491071428571429,42.44791666666666,1030.208333333332,29.434523809523768,0
3730,4,0,0,39,0.0,0.0,1.0,39,1550,1200,350,0.7741935483870968,19,12,7,363.1323467834611,0.8145524066576698,0.0997792271830733,0.22096989612780835,132774.93709926144,1842.9749005762505,134617.9119998377,3692,18,653.7179487179487,36,3,15,32.98595935314685,0.6481481481481481,42.34234234234234,1030.6306306306308,28.628628628628633,0
3731,4,0,0,39,0.0,0.0,1.0,39,1150,900,250,0.782608695652174,14,9,5,367.6545332051393,0.8126968061178588,0.1045793343577428,0.22528984472858088,133036.20501836317,1982.272771081919,135018.47778944508,3693,19,654.7179487179487,36,3,16,32.6067478077357,0.6507523148148147,42.08896396396398,1031.644144144146,28.65678178178183,0
3732,4,0,0,39,0.0,0.0,1.0,39,850,400,450,0.47058823529411764,13,4,9,368.1918063364591,0.8113472784525416,0.10300614097668115,0.22632313246637514,133152.40652392287,2005.125015217956,135157.53153914082,3694,20,655.7179487179487,36,3,16,32.47613202400438,0.6519097222222221,41.97635135135137,1032.0945945945969,28.669294294294357,0
3733,4,0,0,39,0.0,0.0,1.0,39,1050,700,350,0.6666666666666666,14,7,7,370.36070055022634,0.8101102114260009,0.1041864211930752,0.2280118564099349,133210.5262991034,2067.188768160077,135277.71506726346,3695,21,656.7179487179487,36,3,16,32.36177775353623,0.6524884259259258,41.92004504504506,1032.3198198198218,28.675550550550604,0
3734,4,0,0,39,0.0,0.0,1.0,39,1150,1000,150,0.8695652173913043,13,10,3,372.9565924056405,0.8078047683310842,0.10489027564591824,0.23032895009778678,133326.80389426605,2145.0220913481244,135471.82598561418,3696,22,657.7179487179487,36,3,16,32.177970413986124,0.6536458333333333,41.80743243243244,1032.7702702702716,28.688063063063098,0
3735,4,0,0,39,0.0,0.0,1.0,39,1250,900,350,0.72,16,9,7,366.5921829458089,0.8074673864147549,0.10177152522319965,0.22747057689528333,133502.12358807013,1988.2462428136014,135490.36983088372,3697,23,658.7179487179487,35,4,17,32.16637268077799,0.6574404761904762,41.63773148148148,1033.449074074074,29.5271164021164,0
3736,4,0,0,39,0.0,0.0,1.0,39,1050,800,250,0.7619047619047619,13,8,5,366.36976157722927,0.8072986954565903,0.10139259769718878,0.22751613149406538,133532.02830289793,1984.4194744513202,135516.44777734924,3698,24,659.7179487179487,35,4,18,32.14212392683839,0.6577380952380951,41.608796296296305,1033.564814814816,29.53042328042331,0
3737,4,0,0,39,0.0,0.0,1.0,39,750,500,250,0.6666666666666666,10,5,5,364.51792073184924,0.8063990103463788,0.1015999816357922,0.2274673281885337,133711.52692043892,1948.0495541838095,135659.57647462274,3699,25,660.7179487179487,35,4,16,32.010034318113995,0.6595238095238095,41.43518518518518,1034.259259259259,29.55026455026454,0
3738,4,0,0,39,0.0,0.0,1.0,39,1450,1200,250,0.8275862068965517,17,12,5,367.82917811626027,0.8067926225820963,0.10559351888508317,0.22990609748273652,133771.3865847907,2041.0038365912096,135812.39042138192,3700,26,661.7179487179487,35,4,16,31.86441784142612,0.6601190476190477,41.37731481481481,1034.49074074074,29.556878306878286,0
3739,4,0,0,39,0.0,0.0,1.0,39,1200,900,300,0.75,15,9,6,368.50592315661436,0.8057242465137202,0.11041128893477858,0.2307032880266199,133831.25964506174,2063.5223765432065,135894.78202160494,3701,27,662.7179487179487,35,4,16,31.786912751677836,0.6607142857142857,41.31944444444444,1034.7222222222224,29.563492063492067,0
3740,4,0,2,37,0.0,0.05128205128205128,0.9487179487179487,39,900,700,200,0.7777777777777778,11,7,4,368.47816558431526,0.8051057130004499,0.10720890425687513,0.23124913928565125,133921.09435281626,2069.399836033944,135990.4941888502,3702,28,663.7179487179487,35,4,16,31.697626635357274,0.6616071428571428,41.232638888888886,1035.069444444444,29.57341269841268,0
3741,4,0,0,37,0.0,0.0,1.0,37,1150,800,350,0.6956521739130435,15,8,7,378.63974690958725,0.7948573573573573,0.1194784740917636,0.23697964293236817,133820.6928374905,2733.9666534506077,136554.6594909411,3703,29,696.8378378378378,33,4,16,31.535369536894475,0.6650883838383839,41.329656862745104,1034.6813725490204,31.35398098633395,0
3742,4,0,0,37,0.0,0.0,1.0,37,550,300,250,0.5454545454545454,8,3,5,378.5039273427565,0.7944194194194194,0.11932349213258764,0.23709845419007688,133852.39451172634,2732.731401384093,136585.12591311042,3704,30,697.8378378378378,33,4,17,31.507085899257863,0.6654040404040403,41.29901960784314,1034.803921568628,31.35769459298873,0
3743,4,0,0,37,0.0,0.0,1.0,37,750,500,250,0.6666666666666666,10,5,5,377.40125629565415,0.7927302302302303,0.11362788731693985,0.23713015352218272,133964.73922902497,2711.692176870747,136676.4314058957,3705,31,698.8378378378378,34,3,17,31.42297224777675,0.6642156862745099,41.19047619047619,1035.2380952380954,30.44817927170869,0
3744,4,0,0,37,0.0,0.0,1.0,37,1050,800,250,0.7619047619047619,13,8,5,377.69139189493404,0.7914164164164164,0.11150706977813507,0.2379100230336014,134057.1871456917,2726.449121315204,136783.63626700692,3706,32,699.8378378378378,34,3,18,31.32280530329157,0.6651348039215685,41.10119047619048,1035.595238095239,30.45868347338938,0
3745,4,1,2,36,0.02631578947368421,0.05263157894736842,0.9473684210526316,38,1050,700,350,0.6666666666666666,14,7,7,370.04510429273074,0.7953117591275486,0.1285078421816006,0.23606507258190354,134520.7626698602,2355.7499303412174,136876.51260020141,3707,0,682.3947368421053,35,3,19,31.05696102495446,0.6675595238095238,40.65393518518518,1037.384259259259,29.639550264550255,0
3746,4,0,1,35,0.0,0.027777777777777776,0.9722222222222222,36,800,500,300,0.625,11,5,6,378.90557901035567,0.7876653439153439,0.11820575450761028,0.24086552246480983,134391.8974222654,2984.367941416755,137376.26536368215,3708,1,672.9722222222222,33,3,19,30.956127132332664,0.6707702020202021,40.7781862745098,1036.8872549019602,31.420825906120005,0
3747,4,0,0,35,0.0,0.0,1.0,35,950,600,350,0.631578947368421,13,6,7,380.5326517473891,0.7861344537815126,0.11184821323070171,0.2423211310562946,134455.4396896627,3232.937001393698,137688.3766910564,3709,2,678.8571428571429,33,2,19,30.850343652763,0.6714015151515151,40.716911764705884,1037.1323529411768,31.4282531194296,0
3748,4,1,1,35,0.027777777777777776,0.027777777777777776,0.9722222222222222,36,600,400,200,0.6666666666666666,8,4,4,374.9971957818933,0.7885912698412699,0.11063663112843436,0.24105383484196444,134797.9184382087,2909.7682823129344,137707.68672052163,3710,0,660.9722222222222,34,2,16,30.65148649165042,0.6724877450980391,40.386904761904766,1038.4523809523816,30.542717086834756,0
3749,4,0,0,35,0.0,0.0,1.0,35,1050,700,350,0.6666666666666666,14,7,7,386.7132974356328,0.782563025210084,0.11034575813796588,0.24776563005142277,134677.95589436757,3416.351283160318,138094.3071775279,3711,4,680.8571428571429,33,2,19,30.467335694608416,0.6736111111111112,40.502450980392155,1037.9901960784314,31.454248366013072,0
3750,4,0,0,35,0.0,0.0,1.0,35,700,600,100,0.8571428571428571,8,6,2,387.191133866735,0.7821428571428571,0.11044111695669745,0.2485063095544681,134741.5657439446,3434.1479238754255,138175.71366782003,3712,5,681.8571428571429,33,2,19,30.39128895184135,0.6742424242424242,40.44117647058823,1038.2352941176468,31.46167557932263,0
3751,4,0,0,35,0.0,0.0,1.0,35,900,600,300,0.6666666666666666,12,6,6,387.1900871033145,0.7813725490196078,0.11310577328276472,0.249159907987896,134837.0086775519,3441.510626922341,138278.51930447423,3713,6,682.8571428571429,33,2,16,30.295845624385446,0.6751893939393939,40.349264705882355,1038.6029411764707,31.47281639928699,0
3752,4,0,0,35,0.0,0.0,1.0,35,900,500,400,0.5555555555555556,13,5,8,386.28265988217083,0.780952380952381,0.11342961627260317,0.24901278386472706,134900.65607278442,3421.956849529014,138322.61292231342,3714,7,683.8571428571429,33,2,17,30.25576560103808,0.6758207070707072,40.287990196078425,1038.8480392156857,31.48024361259654,0
3753,4,0,0,35,0.0,0.0,1.0,35,700,500,200,0.7142857142857143,9,5,4,383.40757677741425,0.780392156862745,0.10779573062861192,0.2475942759707308,134964.31848627928,3349.268460447904,138313.58694672718,3715,8,684.8571428571429,33,2,17,30.266811141250937,0.6764520202020202,40.22671568627451,1039.0931372549019,31.487670825906118,0
3754,4,0,0,35,0.0,0.0,1.0,35,600,200,400,0.3333333333333333,10,2,8,381.46054044718824,0.780252100840336,0.11018242457931193,0.24677092628013747,135027.9959180363,3301.5704596789665,138329.56637771527,3716,9,685.8571428571429,33,2,17,30.25377805290257,0.6770833333333334,40.16544117647059,1039.3382352941173,31.495098039215677,0
3755,4,0,0,35,0.0,0.0,1.0,35,1000,800,200,0.8,12,8,4,383.55668726641227,0.7799019607843136,0.11495243707382752,0.24900371013431602,135155.39583633706,3367.9511786332264,138523.3470149703,3717,10,686.8571428571429,33,2,17,30.072063445295612,0.6783459595959596,40.04289215686275,1039.8284313725496,31.509952465834836,0
3756,4,0,0,35,0.0,0.0,1.0,35,950,700,250,0.7368421052631579,12,7,5,380.0391881445155,0.7808123249299719,0.10873230903858788,0.2475942185847117,135282.85582768652,3282.557339725109,138565.41316741164,3718,11,687.8571428571429,33,2,18,30.03629697255272,0.6796085858585859,39.9203431372549,1040.3186274509808,31.524806892453963,0
3757,4,0,0,35,0.0,0.0,1.0,35,600,400,200,0.6666666666666666,8,4,4,381.1506171667157,0.7796218487394957,0.11230738173743426,0.24897931084459587,135378.49024413683,3319.919021530181,138698.40926566703,3719,12,688.8571428571429,33,2,18,29.911975977390505,0.6805555555555556,39.82843137254902,1040.6862745098035,31.535947712418288,0
3758,4,0,0,35,0.0,0.0,1.0,35,950,900,50,0.9473684210526315,10,9,1,382.4934585694383,0.7789915966386554,0.1163373412931974,0.2505228936428203,135474.15845167724,3363.5958825932303,138837.75433427046,3720,13,689.8571428571429,33,2,18,29.78161173239159,0.6815025252525253,39.736519607843135,1041.0539215686276,31.547088532382656,0
3759,4,0,0,35,0.0,0.0,1.0,35,650,300,350,0.46153846153846156,10,3,7,381.20426278981176,0.7773809523809523,0.11231527093596028,0.2501229823108132,135537.9560295319,3333.529321655127,138871.48535118703,3721,14,690.8571428571429,33,2,19,29.751554470205154,0.6821338383838385,39.67524509803921,1041.299019607843,31.554515745692214,0
3760,4,0,0,35,0.0,0.0,1.0,35,1300,1000,300,0.7692307692307693,16,10,6,382.35224400691504,0.7777310924369747,0.11364713395062753,0.25177199274227624,135665.59624002784,3374.4090313821494,139040.00527141,3722,15,691.8571428571429,33,2,19,29.594434968435078,0.6833964646464648,39.55269607843137,1041.7892156862742,31.56937017231134,0
3761,4,0,0,35,0.0,0.0,1.0,35,900,600,300,0.6666666666666666,12,6,6,383.11006762132416,0.7750700280112044,0.10876226313667536,0.2529478272555699,135761.36582083817,3402.3092079969247,139163.6750288351,3723,16,692.8571428571429,33,2,19,29.479264659767953,0.6843434343434343,39.46078431372549,1042.1568627450981,31.580510992275702,0
3762,4,0,0,35,0.0,0.0,1.0,35,1000,800,200,0.8,12,8,4,381.86283199603747,0.7733893557422968,0.10342407093318129,0.25280210986694873,135857.16919273834,3375.760674980774,139232.9298677191,3724,17,693.8571428571429,33,2,19,29.416338505544452,0.685290404040404,39.368872549019606,1042.5245098039213,31.59165181224004,0
3763,4,0,0,35,0.0,0.0,1.0,35,950,800,150,0.8421052631578947,11,8,3,381.8072606914378,0.7738795518207282,0.10402551619942924,0.2534461613482166,135953.00635572866,3381.5689878892817,139334.57534361794,3725,18,694.8571428571429,33,2,16,29.322365844104983,0.6862373737373737,39.27696078431373,1042.8921568627457,31.602792632204412,0
3764,4,0,0,35,0.0,0.0,1.0,35,800,500,300,0.625,11,5,6,380.06962465308095,0.7744397759103641,0.10690876139014294,0.2529736289813666,136048.87730980874,3341.6091467224196,139390.48645653116,3726,19,695.8571428571429,33,2,16,29.272264967304906,0.6871843434343434,39.185049019607845,1043.2598039215688,31.61393345216875,0
3765,4,0,0,35,0.0,0.0,1.0,35,850,500,350,0.5882352941176471,12,5,7,379.52266680727655,0.7744397759103641,0.09838287593102102,0.2532927139914392,136144.78205497874,3334.0061514801864,139478.78820645894,3727,20,696.8571428571429,33,2,16,29.19113042116799,0.6881313131313131,39.093137254901954,1043.6274509803911,31.625074272133066,0
3766,4,0,0,35,0.0,0.0,1.0,35,750,400,350,0.5333333333333333,11,4,7,377.5169205099197,0.7734593837535013,0.0957434676147988,0.2524088798197409,136208.7373245868,3284.2206122645275,139492.95793685134,3728,21,697.8571428571429,33,2,16,29.17987399232997,0.6887626262626263,39.031862745098046,1043.8725490196089,31.632501485442692,0
3767,4,0,0,35,0.0,0.0,1.0,35,1050,600,450,0.5714285714285714,15,6,9,376.19078187867837,0.7718487394957982,0.09497879189229974,0.25220469334289675,136304.69838824007,3255.3142120818875,139560.01260032196,3729,22,698.8571428571429,33,2,17,29.119112584594923,0.689709595959596,38.939950980392155,1044.2401960784312,31.643642305407006,0
3768,4,0,0,35,0.0,0.0,1.0,35,350,100,250,0.2857142857142857,6,1,5,376.19078187867837,0.7718487394957982,0.09497879189229974,0.25220469334289675,136304.69838824007,3255.3142120818875,139560.01260032196,3730,23,699.8571428571429,33,2,17,29.119112584594923,0.689709595959596,38.939950980392155,1044.2401960784312,31.643642305407006,0
3769,4,0,0,35,0.0,0.0,1.0,35,1150,900,250,0.782608695652174,14,9,5,379.3254407536028,0.7712184873949579,0.09618522675869956,0.25569233464869323,136496.7218888167,3355.335838379458,139852.05772719617,3731,24,700.8571428571429,33,2,17,28.8464827410969,0.6916035353535354,38.75612745098039,1044.9754901960778,31.66592394533569,0
3770,4,0,0,35,0.0,0.0,1.0,35,1300,800,500,0.6153846153846154,18,8,10,381.87158212721386,0.7700980392156862,0.09451013230614613,0.2581112991715637,136592.7843257401,3432.1805315263364,140024.96485726643,3732,25,701.8571428571429,33,2,18,28.684544744040647,0.6925505050505051,38.66421568627451,1045.343137254902,31.677064765300063,0
3771,4,0,0,35,0.0,0.0,1.0,35,850,400,450,0.47058823529411764,13,4,9,381.78728809717296,0.7696778711484593,0.09761765247526455,0.25876020090017293,136688.88055375335,3437.215403931177,140126.09595768453,3733,26,702.8571428571429,33,2,19,28.591326809641004,0.6934974747474747,38.572303921568626,1045.7107843137253,31.688205585264402,0
3772,4,0,0,35,0.0,0.0,1.0,35,750,500,250,0.6666666666666666,10,5,5,381.6165549249927,0.7698879551820728,0.09685366180211585,0.2593534166273677,136785.01057285664,3439.8849000384544,140224.8954728951,3734,27,703.8571428571429,33,2,20,28.50037097781944,0.6944444444444444,38.48039215686275,1046.0784313725494,31.69934640522877,0
3773,4,0,0,35,0.0,0.0,1.0,35,1500,1100,400,0.7333333333333333,19,11,8,382.205792825058,0.7680672268907562,0.0940916694546674,0.26070586826884945,136913.23649557852,3465.8064206074464,140379.04291618595,3735,28,704.8571428571429,33,2,20,28.357728337236534,0.6957070707070707,38.357843137254896,1046.5686274509796,31.71420083184787,0
3774,4,0,0,35,0.0,0.0,1.0,35,1050,800,250,0.7619047619047619,13,8,5,383.12064891715323,0.76687675070028,0.09501964390203166,0.2625313508417862,137073.60337670607,3503.1455750192204,140576.74895172528,3736,29,705.8571428571429,33,2,18,28.1747366881217,0.6972853535353536,38.2046568627451,1047.1813725490194,31.732768865121802,0
3775,4,0,0,35,0.0,0.0,1.0,35,850,500,350,0.5882352941176471,12,5,7,385.76836270895274,0.7654061624649859,0.1031218664349225,0.2650762029289489,137169.86856016898,3583.1591214917116,140753.0276816607,3737,30,706.8571428571429,33,2,18,28.009963344252064,0.6982323232323233,38.112745098039206,1047.5490196078417,31.743909685086113,0
3776,4,0,0,35,0.0,0.0,1.0,35,1200,800,400,0.6666666666666666,16,8,8,387.15663205167124,0.7653361344537815,0.10285981558198598,0.2670131868795073,137298.2747020376,3631.187524029208,140929.4622260668,3738,31,707.8571428571429,33,2,18,27.846312753352038,0.6994949494949496,37.99019607843137,1048.039215686274,31.758764111705272,0
3777,4,0,0,35,0.0,0.0,1.0,35,800,400,400,0.5,12,4,8,387.15663205167124,0.7653361344537815,0.10285981558198598,0.2670131868795073,137298.2747020376,3631.187524029208,140929.4622260668,3739,32,708.8571428571429,33,2,18,27.846312753352038,0.6994949494949496,37.99019607843137,1048.039215686274,31.758764111705272,0
3778,4,0,0,35,0.0,0.0,1.0,35,550,400,150,0.7272727272727273,7,4,3,387.0023986032919,0.7638655462184873,0.1040916530278233,0.26740052646628115,137362.50030036527,3631.923418877357,140994.42371924262,3740,33,709.8571428571429,33,2,18,27.786707972878187,0.7001262626262627,37.92892156862745,1048.2843137254904,31.76619132501486,0
3779,4,0,0,35,0.0,0.0,1.0,35,700,500,200,0.7142857142857143,9,5,4,389.06767258678445,0.7635154061624649,0.10923053807242211,0.2695750667469728,137458.8668570982,3696.1602809015744,141155.02713799977,3741,34,710.8571428571429,33,2,18,27.63709536052354,0.7010732323232324,37.83700980392157,1048.6519607843136,31.777332144979198,0
3780,4,0,0,35,0.0,0.0,1.0,35,950,800,150,0.8421052631578947,11,8,3,389.7638763183287,0.763235294117647,0.11204913791664595,0.2705587199844749,137523.1300010813,3720.309646530176,141243.43964761146,3742,35,711.8571428571429,33,2,18,27.55518070646881,0.7017045454545454,37.775735294117645,1048.8970588235293,31.784759358288767,0
3781,4,0,0,35,0.0,0.0,1.0,35,650,500,150,0.7692307692307693,8,5,3,389.47373762622175,0.7622549019607843,0.11219007574999118,0.27111171882566754,137619.55287629753,3719.840325836209,141339.39320213374,3743,36,712.8571428571429,33,2,18,27.467297360429786,0.7026515151515151,37.68382352941176,1049.2647058823527,31.795900178253113,0
3782,4,0,0,35,0.0,0.0,1.0,35,1000,700,300,0.7,13,7,6,387.2559427880562,0.761344537815126,0.11359837173220377,0.26981876632173524,137651.70134383414,3661.287876057292,141312.98921989143,3744,37,713.8571428571429,33,2,18,27.493650005839086,0.7029671717171717,37.65318627450981,1049.3872549019611,31.799613784907912,0
3783,4,0,0,35,0.0,0.0,1.0,35,850,600,250,0.7058823529411765,11,6,5,385.6600989423592,0.761484593837535,0.1129645692933876,0.26895709180312416,137683.8535659362,3619.833717800851,141303.68728373706,3745,38,714.8571428571429,33,2,18,27.503697649073647,0.7032828282828283,37.622549019607845,1049.5098039215688,31.803327391562693,0
3784,4,0,0,35,0.0,0.0,1.0,35,700,400,300,0.5714285714285714,10,4,6,385.26879211797797,0.7610644257703081,0.1143140554423876,0.26995593470299695,137846.68180677635,3621.725065531259,141468.40687230762,3746,39,715.8571428571429,31,4,18,27.35288799338707,0.710013440860215,37.46744791666667,1050.1302083333342,33.875168010752716,0
3785,4,0,0,35,0.0,0.0,1.0,35,600,200,400,0.3333333333333333,10,2,8,385.7453034997016,0.7612745098039215,0.11301067842533064,0.2708274467651953,137915.05813598633,3640.0171915690107,141555.07532755533,3747,40,716.8571428571429,31,4,18,27.272762489153337,0.7106854838709677,37.40234375,1050.390625,33.883568548387096,0
3786,4,0,0,35,0.0,0.0,1.0,35,1150,900,250,0.782608695652174,14,9,5,387.518369563667,0.7602941176470588,0.11810892613767043,0.2731581450435247,138051.8616570368,3699.52646891277,141751.38812594957,3748,41,717.8571428571429,31,4,18,27.09094804443892,0.7120295698924731,37.27213541666667,1050.9114583333342,33.90036962365594,0
3787,4,0,0,35,0.0,0.0,1.0,35,600,300,300,0.5,9,3,6,379.2104926524413,0.7602941176470588,0.11115266056900297,0.24531534616211711,135027.99591803632,3240.8065707900782,138268.8024888264,3749,42,718.8571428571429,33,2,17,30.312242070510543,0.6770833333333334,40.16544117647059,1039.3382352941176,31.495098039215684,5
3788,4,0,0,35,0.0,0.0,1.0,35,750,500,250,0.6666666666666666,10,5,5,382.24057814484433,0.7600140056022409,0.11483814464243625,0.2474934796812648,135059.84026576314,3325.070285467125,138384.91055123025,3750,43,719.8571428571429,33,2,17,30.201701642694324,0.6773989898989898,40.134803921568626,1039.4607843137253,31.498811645870465,0
3789,4,0,0,35,0.0,0.0,1.0,35,650,400,250,0.6153846153846154,9,4,5,383.9743615487488,0.7598739495798319,0.11714858288004604,0.24883533300366967,135091.6883680555,3374.348958333328,138466.03732638882,3751,44,720.8571428571429,33,2,17,30.12483299933199,0.6777146464646465,40.104166666666664,1039.583333333333,31.502525252525242,0
3790,4,0,0,35,0.0,0.0,1.0,35,1000,700,300,0.7,13,7,6,382.8243540780397,0.7606442577030812,0.1174919435311057,0.24819636853478247,135107.15880102036,3344.462159863948,138451.6209608843,3752,45,721.8571428571429,34,1,17,30.139270582846677,0.6755514705882353,40.089285714285715,1039.6428571428569,30.577731092436967,0
3791,4,0,0,35,0.0,0.0,1.0,35,950,700,250,0.7368421052631579,12,7,5,385.2702785996058,0.7602941176470588,0.11657509157509227,0.25042568108974356,135199.99999999985,3417.708333333319,138617.70833333317,3753,46,722.8571428571429,34,1,18,29.98297275641026,0.6764705882352942,39.99999999999999,1039.9999999999989,30.588235294117613,0
3792,4,0,1,34,0.0,0.02857142857142857,0.9714285714285714,35,1150,1000,150,0.8695652173913043,13,10,3,389.23193535335645,0.7597338935574229,0.11817631961813224,0.2536538316967174,135292.8730867346,3532.0613662131354,138824.93445294772,3754,47,723.8571428571429,34,1,18,29.787208681389924,0.677389705882353,39.91071428571428,1040.357142857142,30.598739495798295,0
3793,4,0,0,34,0.0,0.0,1.0,34,1100,700,400,0.6363636363636364,15,7,8,389.51450712993255,0.7551247771836007,0.1163276331373242,0.2546687227909557,135410.37589208462,3748.8611651768388,139159.23705726146,3755,48,738.0,33,1,18,29.662540719808476,0.6808712121212122,39.79779411764705,1040.8088235294106,31.539661319073048,0
3794,4,0,0,34,0.0,0.0,1.0,34,900,800,100,0.8888888888888888,10,8,2,387.93986422093013,0.7548276886512181,0.11539313783194305,0.25409014237137995,135474.15845167704,3711.165327037659,139185.3237787147,3756,49,739.0,33,1,18,29.639861683343145,0.6815025252525253,39.73651960784313,1041.053921568626,31.547088532382606,0
3795,4,0,0,34,0.0,0.0,1.0,34,600,400,200,0.6666666666666666,8,4,4,388.839583170579,0.7546791443850268,0.11752593730750394,0.25558759608404846,135601.7686256486,3745.4670379180857,139347.23566356668,3757,50,740.0,33,1,19,29.48913107424402,0.6827651515151516,39.61397058823528,1041.5441176470574,31.56194295900174,0
3796,4,0,0,34,0.0,0.0,1.0,34,500,400,100,0.8,6,4,2,394.97180817672734,0.7541221033868093,0.09030781856369874,0.2504251539399372,134296.61218041147,3808.6751489811704,138105.28732939262,3758,51,741.0,33,1,16,30.635197446204774,0.6698232323232323,40.87009803921569,1036.519607843138,31.409685086155694,2
3797,4,0,0,34,0.0,0.0,1.0,34,950,700,250,0.7368421052631579,12,7,5,390.2178163995464,0.7534536541889484,0.08702573442518147,0.248272418223531,134423.6666786813,3690.901936755099,138114.5686154364,3759,52,742.0,33,1,16,30.63105648782794,0.6710858585858586,40.747549019607845,1037.0098039215688,31.424539512774814,0
3798,4,0,0,34,0.0,0.0,1.0,34,1050,800,250,0.7619047619047619,13,8,5,389.18727117304525,0.7540478312537137,0.08988896763524679,0.2484811039027907,134550.78125000015,3673.0902777777933,138223.87152777793,3760,53,743.0,33,1,16,30.530455153949127,0.6723484848484848,40.62500000000001,1037.5000000000011,31.439393939393973,0
3799,4,0,0,34,0.0,0.0,1.0,34,950,700,250,0.7368421052631579,12,7,5,363.724839821063,0.7540478312537137,0.0691630821480449,0.21640208177572517,131925.46323829758,2796.9135969338504,134722.37683523144,3761,54,744.0,33,1,18,33.82627042824765,0.64614898989899,43.167892156862735,1027.3284313725476,31.131164587046896,7
3800,4,0,0,34,0.0,0.0,1.0,34,1100,800,300,0.7272727272727273,14,8,6,362.32813459016455,0.7528223410576352,0.05859911918987959,0.21646783425514932,132082.88278546702,2771.4689061899157,134854.35169165695,3762,55,745.0,33,1,20,33.70340565887777,0.6477272727272728,43.014705882352935,1027.9411764705874,31.14973262032083,0
3801,4,0,0,34,0.0,0.0,1.0,34,1400,1200,200,0.8571428571428571,16,12,4,365.60923655564557,0.752450980392157,0.06591977908761515,0.21933940832105317,132240.39619677523,2869.6620590638186,135110.05825583905,3763,56,746.0,33,1,20,33.46029925731761,0.6493055555555556,42.861519607843135,1028.5539215686272,31.168300653594763,0
3802,4,0,0,34,0.0,0.0,1.0,34,750,500,250,0.6666666666666666,10,5,5,365.0127827158246,0.7523767082590612,0.06379497600112138,0.21934733793123434,132303.4278432572,2858.48847198191,135161.91631523913,3764,57,747.0,33,1,20,33.41212527297995,0.6499368686868687,42.800245098039206,1028.7990196078417,31.175727866904296,0
3803,4,0,0,34,0.0,0.0,1.0,34,800,700,100,0.875,9,7,2,364.3771446810889,0.7513368983957219,0.07000749567422604,0.21933153289513282,132366.47450800164,2846.2636065455513,135212.7381145472,3765,58,748.0,33,1,20,33.364966654757666,0.6505681818181819,42.73897058823529,1029.044117647058,31.183155080213883,0
3804,4,0,0,34,0.0,0.0,1.0,34,650,400,250,0.6153846153846154,9,4,5,363.7023786317835,0.7523024361259656,0.07288332644642614,0.21929190797762727,132429.53619100817,2832.9874627546997,135262.52365376288,3766,59,749.0,33,1,20,33.31882267730285,0.651199494949495,42.67769607843137,1029.2892156862738,31.19058229352345,0
3805,4,0,0,34,0.0,0.0,1.0,34,700,500,200,0.7142857142857143,9,5,4,363.3161270656061,0.7514854426619133,0.07266291828003668,0.2194262245491126,132492.61289227704,2827.340596164938,135319.95348844197,3767,60,750.0,33,1,20,33.26526108003015,0.6518308080808082,42.61642156862745,1029.5343137254904,31.198009506833042,0
3806,4,0,0,34,0.0,0.0,1.0,34,1300,800,500,0.6153846153846154,18,8,10,363.08024634779815,0.7499628639334522,0.06460790145921558,0.2200208702633916,132618.81134960108,2830.2541390330616,135449.06548863414,3768,61,751.0,33,1,20,33.14433372992266,0.6530934343434345,42.493872549019606,1030.0245098039213,31.212863933452162,0
3807,4,1,1,34,0.02857142857142857,0.02857142857142857,0.9714285714285714,35,350,200,150,0.5714285714285714,5,2,3,354.4771851998049,0.759313725490196,0.057928167224853055,0.2160040778779105,132827.17013888873,2416.8402777777583,135244.01041666648,3769,0,730.5142857142857,34,1,16,33.15649420641338,0.6528799019607844,42.29166666666666,1030.833333333332,30.31862745098035,0
3808,4,0,0,34,0.0,0.0,1.0,34,550,300,250,0.5454545454545454,8,3,5,362.3592959658022,0.7492201426024956,0.0632200793267721,0.22032388429330657,132745.06987997398,2820.282012927713,135565.3518929017,3770,63,753.0,33,1,16,33.035908946763385,0.6543560606060606,42.37132352941176,1030.5147058823525,31.227718360071286,0
3809,4,0,0,34,0.0,0.0,1.0,34,950,800,150,0.8421052631578947,11,8,3,363.2784256196547,0.7485888294711824,0.06956892574001317,0.22181601401769047,132902.97752066512,2856.156886774319,135759.13440743944,3771,64,754.0,33,1,16,32.85347832976784,0.6559343434343434,42.21813725490196,1031.1274509803923,31.24628639334522,0
3810,4,0,0,34,0.0,0.0,1.0,34,1000,700,300,0.7,13,7,6,363.18163552391815,0.7488116458704694,0.07411988316352924,0.22250822473364917,133029.3712153978,2862.764922145311,135892.13613754313,3772,65,755.0,33,1,16,32.72897362794012,0.6571969696969697,42.09558823529411,1031.6176470588225,31.261140819964318,0
3811,4,0,0,34,0.0,0.0,1.0,34,850,600,250,0.7058823529411765,11,6,5,365.03066446251154,0.7485888294711824,0.07176191141539756,0.22402027658705143,133092.5905901576,2916.5753556324444,136009.16594579004,3773,66,756.0,33,1,16,32.61777513855899,0.6578282828282829,42.03431372549019,1031.8627450980389,31.268568033273905,0
3812,4,0,0,34,0.0,0.0,1.0,34,1350,1200,150,0.8888888888888888,15,12,3,366.0527080453293,0.7474376114081996,0.07263745854424863,0.22560307719692013,133250.70473195397,2955.35626321606,136206.06099517003,3774,67,757.0,33,1,17,32.43261622156281,0.6594065656565657,41.88112745098039,1032.4754901960778,31.287136066547813,0
3813,4,0,0,34,0.0,0.0,1.0,34,1150,900,250,0.782608695652174,14,9,5,362.5921704443987,0.7452094474153298,0.06675992660140828,0.22461532615846608,133440.56560277293,2876.900861447517,136317.46646422043,3775,68,758.0,33,1,19,32.331450401296806,0.661300505050505,41.697303921568626,1033.210784313725,31.309417706476516,0
3814,4,0,0,34,0.0,0.0,1.0,34,950,600,350,0.631578947368421,13,6,7,363.334240806955,0.7437982768865122,0.06989869552182637,0.22623254536444867,133630.56163795176,2910.5117322664405,136541.0733702182,3776,69,759.0,33,1,20,32.1217800561021,0.6631944444444444,41.513480392156865,1033.9460784313726,31.33169934640523,0
3815,4,0,0,34,0.0,0.0,1.0,34,1000,700,300,0.7,13,7,6,365.45027115191084,0.7437982768865122,0.0684950126513455,0.22794049063200136,133693.9236862026,2971.6961324971335,136665.61981869972,3777,70,760.0,33,1,20,32.00356973575068,0.6638257575757576,41.45220588235295,1034.1911764705894,31.33912655971483,0
3816,4,1,1,34,0.02857142857142857,0.02857142857142857,0.9714285714285714,35,1200,900,300,0.75,15,9,6,348.099734015833,0.7523109243697479,0.06961613104832098,0.21690059466725423,133656.80980725616,2305.1799886621225,135961.98979591829,3778,0,739.2571428571429,34,1,20,32.48930270934071,0.6611519607843137,41.488095238095234,1034.0476190476184,30.41316526610642,1
3817,4,0,0,34,0.0,0.0,1.0,34,850,500,350,0.5882352941176471,12,5,7,357.35239056009317,0.7427213309566251,0.07650267506504571,0.22174780791709067,133503.88259623686,2741.586318963839,136245.4689152007,3779,72,762.0,33,1,20,32.403331159334364,0.6619318181818183,41.636029411764696,1033.4558823529399,31.316844919786057,0
3818,4,0,0,34,0.0,0.0,1.0,34,700,500,200,0.7142857142857143,9,5,4,356.9947830773385,0.7432783719548426,0.0747325252130735,0.22171531667704503,133535.54672481728,2734.2987072279816,136269.84543204526,3780,73,763.0,33,1,21,32.380839459331284,0.6622474747474747,41.60539215686274,1033.5784313725483,31.320558526440855,0
3819,4,0,0,34,0.0,0.0,1.0,34,800,500,300,0.625,11,5,6,358.84952857326914,0.7441696375519905,0.07119348450617835,0.22324886600620175,133598.88624567463,2788.3794694348235,136387.26571510945,3781,74,764.0,33,1,21,32.2694404931247,0.662878787878788,41.54411764705882,1033.823529411764,31.327985739750424,0
3820,4,0,0,34,0.0,0.0,1.0,34,800,600,200,0.75,10,6,4,355.6198198602908,0.7436497326203209,0.07146640646780056,0.22199935500154236,133725.61034217596,2711.0954921184025,136436.70583429438,3782,75,765.0,33,1,15,32.22600710900474,0.6641414141414143,41.421568627450974,1034.313725490195,31.342840166369548,0
3821,4,0,0,34,0.0,0.0,1.0,34,700,500,200,0.7142857142857143,9,5,4,359.04841684429823,0.74298128342246,0.07221277900075229,0.22491133767309002,133852.39451172625,2811.8980680507457,136664.292579777,3783,76,766.0,33,1,15,32.010401863255964,0.6654040404040404,41.299019607843135,1034.8039215686274,31.357694592988707,0
3822,4,0,0,34,0.0,0.0,1.0,34,800,600,200,0.75,10,6,4,357.9481775998137,0.7419414735591207,0.07448868028328848,0.22480210083164517,133947.5220618273,2789.2542832083896,136736.7763450357,3784,77,767.0,33,1,17,31.943663430803827,0.6663510101010102,41.20710784313726,1035.1715686274517,31.368835412953082,0
3823,4,0,0,34,0.0,0.0,1.0,34,600,400,200,0.6666666666666666,8,4,4,358.8281285081065,0.7419414735591207,0.07404971218164214,0.22613396823430346,134074.41135921286,2821.9340217704757,136896.34538098334,3785,78,768.0,33,1,18,31.793944503609033,0.6676136363636364,41.08455882352941,1035.6617647058827,31.383689839572202,0
3824,4,0,0,34,0.0,0.0,1.0,34,900,800,100,0.8888888888888888,10,8,2,358.6187773656375,0.7427956030897208,0.07204699201024489,0.2261974556936096,134106.14306997307,2818.596212995004,136924.73928296808,3786,79,769.0,33,1,19,31.767628963558934,0.6679292929292929,41.05392156862745,1035.7843137254902,31.387403446226976,0
3825,4,0,0,34,0.0,0.0,1.0,34,1350,900,450,0.6666666666666666,18,9,9,358.57933659989357,0.7432783719548426,0.06769749886944743,0.22676053036290944,134201.36072964725,2824.3669802479794,137025.72770989523,3787,80,770.0,33,1,20,31.673442736053612,0.6688762626262627,40.96200980392157,1036.1519607843136,31.398544266191323,0
3826,4,0,0,34,0.0,0.0,1.0,34,850,500,350,0.5882352941176471,12,5,7,356.91810718217846,0.7436868686868687,0.06455291336392732,0.22669123023732948,134360.13192041515,2791.1127931564706,137151.24471357162,3788,81,771.0,33,1,21,31.557821118991328,0.6704545454545454,40.80882352941176,1036.7647058823525,31.417112299465227,0
3827,4,0,0,34,0.0,0.0,1.0,34,700,300,400,0.42857142857142855,11,3,8,359.550380133335,0.7423871063576947,0.06682722716878309,0.2289597341661711,134455.4396896626,2868.700890282573,137324.14057994517,3789,82,772.0,33,1,21,31.394378470991366,0.6714015151515152,40.71691176470588,1037.1323529411761,31.42825311942958,0
3828,4,0,0,34,0.0,0.0,1.0,34,300,200,100,0.6666666666666666,4,2,2,359.989853555023,0.7423871063576947,0.05998447452505218,0.23411753924302525,135219.11832288056,2935.5021205786143,138154.62044345916,3790,83,773.0,33,1,20,30.621219708573896,0.6789772727272728,39.98161764705882,1040.0735294117642,31.51737967914437,2
3829,4,0,0,34,0.0,0.0,1.0,34,950,700,250,0.7368421052631579,12,7,5,359.62523919657707,0.7422385620915033,0.054372449721850735,0.2347100619537384,135346.60835075454,2934.81128051711,138281.41963127165,3791,84,774.0,33,1,20,30.50374416048365,0.680239898989899,39.85906862745098,1040.5637254901962,31.53223410576352,0
3830,4,0,1,33,0.0,0.029411764705882353,0.9705882352941176,34,1200,1000,200,0.8333333333333334,14,10,4,355.5818071150118,0.7430555555555556,0.05088460339992418,0.23289648816052624,135474.15845167718,2834.4292159265633,138308.58766760374,3792,85,775.0,33,1,21,30.482023739454593,0.6815025252525253,39.736519607843135,1041.0539215686272,31.54708853238264,0
3831,4,1,0,34,0.029411764705882353,0.0,1.0,34,1200,1100,100,0.9166666666666666,13,11,2,358.0379653501881,0.7490715983363042,0.052592428572417305,0.23576148283826076,135665.59624002778,2914.686809159928,138580.2830491877,3793,0,748.1470588235294,33,1,22,30.227693800729323,0.6833964646464648,39.55269607843137,1041.7892156862738,31.569370172311327,0
3832,4,0,0,34,0.0,0.0,1.0,34,1100,900,200,0.8181818181818182,13,9,4,357.53414474202424,0.7505199049316696,0.05248741076863528,0.23606136388867785,135761.365820838,2907.8647635524662,138669.23058439046,3794,1,749.1470588235294,33,1,22,30.145617748510517,0.6843434343434345,39.46078431372548,1042.1568627450968,31.58051099227566,0
3833,4,0,0,34,0.0,0.0,1.0,34,850,500,350,0.5882352941176471,12,5,7,357.15383005214926,0.750891265597148,0.056500456317929215,0.23665613598782603,135889.11115916955,2906.6633025759297,138795.7744617455,3795,2,750.1470588235294,33,1,17,30.02860053283184,0.6856060606060606,39.338235294117645,1042.6470588235293,31.595365418894826,0
3834,4,0,0,34,0.0,0.0,1.0,34,800,600,200,0.75,10,6,4,357.15383005214926,0.750891265597148,0.056500456317929215,0.23665613598782603,135889.11115916955,2906.6633025759297,138795.7744617455,3796,3,751.1470588235294,33,1,17,30.02860053283184,0.6856060606060606,39.338235294117645,1042.6470588235293,31.595365418894826,0
3835,4,0,0,34,0.0,0.0,1.0,34,850,500,350,0.5882352941176471,12,5,7,358.0441856600016,0.7510769459298872,0.05944901753440157,0.23788556316567308,135984.95958585636,2937.7248233852292,138922.68440924157,3797,4,752.1470588235294,33,1,17,29.91018975443543,0.6865530303030303,39.24632352941176,1043.0147058823527,31.606506238859172,0
3836,4,0,2,32,0.0,0.058823529411764705,0.9411764705882353,34,950,700,250,0.7368421052631579,12,7,5,360.901024719253,0.7496657754010696,0.056409105039549434,0.24064778586409077,136112.8100520233,3024.650525038449,139137.46057706175,3798,5,753.1470588235294,33,1,18,29.708724799373645,0.6878156565656566,39.12377450980392,1043.5049019607845,31.62136066547832,0
3837,4,0,0,32,0.0,0.0,1.0,32,800,700,100,0.875,9,7,2,372.77525585963315,0.7312668010752689,0.0698814133591481,0.24843667051806512,136094.4036322824,3746.5252270176447,139840.92885930004,3799,92,787.71875,32,0,18,29.417251532752502,0.6901041666666667,39.14141414141414,1043.4343434343432,32.607323232323225,0
3838,4,0,0,32,0.0,0.0,1.0,32,650,200,450,0.3076923076923077,11,2,9,373.5230749137279,0.7305947580645162,0.07435579482216337,0.24939755551186396,136160.28498367514,3771.8016656463683,139932.0866493215,3800,93,788.71875,32,0,19,29.33225461730785,0.6907552083333334,39.07828282828283,1043.6868686868688,32.61521464646465,0
3839,4,0,0,32,0.0,0.0,1.0,32,750,500,250,0.6666666666666666,10,5,5,373.5230749137279,0.7305947580645162,0.07435579482216337,0.24939755551186396,136160.28498367514,3771.8016656463683,139932.0866493215,3801,94,789.71875,32,0,19,29.33225461730785,0.6907552083333334,39.07828282828283,1043.6868686868688,32.61521464646465,0
3840,4,0,0,32,0.0,0.0,1.0,32,800,700,100,0.875,9,7,2,373.304831349453,0.7280745967741936,0.06933192261185028,0.2501807905397064,136292.09551321302,3775.6995459647096,140067.79505917773,3802,95,790.71875,32,0,19,29.20697299476017,0.6920572916666666,38.95202020202021,1044.1919191919199,32.630997474747495,0
3841,4,1,1,32,0.030303030303030304,0.030303030303030304,0.9696969696969697,33,500,300,200,0.6,7,3,4,364.07740970768623,0.7355587121212122,0.058701907705424494,0.24608401781351552,136592.7843257402,3346.0694204152396,139938.85374615545,3803,0,767.7272727272727,33,0,19,29.149570144587738,0.692550505050505,38.66421568627452,1045.343137254903,31.67706476530009,0
3842,4,0,0,32,0.0,0.0,1.0,32,900,700,200,0.7777777777777778,11,7,4,371.88510407378504,0.7271505376344086,0.06330050749154181,0.25062875580738164,136489.93087440068,3751.714429650052,140241.64530405073,3804,97,792.71875,32,0,20,29.04759747059771,0.6940104166666666,38.76262626262627,1044.9494949494958,32.654671717171745,0
3843,4,0,0,32,0.0,0.0,1.0,32,1000,700,300,0.7,13,7,6,371.5894770006302,0.7251344086021506,0.0667572463768118,0.25136935208866157,136621.90082644636,3753.452134986234,140375.3529614326,3805,98,793.71875,32,0,20,28.924365942028995,0.6953125,38.63636363636364,1045.454545454546,32.67045454545456,0
3844,4,0,0,32,0.0,0.0,1.0,32,450,300,150,0.6666666666666666,6,3,3,372.76127652482353,0.7259324596774194,0.06886622992392222,0.2523987024449767,136654.90327836457,3787.931237883903,140442.83451624846,3806,99,794.71875,32,0,20,28.860997061546506,0.6956380208333333,38.604797979797986,1045.580808080809,32.67440025252528,0
3845,4,0,1,31,0.0,0.03125,0.96875,32,550,300,250,0.5454545454545454,8,3,5,371.6322079042152,0.7236643145161291,0.06609459867229983,0.2525818574640214,136786.95294166406,3766.8874668401104,140553.84040850415,3807,100,795.71875,32,0,20,28.759555421444386,0.6969401041666667,38.47853535353535,1046.085858585858,32.69018308080806,0
3846,4,0,0,31,0.0,0.0,1.0,31,650,400,250,0.6153846153846154,9,4,5,379.3988060925847,0.7207885304659498,0.06375295729049912,0.2571267351670504,136686.8782043457,4171.767679850261,140858.64588419595,3808,101,803.4516129032259,31,0,20,28.65575582119287,0.6985887096774194,38.57421875,1045.703125,33.732358870967744,0
3847,4,0,0,31,0.0,0.0,1.0,31,900,400,500,0.4444444444444444,14,4,10,375.91728804559716,0.7198924731182795,0.06758373686027941,0.2555092632959668,136789.0167236328,4084.271240234376,140873.2879638672,3809,102,804.4516129032259,31,0,21,28.64544436146378,0.6995967741935485,38.4765625,1046.09375,33.74495967741935,0
3848,4,0,0,31,0.0,0.0,1.0,31,750,500,250,0.6666666666666666,10,5,5,370.18922496841185,0.7185483870967742,0.06806379375386284,0.252596009362996,136925.26075575082,3937.651231553814,140862.91198730463,3810,103,805.4516129032259,31,0,22,28.66021813054656,0.7009408602150538,38.346354166666664,1046.614583333333,33.76176075268816,0
3849,4,0,0,31,0.0,0.0,1.0,31,250,0,250,0.0,5,0,5,369.9218146341908,0.7173835125448028,0.07139389026881071,0.2526594280241511,136959.3323601616,3932.848951551639,140892.18131171324,3811,104,806.4516129032259,31,0,18,28.633458763527806,0.7012768817204302,38.31380208333333,1046.744791666666,33.765961021505355,0
3850,4,0,0,31,0.0,0.0,1.0,31,450,100,350,0.2222222222222222,8,1,7,369.9611395757532,0.7172939068100358,0.07112822981864864,0.2529326158324025,136993.40820312488,3936.447482638874,140929.85568576376,3812,105,807.4516129032259,31,0,18,28.598673300165842,0.7016129032258065,38.28124999999999,1046.874999999999,33.77016129032255,0
3851,4,0,0,31,0.0,0.0,1.0,31,900,600,300,0.6666666666666666,12,6,6,371.59241265128765,0.7161290322580646,0.067773222838164,0.25454396784852257,137061.57260470916,3986.2080891926976,141047.78069390185,3813,106,808.4516129032259,31,0,18,28.488456437038874,0.7022849462365592,38.21614583333333,1047.1354166666663,33.77856182795698,0
3852,4,0,0,31,0.0,0.0,1.0,31,800,600,200,0.75,10,6,4,370.93139998080903,0.7155017921146953,0.06414728215983923,0.2550866704483406,137197.95227050758,3978.2057020399,141176.1579725475,3814,107,809.4516129032259,31,0,19,28.37072251222139,0.7036290322580646,38.085937499999986,1047.6562499999982,33.79536290322575,0
3853,4,0,0,31,0.0,0.0,1.0,31,600,500,100,0.8333333333333334,7,5,2,371.17256698378316,0.7155017921146953,0.06541396780606679,0.2557531523189627,137266.16753472207,3989.887152777753,141256.05468749983,3815,108,810.4516129032259,31,0,19,28.296885354539427,0.7043010752688174,38.02083333333332,1047.9166666666654,33.80376344086017,0
3854,4,0,0,31,0.0,0.0,1.0,31,600,400,200,0.6666666666666666,8,4,4,373.4271694986068,0.7159498207885304,0.06871464512924086,0.2583192069418196,137402.64892578113,4061.9764539930406,141464.62537977417,3816,109,811.4516129032259,31,0,19,28.102748799470113,0.7056451612903227,37.89062499999999,1048.437499999999,33.820564516129004,0
3855,4,0,0,31,0.0,0.0,1.0,31,950,800,150,0.8421052631578947,11,8,3,374.0613203530509,0.7134408602150538,0.06202518972387416,0.259523164120915,137505.05447387684,4087.064446343302,141592.11892022015,3817,110,812.4516129032259,31,0,19,27.984817918477138,0.7066532258064517,37.79296874999999,1048.828124999999,33.83316532258062,0
3856,4,0,0,31,0.0,0.0,1.0,31,1000,800,200,0.8,12,8,4,374.7481581715878,0.7128136200716846,0.06200979312719501,0.2605130207410251,137573.3460320366,4111.071607801639,141684.41763983824,3818,111,813.4516129032259,31,0,19,27.89926461462083,0.7073252688172044,37.72786458333333,1049.088541666666,33.841565860215034,0
3857,4,0,0,31,0.0,0.0,1.0,31,1200,900,300,0.75,15,9,6,373.02119956406364,0.7110215053763441,0.05942527815576737,0.260082255059373,137675.81515842007,4071.1995442708244,141747.01470269088,3819,112,814.4516129032259,31,0,19,27.843258891645984,0.7083333333333335,37.63020833333333,1049.479166666666,33.85416666666665,0
3858,4,0,0,31,0.0,0.0,1.0,31,1300,1100,200,0.8461538461538461,15,11,4,371.41483352288384,0.7094086021505376,0.0665560066396016,0.26024853452320207,137846.68180677615,4039.6604749891285,141886.34228176528,3820,113,815.4516129032259,31,0,19,27.716599504029762,0.7100134408602151,37.46744791666666,1050.1302083333323,33.87516801075266,0
3859,4,0,0,31,0.0,0.0,1.0,31,1100,700,400,0.6363636363636364,15,7,8,357.21958840916284,0.7094086021505376,0.07277659777527812,0.22289043132238623,133707.78613620315,3352.6080661349597,137060.39420233812,3821,114,816.4516129032259,31,0,19,32.20248961349616,0.6690188172043012,41.43880208333332,1034.2447916666652,33.36273521505372,6
3860,4,0,0,31,0.0,0.0,1.0,31,1100,900,200,0.8181818181818182,13,9,4,358.33247852111003,0.7080645161290322,0.07379768164193301,0.22399304027145694,133775.12825859908,3387.194654676631,137162.3229132757,3822,115,817.4516129032259,31,0,20,32.10627753303962,0.6696908602150538,41.37369791666666,1034.5052083333326,33.37113575268815,0
3861,4,0,0,31,0.0,0.0,1.0,31,550,500,50,0.9090909090909091,6,5,1,356.48385857678704,0.706810035842294,0.06936275405204628,0.2232448561158175,133842.48733520487,3342.5372653537047,137185.02460055856,3823,116,818.4516129032259,31,0,20,32.086662681934484,0.6703629032258065,41.308593749999986,1034.7656249999984,33.37953629032253,0
3862,4,0,0,31,0.0,0.0,1.0,31,500,200,300,0.4,8,2,6,357.81396389060336,0.707168458781362,0.06753575661152333,0.22428275906959888,133876.17323133672,3380.5528428819266,137256.72607421866,3824,117,819.4516129032259,31,0,20,32.018537158194924,0.6706989247311829,41.27604166666666,1034.8958333333326,33.38373655913976,0
3863,4,0,0,31,0.0,0.0,1.0,31,900,500,400,0.5555555555555556,13,5,8,358.4979949113233,0.7060931899641577,0.06828923933284914,0.22532945118892722,133977.256351047,3406.115553114131,137383.37190416112,3825,118,820.4516129032259,31,0,21,31.899682429883036,0.671706989247312,41.17838541666666,1035.2864583333323,33.396337365591364,0
3864,4,0,0,31,0.0,0.0,1.0,31,1000,600,400,0.6,14,6,8,377.7199945482513,0.7060931899641577,0.11661990686604695,0.2092874377174022,129168.29639010955,3557.889641655812,132726.18603176536,3826,119,821.4516129032259,31,0,22,36.26673177917253,0.6233198924731183,45.865885416666664,1016.5364583333329,32.79149865591396,8
3865,4,1,0,32,0.03125,0.0,1.0,32,1100,700,400,0.6363636363636364,15,7,8,368.9448322969574,0.7182879704301076,0.12060879945429703,0.2064401237203586,129554.63927469133,3159.7029320987576,132714.34220679008,3827,0,796.75,32,0,18,36.09595270577533,0.6246744791666667,45.48611111111111,1018.0555555555554,31.814236111111107,0
3866,4,0,0,32,0.0,0.0,1.0,32,650,400,250,0.6153846153846154,9,4,5,367.5774444233905,0.7186239919354839,0.11392978921264718,0.20601195894889815,129618.91842987962,3128.9981570758123,132747.91658695543,3828,1,797.75,32,0,18,36.065302748501765,0.6253255208333334,45.4229797979798,1018.308080808081,31.82212752525253,0
3867,4,1,0,33,0.030303030303030304,0.0,1.0,33,750,300,450,0.4,12,3,9,359.6002315131275,0.7279040404040404,0.11018621689133612,0.20357776371783998,130012.50270328723,2750.5052143406438,132763.00791762787,3829,0,774.5454545454545,33,0,19,35.868280861972295,0.6268939393939394,45.036764705882355,1019.8529411764708,30.904634581105178,0
3868,4,1,1,33,0.029411764705882353,0.029411764705882353,0.9705882352941176,34,1200,800,400,0.6666666666666666,16,8,8,349.7901055745848,0.7395276292335117,0.09945016582300625,0.199795365387517,130359.27456382,2320.15746685159,132679.4320306716,3830,0,752.7352941176471,32,2,21,35.76672230464885,0.6328125,44.696969696969695,1021.212121212121,31.912878787878782,0
3869,4,1,1,33,0.029411764705882353,0.029411764705882353,0.9705882352941176,34,850,700,150,0.8235294117647058,10,7,3,352.66365858372666,0.740344622697564,0.099117501671949,0.2021072468314106,130488.2473727172,2403.692544128169,132891.93991684538,3831,0,753.7058823529412,32,2,17,35.5626441753172,0.6341145833333333,44.57070707070708,1021.7171717171727,31.928661616161648,0
3870,4,1,1,33,0.029411764705882353,0.029411764705882353,0.9705882352941176,34,750,400,350,0.5333333333333333,11,4,7,351.7087857408585,0.7397504456327986,0.09883137836305789,0.20189580934656107,130552.7576905419,2383.31037649221,132936.0680670341,3832,0,754.6764705882352,32,2,17,35.52168272794663,0.634765625,44.507575757575765,1021.9696969696978,31.936553030303056,0
3871,4,0,0,33,0.0,0.0,1.0,33,500,300,200,0.6,7,3,4,361.8260261658219,0.724826388888889,0.10613979179944799,0.20704049418460063,130428.79104614268,2838.5062323676357,133267.29727851032,3833,4,778.5454545454545,31,2,23,35.38891544508179,0.6360887096774193,44.62890625000001,1021.4843750000008,32.951108870967765,0
3872,4,2,2,33,0.05714285714285714,0.05714285714285714,0.9428571428571428,35,450,300,150,0.6666666666666666,6,3,3,344.30951271110473,0.7500700280112045,0.08604961505560316,0.19937478718014728,130888.84833958095,2013.2551182237614,132902.1034578047,3834,0,735.0,33,2,18,35.37075848303393,0.6357323232323232,44.17892156862745,1023.2843137254904,31.008615567439104,0
3873,4,3,2,34,0.08333333333333333,0.05555555555555555,0.9444444444444444,36,1000,700,300,0.7,13,7,6,336.10945865556226,0.764484126984127,0.09530261969286369,0.19686411149825783,131328.125,1628.125,132956.25,3835,0,715.5,34,2,20,35.13719512195122,0.6378676470588236,43.75,1025.0,30.147058823529413,0
3874,4,2,3,33,0.05555555555555555,0.08333333333333333,0.9166666666666666,36,1150,800,350,0.6956521739130435,15,8,7,334.3612800022252,0.759623015873016,0.09632252405644581,0.19646576166024335,131450.17715419497,1590.369897959181,133040.54705215414,3836,0,716.4444444444445,34,2,20,35.058964089466755,0.639093137254902,43.63095238095238,1025.4761904761904,30.161064425770306,0
3875,4,0,0,33,0.0,0.0,1.0,33,750,400,350,0.5333333333333333,11,4,7,363.30518514515506,0.7245896464646465,0.12114482268708082,0.21047809332390854,130907.84940631046,2911.900093102732,133819.74949941318,3837,2,782.3030303030303,32,1,20,34.86556652272261,0.6383463541666667,44.16035353535353,1023.3585858585849,31.979955808080778,0
3876,4,0,0,33,0.0,0.0,1.0,33,1000,600,400,0.6,14,6,8,362.88351691059495,0.7219065656565657,0.1270000145059984,0.21115979577332383,131077.01965590153,2913.1379757785403,133990.15763168008,3838,3,783.3030303030303,33,0,21,34.70510212222753,0.6376262626262627,43.995098039215684,1024.019607843137,31.030897207367786,0
3877,4,0,0,33,0.0,0.0,1.0,33,650,500,150,0.7692307692307693,8,5,3,363.2905236695094,0.7213541666666667,0.1235328032025409,0.21156926176349064,131108.39468293454,2926.0874723664056,134034.48215530094,3839,4,784.3030303030303,33,0,21,34.662932272346545,0.6379419191919191,43.96446078431373,1024.1421568627457,31.034610814022596,0
3878,4,0,0,33,0.0,0.0,1.0,33,900,500,400,0.5555555555555556,13,5,8,362.6944073253147,0.720407196969697,0.11981987861384846,0.21139469012726497,131139.77346453283,2912.732482698954,134052.50594723178,3840,5,785.3030303030303,33,0,21,34.64644651830581,0.6382575757575758,43.93382352941176,1024.2647058823527,31.038324420677355,0
3879,4,0,0,33,0.0,0.0,1.0,33,1100,600,500,0.5454545454545454,16,6,10,365.80855113230723,0.7199337121212122,0.12421306716247504,0.21373342390057443,131233.93233672142,3001.2989294982585,134235.2312662197,3841,6,786.3030303030303,33,0,21,34.47142985288839,0.6392045454545455,43.84191176470588,1024.6323529411761,31.0494652406417,0
3880,4,0,0,33,0.0,0.0,1.0,33,1250,900,350,0.72,16,9,7,363.3806002178399,0.7199337121212122,0.1190951814602268,0.2130227450122898,131361.49300469283,2946.911216891297,134308.40422158412,3842,7,787.3030303030303,31,2,21,34.40463715652654,0.645497311827957,43.717447916666664,1025.1302083333328,33.06871639784944,0
3881,4,0,0,33,0.0,0.0,1.0,33,700,700,0,1.0,7,7,0,363.871050322746,0.7206439393939394,0.12165854634739603,0.21349632267073765,131394.86524793826,2962.157524956588,134357.02277289485,3843,8,788.3030303030303,31,2,21,34.35833121666243,0.6458333333333334,43.68489583333333,1025.2604166666658,33.07291666666664,0
3882,4,0,0,33,0.0,0.0,1.0,33,750,700,50,0.9333333333333333,8,7,1,346.986610022298,0.7214330808080809,0.06234553137207954,0.20290224007038193,131265.32613658236,2509.4621059208303,133774.7882425032,3844,9,789.3030303030303,33,0,20,34.92186877142629,0.6395202020202019,43.81127450980394,1024.7549019607864,31.053178847296557,8
3883,4,0,0,33,0.0,0.0,1.0,33,600,400,200,0.6666666666666666,8,4,4,357.58015312379837,0.7214330808080809,0.060027325106498663,0.19475053369277048,128485.98082768646,2588.8073397251073,131074.78816741158,3845,10,790.3030303030303,33,0,19,37.47469176840324,0.6114267676767677,46.53799019607843,1013.8480392156862,30.722667855020795,7
3884,4,1,1,33,0.029411764705882353,0.029411764705882353,0.9705882352941176,34,750,600,150,0.8,9,6,3,347.82294613909414,0.7365196078431373,0.055183715715025006,0.1906874994106608,128747.91843820852,2156.29606009069,130904.21449829922,3846,0,768.0294117647059,34,0,20,37.454789833822076,0.6118259803921569,46.2797619047619,1014.8809523809516,29.84943977591034,0
3885,4,0,0,33,0.0,0.0,1.0,33,850,700,150,0.8235294117647058,10,7,3,356.7250390193593,0.7200126262626263,0.06001281699166938,0.19458798272150282,128548.11137843614,2571.266009467512,131119.37738790366,3847,12,792.3030303030303,33,0,20,37.43290533736154,0.6120580808080809,46.47671568627451,1014.0931372549016,30.730095068330353,0
3886,4,2,1,34,0.05714285714285714,0.02857142857142857,0.9714285714285714,35,1150,1100,50,0.9565217391304348,12,11,1,339.62644450416593,0.7466386554621848,0.06393442622950829,0.18833830104321891,129201.38888888866,1776.0416666666424,130977.4305555553,3848,0,747.9714285714285,35,0,21,37.2011612021858,0.6142857142857143,45.83333333333332,1016.6666666666648,29.047619047618994,0
3887,4,1,0,35,0.02857142857142857,0.0,1.0,35,1050,900,150,0.8571428571428571,12,9,3,340.63972459039195,0.7490196078431373,0.07674509294163534,0.1900320087943354,129436.83556241432,1818.2656035665361,131255.10116598086,3849,0,748.9428571428572,35,0,17,36.93604033970277,0.6166666666666667,45.601851851851855,1017.592592592593,29.074074074074083,0
3888,4,1,1,35,0.027777777777777776,0.027777777777777776,0.9722222222222222,36,700,500,200,0.7142857142857143,9,5,4,330.8483639446389,0.7650132275132275,0.0704424300488864,0.18589157144367716,129717.10519641262,1383.3384059735436,131100.44360238616,3850,0,729.1111111111111,36,0,19,36.900748028594606,0.6174768518518519,45.32657657657658,1018.6936936936936,28.297047047047045,0
3889,4,1,0,36,0.027777777777777776,0.0,1.0,36,1250,900,350,0.72,16,9,7,332.036901919401,0.7612103174603175,0.09432173752990991,0.18779476245347773,129975.34855379042,1431.3224119389815,131406.6709657294,3851,0,730.0833333333334,36,0,20,36.60868764954906,0.6200810185185185,45.073198198198206,1019.7072072072084,28.325200200200232,0
3890,4,1,0,37,0.02702702702702703,0.0,1.0,37,850,600,250,0.7058823529411765,11,6,5,325.16695199206174,0.7703328328328328,0.10123599385920867,0.1856701302208506,130346.55044100122,1076.87810191599,131423.42854291722,3852,0,711.3243243243244,37,0,21,36.408224166935106,0.621903153153153,44.70942982456141,1021.1622807017557,27.59898055950691,0
3891,4,0,0,37,0.0,0.0,1.0,37,900,800,100,0.8888888888888888,10,8,2,321.9949238915063,0.7697072072072072,0.09945017481249341,0.18412416918657987,130402.5412266276,997.791267505407,131400.332494133,3853,1,712.3243243243244,37,0,21,36.432613168724274,0.622466216216216,44.654605263157904,1021.3815789473699,27.604907539118106,0
3892,4,2,2,37,0.05128205128205128,0.05128205128205128,0.9487179487179487,39,1250,900,350,0.72,16,9,7,311.2354239910909,0.7863247863247863,0.10209434331571776,0.18040637408333168,130928.03955078151,349.8887803819746,131277.92833116348,3854,0,676.7435897435897,39,0,17,36.177374893977955,0.6241987179487178,44.140625000000014,1023.437500000002,26.241987179487232,0
3893,4,1,2,36,0.02631578947368421,0.05263157894736842,0.9473684210526316,38,1250,1000,250,0.8,15,10,5,319.55279803518835,0.7802868658131816,0.10438926263025983,0.18478487886382633,130835.79881656809,761.7891190006643,131597.58793556876,3855,0,695.5263157894736,38,0,18,36.05759189640769,0.625,44.23076923076923,1023.0769230769233,26.92307692307693,0
3894,4,1,0,37,0.02702702702702703,0.0,1.0,37,1050,800,250,0.7619047619047619,13,8,5,327.83642297605167,0.7755880880880881,0.11602213145621532,0.18951138948987362,130822.8553497229,1177.6993882733072,132000.5547379962,3856,0,714.5945945945946,37,0,20,35.85878885316185,0.6266891891891893,44.243421052631575,1023.0263157894728,27.649359886201967,0
3895,4,1,0,38,0.02631578947368421,0.0,1.0,38,1050,700,350,0.6666666666666666,14,7,7,317.8023187485308,0.7826280227596017,0.0874670467866836,0.18209368329491912,130480.80490037623,693.4204699028448,131174.22537027908,3857,0,696.7631578947369,38,0,21,36.46062079542682,0.6214364035087719,44.577991452991455,1021.6880341880343,26.886527215474587,4
3896,4,1,1,38,0.02564102564102564,0.02564102564102564,0.9743589743589743,39,1150,900,250,0.782608695652174,14,9,5,310.4283662390688,0.7858187134502924,0.0864973282981023,0.17907084017245492,130741.54188368078,317.17664930557953,131058.71853298636,3858,0,679.8717948717949,39,0,18,36.38597474027296,0.6223290598290598,44.32291666666668,1022.7083333333352,26.223290598290646,0
3897,4,0,0,38,0.0,0.0,1.0,38,1300,800,500,0.6153846153846154,18,8,10,317.059270721939,0.7806721194879089,0.08951986673044288,0.1829540927438893,130753.83434007231,691.3430719921131,131445.17741206443,3859,2,698.7631578947369,38,0,19,36.20403739684531,0.6241776315789473,44.31089743589744,1022.7564102564102,26.91464237516869,0
3898,4,0,0,38,0.0,0.0,1.0,38,1050,900,150,0.8571428571428571,12,9,3,317.56765514009373,0.780049786628734,0.08983211109034284,0.18337712486798907,130781.15297866904,706.3728175907654,131487.5257962598,3860,3,699.7631578947369,38,0,19,36.163480955365216,0.6244517543859649,44.284188034188034,1022.8632478632481,26.91745389113811,0
3899,4,0,0,38,0.0,0.0,1.0,38,1150,700,450,0.6086956521739131,16,7,9,317.7786446188783,0.7804646752015173,0.08334798373805108,0.1842808362862501,130945.12473518869,722.3128515596345,131667.43758674833,3861,4,700.7631578947369,38,0,19,35.992736604036196,0.6260964912280702,44.12393162393162,1023.5042735042723,26.934322986954534,0
3900,4,0,1,37,0.0,0.02631578947368421,0.9736842105263158,38,1150,900,250,0.782608695652174,14,9,5,320.3237874414269,0.7815315315315315,0.08715012024114044,0.18655065774079704,131109.19922017684,799.4790525239301,131908.67827270078,3862,5,701.7631578947369,38,0,20,35.76222268586132,0.6277412280701754,43.96367521367522,1024.1452991452998,26.951192082771048,0
3901,4,0,0,37,0.0,0.0,1.0,37,800,400,400,0.5,12,4,8,327.50040643428304,0.7753378378378378,0.08912490806641249,0.18986886917127915,130935.05333371792,1176.2566366574188,132111.30997037535,3863,6,721.3783783783783,37,0,20,35.754142561245644,0.6278153153153154,44.133771929824555,1023.4649122807006,27.66121384542434,0
3902,4,2,1,38,0.05128205128205128,0.02564102564102564,0.9743589743589743,39,850,600,250,0.7058823529411765,11,6,5,314.2520408993864,0.790710751237067,0.08994798053879038,0.18445729886919937,131410.2692513149,459.7781850492013,131870.04743636408,3864,0,685.3333333333334,38,1,21,35.61464520162551,0.6307565789473684,43.669871794871796,1025.3205128205127,26.982118758434545,0
3903,4,0,0,38,0.0,0.0,1.0,38,1350,1000,350,0.7407407407407407,17,10,7,324.55832560712633,0.7819464201043148,0.10212282202512246,0.1906576294646886,131440.53939673738,932.0242767005162,132372.5636734379,3865,1,704.3684210526316,37,1,21,35.31998502994011,0.632882882882883,43.64035087719298,1025.4385964912276,27.71455666192507,0
3904,4,0,0,38,0.0,0.0,1.0,38,800,500,300,0.625,11,5,6,326.86916481867183,0.7810277382645804,0.10917606683732295,0.19243933523465528,131524.88175448202,998.2856503924135,132523.16740487443,3866,2,705.3684210526316,37,1,21,35.175819526100106,0.6337274774774775,43.55811403508771,1025.7675438596482,27.723447131341842,0
3905,4,1,1,38,0.02564102564102564,0.02564102564102564,0.9743589743589743,39,1000,700,300,0.7,13,7,6,321.29401788365476,0.7877867746288799,0.11913559511812788,0.19146256902137487,131985.99810979614,681.2623274161708,132667.2604372123,3867,0,688.2564102564103,38,1,19,34.85521938032854,0.6365131578947368,43.10897435897436,1027.5641025641023,27.041160593792167,0
3906,4,0,0,38,0.0,0.0,1.0,38,1000,600,400,0.6,14,6,8,326.39508905611626,0.7784791370317686,0.11705989110707793,0.1938708179574281,131862.52170138882,1007.8559027777728,132870.3776041666,3868,1,707.2894736842105,37,1,19,34.84829276538202,0.6371058558558559,43.229166666666664,1027.0833333333328,27.759009009008995,0
3907,4,1,1,38,0.02564102564102564,0.02564102564102564,0.9743589743589743,39,1200,1000,200,0.8333333333333334,14,10,4,322.10242164086736,0.7766531713900136,0.12018747818394515,0.19264087032007882,132123.26189139095,711.4445220615139,132834.70641345246,3869,0,690.1282051282051,38,1,19,34.69660362326371,0.6378837719298245,42.97542735042735,1028.098290598291,27.055218173639236,0
3908,4,0,0,38,0.0,0.0,1.0,38,1050,900,150,0.8571428571428571,12,9,3,330.22572332910664,0.7735004741583689,0.12222795978963097,0.19760859015041704,132144.2189543899,1127.48405759466,133271.70301198456,3870,3,709.2894736842105,37,1,19,34.466758202694564,0.6399211711711711,42.95504385964913,1028.1798245614043,27.78864390706498,0
3909,4,1,2,37,0.02564102564102564,0.05128205128205128,0.9487179487179487,39,950,600,350,0.631578947368421,13,6,7,324.7061908898684,0.7789586144849303,0.12104225059690643,0.19561568085316497,132398.0034722224,798.090277777797,133196.0937500002,3871,0,692.0769230769231,38,1,19,34.35391363022943,0.6406249999999998,42.70833333333334,1029.166666666668,27.08333333333337,0
3910,4,0,0,37,0.0,0.0,1.0,37,1100,900,200,0.8181818181818182,13,9,4,338.8459022860121,0.7625125125125125,0.13595198352097126,0.20304073357453198,132195.26113951814,1558.7645077510206,133754.02564726915,3872,5,730.081081081081,36,1,19,34.19386041757921,0.6423611111111109,42.90540540540542,1028.3783783783804,28.56606606606612,0
3911,4,1,0,38,0.02631578947368421,0.0,1.0,38,850,700,150,0.8235294117647058,10,7,3,333.2780782222086,0.7707444286391655,0.14170682696238424,0.20108877313724177,132455.95838659626,1229.088801639502,133685.04718823577,3873,0,711.8421052631579,36,2,20,34.07518324034571,0.6449652777777777,42.65202702702704,1029.3918918918935,28.594219219219262,0
3912,4,2,2,38,0.05,0.05,0.95,40,1300,1200,100,0.9230769230769231,14,12,2,318.1626944779774,0.7825320512820513,0.13522480058013042,0.19450440087371249,132948.34270445266,459.8405882460577,133408.18329269873,3874,0,677.2,38,2,18,33.971088435374156,0.6461074561403508,42.17414529914531,1031.3034188034203,27.139563652721588,0
3913,4,0,0,38,0.0,0.0,1.0,38,900,400,500,0.4444444444444444,14,4,10,331.0347224067748,0.769233048838312,0.14444342162796575,0.2008160239109534,132658.90045450866,1182.9404573492602,133841.84091185793,3875,2,713.8421052631579,36,2,18,33.92931970558227,0.6469907407407407,42.454954954954964,1030.1801801801812,28.616116116116146,0
3914,4,0,0,38,0.0,0.0,1.0,38,1050,700,350,0.6666666666666666,14,7,7,330.31357222135546,0.768640350877193,0.13526402023628137,0.20146707219763554,132861.99787202742,1177.2242259151024,134039.22209794252,3876,3,714.8421052631579,36,2,18,33.74431094119788,0.6490162037037037,42.25788288288288,1030.9684684684685,28.638013013013012,0
3915,4,1,1,38,0.02564102564102564,0.02564102564102564,0.9743589743589743,39,950,700,250,0.7368421052631579,12,7,5,324.8524350928221,0.7756972559604138,0.1372624330236143,0.1997280190417202,133160.81781173058,851.5231850184696,134012.34099674906,3877,0,697.4871794871794,37,2,18,33.585975955239185,0.6500563063063063,41.968201754385966,1032.1271929824566,27.895329540066392,0
3916,4,0,0,38,0.0,0.0,1.0,38,700,500,200,0.7142857142857143,9,5,4,336.6088546817762,0.7659435751541015,0.15001493257368637,0.2067482268300132,133123.35139193246,1362.0997686876024,134485.45116062005,3878,5,716.8421052631579,36,2,19,33.32014767932489,0.6516203703703705,42.0045045045045,1031.9819819819818,28.66616616616616,0
3917,4,0,0,38,0.0,0.0,1.0,38,800,500,300,0.625,11,5,6,322.8272412102854,0.7662991939307728,0.10121148908857469,0.20141612658119984,133705.0564077591,1040.3390299082866,134745.3954376674,3879,6,717.8421052631579,36,2,16,33.094466826364695,0.6574074074074074,41.44144144144144,1034.2342342342342,28.72872872872873,3
3918,4,0,0,38,0.0,0.0,1.0,38,850,500,350,0.5882352941176471,12,5,7,323.68698057333904,0.7668918918918919,0.1024683580550938,0.20291155194195026,133879.81520371747,1067.0306286016018,134946.8458323191,3880,7,718.8421052631579,36,2,18,32.89785092491839,0.6591435185185184,41.272522522522536,1034.909909909912,28.74749749749755,0
3919,4,0,0,38,0.0,0.0,1.0,38,800,600,200,0.75,10,6,4,324.4804724161629,0.7657954006638217,0.10246068232694183,0.20389261674106557,133967.2374020983,1093.9504961042387,135061.18789820254,3881,8,719.8421052631579,36,2,18,32.7901211066391,0.660011574074074,41.188063063063076,1035.2477477477498,28.756881881881938,0
3920,4,0,0,38,0.0,0.0,1.0,38,1450,1200,250,0.8275862068965517,17,12,5,324.07888655835,0.7648470839260313,0.10610145323091791,0.2048308628153746,134181.31209843417,1097.0660443598058,135278.37814279398,3882,9,720.8421052631579,37,1,19,32.58711239284579,0.6601914414414414,40.98135964912281,1036.074561403509,28.00201517306781,0
3921,4,0,0,38,0.0,0.0,1.0,38,1350,1100,250,0.8148148148148148,16,11,5,324.1172851733482,0.7641358463726885,0.1069978671151477,0.20517297134449544,134238.12044330954,1101.7790329716906,135339.89947628122,3883,10,721.8421052631579,37,1,19,32.52951627693717,0.6607545045045045,40.9265350877193,1036.2938596491233,28.007942152679007,0
3922,4,0,0,38,0.0,0.0,1.0,38,1150,700,450,0.6086956521739131,16,7,9,323.65368102341654,0.7639284020862969,0.10273118830063055,0.20599707369579243,134437.0443309481,1102.2088527239223,135539.253183672,3884,11,722.8421052631579,37,1,20,32.34343060548389,0.6627252252252251,40.73464912280702,1037.0614035087726,28.02868658131818,0
3923,4,0,0,38,0.0,0.0,1.0,38,800,600,200,0.75,10,6,4,324.75344434650316,0.7625355618776671,0.10365266829477249,0.20718087235079352,134522.34251163833,1137.3188144429193,135659.66132608126,3885,12,723.8421052631579,37,1,20,32.230010041221874,0.6635698198198197,40.65241228070176,1037.390350877194,28.03757705073497,0
3924,4,0,0,38,0.0,0.0,1.0,38,700,500,200,0.7142857142857143,9,5,4,326.2998325702773,0.7605500237079185,0.1038838278550418,0.20866432735149953,134609.20538359322,1184.595241549452,135793.80062514267,3886,13,724.8421052631579,36,2,20,32.10345451257009,0.6663773148148147,40.5686936936937,1037.7252252252265,28.825700700700736,0
3925,4,0,0,38,0.0,0.0,1.0,38,1200,800,400,0.6666666666666666,16,8,8,326.2306702391637,0.7592757230915126,0.09731876861966304,0.20979771554711074,134813.7897187729,1196.0785954873936,136009.8683142603,3887,14,725.8421052631579,36,2,18,31.901747632473093,0.6684027777777777,40.37162162162163,1038.513513513514,28.847597597597613,0
3926,4,0,0,38,0.0,0.0,1.0,38,650,400,250,0.6153846153846154,9,4,5,328.9807726591289,0.7598091512565197,0.10069270096316196,0.21190772674635514,134872.27091956828,1274.0767794821895,136146.34769905047,3888,15,726.8421052631579,36,2,18,31.772188493784313,0.6689814814814814,40.31531531531532,1038.7387387387394,28.85385385385387,0
3927,4,0,0,38,0.0,0.0,1.0,38,1000,700,300,0.7,13,7,6,332.50306070106774,0.7580310573731627,0.10848491760278223,0.21521761923358035,135047.79061155755,1380.760743851964,136428.55135540952,3889,16,727.8421052631579,36,2,18,31.506184543156373,0.6707175925925926,40.1463963963964,1039.4144144144148,28.872622622622632,0
3928,4,1,1,38,0.02564102564102564,0.02564102564102564,0.9743589743589743,39,900,700,200,0.7777777777777778,11,7,4,327.2323764161044,0.764957264957265,0.1115569715000635,0.21340948589776038,135319.7633526662,1056.201547591564,136375.96490025776,3890,0,710.1538461538462,37,2,18,31.373059156215962,0.6714527027027027,39.88486842105263,1040.4605263157894,28.120554765291605,0
3929,4,0,0,38,0.0,0.0,1.0,38,700,600,100,0.8571428571428571,8,6,2,336.3371265882784,0.7590979137031769,0.11921884616261336,0.21876124656122103,135223.42443795144,1496.1316045775538,136719.556042529,3891,18,729.8421052631579,36,2,20,31.231954670131373,0.6724537037037037,39.97747747747748,1040.09009009009,28.891391391391387,0
3930,4,0,0,38,0.0,0.0,1.0,38,850,600,250,0.7058823529411765,11,6,5,335.981261798443,0.7581792318634424,0.12195518025332874,0.21870746407556138,135252.7078387508,1488.4750882639232,136741.1829270147,3892,19,730.8421052631579,36,2,20,31.212108909819197,0.6727430555555557,39.949324324324316,1040.2027027027018,28.894519519519495,0
3931,4,0,0,38,0.0,0.0,1.0,38,1000,800,200,0.8,12,8,4,335.6734338654471,0.7573198198198198,0.120246244262463,0.21939843534543552,135399.17239874988,1489.9810283255954,136889.15342707548,3893,20,731.8421052631579,36,2,21,31.074623097453635,0.6741898148148149,39.808558558558545,1040.7657657657642,28.910160160160117,0
3932,4,0,0,38,0.0,0.0,1.0,38,1150,800,350,0.6956521739130435,15,8,7,335.4640787400248,0.7552750118539592,0.12843710335642267,0.2201587179637335,135545.71621875235,1494.1437636961057,137039.85998244846,3894,21,732.8421052631579,36,2,22,30.934582387080486,0.6756365740740742,39.66779279279278,1041.3288288288275,28.92580080080076,0
3933,4,0,0,38,0.0,0.0,1.0,38,750,700,50,0.9333333333333333,8,7,1,336.7905366034959,0.754800853485064,0.1284264017162593,0.22139130583125327,135604.35593955443,1534.0527605307975,137138.40870008522,3895,22,733.8421052631579,36,2,22,30.841847767326183,0.6762152777777779,39.611486486486484,1041.554054054054,28.932057057057055,0
3934,4,0,0,38,0.0,0.0,1.0,38,750,300,450,0.4,12,3,9,337.4404326025587,0.7543563300142248,0.12441613708902022,0.22218230903959196,135663.0083419567,1555.6368446148708,137218.64518657158,3896,23,734.8421052631579,36,2,22,30.766718913270633,0.6767939814814816,39.55518018018017,1041.7792792792784,28.938313313313287,0
3935,4,0,0,38,0.0,0.0,1.0,38,1600,1300,300,0.8125,19,13,6,335.94967828910757,0.7527560455192034,0.12250747898490588,0.2217459574099429,135751.0107235614,1521.101676000325,137272.1123995617,3897,24,735.8421052631579,36,2,22,30.718247964844032,0.6776620370370371,39.47072072072072,1042.117117117117,28.947697697697695,0
3936,4,0,0,38,0.0,0.0,1.0,38,1200,900,300,0.75,15,9,6,339.3601058198678,0.7512446657183499,0.12711103279312885,0.2249202018458234,135897.74476757154,1623.6546090008826,137521.39937657243,3898,25,736.8421052631579,36,2,18,30.483853547899344,0.6791087962962964,39.32995495495495,1042.6801801801794,28.963338338338318,0
3937,4,0,0,38,0.0,0.0,1.0,38,800,500,300,0.625,11,5,6,338.5531450116533,0.7520744428639166,0.12794173642723594,0.22475560401096203,135956.46057797657,1605.6974626653628,137562.15804064192,3899,26,737.8421052631579,36,2,18,30.446676024907322,0.6796875,39.273648648648646,1042.905405405405,28.969594594594582,0
3938,4,0,0,38,0.0,0.0,1.0,38,1400,900,500,0.6428571428571429,19,9,10,341.221546257808,0.752430061640588,0.1285618504860877,0.22690130531127584,136015.189069982,1682.262625801462,137697.45169578347,3900,27,738.8421052631579,36,2,18,30.318876174025693,0.6802662037037038,39.217342342342334,1043.1306306306296,28.975850850850822,0
3939,4,0,1,37,0.0,0.02631578947368421,0.9736842105263158,38,400,200,200,0.5,6,2,4,342.2573740923909,0.7520744428639166,0.1260289147044622,0.22796653996879943,136073.9302435881,1714.461209520321,137788.39145310843,3901,28,739.8421052631579,36,2,18,30.233630149307423,0.6808449074074074,39.16103603603603,1043.3558558558552,28.98210710710709,0
3940,4,0,0,37,0.0,0.0,1.0,37,500,300,200,0.6,7,3,4,346.4032491604398,0.752565065065065,0.12613212213877767,0.23080748641399576,136086.16958429775,2028.1382619598664,138114.3078462576,3902,29,746.3243243243244,35,2,19,30.113352745424287,0.6830357142857144,39.14930555555555,1043.4027777777771,29.81150793650792,0
3941,4,1,1,37,0.02631578947368421,0.02631578947368421,0.9736842105263158,38,1250,800,450,0.64,17,8,9,337.71011624155096,0.7521633475580844,0.1253843987920078,0.22816375181649198,136577.6143260425,1624.7284020082952,138202.3427280508,3903,0,727.6578947368421,37,1,23,29.85364435819434,0.6838400900900901,38.67872807017543,1045.2850877192973,28.250948316737766,0
3942,4,0,0,37,0.0,0.0,1.0,37,1200,900,300,0.75,15,9,6,340.46250937740416,0.7510635635635635,0.11861037127596097,0.23057581324355933,136662.0394676772,1905.6601787598472,138567.69964643705,3904,1,734.4864864864865,36,1,23,29.69821396517681,0.6866319444444444,38.597972972972975,1045.6081081081086,29.044669669669684,0
3943,4,0,0,37,0.0,0.0,1.0,37,1050,700,350,0.6666666666666666,14,7,7,341.58239223945293,0.7509384384384384,0.12218917172610921,0.2315280360828877,136691.47821808307,1938.280425695982,138629.75864377906,3905,2,735.4864864864865,36,1,23,29.63982518486611,0.6869212962962963,38.56981981981983,1045.7207207207216,29.047797797797823,0
3944,4,0,0,37,0.0,0.0,1.0,37,1200,900,300,0.75,15,9,6,338.7330550593567,0.7506881881881882,0.12124184374682279,0.23018566553582473,136781.44959919425,1866.4828300366364,138647.9324292309,3906,3,736.4864864864865,35,2,23,29.625378033488236,0.6898809523809524,38.483796296296305,1046.064814814816,29.887566137566168,0
3945,4,0,0,37,0.0,0.0,1.0,37,1250,900,350,0.72,16,9,7,339.8151773827236,0.7503753753753754,0.11757952642908376,0.23131997014607106,136841.9924554185,1900.197187928681,138742.1896433472,3907,4,737.4864864864865,35,2,23,29.537241887905594,0.6904761904761904,38.42592592592593,1046.2962962962972,29.89417989417992,0
3946,4,0,0,37,0.0,0.0,1.0,37,900,400,500,0.4444444444444444,14,4,10,338.3820531634522,0.7481231231231231,0.12101796621920502,0.23114254447207414,136963.11835562412,1869.1722393689952,138832.2905949931,3908,5,738.4864864864865,35,2,17,29.455071502285136,0.6916666666666667,38.31018518518518,1046.759259259259,29.907407407407398,0
3947,4,0,0,37,0.0,0.0,1.0,37,1000,900,100,0.9,11,9,2,336.745386389423,0.7483108108108109,0.12028422570591268,0.230175375873241,136986.04009414825,1825.883400292193,138811.92349444045,3909,6,739.4864864864865,36,1,17,29.475267139988524,0.6898148148148149,38.28828828828829,1046.8468468468473,29.07907907907909,0
3948,4,0,0,37,0.0,0.0,1.0,37,1200,1100,100,0.9166666666666666,13,11,2,353.78964499916106,0.7478728728728729,0.09570740121956356,0.22550944512677673,134490.74743870023,2143.076639499228,136633.82407819945,3910,7,740.4864864864865,35,2,21,31.50849884698355,0.6672619047619048,40.68287037037037,1037.2685185185182,29.63624338624338,5
3949,4,0,1,36,0.0,0.02702702702702703,0.972972972972973,37,1000,600,400,0.6,14,6,8,352.7049603746482,0.7469344344344344,0.09878734291159019,0.22538512448997333,134582.56927924356,2093.6147447889225,136676.18402403247,3911,8,741.4864864864865,33,4,21,31.444997244202984,0.6726641414141414,40.59436274509804,1037.6225490196077,31.44310754604872,0
3950,4,1,0,37,0.02702702702702703,0.0,1.0,37,1150,900,250,0.782608695652174,14,9,5,352.5525885513005,0.7501251251251251,0.10989501898592802,0.22587900340616615,134677.95589436754,2096.21239427143,136774.16828863896,3912,0,742.2432432432432,33,4,22,31.353797717434077,0.6736111111111112,40.502450980392155,1037.9901960784312,31.454248366013065,0
3951,4,0,0,37,0.0,0.0,1.0,37,850,500,350,0.5882352941176471,12,5,7,352.634632883685,0.7489364364364365,0.11231862099323475,0.22652564400481134,134773.3763005814,2105.1520148500504,136878.52831543147,3913,1,743.2432432432432,33,4,23,31.256515795271238,0.6745580808080809,40.41053921568627,1038.3578431372543,31.465389185977404,0
3952,4,0,0,37,0.0,0.0,1.0,37,900,600,300,0.6666666666666666,12,6,6,356.39498004886576,0.7501251251251251,0.09086938649676246,0.21798111570430617,132966.16685890037,2105.6363538062137,135071.80321270658,3914,2,744.2432432432432,33,4,18,32.96746276932825,0.6565656565656567,42.15686274509803,1031.3725490196073,31.253713606654767,4
3953,4,0,0,37,0.0,0.0,1.0,37,1050,600,450,0.5714285714285714,15,6,9,355.46735398093114,0.7503128128128128,0.09276957204264491,0.2179664714614318,133060.97902549498,2059.766826460974,135120.74585195596,3915,3,745.2432432432432,33,4,20,32.89620204299797,0.6575126262626263,42.064950980392155,1031.7401960784312,31.264854426619127,0
3954,4,0,0,37,0.0,0.0,1.0,37,1100,900,200,0.8181818181818182,13,9,4,355.1446433212759,0.7471846846846847,0.09929542132932001,0.21891751894281614,133257.03124999985,2065.104166666654,135322.1354166665,3916,4,746.2432432432432,34,3,21,32.70782889426959,0.6571691176470589,41.87499999999999,1032.4999999999989,30.367647058823497,0
3955,4,0,0,37,0.0,0.0,1.0,37,700,500,200,0.7142857142857143,9,5,4,355.039905654893,0.7464964964964965,0.10028818443804033,0.2192150307157434,133318.496669501,2066.6772959183527,135385.17396541935,3917,5,747.2432432432432,34,3,22,32.648895292987504,0.6577818627450981,41.81547619047618,1032.7380952380943,30.37464985994395,0
3956,4,0,0,37,0.0,0.0,1.0,37,1300,1000,300,0.7692307692307693,16,10,6,347.83023741605103,0.7463713713713713,0.06824644549763081,0.2171366274993692,133725.61034217617,1902.939312980109,135628.54965515627,3918,6,748.2432432432432,33,4,19,32.42742890995261,0.664141414141414,41.42156862745099,1034.3137254901967,31.342840166369598,2
3957,4,0,0,37,0.0,0.0,1.0,37,550,300,250,0.5454545454545454,8,3,5,348.05561523156575,0.7454954954954955,0.06522859786691093,0.21746391178161725,133757.30075271544,1910.9959210399993,135668.29667375545,3919,7,749.2432432432432,33,4,19,32.38989752399005,0.6644570707070706,41.390931372549026,1034.436274509805,31.34655377302439,0
3958,4,0,0,37,0.0,0.0,1.0,37,900,600,300,0.6666666666666666,12,6,6,349.6321741094355,0.7443693693693694,0.058778732729278804,0.21949832157989474,133933.9303429705,1965.5222505668933,135899.4525935374,3920,8,750.2432432432432,34,3,19,32.17246501820969,0.6639093137254901,41.220238095238095,1035.1190476190475,30.444677871148457,0
3959,4,0,0,37,0.0,0.0,1.0,37,900,600,300,0.6666666666666666,12,6,6,350.9416219405076,0.7443068068068068,0.05506702379546691,0.22087483557442397,134026.36763038562,2007.086167800466,136033.4537981861,3921,9,751.2432432432432,34,3,20,32.046160036790056,0.664828431372549,41.13095238095239,1035.4761904761915,30.45518207282916,0
3960,4,0,0,37,0.0,0.0,1.0,37,500,300,200,0.6,7,3,4,350.0396353547365,0.743993993993994,0.04889717303510421,0.22067716141929042,134088.01020408171,1987.2236394557929,136075.2338435375,3922,10,752.2432432432432,34,3,21,32.007902298850574,0.6654411764705882,41.07142857142858,1035.7142857142862,30.462184873949596,0
3961,4,0,0,37,0.0,0.0,1.0,37,1100,800,300,0.7272727272727273,14,8,6,351.85150198088337,0.743556056056056,0.048016993208306324,0.22237934798399633,134180.50063775518,2042.322137188217,136222.8227749434,3923,11,753.2432432432432,34,3,21,31.868560649584424,0.666360294117647,40.98214285714286,1036.0714285714294,30.472689075630274,0
3962,4,0,0,37,0.0,0.0,1.0,37,1000,600,400,0.6,14,6,8,355.2111924317426,0.7431181181181181,0.04517228216849278,0.2256407202690042,134365.5771683674,2145.6313775510253,136511.20854591843,3924,12,754.2432432432432,34,3,21,31.59662418188081,0.6681985294117647,40.80357142857143,1036.7857142857147,30.493697478991606,0
3963,4,0,0,37,0.0,0.0,1.0,37,900,600,300,0.6666666666666666,12,6,6,358.6961631508337,0.7427427427427428,0.04885463976373061,0.22843281969079432,134458.16326530627,2245.925453514757,136704.08871882103,3925,13,755.2432432432432,34,3,21,31.413806626874802,0.6691176470588235,40.71428571428572,1037.1428571428582,30.504201680672303,0
3964,4,0,0,37,0.0,0.0,1.0,37,1050,700,350,0.6666666666666666,14,7,7,356.6685881526849,0.7432432432432432,0.10660451828741158,0.21193778089403298,131877.80612244864,2007.3341836734282,133885.14030612208,3926,14,756.2432432432432,34,3,20,34.055545897079256,0.6433823529411766,43.214285714285694,1027.1428571428544,30.210084033613363,6
3965,4,0,0,37,0.0,0.0,1.0,37,1450,1100,350,0.7586206896551724,18,11,7,359.3275335891126,0.7413663663663663,0.10078235307008643,0.2143797233914859,132030.69905045317,2088.453089569116,134119.15214002228,3927,15,757.2432432432432,34,3,20,33.83311131703925,0.6449142156862746,43.06547619047617,1027.7380952380925,30.227591036414484,0
3966,4,1,1,37,0.02631578947368421,0.02631578947368421,0.9736842105263158,38,1200,900,300,0.75,15,9,6,348.45955837992216,0.7468883357041252,0.10085082039047677,0.21043842603837715,132489.90929705184,1633.9852607709352,134123.8945578228,3928,0,738.2894736842105,34,4,23,33.65036231884057,0.6495098039215688,42.6190476190476,1029.523809523807,30.28011204481785,0
3967,4,0,0,37,0.0,0.0,1.0,37,900,600,300,0.6666666666666666,12,6,6,355.5088179227933,0.7374874874874875,0.099896062272536,0.21435165554440325,132429.53619100805,2015.973573865796,134445.50976487386,3929,17,759.2432432432432,33,4,24,33.52966126919872,0.651199494949495,42.67769607843136,1029.2892156862729,31.19058229352342,0
3968,4,0,0,37,0.0,0.0,1.0,37,700,200,500,0.2857142857142857,12,2,10,356.7218355929245,0.735985985985986,0.10808237420948741,0.2156242347231474,132524.1568747596,2054.852100153773,134579.00897491336,3930,18,760.2432432432432,33,4,24,33.40325716099341,0.6521464646464648,42.58578431372548,1029.656862745097,31.201723113487787,0
3969,4,0,0,37,0.0,0.0,1.0,37,750,500,250,0.6666666666666666,10,5,5,355.6249477538518,0.7349224224224224,0.10413316696039221,0.21532219459102087,132587.25610342177,2030.2672049211826,134617.52330834293,3931,19,761.2432432432432,33,4,24,33.36803902903379,0.6527777777777778,42.52450980392157,1029.9019607843136,31.20915032679738,0
3970,4,0,0,37,0.0,0.0,1.0,37,1200,800,400,0.6666666666666666,16,8,8,377.6823749780222,0.7349224224224224,0.10008571505102726,0.2128947018730864,129844.02101826355,2410.9032263673516,132254.9242446309,3932,20,762.2432432432432,32,5,18,35.57874958704987,0.6276041666666666,45.20202020202021,1019.1919191919201,31.849747474747502,7
3971,4,1,0,38,0.02631578947368421,0.0,1.0,38,950,600,350,0.631578947368421,13,6,7,368.92746032033637,0.7483700806069227,0.10983020883208705,0.21003878119432684,130232.20663265295,2009.2474489795727,132241.45408163252,3933,0,743.1578947368421,34,4,19,35.40719034289713,0.6268382352941178,44.82142857142856,1020.7142857142848,30.021008403361318,0
3972,4,0,0,38,0.0,0.0,1.0,38,1150,900,250,0.782608695652174,14,9,5,368.9986421153673,0.7491702228544334,0.1085652380425659,0.21094205060573928,130391.51178770048,2022.865244774097,132414.3770324746,3934,1,744.1578947368421,32,6,20,35.24359212098735,0.6331380208333333,44.665404040404056,1021.3383838383858,31.916824494949555,0
3973,4,1,1,38,0.02564102564102564,0.02564102564102564,0.9743589743589743,39,800,500,300,0.625,11,5,6,360.09445405739905,0.7607399910031489,0.1010887138913994,0.20716606453426376,130638.16350682438,1608.4156334102372,132246.57914023462,3935,0,726.0512820512821,33,6,16,35.22087029489333,0.6332070707070706,44.42401960784314,1022.3039215686281,30.97890671420085,0
3974,4,0,0,38,0.0,0.0,1.0,38,1300,1100,200,0.8461538461538461,15,11,4,370.50057335334446,0.750029634898056,0.1161384158153449,0.21298037783185747,130606.844798275,2077.9821763264536,132684.82697460146,3936,3,746.1578947368421,33,5,17,34.9866872477321,0.6328914141414139,44.45465686274512,1022.181372549022,30.97519310754612,0
3975,4,1,0,39,0.02564102564102564,0.0,1.0,39,950,700,250,0.7368421052631579,12,7,5,362.78023519624116,0.7585470085470086,0.11700563404646203,0.21030490101025545,130931.8470096374,1699.8972505669178,132631.74426020432,3937,0,728.0,34,5,18,34.85469737505331,0.6338848039215685,44.13690476190477,1023.4523809523826,30.101540616246545,0
3976,4,1,0,40,0.025,0.0,1.0,40,1000,600,400,0.6,14,6,8,357.2608896820673,0.7651976495726496,0.13373983739837403,0.2092528068137826,131328.12500000026,1383.6805555555852,132711.80555555585,3938,0,710.775,35,5,19,34.59518970189702,0.6357142857142856,43.750000000000014,1025.000000000002,29.285714285714345,0
3977,4,0,0,40,0.0,0.0,1.0,40,1100,700,400,0.6363636363636364,15,7,8,361.0207319354125,0.7648504273504273,0.13631560613097982,0.21179227135066606,131389.14399092997,1486.8409863945858,132875.98497732455,3939,1,711.775,34,6,19,34.437171001703035,0.6384803921568626,43.690476190476204,1025.2380952380972,30.15406162464992,0
3978,4,0,0,40,0.0,0.0,1.0,40,1050,800,250,0.7619047619047619,13,8,5,359.1725765111482,0.7643429487179487,0.13922934076137383,0.2113818933893482,131511.22448979618,1447.0450680272368,132958.26955782343,3940,2,712.775,34,6,19,34.36121750232125,0.639705882352941,43.571428571428584,1025.7142857142876,30.168067226890813,0
3979,4,0,0,40,0.0,0.0,1.0,40,800,500,300,0.625,11,5,6,359.1817395326921,0.7639423076923076,0.13746953696181974,0.21155632601183952,131541.7534722224,1449.4791666666922,132991.23263888908,3941,3,713.775,34,6,19,34.3301516382345,0.6400122549019607,43.54166666666668,1025.8333333333348,30.171568627451023,0
3980,4,0,0,40,0.0,0.0,1.0,40,1200,1000,200,0.8333333333333334,14,10,4,359.922857555015,0.7612179487179487,0.14417352576389675,0.21295235648134947,131713.96933138295,1481.373644332997,133195.34297571593,3942,4,714.775,35,5,17,34.13728060284886,0.6395833333333333,43.373842592592595,1026.5046296296302,29.32870370370372,0
3981,4,1,1,40,0.024390243902439025,0.024390243902439025,0.975609756097561,41,1000,600,400,0.6,14,6,8,352.2551869983264,0.7692581300813008,0.1426524523903725,0.20978957742641868,131963.7458404352,1096.9827936044383,133060.72863403964,3943,0,698.3170731707318,36,5,17,34.082273856495696,0.6400462962962962,43.13063063063064,1027.477477477479,28.541041041041083,0
3982,4,1,0,41,0.024390243902439025,0.0,1.0,41,950,800,150,0.8421052631578947,11,8,3,350.5970351331871,0.7680386178861789,0.14492497982179042,0.20912081977944233,132021.60564280505,1057.2767023780661,133078.8823451831,3944,0,699.2926829268292,36,5,18,34.06658631017606,0.640625,43.07432432432433,1027.7027027027034,28.547297297297316,0
3983,4,0,1,40,0.0,0.024390243902439025,0.975609756097561,41,750,400,350,0.5333333333333333,11,4,7,351.2040943066222,0.7689024390243903,0.1487783501849036,0.20980307413814475,132079.4781267756,1077.3706984011205,133156.8488251767,3945,1,700.2926829268292,36,5,18,33.99270559450774,0.6412037037037037,43.018018018018026,1027.9279279279292,28.553553553553588,0
3984,4,1,1,40,0.024390243902439025,0.024390243902439025,0.975609756097561,41,850,500,350,0.5882352941176471,12,5,7,349.74649104425714,0.770680894308943,0.14654981288614777,0.2094121449000075,132166.3106307322,1044.9406754727866,133211.25130620497,3946,0,701.0731707317074,36,5,18,33.942749972620746,0.6420717592592593,42.933558558558566,1028.2657657657667,28.562937937937964,0
3985,4,0,0,40,0.0,0.0,1.0,40,900,500,400,0.5555555555555556,13,5,8,358.90076567823456,0.7623397435897435,0.1523049645390071,0.214687912560253,132130.126953125,1484.320746527778,133614.44769965278,3947,3,719.6,35,5,18,33.74387875717663,0.64375,42.96875,1028.125,29.375,0
3986,4,0,0,40,0.0,0.0,1.0,40,700,500,200,0.7142857142857143,9,5,4,363.4376648440454,0.7616185897435898,0.16068534773801502,0.2179154581514296,132219.38898533946,1610.7011959876515,133830.0901813271,3948,4,720.6,35,5,18,33.537305874409185,0.6446428571428571,42.88194444444444,1028.472222222222,29.384920634920626,0
3987,4,0,0,40,0.0,0.0,1.0,40,1150,700,450,0.6086956521739131,16,7,9,363.4376648440454,0.7616987179487179,0.16068534773801502,0.2179154581514296,132219.38898533946,1610.7011959876515,133830.0901813271,3949,5,721.6,35,5,18,33.537305874409185,0.6446428571428571,42.88194444444444,1028.472222222222,29.384920634920626,0
3988,4,2,1,41,0.047619047619047616,0.023809523809523808,0.9761904761904762,42,850,400,450,0.47058823529411764,13,4,9,343.9176544598077,0.7710753000387147,0.15927382643213495,0.2094396734045656,132803.95418644996,734.8454486299295,133538.7996350799,3950,0,688.1904761904761,36,6,18,33.45191922502639,0.6484375,42.314189189189186,1030.7432432432431,28.631756756756754,0
3989,4,0,0,41,0.0,0.0,1.0,41,1000,700,300,0.7,13,7,6,353.760585795648,0.7623983739837399,0.157321593433839,0.21498501674666545,132725.77649444845,1190.6296885716479,133916.4061830201,3951,1,705.9756097560976,35,6,18,33.276821483395125,0.6497023809523811,42.39004629629628,1030.4398148148127,29.441137566137506,0
3990,4,0,1,40,0.0,0.024390243902439025,0.975609756097561,41,1300,1100,200,0.8461538461538461,15,11,4,355.96073496836635,0.7610772357723578,0.16650837140174835,0.2177052923337752,132964.41139671177,1266.021921081922,134230.4333177937,3952,2,706.9756097560976,35,6,18,32.98042213743314,0.6520833333333336,42.158564814814795,1031.365740740738,29.467592592592514,0
3991,4,0,0,40,0.0,0.0,1.0,40,1250,900,350,0.72,16,9,7,366.30108786531486,0.7525373931623932,0.1742034172246596,0.2237588168610263,132919.22477324243,1737.691326530591,134656.91609977302,3953,3,725.45,34,6,18,32.75922612175787,0.6537990196078433,42.20238095238094,1031.1904761904748,30.329131652661022,0
3992,4,0,0,40,0.0,0.0,1.0,40,900,700,200,0.7777777777777778,11,7,4,361.89747912757326,0.7512019230769231,0.16926494345718934,0.22179657384155216,133042.0138888888,1629.5138888888787,134671.52777777766,3954,4,726.45,34,6,18,32.74939418416802,0.6550245098039216,42.08333333333333,1031.6666666666658,30.343137254901936,0
3993,4,0,0,40,0.0,0.0,1.0,40,1150,700,450,0.6086956521739131,16,7,9,363.06351640520154,0.7495993589743589,0.16798650363363743,0.22306148998700853,133134.14292800444,1667.2300170067904,134801.37294501124,3955,5,727.45,34,6,19,32.62679278655746,0.6559436274509804,41.99404761904761,1032.0238095238087,30.353641456582608,0
3994,4,0,0,40,0.0,0.0,1.0,40,1000,700,300,0.7,13,7,6,363.28732393081714,0.7469818376068376,0.1745560936238899,0.2239368131095933,133257.03125,1682.1180555555547,134939.14930555556,3956,6,728.45,34,6,19,32.497645951035786,0.6571691176470589,41.875,1032.5,30.36764705882353,0
3995,4,0,0,40,0.0,0.0,1.0,40,650,400,250,0.6153846153846154,9,4,5,365.87685864844775,0.7463675213675214,0.1694444444444445,0.2260931357289127,133349.23469387766,1757.8798185941157,135107.11451247177,3957,7,729.45,34,6,19,32.338251114184736,0.6580882352941175,41.78571428571429,1032.8571428571436,30.37815126050422,0
3996,4,0,0,40,0.0,0.0,1.0,40,1100,900,200,0.8181818181818182,13,9,4,366.2006040597713,0.744684829059829,0.17941193410897371,0.22723284087511625,133502.9779620182,1777.7742346938855,135280.75219671207,3958,8,730.45,34,6,19,32.175632607610495,0.6596200980392156,41.636904761904766,1033.4523809523814,30.395658263305336,0
3997,4,1,1,40,0.024390243902439025,0.024390243902439025,0.975609756097561,41,1200,900,300,0.75,15,9,6,357.47939282014306,0.753760162601626,0.17089540022917005,0.22380012407647626,133831.25964506183,1368.3834876543324,135199.64313271616,3959,0,713.609756097561,35,6,19,32.07214765100671,0.6607142857142856,41.31944444444445,1034.722222222223,29.563492063492088,0
3998,4,0,0,40,0.0,0.0,1.0,40,1450,1000,450,0.6896551724137931,19,10,9,368.8167114778008,0.7449252136752137,0.18002934745079968,0.2303845007929988,133749.15143140595,1865.7844387755144,135614.93587018145,3960,10,732.45,34,6,19,31.86116545824222,0.6620710784313726,41.398809523809526,1034.4047619047624,30.42366946778713,0
3999,4,0,0,40,0.0,0.0,1.0,40,550,300,250,0.5454545454545454,8,3,5,370.022533451093,0.7444711538461538,0.18018352318490427,0.23152381844661277,133810.73022959195,1902.5970804988833,135713.32731009083,3961,11,733.45,34,6,19,31.76825643385879,0.6626838235294117,41.33928571428572,1034.642857142858,30.43067226890759,0
4000,4,1,0,41,0.024390243902439025,0.0,1.0,41,950,700,250,0.7368421052631579,12,7,5,364.30393171889585,0.7466463414634147,0.19948523103321447,0.23088051723586087,134280.734592014,1583.7999131944541,135864.53450520846,3962,0,716.5365853658536,35,6,20,31.44577051926298,0.6651785714285714,40.88541666666667,1036.4583333333342,29.613095238095262,0
4001,4,0,2,39,0.0,0.04878048780487805,0.9512195121951219,41,800,500,300,0.625,11,5,6,364.81584821428544,0.7459857723577236,0.2099738675958187,0.23215553977272727,134430.72702331975,1608.4919410151024,136039.21896433484,3963,1,717.5365853658536,35,6,21,31.28255208333334,0.6666666666666665,40.74074074074075,1037.037037037038,29.629629629629658,0
4002,4,0,0,39,0.0,0.0,1.0,39,750,300,450,0.4,12,3,9,371.2611532138832,0.741340530814215,0.20784895704509831,0.2356371809173831,134334.72222222228,2174.6527777777824,136509.37500000006,3964,2,740.3589743589744,34,5,21,31.211481779206856,0.6678921568627452,40.833333333333336,1036.666666666667,30.49019607843138,0
4003,4,0,1,38,0.0,0.02564102564102564,0.9743589743589743,39,800,400,400,0.5,12,4,8,367.9916381119607,0.741340530814215,0.17362654859669435,0.21731748783847374,131642.34459102261,1895.0800173010266,133537.42460832364,3965,3,741.3589743589744,33,6,17,34.00256747074278,0.6433080808080809,43.44362745098039,1026.2254901960778,31.09774212715387,7
4004,4,0,0,38,0.0,0.0,1.0,38,850,600,250,0.7058823529411765,11,6,5,366.45270199387176,0.7390054528212423,0.1611747851002867,0.21676608982349346,131705.23356401373,2052.74774125335,133757.98130526708,3966,4,741.1315789473684,33,5,17,33.97852992677492,0.643939393939394,43.382352941176464,1026.4705882352932,31.10516934046343,0
4005,4,0,0,38,0.0,0.0,1.0,38,1000,700,300,0.7,13,7,6,368.0239021276903,0.7401315789473685,0.1671189251323797,0.21823582986043275,131799.59518274217,2101.080263600535,133900.6754463427,3967,5,742.1315789473684,33,5,17,33.84291582129929,0.6448863636363636,43.29044117647059,1026.8382352941173,31.116310160427798,0
4006,4,1,0,39,0.02564102564102564,0.0,1.0,39,1150,900,250,0.782608695652174,14,9,5,358.32050151526647,0.7457264957264957,0.16549549790258378,0.21447083656184046,132153.07716836745,1670.6313775510307,133823.7085459185,3968,0,724.0769230769231,34,5,18,33.73567210837096,0.6461397058823529,42.94642857142858,1028.2142857142865,30.241596638655484,0
4007,4,0,0,39,0.0,0.0,1.0,39,1100,800,300,0.7272727272727273,14,8,6,361.42650715516015,0.7455015744489429,0.1762853895708889,0.2170317198281958,132275.51197562355,1761.5752551020328,134037.0872307256,3969,1,725.0769230769231,34,5,18,33.53248080854839,0.6473651960784315,42.82738095238095,1028.690476190476,30.25560224089635,0
4008,4,0,0,39,0.0,0.0,1.0,39,1050,700,350,0.6666666666666666,14,7,7,360.20969586002184,0.7449955015744489,0.17290631916875832,0.2164765084577407,132306.12953514745,1731.5901360544276,134037.7196712019,3970,2,726.0769230769231,34,5,18,33.53293990588598,0.647671568627451,42.79761904761905,1028.8095238095243,30.259103641456598,0
4009,4,0,0,39,0.0,0.0,1.0,39,1100,800,300,0.7272727272727273,14,8,6,360.25290934747943,0.7452204228520019,0.16427097416921677,0.2175605558685058,132489.9092970522,1745.9750566893445,134235.88435374154,3971,3,727.0769230769231,34,5,20,33.3468239284613,0.6495098039215685,42.61904761904762,1029.5238095238096,30.28011204481793,0
4010,4,0,0,39,0.0,0.0,1.0,39,850,500,350,0.5882352941176471,12,5,7,361.9185516258421,0.7443769680611786,0.16691421269985263,0.2187444830895814,132520.5516581634,1792.3292233560246,134312.88088151944,3972,4,728.0769230769231,34,5,20,33.2731144255598,0.6498161764705882,42.58928571428572,1029.6428571428582,30.283613445378183,0
4011,4,0,0,39,0.0,0.0,1.0,39,1000,600,400,0.6,14,6,8,358.9681400810736,0.7430836707152497,0.16726221163475596,0.21784784602115093,132673.81660997734,1725.1346371882064,134398.95124716553,3973,5,729.0769230769231,34,5,18,33.19490986826901,0.6513480392156863,42.44047619047619,1030.2380952380954,30.301120448179276,0
4012,4,0,0,39,0.0,0.0,1.0,39,1100,700,400,0.6363636363636364,15,7,8,361.79329885578414,0.7439271255060729,0.17186625318772708,0.2201015170902689,132765.81809807263,1806.7566609977425,134572.57475907038,3974,6,730.0769230769231,34,5,19,33.02962920180201,0.652267156862745,42.35119047619048,1030.5952380952388,30.311624649859965,0
4013,4,0,0,39,0.0,0.0,1.0,39,900,600,300,0.6666666666666666,12,6,6,361.82686446778945,0.7426900584795322,0.1714375375615418,0.22084443080729563,132888.53635204083,1816.5284863945656,134705.06483843538,3975,7,731.0769230769231,34,5,19,32.90540930608475,0.6534926470588235,42.23214285714286,1031.071428571429,30.32563025210085,0
4014,4,0,0,39,0.0,0.0,1.0,39,1050,800,250,0.7619047619047619,13,8,5,361.94923249279395,0.7431399010346379,0.16573283963333618,0.22128201842519948,132949.9167375285,1824.224064625871,134774.14080215435,3976,8,732.0769230769231,34,5,20,32.840576782484916,0.6541053921568627,42.17261904761906,1031.309523809525,30.332633053221322,0
4015,4,0,0,39,0.0,0.0,1.0,39,650,500,150,0.7692307692307693,8,5,3,360.9454993506021,0.742633828160144,0.16753043910404286,0.22157759124440654,133103.42970521544,1808.616780045355,134912.0464852608,3977,9,733.0769230769231,34,5,20,32.71227503461006,0.6556372549019608,42.023809523809526,1031.9047619047622,30.350140056022415,0
4016,4,0,0,39,0.0,0.0,1.0,39,800,300,500,0.375,13,3,10,362.51277598684624,0.741340530814215,0.15696257924117685,0.22327491430098964,133226.30385487544,1859.2474489796068,135085.55130385506,3978,10,734.0769230769231,34,5,20,32.54847978167282,0.6568627450980391,41.90476190476191,1032.3809523809537,30.364145658263343,0
4017,4,0,0,39,0.0,0.0,1.0,39,550,300,250,0.5454545454545454,8,3,5,364.5901528283437,0.7419590643274854,0.15939239668053218,0.22473990017627773,133257.03125000012,1916.8402777777922,135173.8715277779,3979,11,735.0769230769231,34,5,20,32.46401668011836,0.6571691176470588,41.87500000000001,1032.500000000001,30.367647058823557,0
4018,4,0,0,39,0.0,0.0,1.0,39,700,400,300,0.5714285714285714,10,4,6,366.434402743981,0.7411718398560504,0.15845710485479958,0.22625042304655063,133318.4966695011,1970.4967403628102,135288.9934098639,3980,12,736.0769230769231,34,5,20,32.35470701248799,0.657781862745098,41.81547619047619,1032.738095238095,30.37464985994397,0
4019,4,0,0,39,0.0,0.0,1.0,39,950,600,350,0.631578947368421,13,6,7,368.480714778701,0.7408344579397211,0.16150654324928215,0.22770218528632538,133349.23469387754,2027.3242630385469,135376.5589569161,3981,13,737.0769230769231,34,5,20,32.271015829107114,0.6580882352941178,41.785714285714285,1032.8571428571427,30.378151260504197,0
4020,4,1,0,40,0.025,0.0,1.0,40,1250,1000,250,0.8,15,10,5,359.9735190420048,0.7504540598290599,0.16161593554162934,0.2246315199831951,133711.52692043895,1626.5217764060317,135338.04869684498,3982,0,719.625,35,5,17,32.12753655625185,0.6595238095238095,41.43518518518518,1034.2592592592591,29.550264550264547,0
4021,4,0,0,40,0.0,0.0,1.0,40,550,200,350,0.36363636363636365,9,2,7,356.81888159171996,0.7493589743589744,0.15609967557892412,0.22320531718323194,133801.3214404363,1548.5675743741351,135349.88901481044,3983,1,720.625,35,5,17,32.11920143938546,0.6604166666666667,41.348379629629626,1034.6064814814808,29.560185185185166,0
4022,4,0,0,40,0.0,0.0,1.0,40,950,600,350,0.631578947368421,13,6,7,360.39256140156397,0.7483173076923076,0.15904160143144752,0.22599090351001294,133891.14610125174,1650.6746184842293,135541.82071973596,3984,2,721.625,35,5,17,31.936833668828747,0.6613095238095238,41.261574074074076,1034.953703703704,29.570105820105827,0
4023,4,0,0,40,0.0,0.0,1.0,40,800,700,100,0.875,9,7,2,361.9963222290881,0.7495993589743589,0.16149781952365028,0.2271812708557707,133921.09435281626,1695.7887249228338,135616.8830777391,3985,3,722.625,35,5,17,31.86535558537404,0.6616071428571428,41.232638888888886,1035.069444444444,29.57341269841268,0
4024,4,0,0,40,0.0,0.0,1.0,40,1200,1000,200,0.8333333333333334,14,10,4,361.61050029042144,0.7493322649572649,0.1559446618222473,0.2273089195430654,133981.00090288496,1689.7873531807288,135670.7882560657,3986,4,723.625,35,5,17,31.815376374138257,0.6622023809523809,41.17476851851852,1035.300925925926,29.58002645502646,0
4025,4,0,0,40,0.0,0.0,1.0,40,1100,500,600,0.45454545454545453,17,5,12,361.7778953763396,0.7479700854700855,0.15694323618964812,0.22787051547128892,134054.68813408,1699.6045876958015,135754.2927217758,3987,5,724.625,36,4,17,31.737304262722926,0.6608796296296295,41.1036036036036,1035.5855855855852,28.766266266266257,0
4026,4,0,0,40,0.0,0.0,1.0,40,850,300,550,0.35294117647058826,14,3,11,365.8180107978569,0.7466880341880342,0.14951097587481055,0.23151701068513605,134229.67519884746,1820.726554256956,136050.4017531044,3988,6,725.625,36,4,17,31.457608853147878,0.6626157407407407,40.93468468468468,1036.2612612612609,28.785035035035023,0
4027,4,0,0,40,0.0,0.0,1.0,40,1250,800,450,0.64,17,8,9,365.8492093185221,0.7462339743589743,0.15085813599826214,0.23227640144733191,134346.39665002836,1830.1045978410755,136176.50124786943,3989,7,726.625,36,4,18,31.340068071547538,0.6637731481481481,40.82207207207207,1036.7117117117111,28.79754754754753,0
4028,4,0,0,40,0.0,0.0,1.0,40,800,600,200,0.75,10,6,4,361.6846157986612,0.7473824786324786,0.1420600738337625,0.2262490399317167,133801.3214404363,1684.9138023588775,135486.23524279517,3990,8,727.625,35,5,16,31.99334843569378,0.6604166666666667,41.348379629629626,1034.6064814814808,29.560185185185166,2
4029,4,0,0,40,0.0,0.0,1.0,40,1050,500,550,0.47619047619047616,16,5,11,362.942066877666,0.7481036324786324,0.15051431127012527,0.22796024200518578,133951.04595336076,1723.293895747598,135674.33984910836,3991,9,728.625,35,5,17,31.810897435897424,0.6619047619047618,41.2037037037037,1035.1851851851852,29.57671957671958,0
4030,4,0,0,40,0.0,0.0,1.0,40,800,400,400,0.5,12,4,8,360.59414839135445,0.7475694444444444,0.14773641851106678,0.2268547996841811,134010.9592013888,1664.7135416666572,135675.67274305545,3992,10,729.625,35,5,17,31.811703554661303,0.6625,41.14583333333333,1035.4166666666658,29.58333333333331,0
4031,4,0,0,40,0.0,0.0,1.0,40,1100,800,300,0.7272727272727273,14,8,6,363.55968914827884,0.7467147435897435,0.14399441340782126,0.22946821000543677,134130.82588520227,1752.9122728052043,135883.73815800747,3993,11,730.625,35,5,17,31.614990689013034,0.6636904761904763,41.03009259259259,1035.879629629629,29.59656084656083,0
4032,4,0,0,40,0.0,0.0,1.0,40,1050,800,250,0.7619047619047619,13,8,5,362.9078867927041,0.7462873931623931,0.13925777004998952,0.22967526645574032,134229.6751988475,1742.6015542569567,135972.27675310444,3994,12,731.625,36,4,17,31.533000072448026,0.6626157407407407,40.93468468468468,1036.261261261261,28.78503503503503,0
4033,4,0,0,40,0.0,0.0,1.0,40,1100,900,200,0.8181818181818182,13,9,4,362.13470099068843,0.7450854700854701,0.13732073011734047,0.22955150054533727,134288.02958363772,1726.0710879798733,136014.1006716176,3995,13,732.625,36,4,18,31.494685281761544,0.6631944444444444,40.87837837837838,1036.4864864864867,28.791291291291298,0
4034,4,0,0,40,0.0,0.0,1.0,40,1400,1000,400,0.7142857142857143,18,10,8,364.44571766750215,0.7439636752136752,0.1355320304017369,0.23212621436498598,134463.16882761155,1800.9052126450936,136264.07404025664,3996,14,733.625,36,4,18,31.259726746290266,0.6649305555555556,40.70945945945947,1037.1621621621634,28.810060060060096,0
4035,4,0,0,40,0.0,0.0,1.0,40,800,600,200,0.75,10,6,4,365.6057084866678,0.7439903846153846,0.13275702963847547,0.2330515004062767,134492.36979800757,1834.235629210302,136326.60542721787,3997,15,734.625,36,4,18,31.2004668331343,0.6652199074074073,40.68130630630631,1037.2747747747756,28.81318818818821,0
4036,4,0,0,40,0.0,0.0,1.0,40,900,500,400,0.5555555555555556,13,5,8,365.5114876439304,0.74375,0.1260484050858801,0.2337500711993924,134610.82845721886,1840.3735140765227,136451.20197129538,3998,16,735.625,35,5,18,31.08456019034873,0.6684523809523808,40.56712962962963,1037.731481481482,29.649470899470913,0
4037,4,0,0,40,0.0,0.0,1.0,40,1050,700,350,0.6666666666666666,14,7,7,363.2600772667687,0.7430288461538461,0.1354893545870024,0.2332717360887747,134761.0050824117,1790.658623756857,136551.66370616856,3999,17,736.625,35,5,20,30.993037751272613,0.6699404761904761,40.4224537037037,1038.3101851851852,29.66600529100529,0
4038,4,0,0,40,0.0,0.0,1.0,40,1300,900,400,0.6923076923076923,17,9,8,364.70129771951275,0.742681623931624,0.14106136166522099,0.23491653422938472,134872.27091956837,1837.61844614887,136709.88936571724,4000,18,737.625,36,4,16,30.844581165076615,0.6689814814814814,40.315315315315324,1038.73873873874,28.85385385385389,0
4039,4,0,0,40,0.0,0.0,1.0,40,1150,800,350,0.6956521739130435,15,8,7,365.60605402562885,0.7408119658119658,0.14107800650054148,0.23664403076132917,135047.79061155755,1874.8579660741855,136922.64857763174,4001,19,738.625,36,4,18,30.645991332611054,0.6707175925925926,40.1463963963964,1039.4144144144148,28.872622622622632,0
4040,4,0,0,40,0.0,0.0,1.0,40,1450,800,650,0.5517241379310345,21,8,13,367.542977900706,0.7387820512820513,0.1508041806563416,0.23847676141652974,135135.5932579539,1933.6276732813928,137069.2209312353,4002,20,739.625,36,4,19,30.508095960142967,0.6715856481481481,40.06193693693694,1039.7522522522524,28.88200700700701,0
4041,4,1,0,41,0.024390243902439025,0.0,1.0,41,850,700,150,0.8235294117647058,10,7,3,361.2013981359335,0.7435467479674797,0.14713811030218626,0.235936852698427,135376.81215614424,1579.6587651969858,136956.4709213412,4003,0,722.560975609756,37,4,20,30.432668668563196,0.6720157657657657,39.83004385964912,1040.6798245614036,28.1264817449028,0
4042,4,0,0,41,0.0,0.0,1.0,41,750,400,350,0.5333333333333333,11,4,7,361.09198323298807,0.7421239837398373,0.1449850226330367,0.23642808888372333,135462.40790435512,1582.8779047399132,137045.28580909502,4004,1,723.560975609756,37,4,20,30.350308967066923,0.6728603603603605,39.747807017543856,1041.008771929824,28.135372214319567,0
4043,4,0,1,40,0.0,0.024390243902439025,0.975609756097561,41,950,700,250,0.7368421052631579,12,7,5,359.94419478786875,0.7419207317073171,0.14634659982484877,0.23623980773326816,135548.03070415897,1557.9453533779617,137105.97605753693,4005,2,724.560975609756,37,4,21,30.294983503562534,0.673704954954955,39.665570175438596,1041.3377192982455,28.144262683736365,0
4044,4,0,0,40,0.0,0.0,1.0,40,800,600,200,0.75,10,6,4,369.97273673374946,0.7360042735042736,0.15212075308374828,0.24181669256671237,135399.17239875012,2018.800472770069,137417.97287152018,4006,3,742.3,36,4,21,30.182184592079636,0.6741898148148149,39.80855855855856,1040.765765765766,28.910160160160167,0
4045,4,0,0,40,0.0,0.0,1.0,40,650,500,150,0.7692307692307693,8,5,3,369.65930453395794,0.73616452991453,0.1480232558139538,0.24220412972476552,135487.0891795512,2016.8126318886466,137503.90181143984,4007,4,743.3,36,4,21,30.10275824770147,0.6750578703703705,39.7240990990991,1041.1036036036037,28.919544544544546,0
4046,4,0,0,40,0.0,0.0,1.0,40,1800,1500,300,0.8333333333333334,21,15,6,374.11977965071605,0.7350961538461539,0.15131368517249255,0.24698676855674007,135757.716836735,2158.087941775233,137915.80477851024,4008,5,744.3,34,6,21,29.717129312314366,0.681985294117647,39.46428571428573,1042.1428571428594,30.651260504201748,0
4047,4,0,0,40,0.0,0.0,1.0,40,750,500,250,0.6666666666666666,10,5,5,374.08323648225735,0.7345352564102564,0.1559673366834169,0.24739220684581933,135819.7562358278,2161.578798185958,137981.33503401375,4009,6,745.3,34,6,21,29.656330896908774,0.6825980392156862,39.40476190476191,1042.3809523809537,30.658263305322166,0
4048,4,0,0,40,0.0,0.0,1.0,40,1250,1100,150,0.88,14,11,3,373.0508930574993,0.7345619658119659,0.15981959351450126,0.24713916198166277,135881.80980725636,2138.166099773258,138019.9759070296,4010,7,746.3,34,6,20,29.621488924411967,0.6832107843137254,39.3452380952381,1042.6190476190484,30.6652661064426,0
4049,4,0,0,40,0.0,0.0,1.0,40,1250,1100,150,0.88,14,11,3,395.2563666247418,0.734107905982906,0.19422457432121498,0.24751933275952837,133841.52494331056,2582.925878684794,136424.45082199536,4011,8,747.3,34,6,19,31.08461803957661,0.6629901960784315,41.3095238095238,1034.761904761904,30.43417366946776,3
4050,4,0,0,40,0.0,0.0,1.0,40,900,600,300,0.6666666666666666,12,6,6,395.97291245952124,0.7331463675213675,0.19228004600345017,0.24859093673902802,133933.93034297053,2606.841695011338,136540.77203798186,4012,9,748.3,34,6,19,30.973260494537083,0.6639093137254901,41.220238095238095,1035.1190476190477,30.44467787114846,0
4051,4,0,0,40,0.0,0.0,1.0,40,1250,800,450,0.64,17,8,9,394.97706779614913,0.7327724358974359,0.18866685299049735,0.24828319546286404,133981.000902885,2583.884575402951,136564.88547828794,4013,10,749.3,35,5,19,30.951765418296997,0.6622023809523809,41.17476851851852,1035.3009259259263,29.580026455026466,0
4052,4,0,0,40,0.0,0.0,1.0,40,1000,700,300,0.7,13,7,6,392.53844190919875,0.7327724358974359,0.18786568787384428,0.24704934793669292,134025.53471968594,2522.0349149825524,136547.5696346685,4014,11,750.3,36,4,19,30.97018307050934,0.6605902777777778,41.13175675675676,1035.4729729729734,28.76313813813815,0
4053,4,0,0,40,0.0,0.0,1.0,40,1500,1100,400,0.7333333333333333,19,11,8,390.5332634867068,0.7313034188034188,0.18596314816827886,0.2465693542082511,134142.16739966333,2477.3956811541393,136619.56308081746,4015,12,751.3,36,4,19,30.905080262347344,0.6617476851851851,41.01914414414415,1035.9234234234245,28.775650650650682,0
4054,4,0,0,40,0.0,0.0,1.0,40,1100,900,200,0.8181818181818182,13,9,4,390.0690441741287,0.7293803418803418,0.187301673549229,0.24686487926343395,134229.67519884743,2471.7682209236236,136701.44341977107,4016,13,752.3,36,4,19,30.829348692313285,0.6626157407407407,40.93468468468468,1036.2612612612606,28.78503503503502,0
4055,4,0,0,40,0.0,0.0,1.0,40,1200,800,400,0.6666666666666666,16,8,8,389.7561069774317,0.7297809829059829,0.19102759070171604,0.2474548083333958,134346.3966500285,2472.465708952201,136818.8623589807,4017,14,753.3,36,4,20,30.720454051705403,0.6637731481481481,40.822072072072075,1036.7117117117123,28.797547547547563,0
4056,4,0,0,40,0.0,0.0,1.0,40,1050,600,450,0.5714285714285714,15,6,9,389.3002106712597,0.7289262820512821,0.19153637350705743,0.2479567731868812,134463.16882761137,2469.307990422856,136932.47681803422,4018,15,754.3,36,4,20,30.61527325370974,0.6649305555555556,40.70945945945946,1037.162162162162,28.810060060060056,0
4057,4,0,1,39,0.0,0.025,0.975,40,1000,900,100,0.9,11,9,2,375.64380227324654,0.7294604700854701,0.09893844079982017,0.22810239616892505,132695.96220207476,2048.080282406405,134744.04248448118,4019,16,755.3,35,5,18,32.74311016251029,0.6494047619047618,42.41898148148148,1030.3240740740741,29.43783068783069,6
4058,4,0,0,39,0.0,0.0,1.0,39,1150,800,350,0.6956521739130435,15,8,7,387.1283979016114,0.7214912280701755,0.10639855156207867,0.2347457622314396,132643.15653344675,2469.986536281179,135113.14306972793,4020,38,775.2564102564103,34,5,18,32.5005296814207,0.6510416666666666,42.470238095238095,1030.1190476190477,30.29761904761905,0
4059,4,0,1,38,0.0,0.02564102564102564,0.9743589743589743,39,1250,1000,250,0.8,15,10,5,383.6964223612867,0.722953216374269,0.10053817423576072,0.2334265585651199,132765.8180980725,2388.353883219951,135154.17198129243,4021,39,776.2564102564103,34,5,18,32.46529783219745,0.6522671568627452,42.351190476190474,1030.5952380952376,30.31162464985993,0
4060,4,0,0,38,0.0,0.0,1.0,38,900,800,100,0.8888888888888888,10,8,2,379.45752965540606,0.7164236605026079,0.11306312873596713,0.2321765562806809,132980.61224489813,2492.098922902514,135472.71116780065,4022,40,793.2105263157895,34,4,19,32.35827369959987,0.6544117647058822,42.14285714285715,1031.428571428573,30.336134453781558,0
4061,4,0,0,38,0.0,0.0,1.0,38,950,600,350,0.631578947368421,13,6,7,378.6847412341512,0.7166014698909435,0.11499760846073426,0.23197368375395155,133024.10361207585,2474.839650848791,135498.94326292464,4023,41,794.2105263157895,35,3,19,32.33444126556715,0.6526785714285713,42.10069444444446,1031.597222222224,29.4742063492064,0
4062,4,0,0,38,0.0,0.0,1.0,38,900,800,100,0.8888888888888888,10,8,2,376.69201027269924,0.7155938833570412,0.1121719010996145,0.23149294663002482,133143.52823055992,2430.8206607939073,135574.34889135385,4024,42,795.2105263157895,35,3,19,32.26573305670816,0.6538690476190475,41.98495370370371,1032.060185185186,29.487433862433882,0
4063,4,0,0,38,0.0,0.0,1.0,38,1450,1200,250,0.8275862068965517,17,12,5,376.45570986507204,0.7159495021337127,0.10736098571352692,0.23171901147595458,133203.26063368068,2429.0256076389082,135632.28624131958,4025,43,796.2105263157895,35,3,19,32.21178102926337,0.6544642857142855,41.92708333333334,1032.2916666666679,29.494047619047652,0
4064,4,0,1,37,0.0,0.02631578947368421,0.9736842105263158,38,850,600,250,0.7058823529411765,11,6,5,377.477296801073,0.7164829302987198,0.10801415302963258,0.23347088523559126,133382.53821855737,2469.775993441385,135852.31421199875,4026,44,797.2105263157895,35,3,20,32.00525210084034,0.6562499999999998,41.753472222222236,1032.9861111111131,29.513888888888946,0
4065,4,0,0,37,0.0,0.0,1.0,37,650,500,150,0.7692307692307693,8,5,3,387.05085751346166,0.7139014014014013,0.12124724701518463,0.2298064520143588,131847.2381660997,2806.3173185940927,134653.5554846938,4027,45,802.8378378378378,34,3,17,33.306286464974306,0.6430759803921569,43.24404761904761,1027.023809523809,30.206582633053205,2
4066,4,0,0,37,0.0,0.0,1.0,37,850,800,50,0.9411764705882353,9,8,1,387.2761517148617,0.7140265265265265,0.12018694633437366,0.23012525048180632,131877.806122449,2814.6258503401386,134692.43197278914,4028,46,803.8378378378378,34,3,17,33.26958738989337,0.6433823529411764,43.214285714285715,1027.1428571428573,30.21008403361345,0
4067,4,0,0,37,0.0,0.0,1.0,37,900,600,300,0.6666666666666666,12,6,6,385.1202736375028,0.7138388388388388,0.11967412268617084,0.22958274875959425,132000.11337868482,2767.1839569160993,134767.29733560092,4029,47,804.8378378378378,34,3,17,33.20131487488415,0.6446078431372548,43.095238095238095,1027.6190476190477,30.224089635854344,0
4068,4,0,0,37,0.0,0.0,1.0,37,1250,900,350,0.72,16,9,7,389.71234516863535,0.7155905905905906,0.11193245120989448,0.2330717321936517,132122.47732426284,2897.9520975056507,135020.4294217685,4030,48,805.8378378378378,34,3,17,32.959655318820445,0.6458333333333334,42.97619047619047,1028.0952380952367,30.238095238095198,0
4069,4,0,0,37,0.0,0.0,1.0,37,1000,800,200,0.8,12,8,4,388.5620284636489,0.7162787787787788,0.11514639639639657,0.23313721707818932,132244.89795918364,2877.069160997726,135121.96712018136,4031,49,806.8378378378378,34,3,19,32.86554783950616,0.6470588235294117,42.857142857142854,1028.5714285714282,30.252100840336123,0
4070,4,0,0,37,0.0,0.0,1.0,37,950,600,350,0.631578947368421,13,6,7,388.02613117523794,0.7179054054054054,0.11514776400272608,0.2339521569136057,132428.63520408154,2877.1541950113283,135305.78939909287,4032,50,807.8378378378378,34,3,20,32.69382758886576,0.6488970588235294,42.67857142857142,1029.2857142857135,30.27310924369746,0
4071,4,0,0,37,0.0,0.0,1.0,37,1000,800,200,0.8,12,8,4,391.0466590961019,0.7167167167167167,0.1191589369202688,0.23615722820272966,132489.9092970521,2961.9472789115534,135451.85657596367,4033,51,808.8378378378378,34,3,20,32.55425146469319,0.6495098039215687,42.61904761904761,1029.523809523809,30.280112044817912,0
4072,4,0,0,37,0.0,0.0,1.0,37,700,400,300,0.5714285714285714,10,4,6,390.4179889192613,0.7150275275275275,0.11777311291874382,0.23654736975696425,132612.50000000003,2954.8611111111113,135567.36111111115,4034,52,809.8378378378378,34,3,20,32.44673678532901,0.650735294117647,42.5,1030.0000000000002,30.29411764705883,0
4073,4,0,0,37,0.0,0.0,1.0,37,1400,1100,300,0.7857142857142857,17,11,6,389.6365625032032,0.7172797797797797,0.1131101064095521,0.2368464947350932,132735.1473922903,2943.693310657609,135678.8407029479,4035,53,810.8378378378378,34,3,16,32.34317236598891,0.6519607843137254,42.38095238095239,1030.476190476191,30.308123249299737,0
4074,4,0,0,37,0.0,0.0,1.0,37,750,500,250,0.6666666666666666,10,5,5,390.0941660692383,0.7157782782782782,0.1132207389280957,0.23770762730425987,132827.17013888882,2963.0208333333294,135790.19097222216,4036,54,811.8378378378378,34,3,16,32.238614928590685,0.6528799019607843,42.291666666666664,1030.8333333333328,30.318627450980376,0
4075,4,0,0,37,0.0,0.0,1.0,37,1000,500,500,0.5,15,5,10,385.52733353333656,0.7137137137137137,0.10842001840270776,0.23608440601175673,133011.31129535128,2855.899234693855,135867.21053004512,4037,55,812.8378378378378,34,3,17,32.17085016349298,0.654718137254902,42.11309523809523,1031.5476190476174,30.33963585434169,0
4076,4,1,1,37,0.02631578947368421,0.02631578947368421,0.9736842105263158,38,1100,700,400,0.6363636363636364,15,7,8,376.1823901794835,0.7237731152204836,0.10429265069410487,0.23192281290885736,133263.00643272005,2426.239256472878,135689.24568919293,4038,0,792.421052631579,35,3,17,32.15878731831261,0.6550595238095239,41.86921296296295,1032.5231481481458,29.50066137566131,0
4077,4,0,0,37,0.0,0.0,1.0,37,750,400,350,0.5333333333333333,11,4,7,383.9280198052041,0.7130880880880881,0.1085695223427372,0.23588036879456503,133134.14292800447,2822.7855725623476,135956.9285005668,4039,57,814.8378378378378,34,3,17,32.08847617949013,0.6559436274509804,41.99404761904761,1032.023809523809,30.353641456582615,0
4078,4,0,0,37,0.0,0.0,1.0,37,800,700,100,0.875,9,7,2,382.9090218780857,0.7144019019019019,0.10624417520969276,0.23564259252696082,133195.58000283432,2800.35785147391,135995.93785430823,4040,58,815.8378378378378,34,3,17,32.05296390266406,0.6565563725490196,41.9345238095238,1032.2619047619037,30.36064425770305,0
4079,4,0,0,37,0.0,0.0,1.0,37,450,300,150,0.6666666666666666,6,3,3,382.50405016933496,0.7145895895895896,0.1089370241912615,0.23578234734318715,133257.03125000003,2794.270833333334,136051.30208333337,4041,59,816.8378378378378,34,3,19,32.00161420500402,0.6571691176470589,41.875,1032.5000000000002,30.367647058823536,0
4080,4,0,0,37,0.0,0.0,1.0,37,450,200,250,0.4444444444444444,7,2,5,381.7355845493278,0.7147147147147147,0.10421372381026583,0.2356979498907772,133318.4966695011,2778.482851473922,136096.97952097503,4042,60,817.8378378378378,34,3,19,31.959654178674352,0.657781862745098,41.81547619047619,1032.738095238095,30.37464985994397,0
4081,4,0,0,37,0.0,0.0,1.0,37,750,400,350,0.5333333333333333,11,4,7,367.87571465533927,0.713526026026026,0.08147110915031441,0.23243806365442748,134169.6177551904,2491.5672273811615,136661.18498257158,4043,61,818.8378378378378,33,4,18,31.464395552401236,0.668560606060606,40.992647058823536,1036.0294117647068,31.39483065953657,4
4082,4,0,0,37,0.0,0.0,1.0,37,750,500,250,0.6666666666666666,10,5,5,357.921519670918,0.713526026026026,0.05097846777041881,0.21597678859695926,132459.27047902482,2082.5453343101826,134541.815813335,4044,62,819.8378378378378,34,3,19,33.43765660537374,0.649203431372549,42.64880952380952,1029.404761904761,30.276610644257676,4
4083,4,0,0,37,0.0,0.0,1.0,37,950,700,250,0.7368421052631579,12,7,5,358.3158609519679,0.7118993993993994,0.053591572842353496,0.21656700778291885,132520.55165816314,2096.843112244885,134617.39477040802,4045,63,820.8378378378378,34,3,20,33.36585154353105,0.6498161764705883,42.58928571428571,1029.6428571428562,30.283613445378123,0
4084,4,0,0,37,0.0,0.0,1.0,37,1000,600,400,0.6,14,6,8,359.6423712673312,0.7110235235235235,0.05094311924313066,0.21807886745453503,132643.15653344672,2140.8198696145114,134783.9764030612,4046,64,821.8378378378378,34,3,15,33.20837667090413,0.6510416666666667,42.470238095238095,1030.1190476190475,30.297619047619044,0
4085,4,0,0,37,0.0,0.0,1.0,37,1100,800,300,0.7272727272727273,14,8,6,361.08073530110966,0.710960960960961,0.05397289181072962,0.2198478907339666,132796.49234693864,2190.051020408144,134986.54336734678,4047,65,822.8378378378378,34,3,15,33.017151767151745,0.6525735294117647,42.32142857142856,1030.7142857142846,30.315126050420137,0
4086,4,0,0,37,0.0,0.0,1.0,37,1000,600,400,0.6,14,6,8,360.74999302947765,0.7092092092092092,0.054166380649872004,0.22036787303394453,132919.22477324257,2190.121882086161,135109.34665532873,4048,66,823.8378378378378,34,3,16,32.902332024936506,0.6537990196078431,42.20238095238095,1031.1904761904757,30.32913165266105,0
4087,4,0,0,37,0.0,0.0,1.0,37,850,600,250,0.7058823529411765,11,6,5,361.0657538750275,0.7082707707707707,0.05661939286981377,0.22118069170365062,133024.10361207544,2206.089650848748,135230.19326292418,4049,67,824.8378378378378,35,2,16,32.78883372601817,0.6526785714285714,42.100694444444436,1031.597222222221,29.474206349206316,0
4088,4,0,0,37,0.0,0.0,1.0,37,700,400,300,0.5714285714285714,10,4,6,361.0657538750275,0.7082707707707707,0.05661939286981377,0.22118069170365062,133024.10361207544,2206.089650848748,135230.19326292418,4050,68,825.8378378378378,35,2,16,32.78883372601817,0.6526785714285714,42.100694444444436,1031.597222222221,29.474206349206316,0
4089,4,0,0,37,0.0,0.0,1.0,37,900,400,500,0.4444444444444444,14,4,10,361.0447357786235,0.7070195195195195,0.055527098254472884,0.22187704403431993,133143.5282305597,2214.153994127212,135357.6822246869,4051,69,826.8378378378378,35,2,17,32.66945628200815,0.6538690476190477,41.984953703703695,1032.060185185184,29.487433862433832,0
4090,4,0,0,37,0.0,0.0,1.0,37,1400,900,500,0.6428571428571429,19,9,10,366.8676840819661,0.7063313313313313,0.05635297238350723,0.2263914308904187,133297.72973987472,2380.5258806103084,135678.25562048503,4052,70,827.8378378378378,36,1,17,32.36436750272628,0.6533564814814816,41.83558558558557,1032.6576576576554,28.684934934934873,0
4091,4,0,0,37,0.0,0.0,1.0,37,650,300,350,0.46153846153846156,10,3,7,366.8676840819661,0.7063313313313313,0.05635297238350723,0.2263914308904187,133297.72973987472,2380.5258806103084,135678.25562048503,4053,71,828.8378378378378,36,1,17,32.36436750272628,0.6533564814814816,41.83558558558557,1032.6576576576554,28.684934934934873,0
4092,4,0,0,37,0.0,0.0,1.0,37,800,600,200,0.75,10,6,4,362.1993302557554,0.7072072072072072,0.050895892622511596,0.22421165018665956,133414.04537983908,2264.495576657716,135678.54095649678,4054,72,829.8378378378378,36,1,17,32.36819635200929,0.6545138888888891,41.72297297297296,1033.1081081081063,28.6974474474474,0
4093,4,0,0,37,0.0,0.0,1.0,37,700,300,400,0.42857142857142855,11,3,8,358.39803154365126,0.7082082082082082,0.049471196804453665,0.22239123029524188,133502.97796201796,2169.466264561564,135672.44422657954,4055,73,830.8378378378378,34,3,17,32.37722228621894,0.6596200980392158,41.63690476190475,1033.4523809523796,30.395658263305283,0
4094,4,0,0,37,0.0,0.0,1.0,37,550,400,150,0.7272727272727273,7,4,3,359.4572715462672,0.7071446446446447,0.04640407335018115,0.22360508209941138,133595.26643990926,2204.3579931972718,135799.62443310654,4056,74,831.8378378378378,34,3,18,32.25736027944112,0.6605392156862746,41.547619047619044,1033.8095238095234,30.406162464985982,0
4095,4,0,1,36,0.0,0.02702702702702703,0.972972972972973,37,1100,800,300,0.7272727272727273,14,8,6,359.3186708818569,0.7066441441441441,0.048325854332067486,0.22482639083039732,133810.73022959186,2216.138747165536,136026.8689767574,4057,75,832.8378378378378,34,3,15,32.04512330763626,0.6626838235294117,41.339285714285715,1034.6428571428573,30.430672268907568,0
4096,4,0,0,36,0.0,0.0,1.0,36,1250,900,350,0.72,16,9,7,358.13185361342323,0.7026455026455027,0.05897190293742027,0.22577877727802761,134088.01020408163,2404.237528344669,136492.2477324263,4058,76,851.4166666666666,34,2,16,31.798371647509573,0.6654411764705883,41.07142857142857,1035.7142857142856,30.462184873949575,0
4097,4,0,0,36,0.0,0.0,1.0,36,400,300,100,0.75,5,3,2,364.2002696797862,0.7034060846560847,0.05984965686857868,0.22032936401146455,132555.70461180795,2456.1618673204566,135011.8664791284,4059,77,852.4166666666666,33,3,18,33.17899857193859,0.6524621212121213,42.55514705882353,1029.7794117647059,31.2054367201426,7
4098,4,0,0,36,0.0,0.0,1.0,36,650,300,350,0.46153846153846156,10,3,7,364.38934502953373,0.7019510582010583,0.06286932381518961,0.2208141633001608,132618.81134960108,2464.976361255284,135083.78771085636,4060,78,853.4166666666666,33,3,19,33.11062363672416,0.6530934343434345,42.493872549019606,1030.0245098039213,31.212863933452162,0
4099,4,0,0,36,0.0,0.0,1.0,36,550,400,150,0.7272727272727273,7,4,3,366.5012966121724,0.7026785714285715,0.06746031746031766,0.22246761015296262,132681.9331056564,2525.6201040465153,135207.55320970292,4061,79,854.4166666666666,33,3,15,32.99271936085009,0.6537247474747474,42.432598039215684,1030.2696078431368,31.22029114676172,0
4100,4,0,0,36,0.0,0.0,1.0,36,800,600,200,0.75,10,6,4,368.1201672319772,0.7033068783068783,0.06479719910159898,0.2240152392489817,132776.6438989811,2575.552071318715,135352.19597029983,4062,80,855.4166666666666,33,3,16,32.85572730875942,0.6546717171717171,42.3406862745098,1030.6372549019602,31.231431966726067,0
4101,4,0,0,36,0.0,0.0,1.0,36,900,600,300,0.6666666666666666,12,6,6,366.6369605385546,0.7032738095238096,0.06588639921973272,0.22323085825195516,132796.49234693864,2537.6204648525895,135334.11281179124,4063,81,856.4166666666666,34,2,16,32.873979748979735,0.6525735294117647,42.32142857142856,1030.7142857142846,30.315126050420137,0
4102,4,0,0,36,0.0,0.0,1.0,36,800,500,300,0.625,11,5,6,366.6369605385546,0.7026455026455027,0.06588639921973272,0.22323085825195516,132796.49234693864,2537.6204648525895,135334.11281179124,4064,82,857.4166666666666,34,2,16,32.873979748979735,0.6525735294117647,42.32142857142856,1030.7142857142846,30.315126050420137,0
4103,4,0,0,36,0.0,0.0,1.0,36,1200,900,300,0.75,15,9,6,368.44828229922837,0.7031746031746032,0.06565948165255309,0.22470155807826153,132857.85147392275,2590.2494331065564,135448.10090702932,4065,83,858.4166666666666,34,2,17,32.76558891454965,0.653186274509804,42.26190476190475,1030.9523809523798,30.322128851540583,0
4104,4,0,0,36,0.0,0.0,1.0,36,500,200,300,0.4,8,2,6,367.9337628170318,0.701521164021164,0.06498370917673646,0.22475615328075624,132919.22477324243,2581.094104308369,135500.3188775508,4066,84,859.4166666666666,34,2,17,32.717136150234744,0.6537990196078433,42.20238095238094,1031.1904761904748,30.329131652661022,0
4105,4,0,0,36,0.0,0.0,1.0,36,1000,900,100,0.9,11,9,2,368.7714935340255,0.7012566137566139,0.07484745936522597,0.22638182053490988,133103.42970521518,2616.9501133786594,135720.37981859385,4067,85,860.4166666666666,34,2,17,32.51038301799723,0.6556372549019609,42.02380952380951,1031.90476190476,30.350140056022354,0
4106,4,0,0,36,0.0,0.0,1.0,36,600,400,200,0.6666666666666666,8,4,4,369.58367371770237,0.701388888888889,0.07854616064905606,0.22706738961437,133134.14292800444,2640.8411281179024,135774.98405612234,4068,86,861.4166666666666,34,2,17,32.45856884684892,0.6559436274509804,41.99404761904761,1032.0238095238087,30.353641456582608,0
4107,4,0,0,36,0.0,0.0,1.0,36,1150,800,350,0.6956521739130435,15,8,7,367.7143820470691,0.7001653439153439,0.07440932132670741,0.22670214251844506,133263.0064327202,2600.5448120284464,135863.55124474864,4069,87,862.4166666666666,35,1,17,32.377372678698194,0.6550595238095238,41.869212962962955,1032.523148148147,29.50066137566134,0
4108,4,0,0,36,0.0,0.0,1.0,36,750,400,350,0.5333333333333333,11,4,7,348.105659383878,0.6990079365079366,0.0494797391368067,0.20327761804072655,131212.72243527306,1935.1782525768906,133147.90068784993,4070,88,863.4166666666666,36,0,19,34.946325199677574,0.6325231481481483,43.86261261261261,1024.549549549549,28.459709709709696,6
4109,4,0,0,36,0.0,0.0,1.0,36,700,400,300,0.5714285714285714,10,4,6,348.1281695349146,0.7000330687830688,0.04505915100904634,0.20375012674837673,131299.26960321804,1941.7948776479082,133241.06448086596,4071,89,864.4166666666666,36,0,19,34.85834889938833,0.6333912037037038,43.77815315315315,1024.887387387387,28.469094094094082,0
4110,4,1,1,36,0.02702702702702703,0.02702702702702703,0.972972972972973,37,850,700,150,0.8235294117647058,10,7,3,357.13901988732266,0.7143393393393394,0.01669566910449416,0.21380209249858317,132159.8776148834,2110.279055644736,134270.15667052811,4072,0,842.027027027027,35,2,16,33.75919255590575,0.644047619047619,42.93981481481482,1028.2407407407406,29.378306878306876,7
4111,4,0,0,36,0.0,0.0,1.0,36,1200,900,300,0.75,15,9,6,365.0745363774465,0.7000661375661376,0.02409165766043997,0.21833682106340915,132122.4773242631,2446.9104308390124,134569.38775510213,4073,91,866.4166666666666,34,2,17,33.59290566620351,0.6458333333333333,42.97619047619048,1028.0952380952385,30.23809523809525,0
4112,4,0,0,36,0.0,0.0,1.0,36,1100,800,300,0.7272727272727273,14,8,6,363.290627143347,0.7010582010582012,0.022280092592592782,0.2179743762860083,132244.8979591837,2408.666383219962,134653.56434240367,4074,92,867.4166666666666,34,2,18,33.515383873456784,0.6470588235294117,42.85714285714286,1028.571428571429,30.252100840336144,0
4113,4,0,0,36,0.0,0.0,1.0,36,1100,900,200,0.8181818181818182,13,9,4,361.3556846036582,0.7009920634920636,0.018895573037174485,0.21751800401908228,132367.37528344675,2366.3407029478503,134733.71598639459,4075,93,868.4166666666666,34,2,19,33.44179006632732,0.6482843137254901,42.73809523809524,1029.0476190476193,30.266106442577037,0
4114,4,1,1,36,0.02702702702702703,0.02702702702702703,0.972972972972973,37,700,500,200,0.7142857142857143,9,5,4,354.73415222549545,0.7110235235235235,0.014623892354159285,0.21510263624437354,132643.15653344672,2010.6150793650781,134653.7716128118,4076,0,845.918918918919,34,3,16,33.334777919026166,0.6510416666666667,42.470238095238095,1030.1190476190475,30.297619047619044,0
4115,4,0,0,36,0.0,0.0,1.0,36,700,400,300,0.5714285714285714,10,4,6,364.13611432737196,0.6977843915343915,0.019686392723041735,0.22047549746449818,132587.25610342188,2455.961649365641,135043.21775278752,4077,95,870.4166666666666,33,3,21,33.14889735046803,0.6527777777777777,42.524509803921575,1029.9019607843145,31.20915032679741,0
4116,4,0,0,36,0.0,0.0,1.0,36,650,300,350,0.46153846153846156,10,3,7,363.6509480301082,0.696792328042328,0.019014196209057532,0.22055193861046823,132650.3703503461,2447.6865868896675,135098.05693723576,4078,96,871.4166666666666,33,3,17,33.09788643032755,0.6534090909090908,42.46323529411765,1030.14705882353,31.216577540106968,0
4117,4,1,1,36,0.02702702702702703,0.02702702702702703,0.972972972972973,37,1050,800,250,0.7619047619047619,13,8,5,354.39410587194425,0.706519019019019,0.018381871370562797,0.2171979718165678,133042.01388888882,2029.861111111102,135071.8749999999,4079,0,848.8378378378378,34,3,18,32.942918686052764,0.6550245098039216,42.08333333333333,1031.666666666666,30.343137254901944,0
4118,4,1,0,37,0.02702702702702703,0.0,1.0,37,700,500,200,0.7142857142857143,9,5,4,353.3734546164044,0.711524024024024,0.018695152136410265,0.21340598013426423,132489.90929705207,1963.6833900226636,134453.59268707474,4080,0,849.8108108108108,34,3,21,33.52388798951588,0.6495098039215687,42.61904761904761,1029.5238095238087,30.280112044817905,1
4119,4,0,0,37,0.0,0.0,1.0,37,1250,1000,250,0.8,15,10,5,352.72452151125975,0.7111486486486487,0.022264899214639033,0.21423373569683876,132704.48022959172,1961.6248582766284,134666.10508786835,4081,1,850.8108108108108,34,3,16,33.32490853071441,0.651654411764706,42.41071428571428,1030.357142857142,30.30462184873947,0
4120,4,0,0,37,0.0,0.0,1.0,37,1000,700,300,0.7,13,7,6,354.87083650631826,0.70995995995996,0.030005057032084448,0.21606692703739114,132796.49234693873,2025.1204648526032,134821.61281179133,4082,2,851.8108108108108,34,3,17,33.17716755216755,0.6525735294117647,42.32142857142857,1030.7142857142853,30.315126050420158,0
4121,4,0,0,37,0.0,0.0,1.0,37,1150,800,350,0.6956521739130435,15,8,7,354.44066149564435,0.7132757757757757,0.03510424888700325,0.21669156319948954,132949.91673752837,2024.57128684808,134974.48802437645,4083,3,852.8108108108108,34,3,17,33.03416830197393,0.6541053921568627,42.17261904761905,1031.309523809524,30.332633053221297,0
4122,4,0,0,37,0.0,0.0,1.0,37,900,500,400,0.5555555555555556,13,5,8,356.2076432638205,0.7135885885885885,0.03180127167666136,0.21848914679175752,133072.7200255102,2080.3039965986422,135153.02402210885,4084,4,853.8108108108108,34,3,17,32.865322487596636,0.6553308823529411,42.05357142857143,1031.7857142857144,30.34663865546219,0
4123,4,0,0,37,0.0,0.0,1.0,37,1100,700,400,0.6363636363636364,15,7,8,357.52138268957583,0.7135885885885885,0.033970064192696325,0.21965647530375132,133134.14292800447,2119.6605725623467,135253.8035005668,4085,5,854.8108108108108,34,3,17,32.769783135309716,0.6559436274509804,41.99404761904761,1032.023809523809,30.353641456582615,0
4124,4,0,0,37,0.0,0.0,1.0,37,900,700,200,0.7777777777777778,11,7,4,358.27760549284454,0.7121496496496497,0.0366759748678569,0.22066643429218363,133226.30385487518,2146.400226757356,135372.70408163255,4086,6,855.8108108108108,34,3,17,32.65778751537516,0.6568627450980392,41.9047619047619,1032.3809523809516,30.364145658263283,0
4125,4,0,0,37,0.0,0.0,1.0,37,700,500,200,0.7142857142857143,9,5,4,359.92031592994795,0.7122747747747747,0.035577659919249216,0.22225390858428523,133322.76562767895,2197.114385073708,135519.88001275266,4087,7,856.8108108108108,35,2,17,32.51860827823228,0.6556547619047619,41.81134259259258,1032.754629629628,29.507275132275083,0
4126,4,0,0,37,0.0,0.0,1.0,37,1150,900,250,0.782608695652174,14,9,5,363.48506461408107,0.7110235235235235,0.034467408585055814,0.22481664599311646,133382.53821855693,2296.5121045524534,135679.05032310938,4088,8,857.8108108108108,35,2,17,32.36659663865546,0.65625,41.753472222222214,1032.98611111111,29.513888888888857,0
4127,4,0,0,37,0.0,0.0,1.0,37,950,700,250,0.7368421052631579,12,7,5,363.2284079084289,0.7111486486486487,0.03334786399302536,0.22520161290322582,133472.22222222213,2296.240837191353,135768.46305941348,4089,9,858.8108108108108,33,4,18,32.28326612903226,0.6616161616161617,41.666666666666664,1033.3333333333328,31.313131313131297,0
4128,4,0,0,37,0.0,0.0,1.0,37,550,400,150,0.7272727272727273,7,4,3,365.07621832844967,0.7105230230230231,0.039032986750829446,0.22692836415626197,133567.21460796337,2352.4427203479495,135919.65732831132,4090,10,859.8108108108108,33,4,18,32.140263781861286,0.6625631313131313,41.57475490196079,1033.7009803921574,31.32427213309568,0
4129,4,0,0,37,0.0,0.0,1.0,37,1000,800,200,0.8,12,8,4,366.5081063941658,0.7098348348348348,0.04384284735078792,0.22840438713101688,133662.2407847942,2397.6589532871863,136059.89973808138,4091,11,860.8108108108108,33,4,18,32.00797977403807,0.663510101010101,41.482843137254896,1034.0686274509796,31.33541295305999,0
4130,4,0,0,37,0.0,0.0,1.0,37,1300,1000,300,0.7692307692307693,16,10,6,368.7756650568553,0.7092717717717718,0.047647186887693094,0.23055111721899813,133779.93905895698,2466.957199546489,136246.89625850346,4092,12,861.8108108108108,34,3,14,31.83136747219026,0.6623774509803921,41.36904761904762,1034.5238095238099,30.42717086834735,0
4131,4,0,0,37,0.0,0.0,1.0,37,450,300,150,0.6666666666666666,6,3,3,369.9621489437898,0.710085085085085,0.04980659444534319,0.23167946675932424,133841.52494331065,2503.2596371882096,136344.78458049885,4093,13,862.8108108108108,34,3,14,31.738955361251733,0.6629901960784313,41.30952380952381,1034.7619047619046,30.434173669467782,0
4132,4,0,0,37,0.0,0.0,1.0,37,950,700,250,0.7368421052631579,12,7,5,365.77614580845227,0.7098348348348348,0.048833541791288404,0.23011486641367193,134010.95920138893,2403.60243055556,136414.5616319445,4094,14,863.8108108108108,35,2,14,31.677565392354133,0.6624999999999999,41.145833333333336,1035.416666666667,29.583333333333343,0
4133,4,0,0,37,0.0,0.0,1.0,37,800,700,100,0.875,9,7,2,367.2757654667537,0.709522022022022,0.045548454131377536,0.23143546122510655,134070.8858453361,2448.197445130313,136519.08329046643,4095,15,864.8108108108108,35,2,14,31.57875130382952,0.6630952380952382,41.08796296296296,1035.6481481481483,29.589947089947092,0
4134,4,0,0,37,0.0,0.0,1.0,37,950,400,550,0.42105263157894735,15,4,11,364.661573072472,0.7090215215215215,0.04724295340917295,0.23054028263734272,134190.7793209878,2386.8441358024825,136577.62345679026,4096,16,865.8108108108108,35,2,14,31.5264745308311,0.6642857142857143,40.97222222222223,1036.1111111111122,29.603174603174637,0
4135,4,0,0,37,0.0,0.0,1.0,37,900,600,300,0.6666666666666666,12,6,6,365.59682836292,0.7081456456456456,0.04525329349449958,0.23169990077777433,134280.734592014,2418.5221354166774,136699.25672743068,4097,17,866.8108108108108,35,2,14,31.41226968174204,0.6651785714285714,40.88541666666667,1036.4583333333342,29.613095238095262,0
4136,4,0,0,37,0.0,0.0,1.0,37,1300,1000,300,0.7692307692307693,16,10,6,364.17012117346917,0.7077702702702703,0.049541505791505625,0.23174462256493514,134430.72702331975,2391.1308299039924,136821.85785322374,4098,18,867.8108108108108,35,2,17,31.299293154761905,0.6666666666666665,40.74074074074075,1037.037037037038,29.629629629629658,0
4137,4,0,0,37,0.0,0.0,1.0,37,1150,800,350,0.6956521739130435,15,8,7,376.1188481226231,0.7087087087087087,0.07804596039890166,0.24253180896182927,134911.26543209873,2764.609053497944,137675.87448559667,4099,19,868.8108108108108,32,5,16,30.509135472370772,0.6783854166666666,40.27777777777778,1038.8888888888887,32.46527777777777,3
4138,4,0,0,37,0.0,0.0,1.0,37,1050,800,250,0.7619047619047619,13,8,5,374.851783695569,0.7066441441441441,0.07525017729099348,0.24259275812750988,135042.4701561066,2724.1821625344455,137766.65231864105,4100,20,869.8108108108108,32,5,17,30.411048347910583,0.6796875,40.151515151515156,1039.39393939394,32.48106060606062,0
4139,4,0,0,37,0.0,0.0,1.0,37,1000,600,400,0.6,14,6,8,374.5649798302594,0.7055805805805806,0.06664861679593548,0.24316632393724202,135155.39583633706,2724.8956230776707,137880.29145941473,4101,21,870.8108108108108,33,4,17,30.30580927126301,0.6783459595959596,40.04289215686275,1039.8284313725496,31.509952465834836,0
4140,4,0,0,37,0.0,0.0,1.0,37,1100,900,200,0.8181818181818182,13,9,4,373.07127301117686,0.7053928928928929,0.06704781704781704,0.24249632745726507,135200.00000000012,2687.847222222237,137887.84722222236,4102,22,871.8108108108108,34,3,17,30.300146901709397,0.676470588235294,40.00000000000001,1040.000000000001,30.588235294117673,0
4141,4,0,0,37,0.0,0.0,1.0,37,600,400,200,0.6666666666666666,8,4,4,382.3119527349631,0.7047672672672672,0.060342418814505194,0.23947270168245235,133850.68081172393,2834.5430312068856,136685.2238429308,4103,23,872.8108108108108,36,1,15,31.410291290310884,0.6588541666666666,41.30067567567568,1034.7972972972975,28.744369369369377,3
4142,4,0,0,37,0.0,0.0,1.0,37,950,600,350,0.631578947368421,13,6,7,361.2369455526409,0.7038288288288288,0.04673568689272578,0.22163987402627638,133083.80922335823,2228.580958629272,135312.3901819875,4104,24,873.8108108108108,35,2,18,32.72445784258741,0.6532738095238095,42.042824074074076,1031.828703703704,29.48082010582011,3
4143,4,0,0,37,0.0,0.0,1.0,37,950,600,350,0.631578947368421,13,6,7,357.2312263448741,0.7033908908908909,0.04494504595412785,0.21988580453898754,133203.26063368045,2116.8728298611018,135320.13346354154,4105,25,874.8108108108108,35,2,18,32.70791288261017,0.6544642857142857,41.92708333333333,1032.2916666666658,29.494047619047596,0
4144,4,0,0,37,0.0,0.0,1.0,37,1300,1100,200,0.8461538461538461,15,11,4,354.6866772279703,0.7032032032032032,0.03783359640326367,0.21867034191781093,133263.00643272034,2053.322589806239,135316.3290225266,4106,26,875.8108108108108,35,2,18,32.71365784852221,0.6550595238095238,41.86921296296296,1032.523148148148,29.500661375661373,0
4145,4,0,0,37,0.0,0.0,1.0,37,1100,800,300,0.7272727272727273,14,8,6,354.3244962071093,0.7042667667667668,0.038316797810468595,0.2195041483442654,133442.32420535415,2056.3768593535733,135498.7010647077,4107,27,876.8108108108108,35,2,19,32.543244277659525,0.6568452380952381,41.695601851851855,1033.217592592593,29.52050264550266,0
4146,4,0,0,37,0.0,0.0,1.0,37,500,300,200,0.6,7,3,4,353.13960608760783,0.7033283283283284,0.03675022015633389,0.2194773710486029,133561.9363667052,2033.2019193672752,135595.13828607247,4108,28,877.8108108108108,35,2,19,32.454022505878406,0.6580357142857143,41.57986111111111,1033.680555555555,29.53373015873014,0
4147,4,0,0,37,0.0,0.0,1.0,37,950,700,250,0.7368421052631579,12,7,5,350.7747209105864,0.7033908908908909,0.03514058047301871,0.2185370541572649,133651.68065200618,1976.3261959876588,135628.00684799385,4109,29,878.8108108108108,35,2,20,32.42528542646072,0.6589285714285713,41.49305555555556,1034.0277777777778,29.543650793650794,0
4148,4,0,0,37,0.0,0.0,1.0,37,1000,900,100,0.9,11,9,2,353.5531638580707,0.7053928928928929,0.03531837946695848,0.22098308941003061,133771.38658479083,2059.0593921467807,135830.4459769376,4110,30,879.8108108108108,35,2,16,32.23362795554561,0.6601190476190476,41.37731481481482,1034.490740740741,29.556878306878318,0
4149,4,0,0,37,0.0,0.0,1.0,37,800,500,300,0.625,11,5,6,352.6183108866847,0.7046421421421422,0.03719276820719597,0.22093625211197257,133861.20119866685,2040.3821319873132,135901.58333065416,4111,31,880.8108108108108,35,2,16,32.16793889572382,0.6610119047619047,41.29050925925926,1034.837962962963,29.566798941798943,0
4150,4,0,0,37,0.0,0.0,1.0,37,1300,800,500,0.6153846153846154,18,8,10,353.2214758657327,0.704954954954955,0.03819561959096851,0.22185483708870174,133951.04595336074,2062.87722908093,136013.92318244168,4112,32,881.8108108108108,35,2,16,32.06246273106738,0.6619047619047618,41.2037037037037,1035.185185185185,29.576719576719572,0
4151,4,1,1,37,0.02631578947368421,0.02631578947368421,0.9736842105263158,38,600,300,300,0.5,9,3,6,346.94399068031737,0.7142010431484116,0.044019762574624366,0.21992234781140801,134288.02958363784,1718.0849768687772,136006.11456050663,4113,0,859.578947368421,36,2,19,31.888309430682312,0.6631944444444444,40.878378378378386,1036.4864864864876,28.791291291291323,0
4152,4,0,0,37,0.0,0.0,1.0,37,1050,800,250,0.7619047619047619,13,8,5,352.0214136006667,0.7129004004004004,0.04389515143284006,0.22309637358768372,134280.73459201396,2053.9388020833435,136334.6733940973,4114,1,876.6486486486486,35,2,19,31.7640284757119,0.6651785714285714,40.88541666666667,1036.458333333334,29.613095238095255,0
4153,4,0,0,37,0.0,0.0,1.0,37,500,300,200,0.6,7,3,4,352.20973122332396,0.713526026026026,0.042417585070555486,0.22339875020085612,134310.7263803155,2061.1089677640603,136371.83534807956,4115,2,877.6486486486486,35,2,19,31.729194580914093,0.6654761904761904,40.85648148148148,1036.574074074074,29.61640211640211,0
4154,4,0,0,37,0.0,0.0,1.0,37,1000,600,400,0.6,14,6,8,354.6564229965979,0.7119619619619619,0.04645788773481585,0.22550510245752461,134400.72183909902,2133.2158511231246,136533.93769022214,4116,3,878.6486486486486,35,2,19,31.57590597908993,0.6663690476190476,40.76967592592593,1036.921296296297,29.62632275132277,0
4155,4,0,0,37,0.0,0.0,1.0,37,950,500,450,0.5263157894736842,14,5,9,356.23960944922726,0.7125875875875876,0.046761190383554085,0.22688437386457158,134460.73555651997,2180.0479841820875,136640.78354070205,4117,4,879.6486486486486,35,2,19,31.474933043187143,0.6669642857142857,40.71180555555555,1037.152777777777,29.632936507936485,0
4156,4,1,1,37,0.02631578947368421,0.02631578947368421,0.9736842105263158,38,900,800,100,0.8888888888888888,10,8,2,349.19791125146463,0.7207503556187767,0.05870400234569728,0.22498573248254808,134881.20666420183,1820.0772676611782,136701.283931863,4118,0,857.4736842105264,35,3,18,31.23827762302694,0.6711309523809523,40.30671296296296,1038.773148148148,29.6792328042328,0
4157,4,0,0,37,0.0,0.0,1.0,37,950,600,350,0.631578947368421,13,6,7,353.28412526964377,0.7155280280280281,0.05599296293772604,0.2276777900371427,134890.65334467124,2130.9452947845875,137021.59863945583,4119,1,869.1891891891892,34,3,18,31.122746199098472,0.673406862745098,40.29761904761905,1038.809523809524,30.553221288515413,0
4158,4,0,0,37,0.0,0.0,1.0,37,1250,800,450,0.64,17,8,9,351.53542524832375,0.7130880880880881,0.05733024500210582,0.22693795795616628,134952.4943310657,2088.116496598631,137040.61082766435,4120,2,870.1891891891892,34,3,19,31.10654407271615,0.6740196078431373,40.238095238095234,1039.0476190476186,30.56022408963584,0
4159,4,0,0,37,0.0,0.0,1.0,37,800,600,200,0.75,10,6,4,354.7902652592713,0.7122122122122122,0.06171857345835141,0.22962741334163791,135045.28238378675,2182.550311791373,137227.8326955781,4121,3,871.1891891891892,34,3,19,30.929542244111026,0.6749387254901962,40.14880952380952,1039.404761904761,30.5707282913165,0
4160,4,0,0,37,0.0,0.0,1.0,37,750,600,150,0.8,9,6,3,354.2333655878494,0.7118368368368369,0.06218723017074068,0.2296599837920332,135107.15880102033,2171.89271541949,137279.05151643982,4122,4,872.1891891891892,34,3,19,30.882381006908652,0.6755514705882353,40.08928571428571,1039.6428571428567,30.57773109243696,0
4161,4,0,0,37,0.0,0.0,1.0,37,1000,500,500,0.5,15,5,10,352.35479318704506,0.711524024024024,0.062005909744891285,0.22883413520363094,135169.04939058947,2125.4924886621184,137294.5418792516,4123,5,873.1891891891892,34,3,19,30.86958595687845,0.6761642156862746,40.0297619047619,1039.8809523809516,30.5847338935574,0
4162,4,0,0,37,0.0,0.0,1.0,37,800,500,300,0.625,11,5,6,351.05601050442255,0.7102727727727728,0.060994052755123596,0.22877542697972733,135292.87308673444,2099.0752551020096,137391.94834183645,4124,6,874.1891891891892,34,3,19,30.780123583934095,0.677389705882353,39.91071428571427,1040.3571428571408,30.59873949579826,0
4163,4,0,0,37,0.0,0.0,1.0,37,700,200,500,0.2857142857142857,12,2,10,352.79286166864784,0.7105855855855856,0.05928010390252969,0.2301051948495507,135323.83786848062,2148.2568027210705,137472.0946712017,4125,7,875.1891891891892,34,3,19,30.704138062547674,0.6776960784313726,39.88095238095237,1040.4761904761895,30.602240896358513,0
4164,4,0,0,37,0.0,0.0,1.0,37,1150,700,450,0.6086956521739131,16,7,9,353.39065066182445,0.7090215215215215,0.06760774037243311,0.23169075192566063,135509.7009637186,2177.572278911543,137687.27324263015,4126,8,876.1891891891892,34,3,19,30.50370645628479,0.6795343137254903,39.70238095238094,1041.1904761904746,30.62324929971984,0
4165,4,0,0,37,0.0,0.0,1.0,37,950,700,250,0.7368421052631579,12,7,5,356.8280183229564,0.7097722722722722,0.07158409695262669,0.23495876511242955,135664.68431122438,2281.792091836725,137946.4764030611,4127,9,877.1891891891892,34,3,20,30.26011312992801,0.6810661764705883,39.55357142857142,1041.7857142857135,30.640756302520987,0
4166,4,0,0,37,0.0,0.0,1.0,37,1050,800,250,0.7619047619047619,13,8,5,347.89727186382106,0.7097722722722722,0.024711466582390873,0.20991847598078867,132457.56842635458,1820.4211436374949,134277.9895699921,4128,10,878.1891891891892,35,2,19,33.69734277790271,0.6470238095238094,42.65046296296296,1029.398148148148,29.411375661375658,8
4167,4,1,1,37,0.02631578947368421,0.02631578947368421,0.9736842105263158,38,1100,700,400,0.6363636363636364,15,7,8,339.1874649013687,0.7196242294926506,0.02422801074372094,0.20623950108388212,132745.92318247302,1405.1506320509736,134151.073814524,4129,0,856.0526315789474,36,2,17,33.63202564382763,0.6478587962962963,42.3704954954955,1030.5180180180182,28.625500500500507,0
4168,4,0,0,37,0.0,0.0,1.0,37,1500,1200,300,0.8,18,12,6,349.4352948152634,0.7090215215215215,0.029021944087666673,0.2120193291854571,132666.15125868042,1871.6471354166479,134537.79839409707,4130,12,880.1891891891892,35,2,17,33.44813784967981,0.6491071428571429,42.44791666666666,1030.2083333333321,29.434523809523775,0
4169,4,0,0,37,0.0,0.0,1.0,37,800,600,200,0.75,10,6,4,348.20140021986714,0.7098348348348348,0.022446123535644125,0.2116066256762781,132725.7764944486,1843.0602441272179,134568.8367385758,4131,13,881.1891891891892,35,2,17,33.42003163727584,0.649702380952381,42.39004629629629,1030.4398148148139,29.441137566137538,0
4170,4,0,0,37,0.0,0.0,1.0,37,1000,800,200,0.8,12,8,4,351.1790920005206,0.7103353353353353,0.02547040135453771,0.21409665793625154,132845.0671537422,1930.4820119598646,134775.54916570205,4132,14,882.1891891891892,35,2,17,33.22351801953519,0.6508928571428572,42.27430555555555,1030.902777777777,29.454365079365054,0
4171,4,0,1,36,0.0,0.02702702702702703,0.972972972972973,37,600,400,200,0.6666666666666666,8,4,4,351.1790920005206,0.7103353353353353,0.02547040135453771,0.21409665793625154,132845.0671537422,1930.4820119598646,134775.54916570205,4133,15,883.1891891891892,35,2,17,33.22351801953519,0.6508928571428572,42.27430555555555,1030.902777777777,29.454365079365054,0
4172,4,1,0,37,0.02702702702702703,0.0,1.0,37,800,600,200,0.75,10,6,4,350.0324441317868,0.7073323323323323,0.03473765281822927,0.21415812664014927,132978.12328798388,1909.331502110211,134887.45479009408,4134,0,883.6216216216217,36,1,18,33.11951814244641,0.6501736111111112,42.14527027027027,1031.4189189189185,28.650525525525513,0
4173,4,0,0,37,0.0,0.0,1.0,37,800,600,200,0.75,10,6,4,351.65678916089036,0.7060185185185185,0.03432509129955119,0.21565458516011216,133065.2506391526,1958.6597577306957,135023.9103968833,4135,1,884.6216216216217,36,1,18,32.990204103907445,0.6510416666666667,42.06081081081081,1031.7567567567562,28.659909909909896,0
4174,4,0,0,37,0.0,0.0,1.0,37,600,600,0,1.0,6,6,0,352.25850075476103,0.7053928928928929,0.036087156558566535,0.21636038209896988,133123.35139193246,1978.7664353542693,135102.11782728674,4136,2,885.6216216216217,36,1,19,32.916393860032,0.6516203703703705,42.0045045045045,1031.9819819819818,28.66616616616616,0
4175,4,0,0,37,0.0,0.0,1.0,37,1000,800,200,0.8,12,8,4,357.00204235460285,0.706519019019019,0.033710813464276734,0.2197876240607552,133210.52629910313,2111.285990382271,135321.81228948542,4137,3,886.6216216216217,36,1,19,32.70653794407476,0.6524884259259259,41.92004504504504,1032.3198198198197,28.675550550550547,0
4176,4,0,1,36,0.0,0.02702702702702703,0.972972972972973,37,850,600,250,0.7058823529411765,11,6,5,357.09945070038964,0.7066441441441441,0.033953255327301424,0.22036352374983667,133297.72973987498,2120.109213943669,135417.83895381866,4138,4,887.6216216216217,36,1,19,32.61654852780808,0.6533564814814815,41.835585585585584,1032.6576576576574,28.68493493493493,0
4177,4,0,0,36,0.0,0.0,1.0,36,950,700,250,0.7368421052631579,12,7,5,368.54261252758164,0.7087632275132275,0.030654561757453846,0.22739537959689365,133292.88435570977,2624.821566358012,135917.70592206778,4139,5,856.5833333333334,35,1,19,32.325991930060525,0.655357142857143,41.84027777777777,1032.638888888888,29.503968253968228,0
4178,4,0,0,36,0.0,0.0,1.0,36,950,700,250,0.7368421052631579,12,7,5,367.0644728479629,0.7091931216931218,0.030336134453781805,0.22703052114816816,133382.53821855693,2591.998215663565,135974.5364342205,4140,6,857.5833333333334,35,1,19,32.27415966386555,0.65625,41.753472222222214,1032.98611111111,29.513888888888857,0
4179,4,0,0,36,0.0,0.0,1.0,36,850,600,250,0.7058823529411765,11,6,5,369.73204994797084,0.7094907407407408,0.028449820788530644,0.22923387096774206,133472.22222222228,2669.8519483024793,136142.07417052475,4141,7,858.5833333333334,33,3,19,32.115255376344095,0.6616161616161615,41.66666666666667,1033.333333333334,31.313131313131333,0
4180,4,0,0,36,0.0,0.0,1.0,36,850,700,150,0.8235294117647058,10,7,3,369.73204994797084,0.7094907407407408,0.028449820788530644,0.22923387096774206,133472.22222222228,2669.791666666677,136142.01388888896,4142,8,859.5833333333334,33,3,19,32.115255376344095,0.6616161616161615,41.66666666666667,1033.333333333334,31.313131313131333,0
4181,4,0,0,36,0.0,0.0,1.0,36,1350,1000,350,0.7407407407407407,17,10,7,368.75082326936206,0.7081679894179894,0.030403892349660344,0.22923029537632986,133570.09369260777,2650.816402662977,136220.91009527075,4143,9,860.5833333333334,32,4,20,32.0424148039575,0.6650390625,41.57196969696969,1033.71212121212,32.30350378787875,0
4182,4,0,0,36,0.0,0.0,1.0,36,850,600,250,0.7058823529411765,11,6,5,370.60204752512436,0.7083333333333334,0.03817663817663841,0.23099168715607082,133668.00103305795,2707.5269742883524,136375.5280073463,4144,10,861.5833333333334,32,4,20,31.896367521367537,0.666015625,41.477272727272734,1034.09090909091,32.315340909090935,0
4183,4,0,0,36,0.0,0.0,1.0,36,550,300,250,0.5454545454545454,8,3,5,372.21670150756825,0.707473544973545,0.0382080078125,0.23240847703887207,133733.29252117142,2755.553004795439,136488.84552596687,4145,11,862.5833333333334,32,4,20,31.789143880208336,0.6666666666666666,41.41414141414142,1034.343434343435,32.32323232323235,0
4184,4,0,0,36,0.0,0.0,1.0,36,850,700,150,0.8235294117647058,10,7,3,370.5453349394108,0.7073412698412699,0.03667317549426419,0.23177469270942985,133798.5999515355,2715.689406693186,136514.28935822868,4146,12,863.5833333333334,32,4,20,31.766892441623945,0.6673177083333334,41.3510101010101,1034.5959595959591,32.33112373737372,0
4185,4,0,0,36,0.0,0.0,1.0,36,750,500,250,0.6666666666666666,10,5,5,371.4289082915136,0.7068783068783069,0.03491540588905151,0.2327393984982606,133863.92332415076,2744.186179981652,136608.10950413242,4147,13,864.5833333333334,32,4,20,31.67856271351878,0.66796875,41.287878787878796,1034.8484848484861,32.33901515151519,0
4186,4,0,0,36,0.0,0.0,1.0,36,1250,1000,250,0.8,15,10,5,370.63550561279436,0.7049272486772488,0.027987728066967588,0.2336912415481748,134092.68067352832,2739.9017000816366,136832.58237360994,4148,14,865.5833333333334,32,4,20,31.469939859401038,0.6702473958333333,41.0669191919192,1035.732323232324,32.366635101010125,0
4187,4,0,0,36,0.0,0.0,1.0,36,950,700,250,0.7368421052631579,12,7,5,371.11063314910524,0.7048280423280424,0.02574060931051725,0.23448200991349297,134169.6177551903,2758.354358900423,136927.97211409072,4149,15,866.5833333333334,33,3,20,31.380608784796152,0.6685606060606061,40.99264705882353,1036.0294117647059,31.39483065953654,0
4188,4,0,0,36,0.0,0.0,1.0,36,700,200,500,0.2857142857142857,12,2,10,362.97555292360516,0.7039351851851853,0.017560517128936803,0.22673577134099243,133749.1514314058,2509.5344387754994,136258.6858701813,4150,16,867.5833333333334,34,2,18,32.01221851382975,0.6620710784313726,41.39880952380952,1034.4047619047612,30.423669467787096,1
4189,4,0,0,36,0.0,0.0,1.0,36,1350,1100,250,0.8148148148148148,16,11,5,362.7596293782063,0.7010912698412699,0.02147641141659329,0.2273590092418706,133872.32320011326,2512.6948696144987,136385.01806972775,4151,17,868.5833333333334,34,2,19,31.894436136354912,0.663296568627451,41.2797619047619,1034.8809523809516,30.43767507002799,0
4190,4,0,0,36,0.0,0.0,1.0,36,1000,600,400,0.6,14,6,8,360.12426007739055,0.7016203703703704,0.016445645369412176,0.2264642581267582,133995.55165816328,2451.009778911564,136446.56143707485,4152,18,869.5833333333334,34,2,19,31.839283661032532,0.6645220588235294,41.160714285714285,1035.357142857143,30.451680672268907,0
4191,4,0,0,36,0.0,0.0,1.0,36,900,600,300,0.6666666666666666,12,6,6,361.0450521865504,0.701686507936508,0.025415070242656546,0.22761535898717294,134088.0102040815,2482.3625283446527,136570.37273242616,4153,19,870.5833333333334,34,2,19,31.722940613026804,0.6654411764705883,41.07142857142856,1035.7142857142846,30.46218487394955,0
4192,4,0,0,36,0.0,0.0,1.0,36,600,300,300,0.5,9,3,6,360.90853912116575,0.6999338624338625,0.026335107944897684,0.2281036322419392,134180.50063775506,2485.3776927437584,136665.87833049882,4154,20,871.5833333333334,34,2,19,31.633967214370514,0.666360294117647,40.982142857142854,1036.0714285714282,30.472689075630242,0
4193,4,0,0,36,0.0,0.0,1.0,36,1100,1000,100,0.9090909090909091,12,10,2,363.07134521939986,0.6997685185185185,0.0338137896711459,0.2302448800309768,134303.8708191608,2552.377409297029,136856.24822845784,4155,21,872.5833333333334,34,2,19,31.454576777305615,0.6675857843137256,40.86309523809523,1036.5476190476174,30.4866946778711,0
4194,4,0,0,36,0.0,0.0,1.0,36,1000,900,100,0.9,11,9,2,360.88087902191637,0.7006944444444445,0.04039273460120674,0.229629900449957,134427.2976899092,2502.448270975045,136929.74596088426,4156,22,873.5833333333334,34,2,20,31.387996020357406,0.6688112745098039,40.74404761904761,1037.0238095238087,30.50070028011202,0
4195,4,0,0,36,0.0,0.0,1.0,36,850,500,350,0.5882352941176471,12,5,7,372.5502824403924,0.7013227513227513,0.038787138787138575,0.23220599795942246,133668.00103305775,2759.7236863064627,136427.72471936423,4157,23,874.5833333333334,32,4,20,31.84600122100122,0.666015625,41.47727272727272,1034.0909090909083,32.315340909090885,1
4196,4,0,0,36,0.0,0.0,1.0,36,800,300,500,0.375,13,3,10,371.0900182689622,0.701223544973545,0.03819571616543915,0.23150025435194743,133700.6447843333,2722.994943118053,136423.63972745134,4158,24,875.5833333333334,32,4,19,31.851015342042082,0.6663411458333334,41.44570707070707,1034.217171717172,32.31928661616163,0
4197,4,0,0,36,0.0,0.0,1.0,36,600,400,200,0.6666666666666666,8,4,4,372.8941457015528,0.701223544973545,0.0657589803012748,0.22193630878651074,131938.95266439934,2639.8526077097804,134578.80527210914,4159,25,876.5833333333334,34,2,20,33.577153341058334,0.6439950980392155,43.15476190476192,1027.3809523809543,30.21708683473395,3
4198,4,0,0,36,0.0,0.0,1.0,36,900,800,100,0.8888888888888888,10,8,2,372.10688230987626,0.701388888888889,0.06535550148688829,0.22164627337588316,131969.53125000026,2621.354166666696,134590.88541666695,4160,26,877.5833333333334,34,2,20,33.56650446066505,0.6443014705882352,43.125000000000014,1027.500000000002,30.220588235294176,0
4199,4,0,0,36,0.0,0.0,1.0,36,600,200,400,0.3333333333333333,10,2,8,373.96180149597893,0.7002314814814815,0.06774895117494162,0.22329088479365733,132061.28826530624,2677.1754535147516,134738.463718821,4161,27,878.5833333333334,34,2,20,33.42623156513011,0.645220588235294,43.03571428571429,1027.8571428571438,30.23109243697482,0
4200,4,0,0,36,0.0,0.0,1.0,36,650,400,250,0.6153846153846154,9,4,5,372.8077748782995,0.7013558201058202,0.06374252074889042,0.22278167031654797,132091.88102324272,2648.9760487528465,134740.85707199556,4162,28,879.5833333333334,34,2,20,33.42501447596988,0.6455269607843137,43.00595238095239,1027.9761904761913,30.234593837535037,0
4201,4,0,0,36,0.0,0.0,1.0,36,1100,800,300,0.7272727272727273,14,8,6,379.26572866500925,0.7008597883597885,0.07526622114059833,0.22554679342869502,131908.3776218821,2806.019699546486,134714.39732142858,4163,29,880.5833333333334,34,2,18,33.44439293854059,0.6436887254901961,43.18452380952381,1027.2619047619048,30.21358543417367,1
4202,4,0,0,36,0.0,0.0,1.0,36,850,600,250,0.7058823529411765,11,6,5,401.8906337351881,0.7008597883597885,0.10481776230346229,0.2210673376537883,128880.67065860634,3169.3094721436264,132049.98013074996,4164,30,881.5833333333334,32,4,19,35.946955566608636,0.6178385416666666,46.1489898989899,1015.404040404041,31.73137626262628,7
4203,4,1,1,36,0.02702702702702703,0.02702702702702703,0.972972972972973,37,1300,900,400,0.6923076923076923,17,9,8,394.72584292468747,0.7152777777777778,0.09238305550669956,0.21923929347985674,129263.69214965412,2804.743968665915,132068.43611832004,4165,0,858.7297297297297,33,4,20,35.737024985940394,0.6193181818181817,45.77205882352942,1016.9117647058835,30.815508021390407,0
4204,4,3,0,39,0.07692307692307693,0.0,1.0,39,800,600,200,0.75,10,6,4,384.01442157113286,0.7330746738641476,0.058482545407702924,0.20516888882702716,127716.42261081276,2049.3887561415345,129765.8113669543,4166,0,815.6153846153846,31,8,22,37.594062647601866,0.6085349462365591,47.298177083333336,1010.8072916666671,32.606686827957006,7
4205,4,2,1,40,0.04878048780487805,0.024390243902439025,0.975609756097561,41,900,600,300,0.6666666666666666,12,6,6,361.888847415878,0.7601117886178862,0.05831894560221773,0.1962024399773653,128304.38220589745,1087.1013143551424,129391.48352025259,4167,0,776.780487804878,32,9,23,37.55114863742107,0.6119791666666666,46.71717171717172,1013.1313131313138,31.660353535353558,0
4206,4,1,1,40,0.024390243902439025,0.024390243902439025,0.975609756097561,41,1050,800,250,0.7619047619047619,13,8,5,361.7939575905425,0.7533536585365853,0.06261276311393282,0.19709670823962386,128496.3348765432,1097.8395061728409,129594.17438271604,4168,0,777.7560975609756,32,9,17,37.35730593607306,0.6139322916666666,46.52777777777778,1013.8888888888888,31.684027777777775,0
4207,4,4,4,40,0.09090909090909091,0.09090909090909091,0.9090909090909091,44,1300,800,500,0.6153846153846154,18,8,10,337.0353336567042,0.7751717758985202,0.0799060202847306,0.1881620119900569,129466.28146701373,-73.0577256944643,129393.22374131926,4169,0,725.6363636363636,35,9,17,36.99782497441146,0.6169642857142857,45.57291666666666,1017.708333333332,29.077380952380913,0
4208,4,2,0,42,0.047619047619047616,0.0,1.0,42,1100,800,300,0.7272727272727273,14,8,6,359.3953641505119,0.7563637243515292,0.09576005781739383,0.20024834316627826,129388.34372597063,900.314182045351,130288.65790801597,4170,0,761.0714285714286,33,9,23,36.508271099333506,0.6205808080808082,45.64950980392156,1017.4019607843125,30.830362448009467,0
4209,4,2,3,41,0.045454545454545456,0.06818181818181818,0.9318181818181819,44,1150,800,350,0.6956521739130435,15,8,7,344.2757242973674,0.775722339675828,0.08740424916895484,0.19409039873000086,129849.38298396753,140.79807527431973,129990.18105924185,4171,0,727.4318181818181,35,9,18,36.424502233325754,0.6208333333333336,45.196759259259245,1019.212962962961,29.120370370370313,0
4210,4,2,0,43,0.046511627906976744,0.0,1.0,43,1050,600,450,0.5714285714285714,15,6,9,357.54515321589884,0.7621354743447767,0.09900042774488416,0.19337389700105917,128206.57920030743,584.6730995260439,128791.25229983348,4172,0,745.2790697674419,33,10,21,37.76117295901905,0.6085858585858586,46.81372549019607,1012.7450980392146,30.689245395127713,7
4211,4,1,1,43,0.022727272727272728,0.022727272727272728,0.9772727272727273,44,1700,1400,300,0.8235294117647058,20,14,6,351.28995435552895,0.7696661381254405,0.09831760536316647,0.19127782936647603,128476.21882086166,226.48100907028686,128702.69982993194,4173,0,729.3181818181819,34,10,18,37.64409151401282,0.6090686274509804,46.547619047619044,1013.8095238095236,29.81792717086834,0
4212,4,2,1,44,0.044444444444444446,0.022222222222222223,0.9777777777777777,45,1200,800,400,0.6666666666666666,16,8,8,345.7973889945639,0.775462962962963,0.10041302419865672,0.1897774156121605,128789.87295310356,-92.95964077503784,128696.91331232853,4174,0,714.0666666666667,35,10,20,37.46341695172936,0.6101190476190477,46.238425925925924,1015.0462962962963,29.00132275132275,0
4213,4,1,0,45,0.022222222222222223,0.0,1.0,45,1550,1200,350,0.7741935483870968,19,12,7,345.8674023996115,0.7771885521885522,0.10521129709689792,0.19082995945240921,129001.10995708527,-76.54423849526853,128924.56571859,4175,0,715.0444444444445,36,9,22,37.24642500831394,0.6102430555555557,46.030405405405396,1015.8783783783767,28.2188438438438,0
4214,4,0,0,45,0.0,0.0,1.0,45,950,500,450,0.5263157894736842,14,5,9,343.4435970630653,0.7763047138047139,0.10564788833729089,0.18965127356295333,129034.22807979357,-136.80411280396055,128897.4239669896,4176,1,716.0444444444445,37,8,22,37.27426433556371,0.6086711711711712,45.99780701754385,1016.0087719298227,27.459696538643858,0
4215,4,1,0,46,0.021739130434782608,0.0,1.0,46,1950,1600,350,0.8205128205128205,23,16,7,333.68289491466464,0.7811392914653784,0.10900716479017358,0.18629039333235833,129466.28146701366,-559.5386621364603,128906.7428048772,4177,0,701.4565217391304,35,11,16,37.08312009553052,0.6169642857142859,45.57291666666665,1017.7083333333314,29.0773809523809,0
4216,4,4,3,47,0.08,0.06,0.94,50,1000,700,300,0.7,13,7,6,310.03748438150774,0.804047619047619,0.11714285714285677,0.1766492643569052,130262.58680555529,-1920.3016493055902,128342.2851562497,4178,0,646.26,38,12,17,36.87925170068025,0.6192434210526316,44.79166666666665,1020.8333333333312,26.86403508771924,0
4217,4,0,2,45,0.0,0.0425531914893617,0.9574468085106383,47,1250,900,350,0.72,16,9,7,329.0541729119787,0.7883132901634289,0.1264562587692808,0.18583452447736365,129917.93894823863,-849.9920105916901,129067.94693764694,4179,1,688.5106382978723,36,11,17,36.74288449501086,0.6195023148148149,45.129504504504496,1019.4819819819808,28.31894394394391,0
4218,4,1,2,44,0.021739130434782608,0.043478260869565216,0.9565217391304348,46,1050,500,550,0.47619047619047616,16,5,11,340.0843632493271,0.7841183574879227,0.1379295878227309,0.19216184450694815,129937.8714018561,-362.03234846536606,129575.83905339074,4180,0,704.2173913043479,35,11,18,36.44154179437696,0.6217261904761905,45.1099537037037,1019.5601851851849,29.130291005290996,0
4219,4,1,1,44,0.022222222222222223,0.022222222222222223,0.9777777777777777,45,1050,900,150,0.8571428571428571,12,9,3,348.0659956898558,0.7790404040404041,0.12655164803780283,0.19586435615446898,129776.92920918351,34.18721655326408,129811.11642573678,4181,0,720.4222222222222,34,11,19,36.40149744907893,0.6222426470588236,45.26785714285713,1018.9285714285701,29.968487394957943,0
4220,4,0,0,44,0.0,0.0,1.0,44,1250,900,350,0.72,16,9,7,356.72315318240595,0.770392882311487,0.1314588410226758,0.20080502817250023,129790.40745027439,459.8486796982239,130250.25612997261,4182,2,737.7954545454545,35,9,19,36.16727245191581,0.6202380952380953,45.25462962962963,1018.9814814814818,29.11375661375662,0
4221,4,1,1,44,0.022222222222222223,0.022222222222222223,0.9777777777777777,45,1200,900,300,0.75,15,9,6,344.82381377035097,0.7792087542087542,0.132352219769438,0.1957458491703874,130118.92804967148,-26.37899724046315,130092.54905243102,4183,0,722.3777777777777,36,9,20,36.1370952906549,0.6215277777777777,44.93243243243244,1020.2702702702718,28.340840840840883,0
4222,4,0,0,44,0.0,0.0,1.0,44,900,500,400,0.5555555555555556,13,5,8,343.7483362863978,0.7786513389711065,0.12761234461377957,0.19527922727843594,130147.65346004798,147.6078696940338,130295.26132974202,4184,1,727.4318181818181,36,8,20,36.13540632012657,0.6218171296296295,44.90427927927929,1020.3828828828836,28.343968968968987,0
4223,4,1,0,45,0.022222222222222223,0.0,1.0,45,1400,800,600,0.5714285714285714,20,8,12,335.95273190059896,0.7891414141414141,0.14388852153895137,0.1926950119637189,130521.37230135537,-230.14695438682463,130291.22534696854,4185,0,712.2444444444444,36,9,17,35.955982293732994,0.6255787037037037,44.538288288288285,1021.8468468468466,28.384634634634626,0
4224,4,1,1,45,0.021739130434782608,0.021739130434782608,0.9782608695652174,46,1150,800,350,0.6956521739130435,15,8,7,325.2955376608243,0.7947866344605475,0.14660862107539652,0.18776960243194127,130766.77439212073,-692.4303631886698,130074.34402893206,4186,0,697.7391304347826,37,9,17,35.98038164665521,0.6261261261261261,44.29824561403509,1022.8070175438603,27.643432906590817,0
4225,4,0,0,45,0.0,0.0,1.0,45,1100,900,200,0.8181818181818182,13,9,4,337.66614000406764,0.7877525252525253,0.15604742502661173,0.19468864872234543,130722.82745160708,-171.86548879960816,130550.96196280747,4187,2,714.2444444444444,36,9,17,35.708484748375724,0.6276041666666666,44.34121621621622,1022.6351351351357,28.406531531531545,0
4226,4,0,1,44,0.0,0.022222222222222223,0.9777777777777777,45,1400,900,500,0.6428571428571429,19,9,10,324.04798223977696,0.7871632996632997,0.14508924399588774,0.17920607017818377,129092.7934838192,-633.5481499744237,128459.24533384478,4188,3,715.2444444444444,38,7,17,37.70741344266891,0.6074561403508771,45.940170940170944,1016.239316239317,26.743139901034656,4
4227,4,1,0,45,0.022222222222222223,0.0,1.0,45,1450,1100,350,0.7586206896551724,18,11,7,322.92063555818083,0.7921717171717172,0.14598246370561974,0.1795810440909886,129312.88954293646,-648.3942474890728,128664.49529544738,4189,0,715.7333333333333,37,8,19,37.512577260313336,0.6114864864864864,45.72368421052632,1017.1052631578962,27.489331436699896,0
4228,4,1,2,44,0.021739130434782608,0.043478260869565216,0.9565217391304348,46,1450,1100,350,0.7586206896551724,18,11,7,318.24202734116966,0.7990942028985507,0.14657264317903973,0.17844017674211962,129636.22708013754,-948.8608554313446,128687.3662247062,4190,0,701.1521739130435,38,8,15,37.30373129108967,0.612938596491228,45.40598290598292,1018.37606837607,26.799370220422894,0
4229,4,0,0,44,0.0,0.0,1.0,44,900,500,400,0.5555555555555556,13,5,8,332.74712252312605,0.7826594432699084,0.14097854094532614,0.18505985287123639,129315.90374157965,-194.10102670234755,129121.8027148773,4191,6,734.0,36,8,19,37.259650870977275,0.6134259259259258,45.720720720720735,1017.117117117119,28.253253253253305,0
4230,4,1,1,44,0.022222222222222223,0.022222222222222223,0.9777777777777777,45,1450,1000,450,0.6896551724137931,19,10,9,322.6580044379456,0.7931397306397306,0.13676906881041284,0.18096905466302188,129647.68005540184,-633.6276546629476,129014.05240073889,4192,0,718.6666666666666,37,8,16,37.17969422911284,0.6148648648648647,45.394736842105274,1018.4210526315803,27.524893314367034,0
4231,4,0,0,44,0.0,0.0,1.0,44,1200,800,400,0.6666666666666666,16,8,8,330.5163555925571,0.7821088794926004,0.13634603586478722,0.18475802957335383,129516.42679419323,-238.54052532258123,129277.88626887066,4193,8,736.0,36,8,16,37.11278902533464,0.6154513888888888,45.52364864864867,1017.9054054054086,28.27515015015024,0
4232,4,2,1,45,0.043478260869565216,0.021739130434782608,0.9782608695652174,46,1000,700,300,0.7,13,7,6,317.2899413380025,0.7971014492753623,0.1431967862705985,0.1796470806650399,130017.30974687707,-949.3630834976925,129067.94666337938,4194,0,704.9565217391304,38,8,17,36.94217473287242,0.6167763157894737,45.032051282051285,1019.8717948717949,26.838731443994604,0
4233,4,0,0,45,0.0,0.0,1.0,45,1300,800,500,0.6153846153846154,18,8,10,323.0446265145982,0.7887626262626263,0.13221605390873248,0.18303305930770766,130044.55133912292,-597.9612964788932,129446.59004264402,4195,1,721.6222222222223,38,7,17,36.76787647079364,0.6170504385964911,45.005341880341895,1019.9786324786346,26.84154295996407,0
4234,4,2,1,46,0.0425531914893617,0.02127659574468085,0.9787234042553191,47,1200,800,400,0.6666666666666666,16,8,8,310.2570994414119,0.8028060437866172,0.1361285620075663,0.1777454223902671,130475.34722222245,-1303.636816056667,129171.71040616579,4196,0,691.8723404255319,39,8,19,36.65884991843392,0.6196581196581196,44.58333333333334,1021.6666666666684,26.196581196581242,0
4235,4,0,0,46,0.0,0.0,1.0,46,1150,800,350,0.6956521739130435,15,8,7,317.32240427171314,0.7964371980676329,0.13711867259172972,0.18130812088662945,130371.67302441764,-926.0294533932126,129445.64357102443,4197,1,707.9130434782609,38,8,19,36.58310667085121,0.6203399122807016,44.68482905982907,1021.2606837606855,26.875281151596987,0
4236,4,2,1,47,0.041666666666666664,0.020833333333333332,0.9791666666666666,48,1400,1200,200,0.8571428571428571,16,12,4,302.9638607207344,0.8090277777777778,0.15222194637537267,0.17553774899066732,130911.78882444324,-1667.6918087778286,129244.09701566541,4198,0,679.375,40,8,16,36.40537073816618,0.6223958333333333,44.15650406504066,1023.3739837398383,25.584349593495958,0
4237,4,0,0,47,0.0,0.0,1.0,47,1200,1000,200,0.8333333333333334,14,10,4,313.31017296225485,0.8031529448041936,0.15624499062027497,0.1812327749608521,130848.09570312501,-1200.792100694444,129647.30360243058,4199,1,694.7872340425532,39,8,16,36.204863232199806,0.6233974358974359,44.21875,1023.1250000000001,26.23397435897436,0
4238,4,0,2,45,0.0,0.0425531914893617,0.9574468085106383,47,800,600,200,0.75,10,6,4,311.05104563443643,0.8033071230342275,0.15614387691454734,0.18017485096183403,130901.38888888899,-1256.5972222222117,129644.79166666677,4200,2,695.7872340425532,39,8,16,36.20894408251899,0.6239316239316239,44.16666666666667,1023.3333333333342,26.23931623931626,0
4239,4,0,0,45,0.0,0.0,1.0,45,900,500,400,0.5555555555555556,13,5,8,318.8893285846195,0.7927188552188552,0.1581592871066555,0.18440122044241034,130835.79881656799,-655.5719921104615,130180.22682445752,4201,3,721.6444444444444,38,7,16,36.07456140350877,0.625,44.230769230769226,1023.0769230769225,26.92307692307691,0
4240,4,3,0,48,0.0625,0.0,1.0,48,1100,700,400,0.6363636363636364,15,7,8,330.93586421806367,0.812463061465721,0.24688807531380808,0.18921930992372493,130398.9517130539,-915.7405124552965,129483.21120059861,4202,0,677.4791666666666,38,10,16,36.20794107391912,0.6206140350877194,44.65811965811964,1021.3675213675183,26.87809266756627,3
4241,4,1,3,46,0.02040816326530612,0.061224489795918366,0.9387755102040817,49,1400,900,500,0.6428571428571429,19,9,10,326.86849605686774,0.8189838435374149,0.2396088019559901,0.1882946688552942,130688.28125,-1256.4236111111118,129431.85763888889,4203,0,664.6326530612245,39,10,13,36.01942406954632,0.6217948717948718,44.375,1022.5,26.21794871794872,0
4242,4,1,0,47,0.02127659574468085,0.0,1.0,47,950,700,250,0.7368421052631579,12,7,5,340.96662728058243,0.8082022818378044,0.2471876748780848,0.1949726294118247,130402.54122662735,-507.4170658279563,129895.12416079939,4204,0,693.8510638297872,37,10,16,35.94817945965289,0.6224662162162162,44.65460526315789,1021.3815789473679,27.604907539118052,0
4243,4,1,2,46,0.020833333333333332,0.041666666666666664,0.9583333333333334,48,1000,600,400,0.6,14,6,8,333.3788912689715,0.8144023345153664,0.2464354257957131,0.1916489197435512,130608.41064453126,-891.582573784722,129716.82807074655,4205,0,680.375,39,9,13,35.933731614524945,0.6209935897435898,44.453125,1022.1875000000001,26.2099358974359,0
4244,4,0,0,46,0.0,0.0,1.0,46,950,500,450,0.5263157894736842,14,5,9,346.9605721437181,0.7990338164251208,0.2494454899067493,0.1978291419001933,130290.57167830471,-158.86174111266655,130131.70993719205,4206,4,710.9347826086956,37,9,15,35.90858035298752,0.6213400900900901,44.764254385964904,1020.9429824561391,27.593053579895653,0
4245,4,1,0,47,0.02127659574468085,0.0,1.0,47,650,300,350,0.46153846153846156,10,3,7,331.526284522825,0.8066990440949737,0.2151187277612372,0.18467148548514772,129377.9538001543,-821.5615354938275,128556.39226466046,4207,0,696.7872340425532,41,6,18,37.22767349260523,0.6054369918699187,45.65972222222222,1017.361111111111,24.813685636856366,4
4246,4,1,2,46,0.020833333333333332,0.041666666666666664,0.9583333333333334,48,1350,900,450,0.6666666666666666,18,9,9,326.53954659920464,0.8116504137115839,0.21653031456113658,0.18336451462878392,129694.42942130865,-1129.927964064679,128564.50145724397,4208,0,683.25,42,6,14,37.03346968543886,0.6071428571428572,45.34883720930232,1018.6046511627893,24.252491694352127,0
4247,4,1,0,47,0.02127659574468085,0.0,1.0,47,1150,800,350,0.6956521739130435,15,8,7,331.5827966016053,0.8060437866173296,0.216981073424668,0.18613234405186846,129680.91699932252,-800.0077751008181,128880.9092242217,4209,0,698.7446808510638,41,6,15,36.91874857959155,0.6084857723577237,45.362103174603156,1018.5515873015845,24.84272164150206,0
4248,4,0,1,46,0.0,0.02127659574468085,0.9787234042553191,47,1000,800,200,0.8,12,8,4,332.5840097314099,0.8060437866173296,0.21870765916012358,0.1870557382224302,129756.7131598008,-768.9984095490216,128987.71475025178,4210,1,699.7446808510638,41,6,15,36.816374553716315,0.6092479674796749,45.287698412698404,1018.849206349205,24.84998064266354,0
4249,4,0,0,46,0.0,0.0,1.0,46,1050,700,350,0.6666666666666666,14,7,7,334.7307139577236,0.7998389694041869,0.22525051925019834,0.18845282812207145,129796.16057117115,-510.64770060811475,129285.51287056303,4211,2,715.695652173913,40,6,15,36.72168478441541,0.6111979166666668,45.24898373983739,1019.0040650406495,25.475101626016237,0
4250,4,0,0,46,0.0,0.0,1.0,46,1300,900,400,0.6923076923076923,17,9,8,333.6941892256429,0.8007447665056361,0.22306718737132347,0.18836727136310755,129899.73855054844,-530.64241275036,129369.09613779809,4212,3,716.695652173913,40,6,15,36.64307313993289,0.6122395833333334,45.14735772357723,1019.4105691056897,25.48526422764224,0
4251,4,0,0,46,0.0,0.0,1.0,46,1000,700,300,0.7,13,7,6,340.8722187838335,0.8009057971014493,0.22657004830917926,0.19293021519998677,130003.35784131452,-337.0933926565005,129666.26444865801,4213,4,717.695652173913,40,6,15,36.355048995183544,0.6132812500000002,45.04573170731707,1019.8170731707303,25.495426829268258,0
4252,4,1,0,47,0.02127659574468085,0.0,1.0,47,1050,700,350,0.6666666666666666,14,7,7,334.6938775510207,0.8068146777674992,0.22127659574468095,0.1906976744186046,130262.58680555534,-679.8655520854184,129582.72125346992,4214,0,703.4042553191489,39,8,17,36.25,0.6175213675213677,44.79166666666666,1020.8333333333317,26.175213675213634,0
4253,4,2,1,48,0.04081632653061224,0.02040816326530612,0.9795918367346939,49,1250,800,450,0.64,17,8,9,322.56876028746666,0.8203656462585034,0.22217910158145004,0.18584215831654066,130693.35322381239,-1368.4814145565906,129324.8718092558,4215,0,675.6530612244898,41,8,14,36.12421574334595,0.61864837398374,44.37003968253967,1022.5198412698389,24.939508323654607,0
4254,4,0,1,47,0.0,0.020833333333333332,0.9791666666666666,48,1550,1100,450,0.7096774193548387,20,11,9,331.6725113677039,0.8118720449172576,0.23662873517524763,0.19113910706654252,130703.86860499682,-929.8239308612762,129774.04467413554,4216,1,690.7291666666666,40,8,14,35.88087192738355,0.6203125,44.35975609756097,1022.5609756097545,25.564024390243862,0
4255,4,0,0,47,0.0,0.0,1.0,47,1900,1400,500,0.7368421052631579,24,14,10,338.22901475074616,0.8073543015726179,0.23894733281466718,0.19517986264056833,130755.83316808783,-554.916674928938,130200.91649315889,4217,2,706.3829787234042,40,7,14,35.66072966348701,0.6208333333333333,44.3089430894309,1022.7642276422769,25.569105691056922,0
4256,4,1,1,47,0.020833333333333332,0.020833333333333332,0.9791666666666666,48,1700,1000,700,0.5882352941176471,24,10,14,335.6630675602916,0.8146424349881797,0.2515255714839215,0.19556351633704525,131124.83071932444,-797.247417485547,130327.5833018389,4218,0,692.6458333333334,41,7,15,35.353706573679446,0.6229674796747968,43.94841269841268,1024.2063492063464,24.980642663569427,0
4257,4,2,0,49,0.04081632653061224,0.0,1.0,49,1050,800,250,0.7619047619047619,13,8,5,339.8170501548644,0.8166454081632654,0.2843882089675942,0.20036419228629443,131582.46429358766,-857.049555933498,130725.41473765417,4219,0,679.2857142857143,41,8,15,34.78574421452975,0.6275406504065042,43.50198412698412,1025.9920634920622,25.024196670538103,0
4258,4,0,1,48,0.0,0.02040816326530612,0.9795918367346939,49,1150,800,350,0.6956521739130435,15,8,7,336.7727699183974,0.8149092970521542,0.28770224750124207,0.1993663972034083,131735.18597253715,-927.0353048626889,130808.15066767446,4220,1,680.2857142857143,41,8,15,34.710008375209355,0.6290650406504066,43.3531746031746,1026.5873015873015,25.038714672861012,0
4259,4,1,3,46,0.02040816326530612,0.061224489795918366,0.9387755102040817,49,1200,1000,200,0.8333333333333334,14,10,4,331.53806001598275,0.8199404761904762,0.2874614677098448,0.19776674153709278,132024.2971050416,-1045.7841325641698,130978.51297247743,4221,0,666.0612244897959,42,7,15,34.55355459174051,0.6304563492063493,43.07170542635658,1027.7131782945723,24.469361387966007,0
4260,4,1,1,46,0.02127659574468085,0.02127659574468085,0.9787234042553191,47,1750,1400,350,0.8,21,14,7,338.5913146976359,0.8106305889608387,0.27649056079838785,0.2021554047728388,132058.3037956904,-457.2410602154795,131601.0627354749,4206,0,605.5106382978723,40,7,16,34.33812866653483,0.6338541666666667,43.03861788617886,1027.8455284552845,25.696138211382113,0
4261,4,0,0,46,0.0,0.0,1.0,46,1100,700,400,0.6363636363636364,15,7,8,349.7777523172045,0.8068236714975846,0.2836003437713477,0.2084929019099229,131996.29041883687,33.87315538194946,132030.1635742188,4207,4,619.6739130434783,39,7,16,34.113131441121816,0.6348824786324787,43.098958333333336,1027.6041666666672,26.3488247863248,0
4262,4,0,0,46,0.0,0.0,1.0,46,1050,800,250,0.7619047619047619,13,8,5,350.687737191847,0.8069847020933978,0.28615515425993565,0.2096267279434486,132103.3542209201,65.40527343749437,132168.7594943576,4208,5,620.6739130434783,39,7,17,33.98193417097308,0.6359508547008548,42.994791666666664,1028.020833333333,26.359508547008538,0
4263,4,0,0,46,0.0,0.0,1.0,46,1450,1100,350,0.7586206896551724,18,11,7,351.3052395449449,0.8077697262479872,0.2848761695101818,0.21088992343503518,132264.03130425338,93.00944010416191,132357.04074435754,4209,6,621.6739130434783,39,7,17,33.80432489451478,0.6375534188034189,42.838541666666664,1028.6458333333328,26.375534188034173,0
4264,4,0,0,46,0.0,0.0,1.0,46,1450,1100,350,0.7586206896551724,18,11,7,351.2058317482777,0.8086755233494364,0.2775185577942736,0.21188905378175676,132452.98603121116,103.72004216718068,132556.70607337833,4210,7,622.6739130434783,38,8,18,33.61680505102923,0.6411732456140351,42.65491452991453,1029.3803418803416,27.088956365272146,0
4265,4,0,0,46,0.0,0.0,1.0,46,900,700,200,0.7777777777777778,11,7,4,352.14885338138885,0.8081924315619968,0.2811332503113322,0.21261317989868828,132480.48159105857,130.56993754109857,132611.05152859967,4211,8,623.6739130434783,38,8,18,33.564886882523865,0.6414473684210527,42.62820512820513,1029.48717948718,27.091767881241577,0
4266,4,0,0,46,0.0,0.0,1.0,46,1550,1200,350,0.7741935483870968,19,12,7,349.112949843874,0.8078502415458938,0.27952532287510934,0.21217356025483114,132728.0700402698,67.4176117686007,132795.48765203843,4212,9,624.6739130434783,38,8,15,33.39424572317263,0.6439144736842104,42.387820512820525,1030.44871794872,27.117071524966317,0
4267,4,0,0,46,0.0,0.0,1.0,46,950,600,350,0.631578947368421,13,6,7,351.1740697293531,0.8059983896940419,0.28183817201151684,0.21405423871247817,132838.18354381266,129.86510610710343,132968.04864991977,4213,10,625.6739130434783,38,8,15,33.23055929802743,0.6450109649122806,42.28098290598291,1030.8760683760693,27.128317588843927,0
4268,4,0,0,46,0.0,0.0,1.0,46,1100,600,500,0.5454545454545454,16,6,10,349.828211933226,0.8052737520128824,0.28206417445756404,0.21393756184996138,132961.427137587,102.73166232640904,133064.1587999134,4214,11,626.6739130434783,39,7,16,33.14153873346127,0.6444978632478633,42.16145833333334,1031.3541666666683,26.444978632478676,0
4269,4,0,0,46,0.0,0.0,1.0,46,1500,900,600,0.6,21,9,12,349.7632679183124,0.8037037037037037,0.2844286760392081,0.21457078303169969,133078.7118799162,109.20903149581738,133187.92091141202,4215,12,627.6739130434783,40,6,16,33.02554253258479,0.6440104166666667,42.04776422764228,1031.808943089432,25.7952235772358,0
4270,4,0,0,46,0.0,0.0,1.0,46,1000,600,400,0.6,14,6,8,350.6118053009843,0.8038446054750403,0.2817908556062716,0.21524257986857293,133104.92782900398,133.63180811686675,133238.55963712084,4216,13,628.6739130434783,40,6,16,32.97735703499441,0.6442708333333333,42.02235772357724,1031.9105691056916,25.79776422764229,0
4271,4,0,0,46,0.0,0.0,1.0,46,900,600,300,0.6666666666666666,12,6,6,353.43240493165433,0.8040056360708535,0.2824802770417487,0.21743264305819604,133183.59116803834,214.2793847908141,133397.87055282915,4217,14,629.6739130434783,40,6,17,32.82567851399692,0.6450520833333333,41.94613821138212,1032.2154471544725,25.805386178861813,0
4272,4,0,0,46,0.0,0.0,1.0,46,1150,1000,150,0.8695652173913043,13,10,3,354.61232137549257,0.8038446054750403,0.2778942369806925,0.2190835879719837,133340.98755907535,256.87142656488254,133597.85898564023,4218,15,630.6739130434783,40,6,17,32.63738561448391,0.6466145833333332,41.79369918699187,1032.8252032520331,25.820630081300827,0
4273,4,0,0,46,0.0,0.0,1.0,46,1250,700,550,0.56,18,7,11,355.74921956295503,0.8032206119162641,0.2813814866760165,0.22056451612903233,133472.2222222223,296.52777777778886,133768.7500000001,4219,16,631.6739130434783,40,6,17,32.476478494623656,0.6479166666666667,41.66666666666667,1033.3333333333342,25.833333333333353,0
4274,4,0,0,46,0.0,0.0,1.0,46,1200,900,300,0.75,15,9,6,355.02662804960863,0.802536231884058,0.2829727373237094,0.22044464696738836,133527.42735955864,281.1584575206242,133808.58581707926,4220,17,632.6739130434783,38,8,17,32.439830128867754,0.6518640350877194,41.61324786324786,1033.5470085470076,27.19860548807915,0
4275,4,1,0,47,0.02127659574468085,0.0,1.0,47,1000,700,300,0.7,13,7,6,347.9661135615767,0.8013413506012951,0.28427039435365065,0.21826965305226176,133903.125,-81.24999999999835,133821.875,4221,0,620.1914893617021,39,8,16,32.2463768115942,0.653846153846154,41.25,1035.0,26.53846153846154,0
4276,4,0,0,47,0.0,0.0,1.0,47,1000,600,400,0.6,14,6,8,348.4782245978599,0.7990286771507863,0.28870427201171056,0.21955453161925975,134064.89257812488,-56.26085069445651,134008.63172743042,4222,1,621.1914893617021,39,8,16,32.07143096627102,0.6554487179487181,41.09374999999999,1035.624999999999,26.554487179487158,0
4277,4,0,0,47,0.0,0.0,1.0,47,1050,700,350,0.6666666666666666,14,7,7,349.1023756743368,0.7987588652482269,0.28986021577207,0.2201764488163887,134103.04712803222,-36.86153248727868,134066.18559554496,4223,2,622.1914893617021,40,7,16,32.01714580062794,0.6541666666666668,41.05691056910569,1035.772357723577,25.894308943089424,0
4278,4,0,0,47,0.0,0.0,1.0,47,1550,1100,450,0.7096774193548387,20,11,9,350.359177512795,0.7978723404255319,0.2949469910841527,0.22176365816871324,134234.65617563948,6.068746281975223,134240.72492192144,4224,3,623.1914893617021,40,7,16,31.8531185642836,0.65546875,40.92987804878049,1036.280487804878,25.90701219512195,0
4279,4,0,1,46,0.0,0.02127659574468085,0.9787234042553191,47,900,400,500,0.4444444444444444,14,4,10,348.9049781573329,0.7977567067530065,0.2951767764225779,0.2210020476551852,134260.98573104636,-31.134741225458612,134229.8509898209,4225,4,624.1914893617021,40,7,16,31.86449957508009,0.6557291666666667,40.90447154471545,1036.3821138211383,25.90955284552846,0
4280,4,0,0,46,0.0,0.0,1.0,46,1250,800,450,0.64,17,8,9,356.34453675412266,0.7965177133655394,0.301310902337776,0.22583618730595648,134280.73459201373,370.04123263887055,134650.7758246526,4226,5,636.4347826086956,39,7,16,31.65201005025125,0.6575854700854702,40.88541666666666,1036.458333333332,26.575854700854663,0
4281,4,0,0,46,0.0,0.0,1.0,46,1050,800,250,0.7619047619047619,13,8,5,356.48966493182354,0.7947463768115942,0.3023707667922213,0.22678432300276358,134419.01728468502,383.7980864564694,134802.81537114148,4227,6,637.4347826086956,40,6,17,31.510110414216644,0.6572916666666667,40.7520325203252,1036.991869918699,25.924796747967473,0
4282,4,0,0,46,0.0,0.0,1.0,46,1250,900,350,0.72,16,9,7,350.8007935355883,0.7943236714975845,0.2946568884232583,0.22397281433426003,134550.78124999985,240.10416666665287,134790.8854166665,4228,7,638.4347826086956,40,6,17,31.526104417670684,0.6585937500000001,40.62499999999999,1037.4999999999989,25.93749999999997,0
4283,4,0,0,46,0.0,0.0,1.0,46,1400,900,500,0.6428571428571429,19,9,10,346.2535007349476,0.7931360708534622,0.28711569234959655,0.22219382936609422,134735.35924383617,130.51796219179977,134865.87720602797,4229,8,639.4347826086956,40,6,17,31.460046332550245,0.6604166666666667,40.44715447154471,1038.2113821138198,25.955284552845495,0
4284,4,0,0,46,0.0,0.0,1.0,46,1250,1000,250,0.8,15,10,5,337.0972990612776,0.793719806763285,0.26824777165407876,0.21758098393955205,134946.46044021414,-101.98253354485104,134844.4779066693,4230,9,640.4347826086956,40,6,14,31.487594548774112,0.6625000000000001,40.24390243902439,1039.0243902439024,25.975609756097562,1
4285,4,0,0,46,0.0,0.0,1.0,46,1150,800,350,0.6956521739130435,15,8,7,340.1828951920785,0.7913647342995169,0.27519024129096437,0.22102168676193887,135184.1468062164,-2.5331110780751374,135181.6136951383,4231,10,641.4347826086956,40,6,14,31.171007198931555,0.6648437500000002,40.01524390243902,1039.9390243902428,25.99847560975607,0
4286,4,0,0,46,0.0,0.0,1.0,46,1400,1000,400,0.7142857142857143,18,10,8,340.43562776156085,0.7909219001610306,0.2682079550183889,0.2219987233772519,135316.28515599156,13.296896688454751,135329.58205268002,4232,11,642.4347826086956,40,6,15,31.033079377482576,0.6661458333333334,39.88821138211381,1040.4471544715427,26.01117886178857,0
4287,4,0,0,46,0.0,0.0,1.0,46,1050,600,450,0.5714285714285714,15,6,9,339.72400232285383,0.7894524959742352,0.26575991441888913,0.2221873072663259,135422.0423111241,1.223643333967857,135423.26595445807,4233,12,643.4347826086956,40,6,15,30.94651109809282,0.6671875000000002,39.78658536585365,1040.8536585365835,26.021341463414586,0
4288,4,0,0,46,0.0,0.0,1.0,46,1300,1000,300,0.7692307692307693,16,10,6,339.1069123697333,0.7887278582930757,0.27010206463386166,0.2222744924649978,135501.38728807244,-10.108586985273973,135491.27870108717,4234,13,644.4347826086956,40,6,15,30.883764437937195,0.66796875,39.71036585365853,1041.1585365853648,26.02896341463412,0
4289,4,1,0,47,0.02127659574468085,0.0,1.0,47,1200,800,400,0.6666666666666666,16,8,8,338.4672966800802,0.790972864631514,0.27638422296876963,0.2243329757065647,135898.46073765613,-200.49852518342357,135697.96221247272,4235,0,631.7021276595744,40,7,13,30.50641650422352,0.671875,39.329268292682926,1042.6829268292681,26.067073170731703,0
4290,4,0,0,47,0.0,0.0,1.0,47,900,500,400,0.5555555555555556,13,5,8,339.01805491316475,0.791049953746531,0.27628684740267184,0.22520014871027888,135977.9451405413,-180.20430547293842,135797.74083506837,4236,1,632.7021276595744,40,7,13,30.413256357790118,0.6726562500000001,39.2530487804878,1042.9878048780483,26.07469512195121,0
4291,4,0,0,47,0.0,0.0,1.0,47,1750,1200,550,0.6857142857142857,23,12,11,357.4686397668124,0.7917052112241751,0.28089827362367337,0.22082875783725545,133337.7075195315,134.83404537387648,133472.54156490538,4237,2,633.7021276595744,39,8,17,32.566923012270976,0.6482371794871793,41.796875000000014,1032.812500000002,26.48237179487185,8
4292,4,0,0,47,0.0,0.0,1.0,47,1200,700,500,0.5833333333333334,17,7,10,357.34545086904654,0.7915510329941412,0.27721565960878825,0.22139347452655084,133445.31385633702,137.21516927085358,133582.52902560786,4238,3,634.7021276595744,39,8,17,32.462214772994585,0.6493055555555554,41.69270833333334,1033.2291666666683,26.4930555555556,0
4293,4,0,0,47,0.0,0.0,1.0,47,650,300,350,0.46153846153846156,10,3,7,382.37763363064533,0.7915510329941412,0.2634710210376976,0.2345788588671871,133078.7118799162,795.0624386138716,133873.77431853008,4239,4,635.7021276595744,40,7,16,32.18424767720542,0.6440104166666667,42.04776422764228,1031.808943089432,25.7952235772358,5
4294,4,0,0,47,0.0,0.0,1.0,47,1150,900,250,0.782608695652174,14,9,5,384.96968805188897,0.7904717853839037,0.2662746797831508,0.23750315727354268,133288.5117675492,862.4073592108006,134150.91912676,4240,5,636.7021276595744,40,7,17,31.906308434209244,0.6460937499999999,41.84451219512196,1032.6219512195132,25.81554878048783,0
4295,4,0,0,47,0.0,0.0,1.0,47,1400,900,500,0.6428571428571429,19,9,10,395.91284806211326,0.7906259636139377,0.25449033456178083,0.2330569745091569,131519.83486969466,1014.4580283678275,132534.2928980625,4241,6,637.7021276595744,38,9,19,33.410365239731966,0.6318530701754386,43.56303418803419,1025.7478632478633,26.99336482231219,6
4296,4,0,0,47,0.0,0.0,1.0,47,1550,800,750,0.5161290322580645,23,8,15,395.2617902727503,0.7886601911810052,0.24821111634113402,0.23378809611930826,131702.08875868036,1011.3606770833135,132713.44943576367,4242,7,638.7021276595744,39,8,17,33.24242270482376,0.6319444444444446,43.38541666666666,1026.4583333333317,26.3194444444444,0
4297,4,0,0,47,0.0,0.0,1.0,47,1100,800,300,0.7272727272727273,14,8,6,395.27008957041596,0.7888529139685476,0.24228561564023998,0.23478090862435544,131862.52170138885,1024.2621527777735,132886.78385416663,4243,8,639.7021276595744,39,8,18,33.07978363759297,0.6335470085470085,43.229166666666664,1027.083333333333,26.335470085470078,0
4298,4,0,0,47,0.0,0.0,1.0,47,1450,1200,250,0.8275862068965517,17,12,5,390.7710410573467,0.786964230650632,0.24617381312211228,0.23358688093246235,132103.3542209201,924.4330512152735,133027.78727213538,4244,9,640.7021276595744,39,8,18,32.95177238490897,0.6359508547008548,42.994791666666664,1028.020833333333,26.359508547008538,0
4299,4,0,0,47,0.0,0.0,1.0,47,1350,1000,350,0.7407407407407407,17,10,7,388.3864765261983,0.7871569534381745,0.2435335308375981,0.23314993651648644,132264.03130425327,873.9122178819257,133137.9435221352,4245,10,641.7021276595744,39,8,19,32.85073839662448,0.6375534188034189,42.83854166666666,1028.6458333333317,26.375534188034145,0
4300,4,0,0,47,0.0,0.0,1.0,47,1800,1400,400,0.7777777777777778,22,14,8,386.4927995503135,0.7864246068455134,0.2541269354151443,0.23351919180353403,132507.9800044743,842.7438477775158,133350.7238522518,4246,11,642.7021276595744,38,9,20,32.653228874822744,0.6417214912280702,42.60149572649572,1029.5940170940162,27.094579397210953,0
4301,4,0,0,47,0.0,0.0,1.0,47,1400,1100,300,0.7857142857142857,17,11,6,390.76565106792464,0.7860006167129201,0.26205898125691074,0.23679268648308321,132618.00219382325,964.5119941193377,133582.51418794258,4247,12,643.7021276595744,38,9,20,32.4322338623241,0.6428179824561404,42.494658119658105,1030.0213675213654,27.105825461088564,0
4302,4,0,0,47,0.0,0.0,1.0,47,950,600,350,0.631578947368421,13,6,7,393.5856659467075,0.7847671908726487,0.26929618477217887,0.23920187448367902,132728.07004026926,1047.9731673240965,133776.04320759335,4248,13,644.7021276595744,38,9,14,32.24857439087609,0.6439144736842106,42.3878205128205,1030.4487179487155,27.117071524966196,0
4303,4,0,0,47,0.0,0.0,1.0,47,1250,1000,250,0.8,15,10,5,396.56920527014535,0.7825316065371569,0.26732981038234405,0.242080290959024,132893.25741699527,1140.2746959237193,134033.532112919,4249,14,645.7021276595744,38,9,14,32.00510309812454,0.6455592105263158,42.227564102564095,1031.0897435897425,27.1339406207827,0
4304,4,0,0,47,0.0,0.0,1.0,47,850,600,250,0.7058823529411765,11,6,5,396.06263342790623,0.7802574776441565,0.2687618686746298,0.24302242145150682,133086.10586054495,1142.0867119585057,134228.19257250347,4250,15,646.7021276595744,38,9,15,31.823790294747013,0.6474780701754386,42.04059829059829,1031.8376068376067,27.153621232568597,0
4305,4,1,0,48,0.020833333333333332,0.0,1.0,48,1350,1000,350,0.7407407407407407,17,10,7,390.1242875105076,0.7818225472813238,0.274765974252966,0.24135137612237723,133391.5052625869,807.8531901041774,134199.35845269109,4251,0,634.2083333333334,39,9,17,31.66962875197472,0.6487713675213675,41.74479166666667,1033.0208333333342,26.487713675213698,0
4306,4,0,0,48,0.0,0.0,1.0,48,1350,800,550,0.5925925925925926,19,8,11,389.2429760665971,0.7802157210401891,0.281418010752688,0.24133064516129032,133472.2222222223,790.6250000000113,134262.8472222223,4252,1,635.2083333333334,39,9,17,31.61122311827957,0.6495726495726495,41.66666666666667,1033.3333333333342,26.49572649572652,0
4307,4,1,0,49,0.02040816326530612,0.0,1.0,49,1000,600,400,0.6,14,6,8,374.02128163218896,0.7895408163265306,0.29436927396111034,0.2172506593310376,131008.00781250015,34.678819444460316,131042.68663194461,4253,0,623.2244897959183,39,10,15,34.48989282322616,0.625,44.06250000000001,1023.7500000000011,26.25000000000003,5
4308,4,0,0,49,0.0,0.0,1.0,49,900,500,400,0.5555555555555556,13,5,8,375.7104563784031,0.7889030612244898,0.29659697924319195,0.21914214875594426,131168.01757812515,56.23914930557055,131224.2567274307,4254,1,624.2244897959183,39,10,16,34.28454003118432,0.6266025641025641,43.90625000000001,1024.3750000000011,26.26602564102567,0
4309,4,0,0,49,0.0,0.0,1.0,49,1450,900,550,0.6206896551724138,20,9,11,372.9253406647941,0.7886904761904762,0.2869366707412835,0.21813104032852582,131276.0468305903,-8.767102914923925,131267.27972767537,4255,2,625.2244897959183,40,9,17,34.246496099431454,0.6260416666666666,43.800813008130085,1024.79674796748,25.619918699187004,0
4310,4,0,0,49,0.0,0.0,1.0,49,950,500,450,0.5263157894736842,14,5,9,370.3454390281381,0.7893282312925171,0.2910455624631483,0.21708013724875336,131356.983567182,-70.46673889129136,131286.5168282907,4256,3,626.2244897959183,36,13,17,34.230702332564356,0.6339699074074074,43.721846846846844,1025.1126126126123,28.475350350350343,0
4311,4,0,0,49,0.0,0.0,1.0,49,650,300,350,0.46153846153846156,10,3,7,370.74003462730303,0.7889030612244898,0.2839484048063434,0.21556478476648522,131047.29940943349,-78.99509725813104,130968.30431217536,4257,4,627.2244897959183,37,12,13,34.53407224958948,0.6289414414414415,44.024122807017534,1023.9035087719284,27.673067804646713,4
4312,4,0,1,48,0.0,0.02040816326530612,0.9795918367346939,49,1200,800,400,0.6666666666666666,16,8,8,365.0975822440934,0.7889384920634921,0.28267370311069984,0.21306100630272076,131187.67463305994,-220.739434249024,130966.93519881091,4258,5,628.2244897959183,37,12,13,34.53643993720789,0.6303490990990992,43.88706140350876,1024.451754385963,27.68788525367468,0
4313,4,1,0,49,0.02040816326530612,0.0,1.0,49,1000,600,400,0.6,14,6,8,366.8845551752256,0.7902140022675738,0.29751826229984024,0.21538968020525684,131417.1157648535,-156.86770141345664,131260.24806344003,4259,0,629.1020408163265,35,14,14,34.25859295631562,0.6366071428571427,43.66319444444445,1025.347222222223,29.295634920634946,0
4314,4,1,1,49,0.02,0.02,0.98,50,1650,1200,450,0.7272727272727273,21,12,9,358.48483474830033,0.7931462585034014,0.3107344880508658,0.21317461946375485,131905.89871966574,-542.7471390309056,131363.15158063485,4260,0,617.5,36,14,14,33.98057808960024,0.6394675925925926,43.186936936936945,1027.2522522522534,28.534784784784815,0
4315,4,0,0,49,0.0,0.0,1.0,49,1500,1200,300,0.8,18,12,6,359.1579358228557,0.7938633786848073,0.3027251887056188,0.2140637599205462,131992.67415642014,-318.7567212482587,131673.91743517187,4261,1,624.6938775510204,36,13,14,33.87579908675798,0.6403356481481481,43.102477477477485,1027.5900900900915,28.54416916916921,0
4316,4,0,1,48,0.0,0.02040816326530612,0.9795918367346939,49,1450,1000,450,0.6896551724137931,19,10,9,359.1293293639853,0.7915249433106576,0.30480572307839626,0.21490464080702584,132144.21895439003,-308.6270535164354,131835.5919008736,4262,2,625.6938775510204,37,12,15,33.72380558814122,0.639921171171171,42.95504385964914,1028.1798245614054,27.788643907065012,0
4317,4,0,0,48,0.0,0.0,1.0,48,1600,900,700,0.5625,23,9,14,364.61234362475415,0.7865691489361702,0.30958661976835056,0.21900083277128335,132285.18029586034,46.56192289936433,132331.7422187597,4263,3,637.6458333333334,37,11,15,33.44080864065942,0.6413288288288288,42.817982456140356,1028.7280701754394,27.803461356092956,0
4318,4,0,1,47,0.0,0.020833333333333332,0.9791666666666666,48,1250,900,350,0.72,16,9,7,365.3807707611532,0.7870862884160756,0.31260384215991666,0.2196390026485585,132315.55103550313,69.11160420777759,132384.6626397109,4264,4,638.6458333333334,38,10,15,33.39044652128764,0.6398026315789472,42.78846153846155,1028.8461538461552,27.074898785425138,0
4319,4,0,0,47,0.0,0.0,1.0,47,950,700,250,0.7368421052631579,12,7,5,373.47104569084405,0.7858078939253776,0.319353039092513,0.22432172539510234,132285.18029586025,480.9369228993515,132766.1172187596,4265,5,631.9787234042553,37,10,16,33.212978753641714,0.6413288288288288,42.81798245614035,1028.7280701754385,27.80346135609293,0
4320,4,0,0,47,0.0,0.0,1.0,47,1550,1200,350,0.7741935483870968,19,12,7,369.9294847706161,0.7840733888374961,0.31120726124943987,0.2230464998268774,132429.53619100817,398.11038519237195,132827.64657620055,4266,6,632.9787234042553,33,14,17,33.15858534746199,0.651199494949495,42.67769607843137,1029.2892156862738,31.19058229352345,0
4321,4,0,0,47,0.0,0.0,1.0,47,1250,700,550,0.56,18,7,11,370.7805741456415,0.7819148936170213,0.31253873166701096,0.22464940668824154,132612.50000000003,434.0277777777785,133046.5277777778,4267,7,633.9787234042553,34,13,18,32.95240021574972,0.650735294117647,42.5,1030.0000000000002,30.29411764705883,0
4322,4,0,0,47,0.0,0.0,1.0,47,1000,900,100,0.9,11,9,2,371.0921643554344,0.7820305272895467,0.3122256184264929,0.22551764773081442,132725.7764944487,450.69913301612127,133176.47562746482,4268,8,634.9787234042553,35,12,15,32.830342768355244,0.649702380952381,42.3900462962963,1030.4398148148148,29.441137566137566,0
4323,4,0,0,47,0.0,0.0,1.0,47,1200,600,600,0.5,18,6,12,373.673743198667,0.7819919827320382,0.30989460812995784,0.2281740492225442,132904.73257726748,532.601782193055,133437.33435946054,4269,9,635.9787234042553,35,12,15,32.5837402252404,0.6514880952380953,42.216435185185176,1031.1342592592578,29.460978835978793,0
4324,4,0,0,47,0.0,0.0,1.0,47,1150,600,550,0.5217391304347826,17,6,11,374.2821921625973,0.7824930619796484,0.30894142074676867,0.22964389147484907,133083.8092233583,562.1799714934878,133645.98919485178,4270,10,636.9787234042553,35,12,16,32.38794634511124,0.6532738095238095,42.042824074074076,1031.8287037037044,29.480820105820126,0
4325,4,0,0,47,0.0,0.0,1.0,47,1100,800,300,0.7272727272727273,14,8,6,372.54564542028646,0.7815294480419365,0.30779139918844156,0.22931225752267306,133203.26063368042,524.8589409722126,133728.11957465264,4271,11,637.9787234042553,35,12,17,32.312689202825446,0.6544642857142857,41.92708333333333,1032.2916666666656,29.49404761904759,0
4326,4,0,0,47,0.0,0.0,1.0,47,700,500,200,0.7142857142857143,9,5,4,373.7175491162102,0.7815679925994449,0.30892090449384635,0.23021826920694707,133233.13185871046,558.3118998628204,133791.4437585733,4272,12,638.9787234042553,35,12,17,32.25242899850523,0.6547619047619049,41.898148148148145,1032.4074074074067,29.49735449735448,0
4327,4,0,0,47,0.0,0.0,1.0,47,1100,900,200,0.8181818181818182,13,9,4,354.197896988361,0.783341042244835,0.1832079155588664,0.20609683239715265,131075.36844269375,-114.67603012467225,130960.69241256909,4273,13,639.9787234042553,37,10,16,34.92912785094762,0.629222972972973,43.99671052631578,1024.0131578947355,27.67603129445231,6
4328,4,1,2,46,0.020833333333333332,0.041666666666666664,0.9583333333333334,48,800,700,100,0.875,9,7,2,347.6766474981822,0.7929595153664303,0.17852303523035218,0.20363917924893518,131328.1249999999,-467.5686268852107,130860.5563731147,4274,0,627.625,36,12,16,34.84078590785907,0.6336805555555556,43.74999999999999,1024.9999999999993,28.472222222222204,0
4329,4,0,0,46,0.0,0.0,1.0,46,1150,700,450,0.6086956521739131,16,7,9,361.96224183271886,0.7814210950080516,0.19098115336437815,0.21073525142296684,131097.3705969481,290.45963192920755,131387.8302288773,4275,15,655.0652173913044,36,10,17,34.7080950810058,0.6313657407407408,43.975225225225216,1024.0990990990977,28.447197197197156,0
4330,4,0,0,46,0.0,0.0,1.0,46,950,500,450,0.5263157894736842,14,5,9,362.89402618503254,0.7820652173913044,0.19759218643233623,0.21207275171853626,131241.5683208545,325.35622615857653,131566.9245470131,4276,16,656.0652173913044,36,10,17,34.53836502179727,0.6328125,43.83445945945945,1024.6621621621612,28.46283783783781,0
4331,4,1,0,47,0.02127659574468085,0.0,1.0,47,1700,1300,400,0.7647058823529411,21,13,8,355.2561620455128,0.7874267653407339,0.2041324634252275,0.20986385002382174,131654.5718262389,-45.72335225066797,131608.84847398824,4277,0,643.0851063829788,35,12,16,34.316966467426056,0.6389880952380952,43.43171296296297,1026.2731481481487,29.322089947089964,0
4332,4,0,0,47,0.0,0.0,1.0,47,1750,1400,350,0.8,21,14,7,353.303243378907,0.7863475177304964,0.20577445945362727,0.2098536132359051,131862.521701389,-82.50868055554525,131780.01302083346,4278,1,644.0851063829788,35,12,17,34.15736984448953,0.6410714285714285,43.22916666666667,1027.0833333333342,29.34523809523812,0
4333,4,0,0,47,0.0,0.0,1.0,47,1300,900,400,0.6923076923076923,17,9,8,353.4396655501997,0.7865016959605303,0.21432850987140073,0.2105931107889044,131981.42387902958,-70.50593707132066,131910.91794195827,4279,2,645.0851063829788,35,12,17,34.03403544341819,0.6422619047619047,43.11342592592593,1027.546296296297,29.35846560846563,0
4334,4,0,0,47,0.0,0.0,1.0,47,900,700,200,0.7777777777777778,11,7,4,353.94448502556617,0.786077705827937,0.22058654399079924,0.21122493461203143,132040.8950617284,-52.97067901234345,131987.92438271607,4280,3,646.0851063829788,35,12,17,33.96114864864865,0.6428571428571428,43.05555555555556,1027.7777777777778,29.365079365079367,0
4335,4,0,0,47,0.0,0.0,1.0,47,1200,800,400,0.6666666666666666,16,8,8,353.9734891995126,0.7861933395004624,0.22384617042833455,0.21174050535752675,132130.12695312512,-45.887586805541446,132084.23936631958,4281,4,647.0851063829788,35,12,17,33.87052516041878,0.6437499999999999,42.96875000000001,1028.125000000001,29.375000000000025,0
4336,4,0,0,47,0.0,0.0,1.0,47,1300,600,700,0.46153846153846156,20,6,14,355.8423328413836,0.785037002775208,0.22446074674258143,0.21338857687723972,132224.21481870403,10.194611841592462,132234.4094305456,4282,5,648.0851063829788,36,11,18,33.72773641373772,0.6426504629629629,42.87725225225226,1028.4909909909925,28.569194194194235,0
4337,4,0,0,47,0.0,0.0,1.0,47,950,600,350,0.631578947368421,13,6,7,353.4569410230112,0.7849599136601911,0.22301645976677764,0.2123004494672146,132285.1802958603,-48.57696598953726,132236.60332987076,4283,6,649.0851063829788,37,10,19,33.72770553542242,0.6413288288288288,42.81798245614035,1028.728070175439,27.803461356092942,0
4338,4,0,0,47,0.0,0.0,1.0,47,1250,600,650,0.48,19,6,13,353.29742396602603,0.7853839037927844,0.2139493759847657,0.21268097010398654,132369.79316953282,-46.81861245769073,132322.97455707513,4284,7,650.0851063829788,37,10,19,33.646665778724916,0.6421734234234234,42.73574561403508,1029.0570175438586,27.81235182550969,0
4339,4,0,0,47,0.0,0.0,1.0,47,1700,1400,300,0.8235294117647058,20,14,6,352.73998453422877,0.784304656182547,0.21925021013781887,0.21330207306895946,132539.10007165655,-49.63197810866177,132489.46809354788,4285,8,651.0851063829788,37,10,19,33.49073137401057,0.6438626126126126,42.571271929824555,1029.714912280701,27.83013276434327,0
4340,4,2,2,47,0.04081632653061224,0.04081632653061224,0.9591836734693877,49,1650,1400,250,0.8484848484848485,19,14,5,340.3942705576781,0.7891865079365079,0.21370365410172165,0.20876812692717028,133068.8815646701,-740.8230251736147,132328.05853949647,4286,0,625.469387755102,39,10,16,33.27706966178697,0.6455662393162394,42.057291666666664,1031.770833333333,26.455662393162385,0
4341,4,0,1,46,0.0,0.02127659574468085,0.9787234042553191,47,1300,800,500,0.6153846153846154,18,8,10,354.6921850679936,0.7803731113166821,0.2207390245889027,0.21659255249216947,132906.30290089248,28.165397045228133,132934.4682979377,4287,10,653.0851063829788,37,10,16,33.071476676591516,0.6475225225225225,42.214912280701746,1031.140350877192,27.868658131816,0
4342,4,0,0,46,0.0,0.0,1.0,46,1450,900,550,0.6206896551724138,20,9,11,349.59685197330396,0.7798309178743962,0.2130434782608701,0.2148285998767246,133141.23109796163,109.15105193948932,133250.38214990112,4288,11,664.2608695652174,38,8,17,32.96713250517599,0.6480263157894738,41.987179487179475,1032.05128205128,27.159244264507368,0
4343,4,0,1,45,0.0,0.021739130434782608,0.9782608695652174,46,1500,1000,500,0.6666666666666666,20,10,10,351.46249239342615,0.7791867954911433,0.2142600057587103,0.2166156585771726,133251.51581561822,166.58197275183062,133418.09778837004,4289,12,665.2608695652174,38,8,18,32.80840404249448,0.6491228070175439,41.880341880341874,1032.4786324786312,27.170490328385032,0
4344,4,0,0,45,0.0,0.0,1.0,45,1000,800,200,0.8,12,8,4,356.122795778421,0.7814814814814816,0.22472832820077238,0.21962071826099436,133274.01369892625,492.38287261461795,133766.39657154088,4290,13,679.5333333333333,37,8,19,32.66554723726593,0.6511824324324326,41.85855263157893,1032.5657894736817,27.907183499288692,0
4345,4,0,0,45,0.0,0.0,1.0,45,1200,900,300,0.75,15,9,6,358.0131108428471,0.781439393939394,0.22519021835297526,0.22112298301828007,133330.62967691952,546.822700253894,133877.4523771734,4291,14,680.5333333333333,37,8,19,32.55996301801325,0.6517454954954955,41.803728070175424,1032.785087719296,27.91311047889989,0
4346,4,1,0,46,0.021739130434782608,0.0,1.0,46,1300,900,400,0.6923076923076923,17,9,8,371.7583293950855,0.787962962962963,0.2952504725897924,0.2137610394021738,130617.283950617,562.2442188408078,131179.5281694578,4292,0,666.7173913043479,35,11,17,34.943953804347835,0.6285714285714287,44.44444444444443,1022.2222222222199,29.20634920634914,6
4347,4,0,0,46,0.0,0.0,1.0,46,900,700,200,0.7777777777777778,11,7,4,372.8604096976884,0.7876006441223833,0.2914661763931383,0.21498065907712421,130722.82745160692,548.2734000892672,131271.1008516962,4293,1,667.7173913043479,36,10,17,34.808712329772774,0.6276041666666667,44.34121621621621,1022.6351351351343,28.40653153153151,0
4348,4,2,1,47,0.041666666666666664,0.020833333333333332,0.9791666666666666,48,1300,900,400,0.6923076923076923,17,9,8,358.2523630114349,0.8011044621749409,0.28912601626016254,0.2098335269066976,131328.125,-187.48148486324146,131140.64351513676,4294,0,640.8541666666666,36,12,18,34.56978319783198,0.6336805555555556,43.75,1025.0,28.47222222222222,0
4349,4,0,0,47,0.0,0.0,1.0,47,1100,700,400,0.6363636363636364,15,7,8,366.30562841505764,0.7944804193647856,0.289767837873524,0.2142360702858028,131271.93583602647,217.12978993536092,131489.06562596184,4295,1,655.4893617021277,37,10,18,34.42025108780939,0.6311936936936937,43.80482456140351,1024.780701754386,27.696775723091513,0
4350,4,0,0,47,0.0,0.0,1.0,47,1600,1200,400,0.75,20,12,8,366.97786027255336,0.7935168054270736,0.2910067526826958,0.21511071531661216,131357.78523930497,241.10383731262965,131598.8890766176,4296,2,656.4893617021277,35,12,18,34.31619528809605,0.6360119047619046,43.72106481481483,1025.115740740743,29.289021164021225,0
4351,4,0,0,47,0.0,0.0,1.0,47,1500,1100,400,0.7333333333333333,19,11,8,366.0825159934685,0.7940949737897008,0.2899756792179966,0.2152300499130098,131472.4495399117,225.95302227905563,131698.40256219075,4297,3,657.4893617021277,36,11,18,34.223216573331875,0.6351273148148147,43.60923423423424,1025.5630630630644,28.4878628628629,0
4352,4,0,0,47,0.0,0.0,1.0,47,1300,800,500,0.6153846153846154,18,8,10,366.2327384902856,0.793786617329633,0.2870144553770828,0.21548112287916812,131501.32395909433,232.0179977274728,131733.3419568218,4298,4,658.4893617021277,36,11,18,34.19018079344166,0.6354166666666665,43.58108108108109,1025.6756756756765,28.490990990991016,0
4353,4,0,0,47,0.0,0.0,1.0,47,1350,900,450,0.6666666666666666,18,9,9,361.4650884399464,0.792823003391921,0.28882651822240457,0.2133205884627459,131616.8533398265,114.97950653358407,131731.8328463601,4299,5,659.4893617021277,36,11,18,34.19574919520047,0.636574074074074,43.46846846846848,1026.1261261261277,28.50350350350355,0
4354,4,1,0,48,0.020833333333333332,0.0,1.0,48,1200,900,300,0.75,15,9,6,355.27040248573684,0.7967087765957447,0.299888829598008,0.2114919740337584,131946.99931709768,-224.62728916588122,131722.3720279318,4300,0,646.7291666666666,37,11,19,34.021700462468864,0.6379504504504503,43.14692982456141,1027.4122807017554,27.76789947842582,0
4355,4,0,0,48,0.0,0.0,1.0,48,1400,900,500,0.6428571428571429,19,9,10,352.8350754682873,0.7957114361702128,0.3017788564113504,0.21066726098342217,132059.67821829816,-280.9426939057924,131778.73552439237,4301,1,647.7291666666666,37,11,20,33.97073465614109,0.6390765765765765,43.0372807017544,1027.8508771929842,27.77975343764822,0
4356,4,0,0,48,0.0,0.0,1.0,48,1150,800,350,0.6956521739130435,15,8,7,352.8797656350102,0.7966348995271867,0.2954618174061432,0.21100769659399615,132116.03570329354,-275.7848568790109,131840.25084641454,4302,2,648.7291666666666,37,11,20,33.91282707622298,0.6396396396396395,42.98245614035089,1028.0701754385984,27.785680417259417,0
4357,4,0,0,48,0.0,0.0,1.0,48,1450,1100,350,0.7586206896551724,18,11,7,352.5695225885297,0.7960069444444444,0.2953158241312934,0.21104995497097526,132156.90239800367,-281.1008029513693,131875.8015950523,4303,3,649.7291666666666,39,9,20,33.879651673251615,0.6364850427350428,42.94270833333334,1028.2291666666683,26.36485042735047,0
4358,4,1,0,49,0.02040816326530612,0.0,1.0,49,1950,1400,550,0.717948717948718,25,14,11,336.7266289779386,0.8019416099773243,0.27601653373301893,0.1999353356618235,131848.80566741535,-913.64664410351,130935.15902331183,4304,0,637.4489795918367,38,11,19,34.59681334304241,0.6351425438596492,43.24252136752136,1027.0299145299139,27.0271030139451,2
4359,4,0,0,49,0.0,0.0,1.0,49,1150,600,550,0.5217391304347826,17,6,11,333.3416985010678,0.8001346371882087,0.26882242966855086,0.19849827334270997,131958.55391418276,-1002.542301300326,130956.01161288243,4305,1,638.4489795918367,38,11,19,34.57332501473086,0.6362390350877194,43.135683760683754,1027.4572649572638,27.03834907782273,0
4360,4,0,0,49,0.0,0.0,1.0,49,1050,500,550,0.47619047619047616,16,5,11,336.55651696733696,0.8000637755102041,0.27177234813701046,0.20128547935218638,132123.26189139063,-906.6110334940721,131216.65085789657,4306,2,639.4489795918367,38,11,19,34.32509785583151,0.6378837719298247,42.97542735042734,1028.0982905982887,27.055218173639176,0
4361,4,0,0,49,0.0,0.0,1.0,49,1350,1200,150,0.8888888888888888,15,12,3,340.45088848128415,0.7990362811791384,0.27391442558331747,0.20465306217695164,132315.55103550287,-790.6106180144744,131524.9404174884,4307,3,640.4489795918367,38,11,19,34.031671858774644,0.6398026315789473,42.78846153846153,1028.8461538461531,27.07489878542508,0
4362,4,0,0,49,0.0,0.0,1.0,49,1250,900,350,0.72,16,9,7,343.78795553261085,0.7982213718820862,0.2838058431381927,0.2075771777810732,132482.65241468555,-690.7862744465035,131791.86614023906,4308,4,641.4489795918367,37,12,19,33.77789168175525,0.6432995495495495,42.62609649122808,1029.4956140350896,27.82420578473215,0
4363,4,0,1,48,0.0,0.02040816326530612,0.9795918367346939,49,1100,600,500,0.5454545454545454,16,6,10,341.15717751741977,0.7973356009070295,0.28404547508952405,0.20645284866260394,132567.32840874136,-754.7408818097704,131812.5875269316,4309,5,642.4489795918367,37,12,20,33.76055863145939,0.6441441441441441,42.543859649122815,1029.8245614035104,27.83309625414893,0
4364,4,1,1,48,0.02040816326530612,0.02040816326530612,0.9795918367346939,49,1000,800,200,0.8,12,8,4,342.53370186798765,0.8000283446712019,0.2746220429010078,0.20822326844471895,132736.7615516316,-706.6371383502332,132030.12441328136,4310,0,640.1836734693877,37,12,17,33.555011704617996,0.6458333333333333,42.379385964912295,1030.4824561403532,27.85087719298252,0
4365,4,0,0,48,0.0,0.0,1.0,48,1400,1000,400,0.7142857142857143,18,10,8,355.6998263410215,0.7956375591016548,0.2947191371208886,0.2108084287251473,131778.07113727304,-225.3125961834364,131552.7585410896,4311,7,654.5208333333334,37,11,17,34.18099458920688,0.6362612612612613,43.31140350877193,1026.7543859649127,27.750118539592233,3
4366,4,1,1,48,0.02040816326530612,0.02040816326530612,0.9795918367346939,49,1350,1100,250,0.8148148148148148,16,11,5,347.72559062869925,0.8026502267573696,0.2965895908399734,0.20796540451336068,132123.26189139095,-611.4721446051515,131511.7897467858,4312,0,642.1428571428571,38,11,18,34.03802521736119,0.6378837719298245,42.97542735042735,1028.098290598291,27.055218173639236,0
4367,4,0,0,48,0.0,0.0,1.0,48,1350,1200,150,0.8888888888888888,15,12,3,320.93222918186757,0.7976876477541371,0.2695748879523716,0.17363792595149238,128221.71512492558,-1347.8057921685045,126873.90933275707,4313,1,656.3541666666666,40,8,17,38.67273730684327,0.5953125,46.798780487804876,1012.8048780487801,25.3201219512195,8
4368,4,1,0,49,0.02040816326530612,0.0,1.0,49,850,500,350,0.5882352941176471,12,5,7,314.77479484637246,0.8049532312925171,0.2742510449722506,0.17137366161614717,128471.19005298884,-1712.101501480217,126759.08855150863,4314,0,643.9387755102041,41,8,14,38.57469338160942,0.596290650406504,46.55257936507937,1013.789682539683,24.7265776229191,0
4369,4,1,0,50,0.02,0.0,1.0,50,1400,1000,400,0.7142857142857143,18,10,8,311.86229547011226,0.8097108843537415,0.27963242839817104,0.17116497414972537,128792.54301717473,-1966.8923790461308,126825.6506381286,4315,0,632.04,43,7,16,38.32184672077618,0.596656976744186,46.23579545454546,1015.0568181818194,23.605972515856266,0
4370,4,0,0,50,0.0,0.0,1.0,50,1300,900,400,0.6923076923076923,17,9,8,314.36111912076393,0.8104931972789116,0.2860893345487687,0.17329354154546664,128966.15655006882,-1891.61093964333,127074.54561042548,4316,1,633.04,44,6,16,38.08207991491948,0.5970643939393939,46.064814814814824,1015.7407407407426,23.085016835016877,0
4371,4,0,0,50,0.0,0.0,1.0,50,1550,1100,450,0.7096774193548387,20,11,9,313.8065328888952,0.8110034013605442,0.28370923665512837,0.1738127203861902,129154.32527434836,-1894.1057956104298,127260.21947873793,4317,2,634.04,44,6,18,37.90516639339286,0.5989583333333334,45.879629629629626,1016.481481481481,23.10185185185184,0
4372,4,1,0,51,0.0196078431372549,0.0,1.0,51,1850,1500,350,0.8108108108108109,22,15,7,318.2735934486603,0.8167647058823531,0.23222758376571107,0.1717649160807487,128120.5622004851,-2026.3632185437991,126094.1989819413,4318,0,622.5882352941177,43,8,18,38.843127396875886,0.5898740310077519,46.89867424242425,1012.4053030303041,23.54430937279777,4
4373,4,2,1,52,0.03773584905660377,0.018867924528301886,0.9811320754716981,53,1250,900,350,0.72,16,9,7,309.2766407526432,0.8277092404450894,0.24544837588405732,0.16888416364927503,128590.23062414277,-2646.0068459124664,125944.22377823031,4319,0,600.0566037735849,44,9,16,38.59301777128598,0.5932765151515151,46.43518518518519,1014.2592592592601,23.05134680134682,0
4374,4,2,0,54,0.037037037037037035,0.0,1.0,54,1100,700,400,0.6363636363636364,15,7,8,313.9103982572475,0.8331731889121826,0.27620077105287844,0.17338443732175032,129043.70948550146,-2698.367552562723,126345.34193293874,4320,0,589.8148148148148,46,8,18,38.0147892854027,0.5953351449275361,45.98847517730498,1016.046099290782,22.08795868023439,0
4375,4,1,0,55,0.01818181818181818,0.0,1.0,55,1650,1400,250,0.8484848484848485,19,14,5,311.224888323292,0.8391694725028058,0.28236112030722316,0.17300071727444574,129295.54183813476,-2951.713058244365,126343.82877989039,4321,0,580.0727272727273,44,11,20,37.82755978392813,0.6003787878787877,45.740740740740755,1017.0370370370397,23.114478114478175,0
4376,4,3,3,55,0.05172413793103448,0.05172413793103448,0.9482758620689655,58,1500,1100,400,0.7333333333333333,19,11,8,300.7716492216787,0.8506251260334745,0.2914647683822875,0.16962827594433064,129864.12896050396,-3788.1103515624623,126076.01860894151,4322,0,551.0172413793103,47,11,15,37.51809742803612,0.6023936170212765,45.182291666666686,1019.2708333333372,21.68661347517739,0
4377,4,1,2,54,0.017857142857142856,0.03571428571428571,0.9642857142857143,56,1500,800,700,0.5333333333333333,22,8,14,307.8391429536891,0.8482683982683983,0.281453210729526,0.17312873399715512,129754.51585801333,-3211.296208779644,126543.21964923368,4323,0,568.9464285714286,45,11,17,37.448879800853476,0.6037037037037036,45.28985507246378,1018.8405797101474,22.64090177133661,0
4378,4,0,0,54,0.0,0.0,1.0,54,1400,1000,400,0.7142857142857143,18,10,8,317.6625635478637,0.8408018867924528,0.2712385874246337,0.17767286983036082,129538.57197687095,-2570.089029499546,126968.4829473714,4324,2,590.9629629629629,43,11,17,37.41744186046511,0.6041666666666667,45.50189393939394,1017.992424242424,23.67424242424242,0
4379,4,2,4,52,0.03571428571428571,0.07142857142857142,0.9285714285714286,56,1400,900,500,0.6428571428571429,19,9,10,308.73528271912073,0.8468208874458875,0.2714379947229548,0.17481112465864818,130019.01226279173,-3171.7086980372333,126847.30356475449,4325,0,570.8214285714286,47,9,17,37.1585702329276,0.6039450354609929,45.03038194444444,1019.8784722222221,21.699541962174937,0
4380,4,2,1,53,0.037037037037037035,0.018518518518518517,0.9814814814814815,54,1350,1000,350,0.7407407407407407,17,10,7,319.4685100338429,0.8433496389471232,0.2779678434631896,0.18013386267087264,129855.6577652659,-2503.0412988531716,127352.61646641273,4326,0,592.7037037037037,46,8,18,37.050244991447045,0.6034873188405797,45.190602836879435,1019.2375886524828,22.157338883749627,0
4381,4,0,0,53,0.0,0.0,1.0,53,1300,1000,300,0.7692307692307693,16,10,6,324.62170953490175,0.8391086115142719,0.276370745578957,0.1831061702955514,129869.89935314273,-2168.282250971432,127701.6171021713,4327,1,604.8867924528302,45,8,18,36.90451064901212,0.6048611111111111,45.17663043478261,1019.2934782608696,22.65096618357488,0
4382,4,1,0,54,0.018518518518518517,0.0,1.0,54,1250,900,350,0.72,16,9,7,318.8144526799487,0.8464651758676917,0.2851459312670328,0.1812283044345129,130172.10311509724,-2499.850438232491,127672.25267686475,4328,0,594.6666666666666,46,8,19,36.74673500709466,0.6066576086956521,44.88031914893617,1020.4787234042547,22.184320074005537,0
4383,4,1,1,54,0.01818181818181818,0.01818181818181818,0.9818181818181818,55,1300,900,400,0.6923076923076923,17,9,8,279.7961261163508,0.8520482603815938,0.1791642998341325,0.15924101004146776,130219.1876431694,-3694.1650607518945,126525.0225824175,4329,0,584.8363636363637,48,7,14,37.69474298092144,0.6048177083333333,44.83418367346938,1020.6632653061216,21.263818027210867,5
4384,4,0,2,52,0.0,0.037037037037037035,0.962962962962963,54,1250,800,450,0.64,17,8,9,283.5335991830018,0.8456353365944561,0.17271455840940364,0.16136437847017146,130218.28357084333,-3415.7482759451873,126802.53529489815,4330,2,596.6666666666666,47,7,14,37.60028632987467,0.6059397163120566,44.83506944444446,1020.659722222225,21.716164302600532,0
4385,4,0,3,49,0.0,0.057692307692307696,0.9423076923076923,52,1400,1100,300,0.7857142857142857,17,11,6,290.2739435507131,0.8353915284062342,0.1850800767025902,0.16519643658424962,130217.34103069549,-2840.259780066362,127377.08125062913,4331,3,619.4230769230769,46,6,16,37.42924664871596,0.6071105072463767,44.83599290780143,1020.6560283687971,22.18817452975646,0
4386,4,2,2,49,0.0392156862745098,0.0392156862745098,0.9607843137254902,51,1600,1100,500,0.6875,21,11,10,291.77955356462576,0.8322549019607844,0.20006437147798017,0.16655685156629774,130335.09926143561,-2594.1608662141884,127740.93839522141,4332,0,632.1176470588235,43,8,18,37.27211428483107,0.6121608527131782,44.72064393939395,1021.1174242424261,23.746916842847117,0
4387,4,0,0,49,0.0,0.0,1.0,49,1000,800,200,0.8,12,8,4,303.7067888379836,0.8245110544217688,0.18775510204081547,0.1730422401518749,130262.586805556,-1887.6736111110706,128374.91319444493,4333,1,635.4897959183673,44,5,19,37.0408163265306,0.6100852272727271,44.791666666666686,1020.8333333333369,23.200757575757656,0
4388,4,0,0,49,0.0,0.0,1.0,49,1000,700,300,0.7,13,7,6,301.4849457670227,0.8240858843537415,0.18125098032381137,0.17221408365521182,130361.5235431317,-1939.592628898476,128421.93091423322,4334,2,636.4897959183673,42,7,19,36.99769902267768,0.6138392857142856,44.69476744186048,1021.2209302325604,24.3147840531562,0
4389,4,1,0,50,0.02,0.0,1.0,50,1000,500,500,0.5,15,5,10,295.8089262541628,0.8283843537414965,0.1855279733234534,0.1702320451940268,130649.55305899907,-2270.539198806241,128379.01386019282,4335,0,624.74,43,7,15,36.85238359886378,0.6153100775193798,44.41287878787879,1022.3484848484848,23.775546159267087,0
4390,4,0,0,50,0.0,0.0,1.0,50,1500,900,600,0.6,21,9,12,291.0574662866147,0.8267006802721089,0.1834330154615318,0.1680230728680773,130770.59771184865,-2387.6482330406257,128382.94947880802,4336,1,625.74,43,7,15,36.85200830170046,0.6165213178294573,44.29450757575758,1022.82196969697,23.786557434813254,0
4391,4,0,1,49,0.0,0.02,0.98,50,1600,1100,500,0.6875,21,11,10,301.65430767135797,0.8269557823129251,0.2081228020150172,0.17035453413904242,129916.60399202286,-2151.9555586451406,127764.64843337772,4337,2,626.74,42,8,14,37.44257516712606,0.609375,45.13081395348838,1019.4767441860477,24.273255813953515,3
4392,4,1,2,48,0.02,0.04,0.96,50,1200,900,300,0.75,15,9,6,300.3742805406454,0.8272278911564626,0.209817629179331,0.17038472120322828,130089.53788834809,-2184.889730184479,127904.6481581636,4338,0,627.62,42,8,15,37.30053191489363,0.611111111111111,44.96124031007752,1020.1550387596902,24.28940568475453,0
4393,4,1,1,48,0.02040816326530612,0.02040816326530612,0.9795918367346939,49,900,600,300,0.6666666666666666,12,6,6,306.21601096811696,0.8234126984126985,0.21505647389597216,0.17336866677995863,130015.4092771618,-1837.4400013520833,128177.96927580972,4339,0,641.3469387755102,42,7,15,37.2264449722882,0.6103670634920635,45.03391472868217,1019.8643410852711,24.282484311554075,0
4394,4,0,0,48,0.0,0.0,1.0,48,1150,800,350,0.6956521739130435,15,8,7,310.913718981015,0.8181700650118203,0.21871452434238292,0.17566026882726166,129933.65698420562,-1520.3686972474293,128413.2882869582,4340,18,655.7083333333334,41,7,16,37.18933459829393,0.6110264227642277,45.1140873015873,1019.5436507936499,24.86691831204024,0
4395,4,0,0,48,0.0,0.0,1.0,48,1700,1200,500,0.7058823529411765,22,12,10,308.70344737462847,0.8179114952718676,0.2140770365327893,0.17509087420591826,130085.41907793183,-1568.4365354938534,128516.98254243798,4341,19,656.7083333333334,41,7,16,37.092267982754706,0.6125508130081302,44.965277777777764,1020.1388888888868,24.881436314363093,0
4396,4,3,3,48,0.058823529411764705,0.058823529411764705,0.9411764705882353,51,1400,1000,400,0.7142857142857143,18,10,8,291.35170899546756,0.8352614379084968,0.21306669558286173,0.16785701870409614,130693.35322381252,-2584.0919469639803,128109.26127684854,4342,0,619.0196078431372,41,10,13,36.922217101646154,0.6186483739837398,44.37003968253968,1022.51984126984,24.939508323654632,0
4397,4,0,0,48,0.0,0.0,1.0,48,1300,800,500,0.6153846153846154,18,8,10,310.90455623568334,0.8167848699763594,0.2166092979772234,0.17775038914815583,130395.54172092001,-1491.8863932291772,128903.65532769084,4343,21,658.7083333333334,39,9,17,36.7228667346592,0.6188568376068377,44.66145833333333,1021.3541666666656,26.18856837606835,0
4398,4,0,0,48,0.0,0.0,1.0,48,1200,900,300,0.75,15,9,6,306.7590707597525,0.8169326241134751,0.2165278468423677,0.17595336317680038,130522.07396597591,-1592.2339753123106,128929.8399906636,4344,22,659.7083333333334,40,8,13,36.701060832090185,0.6184895833333334,44.53760162601626,1021.8495934959348,25.546239837398367,0
4399,4,1,0,49,0.02040816326530612,0.0,1.0,49,1300,900,400,0.6923076923076923,17,9,8,300.29837957252255,0.8206490929705216,0.22013273022996338,0.17380906211621744,130870.93431122442,-1939.9340986394602,128931.00021258496,4345,0,647.2244897959183,41,8,15,36.514688772542186,0.6204268292682926,44.19642857142857,1023.2142857142851,24.956445993031345,0
4400,4,0,0,49,0.0,0.0,1.0,49,1000,700,300,0.7,13,7,6,299.931601945409,0.8202947845804989,0.21897177678633262,0.17371108781958958,130896.31287989712,-1948.0118378370098,128948.3010420601,4346,1,648.2244897959183,41,8,15,36.498525609953134,0.6206808943089432,44.17162698412697,1023.3134920634905,24.958865660085134,0
4401,4,0,0,49,0.0,0.0,1.0,49,1350,900,450,0.6666666666666666,18,9,9,296.7724323630787,0.8217828798185941,0.21537314528309937,0.1724806116803237,131030.32889399657,-2022.7621161589034,129007.56677783767,4347,2,649.2244897959183,42,7,16,36.44453120070668,0.6205357142857143,44.040697674418595,1023.8372093023241,24.377076411960097,0
4402,4,0,0,49,0.0,0.0,1.0,49,1700,1500,200,0.8823529411764706,19,15,4,296.8311870663948,0.8212514172335601,0.21754163778840474,0.17307239263534782,131154.36952594473,-2013.8585609338572,129140.51096501086,4348,3,650.2244897959183,42,7,16,36.31830794942137,0.6217757936507937,43.91957364341084,1024.3217054263548,24.38861203396083,0
4403,4,0,0,49,0.0,0.0,1.0,49,1300,900,400,0.6923076923076923,17,9,8,297.9904100722358,0.8207553854875284,0.21668207621647007,0.17397308700683295,131204.00221027856,-1980.4931156481266,129223.50909463043,4349,4,651.2244897959183,42,7,16,36.23872915287365,0.6222718253968256,43.87112403100774,1024.515503875967,24.393226282761116,0
4404,4,1,0,50,0.02,0.0,1.0,50,1300,800,500,0.6153846153846154,18,8,10,294.0222560524976,0.8237244897959184,0.21799861290002953,0.1730359551217411,131510.47992473075,-2266.422347226139,129244.05757750462,4350,0,639.18,40,10,18,36.03260510584893,0.6283854166666667,43.57215447154472,1025.7113821138219,25.642784552845548,0
4405,4,0,1,49,0.0,0.02,0.98,50,1250,900,350,0.72,16,9,7,294.6979139539699,0.8240986394557823,0.22109832737116908,0.17387681255139256,131607.91175555869,-2243.084589159742,129364.82716639894,4351,1,640.18,41,9,14,35.917508620967475,0.6277947154471545,43.47718253968254,1026.0912698412696,25.026616337591943,0
4406,4,0,0,49,0.0,0.0,1.0,49,1050,700,350,0.6666666666666666,14,7,7,297.7615988686405,0.8212514172335601,0.21849761181068206,0.1753334243907597,131531.5767510707,-1966.9894809775863,129564.58727009312,4352,7,654.2244897959183,41,8,17,35.91553836234686,0.6270325203252034,43.5515873015873,1025.79365079365,25.019357336430485,0
4407,4,0,0,49,0.0,0.0,1.0,49,1200,900,300,0.75,15,9,6,296.0793708044208,0.8207199546485261,0.21774231734457117,0.17480850522836341,131633.36167800447,-2005.2154195011424,129628.14625850333,4353,8,655.2244897959183,41,8,14,35.85653518948184,0.6280487804878049,43.45238095238095,1026.1904761904757,25.02903600464575,0
4408,4,0,0,49,0.0,0.0,1.0,49,1400,1200,200,0.8571428571428571,16,12,4,299.2480571308552,0.8210742630385488,0.21735581188997433,0.17738931221674392,131786.11288265287,-1912.6523526077192,129873.46053004515,4354,9,656.2244897959183,41,8,14,35.62198067632852,0.6295731707317074,43.30357142857142,1026.7857142857129,25.043554006968606,0
4409,4,0,0,49,0.0,0.0,1.0,49,1500,1000,500,0.6666666666666666,20,10,10,299.3355907227753,0.8203302154195011,0.21749843117779188,0.17808955852092373,131924.7312736613,-1902.0465266510469,130022.68474701027,4355,10,657.2244897959183,42,7,14,35.480726906872945,0.6294642857142857,43.16860465116279,1027.3255813953479,24.460132890365426,0
4410,4,0,0,49,0.0,0.0,1.0,49,1850,1500,350,0.8108108108108109,22,15,7,303.17922923120364,0.8201884920634921,0.21327853908133854,0.18138481472970275,132136.07681755815,-1787.8172153635276,130348.25960219462,4356,11,658.2244897959183,44,5,15,35.17013388568684,0.6287878787878789,42.962962962962955,1028.148148148147,23.36700336700334,0
4411,4,0,1,48,0.0,0.02040816326530612,0.9795918367346939,49,1300,900,400,0.6923076923076923,17,9,8,305.5415653221217,0.8197278911564626,0.21618542987955025,0.1832589474944994,132231.29286694108,-1719.5687585733817,130511.72410836769,4357,12,659.2244897959183,44,5,15,35.01399141759693,0.6297348484848484,42.870370370370374,1028.518518518519,23.375420875420886,0
4412,4,0,0,48,0.0,0.0,1.0,48,1150,900,250,0.782608695652174,14,9,5,313.7786202246969,0.8156028368794326,0.22339572397703922,0.18793833629453852,132178.8115978679,-1305.0229747761693,130873.78862309174,4358,36,673.7083333333334,43,5,15,34.85482472296404,0.6305717054263567,42.921401515151516,1028.314393939394,23.9142882311487,0
4413,4,0,0,48,0.0,0.0,1.0,48,1150,800,350,0.6956521739130435,15,8,7,311.6959755674723,0.8148825354609929,0.21727505677284764,0.18705202688474498,132251.8553790748,-1355.5257834022013,130896.3295956726,4359,37,674.7083333333334,43,5,15,34.83512858282699,0.6312984496124031,42.85037878787879,1028.5984848484848,23.920894996476388,0
4414,4,0,1,47,0.0,0.020833333333333332,0.9791666666666666,48,1200,800,400,0.6666666666666666,16,8,8,308.16001998001923,0.8135712174940898,0.21384364071415418,0.18540790570890875,132349.2784736572,-1443.048740243325,130906.22973341389,4360,38,675.7083333333334,43,5,16,34.82844039511628,0.632267441860465,42.75568181818183,1028.977272727274,23.92970401691335,0
4415,4,0,1,46,0.0,0.02127659574468085,0.9787234042553191,47,950,400,550,0.42105263157894735,15,4,11,315.36686224478274,0.8159111933395004,0.21590824831312294,0.1894878311518314,132298.29679894552,-1055.500251637502,131242.796547308,4361,39,680.2553191489362,42,5,18,34.69416187874794,0.6331845238095237,42.805232558139544,1028.7790697674432,24.494739756367693,0
4416,4,0,0,46,0.0,0.0,1.0,46,1100,800,300,0.7272727272727273,14,8,6,317.9458374613207,0.8127415458937198,0.21664269148342763,0.19063877946567462,132219.3889853396,-792.2791280864064,131427.1098572532,4362,40,695.0434782608696,41,5,18,34.706982894440706,0.6338922764227641,42.88194444444445,1028.472222222223,25.08468834688349,0
4417,4,0,0,46,0.0,0.0,1.0,46,2150,1900,250,0.8837209302325582,24,19,5,338.8122968925528,0.813365539452496,0.21890480256039124,0.18879517280911526,129391.54071015041,-408.4805774709731,128983.06013267944,4363,41,696.0434782608696,38,8,17,37.02855367706255,0.6104714912280702,45.646367521367516,1017.4145299145293,26.77406657669814,8
4418,4,0,0,46,0.0,0.0,1.0,46,1200,800,400,0.6666666666666666,16,8,8,339.9131697659901,0.8114331723027376,0.21329896436881235,0.19032740939306014,129581.83235627135,-390.6857239389402,129191.14663233241,4364,42,697.0434782608696,38,8,14,36.80723154949283,0.6123903508771931,45.4594017094017,1018.1623931623923,26.79374718848401,0
4419,4,1,0,47,0.02127659574468085,0.0,1.0,47,1100,700,400,0.6363636363636364,15,7,8,334.0244121762696,0.8190333024976872,0.21394895704667594,0.18825431156293934,129837.58680555577,-726.215277777759,129111.37152777801,4365,0,683.1914893617021,39,8,15,36.69766966475878,0.6132478632478633,45.20833333333334,1019.1666666666683,26.132478632478676,0
4420,4,0,0,47,0.0,0.0,1.0,47,1350,1200,150,0.8888888888888888,15,12,3,330.5457691773902,0.8185707678075855,0.21164442068061629,0.18692735612232678,129970.3247070314,-807.7718098958183,129162.55289713558,4366,1,684.1914893617021,39,8,16,36.65179027479825,0.6145833333333333,45.07812500000001,1019.6875000000011,26.145833333333364,0
4421,4,2,0,49,0.04081632653061224,0.0,1.0,49,1700,1300,400,0.7647058823529411,21,13,8,326.2218194812108,0.8307823129251701,0.237441168375762,0.18794680231374186,130693.35322381284,-1272.9953034454334,129420.3579203674,4367,0,657.2244897959183,41,8,15,36.03083260567252,0.6186483739837398,44.37003968253969,1022.5198412698426,24.939508323654696,0
4422,4,0,0,49,0.0,0.0,1.0,49,950,400,550,0.42105263157894735,15,4,11,326.2218194812108,0.8307823129251701,0.237441168375762,0.18794680231374186,130693.35322381284,-1272.9953034454334,129420.3579203674,4368,1,658.2244897959183,41,8,15,36.03083260567252,0.6186483739837398,44.37003968253969,1022.5198412698426,24.939508323654696,0
4423,4,0,1,48,0.0,0.02040816326530612,0.9795918367346939,49,900,700,200,0.7777777777777778,11,7,4,326.2218194812108,0.8315263605442177,0.237441168375762,0.18794680231374186,130693.35322381284,-1272.9953034454334,129420.3579203674,4369,2,659.2244897959183,41,8,15,36.03083260567252,0.6186483739837398,44.37003968253969,1022.5198412698426,24.939508323654696,0
4424,4,0,0,48,0.0,0.0,1.0,48,1150,600,550,0.5217391304347826,17,6,11,327.5500279563122,0.8311354905437353,0.24692106283941007,0.18933272916398508,130820.18455530377,-1029.968978332056,129790.21557697172,4370,3,671.5,41,7,16,35.868809800879234,0.6199186991869918,44.246031746031754,1023.0158730158744,24.951606658923765,0
4425,4,0,1,47,0.0,0.020833333333333332,0.9791666666666666,48,900,700,200,0.7777777777777778,11,7,4,330.8097805690155,0.8314309988179669,0.24984244715920068,0.19146869117782453,130870.93431122477,-941.3229875283175,129929.61132369646,4371,4,672.5,41,7,16,35.73419623812293,0.6204268292682925,44.196428571428584,1023.2142857142879,24.956445993031412,0
4426,4,2,1,48,0.04081632653061224,0.02040816326530612,0.9795918367346939,49,1450,1100,350,0.7586206896551724,18,11,7,329.5396945157013,0.827451814058957,0.2548984416461615,0.19264136370942772,131253.64428407274,-1149.34283171081,130104.30145236193,4372,0,659.6122448979592,42,7,17,35.38061465721039,0.622767857142857,43.82267441860466,1024.7093023255836,24.397840531561513,0
4427,4,1,0,49,0.02040816326530612,0.0,1.0,49,1050,700,350,0.6666666666666666,14,7,7,333.9922564675206,0.8295422335600907,0.27538383774562414,0.19614454334365333,131429.83119173627,-1020.669696340836,130409.16149539544,4373,0,660.5918367346939,41,8,18,35.0889286635707,0.6260162601626015,43.650793650793666,1025.396825396828,25.00967866821532,0
4428,4,1,0,50,0.02,0.0,1.0,50,1500,900,600,0.6,21,9,12,333.2249875539495,0.8366666666666667,0.2909939148073015,0.19792761308927406,131862.52170138917,-1212.0225694444184,130650.49913194474,4374,0,648.36,43,7,17,34.672920892494936,0.6274224806201549,43.22916666666668,1027.0833333333355,23.885658914728733,0
4429,4,0,0,50,0.0,0.0,1.0,50,1550,1200,350,0.7741935483870968,19,12,7,310.99146356849184,0.8370408163265306,0.20271330742180327,0.18009505655525818,130891.69841167326,-1848.9942033976363,129042.70420827562,4375,1,649.36,43,7,15,36.22023258683449,0.617732558139535,44.17613636363635,1023.2954545454522,23.797568710359354,7
4430,4,0,1,49,0.0,0.02,0.98,50,1500,1200,300,0.8,18,12,6,329.0460525703966,0.8365306122448979,0.24625311658521976,0.1852523733365169,129796.16057117115,-1455.3116698459496,128340.8489013252,4376,2,650.36,40,10,17,36.86650211096705,0.6111979166666668,45.24898373983739,1019.0040650406495,25.475101626016237,2
4431,4,1,1,49,0.02,0.02,0.98,50,1100,900,200,0.8181818181818182,13,9,4,327.98828809633454,0.8385884353741496,0.2481363364560496,0.18551490883644983,129977.44914568048,-1473.7837927159778,128503.66535296451,4377,0,651.26,40,10,17,36.70977011494252,0.6130208333333333,45.07113821138211,1019.7154471544716,25.492886178861788,0
4432,4,0,0,49,0.0,0.0,1.0,49,1050,700,350,0.6666666666666666,14,7,7,335.58581438917014,0.8347151360544218,0.2515908277186476,0.18956063569550408,129925.63950029736,-1079.7596916518028,128845.87980864555,4378,4,665.5510204081633,40,9,17,36.56860546251993,0.6125,45.12195121951219,1019.5121951219505,25.487804878048763,0
4433,4,2,1,50,0.0392156862745098,0.0196078431372549,0.9803921568627451,51,950,600,350,0.631578947368421,13,6,7,329.55510678319945,0.8439542483660132,0.2674473011721523,0.1885424374046705,130422.14084201379,-1602.434434953158,128819.70640706063,4379,0,640.4117647058823,39,12,18,36.2197464137603,0.6191239316239316,44.635416666666664,1021.4583333333325,26.191239316239294,0
4434,4,0,0,50,0.0,0.0,1.0,50,900,300,600,0.3333333333333333,15,3,12,337.0128545567927,0.838265306122449,0.2737281573715602,0.19228846871637423,130317.12420784937,-1216.290794616115,129100.83341323325,4380,1,654.22,38,12,19,36.13559868857033,0.6197916666666666,44.738247863247864,1021.0470085470085,26.86965811965812,0
4435,4,2,2,50,0.038461538461538464,0.038461538461538464,0.9615384615384616,52,1250,800,450,0.64,17,8,9,321.9218275033505,0.8461852689793865,0.2703725261932475,0.1855911743794485,130718.71456916105,-1983.7585034013618,128734.95606575969,4381,0,630.0192307692307,41,11,15,36.11515327900657,0.6189024390243902,44.345238095238095,1022.619047619048,24.94192799070849,0
4436,4,0,1,49,0.0,0.02,0.98,50,1250,1000,250,0.8,15,10,5,333.7149275117411,0.8380612244897959,0.2809824980111366,0.1915432255170134,130548.03688280813,-1286.834266970695,129261.20261583744,4382,3,656.22,40,10,15,35.98618569345,0.6187499999999999,44.51219512195123,1021.9512195121973,25.548780487804933,0
4437,4,1,1,49,0.02,0.02,0.98,50,1750,1400,350,0.8,21,14,7,332.55394064036284,0.8390646258503401,0.28021922591909965,0.1918465906022103,130744.07837498422,-1304.1083042013145,129439.9700707829,4383,0,656.9,41,9,17,35.817711869887155,0.6191565040650406,44.320436507936506,1022.7182539682537,24.944347657762286,0
4438,4,0,0,49,0.0,0.0,1.0,49,900,300,600,0.3333333333333333,15,3,12,341.17967531349876,0.8348568594104309,0.2812240146349574,0.19669351751295003,130718.71456916103,-880.2862811791392,129838.4282879819,4384,5,671.3061224489796,41,8,17,35.62281722933643,0.6189024390243902,44.345238095238095,1022.6190476190479,24.941927990708486,0
4439,4,1,0,50,0.02,0.0,1.0,50,1450,1200,250,0.8275862068965517,17,12,5,336.85274167345034,0.8381462585034013,0.2875714556123421,0.19577481124981705,131030.32889399669,-1172.414893936664,129857.91400006003,4385,0,658.86,42,8,19,35.41863839989905,0.6205357142857143,44.0406976744186,1023.837209302325,24.37707641196012,0
4440,4,1,0,51,0.0196078431372549,0.0,1.0,51,1600,1000,600,0.625,22,10,12,335.37702376296664,0.8379411764705883,0.2952390392176294,0.19683646263784607,131406.2616188282,-1384.8577532369686,130021.40386559123,4386,0,646.9215686274509,40,11,20,35.07718802656357,0.6273437499999999,43.67378048780488,1025.3048780487816,25.63262195121954,0
4441,4,1,1,51,0.019230769230769232,0.019230769230769232,0.9807692307692307,52,1200,700,500,0.5833333333333334,17,7,10,328.4403871180848,0.8398849924585218,0.2889114027586721,0.19404430638130146,131658.81406092533,-1751.585628464346,129907.22843246098,4387,0,635.4615384615385,41,11,16,35.00070484936362,0.6283028455284553,43.42757936507937,1026.2896825396829,25.031455671699582,0
4442,4,0,1,50,0.0,0.0196078431372549,0.9803921568627451,51,1600,1200,400,0.75,20,12,8,338.9336900616289,0.8361111111111111,0.2849173722151701,0.2006980150646291,131745.12215777635,-1269.427919888971,130475.69423788738,4388,2,648.9215686274509,40,11,16,34.64454233485119,0.6307291666666668,43.34349593495934,1026.6260162601616,25.66565040650404,0
4443,4,0,0,50,0.0,0.0,1.0,50,1850,1500,350,0.8108108108108109,22,15,7,354.14388765404186,0.8364625850340136,0.3028230980751605,0.204429090704,130768.17626953137,-736.2362087738027,130031.94006075757,4389,3,654.46,39,11,15,35.24130512272126,0.6225961538461537,44.29687500000001,1022.8125000000009,26.22596153846156,3
4444,4,0,0,50,0.0,0.0,1.0,50,1450,900,550,0.6206896551724138,20,9,11,335.245827902008,0.8364625850340136,0.2850946710911575,0.18567182446940408,129150.96391565894,-1302.7697935366157,127848.19412212232,4390,4,655.46,41,9,20,37.36376797449413,0.6031504065040649,45.88293650793651,1016.4682539682547,24.791908633372064,5
4445,4,1,0,51,0.0196078431372549,0.0,1.0,51,1150,500,650,0.43478260869565216,18,5,13,334.1193507349413,0.840326797385621,0.2946213384545302,0.18665981566787376,129492.7856445313,-1546.7613814188855,127946.02426311241,4391,0,643.5882352941177,39,12,15,37.04510370825229,0.609775641025641,45.546875,1017.8125000000003,26.09775641025642,0
4446,4,0,1,50,0.0,0.0196078431372549,0.9803921568627451,51,1100,700,400,0.6363636363636364,15,7,8,335.38123766307007,0.8400326797385622,0.28789720019732146,0.1882524536090416,129678.3908420141,-1501.6601562499804,128176.73068576411,4392,1,644.5882352941177,39,12,15,36.8245892138815,0.6116452991452991,45.36458333333334,1018.5416666666683,26.116452991453034,0
4447,4,0,0,50,0.0,0.0,1.0,50,1100,700,400,0.6363636363636364,15,7,8,338.19697977174724,0.8361904761904762,0.2966462167689159,0.19009002656136154,129731.44531250015,-1225.0434027777617,128506.40190972238,4393,2,657.08,39,11,15,36.699045671438306,0.6121794871794872,45.31250000000001,1018.7500000000011,26.1217948717949,0
4448,4,0,0,50,0.0,0.0,1.0,50,1250,800,450,0.64,17,8,9,341.5160814263194,0.8362414965986394,0.2993498926709597,0.19234610389140383,129811.04736328138,-1133.487955729151,128677.55940755222,4394,3,658.08,39,11,17,36.5337192067873,0.6129807692307692,45.23437500000001,1019.062500000001,26.12980769230772,0
4449,4,0,0,50,0.0,0.0,1.0,50,1300,1200,100,0.9230769230769231,14,12,2,341.7460376575135,0.8356462585034014,0.2973682059664893,0.19312992012654423,129943.7717013891,-1118.446180555532,128825.32552083356,4395,4,659.08,39,11,17,36.39320256095902,0.6143162393162392,45.10416666666668,1019.5833333333351,26.143162393162438,0
4450,4,2,1,51,0.038461538461538464,0.019230769230769232,0.9807692307692307,52,1100,600,500,0.5454545454545454,16,6,10,328.0109172948671,0.8442841880341879,0.2966442747624365,0.18801720424644222,130496.11363110594,-1838.7793878891414,128657.3342432168,4396,0,634.6923076923077,40,12,15,36.18439592865195,0.6182291666666666,44.56300813008131,1021.7479674796757,25.543699186991894,0
4451,4,0,1,50,0.0,0.0196078431372549,0.9803921568627451,51,1050,700,350,0.6666666666666666,14,7,7,332.5401161507112,0.8383986928104576,0.29132795392506794,0.1901198739858733,130395.54172092033,-1527.6502821180352,128867.8914388023,4397,1,648.1372549019608,39,12,19,36.17042750297468,0.6188568376068375,44.66145833333334,1021.3541666666682,26.188568376068417,0
4452,4,0,0,50,0.0,0.0,1.0,50,1800,1300,500,0.7222222222222222,23,13,10,336.5482359944191,0.836938775510204,0.29353624097897724,0.19256359571170834,130426.23325525991,-1221.056254109112,129205.1770011508,4398,2,661.88,38,12,20,36.03702541575149,0.6208881578947366,44.63141025641027,1021.4743589743607,26.880904183535808,0
4453,4,0,0,50,0.0,0.0,1.0,50,1300,1000,300,0.7692307692307693,16,10,6,337.9393584326457,0.8368877551020408,0.29423314166230985,0.19390461688111943,130535.38795976722,-1177.3909480239345,129357.99701174328,4399,3,662.88,38,12,17,35.8910524481617,0.6219846491228068,44.52457264957266,1021.9017094017114,26.892150247413458,0
4454,4,0,1,49,0.0,0.02,0.98,50,1350,1000,350,0.7407407407407407,17,10,7,341.29844045368594,0.8369047619047619,0.2946739130434779,0.19624660326086968,130617.28395061754,-1084.104938271578,129533.17901234597,4400,4,663.88,38,12,18,35.7223731884058,0.6228070175438596,44.44444444444446,1022.2222222222242,26.90058479532169,0
4455,4,0,0,49,0.0,0.0,1.0,49,1700,1000,700,0.5882352941176471,24,10,14,351.80208295898035,0.8322349773242631,0.3148175302292495,0.20262843876420583,130682.67549871113,-605.1125105801848,130077.56298813094,4401,5,677.7551020408164,37,12,18,35.3877345844504,0.6252815315315315,44.38048245614035,1022.4780701754386,27.634542437174016,0
4456,4,1,1,49,0.02,0.02,0.98,50,1550,1200,350,0.7741935483870968,19,12,7,342.4705773694805,0.8357482993197278,0.3015801488833747,0.19909931142513096,131041.82287535546,-1024.4062520655525,130017.4166232899,4402,0,665.18,40,10,18,35.26323407775022,0.6236979166666665,44.029471544715456,1023.8821138211396,25.597052845528488,0
4457,4,0,0,49,0.0,0.0,1.0,49,1200,800,400,0.6666666666666666,16,8,8,344.8121346675648,0.8314554988662132,0.25785123966942103,0.19582511347630607,130136.02612630703,-825.1913894695942,129310.83473683744,4403,7,679.7551020408164,41,8,17,36.120057527143075,0.6130589430894309,44.9156746031746,1020.3373015873018,24.886275648470775,2
4458,4,2,1,50,0.0392156862745098,0.0196078431372549,0.9803921568627451,51,1200,700,500,0.5833333333333334,17,7,10,332.9883665815301,0.8380718954248367,0.2678766228317282,0.191556144761497,130635.03146701399,-1499.7648032013665,129135.26666381262,4404,0,654.0588235294117,39,12,14,35.91680252700224,0.6212606837606838,44.427083333333336,1022.2916666666675,26.21260683760686,0
4459,4,0,0,50,0.0,0.0,1.0,50,1050,700,350,0.6666666666666666,14,7,7,336.72249175106487,0.8325510204081632,0.2587552197255911,0.1935288469732692,130599.97046235712,-1204.8105046599248,129395.1599576972,4405,1,668.14,40,10,16,35.856822098495385,0.6192708333333334,44.46138211382114,1022.1544715447159,25.553861788617898,0
4460,4,0,1,49,0.0,0.02,0.98,50,1100,800,300,0.7272727272727273,14,8,6,314.36197291440817,0.8337755102040816,0.1311776187378011,0.17680190625123432,129755.56456790904,-1841.9569451618602,127913.60762274718,4406,2,669.14,43,7,16,37.281675031756365,0.6063468992248062,45.28882575757575,1018.8446969696956,23.694062720225478,5
4461,4,0,0,49,0.0,0.0,1.0,49,1550,1200,350,0.7741935483870968,19,12,7,317.417562786418,0.8327664399092971,0.11782368529800946,0.17929262754242242,129924.462128386,-1551.9387769742998,128372.5233514117,4407,3,661.7755102040817,43,6,16,37.03286581212459,0.6080426356589148,45.123106060606055,1019.5075757575747,23.70947850599011,0
4462,4,0,1,48,0.0,0.02040816326530612,0.9795918367346939,49,1400,1000,400,0.7142857142857143,18,10,8,317.79733963801635,0.8327664399092971,0.1163619686894164,0.179840228615964,129996.88042534715,-1537.467447916677,128459.41297743047,4408,4,662.7755102040817,43,6,16,36.949906367041194,0.6087693798449614,45.05208333333333,1019.791666666666,23.716085271317812,0
4463,4,1,1,48,0.02040816326530612,0.02040816326530612,0.9795918367346939,49,1550,1100,450,0.7096774193548387,20,11,9,315.1013593651909,0.8352820294784581,0.12223205691121453,0.17976302239474903,130312.0504796135,-1587.4278830805808,128724.62259653292,4409,0,660.734693877551,42,7,16,36.70004112492488,0.6133432539682541,44.74321705426356,1021.0271317829449,24.31016980435583,0
4464,4,1,1,48,0.02040816326530612,0.02040816326530612,0.9795918367346939,49,1300,900,400,0.6923076923076923,17,9,8,316.4683042955899,0.8357780612244898,0.12582385568242893,0.18121337933868487,130455.99819214872,-1542.9622933884311,128913.03589876028,4410,0,661.7142857142857,43,6,18,36.51974416017798,0.6133720930232559,44.60227272727273,1021.5909090909088,23.757928118393227,0
4465,4,0,0,48,0.0,0.0,1.0,48,1650,1300,350,0.7878787878787878,20,13,7,325.08946145930184,0.8292700945626478,0.12840470770495438,0.18617154764613883,130460.49783854622,-1117.7334031909309,129342.76443535529,4411,7,676.5,42,6,18,36.29501406936671,0.6148313492063493,44.597868217054256,1021.6085271317818,24.32401255075671,0
4466,4,0,0,48,0.0,0.0,1.0,48,950,600,350,0.631578947368421,13,6,7,327.5489768873121,0.8296210106382979,0.1332582938388629,0.18842103087029097,130633.7932290725,-1042.2069361817453,129591.58629289076,4412,8,677.5,42,6,16,36.057069510268576,0.6165674603174605,44.4282945736434,1022.2868217054241,24.340162421557718,0
4467,4,0,0,48,0.0,0.0,1.0,48,1000,600,400,0.6,14,6,8,330.69395020350504,0.8300458037825059,0.13850060020217292,0.19047393900367798,130683.32732407896,-956.7628522925474,129726.5644717864,4413,9,678.5,42,6,16,35.92664107910032,0.6170634920634921,44.3798449612403,1022.4806201550377,24.34477667035804,0
4468,4,0,0,48,0.0,0.0,1.0,48,1250,1100,150,0.88,14,11,3,328.8249761758376,0.82989804964539,0.13627139789021547,0.18964037150599922,130732.87080854495,-1002.353374196286,129730.51743434866,4414,10,679.5,42,6,16,35.92437306550436,0.617559523809524,44.3313953488372,1022.6744186046494,24.34939091915832,0
4469,4,0,1,47,0.0,0.020833333333333332,0.9791666666666666,48,950,600,350,0.631578947368421,13,6,7,327.6504268845229,0.8298795803782506,0.1394519163983079,0.18944869699051414,130831.9859458564,-1026.5687909380674,129805.41715491834,4415,11,680.5,42,6,16,35.85432847130138,0.6185515873015874,44.234496124031,1023.0620155038742,24.35861941675891,0
4470,4,0,0,47,0.0,0.0,1.0,47,800,500,300,0.625,11,5,6,313.1575825478042,0.8313290163428924,0.052320954639283324,0.17831362024640934,130237.85848957411,-1190.8915667628012,129046.9669228113,4416,12,690.7021276595744,42,5,15,36.82460761977091,0.6125992063492063,44.81589147286822,1020.7364341085284,24.30324843115544,7
4471,4,0,0,47,0.0,0.0,1.0,47,1550,1300,250,0.8387096774193549,18,13,5,311.163585059776,0.8303654024051803,0.051830210648883934,0.17788361944543502,130392.29811124326,-1285.328316374618,129106.96979486864,4417,13,691.7021276595744,40,7,18,36.719527363184085,0.6171875,44.66463414634146,1021.3414634146337,25.533536585365844,0
4472,4,1,0,48,0.020833333333333332,0.0,1.0,48,1400,1100,300,0.7857142857142857,17,11,6,312.224914100011,0.8346631205673759,0.09255146476642984,0.17677069504586412,130015.40927716176,-1481.1900013520826,128534.21927580968,4418,0,678.2708333333334,42,6,14,37.07323832145686,0.6103670634920635,45.03391472868217,1019.8643410852708,24.282484311554065,1
4473,4,2,1,49,0.04,0.02,0.98,50,1300,900,400,0.6923076923076923,17,9,8,302.29890641637974,0.8429761904761904,0.1033225178455548,0.17299195244103388,130431.81392224804,-2113.8863213857367,128317.9276008623,4419,0,652.1,43,7,16,36.90601727387906,0.6131298449612403,44.62594696969697,1021.496212121212,23.755725863284,0
4474,4,1,1,49,0.02,0.02,0.98,50,750,500,250,0.6666666666666666,10,5,5,302.4948826673895,0.8432823129251701,0.10705969595847309,0.17321203790954323,130455.99819214869,-2107.545626721765,128348.45256542692,4420,0,653.08,43,7,17,36.8766221727846,0.6133720930232559,44.60227272727273,1021.5909090909086,23.757928118393224,0
4475,4,2,3,48,0.0392156862745098,0.058823529411764705,0.9411764705882353,51,1300,900,400,0.6923076923076923,17,9,8,298.5512562914199,0.8481372549019609,0.10729295338700329,0.17251016106211303,130806.65294924537,-2389.5018861454173,128417.15106309995,4421,0,640.6666666666666,44,7,14,36.62408731595461,0.6155303030303031,44.25925925925925,1022.9629629629616,23.249158249158217,0
4476,4,2,1,49,0.04,0.02,0.98,50,1100,900,200,0.8181818181818182,13,9,4,310.21050110884954,0.8430442176870748,0.10306553128470908,0.17941725128372618,130843.2514061063,-1882.209882920134,128961.04152318617,4422,0,654.38,43,7,16,36.28902875478217,0.6172480620155041,44.22348484848484,1023.1060606060588,23.793164200140904,0
4477,4,1,1,49,0.02,0.02,0.98,50,1200,900,300,0.75,15,9,6,310.7465972240869,0.840578231292517,0.10756476683937799,0.18017967933465268,130940.15438475643,-1862.158516988085,129077.99586776835,4423,0,655.36,43,7,16,36.17767702936097,0.618217054263566,44.12878787878787,1023.4848484848467,23.80197322057783,0
4478,4,1,0,50,0.02,0.0,1.0,50,1800,1600,200,0.8888888888888888,20,16,4,312.2730891311706,0.8406632653061225,0.11843992606284637,0.18244032529153656,131231.07854109243,-1804.013142791583,129427.06539830085,4424,0,656.34,43,7,17,35.845656192236596,0.6211240310077522,43.844696969696955,1024.6212121212095,23.828400281888594,0
4479,4,0,0,50,0.0,0.0,1.0,50,1400,900,500,0.6428571428571429,19,9,10,315.42695881018153,0.8399829931972789,0.10809427062169763,0.1852662877402999,131434.91753472234,-1708.2332558539888,129726.68427886834,4425,1,657.34,39,11,17,35.55973181633481,0.6292735042735043,43.645833333333336,1025.4166666666674,26.292735042735064,0
4480,4,0,0,50,0.0,0.0,1.0,50,1600,1100,500,0.6875,21,11,10,315.265321614861,0.8386224489795918,0.11400673400673389,0.18617246886940722,131640.81090124912,-1699.6434827153296,129941.16741853379,4426,2,658.34,40,10,15,35.3568363372285,0.6296875000000001,43.445121951219505,1026.2195121951208,25.65548780487802,0
4481,4,0,0,50,0.0,0.0,1.0,50,1350,700,650,0.5185185185185185,20,7,13,312.35005920803775,0.839047619047619,0.11599320562423321,0.18522515822202404,131800.32680014696,-1766.4320240670952,130033.89477607986,4427,3,659.34,42,8,15,35.271381837626976,0.6282242063492065,43.28972868217053,1026.8410852713155,24.448597268364654,0
4482,4,0,0,50,0.0,0.0,1.0,50,800,500,300,0.625,11,5,6,311.09444643187805,0.8399829931972789,0.11819087136929474,0.1846644374139961,131838.20740250478,-1797.1731699093543,130041.03423259543,4428,4,660.34,43,7,15,35.26557937605655,0.6271802325581397,43.25284090909089,1026.9886363636333,23.88345665961938,0
4483,4,0,0,50,0.0,0.0,1.0,50,950,600,350,0.631578947368421,13,6,7,309.9874043908431,0.8388945578231293,0.11749262536873206,0.18436092997981668,131911.15702479298,-1821.8405647383252,130089.31646005466,4429,5,661.34,43,7,15,35.220778023598825,0.6279069767441863,43.181818181818166,1027.272727272724,23.890063424947073,0
4484,4,0,0,50,0.0,0.0,1.0,50,1500,1200,300,0.8,18,12,6,308.211282224092,0.8382993197278912,0.1157891827144566,0.1838931855952759,132032.78456618733,-1861.201234647629,130171.5833315397,4430,6,662.34,43,7,15,35.14437252372615,0.6291182170542636,43.06344696969696,1027.746212121211,23.901074700493282,0
4485,4,0,0,50,0.0,0.0,1.0,50,1250,1000,250,0.8,15,10,5,309.0166254830135,0.8386904761904762,0.1098180508016573,0.18464491798236865,132088.48165294895,-1836.492626886174,130251.98902606277,4431,7,663.34,44,6,16,35.067818110850894,0.628314393939394,43.009259259259245,1027.9629629629605,23.36279461279456,0
4486,4,1,0,51,0.0196078431372549,0.0,1.0,51,1050,700,350,0.6666666666666666,14,7,7,303.3970107360809,0.8429411764705883,0.11356633506470648,0.1824397376893138,132328.0964887232,-2170.4102177851546,130157.68627093805,4432,0,651.3137254901961,45,6,17,34.97217698154179,0.6293981481481483,42.77626811594202,1028.8949275362297,22.864331723027327,0
4487,4,0,0,51,0.0,0.0,1.0,51,2000,1400,600,0.7,26,14,12,300.446600489303,0.8404901960784315,0.11709899112274491,0.1819408255524311,132592.99314164385,-2232.540271300817,130360.45287034303,4433,1,652.3137254901961,43,8,17,34.78300845899226,0.6346899224806202,42.5189393939394,1029.9242424242434,23.95172656800566,0
4488,4,0,0,51,0.0,0.0,1.0,51,1250,900,350,0.72,16,9,7,300.12486004921595,0.8391503267973857,0.11997591829524623,0.18198206396964176,132641.76297778933,-2238.181889921936,130403.5810878674,4434,2,653.3137254901961,43,8,14,34.74252313538028,0.6351744186046511,42.471590909090914,1030.113636363637,23.956131078224114,0
4489,4,0,0,51,0.0,0.0,1.0,51,1700,1100,600,0.6470588235294118,23,11,12,303.88145828631355,0.8392810457516341,0.11686879823594265,0.1849801897085147,132788.12629132255,-2129.630107897128,130658.49618342542,4435,3,654.3137254901961,43,8,14,34.49941810608845,0.6366279069767441,42.32954545454547,1030.6818181818203,23.969344608879542,0
4490,4,0,1,50,0.0,0.0196078431372549,0.9803921568627451,51,1200,1000,200,0.8333333333333334,14,10,4,308.9193795806622,0.8380065359477125,0.12167702970617977,0.18866085946460107,132910.1573709398,-1988.2953290001988,130921.86204193959,4436,4,655.3137254901961,43,8,14,34.247577830838466,0.6378391472868216,42.211174242424256,1031.1553030303053,23.980355884425705,0
4491,4,0,0,50,0.0,0.0,1.0,50,950,500,450,0.5263157894736842,14,5,9,314.4515994128372,0.833078231292517,0.1181325811001408,0.1912059896944269,132747.27259667404,-1651.481562856781,131095.79103381725,4437,13,669.34,42,8,14,34.26794389594108,0.6376488095238094,42.369186046511636,1030.5232558139548,24.536267995570352,0
4492,4,0,0,50,0.0,0.0,1.0,50,1300,900,400,0.6923076923076923,17,9,8,317.9724699688762,0.831751700680272,0.12404361312153389,0.19386298613174058,132847.14828022657,-1551.6528266029648,131295.4954536236,4438,14,670.34,42,8,14,34.0772550678322,0.638640873015873,42.27228682170543,1030.9108527131784,24.545496493170916,0
4493,4,0,0,50,0.0,0.0,1.0,50,1050,900,150,0.8571428571428571,12,9,3,317.9724699688762,0.8316156462585034,0.12404361312153389,0.19386298613174058,132847.14828022657,-1551.6528266029648,131295.4954536236,4439,15,671.34,42,8,14,34.0772550678322,0.638640873015873,42.27228682170543,1030.9108527131784,24.545496493170916,0
4494,4,0,1,49,0.0,0.02,0.98,50,1150,900,250,0.782608695652174,14,9,5,321.01779529793333,0.8308843537414966,0.1334034955835366,0.19611201937776157,132922.07969022292,-1465.9294062856845,131456.15028393723,4440,16,672.34,42,8,14,33.92376119776984,0.6393849206349207,42.19961240310077,1031.2015503875969,24.552417866371353,0
4495,4,0,0,49,0.0,0.0,1.0,49,1700,1300,400,0.7647058823529411,21,13,8,322.8294046959851,0.8310657596371882,0.1276069573819143,0.19769023262831864,133011.3112953514,-1212.0075113378782,131799.30378401352,4441,17,670.9183673469388,41,8,14,33.78774764377766,0.6417682926829269,42.113095238095234,1031.5476190476184,25.159698025551666,0
4496,4,0,0,49,0.0,0.0,1.0,49,1700,1200,500,0.7058823529411765,22,12,10,321.281403601578,0.8308531746031746,0.12656893743412834,0.19732681363072718,133122.00006760424,-1246.0753936061415,131875.9246739981,4442,18,671.9183673469388,42,7,15,33.71694053208139,0.6413690476190477,42.00581395348838,1031.9767441860474,24.57087486157256,0
4497,4,0,0,49,0.0,0.0,1.0,49,1300,900,400,0.6923076923076923,17,9,8,320.00415444347243,0.8300028344671202,0.12520850923618654,0.1969715012754542,133203.26063368062,-1274.880642361105,131928.37999131953,4443,19,672.9183673469388,43,6,15,33.668642785065586,0.6407461240310077,41.927083333333336,1032.2916666666672,24.006782945736447,0
4498,4,0,1,48,0.0,0.02040816326530612,0.9795918367346939,49,2200,1900,300,0.8636363636363636,25,19,6,321.70189821512815,0.8298965419501134,0.12265480135393281,0.19879901438143907,133349.93332651793,-1220.2146643996866,132129.71866211825,4444,20,673.9183673469388,43,6,16,33.47821353259374,0.6421996124031009,41.785037878787875,1032.8598484848478,24.01999647639181,0
4499,4,0,0,48,0.0,0.0,1.0,48,1500,1200,300,0.8,18,12,6,329.28526026772766,0.8283651004728132,0.12583474085890334,0.20319588990580023,133297.053634472,-821.449000210335,132475.60463426166,4445,21,687.9583333333334,42,6,17,33.33528822995838,0.6431051587301588,41.836240310077514,1032.6550387596892,24.587024732373553,0
4500,4,0,0,48,0.0,0.0,1.0,48,1500,1200,300,0.8,18,12,6,339.73417037912293,0.8283651004728132,0.15553116918470078,0.19304152743816066,130156.27170138898,-744.4415571855616,129411.83014420341,4446,22,688.9583333333334,39,9,17,36.229073091057565,0.6164529914529915,44.895833333333336,1020.4166666666674,26.164529914529933,7
4501,4,1,1,48,0.02040816326530612,0.02040816326530612,0.9795918367346939,49,1450,1000,450,0.6896551724137931,19,10,9,335.0994564092587,0.8347151360544218,0.16347017736300806,0.1920045597149039,130480.80490037642,-1055.1038356526938,129425.70106472372,4447,0,675.8775510204082,38,11,18,36.018813831085076,0.6214364035087718,44.57799145299146,1021.6880341880358,26.886527215474626,0
4502,4,0,0,48,0.0,0.0,1.0,48,1550,1100,450,0.7096774193548387,20,11,9,343.2964855915216,0.8318373226950354,0.1652017355519768,0.19630489645703028,130402.54122662736,-646.6531769390672,129755.88804968829,4448,24,690.9583333333334,37,11,18,35.88868760064411,0.6224662162162162,44.65460526315789,1021.381578947368,27.604907539118052,0
4503,4,1,1,48,0.02040816326530612,0.02040816326530612,0.9795918367346939,49,1500,1200,300,0.8,18,12,6,339.5934247049213,0.8352111678004536,0.17182432475654585,0.19568023286278133,130699.20562358446,-923.0818312148585,129776.1237923696,4449,0,677.8367346938776,38,11,13,35.68309650680876,0.6236293859649124,44.36431623931623,1022.5427350427337,26.909019343229836,0
4504,4,0,0,48,0.0,0.0,1.0,48,1200,900,300,0.75,15,9,6,310.28671408545347,0.8314679373522459,0.10574569714195547,0.17906376529097628,130757.64607182545,-1485.5279317649288,129272.11814006053,4450,26,692.9583333333334,42,6,14,36.37336175588189,0.6178075396825398,44.30717054263565,1022.771317829456,24.35169804355848,3
4505,4,1,0,49,0.02040816326530612,0.0,1.0,49,1500,1100,400,0.7333333333333333,19,11,8,299.52934367299986,0.8333333333333334,0.10637630572026335,0.17457289777190305,131138.3787722906,-1944.0414951989208,129194.33727709168,4451,0,679.795918367347,44,5,16,36.265292593262224,0.618844696969697,43.935185185185176,1024.2592592592575,23.27861952861949,0
4506,4,0,1,48,0.0,0.02040816326530612,0.9795918367346939,49,1450,1100,350,0.7586206896551724,18,11,7,300.4879387389901,0.8347151360544218,0.10930573892007134,0.1757822677570367,131280.67558299008,-1910.3480795610687,129370.32750342901,4452,1,680.795918367347,44,5,17,36.09768401397423,0.6202651515151516,43.79629629629628,1024.8148148148123,23.291245791245732,0
4507,4,2,1,49,0.04,0.02,0.98,50,1650,1100,550,0.6666666666666666,22,11,11,289.86993556908965,0.8410714285714286,0.119909796139275,0.17147802058265343,131708.02897805203,-2364.3518518518576,129343.67712620017,4453,0,662.38,44,6,12,35.94097660713214,0.6245265151515152,43.379629629629626,1026.4814814814806,23.32912457912456,0
4508,4,0,0,49,0.0,0.0,1.0,49,1050,700,350,0.6666666666666666,14,7,7,297.1518235255236,0.8352111678004536,0.12920525287066265,0.17560149745744963,131668.07008293166,-1974.9185749540802,129693.15150797759,4454,1,676.8979591836735,43,6,13,35.79419634618934,0.6254844961240309,43.41856060606061,1026.3257575757582,23.86804087385484,0
4509,4,0,0,49,0.0,0.0,1.0,49,1450,1100,350,0.7586206896551724,18,11,7,296.75527265312576,0.8351048752834467,0.1285734989375249,0.1759276884296253,131789.58553037496,-1978.1491226182181,129811.43640775674,4455,2,677.8979591836735,43,6,14,35.682487165298625,0.6266957364341085,43.3001893939394,1026.7992424242439,23.87905214940102,0
4510,4,1,2,48,0.02,0.04,0.96,50,1400,1100,300,0.7857142857142857,17,11,6,292.6974536580442,0.839625850340136,0.12271049076992369,0.17522400123302329,132159.87761488341,-2263.428069272973,129896.44954561045,4456,0,665.32,44,6,15,35.41572865075792,0.6290246212121211,42.93981481481482,1028.2407407407409,23.369107744107747,0
4511,4,1,1,48,0.02040816326530612,0.02040816326530612,0.9795918367346939,49,750,600,150,0.8,9,6,3,300.02174724356325,0.8366284013605443,0.12775453801972136,0.179236987690087,132081.45127589835,-1874.5384419478746,130206.91283395047,4457,0,679.7755102040817,43,6,15,35.306022570244146,0.6296027131782945,43.01609848484849,1027.9356060606074,23.9054792107118,0
4512,4,2,1,49,0.04,0.02,0.98,50,1650,1100,550,0.6666666666666666,22,11,11,294.2601733343755,0.8347959183673469,0.12863597853713604,0.1775085645276023,132447.87089305063,-2204.4155555404736,130243.45533751015,4458,0,667.14,42,8,17,35.08738899871348,0.6346726190476188,42.659883720930246,1029.3604651162816,24.50858250276861,0
4513,4,0,0,49,0.0,0.0,1.0,49,1050,700,350,0.6666666666666666,14,7,7,300.2372661159029,0.8323767006802721,0.12646008727465086,0.1805322781969652,132326.5432098767,-1854.1280864197354,130472.41512345696,4459,1,681.7551020408164,44,5,17,35.055008099352065,0.6306818181818181,42.777777777777786,1028.88888888889,23.38383838383841,0
4514,4,1,0,50,0.02,0.0,1.0,50,1050,600,450,0.5714285714285714,15,6,9,293.5724941603233,0.8357653061224489,0.13560132401618197,0.1777780872209175,132592.99314164388,-2214.8302787980724,130378.1628628458,4460,0,669.1,43,7,19,34.96000367782271,0.6346899224806202,42.5189393939394,1029.9242424242436,23.951726568005665,0
4515,4,0,1,49,0.0,0.02,0.98,50,1400,900,500,0.6428571428571429,19,9,10,295.9049276257505,0.8343537414965986,0.1392418253683072,0.18019768349725734,132803.30932784674,-2140.569272976647,130662.7400548701,4461,1,670.1,44,6,13,34.68978320756977,0.6354166666666665,42.31481481481483,1030.7407407407438,23.425925925925995,0
4516,4,0,0,49,0.0,0.0,1.0,49,1350,800,550,0.5925925925925926,19,8,11,299.59094905988024,0.8296130952380952,0.13293256233791229,0.18279151878256283,132874.89819101532,-1838.3766289437392,131036.52156207159,4462,4,684.7551020408164,44,5,14,34.5232749588385,0.6361268939393938,42.24537037037038,1031.0185185185203,23.432239057239098,0
4517,4,0,0,49,0.0,0.0,1.0,49,1300,800,500,0.6153846153846154,18,8,10,287.9820618853325,0.8284438775510204,0.09881924590710378,0.17660892215675647,133065.8961334022,-2134.5421810699318,130931.35395233225,4463,5,685.7551020408164,44,5,12,34.63198121391606,0.6380208333333333,42.0601851851852,1031.7592592592614,23.449074074074122,2
4518,4,0,0,49,0.0,0.0,1.0,49,1750,1300,450,0.7428571428571429,22,13,9,288.6352281025403,0.8271683673469388,0.09467806493057296,0.177919924188581,133257.03125000017,-2107.465277777762,131149.56597222242,4464,6,686.7551020408164,44,5,14,34.42460317460316,0.6399147727272727,41.87500000000001,1032.5000000000014,23.465909090909122,0
4519,4,0,0,49,0.0,0.0,1.0,49,1000,800,200,0.8,12,8,4,288.8576830617953,0.8262471655328798,0.10208837074890886,0.1788609338292737,133424.38700274352,-2091.868141289437,131332.51886145407,4465,7,687.7551020408164,44,5,15,34.2521434546215,0.6415719696969697,41.71296296296296,1033.1481481481483,23.480639730639734,0
4520,4,0,0,49,0.0,0.0,1.0,49,1650,1200,450,0.7272727272727273,21,12,9,290.2621182228906,0.8249007936507937,0.10224272926466327,0.18043856961965068,133570.09369260757,-2045.9237613225719,131524.169931285,4466,8,688.7551020408164,43,6,18,34.070782948577005,0.6443798449612405,41.57196969696968,1033.7121212121185,24.03981677237485,0
4521,4,0,0,49,0.0,0.0,1.0,49,1300,800,500,0.6153846153846154,18,8,10,289.69126111983275,0.8234481292517007,0.1083651042834719,0.1805609915198957,133668.0010330578,-2055.50964187328,131612.49139118454,4467,9,689.7551020408164,43,6,18,33.98809523809525,0.6453488372093024,41.47727272727273,1034.0909090909088,24.048625792811833,0
4522,4,0,0,49,0.0,0.0,1.0,49,1050,900,150,0.8571428571428571,12,9,3,289.36084913813966,0.8227749433106576,0.10246310573304607,0.18059423967352903,133716.9681545568,-2061.508910123981,131655.4592444328,4468,10,690.7551020408164,43,6,11,33.94791857413172,0.6458333333333335,41.429924242424235,1034.2803030303019,24.053030303030276,0
4523,4,0,0,49,0.0,0.0,1.0,49,1050,800,250,0.7619047619047619,13,8,5,290.67391157617,0.8225977891156463,0.10382445281581099,0.18201683849815495,133839.42519118718,-2019.2741513143071,131820.15103987287,4469,11,691.7551020408164,43,6,14,33.792154754278386,0.647044573643411,41.31155303030302,1034.7537878787857,24.06404157857641,0
4524,4,0,0,49,0.0,0.0,1.0,49,900,600,300,0.6666666666666666,12,6,6,290.89640886518936,0.8203656462585034,0.10798611953699444,0.18288501656832146,133986.44761715137,-2004.7647103133845,131981.682906838,4470,12,692.7551020408164,43,6,14,33.64022150065551,0.6484980620155041,41.169507575757564,1035.3219696969677,24.077255109231807,0
4525,4,0,1,48,0.0,0.02040816326530612,0.9795918367346939,49,1700,1200,500,0.7058823529411765,22,12,10,288.5425597091938,0.8186649659863946,0.10712279191261853,0.1821791285567976,134142.81550068557,-2058.8177297668312,132083.99777091874,4471,13,693.7551020408164,44,5,14,33.545800560123936,0.6486742424242425,41.018518518518505,1035.9259259259234,23.543771043770985,0
4526,4,0,0,48,0.0,0.0,1.0,48,1300,800,500,0.6153846153846154,18,8,10,293.98150254001615,0.8172096631205673,0.1016215557181177,0.18519479906553082,134059.98909550035,-1717.7685950413315,132342.22050045902,4472,14,707.8125,43,5,14,33.48725920507194,0.6492248062015504,41.098484848484844,1035.6060606060598,24.08386187455953,0
4527,4,0,0,48,0.0,0.0,1.0,48,1200,800,400,0.6666666666666666,16,8,8,294.0229657301741,0.8171727245862884,0.100516976014142,0.18534462110610436,134084.50740537464,-1715.2150948404578,132369.2923105342,4473,15,708.8125,43,5,14,33.461815397275316,0.649467054263566,41.0748106060606,1035.7007575757566,24.08606412966876,0
4528,4,0,0,48,0.0,0.0,1.0,48,850,600,250,0.7058823529411765,11,6,5,295.7307360053131,0.8154550827423168,0.10062494287542312,0.18692027629313274,134182.6030636621,-1663.616007374891,132518.9870562872,4474,16,709.8125,43,5,14,33.320099472930565,0.6504360465116279,40.98011363636363,1036.0795454545448,24.094873150105695,0
4529,4,0,0,48,0.0,0.0,1.0,48,1400,1100,300,0.7857142857142857,17,11,6,295.92043644990525,0.813386524822695,0.10010199732066738,0.18791977600078666,134354.35677800732,-1648.3600206611604,132705.99675734615,4475,17,710.8125,43,5,16,33.14456217269516,0.6521317829457365,40.81439393939394,1036.742424242424,24.110288935870326,0
4530,4,0,1,47,0.0,0.020833333333333332,0.9791666666666666,48,1400,1100,300,0.7857142857142857,17,11,6,293.9861342766234,0.8119089834515366,0.10027884293496481,0.18731996095007888,134477.10525891007,-1693.1191352444928,132783.98612366559,4476,18,711.8125,43,5,16,33.072845339176475,0.653343023255814,40.69602272727273,1037.2159090909088,24.121300211416482,0
4531,4,0,0,47,0.0,0.0,1.0,47,1450,1000,450,0.6896551724137931,19,10,9,297.6877908274898,0.8125578168362627,0.10245639667610251,0.1894235326758768,134427.99914091197,-1396.4851820764475,133031.5139588355,4477,19,721.2553191489362,43,4,16,33.025617903996604,0.6528585271317829,40.74337121212121,1037.026515151515,24.116895701198022,0
4532,4,0,0,47,0.0,0.0,1.0,47,1300,1000,300,0.7692307692307693,16,10,6,309.8458634790818,0.8137141535615171,0.05080213903743336,0.19979716024340757,134911.26543209862,-1028.8949907853919,133882.37044131322,4478,20,722.2553191489362,41,6,14,32.230392156862735,0.660569105691057,40.27777777777777,1038.8888888888878,25.33875338753385,4
4533,4,0,0,47,0.0,0.0,1.0,47,1300,700,600,0.5384615384615384,19,7,12,311.7219470850877,0.8134057971014492,0.05048064231845406,0.20186789626437254,135065.90628149395,-979.3985418241526,134086.5077396698,4479,21,723.2553191489362,41,6,16,32.02821785327988,0.6620934959349594,40.128968253968246,1039.484126984126,25.353271389856733,0
4534,4,0,1,46,0.0,0.02127659574468085,0.9787234042553191,47,1600,1000,600,0.625,22,10,12,311.3941121170396,0.8122494603761948,0.05718964939517113,0.20215185826545348,135154.65496552165,-982.7272437053257,134171.92772181632,4480,22,724.2553191489362,42,5,16,31.948715559283087,0.6614583333333335,40.04360465116278,1039.825581395347,24.75775193798445,0
4535,4,0,0,46,0.0,0.0,1.0,46,1200,1000,200,0.8333333333333334,14,10,4,316.7277099097574,0.8087761674718197,0.0594056325524861,0.20554941966341542,135143.2599226029,-639.2769549950006,134503.9829676079,4481,23,737.3478260869565,41,5,16,31.82137121139839,0.6628556910569108,40.05456349206347,1039.781746031743,25.360530391018123,0
4536,4,0,0,46,0.0,0.0,1.0,46,1300,1000,300,0.7692307692307693,16,10,6,318.8117162754028,0.8082528180354267,0.0593094555992717,0.20779232247235196,135298.0336376446,-573.0803374590853,134724.95330018553,4482,24,738.3478260869565,41,5,16,31.613644671180193,0.6643800813008132,39.905753968253954,1040.376984126982,25.375048393341025,0
4537,4,0,0,46,0.0,0.0,1.0,46,900,500,400,0.5555555555555556,13,5,8,317.50207424384456,0.8083333333333333,0.05969660546276012,0.20738460515678198,135375.4537115768,-603.6025289745901,134771.8511826022,4483,25,739.3478260869565,41,5,16,31.57094057832856,0.6651422764227644,39.83134920634919,1040.6746031745997,25.382307394502433,0
4538,4,0,0,46,0.0,0.0,1.0,46,1250,900,350,0.72,16,9,7,319.64827786013444,0.8079911433172303,0.05834324332163421,0.20923701681761628,135452.89592978382,-540.5430169753249,134912.35291280848,4484,26,740.3478260869565,41,5,17,31.438319991105168,0.6659044715447155,39.756944444444436,1040.9722222222213,25.389566395663934,0
4539,4,0,0,46,0.0,0.0,1.0,46,650,600,50,0.9230769230769231,7,6,1,319.17282799188376,0.8074074074074075,0.061314539985581895,0.20907613339243594,135478.7149234692,-551.7750850340335,134926.93983843518,4485,27,741.3478260869565,41,5,17,31.425100057175513,0.666158536585366,39.73214285714285,1041.071428571427,25.391986062717734,0
4540,4,0,0,46,0.0,0.0,1.0,46,1600,1300,300,0.8125,19,13,6,324.4909985553788,0.8061795491143318,0.06622598609704244,0.21364282268284035,135660.80864800359,-395.6805932008118,135265.12805480277,4486,28,742.3478260869565,39,7,18,31.106160217311615,0.6712072649572649,39.55729166666667,1041.7708333333342,26.712072649572672,0
4541,4,0,1,45,0.0,0.021739130434782608,0.9782608695652174,46,1150,700,450,0.6086956521739131,16,7,9,325.1142565764576,0.8054951690821256,0.07168436973036862,0.21454109649016398,135742.2092013891,-373.65451388886436,135368.55468750023,4487,29,743.3478260869565,39,7,18,31.00926296148207,0.6720085470085468,39.47916666666668,1042.083333333335,26.720085470085515,0
4542,4,0,1,44,0.0,0.022222222222222223,0.9777777777777777,45,1000,800,200,0.8,12,8,4,331.9351347642467,0.8013047138047138,0.07119586266602873,0.21905922222533614,135744.9925578935,11.706479655229316,135756.69903754874,4488,30,758.3333333333334,38,7,18,30.82880527646779,0.6737938596491226,39.47649572649574,1042.0940170940194,27.42352676563209,0
4543,4,0,0,44,0.0,0.0,1.0,44,1150,800,350,0.6956521739130435,15,8,7,329.0202948240217,0.7993084918957012,0.08055860925301417,0.2178141137647767,135856.35021732803,139.8992804441807,135996.24949777222,4489,31,772.2954545454545,38,6,18,30.79439092710256,0.6748903508771928,39.36965811965813,1042.5213675213695,27.434772829509722,0
4544,4,0,1,43,0.0,0.022727272727272728,0.9772727272727273,44,1000,800,200,0.8,12,8,4,328.7916134775594,0.7997269203664553,0.08169709388971613,0.21800313502316465,135912.04616845667,137.34819015269716,136049.39435860937,4490,32,773.2954545454545,38,6,15,30.745175887978135,0.675438596491228,39.316239316239326,1042.7350427350445,27.44039586144854,0
4545,4,0,0,43,0.0,0.0,1.0,43,1650,1400,250,0.8484848484848485,19,14,5,333.27208833991995,0.7988187523071244,0.07938075772096931,0.22137458828836043,135976.55047707,463.4377885503383,136439.98826562034,4491,33,782.3720930232558,37,6,16,30.564462433417436,0.6779279279279278,39.25438596491229,1042.9824561403518,28.18871503082032,0
4546,4,0,0,43,0.0,0.0,1.0,43,1500,1200,300,0.8,18,12,6,332.563716987766,0.797296050203027,0.08120721081720328,0.2219734542980054,136148.14774738377,455.58681517389795,136603.73456255769,4492,34,783.3720930232558,37,6,17,30.412989423548364,0.679617117117117,39.08991228070175,1043.6403508771928,28.206495969653858,0
4547,4,0,0,43,0.0,0.0,1.0,43,1500,1200,300,0.8,18,12,6,336.6210363941002,0.7966039128829826,0.08857380784343416,0.22559057914011355,136291.22813029002,575.6988929285874,136866.92702321862,4493,35,784.3720930232558,37,6,18,30.165454688648534,0.6810247747747749,38.95285087719298,1044.1885964912276,28.221313418681827,0
4548,4,0,0,43,0.0,0.0,1.0,43,1050,800,250,0.7619047619047619,13,8,5,355.62560806986215,0.7962809154669619,0.08352954508253507,0.23111910559642343,135194.14420755216,1016.3762380790216,136210.52044563118,4494,36,785.3720930232558,36,7,17,30.759565060458407,0.6721643518518519,40.005630630630634,1039.9774774774778,28.888263263263273,2
4549,4,0,0,43,0.0,0.0,1.0,43,1000,700,300,0.7,13,7,6,354.9144419898652,0.7954964931709118,0.08771598550823145,0.23103204373928038,135252.70783875103,1000.6278660417295,136253.33570479276,4495,37,786.3720930232558,36,7,17,30.719750279672336,0.6727430555555556,39.94932432432433,1040.2027027027036,28.894519519519545,0
4550,4,0,1,42,0.0,0.023255813953488372,0.9767441860465116,43,950,600,350,0.631578947368421,13,6,7,356.14987859711965,0.795173495754891,0.08915651731724905,0.23202486449084564,135281.9944099505,1036.1331770960219,136318.12758704653,4496,38,787.3720930232558,36,7,17,30.658466839864335,0.6730324074074073,39.921171171171174,1040.3153153153155,28.897647647647652,0
4551,4,0,0,42,0.0,0.0,1.0,42,1300,1100,200,0.8461538461538461,15,11,4,353.6168801434068,0.7935782036391793,0.10293626960293656,0.23089102174069498,135362.548828125,1173.2964409722222,136535.84526909722,4497,39,802.3095238095239,35,7,17,30.644185852519193,0.6758928571428571,39.84375,1040.625,29.732142857142858,0
4552,4,0,0,42,0.0,0.0,1.0,42,1250,800,450,0.64,17,8,9,353.3211252969417,0.7931426635694928,0.10476137524953288,0.2310848639851197,135422.77688025116,1169.5455836333954,136592.32246388454,4498,40,803.3095238095239,35,7,17,30.591965046888316,0.6764880952380953,39.785879629629626,1040.856481481481,29.738756613756603,0
4553,4,0,0,42,0.0,0.0,1.0,42,1350,1100,250,0.8148148148148148,16,11,5,354.09047961833176,0.7919570267131243,0.10568718372186625,0.23217186258356476,135513.1440757885,1196.7828360767928,136709.9269118653,4499,41,804.3095238095239,35,7,17,30.482066103453384,0.6773809523809524,39.69907407407406,1041.2037037037019,29.748677248677197,0
4554,4,0,0,42,0.0,0.0,1.0,42,650,400,250,0.6153846153846154,9,4,5,354.541877413623,0.7915940766550522,0.10459835818288687,0.2326632582852197,135543.2731722606,1211.1533082561518,136754.42648051676,4500,42,805.3095238095239,35,7,17,30.440355118372803,0.6776785714285715,39.67013888888888,1041.3194444444428,29.75198412698408,0
4555,4,0,0,42,0.0,0.0,1.0,42,950,700,250,0.7368421052631579,12,7,5,355.67461942772564,0.7917634533488193,0.10714929284504371,0.23380487242978232,135604.35593955452,1246.2055383085892,136850.5614778631,4501,43,806.3095238095239,36,6,17,30.350127941759457,0.6762152777777778,39.61148648648649,1041.5540540540549,28.93205705705708,0
4556,4,0,0,42,0.0,0.0,1.0,42,1000,800,200,0.8,12,8,4,355.89644479374795,0.7906262098335269,0.11052362457434461,0.23495606920999015,135757.71683673467,1263.1440959023023,137020.86093263698,4502,44,807.3095238095239,34,8,17,30.19191226867719,0.6819852941176471,39.464285714285715,1042.142857142857,30.65126050420168,0
4557,4,0,0,42,0.0,0.0,1.0,42,800,300,500,0.375,13,3,10,355.56739870600177,0.7900938830816879,0.10882216964455704,0.23494283589970147,135788.7347647391,1256.4094387754972,137045.14420351462,4503,45,808.3095238095239,34,8,18,30.16966495335998,0.6822916666666667,39.4345238095238,1042.261904761904,30.65476190476188,0
4558,4,0,1,41,0.0,0.023809523809523808,0.9761904761904762,42,1100,1000,100,0.9090909090909091,12,10,2,355.75548988275966,0.7887630662020906,0.10715780775148298,0.23588662648622954,135912.84190759633,1270.347930839001,137183.18983843533,4504,46,809.3095238095239,34,8,17,30.041481143205093,0.6835171568627451,39.31547619047619,1042.738095238095,30.668767507002794,0
4559,4,0,0,41,0.0,0.0,1.0,41,1200,700,500,0.5833333333333334,17,7,10,352.0002362948959,0.7860772357723578,0.15010604453870635,0.22241773172479715,134171.33349565798,1245.668218894592,135417.00171455258,4505,47,827.9512195121952,36,5,20,31.87386775362319,0.662037037037037,40.990990990991,1036.0360360360373,28.778778778778815,7
4560,4,0,0,41,0.0,0.0,1.0,41,1350,1200,150,0.8888888888888888,15,12,3,354.79351649885035,0.7865853658536586,0.11305439883667101,0.22871909082473077,134901.51627556622,1372.9724657089657,136274.48874127519,4506,48,828.9512195121952,36,5,19,31.07271906052394,0.6692708333333333,40.28716216216217,1038.8513513513524,28.85698198198201,3
4561,4,0,0,41,0.0,0.0,1.0,41,1400,900,500,0.6428571428571429,19,9,10,353.24443606507185,0.7867886178861788,0.11450672278238039,0.22790441728226252,134930.7648019642,1332.7083840597431,136263.47318602394,4507,49,829.9512195121952,36,5,19,31.08380302044945,0.6695601851851851,40.25900900900901,1038.9639639639645,28.860110110110124,0
4562,4,0,0,41,0.0,0.0,1.0,41,1000,900,100,0.9,11,9,2,353.6909622923147,0.7864837398373984,0.12179529531778122,0.22874659362268912,135018.52940355905,1350.9667184076045,136369.49612196666,4508,50,830.9512195121952,36,5,19,30.98475818976415,0.6704282407407407,40.17454954954955,1039.3018018018024,28.86949449449451,0
4563,4,0,0,41,0.0,0.0,1.0,41,1200,800,400,0.6666666666666666,16,8,8,355.341576206939,0.7861280487804878,0.12751511180623099,0.2303731342375325,135106.32253875516,1401.7787212888786,136508.10126004403,4509,51,831.9512195121952,36,5,19,30.854410384171018,0.6712962962962962,40.0900900900901,1039.639639639641,28.87887887887892,0
4564,4,0,0,41,0.0,0.0,1.0,41,1450,1000,450,0.6896551724137931,19,10,9,356.8792611283803,0.7847560975609756,0.12647223483928194,0.23212231378744547,135223.42443795173,1451.6871601331375,136675.11159808488,4510,52,832.9512195121952,36,5,19,30.697812906019927,0.6724537037037035,39.97747747747749,1040.0900900900922,28.89139139139145,0
4565,4,0,0,41,0.0,0.0,1.0,41,750,500,250,0.6666666666666666,10,5,5,357.6964051121352,0.7840955284552845,0.1274041242573274,0.23290774161282296,135262.72657211855,1476.598208102515,136739.32478022107,4511,53,833.9512195121952,37,4,19,30.637429289202764,0.6708896396396395,39.93969298245615,1040.2412280701772,28.114627785680465,0
4566,4,0,0,41,0.0,0.0,1.0,41,950,600,350,0.631578947368421,13,6,7,358.97583946719993,0.7830792682926829,0.12473206713099794,0.23429716069764311,135348.28625153904,1517.3529355186351,136865.63918705768,4512,54,834.9512195121952,37,4,20,30.51896733403582,0.6717342342342342,39.857456140350884,1040.5701754385975,28.12351825509723,0
4567,4,0,0,41,0.0,0.0,1.0,41,750,600,150,0.8,9,6,3,357.32710083537387,0.7828252032520325,0.12171482018233548,0.23359151798411656,135405.34106648216,1476.799592182228,136882.14065866437,4513,55,835.9512195121952,37,4,20,30.505074448658522,0.6722972972972971,39.80263157894738,1040.789473684212,28.12944523470843,0
4568,4,0,0,41,0.0,0.0,1.0,41,1150,900,250,0.782608695652174,14,9,5,353.4620514582515,0.7826219512195122,0.11657396422353328,0.2321703018499637,135576.5776488921,1384.2350530932754,136960.8127019854,4514,56,836.9512195121952,37,4,20,30.435354811539273,0.6739864864864864,39.63815789473685,1041.4473684210539,28.147226173541995,0
4569,4,0,0,41,0.0,0.0,1.0,41,1000,600,400,0.6,14,6,8,348.9758698092031,0.7822154471544716,0.11319495770715293,0.2303240740740742,135747.92243767323,1274.5498614958587,137022.47229916908,4515,57,837.9512195121952,37,4,20,30.381944444444464,0.6756756756756757,39.47368421052632,1042.1052631578955,28.165007112375555,0
4570,4,0,0,41,0.0,0.0,1.0,41,900,500,400,0.5555555555555556,13,5,8,349.331453057276,0.7818089430894309,0.11252456728228122,0.2309280106232593,135805.06141312726,1288.1958871960776,137093.25730032334,4516,58,838.9512195121952,37,4,20,30.31594080931344,0.6762387387387387,39.418859649122815,1042.3245614035097,28.170934091986748,0
4571,4,0,0,41,0.0,0.0,1.0,41,850,700,150,0.8235294117647058,10,7,3,347.8831446396887,0.7815548780487804,0.11103216721514153,0.23052409912047375,135890.79241930204,1254.823238881188,137145.61565818323,4517,59,839.9512195121952,37,4,19,30.268583271987932,0.6770833333333333,39.33662280701754,1042.6535087719294,28.179824561403496,0
4572,4,0,0,41,0.0,0.0,1.0,41,1100,700,400,0.6363636363636364,15,7,8,346.875468754555,0.7821646341463414,0.10743913978935815,0.23022558152997716,135947.9614520814,1231.4025709833772,137179.36402306476,4518,60,840.9512195121952,37,4,19,30.23812340097431,0.6776463963963963,39.281798245614034,1042.8728070175437,28.185751541014692,0
4573,4,0,0,41,0.0,0.0,1.0,41,950,600,350,0.631578947368421,13,6,7,348.2680912318933,0.7813516260162602,0.1099983338246413,0.2318943938468487,136062.3355864305,1277.2339806478983,137339.5695670784,4519,61,841.9512195121952,37,4,19,30.088347346295325,0.6787725225225224,39.17214912280702,1043.3114035087724,28.197605500237092,0
4574,4,0,0,41,0.0,0.0,1.0,41,1300,900,400,0.6923076923076923,17,9,8,346.52037423527804,0.7808943089430894,0.11166667093801363,0.23110262099489434,136119.54068800024,1233.6388359880068,137353.17952398825,4520,62,842.9512195121952,37,4,19,30.0772083289552,0.6793355855855856,39.117324561403514,1043.5307017543867,28.20353247984829,0
4575,4,0,0,41,0.0,0.0,1.0,41,1250,1000,250,0.8,15,10,5,349.934976433004,0.7793191056910569,0.11208086873432532,0.2341342874644155,136233.98695993004,1334.6074032394627,137568.5943631695,4521,63,843.9512195121952,37,4,19,29.874641144137524,0.6804617117117118,39.00767543859649,1043.9692982456145,28.215386439070663,0
4576,4,0,0,41,0.0,0.0,1.0,41,1200,800,400,0.6666666666666666,16,8,8,351.92420889087447,0.7795731707317073,0.11662449677835673,0.23603705390680924,136319.85322406905,1394.8513004001334,137714.70452446918,4522,64,844.9512195121952,37,4,19,29.737592748145033,0.6813063063063063,38.92543859649123,1044.298245614036,28.224276908487457,0
4577,4,0,0,41,0.0,0.0,1.0,41,850,500,350,0.5882352941176471,12,5,7,350.9698240802774,0.7791666666666667,0.11591190122040818,0.2359696199021035,136405.74653980086,1374.860173322577,137780.60671312344,4523,65,845.9512195121952,37,4,19,29.677386200622784,0.6821509009009008,38.84320175438597,1044.6271929824575,28.233167377904255,0
4578,4,0,0,41,0.0,0.0,1.0,41,1200,800,400,0.6666666666666666,16,8,8,349.3622755609698,0.7794207317073171,0.11217259527759005,0.23507936169102556,136434.38365650972,1333.005347799326,137767.38900430905,4524,66,846.9512195121952,37,4,19,29.690998460677314,0.6824324324324325,38.81578947368421,1044.7368421052633,28.23613086770982,0
4579,4,0,0,41,0.0,0.0,1.0,41,900,600,300,0.6666666666666666,12,6,6,347.9892511182384,0.7788109756097561,0.11535144624345195,0.23472650760141064,136520.31304103194,1301.5202995152454,137821.8333405472,4525,67,847.9512195121952,37,4,19,29.641761095372996,0.683277027027027,38.73355263157895,1045.0657894736848,28.245021337126616,0
4580,4,0,0,41,0.0,0.0,1.0,41,1350,1000,350,0.7407407407407407,17,10,7,348.0528365536513,0.7780487804878049,0.1087648841879083,0.23553469102477406,136634.92763398358,1311.234827062176,137946.16246104575,4526,68,848.9512195121952,37,4,20,29.526634329662638,0.6844031531531531,38.62390350877193,1045.5043859649127,28.25687529634899,0
4581,4,0,0,41,0.0,0.0,1.0,41,1250,1000,250,0.8,15,10,5,345.86752591228685,0.7775914634146341,0.10961033913127904,0.23462905136211915,136720.920138889,1257.4652777777874,137978.38541666677,4527,69,849.9512195121952,37,4,20,29.498671978751652,0.6852477477477477,38.54166666666667,1045.8333333333342,28.26576576576579,0
4582,4,0,0,41,0.0,0.0,1.0,41,1100,900,200,0.8181818181818182,13,9,4,346.00990289222483,0.7759654471544716,0.10516790978012436,0.23549404375161287,136835.61889235166,1269.2958410280269,138104.9147333797,4528,70,850.9512195121952,37,4,20,29.381506322923226,0.6863738738738738,38.43201754385966,1046.2719298245627,28.27761972498818,0
4583,4,0,0,41,0.0,0.0,1.0,41,900,700,200,0.7777777777777778,11,7,4,347.13395795745674,0.7759146341463414,0.10454349120668183,0.23645248827894452,136864.30109504866,1302.0493084410787,138166.35040348975,4529,71,851.9512195121952,37,4,20,29.323740787313564,0.6866554054054053,38.404605263157904,1046.38157894737,28.280583214793783,0
4584,4,0,0,41,0.0,0.0,1.0,41,850,700,150,0.8235294117647058,10,7,3,343.8260790003719,0.7765752032520326,0.12435347975201805,0.2154139328070896,133858.89788333708,1004.8359997078016,134863.7338830449,4530,72,852.9512195121952,38,3,14,32.39770459081836,0.6551535087719298,41.292735042735046,1034.8290598290605,27.23234367971212,8
4585,4,0,0,41,0.0,0.0,1.0,41,700,500,200,0.7142857142857143,9,5,4,346.41949985143157,0.7753556910569106,0.12688967756550618,0.21769163122959612,133969.4793721236,1081.92800788955,135051.40738001314,4531,73,853.9512195121952,38,3,14,32.22007223942209,0.65625,41.18589743589744,1035.2564102564104,27.243589743589748,0
4586,4,0,0,41,0.0,0.0,1.0,41,850,500,350,0.5882352941176471,12,5,7,343.79987238414793,0.7745934959349593,0.1281928074566978,0.21686010167627265,134107.77043839925,1021.2468724888415,135129.0173108881,4532,74,854.9512195121952,38,3,14,32.14973353962524,0.6576206140350878,41.05235042735042,1035.7905982905968,27.257647323436757,0
4587,4,0,0,41,0.0,0.0,1.0,41,750,600,150,0.8,9,6,3,344.6349734694568,0.7731707317073171,0.13044014115504687,0.2177150057155257,134163.10683988951,1047.459753269036,135210.56659315855,4533,75,855.9512195121952,38,3,15,32.072848991096905,0.6581688596491229,40.99893162393162,1036.0042735042723,27.263270355375585,0
4588,4,1,0,42,0.023809523809523808,0.0,1.0,42,1150,700,450,0.6086956521739131,16,7,9,338.71654807065124,0.778164924506388,0.13324341387820726,0.2156177719048211,134442.73003472213,707.5954861111062,135150.32552083323,4534,0,836.547619047619,39,3,16,31.947234498459895,0.6591880341880343,40.729166666666664,1037.0833333333328,26.59188034188033,0
4589,4,0,0,42,0.0,0.0,1.0,42,1000,800,200,0.8,12,8,4,338.4849023056915,0.7786488579171505,0.13484731108752035,0.21578954271191242,134496.75021701376,705.0238715277685,135201.77408854154,4535,1,837.547619047619,39,3,16,31.899394121978975,0.6597222222222223,40.67708333333333,1037.2916666666656,26.597222222222197,0
4590,4,0,0,42,0.0,0.0,1.0,42,900,700,200,0.7777777777777778,11,7,4,339.8573920534987,0.7793747580332946,0.14000133828498806,0.21746944104232546,134631.84814453125,751.1257595486122,135382.97390407987,4536,2,838.547619047619,39,3,19,31.72916875773696,0.6610576923076923,40.546875,1037.8125,26.610576923076923,0
4591,4,0,0,42,0.0,0.0,1.0,42,800,600,200,0.75,10,6,4,340.740275154423,0.7788908246225319,0.1330748613280972,0.2186837297143676,134739.97531466992,782.2672526041431,135522.24256727408,4537,3,839.547619047619,39,3,19,31.598546035249647,0.6621260683760685,40.44270833333332,1038.229166666665,26.62126068376064,0
4592,4,0,0,42,0.0,0.0,1.0,42,1150,800,350,0.6956521739130435,15,8,7,342.455260461939,0.7780439411536972,0.13666060145851566,0.22044037456849516,134848.14588758664,835.8913845485915,135684.03727213523,4538,4,840.547619047619,39,3,16,31.446298432119818,0.6631944444444446,40.33854166666666,1038.645833333332,26.631944444444407,0
4593,4,0,0,42,0.0,0.0,1.0,42,1350,800,550,0.5925925925925926,19,8,11,342.29700850071214,0.7776809910956253,0.13425057178190647,0.22066761899014847,134902.24745008658,835.3271484374761,135737.57459852405,4539,5,841.547619047619,39,3,17,31.396541495370826,0.6637286324786327,40.28645833333332,1038.854166666665,26.63728632478628,0
4594,4,0,0,42,0.0,0.0,1.0,42,1000,700,300,0.7,13,7,6,329.46077373442483,0.7776809910956253,0.1202991582389632,0.20615330642957774,133812.3509156663,433.31640354483073,134245.66731921112,4540,6,842.547619047619,37,5,16,32.81581178465451,0.6565315315315315,41.33771929824561,1034.649122807017,27.963489805595053,5
4595,4,0,0,42,0.0,0.0,1.0,42,1550,1100,450,0.7096774193548387,20,11,9,330.60183855214046,0.7771970576848626,0.12218523002421278,0.20750540930400266,133925.8233302552,455.22468451828286,134381.0480147735,4541,7,843.547619047619,37,5,16,32.673022598870055,0.6576576576576578,41.22807017543858,1035.0877192982434,27.97534376481739,0
4596,4,0,0,42,0.0,0.0,1.0,42,1200,1000,200,0.8333333333333334,14,10,4,330.79516315644946,0.777632597754549,0.12686476836021465,0.20794726568063862,133982.57757194497,464.1577216066217,134446.7352935516,4542,8,844.547619047619,37,5,16,32.611381769399145,0.6582207207207208,41.173245614035075,1035.3070175438577,27.981270744428585,0
4597,4,0,0,42,0.0,0.0,1.0,42,850,400,450,0.47058823529411764,13,4,9,332.14879508346525,0.7758178474641889,0.1259780446474621,0.20951090229890645,134107.77043839925,508.7468724888416,134616.5173108881,4543,9,845.547619047619,38,4,16,32.45143544782535,0.6576206140350878,41.05235042735042,1035.7905982905968,27.257647323436757,0
4598,4,0,0,42,0.0,0.0,1.0,42,1100,700,400,0.6363636363636364,15,7,8,330.0771337920344,0.7749467673248162,0.12446411997819662,0.20851843429194494,134163.10683988951,456.83475326903584,134619.94159315855,4544,10,846.547619047619,38,4,16,32.4498985940669,0.6581688596491229,40.99893162393162,1036.0042735042723,27.263270355375585,0
4599,4,0,0,42,0.0,0.0,1.0,42,1400,1000,400,0.7142857142857143,18,10,8,327.22247536328655,0.7750435540069687,0.11992609060526238,0.20765465522890536,134329.1845300056,391.105655088003,134720.2901850936,4545,11,847.547619047619,38,4,16,32.358334192174254,0.6598135964912282,40.8386752136752,1036.645299145297,27.280139451192028,0
4600,4,0,0,42,0.0,0.0,1.0,42,750,300,450,0.4,12,3,9,327.2975956759472,0.774753193960511,0.11746784021665557,0.20817499761669359,134412.26189823952,398.5620297319086,134810.82392797142,4546,12,848.547619047619,38,4,16,32.273636582182846,0.6606359649122806,40.75854700854701,1036.9658119658125,27.28857399910033,0
4601,4,0,0,42,0.0,0.0,1.0,42,1350,800,550,0.5925925925925926,19,8,11,330.80111611103064,0.7745354239256679,0.11923886020271612,0.2112037895170424,134550.78124999985,501.909722222207,135052.69097222207,4547,13,849.547619047619,38,4,17,32.04484605087016,0.6620065789473685,40.62499999999999,1037.4999999999989,27.302631578947338,0
4602,4,0,0,42,0.0,0.0,1.0,42,900,600,300,0.6666666666666666,12,6,6,330.80111611103064,0.7745354239256679,0.11923886020271612,0.2112037895170424,134550.78124999985,501.909722222207,135052.69097222207,4548,14,850.547619047619,38,4,17,32.04484605087016,0.6620065789473685,40.62499999999999,1037.4999999999989,27.302631578947338,0
4603,4,0,1,41,0.0,0.023809523809523808,0.9761904761904762,42,1050,800,250,0.7619047619047619,13,8,5,332.0121206623507,0.7735917537746806,0.12136165080672456,0.2122997845946945,134606.20896568405,538.178578603249,135144.3875442873,4549,15,851.547619047619,38,4,17,31.95824324788084,0.6625548245614036,40.57158119658119,1037.7136752136746,27.308254610886173,0
4604,4,0,0,41,0.0,0.0,1.0,41,550,300,250,0.5454545454545454,8,3,5,337.4747765630808,0.7702235772357724,0.1230797771742771,0.21613912279743736,134664.5662607726,889.1788819636893,135553.7451427363,4550,16,863.6585365853658,37,4,17,31.758398478766118,0.6649774774774775,40.515350877192986,1037.9385964912285,28.052394499762933,0
4605,4,0,0,41,0.0,0.0,1.0,41,1250,900,350,0.72,16,9,7,346.9361195897437,0.770630081300813,0.1020227945239438,0.2187689309509156,134096.12212411495,1104.5576523545524,135200.6797764695,4551,17,864.6585365853658,37,4,18,32.080157385842334,0.6593468468468469,41.06359649122806,1035.7456140350864,27.993124703650984,3
4606,4,0,0,41,0.0,0.0,1.0,41,1000,600,400,0.6,14,6,8,347.720139320251,0.7688516260162601,0.10376499067075118,0.2201140680988407,134238.1204433094,1135.459588527231,135373.58003183664,4552,18,865.6585365853658,37,4,19,31.918028956371472,0.6607545045045045,40.926535087719294,1036.2938596491222,28.00794215267898,0
4607,4,0,0,41,0.0,0.0,1.0,41,750,400,350,0.5333333333333333,11,4,7,353.13447493604457,0.7677337398373983,0.10507849922524493,0.2152491818482558,132838.18354381237,1181.9484394404062,134020.13198325277,4553,19,866.6585365853658,38,3,17,33.18003592772999,0.6450109649122808,42.280982905982896,1030.876068376067,27.128317588843867,2
4608,4,1,0,42,0.023809523809523808,0.0,1.0,42,1500,1000,500,0.6666666666666666,20,10,10,344.1464591682179,0.7721399535423926,0.10288395728443,0.21186907468065164,133209.81744497298,768.7374000264128,133978.5548449994,4554,0,847.0,40,2,20,33.039025070551936,0.6453125000000002,41.92073170731706,1032.3170731707296,25.80792682926824,0
4609,4,0,0,42,0.0,0.0,1.0,42,1050,800,250,0.7619047619047619,13,8,5,342.44452620935857,0.7713656600851723,0.11027544259191568,0.21141684540337172,133314.74837233117,730.581168616552,134045.3295409477,4555,1,848.0,40,2,20,32.97784228826346,0.6463541666666668,41.819105691056905,1032.7235772357715,25.818089430894286,0
4610,4,0,0,42,0.0,0.0,1.0,42,1000,600,400,0.6,14,6,8,342.5687419242288,0.771147890050329,0.10674341565810663,0.21164292548181945,133340.98755907506,735.6908710092964,134076.67843008434,4556,2,849.0,40,2,21,32.94835842434977,0.6466145833333334,41.79369918699186,1032.8252032520306,25.820630081300767,0
4611,4,0,0,42,0.0,0.0,1.0,42,1000,900,100,0.9,11,9,2,344.5188389360654,0.770059039876113,0.11324395979127422,0.21329954425237752,133419.720611078,793.1214472205577,134212.84205829856,4557,3,850.0,40,2,21,32.81916027280475,0.6473958333333334,41.71747967479674,1033.1300813008124,25.82825203252031,0
4612,4,1,1,42,0.023255813953488372,0.023255813953488372,0.9767441860465116,43,750,400,350,0.5333333333333333,11,4,7,337.1835637216483,0.7767165005537098,0.10902685381256672,0.21027377013998283,133687.58680555574,415.47204458327104,134103.058850139,4558,0,831.2093023255813,39,4,21,32.74073327961321,0.6517094017094017,41.45833333333334,1034.166666666668,26.517094017094053,0
4613,4,0,0,42,0.0,0.0,1.0,42,950,900,50,0.9473684210526315,10,9,1,342.3034673397032,0.7702768099109563,0.1140863787375419,0.21270302161282142,133555.03420857998,743.2702580539235,134298.3044666339,4559,5,852.0,38,4,21,32.74095607235143,0.6521381578947367,41.58653846153847,1033.6538461538469,27.2014170040486,0
4614,4,1,1,42,0.023255813953488372,0.023255813953488372,0.9767441860465116,43,1250,800,450,0.64,17,8,9,334.3736197930053,0.774547803617571,0.10381290449475022,0.20913090628363565,133795.33420138914,347.5260416666915,134142.86024305582,4560,0,833.1627906976744,39,4,17,32.70573231306216,0.6527777777777777,41.35416666666668,1034.5833333333353,26.52777777777783,0
4615,4,1,2,41,0.023255813953488372,0.046511627906976744,0.9534883720930233,43,1250,900,350,0.72,16,9,7,336.5978691974963,0.7778700627537837,0.10396441549264468,0.21160317659417593,133983.99658203154,419.7455512153066,134403.74213324685,4561,0,834.1395348837209,39,4,18,32.45977546366167,0.6546474358974358,41.171875000000014,1035.3125000000023,26.546474358974418,0
4616,4,0,0,41,0.0,0.0,1.0,41,850,600,250,0.7058823529411765,11,6,5,345.9464260143988,0.7680386178861789,0.09195628035561842,0.2169050504078634,133886.53897518115,1063.5139299803077,134950.05290516146,4562,8,843.6829268292682,38,3,19,32.31521626922679,0.6554276315789471,41.26602564102566,1034.9358974359,27.23515519568158,0
4617,4,0,0,41,0.0,0.0,1.0,41,1250,900,350,0.72,16,9,7,346.09552473425356,0.7685467479674797,0.08581137204560862,0.21748804375323755,133969.4793721238,1073.2474523340088,135042.72682445782,4563,9,844.6829268292682,38,3,19,32.22845717234261,0.6562499999999998,41.185897435897445,1035.256410256412,27.24358974358979,0
4618,4,0,0,41,0.0,0.0,1.0,41,1050,700,350,0.6666666666666666,14,7,7,348.2249000134459,0.7672764227642277,0.09221192892762398,0.21948583749872233,134080.10651800735,1138.0063372050706,135218.1128552124,4564,10,845.6829268292682,38,3,20,32.062787978818506,0.65734649122807,41.07905982905984,1035.683760683762,27.254835807467423,0
4619,4,0,1,40,0.0,0.024390243902439025,0.975609756097561,41,850,500,350,0.5882352941176471,12,5,7,349.16407914687653,0.7672256097560975,0.09764649363519484,0.22057616126952867,134163.10683988986,1168.9875310468426,135332.0943709367,4565,11,846.6829268292682,38,3,22,31.95554467017291,0.6581688596491228,40.99893162393163,1036.0042735042748,27.263270355375653,0
4620,4,0,0,40,0.0,0.0,1.0,40,1250,900,350,0.72,16,9,7,350.72638492301087,0.7652777777777777,0.08813266673538833,0.22223361594631816,134273.81388569303,1418.673866790868,135692.4877524839,4566,12,842.45,38,2,23,31.804496100058415,0.6592653508771928,40.892094017094024,1036.431623931625,27.27451641925329,0
4621,4,0,1,39,0.0,0.025,0.975,40,1300,900,400,0.6923076923076923,17,9,8,354.42429391111125,0.76383547008547,0.0945528999690941,0.22559977842591197,134439.9600614545,1529.7575836438043,135969.7176450983,4567,13,843.45,38,2,23,31.54274406785482,0.6609100877192982,40.73183760683761,1037.0726495726499,27.291385515069734,0
4622,4,0,0,39,0.0,0.0,1.0,39,1050,700,350,0.6666666666666666,14,7,7,355.9385159019137,0.7619770580296896,0.09872526852860997,0.22654552378198492,134437.04433094786,1770.2644082794618,136207.30873922733,4568,14,859.7435897435897,37,2,23,31.506396701205333,0.6627252252252254,40.734649122807014,1037.061403508771,28.028686581318137,0
4623,4,1,0,40,0.025,0.0,1.0,40,1100,800,300,0.7272727272727273,14,8,6,349.3607454055325,0.7721153846153846,0.09837792642140442,0.2241606499490431,134730.96305941345,1414.0862118899615,136145.0492713034,4569,0,839.225,35,5,24,31.38377926421404,0.6696428571428572,40.45138888888888,1038.1944444444432,29.662698412698376,0
4624,4,0,0,40,0.0,0.0,1.0,40,750,600,150,0.8,9,6,3,350.0551157291146,0.7718215811965812,0.09444599264296083,0.22479201454587577,134761.00508241152,1434.7558459790632,136195.76092839058,4570,1,840.225,35,5,24,31.33580890276075,0.6699404761904763,40.422453703703695,1038.3101851851839,29.666005291005252,0
4625,4,0,1,39,0.0,0.025,0.975,40,800,500,300,0.625,11,5,6,347.2449461979266,0.7717948717948718,0.09125284614550577,0.22349198456269895,134843.0287339704,1364.7120515785996,136207.740785549,4571,2,841.225,36,4,16,31.32702663630779,0.6686921296296298,40.343468468468465,1038.6261261261257,28.850725725725713,0
4626,4,0,1,38,0.0,0.02564102564102564,0.9743589743589743,39,900,400,500,0.4444444444444444,14,4,10,346.036518859132,0.7691183085919928,0.10174127693641988,0.22289391410311687,134872.27091956825,1534.1462239266327,136406.41714349488,4572,3,856.6410256410256,36,3,16,31.32927688638334,0.6689814814814815,40.31531531531532,1038.7387387387391,28.853853853853863,0
4627,4,0,0,38,0.0,0.0,1.0,38,400,100,300,0.25,7,1,6,354.778959466696,0.7588608345187292,0.10781287592937083,0.2274490698682484,134700.92438539513,1957.8107585305113,136658.73514392565,4573,19,880.1052631578947,35,3,23,31.273112015460665,0.6693452380952382,40.48032407407407,1038.078703703703,29.659391534391514,0
4628,4,0,0,38,0.0,0.0,1.0,38,1450,900,550,0.6206896551724138,20,9,11,361.72429315470833,0.7586533902323376,0.11511765602466806,0.2336374607153215,134971.39301483182,2164.4863468792673,137135.8793617111,4574,20,881.1052631578947,35,3,19,30.823030370535367,0.6720238095238096,40.2199074074074,1039.1203703703693,29.689153439153408,0
4629,4,0,0,38,0.0,0.0,1.0,38,1300,1200,100,0.9230769230769231,14,12,2,362.7113479021061,0.757201280227596,0.10935558519430444,0.23553281199212714,135164.86714755293,2205.1662304196066,137370.03337797252,4575,21,882.1052631578947,36,2,21,30.604514114504354,0.671875,40.03378378378378,1039.8648648648648,28.885135135135133,0
4630,4,0,0,38,0.0,0.0,1.0,38,900,500,400,0.5555555555555556,13,5,8,360.7622539543046,0.7566974869606449,0.10738608839369701,0.23445738319971868,135194.14420755208,2154.588837147952,137348.73304470003,4576,22,883.1052631578947,36,2,21,30.626015159718463,0.6721643518518519,40.00563063063063,1039.977477477477,28.888263263263248,0
4631,4,0,0,38,0.0,0.0,1.0,38,800,600,200,0.75,10,6,4,361.3324691733985,0.7559566145092461,0.10218343845974154,0.23520986735410027,135252.70783875088,2174.238977152827,137426.9468159037,4577,23,884.1052631578947,36,2,22,30.552849049114073,0.6727430555555556,39.94932432432432,1040.2027027027025,28.894519519519513,0
4632,4,0,0,38,0.0,0.0,1.0,38,1350,1100,250,0.8148148148148148,16,11,5,364.43264217774686,0.7565196775723092,0.10288479614449031,0.23761419767679615,135311.28415155012,2262.369759962653,137573.65391151278,4578,24,885.1052631578947,36,2,22,30.413870548760684,0.6733217592592593,39.89301801801801,1040.4279279279272,28.900775775775756,0
4633,4,0,0,38,0.0,0.0,1.0,38,850,700,150,0.8235294117647058,10,7,3,390.33159725713364,0.7565196775723092,0.10302100542836934,0.24045289002304102,133233.1318587106,2808.708453511077,136041.84031222167,4579,25,886.1052631578947,35,3,16,31.823617339312403,0.6547619047619048,41.89814814814815,1032.4074074074078,29.49735449735451,5
4634,4,0,1,37,0.0,0.02631578947368421,0.9736842105263158,38,1200,900,300,0.75,15,9,6,395.88247667790245,0.7559862494073021,0.10456722262851192,0.24465756384166196,133352.6502486281,2958.395490397785,136311.0457390259,4580,26,887.1052631578947,35,3,16,31.560025399671296,0.6559523809523811,41.7824074074074,1032.870370370369,29.510582010581974,0
4635,4,0,0,37,0.0,0.0,1.0,37,1050,800,250,0.7619047619047619,13,8,5,398.5683585754676,0.7558183183183184,0.09542614751188183,0.2467030111068407,133410.72137188204,3234.6584467120147,136645.37981859405,4581,27,894.2972972972973,34,3,17,31.4322136436967,0.6587009803921569,41.726190476190474,1033.0952380952378,30.385154061624643,0
4636,4,0,0,37,0.0,0.0,1.0,37,750,500,250,0.6666666666666666,10,5,5,402.5419835051687,0.7552552552552553,0.0925835120072045,0.24978929704923372,133503.88259623697,3348.1977135216766,136852.08030975866,4582,28,895.2972972972973,33,4,17,31.23579489307878,0.6619318181818181,41.6360294117647,1033.4558823529408,31.316844919786085,0
4637,4,0,0,37,0.0,0.0,1.0,37,1200,900,300,0.75,15,9,6,399.86241433384725,0.7570695695695696,0.09664267893916012,0.24940420654570122,133693.92368620244,3291.835021386007,136985.75870758845,4583,29,896.2972972972973,33,4,18,31.113851364695662,0.6638257575757576,41.45220588235294,1034.1911764705883,31.339126559714796,0
4638,4,0,1,36,0.0,0.02702702702702703,0.972972972972973,37,1050,600,450,0.5714285714285714,15,6,9,401.92079545399866,0.7559434434434434,0.09654293554305404,0.2511186850057142,133757.30075271518,3351.968143262192,137109.26889597738,4584,30,897.2972972972973,33,4,14,30.99689511511276,0.6644570707070707,41.39093137254901,1034.4362745098028,31.34655377302433,0
4639,4,0,0,36,0.0,0.0,1.0,36,1150,800,350,0.6956521739130435,15,8,7,403.64452044206257,0.7566798941798942,0.0873330701927506,0.253064437649088,133884.0999405275,3608.316663062264,137492.41660358975,4585,31,892.9722222222222,33,3,14,30.824822380106575,0.665719696969697,41.26838235294117,1034.9264705882338,31.36140819964345,0
4640,4,0,0,36,0.0,0.0,1.0,36,950,600,350,0.631578947368421,13,6,7,398.9672822284781,0.756712962962963,0.05566852437616121,0.2329589961930401,131209.51753257887,3271.3166859048747,134480.83421848374,4586,32,893.9722222222222,35,1,17,33.646821810513636,0.6345238095238095,43.86574074074074,1024.5370370370372,29.272486772486776,8
4641,4,0,0,36,0.0,0.0,1.0,36,1050,800,250,0.7619047619047619,13,8,5,399.428906840588,0.7562169312169312,0.06083505866114569,0.2337701896942105,131298.46810967504,3288.8807173782543,134587.3488270533,4587,33,894.9722222222222,35,1,19,33.5447252023339,0.6354166666666666,43.77893518518518,1024.884259259259,29.282407407407398,0
4642,4,0,0,36,0.0,0.0,1.0,36,1050,900,150,0.8571428571428571,12,9,3,405.8083821883405,0.7553240740740741,0.05563761693746905,0.23889763021000582,131522.3255280075,3474.582475773111,134996.9080037806,4588,34,895.9722222222222,32,4,19,33.154080502215656,0.64453125,43.56060606060607,1025.757575757577,32.05492424242428,0
4643,4,0,0,36,0.0,0.0,1.0,36,900,400,500,0.4444444444444444,14,4,10,403.00439812447223,0.7553240740740741,0.04469579788605316,0.23793821313924288,131633.36167800432,3409.7647392290037,135043.12641723332,4589,35,896.9722222222222,34,2,14,33.11339907192575,0.6409313725490197,43.45238095238094,1026.1904761904746,30.182072829131606,0
4644,4,0,0,36,0.0,0.0,1.0,36,950,800,150,0.8421052631578947,11,8,3,402.7871479170184,0.7549272486772487,0.042974386724387026,0.23857392607392602,131755.55555555536,3413.8888888888646,135169.44444444423,4590,36,897.9722222222222,34,2,15,32.995129870129865,0.6421568627450982,43.33333333333332,1026.6666666666652,30.196078431372506,0
4645,4,0,0,36,0.0,0.0,1.0,36,1000,800,200,0.8,12,8,4,400.1115815957751,0.7543320105820106,0.037423376088188576,0.2377522538573239,131877.80612244876,3353.1675170067756,135230.97363945554,4591,37,898.9722222222222,34,2,15,32.93999188687991,0.6433823529411766,43.2142857142857,1027.1428571428555,30.2100840336134,0
4646,4,0,1,35,0.0,0.027777777777777776,0.9722222222222222,36,700,400,300,0.5714285714285714,10,4,6,399.25904516333014,0.755191798941799,0.050799351251159086,0.23801133134322244,132000.11337868465,3340.4478458049753,135340.56122448962,4592,38,899.9722222222222,34,2,17,32.838083101637324,0.644607843137255,43.09523809523809,1027.6190476190463,30.224089635854305,0
4647,4,0,0,35,0.0,0.0,1.0,35,850,600,250,0.7058823529411765,11,6,5,395.3473455555538,0.7546918767507003,0.06717708729515648,0.2370163579635271,132214.28748582752,3454.113520408143,135668.40100623565,4593,39,915.5714285714286,34,1,18,32.722006790909425,0.6467524509803922,42.88690476190475,1028.4523809523798,30.248599439775877,0
4648,4,0,0,35,0.0,0.0,1.0,35,400,300,100,0.75,5,3,2,396.110628858025,0.7539915966386554,0.06994047619047628,0.2376663773148146,132244.8979591834,3476.721938775476,135721.61989795888,4594,40,916.5714285714286,34,1,18,32.6714409722222,0.6470588235294119,42.85714285714284,1028.5714285714264,30.25210084033607,0
4649,4,0,0,35,0.0,0.0,1.0,35,650,300,350,0.46153846153846156,10,3,7,401.0311416402982,0.7535714285714286,0.07196403781318206,0.24140063985645754,132367.3752834464,3616.6879251700307,135984.06320861643,4595,41,917.5714285714286,34,1,18,32.42109170137283,0.6482843137254903,42.73809523809522,1029.0476190476165,30.266106442576955,0
4650,4,0,0,35,0.0,0.0,1.0,35,700,400,300,0.5714285714285714,10,4,6,398.22478910129,0.7514005602240896,0.0723818335012969,0.2402965632490475,132459.27047902474,3549.7130102040574,136008.9834892288,4596,42,918.5714285714286,34,1,18,32.40044716857483,0.6492034313725491,42.64880952380951,1029.4047619047603,30.27661064425766,0
4651,4,0,0,35,0.0,0.0,1.0,35,850,700,150,0.8235294117647058,10,7,3,399.26492699388587,0.7521008403361344,0.06956234516928173,0.24151339989490264,132551.19756235805,3584.6088435373886,136135.80640589545,4597,43,919.5714285714286,34,1,18,32.28082851637763,0.6501225490196079,42.559523809523796,1029.761904761903,30.287114845938323,0
4652,4,1,0,36,0.027777777777777776,0.0,1.0,36,700,500,200,0.7142857142857143,9,5,4,388.7515781408451,0.7590939153439153,0.06924329179297195,0.23700275882960334,132845.06715374222,3128.745900848755,135973.81305459098,4598,0,895.0,35,1,16,32.25517851128325,0.6508928571428572,42.27430555555555,1030.9027777777771,29.45436507936506,0
4653,4,0,0,36,0.0,0.0,1.0,36,600,300,300,0.5,9,3,6,386.7365670533538,0.7592261904761906,0.07280091293448598,0.23615051925142727,132904.7325772674,3079.8240044152626,135984.55658168264,4599,1,896.0,35,1,16,32.24700209525947,0.6514880952380953,42.21643518518517,1031.134259259257,29.460978835978775,0
4654,4,0,0,36,0.0,0.0,1.0,36,1050,500,550,0.47619047619047616,16,5,11,418.1463924324374,0.7584656084656085,0.07008495951148319,0.24612414238111802,131516.6116998269,3853.864021798647,135370.47572162555,4600,2,897.0,33,3,17,32.84348864994026,0.6420454545454546,43.56617647058823,1025.7352941176464,31.08288770053474,5
4655,4,0,1,35,0.0,0.027777777777777776,0.9722222222222222,36,950,400,550,0.42105263157894735,15,4,11,417.9890042325687,0.759292328042328,0.06770480928689904,0.24704713552912919,131673.78720023538,3807.6390390714987,135481.4262393069,4601,3,898.0,33,3,17,32.68793532338309,0.6436237373737375,43.412990196078425,1026.3480392156855,31.101455733808653,0
4656,4,2,2,35,0.05405405405405406,0.05405405405405406,0.9459459459459459,37,1250,900,350,0.72,16,9,7,414.414747338501,0.7703953953953954,0.0674717270461953,0.2478953670443032,132130.12695312488,3551.334635416652,135681.46158854154,4602,0,874.5945945945946,35,2,17,32.316995947315085,0.64375,42.96874999999999,1028.124999999999,29.374999999999975,0
4657,4,0,0,35,0.0,0.0,1.0,35,700,600,100,0.8571428571428571,8,6,2,436.3486195681277,0.7486694677871147,0.08309580634162983,0.2589661070808007,131831.05656478263,4504.8599096501175,136335.91647443274,4603,49,925.5714285714286,33,2,17,32.05698090692123,0.6452020202020203,43.25980392156862,1026.9607843137244,31.120023767082557,0
4658,4,0,0,35,0.0,0.0,1.0,35,1400,1200,200,0.8571428571428571,16,12,4,436.7616625098125,0.7488795518207282,0.07907159046369361,0.2598561402994857,131925.46323829758,4523.9969302671825,136449.46016856478,4604,50,926.5714285714286,33,2,18,31.950450316115948,0.64614898989899,43.167892156862735,1027.3284313725476,31.131164587046896,0
4659,4,1,1,35,0.027777777777777776,0.027777777777777776,0.9722222222222222,36,950,500,450,0.5263157894736842,14,5,9,427.8188227656737,0.7583994708994709,0.07381889763779559,0.2558617280750937,132122.47732426284,4104.896541950097,136227.37386621293,4605,0,901.8055555555555,34,2,18,31.980228114867995,0.6458333333333334,42.97619047619047,1028.0952380952367,30.238095238095198,0
4660,4,0,0,35,0.0,0.0,1.0,35,1150,900,250,0.782608695652174,14,9,5,430.7465965235174,0.7464985994397758,0.07844285884576752,0.2575576050061144,132114.37795859753,4381.563731497488,136495.941690095,4606,52,928.5714285714286,33,2,18,31.913194858346248,0.6480429292929294,42.984068627450974,1028.063725490195,31.15344622697561,0
4661,4,0,1,34,0.0,0.02857142857142857,0.9714285714285714,35,850,400,450,0.47058823529411764,13,4,9,431.9269087731813,0.7446078431372548,0.0825487593178802,0.2593415216196048,132271.91014273316,4426.359453094914,136698.26959582808,4607,53,929.5714285714286,33,2,19,31.72305615121911,0.6496212121212124,42.83088235294115,1028.6764705882322,31.17201426024946,0
4662,4,0,0,34,0.0,0.0,1.0,34,1150,1000,150,0.8695652173913043,13,10,3,435.56312615175744,0.7382650029708854,0.10031628659320369,0.26127372795524373,132235.62168401157,4719.392153861815,136955.01383787338,4608,54,955.7647058823529,32,2,19,31.666359767575077,0.6516927083333335,42.8661616161616,1028.5353535353513,32.14172979797973,0
4663,4,0,0,34,0.0,0.0,1.0,34,950,700,250,0.7368421052631579,12,7,5,443.65803659557747,0.737262329174094,0.15410559337356466,0.25684932567316565,130880.7579814139,4819.114814437894,135699.87279585178,4609,55,956.7647058823529,30,4,17,32.83747099260039,0.6434027777777779,44.18682795698924,1023.252688172042,34.10842293906806,4
4664,4,0,0,34,0.0,0.0,1.0,34,550,300,250,0.5454545454545454,8,3,5,442.2622679586541,0.7361853832442068,0.1569528546712804,0.2567278531077064,130983.9287778933,4785.849881489173,135769.7786593825,4610,56,957.7647058823529,30,4,18,32.767911852240886,0.6444444444444445,44.08602150537634,1023.6559139784938,34.121863799283126,0
4665,4,0,0,34,0.0,0.0,1.0,34,700,500,200,0.7142857142857143,9,5,4,442.2362066946357,0.7363339275103982,0.15428439092172286,0.2576330194964161,131121.55306971897,4797.339649092369,135918.89271881134,4611,57,958.7647058823529,30,4,19,32.62822615923009,0.6458333333333335,43.9516129032258,1024.1935483870961,34.13978494623654,0
4666,4,0,0,34,0.0,0.0,1.0,34,600,300,300,0.5,9,3,6,441.93551867695913,0.735702614379085,0.15617211071756532,0.2581512995306098,131224.81871097803,4798.581664065196,136023.40037504322,4612,58,959.7647058823529,30,4,19,32.53066378066377,0.6468750000000001,43.8508064516129,1024.5967741935476,34.15322580645159,0
4667,4,0,0,34,0.0,0.0,1.0,34,850,600,250,0.7058823529411765,11,6,5,441.790400429992,0.7377450980392157,0.1623722275795565,0.258530453052854,131293.68505390786,4800.85793877903,136094.54299268688,4613,59,960.7647058823529,30,4,19,32.46420765027322,0.6475694444444444,43.783602150537625,1024.8655913978484,34.16218637992828,0
4668,4,0,0,34,0.0,0.0,1.0,34,900,700,200,0.7777777777777778,11,7,4,442.1329614655756,0.7375594177064766,0.16498796755223388,0.25944558994744654,131399.31520061722,4819.198189257578,136218.5133898748,4614,60,961.7647058823529,29,5,19,32.34782805021222,0.6515804597701149,43.68055555555555,1025.2777777777771,35.354406130268174,0
4669,4,0,0,34,0.0,0.0,1.0,34,950,700,250,0.7368421052631579,12,7,5,440.1244624826061,0.7396390374331552,0.163064684381943,0.25947321662881156,131577.3750964506,4782.084297839502,136359.45939429008,4615,61,962.7647058823529,29,5,18,32.218057623753445,0.6533764367816093,43.50694444444444,1025.972222222222,35.37835249042145,0
4670,4,1,1,34,0.02857142857142857,0.02857142857142857,0.9714285714285714,35,450,400,50,0.8888888888888888,5,4,1,429.6677533099904,0.7565126050420168,0.15182241505058602,0.2546339773107072,131776.25529324202,4324.001510290206,136100.25680353222,4616,0,936.2285714285714,30,5,18,32.28416677575596,0.6524305555555556,43.31317204301075,1026.7473118279572,34.224910394265244,0
4671,4,2,2,34,0.05555555555555555,0.05555555555555555,0.9444444444444444,36,850,800,50,0.9411764705882353,9,8,1,422.2640330397265,0.7595238095238096,0.13891703609879724,0.25236748984471147,132096.66146172408,3955.933803982196,136052.59526570627,4617,0,911.1666666666666,31,5,19,32.14917141650835,0.6528897849462366,43.00130208333333,1027.9947916666658,33.16112231182793,0
4672,4,0,0,34,0.0,0.0,1.0,34,1000,800,200,0.8,12,8,4,439.1493910984562,0.7378936423054071,0.15756018393291882,0.26059956643515136,131826.86149691363,4778.337191358033,136605.19868827166,4618,64,965.7647058823529,29,5,19,31.989338202145877,0.6558908045977011,43.26388888888889,1026.9444444444448,35.41187739463603,0
4673,4,0,1,33,0.0,0.029411764705882353,0.9705882352941176,34,1150,800,350,0.6956521739130435,15,8,7,441.9620216945594,0.7384878193701724,0.1620867325032207,0.2632556390093681,131969.5312500001,4865.104166666682,136834.63541666677,4619,65,966.7647058823529,29,5,19,31.772100567721022,0.6573275862068965,43.12500000000001,1027.5000000000007,35.43103448275865,0
4674,4,0,0,33,0.0,0.0,1.0,33,450,300,150,0.6666666666666666,6,3,3,436.9224509157998,0.7373737373737375,0.15091865072310928,0.26663740023668264,132882.5970668574,5011.877998901602,137894.47506575898,4620,66,949.3030303030303,30,3,18,30.975698518228825,0.6635416666666667,42.23790322580645,1031.048387096774,34.368279569892465,2
4675,4,0,0,33,0.0,0.0,1.0,33,1150,900,250,0.782608695652174,14,9,5,435.08383678900054,0.736584595959596,0.14885726810658384,0.26600783105035886,132951.89698592332,4969.044289802307,137920.94127572564,4621,67,950.3030303030303,30,3,18,30.952962769885758,0.664236111111111,42.17069892473119,1031.3172043010761,34.37724014336921,0
4676,4,0,0,33,0.0,0.0,1.0,33,700,400,300,0.5714285714285714,10,4,6,432.6802611690936,0.7357165404040404,0.14488907843090826,0.26478375791161274,132986.5537200832,4908.131359116653,137894.68507919984,4622,68,951.3030303030303,30,3,18,30.979877942837284,0.6645833333333333,42.137096774193544,1031.4516129032254,34.381720430107514,0
4677,4,0,0,33,0.0,0.0,1.0,33,800,600,200,0.75,10,6,4,432.3241747852999,0.7348484848484849,0.14537042347767892,0.2653887749940746,133102.469974094,4908.683098687071,138011.15307278108,4623,69,952.3030303030303,31,2,18,30.871845425867512,0.6629704301075269,42.024739583333336,1031.901041666667,33.287130376344095,0
4678,4,0,0,33,0.0,0.0,1.0,33,800,500,300,0.625,11,5,6,434.87207002250926,0.7332702020202021,0.14887428962343874,0.2679176878949865,133236.86599731445,4988.198343912762,138225.0643412272,4624,70,953.3030303030303,31,2,19,30.67024530205574,0.6643145161290323,41.89453125,1032.421875,33.303931451612904,0
4679,4,0,0,33,0.0,0.0,1.0,33,750,600,150,0.8,9,6,3,434.31795618317267,0.7301136363636365,0.14357364136766604,0.2685459350273662,133371.3298373752,4985.112677680118,138356.44251505533,4625,71,954.3030303030303,31,2,19,30.54868376822555,0.6656586021505377,41.764322916666664,1032.9427083333333,33.32073252688172,0
4680,4,0,0,33,0.0,0.0,1.0,33,1150,900,250,0.782608695652174,14,9,5,436.5755289567501,0.729876893939394,0.13941163336408735,0.27094803967091474,133509.34166088642,5057.49673217175,138566.83839305816,4626,72,955.3030303030303,28,5,19,30.35097780249315,0.675967261904762,41.63074712643677,1033.477011494252,36.90989326765186,0
4681,4,0,0,33,0.0,0.0,1.0,33,850,600,250,0.7058823529411765,11,6,5,434.01408408488913,0.7297190656565657,0.1390633016540035,0.26961041851082984,133543.99112654306,4991.994598765416,138535.98572530848,4627,73,956.3030303030303,29,4,19,30.382177730000905,0.673132183908046,41.597222222222214,1033.61111111111,35.64176245210724,0
4682,4,0,0,33,0.0,0.0,1.0,33,400,300,100,0.75,5,3,2,417.0956057479624,0.7285353535353536,0.09710173006407974,0.26172284443887733,133915.80912389458,4571.139105151858,138486.94822904642,4628,74,957.3030303030303,33,0,16,30.444885152735022,0.6660353535353536,41.23774509803921,1035.0490196078426,31.365121806298262,4
4683,4,0,0,33,0.0,0.0,1.0,33,750,500,250,0.6666666666666666,10,5,5,418.8654838449856,0.7279040404040404,0.10001757841227499,0.26305998082071336,133947.52206182724,4621.198727652833,138568.72078948008,4629,75,958.3030303030303,33,0,16,30.367166844244508,0.6663510101010102,41.20710784313726,1035.1715686274513,31.368835412953068,0
4684,4,0,0,33,0.0,0.0,1.0,33,600,400,200,0.6666666666666666,8,4,4,417.3851888917586,0.7275094696969697,0.10024965564738308,0.26235640444624825,133979.23875432528,4584.189975009618,138563.4287293349,4630,76,959.3030303030303,33,0,16,30.3735598169192,0.6666666666666666,41.1764705882353,1035.294117647059,31.37254901960785,0
4685,4,0,0,33,0.0,0.0,1.0,33,1050,800,250,0.7619047619047619,13,8,5,416.6638423024408,0.7272727272727273,0.10120136273982472,0.26235539995943524,134042.68340301793,4570.1478998462035,138612.83130286413,4631,77,960.3030303030303,33,0,16,30.328402366863916,0.6672979797979799,41.11519607843137,1035.5392156862736,31.379976232917382,0
4686,4,0,0,33,0.0,0.0,1.0,33,850,600,250,0.7058823529411765,11,6,5,416.31846093854267,0.7278251262626263,0.09238964828696306,0.2628185175738236,134137.8785352988,4568.81502907534,138706.69356437415,4632,78,961.3030303030303,33,0,16,30.24160554438266,0.6682449494949496,41.02328431372548,1035.906862745097,31.391117052881725,0
4687,4,0,0,33,0.0,0.0,1.0,33,1100,700,400,0.6363636363636364,15,7,8,416.7229839112056,0.7269570707070707,0.08994128653461497,0.2633016521663178,134169.6177551903,4582.312692233757,138751.93044742406,4633,79,962.3030303030303,33,0,16,30.199215361564544,0.6685606060606061,40.99264705882353,1036.0294117647059,31.39483065953654,0
4688,4,1,1,33,0.029411764705882353,0.029411764705882353,0.9705882352941176,34,750,500,250,0.6666666666666666,10,5,5,404.8562256676459,0.7350713012477719,0.07893102144439057,0.2578294910830796,134458.163265306,4087.2448979591713,138545.40816326518,4634,0,934.9705882352941,34,0,16,30.21694214876033,0.6691176470588236,40.71428571428571,1037.1428571428562,30.504201680672242,0
4689,4,0,0,33,0.0,0.0,1.0,33,950,700,250,0.7368421052631579,12,7,5,411.16429545678506,0.7249053030303031,0.08136214969173938,0.2609181376795907,134328.3701731305,4446.205936418678,138774.57610954918,4635,81,964.3030303030303,33,0,16,30.183704732631906,0.670138888888889,40.83946078431372,1036.6421568627447,31.413398692810446,0
4690,4,0,0,33,0.0,0.0,1.0,33,950,700,250,0.7368421052631579,12,7,5,410.2306361857425,0.7255366161616162,0.075967043708979,0.26123264665462276,134455.43968966257,4431.548112504794,138886.98780216736,4636,82,965.3030303030303,33,0,16,30.080325140809006,0.6714015151515152,40.71691176470588,1037.132352941176,31.428253119429574,0
4691,4,0,0,33,0.0,0.0,1.0,33,400,200,200,0.5,6,2,4,411.4803703376784,0.7244318181818182,0.07375825592009866,0.2624854057956629,134518.9969753219,4470.385338571689,138989.38231389358,4637,83,966.3030303030303,33,0,16,29.984125812167743,0.6720328282828283,40.655637254901954,1037.3774509803914,31.435680332739132,0
4692,4,1,1,33,0.029411764705882353,0.029411764705882353,0.9705882352941176,34,850,400,450,0.47058823529411764,13,4,9,401.0826455597837,0.7317290552584671,0.07090813203894286,0.2585534286243565,134900.6560727845,4021.2661596501353,138921.92223243465,4638,0,938.8529411764706,33,1,15,29.871392198497894,0.6758207070707071,40.28799019607843,1038.8480392156864,31.480243612596556,0
4693,4,0,0,33,0.0,0.0,1.0,33,750,700,50,0.9333333333333333,8,7,1,409.10796340595596,0.7238005050505051,0.0776146680815939,0.26285186648832665,134780.12447709416,4427.924446485048,139208.0489235792,4639,85,968.3030303030303,32,1,15,29.783762970168603,0.6770833333333334,40.4040404040404,1038.3838383838383,32.44949494949495,0
4694,4,0,0,33,0.0,0.0,1.0,33,800,600,200,0.75,10,6,4,406.9867795012981,0.7234848484848485,0.07538730772773339,0.2617252745424688,134812.90373750124,4373.4139054688285,139186.31764297007,4640,86,969.3030303030303,32,1,15,29.80597771023303,0.6774088541666666,40.37247474747475,1038.510101010101,32.453440656565654,0
4695,4,0,0,33,0.0,0.0,1.0,33,1200,800,400,0.6666666666666666,16,8,8,410.8639080328292,0.7215909090909092,0.07308377896613183,0.26493638207634146,134911.26543209868,4486.03395061727,139397.29938271595,4641,87,970.3030303030303,32,1,16,29.606729055258455,0.6783854166666667,40.27777777777777,1038.8888888888882,32.46527777777776,0
4696,4,0,0,33,0.0,0.0,1.0,33,750,500,250,0.6666666666666666,10,5,5,409.1078338591735,0.7208806818181819,0.08029750727199092,0.26428237619003103,134976.8598229771,4444.018148658283,139420.87797163537,4642,88,971.3030303030303,32,1,17,29.58662413932765,0.6790364583333335,40.21464646464646,1039.1414141414132,32.47316919191916,0
4697,4,0,0,33,0.0,0.0,1.0,33,1450,1200,250,0.8275862068965517,17,12,5,403.3009350628166,0.718671085858586,0.07492430680484596,0.26219335454715226,135206.56573627685,4305.7868776145215,139512.3526138914,4643,89,972.3030303030303,32,1,18,29.507607947877464,0.6813151041666667,39.993686868686865,1040.025252525252,32.500789141414124,0
4698,4,0,0,33,0.0,0.0,1.0,33,400,200,200,0.5,6,2,4,403.3009350628166,0.718671085858586,0.07492430680484596,0.26219335454715226,135206.56573627685,4305.7868776145215,139512.3526138914,4644,90,973.3030303030303,32,1,18,29.507607947877464,0.6813151041666667,39.993686868686865,1040.025252525252,32.500789141414124,0
4699,4,0,0,33,0.0,0.0,1.0,33,900,700,200,0.7777777777777778,11,7,4,401.99683052125573,0.719302398989899,0.07699323330391317,0.2620612249600589,135305.07091113145,4278.441931945714,139583.51284307716,4645,91,974.3030303030303,32,1,19,29.443011731391575,0.6822916666666667,39.898989898989896,1040.40404040404,32.51262626262625,0
4700,4,0,0,33,0.0,0.0,1.0,33,850,600,250,0.7058823529411765,11,6,5,401.18895520680377,0.7195391414141414,0.08290326849278795,0.26249220212102314,135436.46694214878,4267.122933884299,139703.58987603307,4646,92,975.3030303030303,32,1,20,29.33269650655022,0.68359375,39.77272727272727,1040.909090909091,32.52840909090909,0
4701,4,0,0,33,0.0,0.0,1.0,33,500,300,200,0.6,7,3,4,425.0192594535234,0.7195391414141414,0.05496258127837139,0.2560481880122446,132398.00347222225,4654.483758034899,137052.48723025716,4647,93,976.3030303030303,31,2,18,31.772941970310406,0.6559139784946236,42.708333333333336,1029.1666666666667,33.1989247311828,8
4702,4,0,0,33,0.0,0.0,1.0,33,450,300,150,0.6666666666666666,6,3,3,424.9674377195388,0.7197758838383839,0.062077900175547374,0.256472714703105,132465.0149875218,4658.663601345495,137123.6785888673,4648,94,977.3030303030303,31,2,18,31.70640441858503,0.6565860215053763,42.64322916666667,1029.4270833333342,33.20732526881723,0
4703,4,0,0,33,0.0,0.0,1.0,33,700,400,300,0.5714285714285714,10,4,6,422.5809761165901,0.719302398989899,0.05521068040036159,0.2554870305145256,132532.04345703125,4601.104058159721,137133.14751519097,4649,95,978.3030303030303,31,2,18,31.699966278873713,0.657258064516129,42.578125,1029.6875,33.215725806451616,0
4704,4,0,0,33,0.0,0.0,1.0,33,900,700,200,0.7777777777777778,11,7,4,419.97871428994955,0.7199337121212122,0.05227196127095013,0.2548214407562947,132666.15125868074,4543.3919270833585,137209.5431857641,4650,96,979.3030303030303,31,2,18,31.631277384563532,0.6586021505376343,42.44791666666668,1030.2083333333348,33.23252688172048,0
4705,4,0,0,33,0.0,0.0,1.0,33,1000,800,200,0.8,12,8,4,418.1648907832707,0.718118686868687,0.053867799919600445,0.2544023912797533,132766.77661471904,4503.680928548189,137270.45754326723,4651,97,980.3030303030303,31,2,18,31.576252895346393,0.6596102150537634,42.35026041666667,1030.598958333334,33.24512768817206,0
4706,4,0,0,33,0.0,0.0,1.0,33,1050,1000,50,0.9523809523809523,11,10,1,403.14251226766083,0.718118686868687,0.06924643584521362,0.23287408649814306,130794.81336805562,3945.7899305555607,134740.60329861118,4652,98,981.3030303030303,31,2,19,33.96130346232179,0.6397849462365591,44.270833333333336,1022.9166666666672,32.997311827957006,7
4707,4,1,1,33,0.029411764705882353,0.029411764705882353,0.9705882352941176,34,900,500,400,0.5555555555555556,13,5,8,389.6357270027866,0.7305407011289364,0.06627257561470934,0.22668190430362997,131069.41415416799,3413.8652943577194,134483.27944852572,4653,0,953.4117647058823,32,2,19,34.02794903411425,0.6399739583333334,44.00252525252525,1023.9898989898993,31.999684343434353,0
4708,4,0,0,33,0.0,0.0,1.0,33,550,400,150,0.7272727272727273,7,4,3,399.4852381359875,0.7170928030303031,0.07319311722467758,0.23116016209665602,130861.41798231332,3855.4409450954818,134716.8589274088,4654,100,983.3030303030303,31,2,19,33.98712564689912,0.6404569892473118,44.205729166666664,1023.1770833333329,33.005712365591386,0
4709,4,0,0,33,0.0,0.0,1.0,33,700,500,200,0.7142857142857143,9,5,4,401.2680979657857,0.7170928030303031,0.08490089756781849,0.23319815626792115,131028.00369262695,3915.4715643988707,134943.47525702583,4655,101,984.3030303030303,31,2,19,33.772229640934334,0.6421370967741935,44.04296875,1023.828125,33.026713709677416,0
4710,4,1,2,32,0.029411764705882353,0.058823529411764705,0.9411764705882353,34,900,700,200,0.7777777777777778,11,7,4,392.2929473197171,0.7303550207961973,0.08106169296987109,0.22977158343011997,131328.125,3504.16276719835,134832.28776719834,4656,0,956.3235294117648,31,3,19,33.697493224932245,0.6451612903225806,43.75,1025.0,33.064516129032256,0
4711,4,1,1,32,0.030303030303030304,0.030303030303030304,0.9696969696969697,33,750,600,150,0.8,9,6,3,400.2002037557579,0.7230902777777778,0.09017750567941163,0.2339952157175198,131261.40170627175,3906.1679416232737,135167.56964789503,4657,0,983.1818181818181,31,2,19,33.56257941550192,0.644489247311828,43.81510416666667,1024.7395833333337,33.05611559139786,0
4712,4,0,0,32,0.0,0.0,1.0,32,900,600,300,0.6666666666666666,12,6,6,411.7199029091787,0.7136676747311829,0.1018843479401732,0.24028553598573954,131190.39231414025,4402.739117238969,135593.1314313792,4658,200,1014.90625,30,2,20,33.339619959765585,0.6465277777777778,43.88440860215053,1024.462365591397,34.14874551971323,0
4713,4,0,0,32,0.0,0.0,1.0,32,850,600,250,0.7058823529411765,11,6,5,410.7160870733673,0.7127016129032259,0.10238934426229473,0.24034613690977924,131293.6850539079,4384.885716556809,135678.5707704647,4659,201,1015.90625,30,2,20,33.26038251366119,0.6475694444444444,43.783602150537625,1024.8655913978487,34.162186379928286,0
4714,4,0,0,32,0.0,0.0,1.0,32,600,300,300,0.5,9,3,6,409.2217292189742,0.7127016129032259,0.09781450767011934,0.23990270013475118,131362.56946250994,4351.283566019169,135713.85302852912,4660,202,1016.90625,30,2,21,33.22871596521131,0.648263888888889,43.71639784946235,1025.134408602149,34.17114695340497,0
4715,4,0,0,32,0.0,0.0,1.0,32,400,200,200,0.5,6,2,4,409.2217292189742,0.7127016129032259,0.09781450767011934,0.23990270013475118,131362.56946250994,4351.283566019169,135713.85302852912,4661,203,1017.90625,30,2,21,33.22871596521131,0.648263888888889,43.71639784946235,1025.134408602149,34.17114695340497,0
4716,4,0,0,32,0.0,0.0,1.0,32,700,500,200,0.7142857142857143,9,5,4,409.2217292189742,0.7127016129032259,0.09781450767011934,0.23990270013475118,131362.56946250994,4351.283566019169,135713.85302852912,4662,204,1018.90625,30,2,21,33.22871596521131,0.648263888888889,43.71639784946235,1025.134408602149,34.17114695340497,0
4717,4,0,0,32,0.0,0.0,1.0,32,800,600,200,0.75,10,6,4,409.61473048402536,0.7135836693548387,0.10009996067121141,0.24034932031785736,131397.01844143827,4364.430859058844,135761.4493004971,4663,205,1019.90625,30,2,21,33.18366544310436,0.6486111111111111,43.68279569892473,1025.2688172043006,34.175627240143356,0
4718,4,1,1,32,0.030303030303030304,0.030303030303030304,0.9696969696969697,33,1000,500,500,0.5,15,5,10,398.5470355559367,0.7265625000000001,0.09429829617503982,0.23631142273639957,131795.6627739799,3905.354139539907,135701.0169135198,4664,0,989.969696969697,31,2,18,33.06334009637332,0.6498655913978496,43.29427083333332,1026.8229166666654,33.12331989247308,0
4719,4,0,0,32,0.0,0.0,1.0,32,850,500,350,0.5882352941176471,12,5,7,411.0630351983446,0.710853494623656,0.10263179436804215,0.24272747670064623,131638.28775364178,4422.326822464992,136060.61457610677,4665,207,1021.90625,30,2,18,32.901659026413434,0.6510416666666667,43.447580645161274,1026.2096774193528,34.20698924731176,0
4720,4,1,1,32,0.030303030303030304,0.030303030303030304,0.9696969696969697,33,600,500,100,0.8333333333333334,7,5,2,400.19830221005543,0.7210385101010102,0.09170421415319385,0.23791743829202142,131895.957522922,3956.9076538085837,135852.8651767306,4666,0,991.9090909090909,31,2,18,32.9193866987789,0.6508736559139785,43.19661458333333,1027.2135416666658,33.13592069892471,0
4721,4,0,0,32,0.0,0.0,1.0,32,400,300,100,0.75,5,3,2,406.5434746854529,0.7105174731182796,0.0967931937172779,0.24114845858671255,131810.7584691871,4317.360749797654,136128.11921898476,4667,209,1023.90625,30,2,18,32.84276832460732,0.6527777777777779,43.27956989247311,1026.8817204301067,34.22939068100356,0
4722,4,0,0,32,0.0,0.0,1.0,32,650,500,150,0.7692307692307693,8,5,3,406.1347662933493,0.7098034274193549,0.09856775945556873,0.2411247668412959,131845.26616155033,4309.38927188112,136154.65543343144,4668,210,1024.90625,30,2,19,32.81829385333508,0.6531250000000001,43.24596774193547,1027.016129032257,34.2338709677419,0
4723,4,0,0,32,0.0,0.0,1.0,32,1100,700,400,0.6363636363636364,15,7,8,404.95605879876064,0.7097194220430109,0.10135499803741976,0.2408621912372705,131914.29509553118,4283.898608220591,136198.19370375178,4669,211,1025.90625,30,2,19,32.778631863578866,0.6538194444444445,43.17876344086021,1027.2849462365584,34.242831541218614,0
4724,4,0,0,32,0.0,0.0,1.0,32,550,400,150,0.7272727272727273,7,4,3,401.95742429062005,0.7088373655913979,0.10287241695003924,0.23973217364477994,132017.872369638,4213.11278760549,136230.9851572435,4670,212,1026.90625,30,2,19,32.75078472403871,0.6548611111111111,43.077956989247305,1027.68817204301,34.25627240143366,0
4725,4,0,0,32,0.0,0.0,1.0,32,1100,900,200,0.8181818181818182,13,9,4,399.2895064965302,0.7061491935483871,0.10235886042864628,0.23944853477362435,132225.14886113987,4159.222887038946,136384.37174817882,4671,213,1027.90625,30,2,19,32.6096663181739,0.6569444444444446,42.8763440860215,1028.4946236559128,34.28315412186376,0
4726,4,0,0,32,0.0,0.0,1.0,32,700,400,300,0.5714285714285714,10,4,6,400.393495408079,0.7064432123655915,0.09982604860838862,0.2403303074790611,132259.71075052032,4191.185577812465,136450.89632833278,4672,214,1028.90625,30,2,19,32.54633259288296,0.6572916666666666,42.84274193548387,1028.6290322580649,34.28763440860216,0
4727,4,1,1,32,0.030303030303030304,0.030303030303030304,0.9696969696969697,33,1150,900,250,0.782608695652174,14,9,5,392.0048714920226,0.7256155303030304,0.09444125196337638,0.23742408372908852,132599.08888075076,3795.8977593315876,136394.98664008235,4673,0,998.6969696969697,31,2,20,32.41940581542353,0.6579301075268817,42.51302083333333,1029.9479166666658,33.224126344085995,0
4728,4,0,0,32,0.0,0.0,1.0,32,550,400,150,0.7272727272727273,7,4,3,404.1022175407936,0.7055611559139785,0.10589416296683218,0.24367045526987377,132432.58794369284,4303.260492542485,136735.84843623533,4674,216,1030.90625,30,2,20,32.2761600069644,0.6590277777777778,42.674731182795696,1029.3010752688167,34.31003584229389,0
4729,4,0,0,32,0.0,0.0,1.0,32,750,400,350,0.5333333333333333,11,4,7,402.18883370163195,0.7055191532258065,0.10614554772163487,0.2427395017589282,132467.1769315817,4255.363878772113,136722.5408103538,4675,217,1031.90625,30,2,20,32.29044261652957,0.659375,42.641129032258064,1029.4354838709678,34.31451612903226,0
4730,4,1,1,32,0.030303030303030304,0.030303030303030304,0.9696969696969697,33,650,400,250,0.6153846153846154,9,4,5,391.5829623779353,0.7179608585858587,0.09896258171248706,0.23780475681478128,132699.6888054741,3792.587449815529,136492.27625528965,4676,0,1001.6060606060606,31,2,15,32.328789123383466,0.6589381720430108,42.41536458333333,1030.338541666666,33.23672715053762,0
4731,4,0,0,32,0.0,0.0,1.0,32,750,600,150,0.8,9,6,3,394.6969438744554,0.7056031586021506,0.09703818537858999,0.23843679732478937,132501.77043588855,4059.608769799979,136561.37920568854,4677,219,1033.90625,30,2,22,32.44832463011314,0.6597222222222221,42.60752688172043,1029.5698924731184,34.31899641577061,6
4732,4,1,1,32,0.030303030303030304,0.030303030303030304,0.9696969696969697,33,800,400,400,0.5,12,4,8,384.8834972170614,0.7203282828282829,0.08963450342760693,0.23457449172189956,132833.88137817383,3625.113762749565,136458.9951409234,4678,0,1003.5454545454545,31,2,20,32.36613721527515,0.6602822580645162,42.28515625,1030.859375,33.25352822580645,0
4733,4,0,0,32,0.0,0.0,1.0,32,650,600,50,0.9230769230769231,7,6,1,396.00724625834584,0.7054351478494624,0.09880412808138805,0.2407761742317792,132744.05142574277,4113.521252456922,136857.5726781997,4679,221,1035.90625,30,2,20,32.17006869266554,0.6621527777777778,42.372311827956985,1030.5107526881714,34.350358422939046,0
4734,4,0,0,32,0.0,0.0,1.0,32,650,600,50,0.9230769230769231,7,6,1,395.7677013796473,0.7046370967741936,0.09728604484421854,0.24152219867010932,132882.5970668574,4118.127998901599,137000.72506575898,4680,222,1036.90625,30,2,20,32.03651197149438,0.6635416666666667,42.23790322580645,1031.048387096774,34.368279569892465,0
4735,4,0,0,32,0.0,0.0,1.0,32,750,500,250,0.6666666666666666,10,5,5,396.77959736510655,0.7039230510752689,0.09475990357049802,0.2428139258516609,132986.5537200832,4153.270248005542,137139.82396808875,4681,223,1037.90625,30,2,20,31.90562288246026,0.6645833333333333,42.137096774193544,1031.4516129032254,34.381720430107514,0
4736,4,0,0,32,0.0,0.0,1.0,32,950,800,150,0.8421052631578947,11,8,3,397.50767197067466,0.704091061827957,0.10006025273579988,0.24371157268745186,133055.88073765746,4178.146678806785,137234.02741646423,4682,224,1038.90625,30,2,20,31.816972815702616,0.6652777777777779,42.06989247311827,1031.7204301075262,34.390681003584206,0
4737,4,0,0,32,0.0,0.0,1.0,32,650,400,250,0.6153846153846154,9,4,5,398.5175385320629,0.7029149865591399,0.10031095337327423,0.2447854128679343,133125.22582090413,4210.547462134346,137335.77328303846,4683,225,1039.90625,30,2,20,31.721042806286352,0.6659722222222222,42.00268817204301,1031.9892473118277,34.399641577060926,0
4738,4,0,0,32,0.0,0.0,1.0,32,1300,1000,300,0.7692307692307693,16,10,6,396.8212223436943,0.7013188844086022,0.10232524082270267,0.24465334109504475,133263.97018441427,4176.394308590572,137440.36449300483,4684,226,1040.90625,30,2,20,31.625065087216868,0.6673611111111111,41.868279569892465,1032.5268817204292,34.4175627240143,0
4739,4,0,0,32,0.0,0.0,1.0,32,800,400,400,0.5,12,4,8,397.63314142202364,0.7008148521505377,0.09879097827501004,0.24630184996866225,133437.50225820908,4211.834641288016,137649.33689949708,4685,227,1041.90625,30,2,20,31.42941546333637,0.6690972222222222,41.700268817204304,1033.198924731183,34.4399641577061,0
4740,4,1,0,33,0.030303030303030304,0.0,1.0,33,500,200,300,0.4,8,2,6,406.84674210513737,0.7095170454545455,0.08122208905396433,0.24600259599585303,132536.36845661348,4184.4024598219385,136720.7709164354,4686,0,1011.3030303030303,30,3,21,32.100628725579774,0.6600694444444444,42.57392473118279,1029.7043010752686,34.323476702508955,3
4741,4,0,0,33,0.0,0.0,1.0,33,700,500,200,0.7142857142857143,9,5,4,408.1753211804865,0.7093592171717172,0.07864866361342471,0.2470331209229767,132570.9709937565,4222.439732917097,136793.41072667358,4687,1,1012.3030303030303,30,3,21,32.03145392847819,0.6604166666666667,42.54032258064516,1029.8387096774193,34.32795698924731,0
4742,4,0,0,33,0.0,0.0,1.0,33,850,500,350,0.5882352941176471,12,5,7,410.78291077486887,0.70864898989899,0.08294293225800131,0.249299367465508,132674.80570369388,4300.1085746906965,136974.9142783846,4688,2,1013.3030303030303,30,3,20,31.859371602522298,0.6614583333333335,42.43951612903225,1030.2419354838696,34.34139784946232,0
4743,4,0,1,32,0.0,0.030303030303030304,0.9696969696969697,33,800,500,300,0.625,11,5,6,409.89241682234433,0.7065972222222223,0.08307060171466984,0.2499105593821446,132847.95388195157,4290.673777315285,137138.62765926687,4689,3,1014.3030303030303,30,3,20,31.707409821816604,0.6631944444444444,42.27150537634408,1030.9139784946228,34.363799283154094,0
4744,4,0,0,32,0.0,0.0,1.0,32,650,300,350,0.46153846153846156,10,3,7,420.7200809584598,0.6986727150537635,0.09028760614638087,0.255636550420214,132719.8133680556,4767.578125000005,137487.3914930556,4690,232,1046.90625,29,3,20,31.55790874780969,0.6648706896551724,42.395833333333336,1030.416666666667,35.53160919540231,0
4745,4,0,0,32,0.0,0.0,1.0,32,1050,900,150,0.8571428571428571,12,9,3,422.0767423781133,0.6989247311827957,0.08398884921169647,0.25695090280459215,132791.37972608022,4809.630594135797,137601.010320216,4691,233,1047.90625,29,3,20,31.45058505143061,0.6655890804597702,42.326388888888886,1030.6944444444443,35.541187739463595,0
4746,4,1,1,32,0.030303030303030304,0.030303030303030304,0.9696969696969697,33,550,300,250,0.5454545454545454,8,3,5,410.2682500564844,0.7096748737373738,0.07027488057400988,0.2513963917399478,133035.29739379883,4316.0317314995655,137351.3291252984,4692,0,1017.1212121212121,31,2,21,31.508608902351817,0.6622983870967742,42.08984375,1031.640625,33.27872983870968,0
4747,4,1,0,33,0.030303030303030304,0.0,1.0,33,850,500,350,0.5882352941176471,12,5,7,412.603343568965,0.7080176767676768,0.08604073522106348,0.25442803378708334,133270.47559950082,4397.568766276037,137668.04436577685,4693,0,1018.0909090909091,31,2,22,31.211118116855822,0.6646505376344086,41.861979166666664,1032.552083333333,33.3081317204301,0
4748,4,0,0,33,0.0,0.0,1.0,33,500,300,200,0.6,7,3,4,412.98846549681366,0.7070707070707072,0.08823484466449671,0.25512651933962044,133337.70751953125,4413.387044270834,137751.0945638021,4694,1,1019.0909090909091,31,2,23,31.133383761976805,0.6653225806451613,41.796875,1032.8125,33.31653225806452,0
4749,4,0,0,33,0.0,0.0,1.0,33,600,500,100,0.8333333333333334,7,5,2,415.4382905530881,0.7056502525252526,0.086880143590919,0.2573382385276153,133438.5871887206,4487.099711100246,137925.68689982084,4695,2,1020.0909090909091,31,2,23,30.9684152488973,0.6663306451612904,41.69921874999999,1033.203124999999,33.3291330645161,0
4750,4,0,0,33,0.0,0.0,1.0,33,1300,800,500,0.6153846153846154,18,8,10,416.7710905965125,0.7043876262626263,0.08305307283283359,0.2592040077326743,133587.57451548325,4535.104778402235,138122.67929388548,4696,3,1021.0909090909091,27,6,23,30.783821553668258,0.6801697530864198,41.55505952380952,1033.7797619047617,38.288139329805986,0
4751,4,0,0,33,0.0,0.0,1.0,33,750,300,450,0.4,12,3,9,417.21050373764376,0.7026515151515152,0.08031981445878689,0.26055976742860393,133741.45507812503,4559.66796875,138301.12304687503,4697,4,1022.0909090909091,27,6,19,30.61744712990936,0.681712962962963,41.40625,1034.3750000000002,38.31018518518519,0
4752,4,0,0,33,0.0,0.0,1.0,33,500,200,300,0.4,8,2,6,417.21050373764376,0.7026515151515152,0.08031981445878689,0.26055976742860393,133741.45507812503,4559.66796875,138301.12304687503,4698,5,1023.0909090909091,27,6,19,30.61744712990936,0.681712962962963,41.40625,1034.3750000000002,38.31018518518519,0
4753,4,1,1,33,0.029411764705882353,0.029411764705882353,0.9705882352941176,34,800,500,300,0.625,11,5,6,399.5407265400645,0.7216280451574569,0.06206521224740924,0.2520960015681726,134118.8368055555,3917.1874999999964,138036.0243055555,4699,0,993.9705882352941,29,5,19,30.69522660230625,0.6788793103448276,41.041666666666664,1035.833333333333,35.71839080459769,0
4754,4,0,0,33,0.0,0.0,1.0,33,800,500,300,0.625,11,5,6,434.3976704429224,0.703046085858586,0.04733466047334667,0.2587499167420885,131969.53125,4865.4513888888905,136834.98263888888,4700,7,1025.090909090909,29,4,17,31.96640984049744,0.6573275862068966,43.125,1027.5,35.43103448275862,8
4755,4,0,0,33,0.0,0.0,1.0,33,950,700,250,0.7368421052631579,12,7,5,432.1966047763711,0.7041508838383839,0.047705054327570995,0.2576811183513596,132005.21074459888,4810.440779321005,136815.6515239199,4701,8,1026.090909090909,29,4,17,31.986726809929273,0.6576867816091954,43.090277777777786,1027.6388888888898,35.435823754789304,0
4756,4,0,0,33,0.0,0.0,1.0,33,800,600,200,0.75,10,6,4,430.4604939287388,0.7051767676767677,0.04095535195237976,0.2573722597787175,132112.27816358022,4773.823302469129,136886.10146604935,4702,9,1027.090909090909,29,4,17,31.9226785553454,0.6587643678160919,42.98611111111111,1028.0555555555552,35.450191570881216,0
4757,4,1,0,34,0.029411764705882353,0.0,1.0,34,900,700,200,0.7777777777777778,11,7,4,415.6224549964226,0.7144236482471777,0.03749145565002365,0.2508473114907487,132467.17693158166,4211.26665654989,136678.44358813154,4703,0,997.8529411764706,30,4,18,31.944716455586022,0.659375,42.641129032258064,1029.4354838709676,34.31451612903225,0
4758,4,0,0,34,0.0,0.0,1.0,34,850,600,250,0.7058823529411765,11,6,5,412.7588199987723,0.7141265597147951,0.03984522548251879,0.2498071152314843,132570.9709937565,4143.967510694874,136714.93850445136,4704,1,998.8529411764706,30,4,18,31.913447315757413,0.6604166666666667,42.54032258064516,1029.8387096774193,34.32795698924731,0
4759,4,0,0,34,0.0,0.0,1.0,34,600,400,200,0.6666666666666666,8,4,4,411.45613803336886,0.7131238859180036,0.037456532919836194,0.24924809373515475,132605.57804731766,4112.275805006362,136717.853852324,4705,2,999.8529411764706,30,4,18,31.912001391970076,0.6607638888888889,42.50672043010753,1029.9731182795701,34.33243727598567,0
4760,4,0,0,34,0.0,0.0,1.0,34,1050,800,250,0.7619047619047619,13,8,5,414.49771275403543,0.7127525252525253,0.03476845402559836,0.2465374333524586,131914.29509553127,4135.634719331717,136049.929814863,4706,3,1000.8529411764706,30,4,17,32.53358192681756,0.6538194444444445,43.178763440860216,1027.284946236559,34.242831541218635,2
4761,4,0,0,34,0.0,0.0,1.0,34,900,600,300,0.6666666666666666,12,6,6,414.47377059225164,0.7103386809269163,0.03925670686684746,0.24764807792887045,132086.94646779977,4149.314949705176,136236.26141750495,4707,4,1001.8529411764706,30,4,17,32.35922245467226,0.6555555555555554,43.01075268817205,1027.956989247312,34.265232974910404,0
4762,4,0,0,34,0.0,0.0,1.0,34,700,400,300,0.5714285714285714,10,4,6,408.26941363560024,0.7074049316696376,0.03516114403425097,0.2450577115728038,132259.71075052026,3999.5189111457994,136259.22966166606,4708,5,1002.8529411764706,30,4,17,32.34379763927002,0.6572916666666666,42.84274193548387,1028.6290322580644,34.287634408602145,0
4763,4,0,0,34,0.0,0.0,1.0,34,650,400,250,0.6153846153846154,9,4,5,407.814805792417,0.7061794414735592,0.03490605909248079,0.24523349083589574,132328.8480785351,3993.13269597641,136321.98077451152,4709,6,1003.8529411764706,30,4,18,32.28554321794034,0.657986111111111,42.7755376344086,1028.8978494623657,34.29659498207886,0
4764,4,0,0,34,0.0,0.0,1.0,34,550,300,250,0.5454545454545454,8,3,5,409.67371043147006,0.7075163398692811,0.039881400457806526,0.2470300216129291,132432.58794369298,4050.829936986944,136483.41788067992,4710,7,1004.8529411764706,30,4,18,32.13279141638374,0.6590277777777778,42.6747311827957,1029.3010752688178,34.31003584229393,0
4765,4,1,1,34,0.02857142857142857,0.02857142857142857,0.9714285714285714,35,350,300,50,0.8571428571428571,4,3,1,399.10569206837334,0.7151960784313725,0.03164412991280163,0.24237324185242048,132699.68880547426,3592.2402275933214,136291.92903306757,4711,0,977.1142857142858,31,4,17,32.13501516491848,0.6589381720430108,42.415364583333336,1030.3385416666672,33.236727150537654,0
4766,4,0,0,34,0.0,0.0,1.0,34,800,700,100,0.875,9,7,2,397.70790151171,0.7071449792038028,0.07295916728242391,0.2213383488352406,129342.63117283965,3522.4410822362324,132865.07225507588,4712,9,1006.8529411764706,29,5,20,35.58051156016749,0.6307471264367814,45.69444444444446,1017.2222222222234,35.07662835249046,7
4767,4,2,2,34,0.05555555555555555,0.05555555555555555,0.9444444444444444,36,1000,800,200,0.8,12,8,4,382.1431338307823,0.7346560846560847,0.03830755731051916,0.22120628261176145,130875.54841342726,2802.638442505876,133678.18685593313,4713,0,951.8611111111111,32,4,19,34.41638902599541,0.6380208333333333,44.1919191919192,1023.2323232323237,31.976010101010115,8
4768,4,1,1,34,0.02857142857142857,0.02857142857142857,0.9714285714285714,35,400,300,100,0.75,5,3,2,392.19183593895815,0.7279411764705882,0.05306953738725628,0.22654846052473943,130794.81336805559,3259.331597222226,134054.1449652778,4714,0,979.4571428571429,31,4,19,34.24134419551934,0.6397849462365591,44.270833333333336,1022.916666666667,32.997311827957,0
4769,4,1,0,35,0.02857142857142857,0.0,1.0,35,1100,700,400,0.6363636363636364,15,7,8,388.220256289581,0.7265406162464986,0.05604314264565935,0.22510110139365858,130940.15438475684,3166.7240587695346,134106.87844352637,4715,0,980.4285714285714,32,3,20,34.195349124105604,0.638671875,44.12878787878789,1023.4848484848499,31.983901515151558,0
4770,4,0,0,35,0.0,0.0,1.0,35,1000,900,100,0.9,11,9,2,388.3039754269277,0.7269607843137255,0.06166693092331288,0.22571734313526592,131037.09323347126,3176.4448461891866,134213.53807966044,4716,1,981.4285714285714,32,3,20,34.09483290171414,0.6396484375,44.03409090909092,1023.8636363636379,31.995738636363683,0
4771,4,2,1,36,0.05405405405405406,0.02702702702702703,0.972972972972973,37,1150,800,350,0.6956521739130435,15,8,7,367.9182304798462,0.7501876876876877,0.06170595395299738,0.21673775561905637,131548.0392907775,2280.1071983697384,133828.14648914724,4717,0,929.3243243243244,33,4,21,34.099744156413024,0.6423611111111112,43.53553921568627,1025.8578431372543,31.086601307189525,0
4772,4,0,0,36,0.0,0.0,1.0,36,700,600,100,0.8571428571428571,8,6,2,376.58369530927706,0.7419642857142857,0.06336891078270401,0.22094361314388222,131392.84256708506,2696.0804382206006,134088.92300530567,4718,1,956.1388888888889,32,4,22,34.0345340722496,0.6432291666666666,43.68686868686869,1025.2525252525259,32.03914141414143,0
4773,4,1,0,37,0.02702702702702703,0.0,1.0,37,950,700,250,0.7368421052631579,12,7,5,365.6688065198503,0.7536286286286287,0.05897744467638222,0.21648110192344772,131736.6836823577,2234.3991794021526,133971.08286175985,4719,0,931.2702702702703,33,4,18,33.9668885042378,0.6442550505050505,43.35171568627451,1026.5931372549016,31.108882947118232,0
4774,4,0,0,37,0.0,0.0,1.0,37,1350,1100,250,0.8148148148148148,16,11,5,366.21235776906826,0.7542542542542543,0.052686903080603864,0.21770155906527153,131893.99059256038,2260.2418540945573,134154.23244665493,4720,1,932.2702702702703,33,4,19,33.79414220949654,0.6458333333333335,43.198529411764696,1027.2058823529399,31.127450980392116,0
4775,4,0,0,37,0.0,0.0,1.0,37,1250,1100,150,0.88,14,11,3,365.5195251060578,0.7515640640640641,0.0542925183440266,0.21819304320743804,132051.391366902,2253.4723724048326,134304.86373930683,4721,2,933.2702702702703,33,4,20,33.653148722228856,0.6474116161616161,43.045343137254896,1027.8186274509794,31.14601901366604,0
4776,4,0,1,36,0.0,0.02702702702702703,0.972972972972973,37,950,900,50,0.9473684210526315,10,9,1,365.94276311346084,0.7516891891891891,0.057417932954413775,0.2186273430908624,132082.882785467,2266.955017301026,134349.83780276802,4722,3,934.2702702702703,33,4,20,33.61051502145925,0.6477272727272728,43.014705882352935,1027.9411764705872,31.149732620320822,0
4777,4,1,1,36,0.02702702702702703,0.02702702702702703,0.972972972972973,37,700,300,400,0.42857142857142855,11,3,8,364.603427211934,0.7579454454454454,0.05061311311311267,0.21876205632716036,132244.89795918367,2243.38860544217,134488.28656462583,4723,0,935.0540540540541,34,3,20,33.48162615740739,0.6470588235294117,42.857142857142854,1028.5714285714284,30.25210084033613,0
4778,4,2,1,37,0.05263157894736842,0.02631578947368421,0.9736842105263158,38,700,500,200,0.7142857142857143,9,5,4,357.58906311697183,0.760876007586534,0.05053984318244442,0.21651141833105392,132587.25610342165,1882.5276924495117,134469.78379587116,4724,0,911.3947368421053,33,5,21,33.31746787244169,0.6527777777777779,42.52450980392156,1029.9019607843127,31.209150326797353,0
4779,4,0,0,37,0.0,0.0,1.0,37,900,600,300,0.6666666666666666,12,6,6,366.9048505288623,0.7526901901901902,0.05904702543564144,0.2212284276265744,132430.49178655236,2317.8779588817424,134748.36974543412,4725,1,937.027027027027,32,5,21,33.23545346745174,0.6536458333333334,42.676767676767675,1029.292929292929,32.165404040404034,0
4780,4,0,0,37,0.0,0.0,1.0,37,1250,1100,150,0.88,14,11,3,368.33179831293944,0.7518143143143143,0.05546606208857896,0.22247240618101569,132495.48037190095,2360.459710743822,134855.94008264478,4726,2,938.027027027027,32,5,21,33.13327814569537,0.654296875,42.613636363636374,1029.5454545454556,32.17329545454549,0
4781,4,0,0,37,0.0,0.0,1.0,37,950,600,350,0.631578947368421,13,6,7,377.45636663851747,0.7510635635635635,0.11196384935594428,0.21247607748628553,129790.40745027429,2398.0431241426536,132188.45057441693,4727,3,939.027027027027,35,2,15,35.63910343783129,0.6202380952380953,45.254629629629626,1018.981481481481,29.1137566137566,5
4782,4,1,1,37,0.02631578947368421,0.02631578947368421,0.9736842105263158,38,750,400,350,0.5333333333333333,11,4,7,370.17455374764256,0.761972498814604,0.11160102242360881,0.21013668276651898,130118.92804967133,2033.3432249817438,132152.2712746531,4728,0,915.2894736842105,36,2,16,35.490480132450344,0.6215277777777778,44.932432432432435,1020.2702702702707,28.34084084084085,0
4783,4,1,1,37,0.02631578947368421,0.02631578947368421,0.9736842105263158,38,800,500,300,0.625,11,5,6,370.09394723893786,0.7653212422949265,0.1125035577576543,0.2102458467668976,130147.65346004789,2033.3717585829077,132181.0252186308,4729,0,916.0263157894736,36,2,17,35.463341058749954,0.6218171296296295,44.90427927927928,1020.3828828828829,28.34396896896897,0
4784,4,1,0,38,0.02631578947368421,0.0,1.0,38,850,700,150,0.8235294117647058,10,7,3,370.13005097028946,0.7652916073968705,0.12101082361685345,0.21073233555243126,130233.84871357855,2040.6922124827668,132274.5409260613,4730,0,917.0,36,2,19,35.37483451015005,0.6226851851851851,44.81981981981983,1020.7207207207216,28.353353353353377,0
4785,4,1,1,38,0.02564102564102564,0.02564102564102564,0.9743589743589743,39,900,600,300,0.6666666666666666,12,6,6,363.744081496298,0.7736729644624382,0.1238469377977931,0.20899310238736538,130587.70743580667,1700.1074799892092,132287.8149157959,4731,0,894.4615384615385,35,4,16,35.17875004718227,0.6282738095238096,44.473379629629626,1022.1064814814808,29.20304232804231,0
4786,4,0,0,38,0.0,0.0,1.0,38,1100,900,200,0.8181818181818182,13,9,4,376.2816437641615,0.7657954006638217,0.1260581523739417,0.21523310023310005,130414.54081632635,2214.519557823106,132629.06037414944,4732,2,919.0,34,4,19,35.034236596736584,0.6286764705882353,44.64285714285713,1021.42857142857,30.042016806722646,0
4787,4,2,2,38,0.05,0.05,0.95,40,1250,900,350,0.72,16,9,7,355.17366611190056,0.7791666666666667,0.12230134932533776,0.20651380411911097,131047.29940943344,1308.9099530624594,132356.2093624959,4733,0,874.0,37,3,16,34.93253373313345,0.6289414414414416,44.024122807017534,1023.903508771928,27.673067804646703,0
4788,4,1,1,38,0.02564102564102564,0.02564102564102564,0.9743589743589743,39,1200,800,400,0.6666666666666666,16,8,8,364.6621191345719,0.7723796671165093,0.13467671666285974,0.21214796220669613,131068.54056336732,1759.1463507426201,132827.68691410995,4734,0,897.3846153846154,36,3,17,34.6681513251952,0.6310763888888891,44.00337837837837,1023.9864864864858,28.444069069069048,0
4789,4,0,0,38,0.0,0.0,1.0,38,750,500,250,0.6666666666666666,10,5,5,373.9783518102775,0.7618539592223803,0.13658624123000007,0.2174048065638772,131039.71370018649,2201.203230257262,133240.91693044375,4735,1,921.8421052631579,36,2,17,34.45886493620765,0.6307870370370372,44.03153153153152,1023.8738738738724,28.4409409409409,0
4790,4,0,1,37,0.0,0.02631578947368421,0.9736842105263158,38,1400,1000,400,0.7142857142857143,18,10,8,375.40131879709406,0.7619132290184922,0.1457147155487668,0.21888784588322846,131155.0401753103,2247.155009739456,133402.19518504976,4736,2,922.8421052631579,36,2,17,34.3056013632366,0.6319444444444446,43.91891891891891,1024.3243243243232,28.453453453453424,0
4791,4,0,0,37,0.0,0.0,1.0,37,850,700,150,0.8235294117647058,10,7,3,378.08182959878394,0.7626376376376376,0.13974950560316413,0.22144792876500183,131328.12499999988,2530.669689960216,133858.7946899601,4737,3,926.081081081081,35,2,17,34.06165311653116,0.6357142857142858,43.74999999999999,1024.999999999999,29.28571428571426,0
4792,4,0,0,37,0.0,0.0,1.0,37,1400,1000,400,0.7142857142857143,18,10,8,380.856972519605,0.7622622622622622,0.13831980965163782,0.2237660992389722,131446.78605109744,2612.4849965706453,134059.2710476681,4738,4,927.081081081081,35,2,17,33.870391271632805,0.6369047619047619,43.63425925925926,1025.4629629629633,29.298941798941808,0
4793,4,0,0,37,0.0,0.0,1.0,37,1050,900,150,0.8571428571428571,12,9,3,380.1137805848704,0.7613863863863863,0.14032220192662503,0.2238503945065586,131535.81700370807,2599.715336719835,134135.53234042792,4739,5,928.081081081081,35,2,17,33.799339012373544,0.6377976190476189,43.54745370370371,1025.8101851851857,29.308862433862448,0
4794,4,0,0,37,0.0,0.0,1.0,37,950,900,50,0.9473684210526315,10,9,1,379.9462727735285,0.7612612612612613,0.14759085726827648,0.22427454423502718,131624.87809713668,2602.076367455442,134226.95446459213,4740,6,929.081081081081,35,2,15,33.71353109256335,0.6386904761904761,43.46064814814816,1026.157407407409,29.318783068783112,0
4795,4,1,0,38,0.02631578947368421,0.0,1.0,38,1400,1000,400,0.7142857142857143,18,10,8,373.57653408892344,0.7677809388335705,0.1570414945212859,0.22338351936337678,132116.0357032933,2271.09014312096,134387.12584641427,4741,0,905.6052631578947,37,1,17,33.3808838168373,0.6396396396396395,42.98245614035088,1028.0701754385966,27.785680417259368,0
4796,4,0,0,38,0.0,0.0,1.0,38,1250,900,350,0.72,16,9,7,372.1103318489475,0.7664473684210527,0.1610387206425954,0.22367144418569357,132313.3815813521,2247.0352656586774,134560.41684701078,4742,1,906.6052631578947,37,1,17,33.21954154676898,0.6416103603603602,42.7905701754386,1028.8377192982466,27.806424845898558,0
4797,4,0,0,38,0.0,0.0,1.0,38,700,500,200,0.7142857142857143,9,5,4,374.98314007169614,0.7663288288288288,0.1649878378618308,0.2260830552310236,132427.78427479873,2331.6913792058517,134759.47565400458,4743,2,907.6052631578947,35,3,17,33.030309419393525,0.6467261904761903,42.67939814814816,1029.282407407409,29.408068783068828,0
4798,4,0,0,38,0.0,0.0,1.0,38,1450,1200,250,0.8275862068965517,17,12,5,372.3547482444444,0.7673660502607871,0.1650189326366427,0.22553354486382077,132600.90115453315,2274.915033276548,134875.8161878097,4744,3,908.6052631578947,36,2,18,32.92354581237701,0.646412037037037,42.511261261261275,1029.9549549549567,28.60985985985991,0
4799,4,0,0,38,0.0,0.0,1.0,38,700,300,400,0.42857142857142855,11,3,8,371.6045177692047,0.7677216690374585,0.1575035095390418,0.2254269316016374,132658.90045450884,2259.329346238163,134918.229800747,4745,4,909.6052631578947,36,2,17,32.88446472817373,0.6469907407407407,42.45495495495497,1030.1801801801826,28.61611611611618,0
4800,4,0,0,38,0.0,0.0,1.0,38,650,300,350,0.46153846153846156,10,3,7,387.8204835662325,0.7675142247510669,0.18548258864684364,0.21445824831096916,129089.936326562,2412.744305940287,131502.6806325023,4746,5,910.6052631578947,37,1,16,36.09013091641491,0.6092342342342343,45.94298245614035,1016.2280701754385,27.465623518255093,8
4801,4,1,0,39,0.02564102564102564,0.0,1.0,39,1150,600,550,0.5217391304347826,17,6,11,380.75307368336496,0.7786774628879892,0.18726974449799316,0.2120667859220423,129373.18019032576,2051.9433853727537,131425.12357569853,4747,0,888.2307692307693,36,3,17,35.98050881853738,0.6140046296296295,45.66441441441443,1017.3423423423448,28.259509509509577,0
4802,4,2,3,38,0.04878048780487805,0.07317073170731707,0.926829268292683,41,1500,1100,400,0.7333333333333333,19,11,8,364.9945611738564,0.7933434959349593,0.16952715610830205,0.20536596636667065,129772.2638272518,1273.2340976331375,131045.49792488493,4748,0,845.8536585365854,38,3,13,35.975018349585824,0.6143092105263158,45.2724358974359,1018.9102564102564,26.813427800269903,0
4803,4,1,0,39,0.02564102564102564,0.0,1.0,39,1000,800,200,0.8,12,8,4,380.6215661231532,0.7814327485380117,0.1862743473770827,0.21317562503133905,129591.85157933214,2065.0907009849234,131656.94228031707,4749,0,890.1794871794872,37,2,14,35.76082274391557,0.6143018018018017,45.449561403508774,1018.2017543859652,27.518966334755817,0
4804,4,0,0,39,0.0,0.0,1.0,39,1000,700,300,0.7,13,7,6,385.62066903366895,0.7809266756635178,0.18541240627130184,0.2167454105258209,129731.44531250004,2205.4253472222226,131936.87065972228,4750,1,891.1794871794872,37,2,14,35.491223585548724,0.6157094594594594,45.3125,1018.7500000000003,27.533783783783793,0
4805,4,0,0,39,0.0,0.0,1.0,39,950,700,250,0.7368421052631579,12,7,5,383.55822974150595,0.7789586144849303,0.18481181683247483,0.21604789013439765,129815.23762119134,2158.3405470914345,131973.57816828278,4751,2,892.1794871794872,37,2,14,35.45836023240802,0.616554054054054,45.23026315789475,1019.0789473684226,27.542674253200612,0
4806,4,2,0,41,0.04878048780487805,0.0,1.0,41,1000,600,400,0.6,14,6,8,367.6276742764661,0.7892784552845529,0.18245984719734198,0.20990354305462752,130344.39718934921,1384.4109862661549,131728.80817561536,4752,0,849.609756097561,38,3,17,35.326428123038305,0.6200657894736842,44.71153846153847,1021.1538461538469,26.87246963562755,0
4807,4,3,3,41,0.06818181818181818,0.06818181818181818,0.9318181818181819,44,850,400,450,0.47058823529411764,13,4,9,352.93112969444354,0.8092626849894292,0.18323698403186572,0.20454143449033022,130921.69390904503,441.26826656587764,131362.9621756109,4753,0,792.6136363636364,41,3,15,35.11697040196457,0.6209349593495934,44.14682539682539,1023.4126984126979,24.961285327138974,0
4808,4,0,0,41,0.0,0.0,1.0,41,1350,700,650,0.5185185185185185,20,7,13,374.51298576498516,0.79375,0.20625433803889548,0.20813703227345126,129287.27027280675,1492.8592415038863,130780.12951431064,4754,1,851.5853658536586,36,5,16,36.226839035913336,0.613136574074074,45.74887387387388,1017.0045045045058,28.250125125125162,3
4809,4,0,0,41,0.0,0.0,1.0,41,1100,600,500,0.5454545454545454,16,6,10,374.714341398585,0.7938008130081301,0.20459294696998276,0.20870341308229473,129373.18019032563,1495.5972019316782,130868.77739225731,4755,2,852.5853658536586,36,5,17,36.13409526972179,0.6140046296296295,45.66441441441442,1017.3423423423436,28.259509509509545,0
4810,4,0,0,41,0.0,0.0,1.0,41,850,500,350,0.5882352941176471,12,5,7,375.57986415357425,0.7944613821138211,0.20773487631450327,0.20975525265183362,129480.23069598335,1526.0334910741722,131006.26418705752,4756,3,853.5853658536586,37,4,16,36.00292681175033,0.6131756756756757,45.55921052631579,1017.7631578947365,27.50711237553342,0
4811,4,2,0,43,0.046511627906976744,0.0,1.0,43,800,400,400,0.5,12,4,8,364.5574639076093,0.8098468069398301,0.2184061432960851,0.20686418316982216,130103.13042534744,886.0134548611356,130989.14388020858,4757,0,814.8372093023256,39,4,18,35.64980260023143,0.6159188034188033,44.94791666666668,1020.2083333333351,26.15918803418808,0
4812,4,0,1,42,0.0,0.023255813953488372,0.9767441860465116,43,950,800,150,0.8421052631578947,11,8,3,365.7937105634459,0.809939091915836,0.21959064395193661,0.20813973003901912,130210.72035701307,926.0525109062098,131136.77286791927,4758,1,815.8372093023256,40,3,18,35.508978061004335,0.6153645833333332,44.84247967479675,1020.6300813008133,25.515752032520332,0
4813,4,0,0,42,0.0,0.0,1.0,42,1400,1100,300,0.7857142857142857,17,11,6,371.6784673052887,0.8028697251258227,0.22361516034985351,0.2117702895111534,130262.58680555595,1283.1597222222615,131545.74652777822,4759,2,835.6904761904761,39,3,19,35.3061224489796,0.6175213675213673,44.791666666666686,1020.8333333333366,26.175213675213758,0
4814,4,3,3,42,0.06666666666666667,0.06666666666666667,0.9333333333333333,45,1100,700,400,0.6363636363636364,15,7,8,356.6238578805349,0.8196127946127947,0.21862069745608337,0.20642994437009457,130874.74093967059,334.6110026042158,131209.3519422748,4760,0,780.9111111111112,39,6,17,35.07001001051954,0.6236645299145296,44.19270833333336,1023.2291666666704,26.236645299145394,0
4815,4,2,1,43,0.045454545454545456,0.022727272727272728,0.9772727272727273,44,1150,800,350,0.6956521739130435,15,8,7,364.4001240185497,0.8271670190274841,0.22905930586794954,0.21116689582418002,130917.78897518113,741.2917077580908,131659.0806829392,3673,0,691.4318181818181,38,6,18,34.82748721160874,0.6258223684210524,44.15064102564104,1023.3974358974385,26.931511470985225,0
4816,4,0,1,42,0.0,0.023255813953488372,0.9767441860465116,43,1200,700,500,0.5833333333333334,17,7,10,369.70455552385175,0.8189830195644149,0.23105776444110937,0.2142407705603741,130917.78897518116,1080.180596646979,131997.96957182814,3674,1,708.5116279069767,38,5,20,34.69177367157322,0.6258223684210524,44.15064102564104,1023.3974358974388,26.93151147098523,0
4817,4,0,0,42,0.0,0.0,1.0,42,1000,800,200,0.8,12,8,4,374.4782342138301,0.8119676732481611,0.23361261824758373,0.2164656114310791,130821.45317925383,1397.957356770872,132219.4105360247,3675,2,726.2619047619048,39,3,20,34.667315785900975,0.6231303418803417,44.244791666666686,1023.0208333333362,26.231303418803492,0
4818,4,0,0,42,0.0,0.0,1.0,42,1650,1300,350,0.7878787878787878,20,13,7,372.0334896566064,0.8106126596980255,0.22537163013353423,0.2160960482473486,131008.00781250044,1347.8732638889317,132355.88107638937,3676,3,727.2619047619048,39,3,20,34.54076787410121,0.6249999999999998,44.06250000000002,1023.7500000000035,26.25000000000009,0
4819,4,1,0,43,0.023255813953488372,0.0,1.0,43,600,200,400,0.3333333333333333,10,2,8,366.7149222190286,0.8186138796603912,0.23207181406156074,0.2143632389134324,131251.87119118503,1026.4039469954887,132278.27513818053,3677,0,711.3255813953489,41,2,21,34.43006341368963,0.6242378048780486,43.82440476190477,1024.7023809523826,24.9927409988386,0
4820,4,0,0,43,0.0,0.0,1.0,43,950,700,250,0.7368421052631579,12,7,5,366.1841496463742,0.8182908822443706,0.23028927963698242,0.21447928765001933,131328.12500000015,1018.0555555555707,132346.1805555557,3678,1,712.3255813953489,41,2,21,34.366531165311656,0.6249999999999998,43.75000000000001,1025.0000000000011,25.00000000000003,0
4821,4,0,0,43,0.0,0.0,1.0,43,1100,800,300,0.7272727272727273,14,8,6,365.2219767016642,0.8187523071244001,0.2340502321705833,0.21499057009887645,131519.83486969452,1006.786813317246,132526.62168301176,3679,2,713.3255813953489,38,5,22,34.19739263271185,0.6318530701754387,43.56303418803418,1025.7478632478621,26.993364822312163,0
4822,4,1,0,44,0.022727272727272728,0.0,1.0,44,1000,500,500,0.5,15,5,10,358.9756568568421,0.820934637068358,0.24580157245167888,0.21367392296795593,131942.77479383667,672.8488498263698,132615.62364366304,3680,0,698.0909090909091,39,5,19,33.93078931359625,0.6343482905982907,43.15104166666666,1027.3958333333321,26.343482905982874,0
4823,4,0,0,44,0.0,0.0,1.0,44,850,400,450,0.47058823529411764,13,4,9,360.12714300267425,0.8202519379844961,0.24575216998691585,0.2148134457596362,132023.05230034713,709.0169270833294,132732.06922743047,3681,1,699.0909090909091,39,5,19,33.82027501858234,0.6351495726495726,43.072916666666664,1027.7083333333328,26.351495726495713,0
4824,4,0,1,43,0.0,0.022727272727272728,0.9772727272727273,44,950,800,150,0.8421052631578947,11,8,3,361.9181018152557,0.8202739605355884,0.24733270681887265,0.2160342353666744,132049.81689453125,758.243815104167,132808.0607096354,3682,2,700.0909090909091,39,5,19,33.7472762744502,0.6354166666666667,43.046875,1027.8125,26.354166666666668,0
4825,4,0,1,42,0.0,0.023255813953488372,0.9767441860465116,43,950,500,450,0.5263157894736842,14,5,9,367.5485669078287,0.8126153562200074,0.24952421946601344,0.21886777510542307,131958.55391418267,1100.2354764774377,133058.78939066012,3683,3,717.1395348837209,38,5,20,33.69467262833178,0.6362390350877194,43.13568376068375,1027.4572649572629,27.038349077822705,0
4826,4,0,1,41,0.0,0.023809523809523808,0.9761904761904762,42,850,600,250,0.7058823529411765,11,6,5,363.91363556835796,0.8050716221447929,0.23738802451673768,0.20225864109672104,129289.65627411252,1069.8931038949927,130359.54937800752,3684,4,734.9761904761905,35,7,18,36.493897234551035,0.6151785714285715,45.74652777777777,1017.0138888888879,29.057539682539655,6
4827,4,2,2,41,0.046511627906976744,0.046511627906976744,0.9534883720930233,43,450,400,50,0.8888888888888888,5,4,1,353.8280433830554,0.8151531930601698,0.22508502421750198,0.19816931307931543,129591.85157933201,570.646256540465,130162.49783587248,3685,0,682.6976744186046,37,6,15,36.442853040419266,0.6143018018018018,45.44956140350877,1018.2017543859641,27.51896633475579,0
4828,4,0,0,41,0.0,0.0,1.0,41,1000,800,200,0.8,12,8,4,413.67131762681225,0.7997459349593496,0.31051275859293215,0.21989896358056849,127512.4999999999,2364.669417513066,129877.16941751297,3686,6,717.0,34,7,17,37.05479922992298,0.599264705882353,47.49999999999999,1009.9999999999992,29.705882352941153,7
4829,4,3,2,42,0.06818181818181818,0.045454545454545456,0.9545454545454546,44,1000,700,300,0.7,13,7,6,394.437121433667,0.8240177942212826,0.2894804880463844,0.21316114678916875,128175.553347871,1317.6892601403285,129493.24260801132,3687,0,669.0454545454545,33,11,18,36.858964661745134,0.6082702020202021,46.84436274509804,1012.6225490196077,30.68553178847296,0
4830,4,1,1,42,0.023255813953488372,0.023255813953488372,0.9767441860465116,43,1000,600,400,0.6,14,6,8,398.2267991073173,0.8175987449243263,0.2897202853573011,0.21474473185506723,128089.02739304397,1601.6966759002732,129690.72406894424,3688,0,685.5813953488372,37,6,18,36.85189196995956,0.5990990990990991,46.92982456140351,1012.2807017543856,27.358937885253667,0
4831,4,3,4,41,0.06666666666666667,0.08888888888888889,0.9111111111111111,45,1150,700,450,0.6086956521739131,16,7,9,381.2679459007311,0.8317760942760943,0.27567423637262745,0.20816517195813755,128584.36113522375,805.0671407174401,129389.42827594119,3689,0,656.0444444444445,35,10,13,36.773579253680246,0.6080357142857142,46.44097222222222,1014.236111111111,28.978174603174597,0
4832,4,1,0,42,0.023809523809523808,0.0,1.0,42,750,600,150,0.8,9,6,3,420.06897043990944,0.8135646535036779,0.29100011508804213,0.21739007052724102,126421.84452428424,2261.024975351521,128682.86949963577,3690,0,689.0952380952381,35,7,17,38.020893275022054,0.5860119047619048,48.58217592592593,1005.6712962962972,28.733465608465636,7
4833,4,1,1,42,0.023255813953488372,0.023255813953488372,0.9767441860465116,43,1400,1000,400,0.7142857142857143,18,10,8,412.79101760551913,0.8223052787006275,0.29202520355013273,0.21550438239615646,126779.9403077064,1866.7241143170259,128646.66442202343,3691,0,674.046511627907,36,7,17,37.83336128815834,0.5876736111111112,48.226351351351354,1007.094594594595,27.97484984984986,0
4834,4,2,0,44,0.045454545454545456,0.0,1.0,44,1250,1000,250,0.8,15,10,5,405.02264656710855,0.8311090556730092,0.2952668054154961,0.21370871151990517,127212.0819160998,1505.9056738412519,128717.98758994105,3692,0,659.6818181818181,34,10,19,37.58285146723312,0.5962009803921569,47.79761904761905,1008.8095238095241,29.670868347338942,0
4835,4,4,3,45,0.08333333333333333,0.0625,0.9375,48,950,600,350,0.631578947368421,13,6,7,372.04674812429613,0.8567154255319148,0.2828637259040381,0.2007696460834758,128117.4894075537,-66.86093761412303,128050.62846993958,3693,0,605.625,38,10,19,37.485269804418174,0.5975877192982455,46.90170940170941,1012.393162393164,26.641925326135894,0
4836,4,4,4,45,0.08163265306122448,0.08163265306122448,0.9183673469387755,49,1100,700,400,0.6363636363636364,15,7,8,366.76810364951353,0.8573200113378685,0.28193888038257486,0.1993661256150706,128408.33875868045,-380.77200586466415,128027.56675281578,3694,0,594.1632653061224,35,14,16,37.32121445700583,0.60625,46.61458333333333,1013.5416666666657,28.958333333333307,0
4837,4,4,2,47,0.08163265306122448,0.04081632653061224,0.9591836734693877,49,1500,1100,400,0.7333333333333333,19,11,8,370.8914606311642,0.8542729591836735,0.3072678050812159,0.2038998420152791,128858.14868922983,-241.5226036847589,128616.62608554507,3695,0,595.0816326530612,36,13,19,36.756876663708965,0.6087962962962963,46.171171171171174,1015.3153153153158,28.203203203203216,0
4838,4,2,0,49,0.04081632653061224,0.0,1.0,49,1500,1000,500,0.6666666666666666,20,10,10,388.387743902743,0.8596938775510204,0.3220418234265858,0.2106799291495376,128325.39859693873,168.9154845344467,128494.31408147317,3696,0,596.0408163265306,34,15,21,36.85842830846356,0.6075367647058822,46.69642857142857,1013.2142857142853,29.800420168067216,5
4839,4,2,2,49,0.0392156862745098,0.0392156862745098,0.9607843137254902,51,1150,700,450,0.6086956521739131,16,7,9,370.5546346079809,0.8689215686274511,0.3184665170415997,0.20371466985521672,128858.14868922967,-650.2031592403303,128207.94552998933,3697,0,573.6274509803922,36,15,18,36.76542627920733,0.6087962962962964,46.17117117117117,1015.3153153153146,28.203203203203184,0
4840,4,5,5,49,0.09259259259259259,0.09259259259259259,0.9074074074074074,54,950,600,350,0.631578947368421,13,6,7,350.90964028786675,0.8814785697647333,0.2972879678514848,0.19583838674153276,129452.33298947748,-1713.8726040100673,127738.4603854674,3698,0,542.6296296296297,37,17,14,36.65901213949647,0.6128941441441441,45.58662280701754,1017.6535087719294,27.504148885727822,0
4841,4,0,1,48,0.0,0.02040816326530612,0.9795918367346939,49,800,400,400,0.5,12,4,8,389.5184708841921,0.8580286281179138,0.334472705338293,0.2137087826743,128778.12500000009,232.2916666666803,129010.41666666677,3699,2,599.0,34,15,18,36.36596880131363,0.6121323529411764,46.25000000000001,1015.0000000000007,29.85294117647061,0
4842,4,1,1,48,0.02040816326530612,0.02040816326530612,0.9795918367346939,49,1200,800,400,0.6666666666666666,16,8,8,382.25542528599397,0.8619260204081632,0.3328486773195334,0.21100697279370445,129019.90504535145,63.71173469387202,129083.61678004533,3700,0,599.265306122449,34,15,19,36.30307202562298,0.6145833333333333,46.01190476190476,1015.9523809523807,29.880952380952376,0
4843,4,2,1,49,0.04,0.02,0.98,50,1150,800,350,0.6956521739130435,15,8,7,375.62020363003165,0.8640646258503402,0.3338738738738738,0.20942112722934636,129413.2812499999,-277.82383786849505,129135.4574121314,3701,0,588.24,34,16,20,36.07016107016106,0.6185661764705883,45.62499999999999,1017.4999999999992,29.926470588235272,0
4844,4,2,0,51,0.0392156862745098,0.0,1.0,51,1100,800,300,0.7272727272727273,14,8,6,365.7915204053599,0.8687254901960785,0.3437590726898492,0.20612784929442768,129831.84831791249,-701.722161350544,129130.12615656195,3702,0,577.6666666666666,36,15,17,35.89410681399631,0.6186342592592593,45.21396396396396,1019.1441441441441,28.30955955955956,0
4845,4,1,2,50,0.019230769230769232,0.038461538461538464,0.9615384615384616,52,1300,1000,300,0.7692307692307693,16,10,6,364.85269169741815,0.8674428104575163,0.3468440542908635,0.20728444132699453,130150.67737188353,-902.8350069252197,129247.84236495831,3703,0,567.5384615384615,37,15,17,35.59397163120569,0.6199324324324325,44.90131578947368,1020.3947368421042,27.57823613086768,0
4846,4,1,1,50,0.0196078431372549,0.0196078431372549,0.9803921568627451,51,1200,900,300,0.75,15,9,6,370.3609428388163,0.8690522875816994,0.3492867611878583,0.20977855280119803,130032.77084094219,-568.1880782809915,129464.5827626612,3704,0,579.3921568627451,36,15,17,35.573313459202815,0.6206597222222223,45.01689189189189,1019.9324324324316,28.331456456456433,0
4847,4,1,2,49,0.0196078431372549,0.0392156862745098,0.9607843137254902,51,800,600,200,0.75,10,6,4,371.5804699907871,0.8683006535947714,0.35468573123034397,0.21077942878187458,130090.2058096947,-532.2040368070964,129558.0017728876,3705,0,580.3725490196078,36,15,18,35.48381903815726,0.621238425925926,44.96058558558558,1020.1576576576566,28.337712712712683,0
4848,4,1,0,50,0.02,0.0,1.0,50,700,500,200,0.7142857142857143,9,5,4,371.79639110407584,0.8720578231292517,0.3520653133274487,0.21168106086478275,130233.84871357837,-315.90500973948315,129917.94370383889,3706,0,581.0,36,14,19,35.33231281259193,0.6226851851851853,44.81981981981981,1020.7207207207201,28.353353353353338,0
4849,4,0,0,50,0.0,0.0,1.0,50,1450,900,550,0.6206896551724138,20,9,11,371.3905042006327,0.8714625850340135,0.34478585995921196,0.21257409792962242,130439.87509645037,-311.1706336122427,130128.70446283813,3707,1,582.0,35,15,19,35.13341264445955,0.6267857142857145,44.61805555555554,1021.5277777777758,29.18650793650788,0
4850,4,1,2,49,0.0196078431372549,0.0392156862745098,0.9607843137254902,51,1250,800,450,0.64,17,8,9,362.62745153760955,0.872124183006536,0.3332167484919537,0.20923650030905758,130751.61944038616,-717.1746915834923,130034.44474880266,3708,0,571.5686274509804,36,15,17,35.041152829773175,0.6278935185185186,44.313063063063055,1022.7477477477464,28.409659659659624,0
4851,4,0,0,49,0.0,0.0,1.0,49,1100,800,300,0.7272727272727273,14,8,6,393.1482387577836,0.8684098639455783,0.24790284211844216,0.22097642385351296,129731.44531250012,412.306637296094,130143.7519497962,3709,3,595.5918367346939,33,16,19,35.299505794137694,0.6240530303030303,45.31250000000001,1018.7500000000009,30.87121212121215,6
4852,4,0,0,49,0.0,0.0,1.0,49,1150,700,450,0.6086956521739131,16,7,9,394.29892965246506,0.8674532312925171,0.25162214958133333,0.22215378719443776,129825.09731833916,437.9793829296526,130263.07670126882,3710,4,596.5918367346939,33,16,19,35.17466329966331,0.625,45.22058823529412,1019.117647058824,30.882352941176485,0
4853,4,0,0,49,0.0,0.0,1.0,49,1550,1100,450,0.7096774193548387,20,11,9,391.89234293409675,0.8679492630385488,0.24758601914506917,0.22168158977257804,129981.2590860488,387.73203215111505,130368.99111819992,3711,5,597.5918367346939,33,16,19,35.07678864719785,0.6265782828282828,45.06740196078432,1019.730392156864,30.900920974450425,0
4854,4,0,0,49,0.0,0.0,1.0,49,1200,700,500,0.5833333333333334,17,7,10,394.1486182409478,0.8679492630385488,0.2692012222808542,0.22189206233402037,129793.87622849384,431.9195141291789,130225.79574262303,3712,6,598.5918367346939,33,16,18,35.210337743034664,0.6246843434343434,45.25122549019608,1018.9950980392156,30.878639334521683,1
4855,4,1,1,49,0.02,0.02,0.98,50,1150,900,250,0.782608695652174,14,9,5,387.6990100611231,0.8710714285714285,0.2584758448627804,0.2205632174657408,130203.51750042858,95.95496827845048,130299.47246870704,3713,0,587.6,35,15,20,34.95737884629924,0.6244047619047619,44.84953703703703,1020.6018518518512,29.16005291005289,0
4856,4,0,1,48,0.0,0.02040816326530612,0.9795918367346939,49,1750,1500,250,0.8571428571428571,20,15,5,394.16676171676556,0.8658942743764173,0.2654799001135508,0.2242330224417936,130201.83000283444,464.24674036280794,130666.07674319725,3714,1,600.4489795918367,34,15,20,34.79407247560169,0.626531862745098,44.851190476190474,1020.5952380952378,30.017507002801114,0
4857,4,1,0,49,0.02040816326530612,0.0,1.0,49,1650,1200,450,0.7272727272727273,21,12,9,389.96765566724827,0.869437358276644,0.2726945676939676,0.22380869102609677,130544.2186448723,381.6187535063174,130925.83739837862,3715,0,599.8367346938776,33,16,16,34.552879042251284,0.6322601010101009,44.515931372549026,1021.936274509805,30.967765894236514,0
4858,4,0,1,48,0.0,0.02040816326530612,0.9795918367346939,49,1800,1500,300,0.8333333333333334,21,15,6,387.33785431839436,0.8695436507936508,0.27080081613081575,0.22283947453269295,130638.16350682439,320.221188965793,130958.38469579018,3716,1,600.8367346938776,33,16,16,34.524594421801325,0.6332070707070707,44.42401960784314,1022.3039215686282,30.978906714200853,0
4859,4,0,0,48,0.0,0.0,1.0,48,1650,1300,350,0.7878787878787878,20,13,7,396.56927293612324,0.8654883274231678,0.27760442412259057,0.2272690195891722,130488.2473727172,749.5258774615024,131237.7732501787,3717,2,614.0416666666666,32,16,16,34.441166172351295,0.6341145833333333,44.57070707070708,1021.7171717171727,31.928661616161648,0
4860,4,1,1,48,0.02040816326530612,0.02040816326530612,0.9795918367346939,49,1100,900,200,0.8181818181818182,13,9,4,387.94124415153686,0.8701459750566893,0.26824323498123004,0.22372976381786996,130732.14215986658,343.2779760188616,131075.42013588545,3718,0,602.4897959183673,33,16,16,34.413695825843824,0.6341540404040403,44.332107843137265,1022.6715686274524,30.990047534165225,0
4861,4,1,1,48,0.02040816326530612,0.02040816326530612,0.9795918367346939,49,1000,700,300,0.7,13,7,6,387.94124415153686,0.870500283446712,0.26824323498123004,0.22372976381786996,130732.14215986658,343.2779760188616,131075.42013588545,3719,0,603.469387755102,33,16,16,34.413695825843824,0.6341540404040403,44.332107843137265,1022.6715686274524,30.990047534165225,0
4862,4,1,1,48,0.02040816326530612,0.02040816326530612,0.9795918367346939,49,1300,1000,300,0.7692307692307693,16,10,6,389.11678359360144,0.8644770408163266,0.27000968092076283,0.22495477212184123,130826.15460399863,381.3304978854467,131207.4851018841,3720,0,604.4489795918367,33,16,16,34.288152850982264,0.63510101010101,44.24019607843138,1023.0392156862758,31.00118835412957,0
4863,4,1,1,48,0.02040816326530612,0.02040816326530612,0.9795918367346939,49,1550,1200,350,0.7741935483870968,19,12,7,382.2213885091084,0.8676303854875284,0.26576028832207643,0.22277589715196142,131139.77346453283,224.88526047673207,131364.65872500956,3721,0,605.4285714285714,33,16,17,34.1464265773311,0.6382575757575758,43.93382352941176,1024.2647058823527,31.038324420677355,0
4864,4,0,1,47,0.0,0.020833333333333332,0.9791666666666666,48,1250,900,350,0.72,16,9,7,391.94965927158995,0.8617944739952719,0.2796742078658614,0.22821993441147667,131101.73906042767,677.0563909295154,131778.79545135717,3722,7,619.0416666666666,32,16,18,33.93591008096002,0.6402994791666665,43.970959595959606,1024.1161616161628,32.00363005050509,0
4865,4,0,0,47,0.0,0.0,1.0,47,1150,700,450,0.6086956521739131,16,7,9,397.46872788541833,0.857654949121184,0.27037643207855955,0.23139093595994212,131094.66764662013,1021.2061564127789,132115.8738030329,3723,8,631.5106382978723,31,16,18,33.80178533587625,0.6428091397849462,43.97786458333334,1024.0885416666679,33.03511424731187,0
4866,4,0,0,47,0.0,0.0,1.0,47,1750,1300,450,0.7428571428571429,22,13,9,396.36837558649745,0.8576164045636755,0.26342529127224235,0.2315532848916223,131228.04641723647,1002.9295179579117,132230.97593519438,3724,9,632.5106382978723,31,16,20,33.69458741051382,0.6441532258064515,43.84765625000001,1024.6093750000011,33.05191532258068,0
4867,4,1,1,47,0.020833333333333332,0.020833333333333332,0.9791666666666666,48,1350,1000,350,0.7407407407407407,17,10,7,404.91152118474946,0.8630873226950354,0.2574123527800598,0.22097637725643066,128566.7534722223,853.1739976671067,129419.92746988942,3725,0,620.3125,34,14,18,36.19213913996163,0.6099877450980392,46.458333333333336,1014.1666666666674,29.82843137254904,8
4868,4,1,0,48,0.020833333333333332,0.0,1.0,48,1550,1300,250,0.8387096774193549,18,13,5,396.54889820844073,0.8628656914893617,0.2739403798804081,0.2180635430573689,128868.76594387753,620.5534297052137,129489.31937358274,3726,0,620.8125,34,14,19,36.09474537851253,0.6130514705882353,46.160714285714285,1015.3571428571427,29.863445378151255,0
4869,4,2,1,49,0.04,0.02,0.98,50,1100,800,300,0.7272727272727273,14,8,6,380.59274532206706,0.8672448979591837,0.27514335868929196,0.21186742728189323,129352.72285997722,-153.00099206350382,129199.72186791371,3727,0,596.94,34,16,20,36.005461283401594,0.617953431372549,45.6845238095238,1017.2619047619039,29.919467787114822,0
4870,4,0,3,46,0.0,0.061224489795918366,0.9387755102040817,49,1200,900,300,0.75,15,9,6,372.62943949137565,0.8620677437641724,0.25542298218254067,0.21023366262655646,129878.87577428426,-120.66146369168175,129758.21431059258,3728,1,610.1224489795918,35,14,18,35.672026986109536,0.6211309523809523,45.16782407407408,1019.3287037037047,29.12367724867728,1
4871,4,2,1,47,0.041666666666666664,0.020833333333333332,0.9791666666666666,48,900,500,400,0.5555555555555556,13,5,8,378.644659405642,0.858488475177305,0.26607859278604185,0.21362738727645683,129878.87577428426,235.58853630831823,130114.46431059258,3729,0,623.25,35,13,20,35.51873982816699,0.6211309523809523,45.16782407407408,1019.3287037037047,29.12367724867728,0
4872,4,0,0,47,0.0,0.0,1.0,47,1200,600,600,0.5,18,6,12,383.8419381597067,0.8553037311131667,0.270043336290094,0.21590802438465834,129760.92470689747,561.5369673782757,130322.46167427574,3730,1,637.5106382978723,35,12,20,35.50647979855351,0.6199404761904761,45.283564814814824,1018.8657407407422,29.110449735449777,0
4873,4,2,2,47,0.04081632653061224,0.04081632653061224,0.9591836734693877,49,700,500,200,0.7142857142857143,9,5,4,367.6800894524208,0.8629535147392291,0.26526340073395893,0.20934538585389922,130235.32238476147,-223.01300314120874,130012.30938162026,3731,0,612.4489795918367,38,11,21,35.43585583699674,0.6189692982456141,44.81837606837607,1020.7264957264956,26.861223571749886,0
4874,4,0,0,47,0.0,0.0,1.0,47,1300,800,500,0.6153846153846154,18,8,10,379.0087463556847,0.8569996916435398,0.27338254450716426,0.21594684385382054,130262.58680555568,474.1319444444539,130736.71875000013,3732,1,638.0212765957447,36,11,21,35.11904761904762,0.622974537037037,44.79166666666667,1020.8333333333344,28.35648148148151,0
4875,4,0,0,47,0.0,0.0,1.0,47,900,600,300,0.6666666666666666,12,6,6,379.65022741075256,0.8560360777058279,0.27466800799691593,0.2168351847165046,130356.43029423781,497.96968113226296,130854.39997537008,3733,2,639.0212765957447,33,14,21,35.007275291011645,0.6303661616161615,44.69975490196079,1021.200980392157,30.94548425430779,0
4876,4,0,0,47,0.0,0.0,1.0,47,1200,700,500,0.5833333333333334,17,7,10,378.96836199460733,0.8549182855380819,0.2736178643068432,0.2169397941478135,130444.94224773235,486.90121882085293,130931.84346655321,3734,3,640.0212765957447,34,13,21,34.93473954084606,0.6289828431372548,44.613095238095234,1021.5476190476185,30.045518207282896,0
4877,4,2,1,48,0.04081632653061224,0.02040816326530612,0.9795918367346939,49,1000,600,400,0.6,14,6,8,364.21935582533763,0.8613236961451247,0.2786325745251368,0.2122085228207204,131126.20380092927,-248.25970396072535,130877.94409696855,3735,0,614.8571428571429,36,13,21,34.62112882536193,0.6316550925925927,43.94707207207207,1024.2117117117114,28.450325325325316,0
4878,4,1,2,47,0.02040816326530612,0.04081632653061224,0.9591836734693877,49,1350,1100,250,0.8148148148148148,16,11,5,363.99377056048377,0.8607213718820862,0.2688844232537424,0.2135364000045561,131389.14399092953,-234.72331439273134,131154.4206765368,3736,0,613.6734693877551,34,15,22,34.360969190277146,0.6384803921568627,43.69047619047618,1025.2380952380938,30.154061624649817,0
4879,4,1,0,48,0.020833333333333332,0.0,1.0,48,1850,1100,750,0.5945945945945946,26,11,15,369.0644259245674,0.858876329787234,0.2656749614415226,0.21700596404230893,131476.45968632132,108.51524171270239,131584.97492803403,3737,0,627.3333333333334,35,13,21,34.142708686002344,0.6372023809523808,43.60532407407408,1025.578703703705,29.302248677248716,1
4880,4,0,1,47,0.0,0.020833333333333332,0.9791666666666666,48,1550,1000,550,0.6451612903225806,21,10,11,349.54023702721554,0.8586731678486997,0.20630000661244452,0.20417524158217806,131223.97898902796,-390.85852975811775,130833.12045926985,3738,1,628.3333333333334,40,8,21,34.89820968061894,0.6255208333333332,43.85162601626018,1024.5934959349615,25.61483739837404,4
4881,4,0,1,46,0.0,0.02127659574468085,0.9787234042553191,47,1000,600,400,0.6,14,6,8,354.20231279549637,0.8546484736355227,0.2127140316487739,0.20659700735651926,131168.01757812515,-107.99696180554076,131060.0206163196,3739,4,642.6808510638298,39,8,21,34.835350145752834,0.6266025641025641,43.90625000000001,1024.3750000000011,26.26602564102567,0
4882,4,0,1,45,0.0,0.021739130434782608,0.9782608695652174,46,1450,800,650,0.5517241379310345,21,8,13,377.59615661237314,0.851328502415459,0.2691981148003606,0.20713780642406104,128772.40997331808,631.1844757553372,129403.59444907341,3740,5,656.6304347826087,36,10,19,36.674340767040206,0.6079282407407407,46.25563063063064,1014.9774774774788,28.193818818818855,7
4883,4,1,0,46,0.021739130434782608,0.0,1.0,46,1450,1100,350,0.7586206896551724,18,11,7,373.7124258778126,0.8558977455716587,0.2609375953007629,0.20651121351280194,129062.08070031162,446.4206534702929,129508.50135378192,3741,0,649.5652173913044,37,9,20,36.47699273407431,0.6089527027027027,45.9703947368421,1016.1184210526314,27.4626600284495,0
4884,4,1,0,47,0.02127659574468085,0.0,1.0,47,750,400,350,0.5333333333333333,11,4,7,367.1712179454037,0.862550107924761,0.26353597350696534,0.20439596464778337,129352.72285997737,99.21993266374102,129451.9427926411,3742,0,636.7234042553191,34,13,21,36.346791496001565,0.617953431372549,45.68452380952381,1017.261904761905,29.919467787114854,0
4885,4,1,3,45,0.020833333333333332,0.0625,0.9375,48,1050,700,350,0.6666666666666666,14,7,7,360.10391876118615,0.8668550531914894,0.2587296851914984,0.20194737929762135,129643.0272231869,-263.0075713734394,129380.01965181346,3743,0,624.4375,35,13,18,36.23103477667916,0.6187499999999999,45.399305555555564,1018.4027777777792,29.097222222222264,0
4886,4,1,1,45,0.021739130434782608,0.021739130434782608,0.9782608695652174,46,1350,1000,350,0.7407407407407407,17,10,7,374.50772559581407,0.8600040257648953,0.27101652825272726,0.20831992236267183,129322.44897959198,486.45124716555017,129808.90022675753,3744,0,652.2391304347826,34,12,21,36.19108926342072,0.6176470588235293,45.71428571428572,1017.1428571428582,29.915966386554654,0
4887,4,0,0,45,0.0,0.0,1.0,45,1250,800,450,0.64,17,8,9,376.4020068370691,0.8575336700336701,0.2746897682041676,0.20905240197673922,129261.91184807273,730.8886054421941,129992.80045351492,3745,1,667.5333333333333,34,11,21,36.20468469523141,0.6170343137254901,45.77380952380953,1016.9047619047632,29.90896358543421,0
4888,4,1,2,44,0.021739130434782608,0.043478260869565216,0.9565217391304348,46,1500,900,600,0.6,21,9,12,333.7077600120922,0.8619162640901772,0.15831013722020093,0.1873131158093134,129678.39084201399,-477.58844423185377,129200.80239778214,3746,0,654.0,39,7,20,36.867201881775394,0.6116452991452992,45.364583333333336,1018.5416666666675,26.116452991453013,8
4889,4,2,2,44,0.043478260869565216,0.043478260869565216,0.9565217391304348,46,900,500,400,0.5555555555555556,13,5,8,331.19031074348885,0.8626207729468599,0.18817833235848447,0.18745035354263462,130003.3578413147,-588.8295037675957,129414.5283375471,3747,0,654.8478260869565,40,6,21,36.60189337319382,0.61328125,45.045731707317074,1019.8170731707319,25.495426829268297,0
4890,4,1,1,44,0.022222222222222223,0.022222222222222223,0.9777777777777777,45,1000,700,300,0.7,13,7,6,341.5659129670993,0.8556397306397306,0.186903667381755,0.19315937157914156,129970.32470703151,-121.31347656246984,129849.01123046904,3748,0,670.3111111111111,39,6,21,36.37086270303402,0.6145833333333333,45.078125000000014,1019.687500000002,26.145833333333385,0
4891,4,0,0,44,0.0,0.0,1.0,44,650,400,250,0.6153846153846154,9,4,5,346.49449672907497,0.8521626145172657,0.1941834760983694,0.19549994046671257,129881.1445891776,200.6203658046758,130081.76495498227,3749,2,686.5454545454545,38,6,21,36.335726513642875,0.6154057017543859,45.1655982905983,1019.3376068376081,26.82467386414758,0
4892,4,0,0,44,0.0,0.0,1.0,44,1000,700,300,0.7,13,7,6,347.0573126492464,0.8525369978858351,0.19317110114029368,0.19609046386096868,129935.60209155174,219.02017587115682,130154.6222674229,3750,3,687.5454545454545,38,6,22,36.26611128575922,0.615953947368421,45.112179487179496,1019.5512820512831,26.8302968960864,0
4893,4,1,1,44,0.022222222222222223,0.022222222222222223,0.9777777777777777,45,1050,700,350,0.6666666666666666,14,7,7,357.77879247101106,0.8562289562289562,0.19693038010795028,0.19538374101459519,128593.16541883664,224.69539404070304,128817.86081287733,3751,0,673.2444444444444,39,6,19,37.36017681695251,0.6006944444444446,46.43229166666666,1014.270833333332,26.00694444444441,6
4894,4,2,1,45,0.043478260869565216,0.021739130434782608,0.9782608695652174,46,1250,900,350,0.72,16,9,7,342.5205023824616,0.8665660225442834,0.13228360527292438,0.18647028382714714,128469.25593770538,-367.0293784157303,128102.22655928966,3752,0,645.6521739130435,38,8,14,37.873458741700915,0.6011513157894737,46.554487179487175,1013.7820512820507,26.678475033738177,2
4895,4,3,2,46,0.0625,0.041666666666666664,0.9583333333333334,48,750,300,450,0.4,12,3,9,332.1779949504518,0.8693299349881797,0.14383650158412564,0.18312846439767042,128969.02394614645,-1031.8656429704524,127937.158303176,3753,0,619.6875,40,8,15,37.626730031682506,0.6028645833333334,46.0619918699187,1015.7520325203251,25.393800813008127,0
4896,4,2,1,47,0.041666666666666664,0.020833333333333332,0.9791666666666666,48,1450,1100,350,0.7586206896551724,18,11,7,334.5627957065181,0.8725989952718676,0.1649466036414564,0.18604192845362444,129310.02995105548,-947.1166955254405,128362.91325553003,3754,0,620.6458333333334,38,10,18,37.21945028011204,0.6096491228070176,45.72649572649572,1017.0940170940162,26.7656320287899,0
4897,4,2,2,47,0.04081632653061224,0.04081632653061224,0.9591836734693877,49,1000,700,300,0.7,13,7,6,332.45318647152965,0.874468537414966,0.17771821830910928,0.18648277705864308,129651.8676757814,-1179.3646918402642,128472.50298394113,3755,0,608.795918367347,39,10,15,36.926055197572545,0.6113782051282051,45.39062500000001,1018.4375000000011,26.11378205128208,0
4898,4,0,0,47,0.0,0.0,1.0,47,1200,900,300,0.75,15,9,6,345.89307473619897,0.8684474252235583,0.18012869611480786,0.19262880836749446,129368.65790435538,-450.45542859339577,128918.20247576198,3756,1,635.6170212765958,37,10,19,36.87172163540994,0.6120495495495495,45.668859649122815,1017.3245614035103,27.49525841631109,0
4899,4,2,2,47,0.04081632653061224,0.04081632653061224,0.9591836734693877,49,1350,900,450,0.6666666666666666,18,9,9,340.07590768628916,0.8752834467120182,0.16508381402837036,0.19192519219250434,129890.67382812499,-965.4622395833343,128925.21158854166,3757,0,610.6326530612245,39,10,16,36.489628040057234,0.6137820512820513,45.15625,1019.3749999999999,26.13782051282051,0
4900,4,0,0,47,0.0,0.0,1.0,47,1200,1100,100,0.9166666666666666,13,11,2,354.7238196099606,0.867368177613321,0.1722465245173257,0.19923726022832736,129703.52055440134,-198.21435441674598,129505.3061999846,3758,3,637.6170212765958,37,10,16,36.30651237890204,0.6154279279279279,45.33991228070175,1018.6403508771929,27.530820293978184,0
4901,4,1,1,47,0.020833333333333332,0.020833333333333332,0.9791666666666666,48,1750,1400,350,0.8,21,14,7,347.7209343089454,0.8713800236406619,0.1806052093973438,0.19677386976211414,129996.88042534729,-559.472656249994,129437.40776909729,3759,0,625.3125,39,9,16,36.187010554988085,0.6148504273504274,45.052083333333336,1019.7916666666672,26.148504273504287,0
4902,4,0,1,46,0.0,0.02127659574468085,0.9787234042553191,47,900,500,400,0.5555555555555556,13,5,8,353.44184890396576,0.867368177613321,0.175491692430785,0.199468392928155,129890.67382812499,-218.2400173611113,129672.43381076388,3760,5,639.6170212765958,39,8,17,36.14900538183801,0.6137820512820513,45.15625,1019.3749999999999,26.13782051282051,0
4903,4,1,1,46,0.02127659574468085,0.02127659574468085,0.9787234042553191,47,1050,700,350,0.6666666666666666,14,7,7,360.1134936043448,0.8660962072155411,0.18579923566768253,0.204203326164873,130076.56385633715,-31.534830729131414,130045.02902560802,3761,0,640.4255319148937,39,8,17,35.79012645086628,0.6156517094017092,44.97395833333335,1020.1041666666694,26.156517094017165,0
4904,4,0,0,46,0.0,0.0,1.0,46,1100,700,400,0.6363636363636364,15,7,8,367.6180843354284,0.8631441223832529,0.1927642517138497,0.20799730972031225,129990.0710082001,357.3401773321759,130347.41118553228,3762,7,655.3478260869565,38,8,17,35.68665968220708,0.6165021929824561,45.05876068376069,1019.764957264958,26.83591992802521,0
4905,4,0,0,46,0.0,0.0,1.0,46,1450,1100,350,0.7586206896551724,18,11,7,369.1025602892631,0.8633856682769726,0.1993455717935524,0.20912891056864075,130044.55133912269,399.9553701877446,130444.50670931043,3763,8,656.3478260869565,38,8,18,35.593423763136755,0.6170504385964912,45.00534188034188,1019.9786324786328,26.84154295996402,0
4906,4,1,0,47,0.02127659574468085,0.0,1.0,47,1050,800,250,0.7619047619047619,13,8,5,359.5460463386119,0.8658263953129818,0.20282225634276552,0.2051527440873257,130318.5595567867,-28.5301725873679,130290.02938419933,3764,0,643.3617021276596,37,10,19,35.55895618556703,0.6216216216216216,44.73684210526316,1021.0526315789473,27.59601706970128,0
4907,4,0,0,47,0.0,0.0,1.0,47,1200,900,300,0.75,15,9,6,358.7848452449454,0.8651325932778291,0.19816472117023531,0.20543117905581854,130453.51765103375,-39.05097158301345,130414.46667945074,3765,1,644.3617021276596,38,9,19,35.441504566687584,0.6211622807017543,44.60470085470086,1021.5811965811972,26.88371569950519,0
4908,4,3,2,48,0.06,0.04,0.96,50,1100,800,300,0.7272727272727273,14,8,6,341.4058938990738,0.8748469387755102,0.2098750363266495,0.19877794939199894,131099.43000637766,-1048.3763818027073,130051.05362457495,3766,0,606.64,41,9,19,35.23230892182506,0.6227134146341463,43.97321428571429,1024.1071428571436,24.978222996515697,0
4909,4,1,1,48,0.02040816326530612,0.02040816326530612,0.9795918367346939,49,1350,800,550,0.5925925925925926,19,8,11,346.95996807746627,0.8695082199546486,0.2099472579821926,0.20184576433883092,131067.83743142316,-704.9414617621726,130362.895969661,3767,0,619.9591836734694,40,9,19,35.122030898504704,0.6239583333333333,44.00406504065041,1023.9837398373988,25.599593495934972,0
4910,4,1,0,49,0.02040816326530612,0.0,1.0,49,1000,500,500,0.5,15,5,10,351.64254081565207,0.8666028911564626,0.22930147668823642,0.20596205962059633,131328.12500000012,-563.8888888888747,130764.23611111124,3768,0,620.9387755102041,40,9,20,34.73915989159892,0.6265624999999999,43.75000000000001,1025.000000000001,25.62500000000002,0
4911,4,0,0,49,0.0,0.0,1.0,49,1200,700,500,0.5833333333333334,17,7,10,350.23635704059325,0.8660005668934241,0.22268584605248698,0.20591365420068955,131472.44953991147,-590.7136443876414,130881.73589552383,3769,1,621.9387755102041,36,13,20,34.629497456169226,0.6351273148148149,43.60923423423423,1025.5630630630626,28.48786286286285,0
4912,4,2,2,49,0.0392156862745098,0.0392156862745098,0.9607843137254902,51,1400,1100,300,0.7857142857142857,17,11,6,332.4725256398781,0.8701960784313726,0.21400423888882303,0.1977589896176402,131916.0210503471,-1428.3094618055657,130487.71158854154,3770,0,598.5098039215686,39,12,17,34.63842695869669,0.6340811965811967,43.17708333333333,1027.2916666666656,26.340811965811938,0
4913,4,0,2,47,0.0,0.04081632653061224,0.9591836734693877,49,1650,1500,150,0.9090909090909091,18,15,3,350.4300235699596,0.8640873015873016,0.22544874421361927,0.20768523675374015,131778.07113727267,-564.2014850723693,131213.8696522003,3771,3,623.9387755102041,37,12,17,34.316264416915836,0.6362612612612614,43.31140350877191,1026.7543859649095,27.750118539592147,0
4914,4,0,0,47,0.0,0.0,1.0,47,1550,1200,350,0.7741935483870968,19,12,7,353.94605200093827,0.8580403946962688,0.23478312229385612,0.21007976698610784,131834.36850761744,-67.54914973841551,131766.81935787902,3772,4,648.936170212766,37,10,18,34.16924692148906,0.6368243243243243,43.2565789473684,1026.973684210524,27.75604551920335,0
4915,4,0,0,47,0.0,0.0,1.0,47,1400,800,600,0.5714285714285714,20,8,12,347.93036605958395,0.8575393154486586,0.23287453046813922,0.20733545605706763,131985.99810979582,-215.61267258385726,131770.38543721195,3773,5,649.936170212766,38,9,18,34.17095550010397,0.636513157894737,43.10897435897434,1027.5641025640998,27.0411605937921,0
4916,4,0,1,46,0.0,0.02127659574468085,0.9787234042553191,47,950,500,450,0.5263157894736842,14,5,9,349.7020821787613,0.8559204440333025,0.2256065090989845,0.20903754385355483,132103.35422091995,-160.6363932291863,131942.71782769077,3774,6,650.936170212766,39,8,18,34.00726601817138,0.6359508547008549,42.99479166666666,1028.0208333333317,26.359508547008506,0
4917,4,0,0,46,0.0,0.0,1.0,46,1500,1200,300,0.8,18,12,6,356.58635600752996,0.8513888888888889,0.21987054606598355,0.21264749897312002,132013.44515897782,214.83867064794364,132228.28382962575,3775,7,665.9130434782609,38,8,18,33.920929064005264,0.6367872807017545,43.08226495726495,1027.6709401709386,27.04397210976154,0
4918,4,1,1,46,0.02127659574468085,0.02127659574468085,0.9787234042553191,47,1450,1200,250,0.8275862068965517,17,12,5,351.17564965446405,0.8553808202281837,0.22061410606980947,0.2109763264956758,132293.4340195154,-108.35347263534575,132185.08054688005,3776,0,652.7234042553191,40,7,18,33.77807138858704,0.6361979166666667,42.80995934959349,1028.7601626016253,25.719004065040632,0
4919,4,0,0,46,0.0,0.0,1.0,46,1200,1100,100,0.9166666666666666,13,11,2,363.03935563387296,0.8504428341384863,0.2288443078440523,0.21777950167247048,132237.24500868062,401.4648437500042,132638.70985243062,3777,9,667.9130434782609,39,7,18,33.529555735601924,0.6372863247863249,42.864583333333336,1028.5416666666672,26.37286324786326,0
4920,4,0,0,46,0.0,0.0,1.0,46,1250,900,350,0.72,16,9,7,360.8033985845372,0.849194847020934,0.2228067613763247,0.21691054674999144,132319.57250974953,348.2702921541488,132667.84280190367,3778,10,668.9130434782609,40,6,18,33.50413209535099,0.6364583333333333,42.78455284552846,1028.8617886178865,25.721544715447163,0
4921,4,0,1,45,0.0,0.021739130434782608,0.9782608695652174,46,1500,1200,300,0.8,18,12,6,362.2817625369835,0.8482286634460547,0.22209011442648818,0.21875692688990128,132484.94059938332,399.46850861506994,132884.4091079984,3779,11,669.9130434782609,36,10,18,33.29960621308248,0.6452546296296295,42.62387387387388,1029.5045045045058,28.597347347347384,0
4922,4,1,1,45,0.021739130434782608,0.021739130434782608,0.9782608695652174,46,900,400,500,0.4444444444444444,14,4,10,358.9883722977319,0.850402576489533,0.21859427897599715,0.2171024918181525,132542.91453615797,316.2730297865661,132859.18756594454,3780,0,669.9347826086956,36,10,18,33.32604257801109,0.6458333333333333,42.56756756756758,1029.7297297297314,28.60360360360365,0
4923,4,0,0,45,0.0,0.0,1.0,45,1300,800,500,0.6153846153846154,18,8,10,365.69533824922036,0.843476430976431,0.23317968896383778,0.2208323172930627,132487.35592689042,690.0016878858023,133177.35761477624,3781,13,685.8222222222222,35,10,18,33.20931703204048,0.6473214285714286,42.62152777777778,1029.5138888888887,29.414682539682534,0
4924,4,0,0,45,0.0,0.0,1.0,45,1100,800,300,0.7272727272727273,14,8,6,371.18814307714877,0.8420454545454545,0.2372967708099194,0.22468245558506617,132576.7385223767,842.1826774691475,133418.92119984585,3782,14,686.8222222222222,35,10,18,32.97791638570464,0.6482142857142856,42.53472222222223,1029.8611111111122,29.424603174603206,0
4925,4,1,2,44,0.021739130434782608,0.043478260869565216,0.9565217391304348,46,750,500,250,0.6666666666666666,10,5,5,352.57015860801,0.8418075684380032,0.19908066936387603,0.2152088248143295,132891.02447041657,185.27007088735058,133076.2945413039,3783,0,672.8695652173913,36,10,19,33.14151922236785,0.6493055555555556,42.22972972972974,1031.0810810810826,28.641141141141183,2
4926,4,0,0,44,0.0,0.0,1.0,44,1150,700,450,0.6086956521739131,16,7,9,362.16958480393316,0.8361742424242424,0.21655499075785611,0.22015027570666063,132735.14739229032,814.5266439909419,133549.67403628127,3784,16,702.4545454545455,34,10,19,33.05077402957486,0.6519607843137254,42.38095238095239,1030.4761904761913,30.308123249299744,0
4927,4,1,0,45,0.022222222222222223,0.0,1.0,45,600,300,300,0.5,9,3,6,314.0552495028478,0.8419612794612795,0.10773097230868567,0.18989112262913682,132535.48127145856,-662.9737972057426,131872.5074742528,3785,0,687.8222222222222,38,7,22,34.49021235387701,0.6419956140350879,42.57478632478631,1029.7008547008525,27.097390913180327,7
4928,4,0,0,45,0.0,0.0,1.0,45,1200,800,400,0.6666666666666666,16,8,8,313.27607134863393,0.8420033670033671,0.11353619179345342,0.18969731958547892,132590.49236613302,-692.5142906713836,131897.97807546164,3786,1,688.8222222222222,38,7,23,34.45517807745503,0.6425438596491231,42.5213675213675,1029.914529914527,27.103013945119134,0
4929,4,0,0,45,0.0,0.0,1.0,45,1200,900,300,0.75,15,9,6,314.3339269367418,0.8410774410774411,0.11217348220355583,0.19075658007872856,132673.0304099092,-659.2730705311068,132013.7573393781,3787,2,689.8222222222222,38,7,17,34.345293649970614,0.6433662280701755,42.441239316239304,1030.2350427350411,27.1114484930274,0
4930,4,0,1,44,0.0,0.022222222222222223,0.9777777777777777,45,1100,700,400,0.6363636363636364,15,7,8,315.18608754913487,0.8398989898989899,0.10778250002879441,0.19183597391712934,132783.12108490375,-629.7215145372461,132153.3995703665,3788,3,690.8222222222222,38,7,17,34.21314052727962,0.6444627192982457,42.334401709401696,1030.6623931623915,27.12269455690504,0
4931,4,3,3,44,0.06382978723404255,0.06382978723404255,0.9361702127659575,47,1000,700,300,0.7,13,7,6,299.7293806221964,0.844395621338267,0.09792260010051956,0.1831005051750276,132920.79863393944,-1428.3793100299704,131492.41932390947,3789,0,662.2978723404256,38,9,16,34.47385688631026,0.6458333333333335,42.20085470085469,1031.1965811965795,27.13675213675209,1
4932,4,0,0,44,0.0,0.0,1.0,44,950,500,450,0.5263157894736842,14,5,9,321.90120205993503,0.8337517618040874,0.10893557880967975,0.19454029167969975,132517.1467764059,-268.5142318244256,132248.63254458146,3790,1,707.9318181818181,35,9,21,34.30661720623502,0.6476190476190476,42.59259259259259,1029.6296296296287,29.41798941798939,0
4933,4,1,1,44,0.022222222222222223,0.022222222222222223,0.9777777777777777,45,1200,800,400,0.6666666666666666,16,8,8,320.781315359845,0.8371212121212122,0.10196878110358587,0.19550147541970836,132832.97444403864,-477.93274693612307,132355.0416971025,3791,0,693.1777777777778,36,9,16,34.01905360134004,0.6487268518518519,42.28603603603604,1030.855855855856,28.634884884884887,0
4934,4,0,1,43,0.0,0.022727272727272728,0.9772727272727273,44,1000,600,400,0.6,14,6,8,326.01195285818477,0.8319679351656096,0.10296819968352855,0.19843721395776703,132785.4151261358,-142.07350072875727,132643.34162540705,3792,3,709.9318181818181,35,9,17,33.93189687441512,0.6502976190476191,42.33217592592592,1030.671296296295,29.447751322751284,0
4935,4,0,0,43,0.0,0.0,1.0,43,1350,1100,250,0.8148148148148148,16,11,5,329.492435043291,0.8295957918050941,0.11674359532037504,0.2011088076046469,132888.53635204062,157.15348639453688,133045.68983843515,3793,4,725.0,34,9,18,33.73888696455374,0.6534926470588236,42.23214285714285,1031.071428571427,30.325630252100797,0
4936,4,0,0,43,0.0,0.0,1.0,43,1750,1200,550,0.6857142857142857,23,12,11,328.62164990695817,0.8279346622369878,0.11541496036367715,0.2014027735568387,133042.01388888882,144.09722222221245,133186.11111111104,3794,5,726.0,34,9,19,33.60763327948303,0.6550245098039216,42.08333333333333,1031.666666666666,30.343137254901944,0
4937,4,0,0,43,0.0,0.0,1.0,43,1550,1300,250,0.8387096774193549,18,13,5,326.2786085103808,0.8279808047249907,0.11700832747960987,0.2012902311677841,133287.76218820867,97.78911564625787,133385.55130385494,3795,6,727.0,34,9,20,33.42220044577664,0.6574754901960784,41.845238095238095,1032.619047619048,30.37114845938376,0
4938,4,0,0,43,0.0,0.0,1.0,43,950,700,250,0.7368421052631579,12,7,5,325.93575198748306,0.8268733850129198,0.11298514383119262,0.20157836920850977,133379.97626133793,94.66057256236962,133474.6368339003,3796,7,728.0,34,9,21,33.338855595251836,0.6583946078431373,41.75595238095239,1032.976190476191,30.381652661064443,0
4939,4,0,0,43,0.0,0.0,1.0,43,1000,400,600,0.4,16,4,12,326.15764828303816,0.8255813953488371,0.1125281320330076,0.20221774193548384,133472.22222222234,106.5972222222317,133578.81944444455,3797,8,729.0,34,9,21,33.240927419354826,0.6593137254901961,41.66666666666667,1033.3333333333344,30.39215686274513,0
4940,4,0,0,43,0.0,0.0,1.0,43,1500,1100,400,0.7333333333333333,19,11,8,326.618169664894,0.8259966777408637,0.11413373900886237,0.20300827252686304,133564.50007086174,124.91850907030224,133689.41857993204,3798,9,730.0,34,9,21,33.13682866904678,0.6602328431372548,41.577380952380956,1033.6904761904768,30.40266106442579,0
4941,4,1,1,43,0.022727272727272728,0.022727272727272728,0.9772727272727273,44,1150,700,450,0.6086956521739131,16,7,9,317.8930079361902,0.8334874911909796,0.10827680541854368,0.19885553519535382,133801.32144043644,-293.0990922925166,133508.22234814393,3799,0,714.3863636363636,35,9,17,33.12602546891898,0.6604166666666667,41.34837962962963,1034.606481481482,29.5601851851852,0
4942,4,0,0,43,0.0,0.0,1.0,43,750,500,250,0.6666666666666666,10,5,5,326.01090625019646,0.8247046880767811,0.11251690297358419,0.20296808034286454,133626.03635204103,112.70904195013372,133738.74539399118,3800,11,732.0,34,9,21,33.091057378622125,0.6608455882352939,41.51785714285715,1033.9285714285732,30.409663865546268,0
4943,4,0,0,43,0.0,0.0,1.0,43,1150,600,550,0.5217391304347826,17,6,11,325.35403715121976,0.8240125507567367,0.11355946721487009,0.20306579560127871,133718.36734693893,101.1621315192931,133819.52947845822,3801,12,733.0,34,9,17,33.01584561080418,0.6617647058823528,41.42857142857144,1034.2857142857156,30.42016806722693,0
4944,4,0,0,43,0.0,0.0,1.0,43,1500,1100,400,0.7333333333333333,19,11,8,325.5351255810918,0.822858988556663,0.11501086270186955,0.20385816365640155,133841.52494331083,114.02352607711254,133955.54846938793,3802,13,734.0,34,9,17,32.888240144193894,0.6629901960784312,41.30952380952382,1034.761904761906,30.43417366946782,0
4945,4,0,0,43,0.0,0.0,1.0,43,1400,1000,400,0.7142857142857143,18,10,8,324.81784341479255,0.8222591362126246,0.11350077947220516,0.2042618065204957,133995.55165816352,104.82922335603621,134100.38088151955,3803,14,735.0,34,9,19,32.753152428040316,0.6645220588235292,41.1607142857143,1035.3571428571447,30.451680672268964,0
4946,4,0,0,43,0.0,0.0,1.0,43,1000,500,500,0.5,15,5,10,323.62692616700883,0.8212901439645626,0.1115665638215746,0.20376425815737026,134040.9208488728,75.8502389832191,134116.77108785603,3804,15,736.0,35,8,20,32.738743899258594,0.6627976190476189,41.11689814814816,1035.532407407409,29.58664021164026,0
4947,4,0,0,43,0.0,0.0,1.0,43,1000,700,300,0.7,13,7,6,321.41164645444024,0.8205057216685123,0.11274302208665765,0.20303145006448114,134160.80092860523,24.16878322188768,134184.9697118271,3805,16,737.0,35,8,21,32.67663296465944,0.6639880952380952,41.00115740740741,1035.9953703703711,29.599867724867746,0
4948,4,0,0,43,0.0,0.0,1.0,43,1200,800,400,0.6666666666666666,16,8,8,323.3115473406247,0.8203211517165006,0.12011392934199838,0.2052375286697361,134340.7215175969,86.78130894204736,134427.50282653893,3806,17,738.0,35,8,21,32.4482015927952,0.6657738095238095,40.8275462962963,1036.689814814815,29.619708994709,0
4949,4,0,0,43,0.0,0.0,1.0,43,500,300,200,0.6,7,3,4,322.79534667269104,0.8199981543004798,0.11662511587492852,0.2051053662398528,134375.58493882397,75.1627049346663,134450.74764375863,3807,18,739.0,36,7,22,32.42686723869518,0.6640625,40.79391891891892,1036.8243243243244,28.800675675675677,0
4950,4,1,1,43,0.022727272727272728,0.022727272727272728,0.9772727272727273,44,1500,1100,400,0.7333333333333333,19,11,8,319.004752698092,0.8223661028893587,0.10250695279985789,0.20449136372538357,134696.86536198377,-206.09782079374716,134490.76754119003,3808,0,723.1818181818181,36,8,22,32.205557966297825,0.6672453703703702,40.48423423423424,1038.0630630630644,28.835085085085122,0
4951,4,0,0,43,0.0,0.0,1.0,43,1550,1400,150,0.9032258064516129,17,14,3,323.05582201960874,0.8181524547803617,0.1067037400556603,0.20692185625814719,134667.64219878687,101.03316999434338,134768.6753687812,3809,20,741.0,36,7,24,32.12948898774004,0.6669560185185184,40.5123873873874,1037.9504504504523,28.831956956957008,0
4952,4,0,1,42,0.0,0.023255813953488372,0.9767441860465116,43,1550,1300,250,0.8387096774193549,18,13,5,322.8942315905851,0.8172757475083056,0.10538673320775005,0.20728715111398294,134749.93657904354,101.99544571406571,134851.9320247576,3810,21,742.0,37,6,24,32.05184901608758,0.665822072072072,40.43311403508772,1038.267543859649,28.061284969179706,0
4953,4,0,0,42,0.0,0.0,1.0,42,800,600,200,0.75,10,6,4,325.2554734082064,0.8129839334107627,0.11098456087066566,0.20866598534100603,134726.0916955808,364.0797469767208,135090.17144255753,3811,22,757.9285714285714,36,6,24,32.01427305926168,0.6675347222222221,40.45608108108109,1038.1756756756765,28.838213213213237,0
4954,4,0,0,42,0.0,0.0,1.0,42,850,400,450,0.47058823529411764,13,4,9,324.9428857219176,0.8116531165311653,0.11450361970856493,0.20896954617346752,134813.7897187729,361.3563732651707,135175.14609203808,3812,23,758.9285714285714,36,6,19,31.935182173064426,0.6684027777777777,40.37162162162163,1038.513513513514,28.847597597597613,0
4955,4,0,0,42,0.0,0.0,1.0,42,1650,1300,350,0.7878787878787878,20,13,7,324.67291833193815,0.8098141695702671,0.10890657335872556,0.20964009919165816,134960.01649876236,363.57248295594735,135323.5889817183,3813,24,759.9285714285714,36,6,20,31.79685524366897,0.669849537037037,40.230855855855864,1039.0765765765773,28.863238238238257,0
4956,4,0,0,42,0.0,0.0,1.0,42,900,600,300,0.6666666666666666,12,6,6,325.0423364258228,0.809789972899729,0.11198835841228538,0.21004836698441842,134989.2713659607,375.4456314422664,135364.71699740298,3814,25,760.9285714285714,36,6,20,31.758190651639943,0.6701388888888888,40.20270270270271,1039.1891891891903,28.866366366366396,0
4957,4,0,0,42,0.0,0.0,1.0,42,1600,1100,500,0.6875,21,11,10,324.82037899975927,0.8080236159504453,0.10317976009983787,0.2109276638314894,135164.86714755304,380.860674864066,135545.7278224171,3815,26,761.9285714285714,36,6,20,31.58955129593531,0.671875,40.03378378378379,1039.8648648648657,28.885135135135158,0
4958,4,0,0,42,0.0,0.0,1.0,42,1250,1000,250,0.8,15,10,5,324.01657463178395,0.8060394889663183,0.10560563656136757,0.21126246528038503,135311.28415155035,368.6197599626827,135679.90391151304,3816,27,762.9285714285714,36,6,21,31.46512068405672,0.6733217592592592,39.893018018018026,1040.4279279279292,28.900775775775813,0
4959,4,0,0,42,0.0,0.0,1.0,42,350,300,50,0.8571428571428571,4,3,1,325.24034407151294,0.8060636856368564,0.10696763553906408,0.21223310587717378,135340.57706355012,403.6431701972359,135744.22023374736,3817,28,763.9285714285714,36,6,21,31.404220779220775,0.673611111111111,39.86486486486487,1040.5405405405413,28.903903903903924,0
4960,4,0,0,42,0.0,0.0,1.0,42,1100,700,400,0.6363636363636364,15,7,8,326.8758360889975,0.8047086720867209,0.10939538057110787,0.21368494739371643,135405.3410664819,452.1468144044216,135857.48788088633,3818,29,764.9285714285714,37,5,21,31.297408343868515,0.6722972972972973,39.80263157894736,1040.7894736842097,28.12944523470837,0
4961,4,0,0,42,0.0,0.0,1.0,42,1100,800,300,0.7272727272727273,14,8,6,326.1696054995556,0.8037166085946573,0.11446067004546867,0.2144141925702616,135605.1275993575,446.0541945598692,136051.18179391738,3819,30,765.9285714285714,37,5,23,31.117639576095726,0.6742680180180181,39.61074561403509,1041.5570175438597,28.15018966334756,0
4962,4,0,0,42,0.0,0.0,1.0,42,1200,800,400,0.6666666666666666,16,8,8,328.1914048970133,0.803305265195509,0.1179367547952308,0.21627957737063794,135693.9688893176,506.72486863241744,136200.69375795,3820,31,766.9285714285714,35,7,23,30.976912537954533,0.6791666666666667,39.52546296296296,1041.8981481481483,29.768518518518523,0
4963,4,0,0,42,0.0,0.0,1.0,42,1300,800,500,0.6153846153846154,18,8,10,327.7704008600319,0.8019986449864499,0.11817508791412168,0.21654970357627198,135784.42650730876,501.223181370023,136285.6496886788,3821,32,767.9285714285714,35,7,23,30.89822783638718,0.6800595238095237,39.438657407407405,1042.24537037037,29.77843915343914,0
4964,4,0,0,42,0.0,0.0,1.0,42,1050,600,450,0.5714285714285714,15,6,9,333.37973222501574,0.799845141308556,0.12225040959780165,0.22118935105650878,135935.25618355614,663.6118612825637,136598.8680448387,3822,33,768.9285714285714,35,7,17,30.602571217166105,0.6815476190476191,39.293981481481474,1042.8240740740732,29.79497354497352,0
4965,4,0,0,42,0.0,0.0,1.0,42,1150,900,250,0.782608695652174,14,9,5,332.71765356348027,0.7986837011227255,0.12174184073451877,0.22150051175932123,136055.98020618988,653.6452974965564,136709.62550368643,3823,34,769.9285714285714,35,7,17,30.500240366836763,0.6827380952380953,39.17824074074073,1043.2870370370363,29.808201058201035,0
4966,4,0,0,42,0.0,0.0,1.0,42,1100,900,200,0.8181818181818182,13,9,4,357.2321081629424,0.7986837011227255,0.15637161630768426,0.21504960456120709,132369.79316953314,1057.3480542090049,133427.14122374213,3824,35,770.9285714285714,37,5,20,33.5454404191085,0.6421734234234233,42.735745614035096,1029.057017543861,27.812351825509758,7
4967,4,0,0,42,0.0,0.0,1.0,42,850,600,250,0.7058823529411765,11,6,5,355.97382775180284,0.7981513743708866,0.15073117968653782,0.21462205086079905,132427.78427479873,1028.1710652630995,133455.95534006183,3825,36,771.9285714285714,35,7,20,33.51945818808802,0.6467261904761903,42.67939814814816,1029.282407407409,29.408068783068828,0
4968,4,0,0,42,0.0,0.0,1.0,42,1250,1000,250,0.8,15,10,5,354.2293593896185,0.7969173441734417,0.14951417329157612,0.21390836060900595,132487.35592689048,986.1822434413591,133473.53817033183,3826,37,772.9285714285714,35,7,21,33.50442664418211,0.6473214285714286,42.62152777777778,1029.5138888888891,29.41468253968255,0
4969,4,0,1,41,0.0,0.023809523809523808,0.9761904761904762,42,1000,700,300,0.7,13,7,6,355.33416674919334,0.796965737514518,0.15157289681671915,0.2152242575555052,132600.90115453317,1023.5261443876581,133624.42729892084,3827,38,773.9285714285714,36,6,21,33.36180661855821,0.646412037037037,42.511261261261275,1029.954954954957,28.609859859859917,0
4970,4,0,0,41,0.0,0.0,1.0,41,1250,900,350,0.72,16,9,7,356.73467921270367,0.7924288617886179,0.15141205992334372,0.2170193689268742,132765.01092884367,1272.3767168744394,134037.38764571812,3828,39,768.0,37,4,17,33.16077508245558,0.6461148648648647,42.351973684210535,1030.5921052631593,27.85384068278809,0
4971,4,0,0,41,0.0,0.0,1.0,41,950,700,250,0.7368421052631579,12,7,5,356.5551955406827,0.791819105691057,0.15447068008912557,0.2175657692192761,132878.03849501794,1275.6709997307112,134153.70949474865,3829,40,769.0,37,4,19,33.05184072459144,0.6472409909909909,42.24232456140352,1031.0307017543878,27.86569464201048,0
4972,4,0,1,40,0.0,0.024390243902439025,0.975609756097561,41,850,400,450,0.47058823529411764,13,4,9,355.3170843167193,0.7916158536585366,0.1563692550190805,0.21763171414399105,133019.3905817178,1252.812403816594,134272.2029855344,3830,41,770.0,37,4,19,32.94182256235827,0.6486486486486485,42.105263157894754,1031.5789473684238,27.88051209103848,0
4973,4,0,0,40,0.0,0.0,1.0,40,1200,900,300,0.75,15,9,6,353.8494277638337,0.7856036324786325,0.1377495908346973,0.21750704261941917,133152.40652392275,1423.180570773497,134575.58709469624,3831,42,759.575,36,4,19,32.84619930896526,0.6519097222222221,41.97635135135136,1032.094594594596,28.669294294294332,0
4974,4,0,0,40,0.0,0.0,1.0,40,1100,800,300,0.7272727272727273,14,8,6,338.1512988966204,0.7856036324786325,0.12909752793769025,0.19852103094268786,131417.11576485337,1009.5677700152264,132426.68353486859,3832,43,760.575,35,5,19,34.99513206908229,0.6366071428571429,43.66319444444444,1025.3472222222222,29.29563492063492,7
4975,4,0,0,40,0.0,0.0,1.0,40,1050,700,350,0.6666666666666666,14,7,7,336.74954605221,0.7829594017094017,0.13140649672907756,0.19877639649127127,131624.87809713645,864.9235896776347,132489.80168681408,3833,44,761.575,35,5,17,34.82169712008421,0.6386904761904761,43.460648148148145,1026.1574074074072,29.318783068783063,0
4976,4,0,0,40,0.0,0.0,1.0,40,700,400,300,0.5714285714285714,10,4,6,339.4738359911303,0.783573717948718,0.14814646410613053,0.1986889132754596,131300.02891514672,914.5848963142204,132214.61381146093,3834,45,762.575,37,3,19,35.07932580863734,0.6314752252252254,43.77741228070174,1024.890350877191,27.699739212897054,2
4977,4,0,0,40,0.0,0.0,1.0,40,1150,800,350,0.6956521739130435,15,8,7,338.9556813090132,0.7823450854700855,0.14849774799516635,0.19868084784004814,131356.98356718203,904.8421776747412,132261.82574485676,3835,46,763.575,36,4,20,35.03515324618256,0.6339699074074074,43.721846846846844,1025.1126126126126,28.47535035035035,0
4978,4,0,0,40,0.0,0.0,1.0,40,1050,700,350,0.6666666666666666,14,7,7,339.8282726059549,0.7802884615384615,0.15053798858146705,0.1999454720216432,131501.3239590942,937.5735532830118,132438.8975123772,3836,47,764.575,36,4,21,34.867241253110805,0.6354166666666667,43.58108108108108,1025.6756756756756,28.49099099099099,0
4979,4,1,0,41,0.024390243902439025,0.0,1.0,41,1350,1000,350,0.7407407407407407,17,10,7,333.7524931380804,0.7859247967479674,0.15412863151589362,0.197947567969482,131806.21831957897,598.1307950523152,132404.34911463127,3837,0,746.9024390243902,37,4,18,34.7160304324613,0.6365427927927929,43.28399122807017,1026.8640350877183,27.753082029397792,0
4980,4,1,1,41,0.023809523809523808,0.023809523809523808,0.9761904761904762,42,750,500,250,0.6666666666666666,10,5,5,325.35268974025365,0.7906262098335269,0.14899331184807862,0.1940215451092062,132013.44515897782,190.18589287016607,132203.63105184797,3838,0,730.0952380952381,38,4,18,34.72337734345219,0.6367872807017545,43.08226495726495,1027.6709401709386,27.04397210976154,0
4981,4,1,1,41,0.023809523809523808,0.023809523809523808,0.9761904761904762,42,900,500,400,0.5555555555555556,13,5,8,323.9274785992592,0.7873112659698026,0.14568183392201717,0.19415478885407655,132205.65440317048,165.00885747681272,132370.6632606473,3839,0,731.0714285714286,38,4,18,34.56697139691115,0.6387061403508771,42.89529914529915,1028.4188034188037,27.063652721547466,0
4982,4,0,0,41,0.0,0.0,1.0,41,1200,1000,200,0.8333333333333334,14,10,4,332.20096802974837,0.7842987804878049,0.15096047313640115,0.19893874062471145,132172.40521121887,581.560191597418,132753.96540281628,3840,3,749.9024390243902,37,4,19,34.38766261462999,0.6402027027027026,42.92763157894737,1028.2894736842109,27.791607396870564,0
4983,4,2,1,42,0.046511627906976744,0.023255813953488372,0.9767441860465116,43,900,700,200,0.7777777777777778,11,7,4,318.84292837266827,0.7941583610188261,0.15895509927638618,0.19331929605624265,132639.32427300356,-141.77788628471706,132497.54638671884,3841,0,715.9767441860465,39,4,16,34.26292260761115,0.6412927350427351,42.473958333333336,1030.1041666666672,26.412927350427363,0
4984,4,0,0,42,0.0,0.0,1.0,42,1150,900,250,0.782608695652174,14,9,5,325.7151650281504,0.7885694928377855,0.1562191266548112,0.19722953460247297,132590.4923661334,237.34682043977153,132827.83918657317,3842,1,734.0238095238095,38,4,20,34.1348979944675,0.6425438596491228,42.52136752136752,1029.91452991453,27.103013945119212,0
4985,4,0,0,42,0.0,0.0,1.0,42,1100,700,400,0.6363636363636364,15,7,8,340.42802071572567,0.7888114595431669,0.13747220428950624,0.1917538196686036,129815.23762119142,475.99911418911825,130291.23673538055,3843,2,735.0238095238095,37,5,16,36.557187432752336,0.616554054054054,45.230263157894754,1019.0789473684233,27.54267425320063,6
4986,4,1,1,42,0.023255813953488372,0.023255813953488372,0.9767441860465116,43,1050,700,350,0.6666666666666666,14,7,7,346.2423664304183,0.7957272056109265,0.13908075006197973,0.1962300752039589,130055.18297846861,406.1228642012142,130461.30584266983,3844,0,718.9069767441861,40,3,16,36.165562419049515,0.6138020833333333,44.994918699187,1020.0203252032529,25.50050813008132,3
4987,4,1,1,42,0.023255813953488372,0.023255813953488372,0.9767441860465116,43,1750,1500,250,0.8571428571428571,20,15,5,343.6293427831665,0.7950350682908822,0.14553928461709442,0.19592974958077566,130290.57167830496,354.82843999649043,130645.40011830145,3845,0,719.8837209302326,37,6,20,35.99360523395267,0.6213400900900901,44.76425438596492,1020.9429824561412,27.593053579895706,0
4988,4,0,0,42,0.0,0.0,1.0,42,1200,1000,200,0.8333333333333334,14,10,4,348.0216576426488,0.7879645760743321,0.15403304178814348,0.19829140958709068,130262.58680555565,666.8402777777873,130929.42708333343,3846,1,737.9285714285714,39,3,20,35.90986394557823,0.6175213675213675,44.79166666666667,1020.8333333333342,26.175213675213698,0
4989,4,0,0,42,0.0,0.0,1.0,42,1100,600,500,0.5454545454545454,16,6,10,345.72350373247,0.7874806426635695,0.15500986737834532,0.1975502278382962,130374.54433094813,614.7088527239332,130989.25318367207,3847,2,738.9285714285714,37,5,20,35.85507479779543,0.6221846846846846,44.68201754385966,1021.2719298245627,27.601944049312504,0
4990,4,0,0,42,0.0,0.0,1.0,42,1000,600,400,0.6,14,6,8,345.00455755507255,0.786125629113434,0.1575401804385499,0.19781915997941923,130508.0950032873,605.177514792899,131113.2725180802,3848,3,739.9285714285714,38,4,14,35.73818485989126,0.6217105263157894,44.55128205128205,1021.7948717948716,26.88933873144399,0
4991,4,0,0,42,0.0,0.0,1.0,42,1250,900,350,0.72,16,9,7,341.51378919899986,0.7869967092528068,0.1513344181857088,0.19650904683374804,130644.58832137122,523.3856791949809,131167.9740005662,3849,4,740.9285714285714,38,4,14,35.68924826697321,0.6230811403508771,44.417735042735046,1022.3290598290603,26.90339631129106,0
4992,4,0,0,42,0.0,0.0,1.0,42,1500,1100,400,0.7333333333333333,19,11,8,338.4756754298827,0.7868757259001161,0.15114844768072255,0.19545030859865486,130781.15297866902,453.24781759076666,131234.40079625978,3850,5,741.9285714285714,38,4,15,35.6288298168651,0.6244517543859649,44.284188034188034,1022.863247863248,26.917453891138106,0
4993,4,2,2,42,0.045454545454545456,0.045454545454545456,0.9545454545454546,44,950,900,50,0.9473684210526315,10,9,1,333.21397817274743,0.8020172656800564,0.15555319502687914,0.19544052283529123,131381.51584201414,-43.22706215982947,131338.2887798543,3851,0,709.1590909090909,39,5,18,35.15757298652035,0.6287393162393162,43.69791666666668,1025.2083333333353,26.28739316239321,0
4994,4,0,0,42,0.0,0.0,1.0,42,900,500,400,0.5555555555555556,13,5,8,349.4699320615009,0.7901664730933023,0.16030325483188235,0.20369518920929147,131141.34250217053,765.9912109375397,131907.33371310806,3852,1,743.452380952381,39,3,18,34.98349520322722,0.62633547008547,43.932291666666686,1024.2708333333364,26.26335470085478,0
4995,4,1,1,42,0.023255813953488372,0.023255813953488372,0.9767441860465116,43,950,800,150,0.8421052631578947,11,8,3,343.0164732734788,0.798172757475083,0.15842356795951762,0.20119719300319708,131382.8849806415,413.56461292484636,131796.44959356636,3853,0,727.1395348837209,38,5,18,34.904951715992766,0.6304824561403508,43.6965811965812,1025.213675213676,26.979307242465158,0
4996,4,1,0,43,0.023255813953488372,0.0,1.0,43,1400,1000,400,0.7142857142857143,18,10,8,345.7347094674845,0.7947582133628645,0.17297676839824194,0.2041046026081861,131629.4461451713,501.7736640733401,132131.21980924465,3854,0,728.1162790697674,38,5,17,34.586586847128224,0.6329495614035088,43.45619658119658,1026.1752136752136,27.004610886189834,0
4997,4,0,0,43,0.0,0.0,1.0,43,500,300,200,0.6,7,3,4,346.1687062024718,0.7948504983388704,0.1725776505019352,0.20465493910690116,131684.26890432087,516.9945987654196,132201.2635030863,3855,1,729.1162790697674,38,5,17,34.5201849345963,0.6334978070175439,43.40277777777777,1026.388888888888,27.01023391812863,0
4998,4,0,0,43,0.0,0.0,1.0,43,1300,900,400,0.6923076923076923,17,9,8,344.46642071941903,0.7940199335548173,0.17563801062625184,0.20438340962685528,131821.37573964495,481.6074950690283,132302.983234714,3856,2,730.1162790697674,38,5,17,34.42571785268414,0.6348684210526316,43.26923076923077,1026.9230769230767,27.024291497975703,0
4999,4,0,0,43,0.0,0.0,1.0,43,1200,600,600,0.5,18,6,12,344.6778869017667,0.7948504983388704,0.17593692827099727,0.20530813263279146,131969.53125,497.3958333333329,132466.92708333334,3857,3,731.1162790697674,39,4,17,34.27108678021088,0.6346153846153847,43.125,1027.5,26.346153846153847,0
5000,4,0,0,43,0.0,0.0,1.0,43,1100,1000,100,0.9090909090909091,12,10,2,342.14539374510144,0.7949427833148763,0.17846345262473307,0.2045204658310359,132103.35422092004,439.71082899304974,132543.0650499131,3858,4,732.1162790697674,39,4,17,34.201476846691676,0.6359508547008548,42.994791666666664,1028.0208333333326,26.359508547008527,0
