period,mktsize,entries,exits,surviv,entryrate,exitrate,survivrate,firms,totresinv,totinninv,totimiinv,costshareinn,firmsres,firmsinn,firmsimi,hindex,div,gini,pcm,cs,totprofits,ts,maxage,minage,avgage,actfirms,inactfirms,profitablefirms,wmc,avgproxopt,price,totoutput,avgoutput,magtechshock
1,4,40,24,16,1.0,0.6,0.4,40,0,0,0,0,0,0,0,421.50487504909677,0.9992788461538461,0.03957655782489944,0.17832184779870158,117753.38812684931,3526.7254298030807,121280.11355665239,0,0,0.0,32,8,16,47.127184423919175,0.5022786458333334,57.35479797979798,970.5808080808082,30.330650252525256,0
2,4,39,39,16,0.7090909090909091,0.7090909090909091,0.2909090909090909,55,550,400,150,0.7272727272727273,7,4,3,284.6553286022703,0.9952020202020202,-0.10942461415352112,0.1332676130707431,122214.76444615937,-1842.1832133058738,120372.5812328535,1,0,0.2909090909090909,44,11,10,45.76427255985269,0.5281723484848484,52.80092592592594,988.7962962962984,22.472643097643143,0
3,4,35,37,14,0.6862745098039216,0.7254901960784313,0.27450980392156865,51,500,400,100,0.8,6,4,2,283.0910910776132,0.9990196078431374,-0.17240559435195946,0.13414687198144903,122733.23887536794,-1451.0626990565595,121282.17617631138,2,0,0.5686274509803921,42,9,12,45.26431807810157,0.5362103174603174,52.27713178294573,990.891472868216,23.592654115909905,0
4,4,39,34,19,0.7358490566037735,0.6415094339622641,0.3584905660377359,53,450,400,50,0.8888888888888888,5,4,1,338.39653393845236,1.0013909046927914,-0.2415934006705991,0.15932903346408397,122458.48809720651,87.90558468758269,122546.3936818941,3,0,0.660377358490566,41,12,17,44.18109568674618,0.5348069105691057,52.554563492063494,989.7817460317464,24.14101819589625,0
5,4,25,21,23,0.5681818181818182,0.4772727272727273,0.5227272727272727,44,550,400,150,0.7272727272727273,7,4,3,315.6065082531586,0.9935253699788584,-0.1688366072788181,0.15318462229848426,123753.12499999999,-988.5416666666674,122764.58333333331,4,0,1.2272727272727273,44,0,18,43.399288107202686,0.5440340909090909,51.25,994.9999999999999,22.61363636363636,0
6,4,19,20,22,0.4523809523809524,0.47619047619047616,0.5238095238095238,42,900,800,100,0.8888888888888888,10,8,2,308.7735574813676,0.989159891598916,0.05242158927186047,0.15367147320211721,124806.27666606603,-692.6243915629807,124113.65227450305,5,0,1.7380952380952381,42,0,14,42.48044349625032,0.5575396825396824,50.193798449612416,999.2248062015527,23.791066814322683,7
7,4,12,9,25,0.35294117647058826,0.2647058823529412,0.7352941176470589,34,950,700,250,0.7368421052631579,12,7,5,360.45556939598725,0.9870766488413548,-0.02063244768200745,0.17793513443328426,124464.85969387765,2172.8103741496716,126637.67006802732,6,0,2.3823529411764706,34,0,18,41.54363517060367,0.5680147058823529,50.53571428571429,997.8571428571436,29.34873949579834,0
8,4,6,7,24,0.1935483870967742,0.22580645161290322,0.7741935483870968,31,500,400,100,0.8,6,4,2,379.53853802990784,0.9834229390681004,0.0171607679247745,0.18526881204226753,123993.96787200858,3239.5354998572725,127233.50337186585,7,0,3.225806451612903,30,1,19,41.557860998650476,0.5729166666666665,51.008064516129046,995.967741935486,33.19892473118286,5
9,4,8,9,23,0.25,0.28125,0.71875,32,850,600,250,0.7058823529411765,11,6,5,379.3883550793184,0.9816868279569894,-0.015178571428571264,0.18749269772295152,124512.1955871584,3047.6954142252916,127559.8910013837,8,0,3.65625,31,1,18,41.02209719504241,0.5756048387096773,50.488281250000014,998.0468750000016,32.19506048387102,0
10,4,15,16,22,0.39473684210526316,0.42105263157894735,0.5789473684210527,38,800,500,300,0.625,11,5,6,327.5572062713703,0.9702761972498815,-0.045328330636925984,0.16977456555556786,126484.64551592804,695.5543867952548,127180.1999027233,9,0,3.263157894736842,37,1,15,40.28231959886635,0.5827702702702702,48.51973684210527,1005.9210526315794,27.187055476529174,0
11,4,13,12,23,0.37142857142857144,0.34285714285714286,0.6571428571428571,35,1050,800,250,0.7619047619047619,13,8,5,340.98079200126944,0.9698879551820727,-0.05837039468285887,0.17848693892790443,126887.86175679442,1653.2647194358688,128541.12647623029,10,0,3.657142857142857,35,0,17,39.530561937583755,0.5907738095238095,48.11921296296296,1007.5231481481482,28.78637566137566,0
12,4,5,4,24,0.17857142857142858,0.14285714285714285,0.8571428571428572,28,700,500,200,0.7142857142857143,9,5,4,391.985689755035,0.9630731922398589,-0.020447578172900105,0.20117327249542566,126079.90859096321,4284.303986656105,130364.21257761931,11,0,5.071428571428571,28,0,22,39.08053171196947,0.6004464285714285,48.92241379310345,1004.3103448275868,35.868226600985246,0
13,4,5,3,26,0.1724137931034483,0.10344827586206896,0.896551724137931,29,1100,700,400,0.6363636363636364,15,7,8,371.69655226246164,0.9576149425287356,0.00856005592569864,0.1940368394856091,126777.10503472229,3624.522569444456,130401.62760416674,12,0,5.724137931034483,29,0,20,38.870931595641984,0.6045258620689654,48.22916666666667,1007.0833333333339,34.72701149425289,0
14,4,4,2,28,0.13333333333333333,0.06666666666666667,0.9333333333333333,30,900,600,300,0.6666666666666666,12,6,6,369.31815570895446,0.9528735632183908,0.07610564566161471,0.19758258657487582,127770.56054168109,3437.597554630588,131208.15809631167,13,0,6.4,30,0,19,37.90990871222191,0.6118055555555555,47.244623655913976,1011.0215053763438,33.70071684587813,0
15,4,0,3,25,0.0,0.10714285714285714,0.8928571428571429,28,500,200,300,0.4,8,2,6,390.17480772090096,0.9521604938271604,0.07574802829498317,0.20711091757269579,127454.46062888093,4345.9039338089515,131800.36456268988,14,1,7.392857142857143,28,0,19,37.70779975336747,0.6145833333333334,47.55747126436781,1009.7701149425285,36.063218390804586,0
16,4,5,5,25,0.16666666666666666,0.16666666666666666,0.8333333333333334,30,950,500,450,0.5263157894736842,14,5,9,372.80413424739476,0.9539750957854406,0.00013728355697284478,0.2002924138815232,127940.47948100934,3539.34793762285,131479.8274186322,15,0,6.966666666666667,30,0,19,37.64752446747268,0.6135416666666667,47.07661290322581,1011.6935483870966,33.72311827956989,0
17,4,1,0,26,0.038461538461538464,0.0,1.0,26,1000,900,100,0.9,11,9,2,416.0642252246768,0.951474358974359,0.058301267342111496,0.21951669413185734,127208.74592764059,5385.401663237309,132594.1475908779,16,0,9.0,26,0,23,37.30782469022487,0.6189903846153846,47.800925925925924,1008.7962962962962,38.79985754985755,0
18,4,4,8,22,0.13333333333333333,0.26666666666666666,0.7333333333333334,30,700,500,200,0.7142857142857143,9,5,4,369.6929668580331,0.9508141762452108,0.00534979423868287,0.19963420210333788,128144.53125000001,3474.8263888888887,131619.3576388889,17,0,8.666666666666666,30,0,20,37.51714677640604,0.615625,46.875,1012.5000000000001,33.75000000000001,0
19,4,2,1,23,0.08333333333333333,0.041666666666666664,0.9583333333333334,24,1050,800,250,0.7619047619047619,13,8,5,445.10904270129794,0.9375754830917874,0.011878201950090705,0.2344086002946527,127134.03125000026,6517.7013888889305,133651.7326388892,18,0,10.125,24,0,22,36.65268826089351,0.6263020833333333,47.87500000000002,1008.5000000000022,42.02083333333342,0
20,4,5,5,23,0.17857142857142858,0.17857142857142858,0.8214285714285714,28,800,700,100,0.875,9,7,2,394.91606422322786,0.941137566137566,-0.04587490873691913,0.21267498137526103,128035.44887039233,4512.651109789923,132548.09998018225,19,0,9.5,28,0,22,36.99070130607609,0.6205357142857143,46.98275862068965,1012.0689655172408,36.14532019704431,0
21,4,2,2,23,0.08,0.08,0.92,25,750,600,150,0.8,9,6,3,429.92879158252754,0.9318055555555556,-0.01022680412371102,0.2291378724368418,127617.73003472238,5973.307291666699,133591.03732638908,20,0,11.24,25,0,22,36.535652920962214,0.6270833333333332,47.39583333333335,1010.416666666668,40.41666666666672,0
22,4,2,2,23,0.08,0.08,0.92,25,1050,800,250,0.7619047619047619,13,8,5,429.51042397522946,0.9348611111111111,-0.0065937549532417705,0.22983725740964583,127779.70714681962,5976.543238412238,133756.25038523186,21,0,12.16,25,0,22,36.37908147091456,0.6287499999999999,47.23557692307693,1011.0576923076931,40.44230769230772,0
23,4,5,4,24,0.17857142857142858,0.14285714285714285,0.8571428571428572,28,1000,900,100,0.9,11,9,2,387.9354568964841,0.9311618165784832,-0.02124466988662732,0.21374245867507774,128945.88793516322,4404.536390210082,133350.42432537331,22,0,11.678571428571429,28,0,23,36.234498043098995,0.6298363095238095,46.084770114942536,1015.6609195402303,36.27360426929394,0
24,4,2,1,25,0.07692307692307693,0.038461538461538464,0.9615384615384616,26,700,400,300,0.5714285714285714,10,4,6,407.5060987051979,0.9224358974358975,-0.008219178082191858,0.22199959108566758,128496.33487654325,5272.608024691362,133768.9429012346,23,0,12.692307692307692,26,0,21,36.19863013698631,0.6322115384615385,46.52777777777778,1013.8888888888891,38.99572649572651,2
25,4,2,1,26,0.07407407407407407,0.037037037037037035,0.962962962962963,27,800,500,300,0.625,11,5,6,415.0642222254488,0.9286562203228871,0.006772989406208962,0.21072250679222665,125633.24043810226,5029.172645620737,130662.413083723,24,0,13.148148148148149,27,0,20,38.96470362673791,0.5991512345679013,49.36755952380952,1002.5297619047614,37.13073192239857,8
26,4,3,3,26,0.10344827586206896,0.10344827586206896,0.896551724137931,29,950,700,250,0.7368421052631579,12,7,5,391.46359577210717,0.939039408866995,-0.00943688487477079,0.2015828551894089,126218.23157793209,4081.9685570987635,130300.20013503086,25,0,13.10344827586207,29,0,21,38.95055862704446,0.5987787356321839,48.78472222222222,1004.8611111111111,34.650383141762454,0
27,4,6,5,27,0.1875,0.15625,0.84375,32,800,500,300,0.625,11,5,6,363.64912209506826,0.9401041666666667,0.012129316816816837,0.1922145359645359,127283.05785123953,2857.2744490357954,130140.33230027533,26,0,12.59375,32,0,20,38.55339714714713,0.6015625,47.72727272727272,1009.090909090908,31.534090909090875,0
28,4,2,2,27,0.06896551724137931,0.06896551724137931,0.9310344827586207,29,850,600,250,0.7058823529411765,11,6,5,390.33419286872214,0.930316091954023,0.026806720692031716,0.20446747792509587,126917.0163001542,4108.010223765419,131025.02652391962,27,0,14.310344827586206,29,0,20,38.25737996783829,0.605962643678161,48.09027777777777,1007.6388888888879,34.74616858237545,0
29,4,3,1,29,0.1,0.03333333333333333,0.9666666666666667,30,700,500,200,0.7142857142857143,9,5,4,387.23602988229976,0.932088122605364,0.053805073431241635,0.20169665256039115,126685.75304948549,3811.4576107064404,130497.21066019192,28,0,14.733333333333333,30,0,21,38.57393190921229,0.6006944444444444,48.31989247311828,1006.7204301075268,33.55734767025089,3
30,4,3,3,29,0.09375,0.09375,0.90625,32,1050,700,350,0.6666666666666666,14,7,7,366.18134299507636,0.9341397849462366,0.0478908668730651,0.19389602260231095,127354.73632812501,2927.636041287288,130282.3723694123,29,0,14.71875,31,1,17,38.41589267285861,0.6048387096774194,47.65625,1009.3750000000001,32.560483870967744,0
31,4,1,1,29,0.03333333333333333,0.03333333333333333,0.9666666666666667,30,1000,600,400,0.6,14,6,8,387.3394729887408,0.926867816091954,0.061475974115379195,0.20430258477249272,127197.0703125001,3853.6892361111245,131050.75954861123,30,0,16.5,29,1,22,38.044282665565206,0.6088362068965516,47.81250000000001,1008.7500000000008,34.78448275862072,0
32,4,2,2,29,0.06451612903225806,0.06451612903225806,0.935483870967742,31,1050,700,350,0.6666666666666666,14,7,7,376.53679744139197,0.9292114695340502,0.04734270923135675,0.20127457381355424,127736.59030306975,3419.5053257602094,131156.09562882996,31,0,16.903225806451612,30,1,19,37.762321056597095,0.6114583333333332,47.278225806451616,1010.8870967741938,33.69623655913979,0
33,4,1,1,29,0.03333333333333333,0.03333333333333333,0.9666666666666667,30,900,600,300,0.6666666666666666,12,6,6,387.1292653304509,0.9260536398467433,0.05399835119538321,0.20686687173825397,127723.0034722221,3889.062499999982,131612.06597222207,32,0,18.433333333333334,29,1,21,37.508587524045055,0.6142241379310346,47.29166666666666,1010.8333333333323,34.85632183908042,0
34,4,0,0,29,0.0,0.0,1.0,29,900,700,200,0.7777777777777778,11,7,4,399.32093506998064,0.9215927750410509,0.05890027958993471,0.21234691176565518,127527.01190712104,4384.8411282864145,131911.85303540746,33,1,19.93103448275862,28,1,21,37.40220483641536,0.6153273809523812,47.48563218390804,1010.0574712643668,36.073481116584524,0
35,4,3,2,30,0.09375,0.0625,0.9375,32,650,500,150,0.7692307692307693,8,5,3,365.44477820732624,0.9280493951612904,0.03819812947731527,0.19818149195157006,128314.69859232275,2979.878800218353,131294.5773925411,34,0,18.96875,30,2,22,37.45052843371362,0.6173611111111111,46.706989247311824,1013.1720430107521,33.77240143369173,0
36,4,2,1,31,0.0625,0.03125,0.96875,32,450,100,350,0.2222222222222222,8,1,7,362.9599474063503,0.9236811155913979,0.047601888667991865,0.1980139409386055,128553.12256113421,2931.926920742278,131485.0494818765,35,0,19.90625,30,2,20,37.26971504307488,0.6197916666666666,46.471774193548384,1014.1129032258062,33.80376344086021,0
37,4,1,1,31,0.03125,0.03125,0.96875,32,950,500,450,0.5263157894736842,14,5,9,361.87372727632726,0.9226310483870969,0.041542461579226364,0.19792919517983457,128655.3720083246,2911.3998005549715,131566.77180887957,36,0,20.875,30,2,20,37.192799417064144,0.6208333333333333,46.37096774193548,1014.5161290322576,33.81720430107525,0
38,4,2,2,31,0.06060606060606061,0.06060606060606061,0.9393939393939394,33,850,700,150,0.8235294117647058,10,7,3,355.7651407510258,0.9194286616161617,0.07368282259503167,0.19828450854696952,129400.03289116744,2607.204182942699,132007.23707411013,37,0,21.181818181818183,31,2,22,36.58870830133948,0.6256720430107527,45.63802083333333,1017.4479166666658,32.82090053763438,0
39,4,2,2,31,0.06060606060606061,0.06060606060606061,0.9393939393939394,33,900,600,300,0.6666666666666666,12,6,6,348.1096914568335,0.9236900252525253,0.06544704006004265,0.19670999009894546,129940.55333958274,2446.7131861544735,132387.2665257372,38,0,20.606060606060606,32,1,22,36.23426212590298,0.6285807291666667,45.10732323232323,1019.5707070707074,31.861584595959606,0
40,4,1,2,30,0.03125,0.0625,0.9375,32,850,500,350,0.5882352941176471,12,5,7,347.45585930359493,0.9204049059139786,0.03661620066806859,0.19764149970098233,130198.14822785942,2647.621894449546,132845.77012230895,39,0,20.9375,32,0,22,35.98962843828611,0.6311848958333334,44.85479797979798,1020.5808080808082,31.893150252525256,0
41,4,0,1,29,0.0,0.03333333333333333,0.9666666666666667,30,800,500,300,0.625,11,5,6,361.3510803757784,0.9163793103448277,0.0424881391671057,0.20462179088741833,130022.58209041506,3396.7601023239627,133419.34219273902,40,2,22.466666666666665,30,0,22,35.813400544719734,0.6347222222222222,45.026881720430104,1019.8924731182794,33.99641577060932,0
42,4,1,0,30,0.03333333333333333,0.0,1.0,30,550,200,350,0.36363636363636365,9,2,7,361.11972721795996,0.9139367816091954,0.05430001317002531,0.20539191676149576,130193.9914477106,3403.123735402925,133597.11518311352,41,0,23.266666666666666,30,0,23,35.645221475920806,0.6364583333333333,44.85887096774193,1020.5645161290313,34.018817204301044,0
43,4,0,0,30,0.0,0.0,1.0,30,1050,600,450,0.5714285714285714,15,6,9,363.2749672074661,0.9114942528735632,0.05684829341054631,0.20753106773250574,130365.51371545841,3471.705543993519,133837.21925945193,42,1,24.266666666666666,30,0,24,35.416118276739496,0.6381944444444445,44.69086021505376,1021.2365591397847,34.04121863799283,0
44,4,0,0,30,0.0,0.0,1.0,30,1000,600,400,0.6,14,6,8,362.10362989477085,0.9102011494252874,0.051795816339955,0.2074114311100341,130468.48127312404,3448.622131171227,133917.10340429525,43,2,25.266666666666666,30,0,25,35.34156689909222,0.6392361111111111,44.59005376344086,1021.6397849462364,34.05465949820788,0
45,4,0,1,29,0.0,0.03333333333333333,0.9666666666666667,30,950,800,150,0.8421052631578947,11,8,3,361.8316282495906,0.9094827586206897,0.04267052428546325,0.2078072281880579,130571.48947855242,3448.978928199783,134020.46840675222,44,3,26.266666666666666,30,0,19,35.244060143783976,0.6402777777777778,44.48924731182795,1022.0430107526881,34.06810035842294,0
46,4,1,1,29,0.03333333333333333,0.03333333333333333,0.9666666666666667,30,1000,800,200,0.8,12,8,4,363.4176792153039,0.9089080459770115,0.023633017875920093,0.20946073511136587,130708.89698230995,3500.384798820653,134209.2817811306,45,0,25.966666666666665,30,0,19,35.0642415878023,0.6416666666666667,44.35483870967741,1022.5806451612891,34.0860215053763,0
47,4,1,1,29,0.03333333333333333,0.03333333333333333,0.9666666666666667,30,550,200,350,0.36363636363636365,9,2,7,363.24465963133355,0.9067528735632184,0.019143345158323388,0.20992066093045395,130812.00003251816,3503.3520855012066,134315.35211801936,46,0,26.933333333333334,30,0,20,34.96419655761398,0.6427083333333334,44.25403225806451,1022.9838709677415,34.099462365591386,0
48,4,0,0,29,0.0,0.0,1.0,29,750,600,150,0.8,9,6,3,372.1676314369512,0.9050697865353038,0.031190434933287436,0.2145865520963409,130723.78713348773,3930.2324459876713,134654.0195794754,47,6,28.862068965517242,29,0,20,34.82545045045047,0.6447557471264367,44.340277777777786,1022.6388888888895,35.263409961685845,0
49,4,0,2,27,0.0,0.06896551724137931,0.9310344827586207,29,700,500,200,0.7142857142857143,9,5,4,373.5103303984074,0.90311986863711,0.0311734997168176,0.21615480000354034,130865.85889274691,3975.9500385802558,134841.80893132716,48,7,29.862068965517242,29,0,21,34.64704651373241,0.646192528735632,44.20138888888889,1023.1944444444445,35.28256704980843,0
50,4,0,1,26,0.0,0.037037037037037035,0.962962962962963,27,750,600,150,0.8,9,6,3,397.01311595409766,0.8998100664767332,0.0356349360426238,0.22798378598434313,130566.58340419503,4967.329223356012,135533.91262755104,49,8,30.74074074074074,27,0,21,34.3501261890895,0.6496913580246912,44.49404761904762,1022.0238095238096,37.852733686067026,0
51,4,2,3,25,0.07142857142857142,0.10714285714285714,0.8928571428571429,28,500,300,200,0.6,7,3,4,379.50148353339495,0.8988646384479717,-0.00392481203007522,0.22037066586596898,130996.97625594532,4342.7093655040335,135339.68562144935,50,0,29.0,28,0,22,34.36081871345031,0.6506696428571428,44.07327586206897,1023.7068965517243,36.56096059113301,0
52,4,1,2,24,0.038461538461538464,0.07692307692307693,0.9230769230769231,26,1000,900,100,0.9,11,9,2,404.88532573869736,0.8999358974358974,-0.004545718432510171,0.23304650590954556,130656.72451322204,5380.19809289743,136036.92260611948,51,0,30.5,26,0,22,34.05723270440253,0.6542467948717948,44.40586419753087,1022.3765432098763,39.3221747388414,0
53,4,0,0,24,0.0,0.0,1.0,24,800,700,100,0.875,9,7,2,432.7746438364126,0.886850845410628,0.025348413087266763,0.24604263177440608,130177.53124999999,6467.5069444444425,136645.03819444444,52,2,33.5,24,0,23,33.833836899123526,0.6575520833333333,44.875,1020.4999999999999,42.52083333333333,0
54,4,2,0,26,0.07692307692307693,0.0,1.0,26,850,700,150,0.8235294117647058,10,7,3,402.4902654236289,0.8910256410256411,0.008455507098450221,0.2333317692560757,130932.97515622621,5339.849584666976,136272.82474089318,53,0,31.846153846153847,26,0,24,33.83751759147567,0.657051282051282,44.135802469135804,1023.4567901234569,39.36372269705603,0
55,4,1,1,26,0.037037037037037035,0.037037037037037035,0.962962962962963,27,1000,800,200,0.8,12,8,4,393.4001373542061,0.8896011396011396,-0.004214985779799285,0.23064966350920216,131366.2602085105,4935.900961947283,136302.16117045778,54,0,31.62962962962963,27,0,24,33.630455557168425,0.6577932098765431,43.71279761904762,1025.1488095238096,37.96847442680777,0
56,4,0,0,26,0.0,0.0,1.0,26,900,700,200,0.7777777777777778,11,7,4,405.1436166352155,0.8861538461538462,0.010947636700648689,0.2368092970473444,131249.04740131085,5434.942748818788,136683.99015012963,55,2,33.84615384615385,26,0,25,33.44848142570281,0.6602564102564102,43.827160493827165,1024.691358024692,39.41120607787276,0
57,4,1,1,26,0.037037037037037035,0.037037037037037035,0.962962962962963,27,550,100,450,0.18181818181818182,10,1,9,391.81491639867295,0.8877018043684711,-0.0009025561680040539,0.2308694045856797,131557.01929209183,4909.200503117915,136466.21979520976,56,0,33.55555555555556,27,0,22,33.47778261290012,0.6597222222222222,43.526785714285715,1025.892857142857,37.99603174603175,0
58,4,0,0,26,0.0,0.0,1.0,26,750,500,250,0.6666666666666666,10,5,5,403.86069628922854,0.8844230769230769,0.00578399471971669,0.23679140383489378,131367.67272995738,5410.847955723224,136778.52068568062,57,4,35.84615384615385,26,0,25,33.360931306136806,0.6614583333333333,43.711419753086425,1025.1543209876547,39.42901234567903,0
59,4,0,0,26,0.0,0.0,1.0,26,600,400,200,0.6666666666666666,8,4,4,405.76675445913634,0.8824358974358975,0.005000115743419853,0.23864830532171866,131486.3516422802,5470.55803231216,136956.90967459237,58,5,36.84615384615385,26,0,25,33.191644096699775,0.6626602564102564,43.595679012345684,1025.6172839506178,39.4468186134853,0
60,4,0,0,26,0.0,0.0,1.0,26,550,200,350,0.36363636363636365,9,2,7,405.76675445913634,0.8824358974358975,0.005000115743419853,0.23864830532171866,131486.3516422802,5470.55803231216,136956.90967459237,59,6,37.84615384615385,26,0,25,33.191644096699775,0.6626602564102564,43.595679012345684,1025.6172839506178,39.4468186134853,0
61,4,1,0,27,0.037037037037037035,0.0,1.0,27,850,600,250,0.7058823529411765,11,6,5,394.1180584984922,0.8850902184235518,0.001803020058598337,0.2340966299274176,131862.52170138885,4993.8802083333285,136856.4019097222,60,0,37.407407407407405,27,0,23,33.10936443542934,0.6628086419753085,43.229166666666664,1027.083333333333,38.04012345679011,0
62,4,0,0,27,0.0,0.0,1.0,27,750,600,150,0.8,9,6,3,393.6656869445425,0.8837844254510921,-0.0033045792026094034,0.23429895712630353,131938.95266439902,4987.967687074817,136926.92035147385,61,1,38.407407407407405,27,0,24,33.04364619544225,0.6635802469135803,43.1547619047619,1027.3809523809518,38.0511463844797,0
63,4,0,0,27,0.0,0.0,1.0,27,950,800,150,0.8421052631578947,11,8,3,394.4592775996774,0.8821225071225072,-0.01020676197981163,0.2359583678732615,132130.126953125,5023.990885416669,137154.11783854166,62,2,39.407407407407405,27,0,24,32.8299138804458,0.6655092592592593,42.96875,1028.125,38.0787037037037,0
64,4,1,2,26,0.03571428571428571,0.07142857142857142,0.9285714285714286,28,750,400,350,0.5333333333333333,11,4,7,409.1868135336451,0.8848104056437389,-0.04771268057784894,0.23647809353567784,130813.18536134221,5105.40609723873,135918.59145858095,63,0,38.964285714285715,28,0,20,33.78803838951312,0.648809523809524,44.25287356321839,1022.9885057471256,36.53530377668306,5
65,4,0,1,25,0.0,0.038461538461538464,0.9615384615384616,26,600,300,300,0.5,9,3,6,424.15231043075823,0.8786538461538461,-0.006113207547169708,0.24413632116453296,130656.7245132221,5883.670315119653,136540.39482834176,64,1,42.46153846153846,26,0,20,33.56477987421385,0.6542467948717949,44.40586419753087,1022.3765432098768,39.32217473884141,0
66,4,0,0,25,0.0,0.0,1.0,25,850,600,250,0.7058823529411765,11,6,5,435.2079873428917,0.8736111111111111,0.020865203761755602,0.25059810101513097,130671.89554569371,6373.890532544398,137045.7860782381,65,2,44.72,25,0,20,33.26671891327065,0.6583333333333332,44.39102564102565,1022.4358974358981,40.897435897435926,0
67,4,0,0,25,0.0,0.0,1.0,25,600,500,100,0.8333333333333334,7,5,2,433.9617391300932,0.8730555555555556,0.01955806299953,0.25014542523840333,130712.86173261834,6344.876160831696,137057.73789345004,66,3,45.72,25,0,20,33.25677140469102,0.65875,44.35096153846154,1022.5961538461539,40.90384615384616,0
68,4,0,0,25,0.0,0.0,1.0,25,750,500,250,0.6666666666666666,10,5,5,432.80192963612035,0.87125,0.02378446115288213,0.2502724201808871,130835.7988165681,6325.197238658783,137160.9960552269,67,4,46.72,25,0,21,33.1610275689223,0.6599999999999999,44.23076923076923,1023.0769230769234,40.923076923076934,0
69,4,0,0,25,0.0,0.0,1.0,25,850,800,50,0.9411764705882353,9,8,1,433.51074603474615,0.87,0.025079862198559066,0.2512159368582477,130917.78897518087,6350.853673570027,137268.6426487509,68,5,47.72,25,0,21,33.05929637749242,0.6608333333333333,44.15064102564103,1023.3974358974364,40.93589743589745,0
70,4,2,1,26,0.07407407407407407,0.037037037037037035,0.962962962962963,27,600,200,400,0.3333333333333333,10,2,8,410.5090090742535,0.8766619183285851,-0.003912211689344636,0.24140171420987683,131480.6990504536,5394.802295918378,136875.50134637198,69,0,45.111111111111114,27,0,22,33.07578835364673,0.6589506172839507,43.60119047619048,1025.5952380952388,37.98500881834217,0
71,4,0,0,26,0.0,0.0,1.0,26,900,600,300,0.6666666666666666,12,6,6,422.3449131018975,0.8692307692307693,0.011878849627193988,0.2478851239089229,131407.22641365646,5899.834724127427,137307.0611377839,70,1,47.84615384615385,26,0,23,32.84699227373069,0.6618589743589742,43.67283950617284,1025.3086419753088,39.434947768281106,0
72,4,1,1,26,0.037037037037037035,0.037037037037037035,0.962962962962963,27,450,300,150,0.6666666666666666,6,3,3,410.9531282477854,0.8685897435897436,0.006311484647957943,0.24385103508494987,131824.3145239867,5434.722886550461,137259.03741053716,71,0,47.03703703703704,27,0,19,32.71582017098974,0.6624228395061729,43.26636904761905,1026.9345238095239,38.03461199294533,0
73,4,1,1,26,0.037037037037037035,0.037037037037037035,0.962962962962963,27,700,600,100,0.8571428571428571,8,6,2,412.5993639188944,0.8709639126305794,0.0018032813279884596,0.24482787707689516,131824.3145239867,5478.125664328239,137302.4401883149,72,0,47.925925925925924,27,0,19,32.67355576486502,0.6624228395061729,43.26636904761905,1026.9345238095239,38.03461199294533,0
74,4,0,0,26,0.0,0.0,1.0,26,1000,800,200,0.8,12,8,4,427.01926800596914,0.8642307692307692,0.009991211434386527,0.25271638530032986,131723.87021795462,6049.726127876861,137773.5963458315,73,2,50.76923076923077,26,0,19,32.40535427941472,0.6650641025641024,43.3641975308642,1026.5432098765436,39.482431149097835,0
75,4,0,0,26,0.0,0.0,1.0,26,600,500,100,0.8333333333333334,7,5,2,427.3990735689064,0.8630769230769231,0.009988208365124596,0.2534682206352498,131803.09070644717,6066.503772290811,137869.59447873797,74,3,51.76923076923077,26,0,19,32.3151487826871,0.6658653846153846,43.28703703703704,1026.8518518518517,39.49430199430199,0
76,4,0,2,24,0.0,0.07692307692307693,0.9230769230769231,26,450,200,250,0.4444444444444444,7,2,5,431.4920447176574,0.8616025641025641,0.007955766630845629,0.25669727807734105,131921.96609224973,6184.655778463667,138106.6218707134,75,4,52.76923076923077,26,0,19,32.08934204596665,0.6670673076923076,43.171296296296305,1027.3148148148155,39.512108262108285,0
77,4,0,0,24,0.0,0.0,1.0,24,700,400,300,0.5714285714285714,10,4,6,458.83193599172046,0.8615640096618357,0.00846608149111372,0.2693448540287279,131413.5555555557,7259.347222222245,138672.90277777796,76,5,54.291666666666664,24,0,21,31.905274707412218,0.6701388888888888,43.66666666666668,1025.3333333333346,42.72222222222228,0
78,4,0,0,24,0.0,0.0,1.0,24,1000,700,300,0.7,13,7,6,458.8663811418715,0.8607336956521738,0.011681293677880733,0.2696661741323722,131456.2812500001,7264.173611111126,138720.4548611112,77,6,55.291666666666664,24,0,21,31.860813153475277,0.6705729166666665,43.62500000000001,1025.5000000000007,42.72916666666669,0
79,4,1,0,25,0.04,0.0,1.0,25,750,600,150,0.8,9,6,3,444.092571815197,0.8626388888888888,0.008112324492979717,0.26406617674725563,131903.67408366222,6715.488371137435,138619.16245479966,78,0,54.04,25,0,20,31.78432137285492,0.6708333333333333,43.189102564102576,1027.243589743591,41.08974358974364,0
80,4,0,0,25,0.0,0.0,1.0,25,900,800,100,0.8888888888888888,10,8,2,445.0910624923871,0.8606944444444444,0.012975670617592083,0.2652345625186976,131985.99810979623,6749.157626561484,138735.1557363577,79,1,55.04,25,0,20,31.674984404242046,0.6716666666666666,43.108974358974365,1027.564102564103,41.102564102564116,0
81,4,1,1,25,0.038461538461538464,0.038461538461538464,0.9615384615384616,26,950,800,150,0.8421052631578947,11,8,3,431.57861605944754,0.8583974358974359,-0.0032709902966387983,0.25945307784205024,132318.60437147538,6221.176030711782,138539.78040218717,80,0,53.88461538461539,26,0,20,31.684665766711653,0.6710737179487178,42.785493827160494,1028.858024691358,39.57146248812915,0
82,4,0,0,25,0.0,0.0,1.0,25,450,300,150,0.6666666666666666,6,3,3,445.04980092561374,0.8591666666666666,0.011025880885562778,0.2657867246868613,132068.3478180475,6755.39838099937,138823.74619904687,81,3,57.04,25,0,20,31.592350067560552,0.6724999999999999,43.02884615384617,1027.8846153846168,41.11538461538467,0
83,4,0,0,25,0.0,0.0,1.0,25,600,400,200,0.6666666666666666,8,4,4,445.6129004172857,0.8577777777777778,0.012643391521196756,0.26670264636915186,132150.7232084157,6777.613412228828,138928.33662064452,82,4,58.04,25,0,20,31.49418121363258,0.6733333333333333,42.94871794871796,1028.2051282051298,41.12820512820519,0
84,4,0,0,25,0.0,0.0,1.0,25,650,400,250,0.6153846153846154,9,4,5,446.1227726902784,0.8559722222222222,0.015232159551262114,0.2675902761800196,132233.12428090084,6798.441609138742,139031.56589003958,83,5,59.04,25,0,20,31.397371974654618,0.6741666666666666,42.86858974358975,1028.5256410256418,41.14102564102567,0
85,4,0,0,25,0.0,0.0,1.0,25,950,600,350,0.631578947368421,13,6,7,445.59544259081326,0.8548611111111111,0.015227414330218014,0.2678579345911069,132315.55103550298,6791.841305062461,139107.39234056545,84,6,60.04,25,0,21,31.3272326064382,0.675,42.78846153846154,1028.846153846154,41.15384615384616,0
86,4,0,0,25,0.0,0.0,1.0,25,900,700,200,0.7777777777777778,11,7,4,444.36066809814963,0.8536111111111111,0.011983805668016378,0.2677002073664462,132398.00347222225,6766.493055555558,139164.4965277778,85,7,61.04,25,0,21,31.275303643724698,0.6758333333333333,42.708333333333336,1029.1666666666667,41.16666666666667,0
87,4,0,0,25,0.0,0.0,1.0,25,1100,800,300,0.7272727272727273,14,8,6,446.7617529610665,0.8505555555555555,0.012615863141524075,0.2715196664971321,132728.07004026964,6859.56504766602,139587.63508793566,86,8,62.04,25,0,20,30.8786936236392,0.6791666666666666,42.38782051282052,1030.4487179487185,41.21794871794874,0
88,4,0,0,25,0.0,0.0,1.0,25,400,300,100,0.75,5,3,2,446.5758118610924,0.8493055555555555,0.00873134328358205,0.2720052672244836,132810.65088757395,6862.004848783692,139672.65573635764,87,9,63.04,25,0,21,30.79977715588723,0.6799999999999999,42.30769230769231,1030.7692307692307,41.230769230769226,0
89,4,0,0,25,0.0,0.0,1.0,25,550,200,350,0.36363636363636365,9,2,7,439.9645159080398,0.8490277777777778,-0.0006482780115319997,0.26360899146422895,132191.9205343935,6631.950864973703,138823.8713993672,88,10,64.04,25,0,19,31.597546880681524,0.6737499999999998,42.90865384615385,1028.3653846153848,41.13461538461539,2
90,4,0,0,25,0.0,0.0,1.0,25,900,700,200,0.7777777777777778,11,7,4,440.3470463213672,0.8461111111111111,-0.0016199376947039212,0.2647029997549792,132315.55103550298,6652.952416173574,138968.50345167654,89,11,65.04,25,0,20,31.462227414330208,0.6749999999999999,42.78846153846154,1028.846153846154,41.15384615384616,0
91,4,0,1,24,0.0,0.04,0.96,25,850,600,250,0.7058823529411765,11,6,5,443.4026200006513,0.8427777777777777,0.0012951432129515439,0.2677084991432506,132480.48159105863,6748.438527284703,139228.92011834335,90,12,66.04,25,0,20,31.21627231216273,0.6766666666666665,42.62820512820514,1029.4871794871804,41.17948717948721,0
92,4,1,1,24,0.04,0.04,0.96,25,750,600,150,0.8,9,6,3,445.3631989767937,0.8431944444444445,-0.0022647379063620576,0.2703720496904447,132686.7892474114,6818.762584237368,139505.55183164877,91,0,66.52,25,0,19,30.956570487893398,0.67875,42.42788461538463,1030.2884615384628,41.21153846153851,0
93,4,0,0,24,0.0,0.0,1.0,24,750,600,150,0.8,9,6,3,460.5246679363621,0.8360507246376812,0.011802632998813012,0.2783876123787521,132526.68055555562,7406.3611111111295,139933.04166666674,92,21,70.29166666666667,24,0,20,30.728660839538154,0.681423611111111,42.58333333333334,1029.6666666666674,42.90277777777781,0
94,4,0,0,24,0.0,0.0,1.0,24,700,300,400,0.42857142857142855,11,3,8,462.792844064644,0.8335597826086956,0.0062355066601951226,0.28071860345079164,132655.420138889,7478.395833333354,140133.81597222234,93,22,71.29166666666667,24,0,19,30.53948929515181,0.6827256944444444,42.45833333333334,1030.1666666666677,42.92361111111115,0
95,4,1,1,24,0.04,0.04,0.96,25,400,200,200,0.5,6,2,4,447.9951025405572,0.8379166666666666,-0.012929292929293013,0.2737747848858959,132934.5703125,6910.807291666667,139845.37760416666,94,0,69.4,25,0,19,30.637626262626267,0.68125,42.1875,1031.25,41.25,0
96,4,0,0,24,0.0,0.0,1.0,24,550,200,350,0.36363636363636365,9,2,7,461.6288461481773,0.832427536231884,-0.00337983993078117,0.27466025170437897,131926.72222222228,7380.236111111122,139306.9583333334,95,24,73.29166666666667,24,0,20,31.31049913476097,0.6753472222222222,43.16666666666667,1027.333333333334,42.80555555555558,1
97,4,0,0,24,0.0,0.0,1.0,24,900,700,200,0.7777777777777778,11,7,4,495.66737066074967,0.832427536231884,0.01124468433104342,0.2790525142007204,129795.125,8067.041666666667,137862.16666666666,96,25,74.29166666666667,24,0,18,32.622873732417396,0.6536458333333333,45.25,1019.0,42.458333333333336,5
98,4,2,2,24,0.07692307692307693,0.07692307692307693,0.9230769230769231,26,550,200,350,0.36363636363636365,9,2,7,467.582436099026,0.8501282051282051,-0.018202106144082464,0.2672245735840547,130380.76560356651,6992.751200274345,137373.51680384084,97,0,69.5,26,0,20,32.73742067089755,0.6514423076923077,44.675925925925924,1021.2962962962962,39.280626780626775,0
99,4,1,1,24,0.04,0.04,0.96,25,600,500,100,0.8333333333333334,7,5,2,479.4185192194655,0.83625,-0.005551891976762535,0.27287011160936353,130221.69124445273,7486.138077334,137707.82932178673,98,0,73.24,25,0,20,32.59849139058983,0.65375,44.831730769230774,1020.6730769230775,40.8269230769231,0
100,4,0,0,24,0.0,0.0,1.0,24,900,600,300,0.6666666666666666,12,6,6,489.8915277726661,0.8287288647342995,0.015145945651581894,0.27790788151033247,130092.50347222216,7946.243055555547,138038.7465277777,99,28,77.29166666666667,24,0,20,32.4640581604313,0.6566840277777778,44.95833333333333,1020.1666666666661,42.50694444444442,0
101,4,1,1,24,0.04,0.04,0.96,25,650,400,250,0.6153846153846154,9,4,5,476.6983142313418,0.83875,-0.002284279887041274,0.27275359559340895,130426.2332552598,7434.793104865233,137861.02636012502,100,0,75.16,25,0,20,32.458032632569804,0.6558333333333333,44.63141025641026,1021.4743589743598,40.85897435897439,0
102,4,0,0,24,0.0,0.0,1.0,24,950,800,150,0.8421052631578947,11,8,3,490.2156008568401,0.8294082125603864,0.012587089048551992,0.27900374903785224,130220.05555555568,7967.180555555576,138187.23611111124,101,30,79.29166666666667,24,0,20,32.324665251469625,0.657986111111111,44.83333333333334,1020.6666666666677,42.52777777777782,0
103,4,0,0,24,0.0,0.0,1.0,24,500,400,100,0.8,6,4,2,483.73956849168775,0.8285778985507246,-0.018995400032856935,0.26455730039612796,128651.28125000001,7646.7430555555575,136298.02430555556,102,31,80.29166666666667,24,0,20,34.106155194129556,0.6419270833333334,46.375,1014.5000000000001,42.270833333333336,8
104,4,2,0,26,0.07692307692307693,0.0,1.0,26,800,600,200,0.75,10,6,4,450.9061982501001,0.8421794871794872,-0.022791125750823538,0.25212642352857695,129527.4490466797,6482.11953484548,136009.56858152518,103,0,75.03846153846153,25,1,21,34.03783585222503,0.6466666666666667,45.512820512820504,1017.948717948717,40.71794871794868,0
105,4,1,1,26,0.037037037037037035,0.037037037037037035,0.962962962962963,27,400,200,200,0.5,6,2,4,436.9435973611599,0.8518518518518519,-0.03197199925959593,0.24596236772171665,129790.40745027423,5942.21750685869,135732.6249571329,104,0,73.22222222222223,26,1,21,34.12369377555657,0.6454326923076924,45.25462962962962,1018.9814814814805,39.1915954415954,0
106,4,2,2,26,0.07142857142857142,0.07142857142857142,0.9285714285714286,28,400,200,200,0.5,6,2,4,426.346196534515,0.8563712522045855,-0.04642752928425542,0.24150221744194722,130034.82187145676,5487.970344387733,135522.7922158445,105,0,71.53571428571429,27,1,21,34.14368738449567,0.6442901234567902,45.01488095238094,1019.9404761904749,37.77557319223981,0
107,4,0,0,26,0.0,0.0,1.0,26,700,400,300,0.5714285714285714,10,4,6,470.0526039469888,0.8428846153846153,-0.025838685814262297,0.25137262109850805,127754.20393709032,6810.239245160786,134564.4431822511,106,3,78.03846153846153,26,0,18,35.38073067725029,0.624599358974359,47.2608024691358,1010.9567901234562,38.88295346628678,5
108,4,4,1,29,0.13333333333333333,0.03333333333333333,0.9666666666666667,30,1250,1000,250,0.8,15,10,5,422.71589856743475,0.8670498084291188,-0.029789297364013256,0.23401007503418297,129133.07354896508,4917.320644005071,134050.39419297015,107,0,68.5,30,0,20,35.1593493784713,0.6256944444444446,45.90053763440859,1016.3978494623645,33.87992831541215,0
109,4,0,0,29,0.0,0.0,1.0,29,550,200,350,0.36363636363636365,9,2,7,435.05279518767105,0.8588875205254516,-0.02659411440184467,0.23975441531329597,128954.40055941355,5420.394483024687,134374.79504243823,108,1,71.86206896551724,29,0,20,35.029371211085284,0.6267959770114944,46.076388888888886,1015.6944444444442,35.023946360153246,0
110,4,1,1,29,0.03333333333333333,0.03333333333333333,0.9666666666666667,30,1000,800,200,0.8,12,8,4,417.92651220869993,0.8598180076628352,-0.044096534108424734,0.23276569322352092,129372.25627601457,4813.61916840097,134185.87544441555,109,0,70.43333333333334,30,0,21,35.03600211388558,0.628125,45.66532258064516,1017.3387096774193,33.91129032258064,0
111,4,0,0,29,0.0,0.0,1.0,29,900,800,100,0.8888888888888888,10,8,2,429.98015134163666,0.8535509031198686,-0.030517382663489023,0.23887061214897296,129272.00038580252,5316.878858024699,134588.87924382722,110,3,73.86206896551724,29,0,21,34.83224073568242,0.6300287356321839,45.76388888888889,1016.9444444444448,35.06704980842913,0
112,4,0,1,28,0.0,0.034482758620689655,0.9655172413793104,29,900,800,100,0.8888888888888888,10,8,2,430.88213025195415,0.8528325123152709,-0.028810168294692406,0.2400160915662024,129377.9538001542,5349.329668209862,134727.28346836407,111,4,74.86206896551724,29,0,21,34.70065415244596,0.6311063218390804,45.659722222222214,1017.3611111111102,35.08141762452104,0
113,4,0,0,28,0.0,0.0,1.0,28,750,500,250,0.6666666666666666,10,5,5,439.7790842427951,0.8520171957671957,-0.049584400911896864,0.24500988949828728,129384.044395726,5780.079311996305,135164.1237077223,112,5,74.71428571428571,28,0,22,34.46811890975852,0.6343005952380952,45.65373563218391,1017.3850574712644,36.33518062397373,0
114,4,0,0,28,0.0,0.0,1.0,28,450,200,250,0.4444444444444444,7,2,5,440.1155863746554,0.8504739858906525,-0.04664589257981899,0.2456531677140807,129457.14272443518,5795.221256110443,135252.36398054563,113,6,75.71428571428571,28,0,17,34.38455927337756,0.6350446428571428,45.581896551724135,1017.6724137931033,36.34544334975369,0
115,4,1,1,28,0.034482758620689655,0.034482758620689655,0.9655172413793104,29,750,600,150,0.8,9,6,3,431.4310437431243,0.8558087027914614,-0.05160429189793847,0.2429324303870529,129802.20148533944,5400.1398533950505,135202.3413387345,114,0,74.06896551724138,29,0,18,34.25205011130799,0.6354166666666667,45.24305555555555,1019.0277777777771,35.138888888888864,0
116,4,0,0,28,0.0,0.0,1.0,28,900,400,500,0.4444444444444444,14,4,10,446.6021194355865,0.8461199294532628,-0.04177916582712082,0.2509040433279165,129713.14944180199,5986.033491874738,135699.18293367673,115,8,77.71428571428571,28,0,18,33.95686412787964,0.6376488095238095,45.330459770114935,1018.6781609195394,36.38136288998355,0
117,4,3,3,28,0.0967741935483871,0.0967741935483871,0.9032258064516129,31,800,600,200,0.75,10,6,4,414.94443939992493,0.8629928315412186,-0.04887372971266768,0.23815609868210974,130546.30594135792,4636.215130980149,135182.52107233807,116,0,71.09677419354838,29,2,17,33.91263477394218,0.6429597701149427,44.51388888888888,1021.9444444444435,35.239463601532535,0
118,4,0,0,28,0.0,0.0,1.0,28,600,400,200,0.6666666666666666,8,4,4,445.79958440983137,0.845623897707231,-0.027290203103927713,0.2520987769367787,129969.40904098951,5988.061707292897,135957.47074828242,117,1,79.39285714285714,28,0,19,33.71465642759851,0.6402529761904763,45.07902298850574,1019.6839080459766,36.417282430213454,0
119,4,0,0,28,0.0,0.0,1.0,28,800,500,300,0.625,11,5,6,451.32276860470273,0.8440806878306878,-0.028441668175508417,0.2561824923950433,130115.9566364446,6144.858757761912,136260.8153942065,118,2,80.39285714285714,28,0,19,33.42369619302446,0.6417410714285715,44.9353448275862,1020.2586206896542,36.43780788177337,0
120,4,1,0,29,0.034482758620689655,0.0,1.0,29,450,200,250,0.4444444444444444,7,2,5,432.23289829709404,0.847803776683087,-0.02783739959321796,0.24807875707254431,130546.30594135802,5485.281635802462,136031.58757716048,119,0,78.58620689655173,29,0,19,33.47093866086798,0.6429597701149425,44.513888888888886,1021.9444444444443,35.23946360153256,0
121,4,0,0,29,0.0,0.0,1.0,29,850,700,150,0.8235294117647058,10,7,3,432.4612955940205,0.8479064039408867,-0.024740992732333655,0.24843736723469118,130581.79253472212,5494.31423611109,136076.1067708332,120,1,79.58620689655173,29,0,19,33.42887960320696,0.6433189655172414,44.47916666666666,1022.0833333333325,35.24425287356319,0
122,4,0,0,29,0.0,0.0,1.0,29,900,700,200,0.7777777777777778,11,7,4,430.8901462472883,0.8466748768472906,-0.0210803442185985,0.24798923897781755,130652.78018904309,5459.399112654304,136112.17930169738,121,2,80.58620689655173,29,0,19,33.396589005117065,0.6440373563218391,44.409722222222214,1022.3611111111102,35.25383141762449,0
123,4,1,1,29,0.03333333333333333,0.03333333333333333,0.9666666666666667,30,900,700,200,0.7777777777777778,11,7,4,422.64850345150353,0.8482758620689655,-0.03447158742667056,0.24490454378080267,130915.14373048903,5066.217915365929,135981.36164585495,122,0,78.86666666666666,30,0,19,33.339900183871805,0.64375,44.15322580645161,1023.3870967741932,34.11290322580644,0
124,4,1,0,30,0.03333333333333333,0.0,1.0,30,800,600,200,0.75,10,6,4,435.1355768161311,0.8508620689655173,-0.0313827542551699,0.2488639433295155,130409.29954832215,5358.14637746881,135767.44592579096,123,0,79.83333333333333,28,2,19,33.53671402447601,0.6447172619047619,44.64798850574713,1021.4080459770119,36.47885878489328,3
125,4,0,1,29,0.0,0.03333333333333333,0.9666666666666667,30,600,300,300,0.5,9,3,6,436.64061433649647,0.8511015325670498,-0.03524613220815753,0.2499609313955305,130445.99063614738,5391.60349782005,135837.59413396745,124,1,80.83333333333333,28,2,19,33.46079465541491,0.6450892857142857,44.61206896551724,1021.5517241379306,36.48399014778324,0
126,4,0,0,29,0.0,0.0,1.0,29,550,400,150,0.7272727272727273,7,4,3,443.95432269906246,0.8481116584564861,-0.03749240052857161,0.25369346516933106,130376.54400953093,5776.246058319166,136152.7900678501,125,2,81.24137931034483,27,2,21,33.3450203992423,0.6477623456790124,44.680059523809526,1021.2797619047622,37.825176366843046,0
127,4,0,0,29,0.0,0.0,1.0,29,850,300,550,0.35294117647058826,14,3,11,441.2248069851354,0.8467775041050903,-0.0407687827606289,0.25337223866002573,130566.58340419491,5721.843112244886,136288.4265164398,126,3,82.24137931034483,27,2,17,33.22049116676374,0.6496913580246915,44.49404761904761,1022.0238095238087,37.85273368606699,0
128,4,2,3,28,0.06451612903225806,0.0967741935483871,0.9032258064516129,31,950,600,350,0.631578947368421,13,6,7,415.6335798617754,0.8509856630824373,-0.051707393894852904,0.24209178656403893,131114.67013888893,4699.131944444451,135813.80208333337,127,0,77.87096774193549,29,2,17,33.31638188228912,0.6487068965517242,43.958333333333336,1024.166666666667,35.316091954023,0
129,4,0,0,28,0.0,0.0,1.0,28,800,600,200,0.75,10,6,4,452.93516651611156,0.8414351851851851,-0.03558476881233008,0.25885362107112486,130380.7656035665,6210.806755829902,136591.5723593964,128,9,87.07142857142857,26,2,20,33.11140072529465,0.6514423076923077,44.675925925925924,1021.2962962962961,39.280626780626775,0
130,4,0,1,27,0.0,0.03571428571428571,0.9642857142857143,28,1000,800,200,0.8,12,8,4,450.51386898622695,0.8412698412698412,-0.03860595597755723,0.2579932363917666,130459.58123761613,6154.770137936277,136614.35137555242,129,10,88.07142857142857,26,2,21,33.092585599194365,0.6522435897435898,44.59876543209876,1021.6049382716043,39.29249762583093,0
131,4,0,0,27,0.0,0.0,1.0,27,1250,1100,150,0.88,14,11,3,455.59983648598165,0.836894586894587,-0.04179598593006395,0.2617031844793282,130577.84934175422,6498.249361758864,137076.0987035131,130,11,87.88888888888889,26,1,17,32.84167547435703,0.6534455128205128,44.48302469135802,1022.0679012345672,39.3103038936372,0
132,4,1,0,28,0.03571428571428571,0.0,1.0,28,900,600,300,0.6666666666666666,12,6,6,442.59734991887507,0.8447420634920635,-0.051868770764119554,0.2571849465744814,131023.24263038544,5998.10799319727,137021.35062358272,131,0,85.71428571428571,27,1,19,32.71923449612403,0.654320987654321,44.047619047619044,1023.8095238095234,37.91887125220457,0
133,4,0,1,27,0.0,0.03571428571428571,0.9642857142857143,28,450,200,250,0.4444444444444444,7,2,5,444.45295351597724,0.8452380952380952,-0.051119023397761976,0.2585190847965712,131061.33355034709,6050.119357638868,137111.45290798595,132,1,86.71428571428571,27,1,19,32.632884028484234,0.6547067901234568,44.01041666666666,1023.9583333333322,37.924382716049344,0
134,4,0,0,27,0.0,0.0,1.0,27,700,400,300,0.5714285714285714,10,4,6,447.4080365396453,0.8428300094966762,-0.04196935712452421,0.2609749162170621,131169.9936175888,6337.301859472646,137507.29547706145,133,2,87.55555555555556,26,1,19,32.44639449633423,0.6594551282051282,43.90432098765432,1024.382716049383,39.39933523266858,0
135,4,0,0,27,0.0,0.0,1.0,27,900,600,300,0.6666666666666666,12,6,6,450.4601411413462,0.8430674264007598,-0.0433892709152458,0.2635687927153906,131288.5832237846,6428.054745846688,137716.6379696313,134,3,88.55555555555556,26,1,19,32.247277016513586,0.6606570512820513,43.78858024691359,1024.8456790123466,39.41714150047487,0
136,4,0,0,27,0.0,0.0,1.0,27,1000,800,200,0.8,12,8,4,451.7016647218585,0.842355175688509,-0.03996321377811207,0.26538970486973906,131446.7860510974,6474.946416323733,137921.73246742116,135,4,89.55555555555556,26,1,19,32.05417607223476,0.6622596153846154,43.63425925925926,1025.462962962963,39.44088319088319,0
137,4,2,4,25,0.06896551724137931,0.13793103448275862,0.8620689655172413,29,650,400,250,0.6153846153846154,9,4,5,429.94613605180353,0.8501642036124795,-0.05912845562954794,0.2559987359622354,131954.7687318338,5546.688589972258,137501.45732180608,136,0,84.3103448275862,28,1,16,32.09574418496247,0.6603422619047619,43.139367816091955,1027.4425287356323,36.694376026272586,0
138,4,1,1,25,0.038461538461538464,0.038461538461538464,0.9615384615384616,26,800,500,300,0.625,11,5,6,470.4871036240061,0.8428205128205128,-0.05604842102732399,0.2764597774187341,131451.3510077663,7169.233080621305,138620.5840883876,137,0,89.92307692307692,25,1,19,31.567920768870138,0.66625,43.62980769230769,1025.4807692307693,41.019230769230774,0
139,4,1,1,25,0.038461538461538464,0.038461538461538464,0.9615384615384616,26,800,700,100,0.875,9,7,2,472.75067386443766,0.8376282051282051,-0.05076154326622806,0.27928923574057724,131656.8560979618,7248.173487836941,138905.02958579874,138,0,90.88461538461539,25,1,17,31.300098896523004,0.6683333333333333,43.429487179487175,1026.2820512820508,41.05128205128203,0
140,4,1,1,25,0.038461538461538464,0.038461538461538464,0.9615384615384616,26,550,300,250,0.5454545454545454,8,3,5,471.2556299418403,0.836474358974359,-0.04290448858041751,0.2790077232354374,131739.10307774504,7216.558801775171,138955.6618795202,139,0,91.84615384615384,25,1,18,31.254553023207414,0.6691666666666667,43.349358974358985,1026.6025641025653,41.06410256410261,0
141,4,0,0,25,0.0,0.0,1.0,25,1100,800,300,0.7272727272727273,14,8,6,472.7234701139663,0.8323611111111111,-0.0408797379503979,0.28139555867229704,131944.8328864646,7474.683853139392,139419.516739604,140,1,92.44,25,0,19,31.007090677481408,0.6712500000000001,43.14903846153847,1027.4038461538469,41.096153846153875,0
142,4,0,1,24,0.0,0.04,0.96,25,750,600,150,0.8,9,6,3,472.05625447295665,0.8318055555555556,-0.04444167186525283,0.28130341112273205,131985.99810979608,7460.96318211701,139446.9612919131,141,2,93.44,25,0,19,30.98227282179247,0.6716666666666666,43.10897435897435,1027.5641025641019,41.102564102564074,0
143,4,0,0,24,0.0,0.0,1.0,24,400,300,100,0.75,5,3,2,482.6843058078116,0.8244263285024154,-0.034474367293965136,0.28718784372580597,131926.7222222222,7935.791666666663,139862.51388888885,142,3,96.75,24,0,19,30.76972474583603,0.6753472222222222,43.166666666666664,1027.3333333333333,42.80555555555555,0
144,4,2,1,25,0.07692307692307693,0.038461538461538464,0.9615384615384616,26,750,600,150,0.8,9,6,3,451.7191509366867,0.8360897435897436,-0.06053672088439066,0.2732839432638721,132556.8731186175,6775.695635192795,139332.5687538103,143,0,90.23076923076923,26,0,20,30.924684050152358,0.6734775641025641,42.554012345679006,1029.7839506172832,39.60707502374166,0
145,4,0,0,25,0.0,0.0,1.0,25,750,600,150,0.8,9,6,3,463.5120496154657,0.8315277777777778,-0.04340756891449926,0.27893260267862285,132356.774043598,7269.791923487842,139626.56596708586,144,1,94.84,25,0,20,30.82447567876239,0.6754166666666668,42.74839743589744,1029.0064102564106,41.16025641025642,0
146,4,1,1,25,0.038461538461538464,0.038461538461538464,0.9615384615384616,26,800,600,200,0.75,10,6,4,451.77838503626396,0.8391025641025641,-0.057554039728994644,0.2741884089547362,132676.08786770309,6788.037741960069,139464.12560966314,145,0,92.15384615384616,26,0,17,30.802189434791284,0.6746794871794872,42.43827160493827,1030.2469135802469,39.62488129154796,0
147,4,0,0,25,0.0,0.0,1.0,25,750,600,150,0.8,9,6,3,470.55084439973047,0.8305555555555556,-0.04207905384375965,0.2847231380520403,132562.98539201188,7475.524942472069,140038.51033448396,146,3,96.84,25,0,20,30.43365494345887,0.6775,42.54807692307693,1029.8076923076926,41.19230769230771,0
148,4,0,0,25,0.0,0.0,1.0,25,600,300,300,0.5,9,3,6,471.28714787071686,0.8270833333333333,-0.05013996889580108,0.2864249868439234,132728.07004026964,7510.60671433269,140238.67675460232,147,4,97.84,25,0,18,30.246889580093324,0.6791666666666666,42.38782051282052,1030.4487179487185,41.21794871794874,0
149,4,1,1,25,0.038461538461538464,0.038461538461538464,0.9615384615384616,26,800,600,200,0.75,10,6,4,459.14054173621025,0.8303846153846154,-0.0453259744739567,0.28284072046180914,133233.13185871052,7034.5464677640575,140267.6783264746,148,0,95.03846153846153,26,0,19,30.047645739910305,0.6802884615384615,41.898148148148145,1032.4074074074072,39.7079772079772,0
150,4,0,0,25,0.0,0.0,1.0,25,700,500,200,0.7142857142857143,9,5,4,470.49684900377446,0.8213888888888888,-0.03295433364398881,0.28848178227488586,133058.54752218944,7520.725468441831,140579.2729906313,149,1,99.64,25,0,19,29.93165579372476,0.6824999999999999,42.0673076923077,1031.73076923077,41.2692307692308,0
151,4,0,0,25,0.0,0.0,1.0,25,900,700,200,0.7777777777777778,11,7,4,470.08795956946074,0.8197222222222222,-0.028745341614906827,0.28887084538428737,133141.2310979621,7517.617932281429,140658.84903024352,150,2,100.64,25,0,19,29.858307453416153,0.6833333333333332,41.9871794871795,1032.0512820512838,41.282051282051356,0
152,4,0,0,25,0.0,0.0,1.0,25,1100,800,300,0.7272727272727273,14,8,6,468.5636280510841,0.8166666666666667,-0.025503647369238047,0.2888952589026927,133265.3046155903,7488.654924802799,140753.95954039312,151,3,101.64,25,0,19,29.771813078793517,0.6845833333333333,41.8669871794872,1032.532051282053,41.30128205128212,0
153,4,0,0,25,0.0,0.0,1.0,25,750,600,150,0.8,9,6,3,469.11538110314694,0.8159722222222222,-0.025499689633767586,0.28955742488780456,133306.675295858,7507.242357001979,140813.91765286,152,4,102.64,25,0,19,29.715626939788958,0.6849999999999999,41.82692307692308,1032.6923076923078,41.307692307692314,0
154,4,0,0,25,0.0,0.0,1.0,25,750,500,250,0.6666666666666666,10,5,5,467.8621949927907,0.8159722222222222,-0.030069951810974382,0.2852850711268835,132851.95094201993,7431.281075361588,140283.23201738152,153,5,103.64,25,0,18,30.209304886263542,0.6804166666666667,42.2676282051282,1030.9294871794862,41.237179487179446,1
155,4,0,0,25,0.0,0.0,1.0,25,950,700,250,0.7368421052631579,12,7,5,467.91143760840777,0.8156944444444444,-0.03070707070707024,0.28594587853847114,132934.57031249985,7440.321180555539,140374.8914930554,154,6,104.64,25,0,18,30.124158249158253,0.6812500000000001,42.18749999999999,1031.2499999999989,41.24999999999996,0
156,4,0,0,25,0.0,0.0,1.0,25,650,500,150,0.7692307692307693,8,5,3,469.7619690598356,0.8143055555555555,-0.02809937888198788,0.2886705229718836,133141.2310979618,7508.937376725827,140650.16847468764,155,7,105.64,25,0,18,29.866718426501023,0.6833333333333333,41.98717948717948,1032.0512820512815,41.28205128205126,0
157,4,0,1,24,0.0,0.04,0.96,25,500,200,300,0.4,8,2,6,466.36955689248623,0.8147222222222222,-0.030350822725862203,0.28722301008617535,133223.94035585131,7426.318006245866,140650.25836209717,156,8,106.64,25,0,18,29.87038186898478,0.6841666666666668,41.90705128205127,1032.371794871794,41.29487179487176,0
158,4,0,0,24,0.0,0.0,1.0,24,800,600,200,0.75,10,6,4,479.26306512028543,0.8118961352657005,-0.02422480620155021,0.2944044542881752,133127.99999999988,7960.666666666649,141088.66666666654,157,9,108.54166666666667,24,0,18,29.635012919896642,0.6875000000000001,41.99999999999999,1031.999999999999,42.999999999999964,0
159,4,0,0,24,0.0,0.0,1.0,24,900,700,200,0.7777777777777778,11,7,4,480.49874632600927,0.811141304347826,-0.02152620815843287,0.2958458483840259,133214.01388888885,8001.833333333329,141215.8472222222,158,10,109.54166666666667,24,0,18,29.515794855236248,0.6883680555555556,41.916666666666664,1032.333333333333,43.01388888888888,0
160,4,0,0,24,0.0,0.0,1.0,24,700,600,100,0.8571428571428571,8,6,2,482.3297564683854,0.8096316425120773,-0.022191736604260548,0.29766087361335797,133300.05555555547,8058.916666666657,141358.97222222213,159,11,110.54166666666667,24,0,18,29.381186787174528,0.6892361111111112,41.83333333333333,1032.666666666666,43.02777777777775,0
161,4,0,0,24,0.0,0.0,1.0,24,600,400,200,0.6666666666666666,8,4,4,482.47719835094455,0.8090277777777778,-0.024537485210282872,0.29844248257276995,133386.125,8071.152777777779,141457.27777777778,160,12,111.54166666666667,24,0,18,29.290026352586857,0.6901041666666667,41.75,1033.0,43.041666666666664,0
162,4,0,0,24,0.0,0.0,1.0,24,900,700,200,0.7777777777777778,11,7,4,481.95903974968894,0.807367149758454,-0.02620122541115788,0.29951001648572884,133558.34722222234,8073.930555555574,141632.2777777779,161,13,112.54166666666667,24,0,18,29.128708481135114,0.6918402777777777,41.58333333333334,1033.6666666666677,43.069444444444485,0
163,4,1,1,24,0.04,0.04,0.96,25,800,500,300,0.625,11,5,6,465.1247525393811,0.8065277777777777,-0.04088531187122746,0.29261645824312965,134010.95920138893,7466.362847222229,141477.32204861115,162,0,109.0,25,0,18,29.105885311871226,0.6920833333333333,41.145833333333336,1035.416666666667,41.41666666666668,0
164,4,0,0,24,0.0,0.0,1.0,24,700,600,100,0.8571428571428571,8,6,2,479.48139331358277,0.8023852657004831,-0.02483354810996552,0.30006254936398424,133816.88888888896,8032.541666666688,141849.43055555565,163,15,114.54166666666667,24,0,18,28.930747959621993,0.6944444444444444,41.33333333333334,1034.6666666666674,43.11111111111114,0
165,4,0,0,24,0.0,0.0,1.0,24,700,500,200,0.7142857142857143,9,5,4,482.22310387121706,0.8007246376811594,-0.026502952227589915,0.30248540151921793,133903.125,8114.236111111112,142017.36111111112,164,16,115.54166666666667,24,0,18,28.77247718733226,0.6953125,41.25,1035.0,43.125,0
166,4,0,0,24,0.0,0.0,1.0,24,700,500,200,0.7142857142857143,9,5,4,481.38338950151376,0.799969806763285,-0.025144834245252934,0.30337894344446337,134075.68055555565,8108.36111111113,142184.04166666677,165,17,116.54166666666667,24,0,18,28.619515073489957,0.6970486111111112,41.08333333333334,1035.6666666666677,43.15277777777782,0
167,4,0,0,24,0.0,0.0,1.0,24,450,300,150,0.6666666666666666,6,3,3,480.39817948119105,0.798611111111111,-0.02513674388674403,0.3034710450868988,134162.0,8090.236111111114,142252.23611111112,166,18,117.54166666666667,24,0,18,28.55768715143715,0.6979166666666667,41.0,1036.0,43.166666666666664,0
168,4,0,0,24,0.0,0.0,1.0,24,750,400,350,0.5333333333333333,11,4,7,481.30015256757264,0.7978562801932366,-0.026133805082020123,0.304758080312135,134248.34722222216,8122.749999999996,142371.09722222216,167,19,118.54166666666667,24,0,19,28.446981880561808,0.6987847222222223,40.916666666666664,1036.333333333333,43.18055555555554,0
169,4,0,0,24,0.0,0.0,1.0,24,800,500,300,0.625,11,5,6,481.73049921112477,0.7974788647342995,-0.025962105375998412,0.30539061922466726,134291.53125000003,8138.465277777778,142429.9965277778,168,20,119.54166666666667,24,0,19,28.392158439191725,0.69921875,40.875,1036.5000000000002,43.18750000000001,0
170,4,1,1,24,0.04,0.04,0.96,25,350,0,350,0.0,7,0,7,467.57310365961814,0.8008333333333333,-0.04080321285140587,0.2985274431057563,134550.78125000003,7582.46527777778,142133.2465277778,169,0,115.72,25,0,19,28.49732262382864,0.6975,40.625,1037.5000000000002,41.50000000000001,0
171,4,0,0,24,0.0,0.0,1.0,24,250,100,150,0.4,4,1,3,481.73049921112477,0.7974788647342995,-0.025962105375998412,0.30539061922466726,134291.53125000003,8138.465277777778,142429.9965277778,170,22,121.54166666666667,24,0,19,28.392158439191725,0.69921875,40.875,1036.5000000000002,43.18750000000001,0
172,4,0,0,24,0.0,0.0,1.0,24,650,400,250,0.6153846153846154,9,4,5,481.64759156056095,0.7948369565217391,-0.021764170148933948,0.306422424814909,134421.125,8148.722222222222,142569.84722222222,171,23,122.54166666666667,24,0,19,28.263286188792453,0.7005208333333333,40.75,1037.0,43.208333333333336,0
173,4,0,0,24,0.0,0.0,1.0,24,500,300,200,0.6,7,3,4,482.9918114646726,0.7941576086956521,-0.01924982591461788,0.3076415601581022,134464.33680555556,8189.034722222227,142653.37152777778,172,24,123.54166666666667,24,0,19,28.1847581552306,0.7009548611111112,40.708333333333336,1037.1666666666667,43.21527777777778,0
174,4,0,0,24,0.0,0.0,1.0,24,600,300,300,0.5,9,3,6,485.64675932596566,0.7911382850241545,-0.017899202398158343,0.31080394350696694,134637.25347222225,8277.229166666675,142914.48263888893,173,25,124.54166666666667,24,0,19,27.941156790321724,0.7026909722222221,40.54166666666667,1037.8333333333337,43.24305555555557,0
175,4,0,0,24,0.0,0.0,1.0,24,350,200,150,0.5714285714285714,5,2,3,486.9203823534629,0.790006038647343,-0.021743202740312606,0.3119897264709226,134680.5000000001,8315.736111111128,142996.2361111112,174,26,125.54166666666667,24,0,19,27.864416077927643,0.703125,40.50000000000001,1038.0000000000007,43.25000000000003,0
176,4,0,0,24,0.0,0.0,1.0,24,500,400,100,0.8,6,4,2,486.9203823534629,0.790006038647343,-0.021743202740312606,0.3119897264709226,134680.5000000001,8315.736111111128,142996.2361111112,175,27,126.54166666666667,24,0,19,27.864416077927643,0.703125,40.50000000000001,1038.0000000000007,43.25000000000003,0
177,4,0,0,24,0.0,0.0,1.0,24,900,500,400,0.5555555555555556,13,5,8,481.8139190676293,0.788118961352657,-0.019553184662281176,0.31056320140108923,134896.8368055555,8199.034722222219,143095.87152777772,176,28,127.54166666666667,24,0,18,27.77855767688112,0.7052951388888888,40.291666666666664,1038.833333333333,43.28472222222221,0
178,4,1,1,24,0.04,0.04,0.96,25,700,400,300,0.5714285714285714,10,4,6,469.3802266842228,0.7963888888888889,-0.04006780705809809,0.3048857148102026,135175.00115569532,7689.694536900079,142864.69569259541,177,0,123.4,25,0,18,27.821280885601283,0.7037500000000001,40.02403846153847,1039.9038461538466,41.59615384615387,0
179,4,0,0,24,0.0,0.0,1.0,24,550,200,350,0.36363636363636365,9,2,7,486.17552278500386,0.785552536231884,-0.02187884132328577,0.314878165691596,135070.03125,8333.548611111111,143403.57986111112,178,30,129.54166666666666,24,0,18,27.490513601624716,0.70703125,40.125,1039.5,43.3125,0
180,4,0,0,24,0.0,0.0,1.0,24,900,500,400,0.5555555555555556,13,5,8,486.0260844778373,0.7851751207729468,-0.019704499305333023,0.31515911798053514,135113.34722222225,8333.722222222226,143447.06944444447,179,31,130.54166666666666,24,0,18,27.450705354280224,0.7074652777777777,40.083333333333336,1039.6666666666667,43.31944444444445,0
181,4,0,0,24,0.0,0.0,1.0,24,1000,800,200,0.8,12,8,4,483.2516266140756,0.7838919082125604,-0.027539657106232962,0.3144914913137066,135243.3368055556,8271.312500000005,143514.6493055556,180,32,131.54166666666666,24,0,18,27.39177749292314,0.7087673611111112,39.958333333333336,1040.166666666667,43.34027777777779,0
182,4,0,0,24,0.0,0.0,1.0,24,500,400,100,0.8,6,4,2,484.3331152436475,0.7826086956521738,-0.027368364840329118,0.3155748752975835,135286.68055555562,8304.763888888898,143591.44444444453,181,33,132.54166666666666,24,0,18,27.31996956103813,0.7092013888888888,39.91666666666667,1040.333333333334,43.34722222222225,0
183,4,0,0,24,0.0,0.0,1.0,24,900,600,300,0.6666666666666666,12,6,6,484.53023550911234,0.7810990338164251,-0.020686525731368866,0.3164651454517677,135373.38888888893,8318.500000000004,143691.88888888893,182,34,133.54166666666666,24,0,18,27.227471706171265,0.7100694444444444,39.833333333333336,1040.666666666667,43.36111111111112,0
184,4,0,0,24,0.0,0.0,1.0,24,800,500,300,0.625,11,5,6,484.032867810935,0.7801932367149758,-0.023681823033408378,0.31690453798187657,135460.12500000012,8313.43055555557,143773.55555555568,183,35,134.54166666666666,24,0,18,27.1530446152204,0.7109375,39.75000000000001,1041.000000000001,43.375000000000036,0
185,4,0,0,24,0.0,0.0,1.0,24,300,100,200,0.3333333333333333,5,1,4,482.4831686778087,0.7790609903381642,-0.026512726108531837,0.3162720204333969,135503.5034722223,8275.631944444463,143779.13541666677,184,36,135.54166666666666,24,0,18,27.149698521957205,0.7113715277777777,39.70833333333334,1041.1666666666674,43.38194444444448,0
186,4,0,0,24,0.0,0.0,1.0,24,600,500,100,0.8333333333333334,7,5,2,477.2750581814895,0.7777777777777778,-0.040051265619993615,0.31097608696960927,135286.6805555555,8113.791666666663,143400.47222222216,185,37,136.54166666666666,24,0,19,27.50353786179644,0.7092013888888888,39.916666666666664,1040.333333333333,43.34722222222221,1
187,4,0,0,24,0.0,0.0,1.0,24,800,700,100,0.875,9,7,2,479.8009744865549,0.7774003623188406,-0.05154123298638902,0.3137546686563912,135416.75347222225,8194.618055555566,143611.3715277778,186,38,137.54166666666666,24,0,19,27.30684547638111,0.7105034722222221,39.79166666666667,1040.8333333333337,43.36805555555557,1
188,4,0,0,24,0.0,0.0,1.0,24,400,200,200,0.5,6,2,4,479.6004018858778,0.7763435990338163,-0.05452617256283021,0.31438234108930524,135503.50347222228,8197.506944444449,143701.01041666672,187,39,138.54166666666666,24,0,19,27.2247345392455,0.7113715277777777,39.708333333333336,1041.166666666667,43.38194444444446,0
189,4,0,0,24,0.0,0.0,1.0,24,650,300,350,0.46153846153846156,10,3,7,475.69948485725155,0.7763435990338163,-0.04957116739258993,0.29459151914386655,133429.17013888896,7894.437500000022,141323.607638889,188,40,139.54166666666666,24,0,19,29.42141205570793,0.6905381944444444,41.70833333333334,1033.1666666666674,43.04861111111114,3
190,4,0,0,24,0.0,0.0,1.0,24,450,300,150,0.6666666666666666,6,3,3,477.0700794470547,0.7758907004830917,-0.05190695049185634,0.29612728354866724,133515.28125,7939.229166666669,141454.51041666666,189,41,140.54166666666666,24,0,19,29.298701822286727,0.69140625,41.625,1033.5,43.0625,0
191,4,0,0,24,0.0,0.0,1.0,24,800,600,200,0.75,10,6,4,476.0329347676284,0.7746074879227053,-0.05069019228703431,0.2972092950873139,133730.68055555553,7932.041666666663,141662.7222222222,190,42,141.54166666666666,24,0,18,29.10724836180041,0.6935763888888888,41.416666666666664,1034.3333333333333,43.09722222222222,0
192,4,0,0,24,0.0,0.0,1.0,24,400,300,100,0.75,5,3,2,476.3044597807623,0.774381038647343,-0.053870629933945646,0.2977262620200596,133773.78125,7943.409722222224,141717.19097222222,191,43,142.54166666666666,24,0,18,29.056575908920035,0.6940104166666667,41.375,1034.5,43.104166666666664,0
193,4,0,0,24,0.0,0.0,1.0,24,450,300,150,0.6666666666666666,6,3,3,476.2379478757041,0.7741545893719807,-0.054365335051546615,0.29803278028350505,133816.88888888885,7945.736111111102,141762.62499999994,192,44,143.54166666666666,24,0,18,29.01464508161512,0.6944444444444444,41.33333333333333,1034.6666666666663,43.11111111111109,0
194,4,0,0,24,0.0,0.0,1.0,24,750,700,50,0.9333333333333333,8,7,1,472.3932985040304,0.7722675120772946,-0.049139966725701756,0.29666681263989203,133946.2534722222,7855.062499999991,141801.3159722222,193,45,144.54166666666666,24,0,19,28.983188429131108,0.6957465277777779,41.20833333333333,1035.1666666666663,43.13194444444443,0
195,4,0,0,24,0.0,0.0,1.0,24,650,400,250,0.6153846153846154,9,4,5,456.65282868606914,0.7719655797101449,-0.010693335505947754,0.26363860862148714,130773.50347222229,7143.618055555565,137917.12152777787,194,46,145.54166666666666,24,0,19,32.614673293139965,0.6636284722222222,44.29166666666667,1022.8333333333339,42.61805555555558,6
196,4,0,1,23,0.0,0.041666666666666664,0.9583333333333334,24,650,400,250,0.6153846153846154,9,4,5,459.3284809387896,0.769927536231884,-0.006786102062975363,0.266063855940016,130901.38888888896,7225.347222222232,138126.73611111118,195,47,146.54166666666666,24,0,19,32.41551302931597,0.6649305555555556,44.16666666666667,1023.3333333333339,42.638888888888914,0
197,4,2,1,24,0.08,0.04,0.96,25,550,400,150,0.7272727272727273,7,4,3,442.4216932434529,0.7855555555555556,-0.009426472886388204,0.259968449500905,131451.35100776626,6631.3858583990805,138082.73686616536,196,0,139.36,25,0,21,32.28743423451583,0.66625,43.62980769230769,1025.480769230769,41.01923076923076,0
198,4,0,0,24,0.0,0.0,1.0,24,650,400,250,0.6153846153846154,9,4,5,454.01742244110244,0.7701539855072463,0.009656041632785328,0.26562827122648336,131285.42013888896,7121.173611111121,138406.5937500001,197,1,146.16666666666666,24,0,21,32.159361955873585,0.6688368055555556,43.79166666666667,1024.833333333334,42.701388888888914,0
199,4,1,1,24,0.04,0.04,0.96,25,550,400,150,0.7272727272727273,7,4,3,439.5582409862741,0.78125,-0.008772258669165645,0.25912079731069315,131574.6348002959,6566.943006245896,138141.57780654178,198,0,141.28,25,0,20,32.23536915547226,0.6675,43.50961538461539,1025.9615384615386,41.03846153846154,0
200,4,1,0,25,0.04,0.0,1.0,25,750,600,150,0.8,9,6,3,437.515952278927,0.7731944444444444,0.01686574146265385,0.26100370250834987,132027.16975365728,6552.798580292598,138579.96833394986,199,0,142.24,25,0,21,31.827765216487343,0.6720833333333334,43.06891025641027,1027.7243589743603,41.10897435897441,0
201,4,0,0,25,0.0,0.0,1.0,25,500,400,100,0.8,6,4,2,435.75988333405877,0.7725,0.01620947630922709,0.2608055421148622,132150.72320841558,6517.196745562145,138667.91995397772,200,1,143.24,25,0,21,31.747454280964263,0.6733333333333333,42.948717948717956,1028.2051282051289,41.12820512820515,0
202,4,0,0,25,0.0,0.0,1.0,25,750,500,250,0.6666666666666666,10,5,5,435.9476662755431,0.7719444444444444,0.01847304456216925,0.2614871142202278,132233.1242809008,6529.3443869165185,138762.46866781733,201,2,144.24,25,0,21,31.659005920847633,0.6741666666666666,42.86858974358975,1028.5256410256416,41.141025641025664,0
203,4,0,0,25,0.0,0.0,1.0,25,600,300,300,0.5,9,3,6,436.84209721582056,0.7729166666666667,0.0158778625954199,0.2623095811064877,132274.33444793735,6556.599533612772,138830.93398155013,202,3,145.24,25,0,21,31.59419302071974,0.6745833333333333,42.82852564102565,1028.6858974358984,41.14743589743593,0
204,4,0,0,25,0.0,0.0,1.0,25,850,600,250,0.7058823529411765,11,6,5,438.91785444219056,0.7725,0.018464413642734545,0.26413229085035683,132356.7740435981,6618.750256821189,138975.5243004193,203,4,146.24,25,0,21,31.457165290972323,0.6754166666666667,42.748397435897445,1029.0064102564113,41.16025641025645,0
205,4,0,0,25,0.0,0.0,1.0,25,600,200,400,0.3333333333333333,10,2,8,437.9891188274736,0.77125,0.01943017281644055,0.2641506206787666,132439.2393213758,6601.389145710064,139040.62846708586,204,5,147.24,25,0,21,31.397419430172796,0.67625,42.66826923076923,1029.3269230769235,41.17307692307694,0
206,4,0,0,25,0.0,0.0,1.0,25,650,400,250,0.6153846153846154,9,4,5,466.29511891954553,0.77125,0.0369129720853858,0.2558321868666696,128778.12500000003,7077.837617110456,135855.9626171105,205,6,148.24,24,1,21,34.41776135741652,0.6432291666666667,46.25,1015.0000000000002,42.29166666666668,8
207,4,1,2,24,0.038461538461538464,0.07692307692307693,0.9230769230769231,26,850,700,150,0.8235294117647058,10,7,3,453.3526347105955,0.7877564102564103,0.02570167139703594,0.2508867721932456,129119.93805473363,6507.372822156465,135627.3108768901,206,0,143.5,25,1,21,34.39438137285821,0.6425000000000001,45.91346153846153,1016.3461538461531,40.653846153846125,0
208,4,2,2,24,0.07692307692307693,0.07692307692307693,0.9230769230769231,26,450,300,150,0.6666666666666666,6,3,3,444.08049769064036,0.7942307692307692,-0.022684839432411952,0.24724481763316705,129358.3295229384,6289.102270995247,135647.43179393365,207,0,136.8846153846154,26,0,21,34.38511326860843,0.6410256410256412,45.679012345679,1017.2839506172824,39.126305792972396,0
209,4,3,3,24,0.1111111111111111,0.1111111111111111,0.8888888888888888,27,800,500,300,0.625,11,5,6,429.0763413823509,0.8010446343779678,-0.028789748252050718,0.2407047934771152,129655.65653344654,5726.434948979572,135382.09148242613,208,0,132.7037037037037,27,0,19,34.46205922462498,0.6404320987654322,45.38690476190475,1018.4523809523796,37.720458553791836,0
210,4,2,2,24,0.07692307692307693,0.07692307692307693,0.9230769230769231,26,300,200,100,0.6666666666666666,4,2,2,444.08049769064036,0.7975641025641026,-0.022684839432411952,0.24724481763316705,129358.3295229384,6289.102270995247,135647.43179393365,209,0,138.73076923076923,26,0,21,34.38511326860843,0.6410256410256412,45.679012345679,1017.2839506172824,39.126305792972396,0
211,4,1,1,24,0.04,0.04,0.96,25,600,500,100,0.8333333333333334,7,5,2,454.9964682325557,0.7755555555555556,-0.004259609325772518,0.2533611912579177,129364.36760355014,6772.066074950656,136136.4336785008,210,0,145.24,25,0,21,34.10129174543161,0.6450000000000001,45.673076923076906,1017.307692307691,40.692307692307644,0
212,4,0,0,24,0.0,0.0,1.0,24,450,300,150,0.6666666666666666,6,3,3,467.9521633969365,0.7632850241545893,0.011612021857923427,0.2595007451564827,129201.38888888876,7292.013888888869,136493.40277777764,211,12,152.29166666666666,24,0,21,33.93954918032787,0.6475694444444446,45.83333333333332,1016.6666666666656,42.361111111111065,0
213,4,0,0,24,0.0,0.0,1.0,24,700,600,100,0.8571428571428571,8,6,2,473.20844697566986,0.7639643719806762,0.013142443606969145,0.26326263918801374,129328.50347222209,7439.868055555532,136768.3715277776,212,13,153.29166666666666,24,0,21,33.67503686711454,0.6488715277777779,45.70833333333332,1017.1666666666655,42.38194444444439,0
214,4,1,0,25,0.04,0.0,1.0,25,500,400,100,0.8,6,4,2,456.13038255843696,0.7773611111111111,0.01471929548671147,0.256911700858202,129813.08876253285,6842.3387676692855,136655.42753020214,213,0,148.12,25,0,21,33.611646223200715,0.6495833333333334,45.23237179487179,1019.0705128205126,40.762820512820504,0
215,4,0,0,25,0.0,0.0,1.0,25,1100,900,200,0.8181818181818182,13,9,4,457.4442742627156,0.7784722222222222,0.015688246385921367,0.2590013666733026,130017.30974687704,6895.134779750171,136912.44452662722,214,1,149.12,25,0,22,33.368688455897775,0.6516666666666667,45.032051282051285,1019.8717948717947,40.79487179487179,0
216,4,2,1,26,0.07407407407407407,0.037037037037037035,0.962962962962963,27,550,300,250,0.5454545454545454,8,3,5,426.8865116387732,0.7983143399810066,-0.005264658048722781,0.24621208987207568,130735.62349965703,5762.085991590974,136497.709491248,215,0,139.0,26,1,21,33.41444092349481,0.6550480769230769,44.3287037037037,1022.6851851851849,39.33404558404557,0
217,4,1,0,27,0.037037037037037035,0.0,1.0,27,600,300,300,0.5,9,3,6,428.0148812425337,0.7904795821462488,0.0017200553991869594,0.24812890667836393,130932.97515622621,5808.252362444753,136741.22751867096,216,0,139.96296296296296,26,1,22,33.1844340570969,0.657051282051282,44.135802469135804,1023.4567901234569,39.36372269705603,0
218,4,0,0,27,0.0,0.0,1.0,27,850,400,450,0.47058823529411764,13,4,9,429.89999808225195,0.7904795821462488,-0.003628892685268781,0.24973350151293003,131011.95749504655,5864.4080551745255,136876.36555022106,217,1,140.96296296296296,26,1,22,33.05572304291026,0.6578525641025641,44.058641975308646,1023.7654320987659,39.375593542260226,0
219,4,0,0,27,0.0,0.0,1.0,27,550,400,150,0.7272727272727273,7,4,3,427.49758801232304,0.7891737891737892,-0.0006473250408765008,0.24910460857223785,131130.47565634057,5811.59241159885,136942.06806793943,218,2,141.96296296296296,26,1,22,32.99652202300236,0.659054487179487,43.942901234567906,1024.2283950617289,39.3933998100665,0
220,4,0,0,27,0.0,0.0,1.0,27,900,600,300,0.6666666666666666,12,6,6,424.01288931668637,0.790954415954416,0.0004127000061344699,0.24809423770503233,131288.58322378463,5733.610301402246,137022.19352518689,219,3,142.96296296296296,26,1,22,32.92488581036993,0.6606570512820513,43.78858024691359,1024.8456790123469,39.41714150047488,0
221,4,0,0,27,0.0,0.0,1.0,27,450,300,150,0.6666666666666666,6,3,3,423.99637394474155,0.7916666666666667,0.0015831605235581137,0.2488544088771083,131407.22641365655,5743.237501905218,137150.46391556176,220,4,143.96296296296296,26,1,22,32.8046608468794,0.6618589743589742,43.67283950617285,1025.3086419753095,39.434947768281134,0
222,4,0,0,27,0.0,0.0,1.0,27,500,300,200,0.6,7,3,4,434.5435953559137,0.7910731244064578,0.026507174346446227,0.24266003483253604,129476.09751276475,5852.60178516993,135328.69929793468,221,5,144.96296296296296,26,1,20,34.50688653019963,0.6422275641025641,45.563271604938265,1017.7469135802464,39.14411206077871,6
223,4,3,2,28,0.1,0.06666666666666667,0.9333333333333333,30,800,700,100,0.875,9,7,2,399.9170434388099,0.820977011494253,0.01277309400779636,0.22869284117021843,130404.40779320998,4430.189043209893,134834.59683641986,222,0,131.36666666666667,29,1,22,34.4410071616354,0.6415229885057471,44.652777777777786,1021.3888888888896,35.22030651340999,0
224,4,0,0,28,0.0,0.0,1.0,28,700,600,100,0.8571428571428571,8,6,2,423.0518388615143,0.8023589065255732,0.02975495915986026,0.24010293106246186,130110.72137188194,5408.715986394542,135519.43735827648,223,1,141.53571428571428,27,1,22,34.15013613380009,0.6450617283950617,44.94047619047618,1020.238095238094,37.786596119929406,0
225,4,0,0,28,0.0,0.0,1.0,28,1000,500,500,0.5,15,5,10,422.65722615576846,0.8021384479717812,0.03250728862973773,0.2408163265306122,130262.5868055554,5411.284722222202,135673.8715277776,224,2,142.53571428571428,27,1,22,34.005102040816325,0.6466049382716049,44.79166666666666,1020.8333333333321,37.808641975308596,0
226,4,0,0,28,0.0,0.0,1.0,28,400,100,300,0.25,7,1,6,421.5537505391081,0.8002094356261023,0.027324395220052367,0.24065739069878184,130338.55273880374,5388.941149376403,135727.49388818015,225,3,143.53571428571428,27,1,22,33.95572233556786,0.6473765432098766,44.7172619047619,1021.1309523809515,37.819664902998205,0
227,4,1,1,28,0.034482758620689655,0.034482758620689655,0.9655172413793104,29,500,100,400,0.2,9,1,8,411.29249037068433,0.8030582922824302,0.013097050013087141,0.23634368146179713,130592.80659598362,4942.36812987185,135535.17472585547,226,0,139.55172413793105,28,1,17,33.95856761315716,0.6465773809523809,44.4683908045977,1022.1264367816093,36.504515599343186,0
228,4,0,0,28,0.0,0.0,1.0,28,650,300,350,0.46153846153846156,10,3,7,426.56549880969845,0.7982804232804233,0.032728993738168066,0.2447138914224059,130528.56445312497,5535.796440972222,136064.3608940972,227,5,145.53571428571428,27,1,17,33.633834522596004,0.6493055555555556,44.53125,1021.8749999999998,37.847222222222214,0
229,4,0,0,28,0.0,0.0,1.0,28,700,500,200,0.7142857142857143,9,5,4,427.95161370505434,0.7980048500881833,0.035766264008150195,0.24647573661084898,130680.67347381667,5585.001018636633,136265.6744924533,228,6,146.53571428571428,27,1,17,33.44324576723427,0.6508487654320987,44.38244047619048,1022.4702380952386,37.86926807760143,0
230,4,1,1,28,0.034482758620689655,0.034482758620689655,0.9655172413793104,29,750,500,250,0.6666666666666666,10,5,5,416.9413850415512,0.8044950738916256,0.016116152450090793,0.24211143996911605,130996.97625594534,5123.612143281813,136120.58839922716,229,0,142.44827586206895,28,1,18,33.402631578947364,0.6506696428571428,44.07327586206897,1023.7068965517244,36.56096059113302,0
231,4,0,1,27,0.0,0.03571428571428571,0.9642857142857143,28,700,600,100,0.8571428571428571,8,6,2,413.75033299589745,0.7957451499118166,-0.002262773722627731,0.23345879580081536,129883.08930342969,5147.83428996598,135030.92359339568,230,8,148.53571428571428,27,1,20,34.61982968369829,0.642746913580247,45.163690476190474,1019.345238095238,37.753527336860664,6
232,4,1,1,27,0.03571428571428571,0.03571428571428571,0.9642857142857143,28,750,600,150,0.8,9,6,3,413.6626281501483,0.7914462081128747,-7.295010213015374e-05,0.23431765730091836,130034.82187145675,5158.109233276622,135192.93110473338,231,0,149.21428571428572,27,1,20,34.467099503939316,0.6442901234567902,45.01488095238094,1019.9404761904748,37.775573192239804,0
233,4,1,0,28,0.03571428571428571,0.0,1.0,28,550,300,250,0.5454545454545454,8,3,5,412.192302233643,0.7879739858906525,0.010314914710599199,0.2346246473875979,130224.61214303414,5135.516537344081,135360.12868037823,232,0,150.17857142857142,27,1,21,34.310911454536615,0.6462191358024691,44.82886904761904,1020.6845238095226,37.8031305114638,0
234,4,1,1,28,0.034482758620689655,0.034482758620689655,0.9655172413793104,29,800,600,200,0.75,10,6,4,400.85349534850104,0.7979269293924466,-0.005352026643785424,0.2301267887339699,130556.0948647443,4666.773393116648,135222.86825786094,233,0,145.9655172413793,28,1,20,34.26267632035239,0.6462053571428572,44.50431034482758,1021.9827586206893,36.49938423645319,0
235,4,0,0,28,0.0,0.0,1.0,28,500,100,400,0.2,9,1,8,412.5627423118766,0.7863756613756613,0.006630719906732141,0.23552458716673,130338.5527388037,5154.566149376388,135493.1188881801,234,2,152.17857142857142,27,1,21,34.185247255416286,0.6473765432098766,44.71726190476189,1021.1309523809512,37.81966490299819,0
236,4,1,1,28,0.034482758620689655,0.034482758620689655,0.9655172413793104,29,600,400,200,0.6666666666666666,8,4,4,398.00548408168623,0.7964901477832512,-0.0046513205389717704,0.22936073119104114,130702.97275482216,4604.099988439671,135307.07274326182,235,0,147.89655172413794,28,1,21,34.186045150110075,0.6476934523809526,44.36063218390804,1022.5574712643665,36.519909688013094,0
237,4,2,2,28,0.06666666666666667,0.06666666666666667,0.9333333333333333,30,450,400,50,0.8888888888888888,5,4,1,389.0833466685362,0.7988026819923372,-0.011343189113431684,0.22641764127759395,131079.11120756163,4200.13985339505,135279.25106095668,236,0,143.9,29,1,21,34.032251684072534,0.6483477011494254,43.99305555555555,1024.027777777777,35.31130268199231,0
238,4,1,1,28,0.034482758620689655,0.034482758620689655,0.9655172413793104,29,750,500,250,0.6666666666666666,10,5,5,399.35744097779,0.7924876847290641,-0.013990618056126891,0.23145834435189555,130923.44441554362,4657.050345157881,135580.4947607015,237,0,149.82758620689654,28,1,21,33.92735972670692,0.6499255952380952,44.145114942528735,1023.4195402298847,36.55069786535302,0
239,4,0,0,28,0.0,0.0,1.0,28,650,500,150,0.7692307692307693,8,5,3,410.83114125702514,0.7782186948853616,0.011780104712042272,0.23778408478815694,130870.93431122445,5153.171060090701,136024.10537131515,238,6,156.17857142857142,27,1,21,33.68722125266629,0.6527777777777778,44.19642857142857,1023.2142857142853,37.896825396825385,0
240,4,0,0,28,0.0,0.0,1.0,28,850,500,350,0.5882352941176471,12,5,7,410.5399096540081,0.7758487654320987,0.015765765765765494,0.23903008952951657,131099.43000637766,5164.309630102054,136263.7396364797,239,7,157.17857142857142,27,1,21,33.462292938099395,0.6550925925925926,43.97321428571429,1024.1071428571436,37.929894179894205,0
241,4,1,0,29,0.034482758620689655,0.0,1.0,29,950,500,450,0.5263157894736842,14,5,9,396.24532140197834,0.7828407224958949,0.004511401674145432,0.23320654159016685,131512.27715434667,4622.224905866031,136134.5020602127,240,0,152.72413793103448,28,1,23,33.40949946304338,0.655877976190476,43.570402298850574,1025.7183908045977,36.63279967159277,0
242,4,0,0,29,0.0,0.0,1.0,29,550,300,250,0.5454545454545454,8,3,5,396.8831083870632,0.7831486042692939,0.0068183244885049454,0.23403321857902715,131585.97414205974,4644.85008752808,136230.82422958783,241,1,153.72413793103448,28,1,20,33.318454464827525,0.6566220238095237,43.49856321839081,1026.005747126437,36.64306239737275,0
243,4,2,2,29,0.06451612903225806,0.06451612903225806,0.935483870967742,31,500,300,200,0.6,7,3,4,372.56387543495214,0.8008064516129032,-0.009064807046095025,0.22321740101431628,132190.59148817783,3649.8878121748266,135840.47930035266,242,0,144.74193548387098,30,1,21,33.33169955997039,0.6565972222222222,42.90994623655914,1028.3602150537636,34.27867383512545,0
244,4,0,0,29,0.0,0.0,1.0,29,200,100,100,0.5,3,1,2,394.8877134122148,0.7856116584564861,0.01289183308163988,0.2342126545856515,131807.18896568246,4609.807892390017,136416.99685807247,243,1,155.6551724137931,28,1,21,33.14560888018283,0.6588541666666666,43.2830459770115,1026.8678160919546,36.67385057471267,0
245,4,0,0,29,0.0,0.0,1.0,29,650,400,250,0.6153846153846154,9,4,5,395.9949597912864,0.7864326765188834,0.012955754602765213,0.23532568308793927,131880.9685270512,4644.8397658211225,136525.80829287233,244,2,156.6551724137931,28,1,21,33.04250011656641,0.6595982142857142,43.21120689655173,1027.155172413794,36.68411330049264,0
246,4,0,0,29,0.0,0.0,1.0,29,1100,900,200,0.8181818181818182,13,9,4,398.71632096151825,0.7858169129720853,0.012632106765409157,0.23763492729306496,131991.67657550535,4725.447136345624,136717.12371185096,245,3,157.6551724137931,28,1,21,32.86056347874721,0.6607142857142857,43.10344827586207,1027.5862068965519,36.69950738916257,0
247,4,0,0,29,0.0,0.0,1.0,29,650,400,250,0.6153846153846154,9,4,5,397.0733249086414,0.7842775041050903,0.016889514426459806,0.23711707565913387,132065.5077454091,4687.938053243519,136753.44579865262,246,4,158.6551724137931,28,1,21,32.828079862081815,0.6614583333333333,43.03160919540231,1027.8735632183923,36.70977011494258,0
248,4,0,0,29,0.0,0.0,1.0,29,1050,700,350,0.6666666666666666,14,7,7,400.217702204213,0.7818144499178982,0.015059109171315033,0.23992950689931006,132213.23201545805,4782.815183643846,136996.0471991019,247,5,159.6551724137931,28,1,22,32.5978508894477,0.6629464285714285,42.887931034482776,1028.4482758620711,36.73029556650254,0
249,4,0,0,29,0.0,0.0,1.0,29,600,400,200,0.6666666666666666,8,4,4,399.82473803923074,0.7813013136288998,0.018582830389526794,0.2399283570513708,132250.17598510374,4775.378393777257,137025.554378881,248,6,160.6551724137931,28,1,22,32.57059878009034,0.6633184523809523,42.85201149425288,1028.5919540229888,36.73542692939246,0
250,4,0,0,29,0.0,0.0,1.0,29,600,300,300,0.5,9,3,6,398.6763162135135,0.779659277504105,0.021158670769349186,0.23970790095759645,132324.07940695618,4750.895304861965,137074.97471181815,249,7,161.6551724137931,28,1,22,32.5254270818787,0.6640624999999998,42.78017241379312,1028.879310344829,36.74568965517246,0
251,4,0,0,29,0.0,0.0,1.0,29,700,500,200,0.7142857142857143,9,5,4,400.87226941096947,0.7792487684729064,0.018536528998834845,0.24126447004381216,132361.03885916245,4811.974005813201,137173.01286497567,250,8,162.6551724137931,28,1,22,32.431583356604314,0.6644345238095237,42.74425287356323,1029.022988505748,36.750821018062425,0
252,4,0,0,29,0.0,0.0,1.0,29,1150,1000,150,0.8695652173913043,13,10,3,399.5187350661484,0.7803776683087028,0.013593008210638802,0.24210902888328148,132619.89952850455,4796.826900845575,137416.72642935012,251,9,163.6551724137931,28,1,23,32.20492165341518,0.6670386904761905,42.49281609195403,1030.0287356321849,36.786740558292315,0
253,4,0,0,29,0.0,0.0,1.0,29,900,800,100,0.8888888888888888,10,8,2,401.6197332465416,0.7817118226600985,0.01065297547796562,0.2443442193873998,132767.93344976223,4864.444403157618,137632.37785291986,252,10,164.6551724137931,28,1,19,32.001370881546535,0.6685267857142857,42.349137931034484,1030.6034482758623,36.80726600985223,0
254,4,0,0,29,0.0,0.0,1.0,29,700,500,200,0.7142857142857143,9,5,4,399.2843704098725,0.7790435139573071,0.009666895686892385,0.24388629161120476,132916.04994467576,4814.260263905416,137730.31020858118,253,11,165.6551724137931,28,1,20,31.91212670103571,0.6700148809523809,42.20545977011495,1031.1781609195411,36.82779146141218,0
255,4,0,0,29,0.0,0.0,1.0,29,800,500,300,0.625,11,5,6,398.7014174636556,0.7772988505747126,0.011681580856040652,0.2440134250615161,132990.1391572533,4804.671398137142,137794.81055539043,254,12,166.6551724137931,28,1,21,31.852451594929654,0.6707589285714286,42.133620689655174,1031.4655172413795,36.83805418719213,0
256,4,1,2,28,0.03333333333333333,0.06666666666666667,0.9333333333333333,30,550,300,250,0.5454545454545454,8,3,5,389.53932621597903,0.784051724137931,0.004385256927629699,0.2401190175032826,133257.03125,4381.770833333333,137638.80208333334,255,0,162.06666666666666,29,1,21,31.820016142050044,0.6702586206896551,41.875,1032.5,35.60344827586207,0
257,4,0,0,28,0.0,0.0,1.0,28,850,600,250,0.7058823529411765,11,6,5,413.3119986551449,0.767581569664903,0.023895466358648587,0.25154647651015216,132781.1547796201,5376.008893140576,138157.16367276065,256,24,174.17857142857142,27,1,21,31.686760034652032,0.672067901234568,42.33630952380952,1030.6547619047612,38.17239858906523,0
258,4,1,1,28,0.034482758620689655,0.034482758620689655,0.9655172413793104,29,750,700,50,0.9333333333333333,8,7,1,402.9396833509999,0.7733990147783251,0.010138881554628387,0.2475890287006189,133138.37951265037,4929.347296538525,138067.7268091889,257,0,169.13793103448276,28,1,21,31.59369344285118,0.6722470238095237,41.98994252873564,1032.0402298850581,36.858579638752076,0
259,4,0,0,28,0.0,0.0,1.0,28,800,700,100,0.875,9,7,2,416.2469878856147,0.7664792768959435,0.026399307559145768,0.2548961236769506,133011.31129535142,5473.111536281169,138484.4228316326,258,26,176.17857142857142,27,1,21,31.37863050586651,0.6743827160493827,42.113095238095234,1031.5476190476186,38.205467372134024,0
260,4,0,0,28,0.0,0.0,1.0,28,950,700,250,0.7368421052631579,12,7,5,415.0324718150854,0.7652116402116401,0.02509948269001172,0.25426050747715967,133027.19150482223,5442.120821773014,138469.31232659525,259,27,177.17857142857142,28,0,21,31.393918291550605,0.6711309523809523,42.09770114942528,1031.6091954022984,36.84318555008208,0
261,4,0,0,28,0.0,0.0,1.0,28,650,500,150,0.7692307692307693,8,5,3,414.37135026371277,0.7644400352733686,0.02739984882842017,0.25436025962341746,133101.31168252078,5430.674048751483,138531.98573127226,260,28,178.17857142857142,28,0,22,31.336152882205518,0.671875,42.025862068965516,1031.8965517241377,36.85344827586206,0
262,4,0,0,28,0.0,0.0,1.0,28,500,200,300,0.4,8,2,6,414.37135026371277,0.7644400352733686,0.02739984882842017,0.25436025962341746,133101.31168252078,5430.674048751483,138531.98573127226,261,29,179.17857142857142,28,0,22,31.336152882205518,0.671875,42.025862068965516,1031.8965517241377,36.85344827586206,0
263,4,1,1,28,0.034482758620689655,0.034482758620689655,0.9655172413793104,29,700,400,300,0.5714285714285714,10,4,6,401.97115227369346,0.7696018062397373,0.018361130044094454,0.24850037069488445,133364.60503472228,4921.744791666671,138286.34982638893,262,0,173.9655172413793,29,0,22,31.39076576576577,0.6713362068965518,41.770833333333336,1032.916666666667,35.61781609195403,0
264,4,0,0,28,0.0,0.0,1.0,28,700,600,100,0.8571428571428571,8,6,2,413.3384910045088,0.763558201058201,0.03315900413617534,0.2542314828233211,133175.45250363316,5409.308115338871,138584.76061897204,263,31,181.17857142857142,28,0,22,31.287989513734217,0.6726190476190477,41.95402298850574,1032.1839080459765,36.86371100164202,0
265,4,0,0,28,0.0,0.0,1.0,28,750,400,350,0.5333333333333333,11,4,7,415.0432040787699,0.7610229276895943,0.03861594721361006,0.256299875508436,133323.79607609974,5467.027100673786,138790.82317677353,264,32,182.17857142857142,28,0,22,31.09435865331108,0.6741071428571429,41.8103448275862,1032.7586206896542,36.884236453201936,0
266,4,0,0,28,0.0,0.0,1.0,28,850,700,150,0.8235294117647058,10,7,3,416.8004936542602,0.7608024691358024,0.04206238823763142,0.257899789102765,133397.99882745402,5520.070352754646,138918.06918020867,265,33,183.17857142857142,28,0,22,30.97415391747798,0.6748511904761905,41.73850574712643,1033.0459770114937,36.89449917898192,0
267,4,0,0,28,0.0,0.0,1.0,28,550,400,150,0.7272727272727273,7,4,3,417.33570414864255,0.7606371252204586,0.03989610028408497,0.2584893237323762,133435.10794441137,5537.446946426204,138972.55489083758,266,34,184.17857142857142,28,0,22,30.922912900384738,0.6752232142857143,41.70258620689655,1033.1896551724135,36.89963054187191,0
268,4,0,0,28,0.0,0.0,1.0,28,950,700,250,0.7368421052631579,12,7,5,416.64129504628806,0.7586529982363315,0.0438084953203739,0.2585856831185408,133510.667450574,5525.2166386737745,139035.88408924776,267,35,185.17857142857142,27,1,22,30.864680825533963,0.6793981481481481,41.629464285714285,1033.482142857143,38.277116402116405,0
269,4,0,0,28,0.0,0.0,1.0,28,900,600,300,0.6666666666666666,12,6,6,416.3872360256145,0.7580467372134039,0.0470054707745462,0.25869639905491215,133549.11821499426,5521.629641439897,139070.74785643414,268,36,186.17857142857142,27,1,22,30.832493521451177,0.679783950617284,41.5922619047619,1033.6309523809518,38.28262786596118,0
270,4,0,0,28,0.0,0.0,1.0,28,850,700,150,0.8235294117647058,10,7,3,416.3872360256145,0.7580467372134039,0.0470054707745462,0.25869639905491215,133549.11821499426,5521.629641439897,139070.74785643414,269,37,187.17857142857142,27,1,22,30.832493521451177,0.679783950617284,41.5922619047619,1033.6309523809518,38.28262786596118,0
271,4,0,0,28,0.0,0.0,1.0,28,950,900,50,0.9473684210526315,10,9,1,415.9014543760677,0.7559523809523809,0.049424460431654715,0.2594717332058948,133702.97663336157,5521.45248724488,139224.42912060645,270,38,188.17857142857142,27,1,19,30.6900479616307,0.6813271604938272,41.44345238095237,1034.2261904761895,38.30467372134035,0
272,4,1,1,28,0.034482758620689655,0.034482758620689655,0.9655172413793104,29,750,600,150,0.8,9,6,3,406.7229093525314,0.7625205254515599,0.04572108601975078,0.2506613058839872,133249.6139681596,5039.134132646315,138288.7481008059,271,0,182.6551724137931,28,1,19,31.383940996381853,0.6733630952380952,41.882183908045974,1032.471264367816,36.873973727422005,1
273,4,0,0,28,0.0,0.0,1.0,28,600,300,300,0.5,9,3,6,422.1120103297225,0.7546296296296295,0.05908435472242268,0.25928669545054245,133126.46429014305,5638.855893920053,138765.3201840631,272,40,190.17857142857142,27,1,20,31.111061043018506,0.6755401234567902,42.00148809523809,1031.9940476190468,38.2220017636684,0
274,4,0,0,28,0.0,0.0,1.0,28,1100,1000,100,0.9090909090909091,12,10,2,420.19495813900977,0.7548500881834215,0.0586179564778786,0.2591762501801412,133280.07912149234,5600.723453443874,138880.8025749362,273,41,191.17857142857142,27,1,22,31.00545827929096,0.6770833333333334,41.85267857142857,1032.5892857142856,38.24404761904761,0
275,4,0,1,27,0.0,0.03571428571428571,0.9642857142857143,28,900,700,200,0.7777777777777778,11,7,4,418.51482438444646,0.7527557319223985,0.05665610142630739,0.25867421158080506,133356.91975357843,5562.369570223907,138919.28932380234,274,42,192.17857142857142,27,1,22,30.971311770638227,0.677854938271605,41.7782738095238,1032.8869047619041,38.25507054673719,0
276,4,0,0,27,0.0,0.0,1.0,27,600,400,200,0.6666666666666666,8,4,4,417.2086368366287,0.7471509971509972,0.03375149342891315,0.2586693548387096,133472.22222222207,5737.152777777758,139209.37499999983,275,43,190.33333333333334,27,0,22,30.888776881720425,0.6790123456790124,41.66666666666666,1033.3333333333321,38.27160493827156,0
277,4,0,0,27,0.0,0.0,1.0,27,650,500,150,0.7692307692307693,8,5,3,419.41634691328215,0.7452516619183286,0.03970233906906362,0.2611204998524626,133626.03635204077,5808.988803854867,139435.02515589562,276,44,191.33333333333334,27,0,22,30.676693532911155,0.6805555555555556,41.51785714285714,1033.9285714285709,38.29365079365078,0
278,4,0,0,27,0.0,0.0,1.0,27,850,700,150,0.8235294117647058,10,7,3,419.80672360095684,0.7458452041785375,0.03998358882548203,0.26218118021116366,133741.455078125,5829.112413194443,139570.56749131944,277,45,192.33333333333334,27,0,19,30.550310506881505,0.681712962962963,41.40625,1034.375,38.31018518518518,0
279,4,0,0,27,0.0,0.0,1.0,27,450,300,150,0.6666666666666666,6,3,3,419.1416183890817,0.7444207027540362,0.04265678018015184,0.26231248178751426,133818.42857585734,5817.77454471371,139636.20312057104,278,46,193.33333333333334,27,0,19,30.489986336833027,0.6824845679012346,41.331845238095234,1034.6726190476184,38.32120811287476,0
280,4,0,0,27,0.0,0.0,1.0,27,600,300,300,0.5,9,3,6,418.37942331011243,0.7435897435897436,0.045023747151407,0.26265769571707037,133933.9303429704,5807.040107709737,139740.97045068012,279,47,194.33333333333334,27,0,19,30.39342534023386,0.683641975308642,41.22023809523809,1035.1190476190466,38.337742504409135,0
281,4,0,0,27,0.0,0.0,1.0,27,450,300,150,0.6666666666666666,6,3,3,418.37942331011243,0.7435897435897436,0.045023747151407,0.26265769571707037,133933.9303429704,5807.040107709737,139740.97045068012,280,48,195.33333333333334,27,0,19,30.39342534023386,0.683641975308642,41.22023809523809,1035.1190476190466,38.337742504409135,0
282,4,0,0,27,0.0,0.0,1.0,27,450,300,150,0.6666666666666666,6,3,3,416.62449546372824,0.7432336182336182,0.04113570310753456,0.2621042711968011,134010.95920138882,5766.449652777767,139777.4088541666,281,49,196.33333333333334,27,0,20,30.36133467471496,0.6844135802469136,41.14583333333333,1035.416666666666,38.348765432098745,0
283,4,0,0,27,0.0,0.0,1.0,27,800,700,100,0.875,9,7,2,419.35526489628757,0.7415716999050332,0.04678586632609649,0.2643761452607029,134088.0102040816,5846.102607709746,139934.11281179133,282,50,197.33333333333334,27,0,20,30.21312260536398,0.6851851851851852,41.07142857142857,1035.7142857142853,38.35978835978835,0
284,4,0,0,27,0.0,0.0,1.0,27,400,300,100,0.75,5,3,2,418.27452438288714,0.7406220322886989,0.04856688321707714,0.26397180092740485,134126.5440095308,5820.343280541369,139946.88729007216,283,51,198.33333333333334,27,0,20,30.202347603313704,0.685570987654321,41.03422619047618,1035.8630952380945,38.36529982363313,0
285,4,0,0,27,0.0,0.0,1.0,27,600,500,100,0.8333333333333334,7,5,2,417.10871424629033,0.7401471984805319,0.041254283975529216,0.25700712783665713,133241.66710955199,5715.252090419481,138956.91919997145,284,52,199.33333333333334,27,0,21,31.123882963390034,0.6766975308641976,41.88988095238094,1032.440476190475,38.23853615520278,2
286,4,0,0,27,0.0,0.0,1.0,27,450,100,350,0.2222222222222222,8,1,7,417.407336660881,0.7394349477682811,0.043035542747358546,0.2577230352692626,133318.496669501,5729.62372448978,139048.1203939908,285,53,200.33333333333334,27,0,22,31.03866474543708,0.6774691358024691,41.81547619047618,1032.7380952380943,38.24955908289238,0
287,4,0,0,27,0.0,0.0,1.0,27,400,100,300,0.25,7,1,6,431.1440072066082,0.7387226970560304,0.06388688037278056,0.25947439598204497,132359.71878985967,6013.21991035998,138372.93870021965,286,54,201.33333333333334,27,0,19,31.6541636538925,0.6678240740740741,42.745535714285715,1029.017857142857,38.11177248677249,2
288,4,0,0,27,0.0,0.0,1.0,27,600,500,100,0.8333333333333334,7,5,2,430.5922077070596,0.7378917378917379,0.060278902384165445,0.25940554952108225,132398.00347222228,6001.909722222226,138399.9131944445,287,55,202.33333333333334,27,0,19,31.629554655870443,0.6682098765432098,42.708333333333336,1029.166666666667,38.11728395061729,0
289,4,1,0,28,0.03571428571428571,0.0,1.0,28,750,400,350,0.5333333333333333,11,4,7,417.1968154718626,0.7436067019400352,0.06437131708870814,0.25457519964507536,132879.01307966714,5487.340219976229,138366.35329964338,288,0,196.07142857142858,28,0,18,31.48777173913044,0.6696428571428571,42.24137931034483,1031.0344827586214,36.82266009852219,0
290,4,0,0,28,0.0,0.0,1.0,28,1000,700,300,0.7,13,7,6,416.6270408769682,0.744047619047619,0.058004617282967574,0.2547315927951346,132953.09197053785,5478.370656625726,138431.46262716356,289,1,197.07142857142858,28,0,18,31.427626079687936,0.6703869047619047,42.169540229885065,1031.3218390804607,36.832922824302166,0
291,4,0,0,28,0.0,0.0,1.0,28,550,300,250,0.5454545454545454,8,3,5,417.63034803748144,0.7428902116402116,0.05987204743995367,0.2555983178653949,132990.1391572534,5508.1436203593785,138498.2827776128,290,2,198.07142857142858,28,0,18,31.364338115800713,0.6707589285714285,42.13362068965518,1031.4655172413804,36.83805418719216,0
292,4,0,0,28,0.0,0.0,1.0,28,650,400,250,0.6153846153846154,9,4,5,415.9795830212984,0.7396935626102292,0.05983870646964018,0.2556014837332754,133138.3795126504,5476.56951876075,138614.94903141115,291,3,199.07142857142858,28,0,19,31.257250916515854,0.6722470238095237,41.98994252873564,1032.0402298850584,36.85857963875208,0
293,4,0,0,28,0.0,0.0,1.0,28,650,400,250,0.6153846153846154,9,4,5,408.92054194749505,0.7396935626102292,0.06984138110592597,0.23928057635040859,131291.310051691,5137.542731866808,136428.85278355778,292,4,200.07142857142858,28,0,22,33.30879947661106,0.6536458333333334,43.78591954022988,1024.8563218390796,36.60201149425284,4
294,4,0,0,28,0.0,0.0,1.0,28,1000,700,300,0.7,13,7,6,409.44645477657247,0.736386684303351,0.06078782542572969,0.24097594729183433,131512.27715434667,5169.447128088254,136681.7242824349,293,5,201.07142857142858,28,0,22,33.07098333099874,0.655877976190476,43.570402298850574,1025.7183908045977,36.63279967159277,0
295,4,1,1,28,0.034482758620689655,0.034482758620689655,0.9655172413793104,29,800,600,200,0.75,10,6,4,399.14429859868886,0.7523604269293924,0.04813500188901898,0.23663783476664838,131791.20611496907,4720.741705246906,136511.94782021598,294,0,195.10344827586206,29,0,17,33.05252152937463,0.6555316091954023,43.29861111111111,1026.805555555555,35.407088122605344,0
296,4,1,1,28,0.034482758620689655,0.034482758620689655,0.9655172413793104,29,900,800,100,0.8888888888888888,10,8,2,397.8210155153899,0.7477422003284072,0.04336574106455893,0.236296097167575,131862.52170138885,4691.5364583333285,136554.0581597222,295,0,196.06896551724137,29,0,18,33.01428329952671,0.65625,43.229166666666664,1027.083333333333,35.41666666666666,0
297,4,2,1,29,0.06666666666666667,0.03333333333333333,0.9666666666666667,30,550,500,50,0.9090909090909091,6,5,1,389.1648511256353,0.7633141762452108,0.03944226579520693,0.23295079116675357,132156.03863163374,4286.097019886697,136442.13565152042,296,0,190.46666666666667,30,0,19,32.93981481481482,0.65625,42.943548387096776,1028.2258064516132,34.2741935483871,0
298,4,0,0,29,0.0,0.0,1.0,29,800,500,300,0.625,11,5,6,398.5170114995032,0.7488711001642036,0.049201179710104403,0.23804878144534497,132076.584201389,4726.953125000019,136803.53732638902,297,1,198.0344827586207,29,0,20,32.77977638157006,0.658405172413793,43.02083333333334,1027.9166666666677,35.44540229885061,0
299,4,1,0,30,0.03333333333333333,0.0,1.0,30,850,600,250,0.7058823529411765,11,6,5,384.5424673970098,0.7545019157088123,0.04370757180156626,0.23230246847484987,132501.77043588858,4190.511547577757,136692.28198346635,298,0,192.4,30,0,21,32.709693211488236,0.6597222222222221,42.60752688172043,1029.5698924731187,34.31899641577062,0
300,4,0,0,30,0.0,0.0,1.0,30,350,200,150,0.5714285714285714,5,2,3,385.88813421414886,0.7549329501915709,0.04707392420484702,0.23332983395537452,132536.36845661353,4228.842387848314,136765.21084446184,299,1,193.4,30,0,21,32.64015794282732,0.6600694444444444,42.5739247311828,1029.704301075269,34.32347670250897,0
301,4,0,0,30,0.0,0.0,1.0,30,550,200,350,0.36363636363636365,9,2,7,384.9442442520567,0.7551245210727969,0.051376745399974055,0.2331879639291313,132605.57804731763,4209.15080500636,136814.72885232398,300,2,194.4,30,0,21,32.59466483970595,0.6607638888888889,42.50672043010753,1029.97311827957,34.33243727598566,0
302,4,0,0,30,0.0,0.0,1.0,30,650,500,150,0.7692307692307693,8,5,3,384.29269398233095,0.7555555555555555,0.05177453027139878,0.23300784862979307,132640.18961729683,4194.531159671645,136834.72077696846,301,3,195.4,30,0,17,32.57654836464858,0.6611111111111111,42.473118279569896,1030.1075268817208,34.336917562724025,0
303,4,0,1,29,0.0,0.03333333333333333,0.9666666666666667,30,750,400,350,0.5333333333333333,11,4,7,392.97503358852293,0.7551724137931035,-0.0064600156290703925,0.2413809846314145,133125.22582090425,4462.978017689916,137588.20383859417,302,4,196.4,30,0,19,31.864037943908993,0.6659722222222222,42.002688172043015,1031.9892473118286,34.399641577060954,3
304,4,0,0,29,0.0,0.0,1.0,29,1000,700,300,0.7,13,7,6,403.8824685779813,0.7436371100164203,0.005569970432740323,0.2477657191631564,133077.83805941363,4949.561149691364,138027.399209105,303,5,203.9655172413793,29,0,20,31.630406739354786,0.6684626436781609,42.048611111111114,1031.8055555555559,35.579501915708825,0
305,4,0,0,29,0.0,0.0,1.0,29,400,300,100,0.75,5,3,2,403.8824685779813,0.7436371100164203,0.005569970432740323,0.2477657191631564,133077.83805941363,4949.561149691364,138027.399209105,304,6,204.9655172413793,29,0,20,31.630406739354786,0.6684626436781609,42.048611111111114,1031.8055555555559,35.579501915708825,0
306,4,0,0,29,0.0,0.0,1.0,29,550,400,150,0.7272727272727273,7,4,3,404.10449793231163,0.7442528735632183,0.005846108162280483,0.2486179328338526,133185.3395061728,4964.158950617282,138149.49845679008,305,7,205.9655172413793,29,0,20,31.516303372802305,0.6695402298850575,41.94444444444444,1032.222222222222,35.59386973180076,0
307,4,0,0,29,0.0,0.0,1.0,29,800,700,100,0.875,9,7,2,403.2482365662688,0.7429187192118226,0.0013913688750781805,0.24880918164897983,133292.8843557098,4950.02411265431,138242.9084683641,306,8,206.9655172413793,29,0,20,31.43003250392289,0.670617816091954,41.84027777777777,1032.6388888888882,35.6082375478927,0
308,4,0,0,29,0.0,0.0,1.0,29,550,100,450,0.18181818181818182,10,1,9,404.895220223671,0.7435344827586207,-0.001112646150707608,0.25054997071744267,133400.47260802452,5002.64274691356,138403.11535493808,307,9,207.9655172413793,29,0,20,31.279129694362293,0.6716954022988506,41.7361111111111,1033.055555555554,35.622605363984626,0
309,4,0,1,28,0.0,0.034482758620689655,0.9655172413793104,29,650,300,350,0.46153846153846156,10,3,7,405.17689906347545,0.743431855500821,-0.00027808676307028435,0.2512096774193546,133472.22222222213,5015.972222222204,138488.19444444432,308,10,208.9655172413793,29,0,21,31.19959677419353,0.6724137931034484,41.66666666666666,1033.3333333333326,35.63218390804595,0
310,4,0,0,28,0.0,0.0,1.0,28,500,300,200,0.6,7,3,4,414.0665717208146,0.7368827160493827,0.014408935527466138,0.25569677985646166,133323.79607609977,5440.985434007121,138764.7815101069,309,11,214.35714285714286,28,0,21,31.11957429048414,0.6741071428571429,41.8103448275862,1032.7586206896544,36.88423645320194,0
311,4,0,0,28,0.0,0.0,1.0,28,700,700,0,1.0,7,7,0,416.0346139499263,0.7349537037037036,0.02117229870671644,0.2576834546868148,133435.10794441137,5502.724724203983,138937.83266861536,310,12,215.35714285714286,28,0,21,30.956519723728732,0.6752232142857143,41.70258620689655,1033.1896551724135,36.89963054187191,0
312,4,0,0,28,0.0,0.0,1.0,28,500,200,300,0.4,8,2,6,422.8423758424045,0.73423721340388,0.0052060477919178005,0.2544871509061599,132361.03885916245,5593.571228035425,137954.61008719789,311,13,216.35714285714286,28,0,20,31.866389742157686,0.6644345238095237,42.74425287356323,1029.022988505748,36.750821018062425,2
313,4,0,0,28,0.0,0.0,1.0,28,200,100,100,0.5,3,1,2,422.39669556950605,0.7337411816578483,0.009109311740890691,0.2544682531845561,132398.0034722223,5584.895833333338,137982.89930555565,312,14,217.35714285714286,28,0,20,31.840418353576236,0.6648065476190477,42.708333333333336,1029.1666666666672,36.7559523809524,0
314,4,0,0,28,0.0,0.0,1.0,28,600,400,200,0.6666666666666666,8,4,4,422.92274387633944,0.7328042328042328,0.009541756401052925,0.2550352303981561,132434.97324613552,5601.95245408904,138036.92570022456,313,15,218.35714285714286,28,0,20,31.789444909733845,0.6651785714285714,42.672413793103445,1029.3103448275858,36.76108374384235,0
315,4,0,0,28,0.0,0.0,1.0,28,750,600,150,0.8,9,6,3,422.79167016850437,0.7308752204585538,0.0166188283601425,0.255708683552546,132545.91353299643,5607.861631325144,138153.7751643216,314,16,219.35714285714286,28,0,20,31.680503232407798,0.6662946428571428,42.564655172413794,1029.7413793103449,36.77647783251232,0
316,4,0,0,28,0.0,0.0,1.0,28,800,600,200,0.75,10,6,4,419.80959814016137,0.7303240740740741,0.014302652292609075,0.2544053262102126,132619.89952850435,5535.0213452899925,138154.92087379436,315,17,220.35714285714286,28,0,21,31.68241735248989,0.6670386904761905,42.49281609195402,1030.0287356321833,36.78674055829226,0
317,4,0,0,28,0.0,0.0,1.0,28,600,500,100,0.8333333333333334,7,5,2,421.57408542100694,0.7313712522045855,0.014156206415620654,0.25572641222238734,132656.9002675386,5584.942281014657,138241.84254855325,316,18,221.35714285714286,28,0,18,31.599546722454672,0.6674107142857143,42.456896551724135,1030.172413793103,36.79187192118225,0
318,4,0,0,28,0.0,0.0,1.0,28,700,300,400,0.42857142857142855,11,3,8,421.14108625319585,0.7315917107583774,0.016174010039041065,0.2559681246277898,132730.9172281674,5579.688532170683,138310.6057603381,317,19,222.35714285714286,28,0,19,31.535833798103745,0.6681547619047619,42.38505747126436,1030.4597701149416,36.8021346469622,0
319,4,0,0,28,0.0,0.0,1.0,28,900,800,100,0.8888888888888888,10,8,2,420.0782333159319,0.7295524691358024,0.01746640119462395,0.2560799765541047,132841.98137551203,5560.804969282609,138402.78634479464,318,20,223.35714285714286,28,0,19,31.450929152148664,0.6692708333333333,42.27729885057472,1030.8908045977016,36.8175287356322,0
320,4,1,1,28,0.034482758620689655,0.034482758620689655,0.9655172413793104,29,850,700,150,0.8235294117647058,10,7,3,409.6445012461747,0.7391215106732348,0.003897405441519952,0.252026318978607,133185.33950617295,5111.728395061742,138297.0679012347,319,0,216.6206896551724,29,0,19,31.373340509508434,0.6695402298850575,41.94444444444445,1032.222222222223,35.593869731800794,0
321,4,0,0,28,0.0,0.0,1.0,28,650,500,150,0.7692307692307693,8,5,3,418.94771145475306,0.7270723104056437,0.018463987266215565,0.2566590928536797,133027.19150482232,5546.287488439695,138573.47899326202,320,22,225.35714285714286,28,0,19,31.292943361188488,0.6711309523809523,42.09770114942529,1031.609195402299,36.84318555008211,0
322,4,0,0,28,0.0,0.0,1.0,28,1000,700,300,0.7,13,7,6,416.16894463978053,0.7285052910052909,0.01729553496878844,0.25648285044437946,133249.61396815968,5490.870243757439,138740.48421191712,321,23,226.35714285714286,28,0,21,31.140121996474615,0.6733630952380952,41.88218390804598,1032.4712643678167,36.873973727422026,0
323,4,0,0,28,0.0,0.0,1.0,28,800,500,300,0.625,11,5,6,412.1313433537777,0.7273478835978836,0.018291713848659796,0.25526584755013054,133435.10794441137,5398.558057537316,138833.66600194867,322,24,227.35714285714286,28,0,21,31.057340193760712,0.6752232142857143,41.70258620689655,1033.1896551724135,36.89963054187191,0
324,4,0,0,28,0.0,0.0,1.0,28,400,200,200,0.5,6,2,4,412.51874374906384,0.7274581128747795,0.018574606264026627,0.2560178881610884,133509.3416608864,5415.021180142671,138924.36284102907,323,25,228.35714285714286,28,0,21,30.97253116455813,0.6759672619047619,41.63074712643677,1033.4770114942519,36.90989326765185,0
325,4,0,0,28,0.0,0.0,1.0,28,500,300,200,0.6,7,3,4,412.2094671372919,0.7250330687830687,0.023175816539263483,0.256339422303614,133583.59602077544,5412.884586801418,138996.48060757684,324,26,229.35714285714286,28,0,21,30.90572156590224,0.6767113095238095,41.558908045977006,1033.7643678160912,36.92015599343183,0
326,4,0,0,28,0.0,0.0,1.0,28,550,500,50,0.9090909090909091,6,5,1,412.8283269341939,0.7251432980599647,0.021442466106909475,0.2572403003415925,133657.87102407846,5435.551055291315,139093.42207936978,325,27,230.35714285714286,28,0,22,30.814922884535225,0.6774553571428572,41.48706896551724,1034.0517241379307,36.93041871921181,0
327,4,0,0,28,0.0,0.0,1.0,28,650,300,350,0.46153846153846156,10,3,7,410.4791761122076,0.7237103174603174,0.023738416049847944,0.25629137804265234,133732.16667079527,5378.853918945686,139111.02058974095,326,28,231.35714285714286,28,0,17,30.800863545862867,0.6781994047619048,41.415229885057464,1034.3390804597693,36.94068144499176,0
328,4,0,0,28,0.0,0.0,1.0,28,500,400,100,0.8,6,4,2,410.4791761122076,0.7237103174603174,0.023738416049847944,0.25629137804265234,133732.16667079527,5378.853918945686,139111.02058974095,327,29,232.35714285714286,28,0,17,30.800863545862867,0.6781994047619048,41.415229885057464,1034.3390804597693,36.94068144499176,0
329,4,0,0,28,0.0,0.0,1.0,28,900,700,200,0.7777777777777778,11,7,4,412.1335285949643,0.7215057319223985,0.02947680529937924,0.2583636036962164,133880.81989447083,5435.354942859028,139316.17483732986,328,30,233.35714285714286,28,0,17,30.608484890554866,0.6796875,41.27155172413793,1034.913793103448,36.96120689655171,0
330,4,0,0,28,0.0,0.0,1.0,28,800,400,400,0.5,12,4,8,412.27863202473594,0.7215608465608465,0.03334522818286345,0.25923907699565857,133992.36400118907,5448.437706434143,139440.8017076232,329,31,234.35714285714286,28,0,17,30.492529373670102,0.6808035714285714,41.16379310344828,1035.344827586207,36.97660098522168,0
331,4,0,0,28,0.0,0.0,1.0,28,700,400,300,0.5714285714285714,10,4,6,411.6699320399949,0.7220017636684303,0.034198113207547065,0.25938084529233263,134066.75254326867,5438.250181662052,139505.00272493073,330,32,235.35714285714286,28,0,18,30.433488253792078,0.6815476190476191,41.09195402298851,1035.6321839080465,36.98686371100166,0
332,4,1,1,28,0.034482758620689655,0.034482758620689655,0.9655172413793104,29,1100,800,300,0.7272727272727273,14,8,6,400.5519842767027,0.7253694581280788,0.022172436889391856,0.2544783457553691,134370.7200038581,4964.491705246921,139335.211709105,331,0,228.20689655172413,29,0,18,30.41624804643894,0.6813936781609196,40.798611111111114,1036.8055555555559,35.75191570881227,0
333,4,0,0,28,0.0,0.0,1.0,28,300,100,200,0.3333333333333333,5,1,4,411.98635736696406,0.7211199294532628,0.033039429363978634,0.26010697343395905,134141.16172876215,5452.865718721112,139594.02744748327,332,34,237.35714285714286,28,0,18,30.350496994914476,0.6822916666666666,41.02011494252874,1035.9195402298858,36.997126436781635,0
334,4,0,0,28,0.0,0.0,1.0,28,250,100,150,0.4,4,1,3,411.31842961456533,0.7199625220458553,0.03404025595815918,0.2599489216433506,134178.37406278893,5438.007621548409,139616.38168433734,333,35,238.35714285714286,28,0,19,30.33039800305089,0.6826636904761905,40.984195402298845,1036.063218390804,37.00225779967157,0
335,4,0,0,28,0.0,0.0,1.0,28,850,600,250,0.7058823529411765,11,6,5,412.8586629087473,0.7199625220458553,0.03460517716028577,0.26145298819673335,134252.8142134033,5485.487473576422,139738.3016869797,334,36,239.35714285714286,28,0,19,30.215698507324742,0.6834077380952381,40.91235632183908,1036.3505747126433,37.01252052545154,0
336,4,0,0,28,0.0,0.0,1.0,28,550,200,350,0.36363636363636365,9,2,7,413.1260189406224,0.7193562610229276,0.03531823042496729,0.26188849741982845,134290.0420299906,5495.742089443765,139785.78411943436,335,37,240.35714285714286,28,0,19,30.17136817299694,0.6837797619047619,40.876436781609186,1036.4942528735621,37.017651888341504,0
337,4,0,0,28,0.0,0.0,1.0,28,550,400,150,0.7272727272727273,7,4,3,412.6566025978239,0.7177028218694885,0.03358607855559059,0.26212412362199816,134364.51314572612,5489.280700885206,139853.7938466113,336,38,241.35714285714286,28,0,20,30.108728288987443,0.6845238095238095,40.80459770114943,1036.7816091954032,37.02791461412154,0
338,4,0,0,28,0.0,0.0,1.0,28,700,600,100,0.8571428571428571,8,6,2,412.6566025978239,0.7177028218694885,0.03358607855559059,0.26212412362199816,134364.51314572612,5489.280700885206,139853.7938466113,337,39,242.35714285714286,28,0,20,30.108728288987443,0.6845238095238095,40.80459770114943,1036.7816091954032,37.02791461412154,0
339,4,0,0,28,0.0,0.0,1.0,28,500,100,400,0.2,9,1,8,414.162337612511,0.7154982363315696,0.030698456667986207,0.2641565439542691,134513.51730743807,5542.086553705889,140055.60386114396,338,40,243.35714285714286,28,0,20,29.92007156048016,0.6860119047619048,40.66091954022988,1037.356321839079,37.0484400656814,0
340,4,0,0,28,0.0,0.0,1.0,28,650,400,250,0.6153846153846154,9,4,5,415.63845744423486,0.7142305996472663,0.03427997705106134,0.2653691689836267,134550.78125,5584.895833333333,140135.67708333334,339,41,244.35714285714286,28,0,20,29.84437751004016,0.6863839285714286,40.625,1037.5,37.05357142857143,0
341,4,0,0,28,0.0,0.0,1.0,28,450,200,250,0.4444444444444444,7,2,5,415.9745213734438,0.7144510582010581,0.04086647811554389,0.26612789795220393,134625.32461768386,5600.1409945171,140225.46561220096,340,42,245.35714285714286,28,0,20,29.760833448705533,0.6871279761904763,40.553160919540225,1037.7873563218382,37.06383415435136,0
342,4,0,0,28,0.0,0.0,1.0,28,800,600,200,0.75,10,6,4,415.86340937518344,0.7156635802469136,0.043136847931368516,0.26715065418261774,134774.47328329366,5609.554391267011,140384.02767456067,341,43,246.35714285714286,28,0,21,29.61406300447397,0.6886160714285714,40.40948275862069,1038.362068965517,37.084359605911324,0
343,4,0,0,28,0.0,0.0,1.0,28,750,500,250,0.6666666666666666,10,5,5,419.42889410693334,0.7158840388007054,0.0419671256692411,0.27055221527986045,134923.7045225591,5718.180035341523,140641.88455790063,342,44,247.35714285714286,28,0,17,29.371801963767105,0.6901041666666667,40.26580459770115,1038.9367816091954,37.104885057471265,0
344,4,0,0,28,0.0,0.0,1.0,28,250,100,150,0.4,4,1,3,419.48632613654183,0.7150573192239859,0.03895385587863465,0.27086831344816686,134961.02523450906,5722.860929449054,140683.88616395812,343,45,248.35714285714286,28,0,17,29.332883941740413,0.6904761904761905,40.22988505747126,1039.080459770114,37.11001642036121,0
345,4,0,1,27,0.0,0.03571428571428571,0.9642857142857143,28,800,700,100,0.875,9,7,2,418.6255766404673,0.7124669312169312,0.04051239016684782,0.27115094422504743,135073.01833548018,5709.004037851756,140782.02237333194,344,46,249.35714285714286,28,0,17,29.242973969131533,0.6915922619047621,40.122126436781606,1039.511494252873,37.12541050903118,0
346,4,1,0,28,0.03571428571428571,0.0,1.0,28,250,0,250,0.0,5,0,5,415.6813741949272,0.720568783068783,0.05092738752959747,0.2706414702492148,135259.77672083484,5644.993972123111,140904.77069295794,345,0,245.71428571428572,28,0,18,29.132424033149167,0.693452380952381,39.94252873563217,1040.22988505747,37.15106732348107,0
347,4,0,0,28,0.0,0.0,1.0,28,950,600,350,0.631578947368421,13,6,7,416.24581505307344,0.7202932098765432,0.053519754325872304,0.27586263742832456,135895.72031064206,5713.20497258554,141608.9252832276,346,1,246.71428571428572,28,0,18,28.481695833907494,0.6997767857142856,39.331896551724135,1042.6724137931033,37.23830049261083,1
348,4,0,0,28,0.0,0.0,1.0,28,750,500,250,0.6666666666666666,10,5,5,416.1342956234015,0.718694885361552,0.053069657615112176,0.27666071302434936,136008.1004756243,5719.527018100149,141727.62749372443,347,2,247.71428571428572,28,0,18,28.372359963269048,0.7008928571428572,39.224137931034484,1043.1034482758623,37.2536945812808,0
349,4,0,0,28,0.0,0.0,1.0,28,800,500,300,0.625,11,5,6,414.58555887764845,0.7175374779541446,0.054346115253703475,0.27592169963433594,136045.5708523253,5680.505804928,141726.0766572533,348,3,248.71428571428572,28,0,18,28.37533856677226,0.7012648809523809,39.1882183908046,1043.2471264367819,37.25882594417078,0
350,4,0,0,28,0.0,0.0,1.0,28,550,400,150,0.7272727272727273,7,4,3,415.5778285777912,0.7174823633156966,0.055051737026399206,0.27687396248916685,136083.04638987975,5710.619384991406,141793.66577487116,349,4,249.71428571428572,28,0,18,28.31204672725604,0.7016369047619048,39.15229885057471,1043.390804597701,37.26395730706075,0
351,4,0,0,28,0.0,0.0,1.0,28,450,300,150,0.6666666666666666,6,3,3,415.6015954831258,0.7168761022927689,0.0580387875926911,0.27718222111973745,136120.52708828772,5714.38164717928,141834.908735467,350,5,250.71428571428572,28,0,18,28.2740144109413,0.7020089285714286,39.116379310344826,1043.5344827586205,37.26908866995073,0
352,4,0,0,28,0.0,0.0,1.0,28,600,400,200,0.6666666666666666,8,4,4,414.3388916920569,0.7171516754850088,0.05731788860918785,0.27663214239440276,136158.01294754932,5683.112035936068,141841.12498348538,351,6,251.71428571428572,28,0,18,28.26954845814977,0.7023809523809523,39.08045977011495,1043.678160919541,37.274220032840745,0
353,4,0,0,28,0.0,0.0,1.0,28,750,500,250,0.6666666666666666,10,5,5,413.05579667798804,0.7166005291005291,0.057302111596083005,0.2763594308160462,136233.00014863265,5654.36608204519,141887.36623067784,352,7,252.71428571428572,28,0,18,28.228220478943022,0.703125,39.008620689655174,1043.9655172413798,37.284482758620705,0
354,4,0,0,28,0.0,0.0,1.0,28,1200,1000,200,0.8333333333333334,14,10,4,414.86847027673707,0.7140101410934744,0.05143662912957181,0.27845603974530025,136345.5196566587,5713.091433808954,142058.61109046766,353,8,253.71428571428572,28,0,19,28.068682074563217,0.7042410714285714,38.900862068965516,1044.3965517241377,37.29987684729063,0
355,4,0,0,28,0.0,0.0,1.0,28,600,500,100,0.8333333333333334,7,5,2,414.86847027673707,0.7140101410934744,0.05143662912957181,0.27845603974530025,136345.5196566587,5713.091433808954,142058.61109046766,354,9,254.71428571428572,28,0,19,28.068682074563217,0.7042410714285714,38.900862068965516,1044.3965517241377,37.29987684729063,0
356,4,0,0,28,0.0,0.0,1.0,28,1100,700,400,0.6363636363636364,15,7,8,415.939765043611,0.7135141093474426,0.053551783749803405,0.2800661084626981,136458.08561236627,5751.668813581722,142209.754425948,355,10,255.71428571428572,28,0,19,27.92846993032636,0.7053571428571428,38.793103448275865,1044.827586206897,37.315270935960605,0
357,4,0,0,28,0.0,0.0,1.0,28,800,800,0,1.0,8,8,0,414.68249075943817,0.7137896825396824,0.04854688267059393,0.2801128245380606,136570.69801575507,5726.695443585679,142297.39345934076,356,11,256.7142857142857,28,0,20,27.849083619702167,0.7064732142857142,38.685344827586206,1045.2586206896553,37.33066502463055,0
358,4,0,0,28,0.0,0.0,1.0,28,650,400,250,0.6153846153846154,9,4,5,413.92344445549253,0.7130731922398589,0.04953663708474032,0.2798984183883053,136608.2458052584,5709.071128947038,142317.31693420545,357,12,257.7142857142857,28,0,21,27.831512277808322,0.7068452380952381,38.64942528735633,1045.4022988505756,37.33579638752055,0
359,4,0,0,28,0.0,0.0,1.0,28,150,0,150,0.0,3,0,3,414.1063586596767,0.7119157848324514,0.05223404464162984,0.28032111367129947,136645.79875561508,5717.178829766157,142362.97758538125,358,13,258.7142857142857,28,0,21,27.789324813338823,0.7072172619047619,38.61350574712644,1045.5459770114949,37.34092775041053,0
360,4,0,0,28,0.0,0.0,1.0,28,700,400,300,0.5714285714285714,10,4,6,408.873852795556,0.7106481481481481,0.049793956043955756,0.27766806421190754,136758.48857180602,5583.394024970272,142341.8825967763,359,14,259.7142857142857,28,0,21,27.813930860805858,0.7083333333333333,38.50574712643678,1045.9770114942528,37.35632183908046,0
361,4,0,0,28,0.0,0.0,1.0,28,550,100,450,0.18181818181818182,10,1,9,409.25594012709416,0.710923721340388,0.04877797610874657,0.2788223584607696,136871.22483567838,5603.072359294481,142474.29719497287,360,15,260.7142857142857,28,0,22,27.691770790425192,0.7094494047619048,38.39798850574712,1046.408045977011,37.371715927750394,0
362,4,0,0,28,0.0,0.0,1.0,28,950,800,150,0.8421052631578947,11,8,3,408.5029128308231,0.7096009700176367,0.05359839199921557,0.2789075651333221,136946.40814919415,5588.601326132921,142535.00947532707,361,16,261.7142857142857,28,0,22,27.636696408144594,0.7101934523809523,38.32614942528736,1046.6954022988511,37.381978653530396,0
363,4,0,0,28,0.0,0.0,1.0,28,750,500,250,0.6666666666666666,10,5,5,407.0007728621043,0.7102072310405644,0.05145876632288937,0.27818082843089026,136984.00754723203,5550.519388294342,142534.52693552637,362,17,262.7142857142857,28,0,19,27.638622014822943,0.7105654761904763,38.290229885057464,1046.8390804597693,37.38711001642033,0
364,4,0,0,28,0.0,0.0,1.0,28,650,500,150,0.7692307692307693,8,5,3,408.02221167238963,0.7101521164021164,0.05216236350447945,0.2791791414513337,137021.61210612368,5581.572243691375,142603.18434981504,363,18,263.7142857142857,28,0,19,27.57450482594575,0.7109375,38.25431034482759,1046.9827586206898,37.39224137931035,0
365,4,0,0,28,0.0,0.0,1.0,28,850,600,250,0.7058823529411765,11,6,5,405.9138797806967,0.708939594356261,0.05300060756913538,0.2783354910368296,137096.83670646723,5529.901778636549,142626.7384851038,364,19,264.7142857142857,28,0,20,27.554934376000368,0.7116815476190477,38.18247126436782,1047.270114942529,37.40250410509032,0
366,4,0,0,28,0.0,0.0,1.0,28,900,600,300,0.6666666666666666,12,6,6,405.3634505881221,0.7079475308641975,0.054391686744627465,0.2791610618639447,137247.347837396,5527.011700687015,142774.35953808302,365,20,265.7142857142857,28,0,20,27.419843228666753,0.7131696428571428,38.03879310344828,1047.8448275862072,37.423029556650256,0
367,4,0,0,28,0.0,0.0,1.0,28,500,300,200,0.6,7,3,4,404.0912713094565,0.706900352733686,0.050834345254416435,0.2785861751352719,137284.9885222619,5495.133108732996,142780.1216309949,366,21,266.7142857142857,28,0,20,27.41579837309204,0.7135416666666666,38.002873563218394,1047.9885057471267,37.42816091954024,0
368,4,0,0,28,0.0,0.0,1.0,28,600,400,200,0.6666666666666666,8,4,4,406.476026910897,0.7052469135802468,0.060456876639392476,0.28144801180225093,137435.60287026016,5572.855562161435,143008.45843242158,367,22,267.7142857142857,28,0,20,27.203800127888922,0.715029761904762,37.859195402298845,1048.5632183908037,37.44868637110013,0
369,4,0,0,28,0.0,0.0,1.0,28,550,300,250,0.5454545454545454,8,3,5,403.7251868745814,0.7041997354497355,0.06709941886629989,0.2804564785319997,137548.61782022053,5506.368286761773,143054.9861069823,368,23,268.7142857142857,28,0,20,27.163801762315657,0.7161458333333334,37.751436781609186,1048.9942528735623,37.46408045977008,0
370,4,0,0,28,0.0,0.0,1.0,28,950,700,250,0.7368421052631579,12,7,5,404.46558017260674,0.705081569664903,0.06991745075409339,0.28158361601530496,137623.98692446173,5532.833143413941,143156.82006787567,369,24,269.7142857142857,28,0,20,27.069640330457805,0.7168898809523809,37.67959770114943,1049.281609195403,37.474343185550104,0
371,4,0,0,28,0.0,0.0,1.0,28,800,500,300,0.625,11,5,6,407.22335473980155,0.7044753086419753,0.07314927065816712,0.28443344452475994,137737.0792872242,5617.9510998810865,143355.03038710527,370,25,270.7142857142857,28,0,20,26.885151473674597,0.7180059523809523,37.57183908045977,1049.7126436781607,37.489737274220026,0
372,4,0,0,28,0.0,0.0,1.0,28,750,600,150,0.8,9,6,3,407.22335473980155,0.7044753086419753,0.07314927065816712,0.28443344452475994,137737.0792872242,5617.9510998810865,143355.03038710527,371,26,271.7142857142857,28,0,20,26.885151473674597,0.7180059523809523,37.57183908045977,1049.7126436781607,37.489737274220026,0
373,4,0,0,28,0.0,0.0,1.0,28,350,200,150,0.5714285714285714,5,2,3,407.98625556637023,0.7019951499118166,0.07609502961124237,0.2859033117866347,137850.21809766805,5648.198862135012,143498.41695980306,372,27,272.7142857142857,28,0,20,26.75297578328088,0.7191220238095238,37.46408045977011,1050.143678160919,37.50513136288997,0
374,4,0,0,28,0.0,0.0,1.0,28,1050,800,250,0.7619047619047619,13,8,5,407.28412250977857,0.7024360670194003,0.07295757859976115,0.28603786932459085,137925.66977556478,5634.987077222875,143560.65685278765,373,28,273.7142857142857,28,0,20,26.6966443259016,0.7198660714285714,37.39224137931034,1050.4310344827584,37.51539408866994,0
375,4,0,0,28,0.0,0.0,1.0,28,500,300,200,0.6,7,3,4,407.28412250977857,0.7024360670194003,0.07295757859976115,0.28603786932459085,137925.66977556478,5634.987077222875,143560.65685278765,374,29,274.7142857142857,28,0,20,26.6966443259016,0.7198660714285714,37.39224137931034,1050.4310344827584,37.51539408866994,0
376,4,0,0,28,0.0,0.0,1.0,28,650,500,150,0.7692307692307693,8,5,3,416.404019457778,0.7017195767195766,0.0869031243859304,0.27978347702939443,136383.0364810412,5758.088915312473,142141.12539635366,375,30,275.7142857142857,28,0,20,27.991173773498392,0.7046130952380952,38.86494252873564,1044.5402298850584,37.30500821018065,2
377,4,0,0,28,0.0,0.0,1.0,28,750,500,250,0.6666666666666666,10,5,5,415.9397650436111,0.7016093474426808,0.08460042432814707,0.28006610846269814,136458.08561236624,5751.66881358172,142209.75442594796,376,31,276.7142857142857,28,0,20,27.92846993032637,0.7053571428571428,38.793103448275865,1044.8275862068967,37.3152709359606,0
378,4,0,0,28,0.0,0.0,1.0,28,650,500,150,0.7692307692307693,8,5,3,415.8497809941367,0.7027667548500881,0.08473119758009084,0.28030356414924534,136495.61791930906,5752.334563680812,142247.95248298987,377,32,277.7142857142857,28,0,20,27.893407122232915,0.7057291666666666,38.75718390804598,1044.9712643678165,37.32040229885059,0
379,4,0,0,28,0.0,0.0,1.0,28,750,600,150,0.8,9,6,3,417.5427309549959,0.7019951499118166,0.08613156602847316,0.28204488093756674,136570.69801575504,5804.820443585677,142375.51845934073,378,33,278.7142857142857,28,0,20,27.77434135166093,0.7064732142857142,38.685344827586206,1045.2586206896551,37.33066502463054,0
380,4,0,0,28,0.0,0.0,1.0,28,900,700,200,0.7777777777777778,11,7,4,415.86554199977473,0.7013888888888888,0.08453067954304538,0.28181279466241715,136683.35686682517,5768.379657154173,142451.73652397934,379,34,279.7142857142857,28,0,20,27.705928826600715,0.7075892857142858,38.57758620689655,1045.6896551724135,37.346059113300484,0
381,4,0,0,28,0.0,0.0,1.0,28,650,400,250,0.6153846153846154,9,4,5,414.08911303784737,0.6990189594356261,0.0880520729099219,0.28151100205682233,136796.0621655767,5729.152009842781,142525.21417541947,380,35,280.7142857142857,28,0,20,27.640147873460606,0.7087053571428572,38.4698275862069,1046.1206896551726,37.36145320197045,0
382,4,0,0,28,0.0,0.0,1.0,28,1200,1000,200,0.8333333333333334,14,10,4,415.48385325326507,0.6977513227513227,0.09188017420645767,0.2827620018121755,136833.64092020085,5770.433676839745,142604.0745970406,381,36,281.7142857142857,28,0,20,27.566259269431477,0.7090773809523809,38.43390804597701,1046.2643678160923,37.36658456486044,0
383,4,0,0,28,0.0,0.0,1.0,28,500,300,200,0.6,7,3,4,421.4270556428107,0.6967041446208112,0.08304516965636499,0.28345940070109865,136420.5584662769,5898.262856718197,142318.82132299512,382,37,282.7142857142857,28,0,19,27.82257140237474,0.7049851190476191,38.82902298850575,1044.683908045977,37.31013957307061,1
384,4,0,0,28,0.0,0.0,1.0,28,600,400,200,0.6666666666666666,8,4,4,418.39361520299383,0.6948302469135802,0.07875017186855482,0.2820182357156047,136495.61791930906,5821.779008125257,142317.3969274343,383,38,283.7142857142857,28,0,20,27.82695128099363,0.7057291666666666,38.75718390804598,1044.9712643678165,37.32040229885059,0
385,4,0,0,28,0.0,0.0,1.0,28,700,500,200,0.7142857142857143,9,5,4,415.82974714704375,0.6936728395061728,0.0737355689939525,0.28118747585891163,136608.24580525822,5761.154462280342,142369.40026753856,384,39,284.7142857142857,28,0,20,27.781690947406993,0.7068452380952381,38.649425287356316,1045.4022988505742,37.33579638752051,0
386,4,0,0,28,0.0,0.0,1.0,28,600,500,100,0.8333333333333334,7,5,2,416.81816956408164,0.6919091710758377,0.07371530640285773,0.2824583461906318,136683.35686682517,5794.421323820841,142477.778190646,385,40,285.7142857142857,28,0,20,27.681025006870012,0.7075892857142858,38.57758620689655,1045.6896551724135,37.346059113300484,0
387,4,0,0,28,0.0,0.0,1.0,28,700,500,200,0.7142857142857143,9,5,4,417.3870158448281,0.6898148148148148,0.06940793345627183,0.28405721956841473,136833.64092020076,5822.517010173064,142656.15793037383,386,41,286.7142857142857,28,0,21,27.516478989288657,0.7090773809523809,38.433908045977006,1046.2643678160914,37.36658456486041,0
388,4,0,0,28,0.0,0.0,1.0,28,600,400,200,0.6666666666666666,8,4,4,416.54939344489236,0.6889880952380952,0.06555873756889796,0.28379132202611324,136871.2248356784,5802.725137072259,142673.94997275068,387,42,287.7142857142857,28,0,22,27.500972584557644,0.7094494047619048,38.39798850574712,1046.4080459770112,37.3717159277504,0
389,4,0,0,28,0.0,0.0,1.0,28,750,500,250,0.6666666666666666,10,5,5,414.04062559339275,0.6890983245149911,0.07035523142974798,0.2832970928355919,137021.61210612368,5746.50279924693,142768.1149053706,388,43,288.7142857142857,28,0,19,27.41697543570742,0.7109375,38.25431034482759,1046.9827586206898,37.39224137931035,0
390,4,0,0,28,0.0,0.0,1.0,28,550,400,150,0.7272727272727273,7,4,3,414.04062559339275,0.6890983245149911,0.07035523142974798,0.2832970928355919,137021.61210612368,5746.50279924693,142768.1149053706,389,44,289.7142857142857,28,0,19,27.41697543570742,0.7109375,38.25431034482759,1046.9827586206898,37.39224137931035,0
391,4,0,0,28,0.0,0.0,1.0,28,700,600,100,0.8571428571428571,8,6,2,415.0948396466818,0.6876653439153438,0.0737461536953925,0.2846308829900905,137096.83670646712,5781.637889747648,142878.47459621477,390,45,290.7142857142857,28,0,19,27.314560753647054,0.7116815476190477,38.18247126436781,1047.2701149425282,37.402504105090294,0
392,4,0,0,28,0.0,0.0,1.0,28,450,200,250,0.4444444444444444,7,2,5,413.5713976800894,0.6861221340388006,0.06974841781452712,0.2841987804416145,137172.08195022447,5746.089930968407,142918.1718811929,391,46,291.7142857142857,28,0,19,27.27963699538244,0.7124255952380953,38.11063218390804,1047.5574712643668,37.41276683087024,0
393,4,0,0,28,0.0,0.0,1.0,28,300,0,300,0.0,6,0,6,413.5713976800894,0.6861221340388006,0.06974841781452712,0.2841987804416145,137172.08195022447,5746.089930968407,142918.1718811929,392,47,292.7142857142857,28,0,19,27.27963699538244,0.7124255952380953,38.11063218390804,1047.5574712643668,37.41276683087024,0
394,4,0,0,28,0.0,0.0,1.0,28,400,200,200,0.5,6,2,4,413.2678407705047,0.6856261022927689,0.07272157354439313,0.28429708442438845,137209.71231338344,5740.87230809881,142950.58462148224,393,48,293.7142857142857,28,0,19,27.250182848784053,0.7127976190476191,38.074712643678154,1047.7011494252865,37.41789819376023,0
395,4,0,0,28,0.0,0.0,1.0,28,650,300,350,0.46153846153846156,10,3,7,413.9018669470918,0.6866732804232804,0.07143346849229237,0.28504120072192063,137247.34783739585,5761.3867006870005,143008.73453808285,394,49,294.7142857142857,28,0,19,27.19616984322867,0.713169642857143,38.03879310344827,1047.844827586206,37.423029556650214,0
396,4,0,0,28,0.0,0.0,1.0,28,700,500,200,0.7142857142857143,9,5,4,413.52229472049095,0.6838624338624338,0.0769403978696741,0.28570631271597535,137360.285374554,5760.308082309402,143120.5934568634,395,50,295.7142857142857,28,0,19,27.093898483187132,0.7142857142857144,37.93103448275861,1048.2758620689647,37.438423645320164,0
397,4,0,0,28,0.0,0.0,1.0,28,1050,800,250,0.7619047619047619,13,8,5,411.14753880501087,0.6842482363315696,0.07903724580666638,0.2849920119409088,137473.2693593933,5704.359269718549,143177.62862911186,396,51,296.7142857142857,28,0,19,27.04394437594191,0.7154017857142858,37.82327586206895,1048.706896551722,37.45381773399007,0
398,4,0,1,27,0.0,0.03571428571428571,0.9642857142857143,28,850,600,250,0.7058823529411765,11,6,5,412.9806292290133,0.6822641093474426,0.08012851861270343,0.2875116811496169,137623.9869244614,5767.208143413897,143391.19506787532,397,52,297.7142857142857,28,0,19,26.846273221050716,0.716889880952381,37.67959770114941,1049.2816091954007,37.474343185550026,0
399,4,0,0,27,0.0,0.0,1.0,27,550,200,350,0.36363636363636365,9,2,7,417.79709270157434,0.6835232668566003,0.0888468610454427,0.2904802271741715,137578.22464923467,6095.956455498866,143674.18110473355,398,53,299.44444444444446,27,0,20,26.765366430260052,0.7199074074074074,37.723214285714285,1049.1071428571427,38.8558201058201,0
400,4,0,0,27,0.0,0.0,1.0,27,650,200,450,0.3076923076923077,11,2,9,414.6046675945623,0.6824548907882242,0.0855743025032687,0.2892390425859987,137695.33741230867,6017.8259194302655,143713.16333173894,399,54,300.44444444444446,27,0,20,26.73286190273641,0.7210648148148149,37.61160714285714,1049.5535714285713,38.87235449735449,0
401,4,0,0,27,0.0,0.0,1.0,27,750,400,350,0.5333333333333333,11,4,7,413.7284662712506,0.682573599240266,0.08173980615148713,0.28895451495815855,137734.3860721372,5996.927260487521,143731.3133326247,400,55,301.44444444444446,27,0,21,26.717110859087033,0.7214506172839507,37.57440476190476,1049.702380952381,38.8778659611993,0
402,4,0,0,27,0.0,0.0,1.0,27,550,400,150,0.7272727272727273,7,4,3,413.7284662712506,0.682573599240266,0.08173980615148713,0.28895451495815855,137734.3860721372,5996.927260487521,143731.3133326247,401,56,302.44444444444446,27,0,21,26.717110859087033,0.7214506172839507,37.57440476190476,1049.702380952381,38.8778659611993,0
403,4,0,0,27,0.0,0.0,1.0,27,450,300,150,0.6666666666666666,6,3,3,413.7284662712506,0.682573599240266,0.08173980615148713,0.28895451495815855,137734.3860721372,5996.927260487521,143731.3133326247,402,57,303.44444444444446,27,0,21,26.717110859087033,0.7214506172839507,37.57440476190476,1049.702380952381,38.8778659611993,0
404,4,0,0,27,0.0,0.0,1.0,27,550,300,250,0.5454545454545454,8,3,5,413.7861823748909,0.6826923076923077,0.07996430165104895,0.2893222514028596,137773.44026803417,6001.749176232976,143775.18944426716,403,58,304.44444444444446,27,0,21,26.676854476730462,0.7218364197530864,37.53720238095237,1049.8511904761895,38.88337742504405,0
405,4,0,0,27,0.0,0.0,1.0,27,600,500,100,0.8333333333333334,7,5,2,413.7861823748909,0.6826923076923077,0.07996430165104895,0.2893222514028596,137773.44026803417,6001.749176232976,143775.18944426716,404,59,305.44444444444446,27,0,21,26.676854476730462,0.7218364197530864,37.53720238095237,1049.8511904761895,38.88337742504405,0
406,4,0,0,27,0.0,0.0,1.0,27,700,600,100,0.8571428571428571,8,6,2,415.72184429327274,0.6815052231718899,0.08348030570252774,0.291005291005291,137812.50000000003,6058.333333333334,143870.83333333337,405,60,306.44444444444446,27,0,21,26.587301587301578,0.7222222222222222,37.5,1050.0000000000002,38.8888888888889,0
407,4,0,0,27,0.0,0.0,1.0,27,400,300,100,0.75,5,3,2,414.81108234855736,0.6811490978157645,0.0799416392444594,0.2906972997153692,137851.5652680342,6036.471398455204,143888.0366664894,406,61,307.44444444444446,27,0,22,26.572463511407122,0.722608024691358,37.46279761904761,1050.1488095238087,38.894400352733655,0
408,4,0,0,27,0.0,0.0,1.0,27,650,500,150,0.7692307692307693,8,5,3,417.0368001325857,0.681980056980057,0.08198734296779109,0.29258903929779223,137890.6360721371,6101.0939271541865,143991.7299992913,407,62,308.44444444444446,27,0,22,26.475276282232937,0.7229938271604939,37.425595238095234,1050.2976190476184,38.89991181657846,0
409,4,0,0,27,0.0,0.0,1.0,27,300,200,100,0.6666666666666666,4,2,2,416.41614971631276,0.6805555555555556,0.07843877872206506,0.2928185275893593,137968.79428854873,6090.4868197278865,144059.28110827663,408,63,309.44444444444446,27,0,23,26.414069877242678,0.7237654320987654,37.351190476190474,1050.5952380952378,38.91093474426807,0
410,4,0,0,27,0.0,0.0,1.0,27,450,300,150,0.6666666666666666,6,3,3,415.1451286752558,0.6793684710351378,0.07960261635378485,0.2922572037463589,138007.88170085734,6058.65996138037,144066.54166223772,409,64,310.44444444444446,27,0,23,26.408706273898886,0.7241512345679013,37.31398809523809,1050.7440476190468,38.916446208112845,0
411,4,0,0,27,0.0,0.0,1.0,27,700,600,100,0.8571428571428571,8,6,2,416.9707518360525,0.6774691358024691,0.07899276878464212,0.29421222979201167,138086.07313368047,6115.570746527767,144201.64388020826,410,65,311.44444444444446,27,0,18,26.28324248430789,0.7249228395061729,37.23958333333333,1051.041666666666,38.92746913580245,0
412,4,0,0,27,0.0,0.0,1.0,27,350,200,150,0.5714285714285714,5,2,3,416.29418909334356,0.6762820512820513,0.07810075080743273,0.2940702151755378,138125.17715419485,6100.141723355987,144225.31887755083,411,66,312.44444444444446,27,0,19,26.26226878067196,0.7253086419753086,37.20238095238094,1051.190476190475,38.93298059964722,0
413,4,0,0,27,0.0,0.0,1.0,27,850,700,150,0.8235294117647058,10,7,3,414.9073123897771,0.6748575498575499,0.07690452977744244,0.29376102899260154,138203.4018034296,6068.3204010770805,144271.72220450666,412,67,313.44444444444446,27,0,21,26.221223700349086,0.7260802469135803,37.12797619047618,1051.4880952380945,38.94400352733683,0
414,4,0,0,27,0.0,0.0,1.0,27,600,300,300,0.5,9,3,6,413.56909544496284,0.6739078822412156,0.07483923714290208,0.29314872592874125,138242.52243214985,6034.56699085883,144277.08942300867,413,68,314.44444444444446,27,0,21,26.217660723550768,0.7264660493827162,37.0907738095238,1051.6369047619041,38.94951499118164,0
415,4,0,0,27,0.0,0.0,1.0,27,700,500,200,0.7142857142857143,9,5,4,411.2436876539292,0.6717711301044634,0.07362361654540983,0.2928402935952601,138399.0603077168,5983.147985756801,144382.2082934736,414,69,315.44444444444446,27,0,21,26.123868618300104,0.7280092592592593,36.941964285714285,1052.2321428571427,38.97156084656084,0
416,4,0,0,27,0.0,0.0,1.0,27,650,400,250,0.6153846153846154,9,4,5,411.2436876539292,0.6717711301044634,0.07362361654540983,0.2928402935952601,138399.0603077168,5983.147985756801,144382.2082934736,415,70,316.44444444444446,27,0,21,26.123868618300104,0.7280092592592593,36.941964285714285,1052.2321428571427,38.97156084656084,0
417,4,0,0,27,0.0,0.0,1.0,27,850,400,450,0.47058823529411764,13,4,9,411.73126068463677,0.6696343779677113,0.06831485146441318,0.29420070081647676,138516.52184311222,6006.3164328231205,144522.83827593533,416,71,317.44444444444446,27,0,22,25.994840260107438,0.7291666666666667,36.83035714285714,1052.678571428571,38.98809523809523,0
418,4,0,0,27,0.0,0.0,1.0,27,600,300,300,0.5,9,3,6,411.2438911710723,0.6685660018993352,0.07006412773197224,0.2941911557164141,138555.6867603812,5996.035953443871,144551.7227138251,417,72,318.44444444444446,27,0,22,25.968934040047117,0.7295524691358025,36.79315476190476,1052.8273809523807,38.993606701940024,0
419,4,0,0,27,0.0,0.0,1.0,27,200,100,100,0.5,3,1,2,411.2438911710723,0.6685660018993352,0.07006412773197224,0.2941911557164141,138555.6867603812,5996.035953443871,144551.7227138251,418,73,319.44444444444446,27,0,22,25.968934040047117,0.7295524691358025,36.79315476190476,1052.8273809523807,38.993606701940024,0
420,4,0,0,27,0.0,0.0,1.0,27,450,300,150,0.6666666666666666,6,3,3,414.09567679274915,0.6671415004748339,0.07530899082184739,0.2972585395881419,138673.2147285998,6084.795741213155,144758.01046981296,419,74,320.44444444444446,27,0,22,25.777644343976647,0.7307098765432098,36.68154761904762,1053.2738095238096,39.01014109347443,0
421,4,0,0,27,0.0,0.0,1.0,27,850,600,250,0.7058823529411765,11,6,5,411.34840413066905,0.6647673314339981,0.07817303469477399,0.29734613212874084,138908.42013888893,6027.951388888892,144936.37152777784,420,75,321.44444444444446,27,0,22,25.61758893280632,0.7330246913580247,36.458333333333336,1054.166666666667,39.04320987654322,0
422,4,0,0,27,0.0,0.0,1.0,27,550,300,250,0.5454545454545454,8,3,5,412.9445036740264,0.6627492877492878,0.07639476902813058,0.299194760023942,138986.86623086742,6078.772498582777,145065.6387294502,421,76,322.44444444444446,27,0,22,25.49804779377176,0.7337962962962963,36.38392857142858,1054.4642857142862,39.054232804232825,0
423,4,0,0,27,0.0,0.0,1.0,27,950,600,350,0.631578947368421,13,6,7,415.0925855118848,0.6607312440645774,0.07753274504579344,0.3018042398660257,139104.5768893495,6148.255695507373,145252.83258485686,422,77,323.44444444444446,27,0,22,25.325181031645272,0.7349537037037037,36.27232142857143,1054.9107142857144,39.0707671957672,0
424,4,0,0,27,0.0,0.0,1.0,27,500,300,200,0.6,7,3,4,414.6977739534131,0.659306742640076,0.07985082812328614,0.3022221906581349,139183.07834201396,6143.782552083343,145326.8608940973,423,78,324.44444444444446,27,0,20,25.258102994406062,0.7357253086419753,36.19791666666667,1055.208333333334,39.08179012345681,0
425,4,0,0,27,0.0,0.0,1.0,27,800,700,100,0.875,9,7,2,417.2923399658442,0.659306742640076,0.06451577825623644,0.2948750435526274,138136.76459381185,6141.974847226977,144278.73944103884,424,79,325.44444444444446,26,1,21,26.224554707379145,0.7291666666666667,37.191358024691354,1051.234567901234,40.43209876543207,3
426,4,0,0,27,0.0,0.0,1.0,27,600,500,100,0.8333333333333334,7,5,2,418.8190907564486,0.658713200379867,0.06249660285468894,0.29665626657114763,138217.89027968296,6177.658226642276,144395.54850632523,425,80,326.44444444444446,26,1,21,26.10403825457392,0.7299679487179487,37.114197530864196,1051.5432098765432,40.44396961063627,0
427,4,0,0,27,0.0,0.0,1.0,27,550,300,250,0.5454545454545454,8,3,5,419.56368095279896,0.6591880341880342,0.06618298415803947,0.29753657499410235,138258.46205323114,6201.645852385299,144460.10790561643,426,81,327.44444444444446,26,1,21,26.044265101491806,0.7303685897435898,37.07561728395061,1051.697530864197,40.449905033238345,0
428,4,0,0,27,0.0,0.0,1.0,27,750,500,250,0.6666666666666666,10,5,5,419.98192942868474,0.6590693257359924,0.0666405842462181,0.29818716989436606,138299.0397805212,6216.619513031536,144515.65929355274,427,82,328.44444444444446,26,1,21,25.993067781690144,0.7307692307692308,37.03703703703703,1051.8518518518513,40.45584045584043,0
429,4,0,0,27,0.0,0.0,1.0,27,800,600,200,0.75,10,6,4,418.34082417808906,0.6582383665717,0.06126672206742567,0.29808422989241284,138420.8086848423,6181.41503772291,144602.22372256522,428,83,329.44444444444446,26,1,21,25.915640123185213,0.7319711538461539,36.9212962962963,1052.3148148148152,40.47364672364674,0
430,4,0,0,27,0.0,0.0,1.0,27,450,300,150,0.6666666666666666,6,3,3,419.69506926239427,0.6574074074074074,0.061009844326073814,0.299763357846994,138502.01772309863,6225.722784255457,144727.7405073541,429,84,330.44444444444446,26,1,21,25.799613937350337,0.7327724358974359,36.84413580246914,1052.6234567901238,40.485517568850916,0
431,4,0,0,27,0.0,0.0,1.0,27,600,400,200,0.6666666666666666,8,4,4,420.0599703621625,0.6551519468186136,0.06045999098908372,0.3007417815090279,138583.2505763223,6242.655225956422,144825.90580227872,430,85,331.44444444444446,26,1,21,25.70960965362255,0.7335737179487178,36.76697530864198,1052.9320987654328,40.49738841405511,0
432,4,0,0,27,0.0,0.0,1.0,27,500,300,200,0.6,7,3,4,420.35978839975957,0.654320987654321,0.05978231381102739,0.302039570064922,138705.14450922117,6261.213039170859,144966.35754839203,431,86,332.44444444444446,26,1,21,25.58111143666373,0.734775641025641,36.651234567901234,1053.3950617283951,40.51519468186135,0
433,4,0,0,27,0.0,0.0,1.0,27,550,400,150,0.7272727272727273,7,4,3,422.1671232792089,0.6528964862298196,0.060990691922150786,0.3040672065137593,138786.43689986278,6318.2141632372995,145104.6510631001,432,87,333.44444444444446,26,1,21,25.453097539543062,0.7355769230769231,36.57407407407407,1053.7037037037032,40.52706552706551,0
434,4,0,0,27,0.0,0.0,1.0,27,450,300,150,0.6666666666666666,6,3,3,419.78471777406287,0.6530151946818614,0.06382667252232466,0.3034443817052512,138908.42013888885,6262.326388888879,145170.74652777772,433,88,334.44444444444446,26,1,21,25.395256916996043,0.7367788461538463,36.45833333333333,1054.1666666666663,40.54487179487178,0
435,4,0,0,27,0.0,0.0,1.0,27,350,200,150,0.5714285714285714,5,2,3,419.07160270719413,0.6533713200379867,0.06545450602827652,0.30329419382368106,138949.09312604778,6245.923830208796,145195.0169562566,434,89,335.44444444444446,26,1,21,25.37385343481654,0.7371794871794872,36.419753086419746,1054.3209876543203,40.55080721747386,0
436,4,0,1,26,0.0,0.037037037037037035,0.962962962962963,27,550,200,350,0.36363636363636365,9,2,7,420.10805344244045,0.6533713200379867,0.05992911260690037,0.3047790273063308,139030.45696159115,6281.5629286694,145312.01989026053,435,90,336.44444444444446,26,1,21,25.26613257243197,0.7379807692307692,36.34259259259259,1054.629629629629,40.562678062678046,0
437,4,0,0,26,0.0,0.0,1.0,26,450,300,150,0.6666666666666666,6,3,3,431.1361526739648,0.6492948717948718,0.06614870157961827,0.31204012634125555,138950.65759060642,6781.330385026288,145731.9879756327,436,91,338.11538461538464,25,1,21,25.054307898870153,0.74125,36.418269230769226,1054.3269230769224,42.1730769230769,0
438,4,0,0,26,0.0,0.0,1.0,26,400,200,200,0.5,6,2,4,431.1361526739648,0.6492948717948718,0.06614870157961827,0.31204012634125555,138950.65759060642,6781.330385026288,145731.9879756327,437,92,339.11538461538464,25,1,21,25.054307898870153,0.74125,36.418269230769226,1054.3269230769224,42.1730769230769,0
439,4,0,0,26,0.0,0.0,1.0,26,800,600,200,0.75,10,6,4,429.9775500965437,0.6491025641025641,0.06738368014963725,0.31159166075278166,138992.90146285333,6752.765450361594,145745.66691321493,438,93,340.11538461538464,25,1,22,25.043059777102336,0.7416666666666667,36.378205128205124,1054.4871794871792,42.17948717948717,0
440,4,0,0,26,0.0,0.0,1.0,26,600,400,200,0.6666666666666666,8,4,4,429.18538548037753,0.648974358974359,0.06924479349274248,0.3117989191205126,139077.40846893488,6737.998233070342,145815.40670200522,439,94,341.11538461538464,25,1,22,24.980375772308324,0.7425,36.29807692307692,1054.807692307692,42.19230769230768,0
441,4,0,0,26,0.0,0.0,1.0,26,500,400,100,0.8,6,4,2,427.9909891775845,0.6495512820512821,0.06744061043012906,0.31132206428243514,139119.6716027695,6708.393172666003,145828.0647754355,440,95,342.11538461538464,25,1,23,24.970093422451768,0.7429166666666667,36.25801282051282,1054.9679487179483,42.19871794871793,0
442,4,0,0,26,0.0,0.0,1.0,26,350,100,250,0.2857142857142857,6,1,5,428.99666702988594,0.648525641025641,0.06778225570936258,0.3128397621696345,139204.21713202668,6743.629037228807,145947.8461692555,441,96,343.11538461538464,25,1,20,24.860003796507208,0.74375,36.17788461538462,1055.2884615384621,42.21153846153848,0
443,4,0,0,26,0.0,0.0,1.0,26,850,600,250,0.7058823529411765,11,6,5,429.6361928315306,0.6475641025641026,0.06749748884580331,0.3137011048767694,139246.49952744902,6765.067184418141,146011.56671186717,442,97,344.11538461538464,25,1,20,24.801346290110338,0.7441666666666666,36.13782051282051,1055.4487179487178,42.21794871794871,0
444,4,0,0,26,0.0,0.0,1.0,26,800,500,300,0.625,11,5,6,435.65530499401257,0.6475641025641026,0.09226151714992725,0.2856157937987992,135508.50912742445,6607.000174638411,142115.50930206286,443,98,345.11538461538464,25,1,21,28.363571648453146,0.7070833333333333,39.70352564102565,1041.185897435898,41.64743589743592,7
445,4,0,0,26,0.0,0.0,1.0,26,850,500,350,0.5882352941176471,12,5,7,442.30831004618085,0.6475641025641026,0.11666706248367231,0.2836904190573427,134717.09863987518,6717.298446745581,141434.39708662077,444,99,346.11538461538464,25,1,21,28.98528352372131,0.6991666666666666,40.4647435897436,1038.1410256410265,41.525641025641065,3
446,4,0,0,26,0.0,0.0,1.0,26,400,200,200,0.5,6,2,4,444.7549916171317,0.646025641025641,0.11977682811016166,0.28591392318244174,134800.29585798818,6790.62089086128,141590.91674884947,445,100,347.11538461538464,25,1,17,28.838091563786005,0.7,40.38461538461539,1038.4615384615386,41.53846153846154,0
447,4,0,0,26,0.0,0.0,1.0,26,450,300,150,0.6666666666666666,6,3,3,444.1875496582283,0.6446794871794872,0.12225677423949266,0.28587681324081227,134841.90409783876,6779.018994493774,141620.92309233255,446,101,348.11538461538464,25,1,17,28.81097952990793,0.7004166666666667,40.34455128205129,1038.621794871796,41.544871794871845,0
448,4,0,0,26,0.0,0.0,1.0,26,550,400,150,0.7272727272727273,7,4,3,469.01125060220465,0.6441666666666667,0.1622813805912393,0.29506150829024785,134010.95920138893,7370.529513888894,141381.48871527784,447,102,349.11538461538464,25,1,21,29.005281690140837,0.6920833333333333,41.145833333333336,1035.416666666667,41.41666666666668,4
449,4,0,0,26,0.0,0.0,1.0,26,750,500,250,0.6666666666666666,10,5,5,468.03152032006574,0.6435897435897436,0.15919101016594062,0.29477774700860276,134052.44545118345,7348.153969428013,141400.59942061146,448,103,350.11538461538464,25,1,22,28.98870318786754,0.6924999999999999,41.10576923076923,1035.576923076923,41.42307692307693,0
450,4,0,0,26,0.0,0.0,1.0,26,300,100,200,0.3333333333333333,5,1,4,467.3631204933811,0.6440384615384616,0.15641104988157428,0.29468954612182674,134093.93812150738,7334.112271942821,141428.0503934502,449,104,351.11538461538464,25,1,22,28.964071122801588,0.6929166666666666,41.06570512820514,1035.7371794871806,41.429487179487225,0
451,4,0,0,26,0.0,0.0,1.0,26,800,600,200,0.75,10,6,4,464.6360237456119,0.6444871794871795,0.15642770468010148,0.293966392322811,134218.45465565432,7272.545816896802,141491.00047255112,450,105,352.11538461538464,25,1,22,28.90890813485927,0.6941666666666666,40.94551282051283,1036.2179487179499,41.44871794871799,0
452,4,0,0,26,0.0,0.0,1.0,26,550,400,150,0.7272727272727273,7,4,3,467.1505050835696,0.6454487179487179,0.16014440175565903,0.2958924893609643,134259.97300809505,7343.92284064761,141603.89584874266,451,106,353.11538461538464,25,1,22,28.80183366836761,0.6945833333333333,40.90544871794872,1036.3782051282055,41.45512820512822,0
453,4,0,0,26,0.0,0.0,1.0,26,350,200,150,0.5714285714285714,5,2,3,467.1505050835696,0.6454487179487179,0.16014440175565903,0.2958924893609643,134259.97300809505,7343.92284064761,141603.89584874266,452,107,354.11538461538464,25,1,22,28.80183366836761,0.6945833333333333,40.90544871794872,1036.3782051282055,41.45512820512822,0
454,4,0,0,26,0.0,0.0,1.0,26,700,400,300,0.5714285714285714,10,4,6,465.6745402721055,0.6444230769230769,0.15613517723581083,0.2956279294426154,134343.0289745645,7312.025651298498,141655.054625863,453,108,355.11538461538464,25,1,22,28.756215540784257,0.6954166666666666,40.82532051282052,1036.6987179487185,41.46794871794874,0
455,4,0,0,26,0.0,0.0,1.0,26,450,300,150,0.6666666666666666,6,3,3,465.6745402721055,0.6444230769230769,0.15613517723581083,0.2956279294426154,134343.0289745645,7312.025651298498,141655.054625863,454,109,356.11538461538464,25,1,22,28.756215540784257,0.6954166666666666,40.82532051282052,1036.6987179487185,41.46794871794874,0
456,4,0,0,26,0.0,0.0,1.0,26,550,400,150,0.7272727272727273,7,4,3,464.34734923630253,0.6437179487179487,0.15770775409329607,0.2964679229739471,134550.78125000003,7295.659722222224,141846.44097222225,455,110,357.11538461538464,25,1,22,28.5809906291834,0.6975,40.625,1037.5000000000002,41.50000000000001,0
457,4,0,0,26,0.0,0.0,1.0,26,350,200,150,0.5714285714285714,5,2,3,464.34734923630253,0.6437179487179487,0.15770775409329607,0.2964679229739471,134550.78125000003,7295.659722222224,141846.44097222225,456,111,358.11538461538464,25,1,22,28.5809906291834,0.6975,40.625,1037.5000000000002,41.50000000000001,0
458,4,0,0,26,0.0,0.0,1.0,26,400,200,200,0.5,6,2,4,457.06985015016573,0.6437179487179487,0.10784030610403206,0.2668536577178094,131204.9567769972,6793.965986604236,137998.92276360144,457,112,359.11538461538464,25,1,20,32.16327102560092,0.66375,43.87019230769232,1024.519230769232,40.98076923076928,5
459,4,0,0,26,0.0,0.0,1.0,26,300,100,200,0.3333333333333333,5,1,4,456.97263298824976,0.6423717948717949,0.1040999975938981,0.2670825425344488,131246.00643080217,6795.166625575291,138041.17305637745,458,113,360.11538461538464,25,1,20,32.12386612449172,0.6641666666666666,43.83012820512821,1024.6794871794878,40.98717948717951,0
460,4,1,1,26,0.037037037037037035,0.037037037037037035,0.962962962962963,27,400,200,200,0.5,6,2,4,443.33529511577706,0.6651234567901235,0.0866444901347867,0.26101414584894367,131525.92318720484,6262.016794314913,137787.93998151974,459,0,347.74074074074076,26,1,20,32.18807983551477,0.6630608974358974,43.55709876543211,1025.7716049382727,39.45275403608741,0
461,4,1,0,27,0.037037037037037035,0.0,1.0,27,500,300,200,0.6,7,3,4,442.3838637224456,0.6525403608736943,0.10719870885160132,0.26262842221881166,131842.7098813063,6265.017480185959,138107.72736149226,460,0,348.7037037037037,26,1,21,31.890182819934886,0.6662660256410255,43.24845679012346,1027.006172839507,39.50023741690411,0
462,4,0,0,27,0.0,0.0,1.0,27,400,100,300,0.25,7,1,6,442.53738674186377,0.6512345679012346,0.10706018518518512,0.26299364697802197,131882.33500990708,6272.572778539863,138154.90778844693,461,1,349.7037037037037,26,1,21,31.845953525641022,0.6666666666666666,43.20987654320988,1027.160493827161,39.50617283950619,0
463,4,0,0,27,0.0,0.0,1.0,27,850,500,350,0.5882352941176471,12,5,7,442.80619777173206,0.6532526115859449,0.1124906823314753,0.2637033689413411,131961.6031283342,6286.683146624004,138248.2862749582,462,2,350.7037037037037,26,1,21,31.75847351557023,0.6674679487179487,43.13271604938272,1027.46913580247,39.518043684710385,0
464,4,0,0,27,0.0,0.0,1.0,27,650,400,250,0.6153846153846154,9,4,5,441.60628543218155,0.6528964862298196,0.10934797239047156,0.2632637649680303,132001.24611816037,6258.515994132,138259.76211229237,463,3,351.7037037037037,26,1,21,31.74901136306753,0.6678685897435896,43.09413580246914,1027.6234567901238,39.52397910731246,0
465,4,0,0,27,0.0,0.0,1.0,27,600,400,200,0.6666666666666666,8,4,4,440.81373986985176,0.652659069325736,0.11387457116326671,0.26334173284960366,132080.54995903815,6244.584238302072,138325.13419734023,464,4,352.7037037037037,26,1,21,31.68881048891559,0.6686698717948718,43.01697530864197,1027.9320987654312,39.535849952516585,0
466,4,0,0,27,0.0,0.0,1.0,27,650,600,50,0.9230769230769231,7,6,1,440.0244491554126,0.6527777777777778,0.11015517318038337,0.263698105141337,132199.5503734186,6234.206866331335,138433.75723974995,465,5,353.7037037037037,26,1,21,31.588260304121647,0.6698717948717949,42.90123456790123,1028.3950617283942,39.55365622032286,0
467,4,0,0,27,0.0,0.0,1.0,27,600,300,300,0.5,9,3,6,439.435932792199,0.6517094017094017,0.10837750441710847,0.2638990926119637,132278.91375171463,6225.621570644708,138504.53532235933,466,6,354.7037037037037,26,1,22,31.522839783978398,0.6706730769230769,42.82407407407407,1028.7037037037032,39.56552706552705,0
468,4,0,0,27,0.0,0.0,1.0,27,650,500,150,0.7692307692307693,8,5,3,441.0234082369019,0.6488603988603989,0.11458107785494964,0.2662504213889928,132477.4263879362,6285.129220012173,138762.55560794836,467,7,355.7037037037037,26,1,22,31.28060510668065,0.672676282051282,42.63117283950616,1029.4753086419746,39.595204178537486,0
469,4,0,0,27,0.0,0.0,1.0,27,450,100,350,0.2222222222222222,8,1,7,441.0234082369019,0.6488603988603989,0.11458107785494964,0.2662504213889928,132477.4263879362,6285.129220012173,138762.55560794836,468,8,356.7037037037037,26,1,22,31.28060510668065,0.672676282051282,42.63117283950616,1029.4753086419746,39.595204178537486,0
470,4,0,0,27,0.0,0.0,1.0,27,400,300,100,0.75,5,3,2,440.31995626520376,0.649928774928775,0.11294297895017325,0.26610640835157956,132517.14677640595,6269.988854595325,138787.13563100126,469,9,357.7037037037037,26,1,22,31.258430755395686,0.6730769230769231,42.59259259259259,1029.629629629629,39.60113960113958,0
471,4,0,0,27,0.0,0.0,1.0,27,500,200,300,0.4,8,2,6,440.91404039832184,0.6479107312440646,0.1167002458775277,0.26674699832982784,132556.8731186176,6289.237301859472,138846.11042047708,470,10,358.7037037037037,26,1,22,31.20285728557871,0.6734775641025641,42.55401234567901,1029.7839506172838,39.607075023741686,0
472,4,0,0,27,0.0,0.0,1.0,27,800,500,300,0.625,11,5,6,439.8585290073637,0.6480294396961064,0.1126649574357097,0.26638982056217275,132596.60541457086,6264.749561804584,138861.35497637544,471,11,359.7037037037037,26,1,23,31.189753770852064,0.6738782051282051,42.51543209876542,1029.9382716049374,39.61301044634375,0
473,4,0,0,27,0.0,0.0,1.0,27,450,300,150,0.6666666666666666,6,3,3,439.8585290073637,0.6480294396961064,0.1126649574357097,0.26638982056217275,132596.60541457086,6264.749561804584,138861.35497637544,472,12,360.7037037037037,26,1,23,31.189753770852064,0.6738782051282051,42.51543209876542,1029.9382716049374,39.61301044634375,0
474,4,1,0,28,0.03571428571428571,0.0,1.0,28,750,500,250,0.6666666666666666,10,5,5,431.3473030663718,0.6628637566137566,0.10239194509141147,0.2638718585660214,132972.93803589148,5871.503640518711,138844.44167641018,473,0,348.7857142857143,27,1,19,31.028020247198572,0.6739969135802468,42.15029761904762,1031.3988095238096,38.19995590828925,0
475,4,0,0,28,0.0,0.0,1.0,28,350,100,250,0.2857142857142857,6,1,5,431.3473030663718,0.6628637566137566,0.10239194509141147,0.2638718585660214,132972.93803589148,5871.503640518711,138844.44167641018,474,1,349.7857142857143,27,1,19,31.028020247198572,0.6739969135802468,42.15029761904762,1031.3988095238096,38.19995590828925,0
476,4,0,0,28,0.0,0.0,1.0,28,750,500,250,0.6666666666666666,10,5,5,414.75371703428584,0.6638558201058201,0.06245734141347281,0.24759757334103835,132053.6406294289,5353.9476597930925,137407.588289222,475,2,350.7857142857143,27,1,20,32.38577409391439,0.6647376543209876,43.043154761904766,1027.8273809523814,38.06768077601413,6
477,4,0,0,28,0.0,0.0,1.0,28,600,500,100,0.8333333333333334,7,5,2,414.75371703428584,0.6638558201058201,0.06245734141347281,0.24759757334103835,132053.6406294289,5353.9476597930925,137407.588289222,476,3,351.7857142857143,27,1,20,32.38577409391439,0.6647376543209876,43.043154761904766,1027.8273809523814,38.06768077601413,0
478,4,1,1,28,0.034482758620689655,0.034482758620689655,0.9655172413793104,29,800,500,300,0.625,11,5,6,402.3208176982992,0.6745689655172413,0.04961167197590166,0.24308861548280059,132508.92827652278,4862.220075307202,137371.14835183,477,0,340.62068965517244,28,1,21,32.24485998697554,0.665922619047619,42.60057471264369,1029.5977011494265,36.77134646962237,0
479,4,0,0,28,0.0,0.0,1.0,28,400,300,100,0.75,5,3,2,412.7807500330687,0.6605489417989417,0.0637485796921804,0.24842287958909226,132359.71878985967,5327.108799248869,137686.82758910855,478,1,353.64285714285717,27,1,21,32.12656664256447,0.6678240740740741,42.745535714285715,1029.017857142857,38.11177248677249,0
480,4,0,0,28,0.0,0.0,1.0,28,550,300,250,0.5454545454545454,8,3,5,413.39923730519854,0.6613756613756614,0.06004006112418936,0.249554618121934,132474.58944515302,5352.978847789112,137827.56829294213,479,2,354.64285714285717,27,1,21,31.99443480774792,0.6689814814814814,42.63392857142857,1029.4642857142853,38.128306878306866,0
481,4,0,0,28,0.0,0.0,1.0,28,750,600,150,0.8,9,6,3,410.9613978768917,0.6626984126984127,0.059224513385761846,0.24884198028923593,132589.5099250637,5297.834068523231,137887.34399358692,480,3,355.64285714285717,27,1,21,31.9409827577903,0.670138888888889,42.52232142857142,1029.9107142857138,38.14484126984125,0
482,4,1,0,29,0.034482758620689655,0.0,1.0,29,650,400,250,0.6153846153846154,9,4,5,396.1154356776451,0.6772372742200328,0.06114795269124951,0.2429124631597924,133064.2490132448,4741.76059420002,137806.0096074448,481,0,344.3448275862069,28,1,22,31.844450633616482,0.6715029761904763,42.0617816091954,1031.7528735632181,36.848316912972074,0
483,4,0,0,29,0.0,0.0,1.0,29,600,400,200,0.6666666666666666,8,4,4,397.0717284993655,0.6758004926108374,0.06479859054184445,0.24398342393592323,133138.37951265028,4773.097296538514,137911.47680918878,482,1,345.3448275862069,28,1,22,31.745092579702067,0.672247023809524,41.98994252873563,1032.0402298850574,36.858579638752055,0
484,4,0,0,29,0.0,0.0,1.0,29,800,500,300,0.625,11,5,6,397.6949674108758,0.6750821018062397,0.06439597573151046,0.24460964433901805,133175.45250363316,4792.641448672204,137968.09395230535,483,2,346.3448275862069,28,1,22,31.69166434669636,0.6726190476190477,41.95402298850574,1032.1839080459765,36.86371100164202,0
485,4,0,0,29,0.0,0.0,1.0,29,450,400,50,0.8888888888888888,5,4,1,398.3062215461831,0.6745689655172413,0.06482854606099853,0.2452296659648094,133212.5306554697,4811.875949597045,138024.40660506673,484,3,347.3448275862069,28,1,22,31.63854094177685,0.6729910714285714,41.918103448275865,1032.3275862068967,36.86884236453203,0
486,4,0,0,29,0.0,0.0,1.0,29,400,100,300,0.25,7,1,6,399.8184499326651,0.6739532019704433,0.06318880353895673,0.2466519484691899,133286.70244170286,4858.0965533755925,138144.79899507845,485,4,348.3448275862069,28,1,22,31.524801725337415,0.6737351190476191,41.84626436781608,1032.6149425287347,36.87910509031195,0
487,4,0,0,29,0.0,0.0,1.0,29,750,600,150,0.8,9,6,3,399.98068175786955,0.6719006568144499,0.06294098742811105,0.24724515229211713,133360.89487135014,4868.356330096432,138229.25120144658,486,5,349.3448275862069,28,1,22,31.44590114526823,0.6744791666666667,41.774425287356316,1032.902298850574,36.88936781609193,0
488,4,1,0,30,0.03333333333333333,0.0,1.0,30,500,200,300,0.4,8,2,6,390.1963998638913,0.6841954022988506,0.07781953205386305,0.24452088943531142,133867.1899112653,4446.899112654304,138314.0890239196,487,0,338.6666666666667,29,1,21,31.189745224354663,0.6763649425287357,41.284722222222214,1034.8611111111102,35.68486590038311,0
489,4,0,0,30,0.0,0.0,1.0,30,350,200,150,0.5714285714285714,5,2,3,390.0389222100347,0.683764367816092,0.07380568974771862,0.24466077847720358,133903.125,4445.486111111111,138348.61111111112,488,1,339.6666666666667,29,1,21,31.15774288781535,0.6767241379310345,41.25,1035.0,35.689655172413794,0
490,4,0,0,30,0.0,0.0,1.0,30,400,200,200,0.5,6,2,4,390.0389222100347,0.683764367816092,0.07380568974771862,0.24466077847720358,133903.125,4445.486111111111,138348.61111111112,489,2,340.6666666666667,29,1,21,31.15774288781535,0.6767241379310345,41.25,1035.0,35.689655172413794,0
491,4,0,0,30,0.0,0.0,1.0,30,800,700,100,0.875,9,7,2,389.87035334214545,0.6831417624521073,0.0767699807683706,0.24479391267556966,133939.06491126554,4443.774112654338,138382.83902391986,490,3,341.6666666666667,29,1,21,31.126028668545107,0.6770833333333333,41.215277777777786,1035.1388888888896,35.69444444444447,0
492,4,0,0,30,0.0,0.0,1.0,30,1100,700,400,0.6363636363636364,15,7,8,387.3324147427127,0.6811781609195402,0.08166867766009744,0.24463272494207405,134154.80565200624,4392.500964506185,138547.30661651242,491,4,342.6666666666667,29,1,22,30.975303883451748,0.6792385057471264,41.00694444444445,1035.9722222222229,35.723180076628374,0
493,4,0,0,30,0.0,0.0,1.0,30,700,600,100,0.8571428571428571,8,6,2,391.7779631200015,0.6795498084291188,0.08707400955826539,0.24841452325952199,134298.72926311742,4523.0565200617475,138821.78578317916,492,5,343.6666666666667,29,1,22,30.715837018178572,0.6806752873563218,40.868055555555564,1036.5277777777787,35.74233716475099,0
494,4,0,0,30,0.0,0.0,1.0,30,500,300,200,0.6,7,3,4,392.4767916721436,0.6795498084291188,0.08629158294262096,0.24934802126234493,134370.7200038581,4547.477816358033,138918.19782021613,493,6,344.6666666666667,29,1,22,30.625558160303648,0.6813936781609194,40.798611111111114,1036.8055555555559,35.75191570881227,0
495,4,0,0,30,0.0,0.0,1.0,30,600,200,400,0.3333333333333333,10,2,8,392.48466656260644,0.678544061302682,0.09113432436051982,0.24984509848448272,134442.73003472225,4553.342013888899,138996.07204861115,494,7,345.6666666666667,29,1,23,30.553184009642433,0.6821120689655171,40.72916666666667,1037.0833333333337,35.761494252873575,0
496,4,0,0,30,0.0,0.0,1.0,30,750,500,250,0.6666666666666666,10,5,5,391.5036596781872,0.6780172413793104,0.0898053918943047,0.2494666664229268,134478.74228395068,4529.783950617296,139008.52623456798,495,8,346.6666666666667,29,1,23,30.542537046955914,0.682471264367816,40.69444444444445,1037.2222222222226,35.76628352490423,0
497,4,0,0,30,0.0,0.0,1.0,30,450,400,50,0.8888888888888888,5,4,1,386.89019252220965,0.6780172413793104,0.07574531228922177,0.23374221655803903,132505.23003472213,4252.9947916666615,136758.2248263888,496,9,347.6666666666667,29,1,22,32.6457743153919,0.6627155172413792,42.604166666666664,1029.5833333333328,35.50287356321837,5
498,4,0,0,30,0.0,0.0,1.0,30,350,100,250,0.2857142857142857,6,1,5,388.4027974495394,0.676676245210728,0.08143403011912786,0.23510259127251718,132576.73852237663,4298.635223765445,136875.37374614208,497,10,348.6666666666667,29,1,22,32.53469880872107,0.663433908045977,42.53472222222223,1029.8611111111118,35.512452107279714,0
499,4,0,0,30,0.0,0.0,1.0,30,700,500,200,0.7142857142857143,9,5,4,388.6715712877401,0.6761015325670499,0.08498449925866014,0.23616334049006932,132719.81336805565,4316.883680555575,137036.6970486112,498,11,349.6666666666667,29,1,19,32.38349171047311,0.6648706896551724,42.39583333333334,1030.4166666666677,35.53160919540233,0
500,4,1,1,30,0.03225806451612903,0.03225806451612903,0.967741935483871,31,850,400,450,0.47058823529411764,13,4,9,375.77752549098665,0.6905017921146953,0.06604602290637795,0.23017498069779113,133021.21497066141,3797.276599895952,136818.49157055738,499,0,339.35483870967744,30,1,20,32.412323561346355,0.6649305555555556,42.10349462365592,1031.586021505377,34.3862007168459,0
501,4,0,0,30,0.0,0.0,1.0,30,450,400,50,0.8888888888888888,5,4,1,386.6304994054697,0.6729885057471264,0.08261494252873547,0.23604809437386565,132898.76543209876,4276.543209876541,137175.3086419753,500,13,351.6666666666667,29,1,21,32.25574712643678,0.6666666666666666,42.22222222222222,1031.111111111111,35.55555555555556,0
502,4,0,0,30,0.0,0.0,1.0,30,1000,800,200,0.8,12,8,4,387.1479613008631,0.6703065134099617,0.08885298869143776,0.23727186935171726,133042.013888889,4301.388888888908,137343.4027777779,501,14,352.6666666666667,29,1,22,32.09814216478192,0.668103448275862,42.08333333333334,1031.6666666666677,35.5747126436782,0
503,4,0,0,30,0.0,0.0,1.0,30,650,500,150,0.7692307692307693,8,5,3,387.4172870831513,0.6701628352490422,0.08753868927465991,0.23812223823944567,133149.50086805562,4316.883680555565,137466.38454861118,502,15,353.6666666666667,29,1,22,31.982993540573265,0.6691810344827586,41.97916666666667,1032.083333333334,35.58908045977014,0
504,4,0,0,30,0.0,0.0,1.0,30,250,100,150,0.4,4,1,3,390.1467758371486,0.669300766283525,0.09428673931566456,0.24026188772141896,133221.18296682104,4395.163001543222,137616.34596836427,503,16,354.6666666666667,29,1,22,31.840413247230828,0.6698994252873562,41.90972222222223,1032.3611111111115,35.59865900383143,0
505,4,1,0,31,0.03225806451612903,0.0,1.0,31,800,600,200,0.75,10,6,4,378.0519208571101,0.6835125448028674,0.08928616349564411,0.235715679017391,133680.63685108104,3907.6443085905935,137588.28115967163,504,0,344.19354838709677,30,1,25,31.691090460098795,0.6715277777777777,41.465053763440864,1034.1397849462367,34.471326164874554,0
506,4,0,0,31,0.0,0.0,1.0,31,650,400,250,0.6153846153846154,9,4,5,376.4061493726255,0.6833333333333333,0.08280799409831685,0.23513163356913358,133750.14452537865,3868.8753757659833,137619.01990114464,505,1,345.19354838709677,30,1,18,31.6639054920305,0.6722222222222223,41.39784946236559,1034.4086021505375,34.480286738351246,0
507,4,0,0,31,0.0,0.0,1.0,31,900,500,400,0.5555555555555556,13,5,8,375.04317472776034,0.6841397849462365,0.08490684635305357,0.23472214301254463,133819.67026534857,3837.6307954676786,137657.30106081624,506,2,346.19354838709677,30,1,19,31.62942755694119,0.6729166666666666,41.33064516129032,1034.6774193548385,34.48924731182795,0
508,4,0,0,31,0.0,0.0,1.0,31,750,700,50,0.9333333333333333,8,7,1,378.023871692636,0.6862007168458781,0.09091899045911878,0.23748285968814678,133958.77594230534,3927.9230257833105,137886.69896808863,507,3,347.19354838709677,30,1,19,31.412836492685887,0.6743055555555557,41.19623655913978,1035.2150537634398,34.50716845878132,0
509,4,0,0,31,0.0,0.0,1.0,31,750,600,150,0.8,9,6,3,377.60737292805476,0.6867383512544802,0.0931350583978594,0.2374456811154943,133993.5636525898,3919.391512024499,137912.9551646143,508,4,348.19354838709677,30,1,20,31.38874464494353,0.6746527777777779,41.162634408602145,1035.3494623655906,34.511648745519686,0
510,4,0,0,31,0.0,0.0,1.0,31,850,600,250,0.7058823529411765,11,6,5,376.53262886725815,0.6871863799283154,0.08989883763775874,0.23699406640468568,134028.3558792922,3893.2098363972486,137921.56571568947,509,5,349.19354838709677,30,1,20,31.38169565593632,0.675,41.129032258064505,1035.4838709677404,34.516129032258014,0
511,4,0,0,31,0.0,0.0,1.0,31,650,500,150,0.7692307692307693,8,5,3,375.970766844257,0.6877240143369175,0.08524568204080629,0.2370892577170084,134097.95388195154,3883.382110648616,137981.33599260016,510,6,350.19354838709677,30,1,20,31.326509646163174,0.6756944444444445,41.06182795698924,1035.752688172042,34.525089605734735,0
512,4,0,0,31,0.0,0.0,1.0,31,1000,900,100,0.9,11,9,2,396.3975523549817,0.6874551971326165,0.10454904199761561,0.24484877751572992,133333.36946467805,4370.604260608171,137703.97372528623,511,7,351.19354838709677,30,1,18,31.566133090404314,0.6680555555555555,41.80107526881721,1032.7956989247316,34.42652329749105,3
513,4,0,1,30,0.0,0.03225806451612903,0.967741935483871,31,950,600,350,0.631578947368421,13,6,7,396.98260799561433,0.6891577060931899,0.09663571089858469,0.2458988966689999,133437.50225820908,4394.473530176905,137831.975788386,512,8,352.19354838709677,30,1,20,31.446218724253068,0.6690972222222221,41.700268817204304,1033.198924731183,34.4399641577061,0
514,4,0,0,30,0.0,0.0,1.0,30,650,500,150,0.7692307692307693,8,5,3,410.7516462522018,0.673132183908046,0.120955453975083,0.254173938837261,133400.47260802475,4958.892746913588,138359.36535493835,513,26,364.6666666666667,29,1,21,31.12787935825043,0.6716954022988505,41.736111111111114,1033.0555555555559,35.62260536398468,0
515,4,0,0,30,0.0,0.0,1.0,30,900,600,300,0.6666666666666666,12,6,6,407.22907290430203,0.6722701149425288,0.11669353394232518,0.25346264370398214,133615.77932098776,4882.445987654339,138498.22530864208,514,27,365.6666666666667,29,1,22,31.002037435070765,0.6738505747126438,41.527777777777786,1033.8888888888896,35.65134099616861,0
516,4,0,0,30,0.0,0.0,1.0,30,350,100,250,0.2857142857142857,6,1,5,406.82037651530965,0.6724137931034483,0.11481978956794259,0.2534542011009607,133651.68065200612,4874.445408950607,138526.12606095674,515,28,366.6666666666667,29,1,22,30.976466308484433,0.6742097701149425,41.49305555555555,1034.0277777777774,35.65613026819922,0
517,4,0,0,30,0.0,0.0,1.0,30,750,600,150,0.8,9,6,3,408.12432723668934,0.6724616858237548,0.11376655925528079,0.25500922728681724,133759.41358024685,4918.094135802465,138677.50771604932,516,29,367.6666666666667,29,1,16,30.834340315073398,0.6752873563218391,41.388888888888886,1034.4444444444441,35.670498084291175,0
518,4,0,0,30,0.0,0.0,1.0,30,550,400,150,0.7272727272727273,7,4,3,407.6710759219885,0.6724137931034483,0.11055175191300859,0.2549741263260194,133795.33420138885,4908.897569444441,138704.23177083328,517,30,368.6666666666667,29,1,17,30.809924150892744,0.6756465517241379,41.354166666666664,1034.583333333333,35.67528735632183,0
519,4,0,0,30,0.0,0.0,1.0,30,650,400,250,0.6153846153846154,9,4,5,407.5311922886357,0.6724616858237548,0.11243847874720325,0.2551350741638938,133831.2596450617,4908.082561728394,138739.3422067901,518,31,369.6666666666667,29,1,17,30.777404921700228,0.6760057471264368,41.31944444444444,1034.7222222222222,35.68007662835249,0
520,4,0,0,30,0.0,0.0,1.0,30,1150,1000,150,0.8695652173913043,13,10,3,409.31327440772054,0.6709770114942529,0.11755892481774688,0.25700183944066884,133939.06491126536,4964.607445987642,138903.672357253,519,32,370.6666666666667,29,1,17,30.622875575830758,0.6770833333333334,41.21527777777777,1035.1388888888882,35.69444444444442,0
521,4,0,0,30,0.0,0.0,1.0,30,700,600,100,0.8571428571428571,8,6,2,410.2279674019975,0.6705938697318008,0.1164989939637826,0.2580801263275858,134010.95920138893,4995.008680555562,139005.9678819445,520,33,371.6666666666667,29,1,17,30.526911468812873,0.677801724137931,41.145833333333336,1035.416666666667,35.704022988505756,0
522,4,0,0,30,0.0,0.0,1.0,30,850,600,250,0.7058823529411765,11,6,5,408.278313503326,0.6692528735632184,0.1103513006167871,0.2576091084693573,134118.8368055555,4951.562499999996,139070.3993055555,521,34,372.6666666666667,29,1,19,30.468959506570123,0.6788793103448276,41.041666666666664,1035.833333333333,35.71839080459769,0
523,4,0,0,30,0.0,0.0,1.0,30,600,500,100,0.8333333333333334,7,5,2,410.43502610842165,0.6704501915708813,0.10903364160300222,0.2597333104151768,134226.7578125,5018.272569444445,139245.03038194444,522,35,373.6666666666667,29,1,19,30.304667604878702,0.6799568965517242,40.9375,1036.25,35.73275862068966,0
524,4,1,1,30,0.03225806451612903,0.03225806451612903,0.967741935483871,31,900,700,200,0.7777777777777778,11,7,4,398.54195900066134,0.681899641577061,0.09897655136675754,0.2544537122850376,134550.78125,4524.82638888889,139075.60763888888,523,0,362.5806451612903,30,1,20,30.287817938420346,0.6802083333333333,40.625,1037.5,34.583333333333336,0
525,4,0,0,30,0.0,0.0,1.0,30,550,100,450,0.18181818181818182,10,1,9,409.27319228962665,0.6715996168582375,0.11254744362580937,0.2600190962078351,134370.720003858,4998.866705246906,139369.58670910491,524,37,375.6666666666667,29,1,20,30.190193123465065,0.6813936781609196,40.79861111111111,1036.8055555555552,35.75191570881225,0
526,4,0,0,30,0.0,0.0,1.0,30,650,400,250,0.6153846153846154,9,4,5,409.2548130369634,0.6732758620689655,0.11069451883592207,0.2607777255767955,134478.7422839507,5007.2145061728515,139485.95679012354,525,38,376.6666666666667,29,1,20,30.082239778610955,0.6824712643678161,40.69444444444445,1037.2222222222229,35.76628352490424,0
527,4,0,0,30,0.0,0.0,1.0,30,650,600,50,0.9230769230769231,7,6,1,409.1869485976033,0.6722222222222223,0.1107095046854083,0.26125012872000825,134550.78125,5011.2847222222235,139562.06597222222,526,39,377.6666666666667,29,1,20,30.011713520749666,0.6831896551724137,40.625,1037.5,35.775862068965516,0
528,4,0,0,30,0.0,0.0,1.0,30,750,500,250,0.6666666666666666,10,5,5,409.9688626143639,0.6711206896551725,0.11153485882510372,0.2625276187075529,134658.8758680556,5041.189236111117,139700.06510416672,527,40,378.6666666666667,29,1,20,29.882995450287705,0.6842672413793103,40.520833333333336,1037.916666666667,35.790229885057485,0
529,4,0,0,30,0.0,0.0,1.0,30,500,300,200,0.6,7,3,4,417.94302935507415,0.6702107279693487,0.07818541498066667,0.25274303585958574,132540.98186728396,5078.915895061724,137619.89776234567,528,41,379.6666666666667,29,1,19,31.810313820699577,0.6630747126436782,42.56944444444444,1029.7222222222224,35.50766283524905,8
530,4,0,0,30,0.0,0.0,1.0,30,950,700,250,0.7368421052631579,12,7,5,417.3536015096665,0.6687260536398467,0.07768190193699143,0.2531080672442514,132648.26630015424,5072.2463348765295,137720.51263503075,529,42,380.6666666666667,29,1,17,31.716973394454183,0.6641522988505747,42.46527777777777,1030.1388888888882,35.52203065134098,0
531,4,0,0,30,0.0,0.0,1.0,30,550,400,150,0.7272727272727273,7,4,3,418.75792730515025,0.6657088122605365,0.07986251516376841,0.254444313077552,132719.81336805562,5115.4947916666715,137835.3081597223,530,43,381.6666666666667,29,1,17,31.608454643482947,0.6648706896551724,42.395833333333336,1030.4166666666672,35.53160919540232,0
532,4,0,0,30,0.0,0.0,1.0,30,450,300,150,0.6666666666666666,6,3,3,419.1350981177271,0.6655172413793103,0.08338948030364257,0.25516009541687057,132791.3797260802,5131.505594135796,137922.88532021598,531,44,382.6666666666667,29,1,17,31.526383461348416,0.6655890804597702,42.326388888888886,1030.6944444444441,35.54118773946359,0
533,4,0,0,30,0.0,0.0,1.0,30,1000,800,200,0.8,12,8,4,419.9601481927816,0.6647988505747127,0.08286176232821352,0.25590675040121696,132827.17013888882,5156.423611111107,137983.5937499999,532,45,383.6666666666667,29,1,17,31.468943680948538,0.6659482758620691,42.291666666666664,1030.8333333333328,35.54597701149424,0
534,4,0,0,30,0.0,0.0,1.0,30,600,500,100,0.8333333333333334,7,5,2,419.7530864197531,0.6660919540229885,0.08154882154882159,0.25651577503429357,132934.5703125,5159.939236111111,138094.50954861112,533,46,384.6666666666667,29,1,17,31.365740740740737,0.6670258620689655,42.1875,1031.25,35.560344827586206,0
535,4,0,0,30,0.0,0.0,1.0,30,450,200,250,0.4444444444444444,7,2,5,419.7530864197531,0.6660919540229885,0.08154882154882159,0.25651577503429357,132934.5703125,5159.939236111111,138094.50954861112,534,47,385.6666666666667,29,1,17,31.365740740740737,0.6670258620689655,42.1875,1031.25,35.560344827586206,0
536,4,0,0,30,0.0,0.0,1.0,30,700,400,300,0.5714285714285714,10,4,6,417.9067379203433,0.668007662835249,0.08374837349127273,0.25636904673907773,133077.83805941363,5122.825038580253,138200.66309799388,535,48,386.6666666666667,29,1,18,31.26864876385337,0.6684626436781609,42.048611111111114,1031.8055555555559,35.579501915708825,0
537,4,0,0,30,0.0,0.0,1.0,30,700,500,200,0.7142857142857143,9,5,4,420.3986253260273,0.6670977011494253,0.07813060638679548,0.2586425979654831,133185.33950617292,5198.186728395074,138383.526234568,536,49,387.6666666666667,29,1,18,31.09582436311447,0.6695402298850575,41.94444444444445,1032.2222222222229,35.59386973180079,0
538,4,0,0,30,0.0,0.0,1.0,30,800,600,200,0.75,10,6,4,420.3986253260273,0.6670977011494253,0.07813060638679548,0.2586425979654831,133185.33950617292,5198.186728395074,138383.526234568,537,50,388.6666666666667,29,1,18,31.09582436311447,0.6695402298850575,41.94444444444445,1032.2222222222229,35.59386973180079,0
539,4,0,0,30,0.0,0.0,1.0,30,800,500,300,0.625,11,5,6,417.87585473718366,0.6672892720306514,0.07949959644874882,0.2575861612036669,133257.03125,5136.979166666666,138394.01041666666,538,51,389.6666666666667,29,1,19,31.088579499596452,0.6702586206896551,41.875,1032.5,35.60344827586207,0
540,4,0,0,30,0.0,0.0,1.0,30,300,200,100,0.6666666666666666,4,2,2,413.1977464608564,0.6672892720306514,0.04215726079307047,0.2440542085211246,131648.6328125,4879.383680555555,136528.01649305556,539,52,390.6666666666667,29,1,18,32.83639531736365,0.6540948275862069,43.4375,1026.25,35.38793103448276,3
541,4,1,0,31,0.03225806451612903,0.0,1.0,31,550,300,250,0.5454545454545454,8,3,5,402.0904757851366,0.6810931899641577,0.03741851093904924,0.2395932725937156,131983.3420951845,4413.848963753046,136397.19105893755,540,0,379.03225806451616,30,1,20,32.782319598866366,0.6545138888888888,43.11155913978495,1027.5537634408608,34.25179211469536,0
542,4,1,1,31,0.03125,0.03125,0.96875,32,650,500,150,0.7692307692307693,8,5,3,393.8215029642684,0.697202620967742,0.03371835443037963,0.2364126043630488,132264.03130425353,4017.683919270841,136281.71522352437,541,0,368.15625,31,1,20,32.710970464135016,0.6545698924731183,42.83854166666667,1028.645833333334,33.182123655914,0
543,4,0,0,31,0.0,0.0,1.0,31,450,300,150,0.6666666666666666,6,3,3,406.2589585047531,0.6805555555555556,0.044658523417465235,0.24273972770659,132086.9464677998,4532.301060816289,136619.2475286161,542,2,381.03225806451616,30,1,20,32.57033429218968,0.6555555555555554,43.01075268817205,1027.9569892473123,34.26523297491041,0
544,4,0,0,31,0.0,0.0,1.0,31,550,400,150,0.7272727272727273,7,4,3,408.0240390307794,0.6815412186379929,0.049801628292316824,0.24446295400348428,132190.59148817786,4587.387812174825,136777.9793003527,543,3,382.03225806451616,30,1,20,32.420054023439214,0.6565972222222222,42.90994623655914,1028.3602150537638,34.27867383512546,0
545,4,1,1,31,0.03125,0.03125,0.96875,32,550,400,150,0.7272727272727273,7,4,3,397.9293928032837,0.6969506048387097,0.043278332680506626,0.24016873281957052,132467.17693158166,4142.679247600879,136609.85617918253,544,0,371.0625,30,2,20,32.400063106584845,0.659375,42.641129032258064,1029.4354838709676,34.31451612903225,0
546,4,0,0,31,0.0,0.0,1.0,31,650,300,350,0.46153846153846156,10,3,7,413.2177219754462,0.681989247311828,0.05041138827216973,0.24893848128764692,132398.00347222228,4741.840277777782,137139.84375000006,545,5,384.03225806451616,29,2,20,32.07658569500675,0.6616379310344827,42.708333333333336,1029.166666666667,35.488505747126446,0
547,4,0,0,31,0.0,0.0,1.0,31,800,500,300,0.625,11,5,6,416.697716170467,0.682078853046595,0.05871986005404617,0.2517506250995657,132505.23003472216,4842.925347222218,137348.15538194438,546,6,385.03225806451616,29,2,20,31.87854107648725,0.6627155172413792,42.604166666666664,1029.583333333333,35.50287356321838,0
548,4,0,0,31,0.0,0.0,1.0,31,600,400,200,0.6666666666666666,8,4,4,417.1248730113845,0.6833333333333333,0.05449420607579092,0.2527285995304271,132612.5,4863.194444444445,137475.69444444444,547,7,386.03225806451616,29,2,21,31.759034519956842,0.6637931034482758,42.5,1030.0,35.51724137931034,0
549,4,0,0,31,0.0,0.0,1.0,31,500,300,200,0.6,7,3,4,413.52551756299215,0.6839605734767025,0.05809843079451604,0.25126501349712027,132719.8133680556,4776.605902777783,137496.41927083337,548,8,387.03225806451616,29,2,16,31.74324369861168,0.6648706896551724,42.395833333333336,1030.416666666667,35.53160919540231,0
550,4,0,0,31,0.0,0.0,1.0,31,550,300,250,0.5454545454545454,8,3,5,427.6844411979551,0.6839605734767025,0.04681778552746296,0.255231037489102,132040.89506172828,5094.367283950606,137135.2623456789,549,9,388.03225806451616,29,2,17,32.06644144144144,0.6580459770114943,43.05555555555555,1027.777777777777,35.440613026819896,3
551,4,0,1,30,0.0,0.03225806451612903,0.967741935483871,31,500,300,200,0.6,7,3,4,425.13509086048504,0.6832437275985663,0.04767446421799981,0.2539487334510453,132076.58420138896,5030.078125000005,137106.66232638896,550,10,389.03225806451616,29,2,17,32.09574719632481,0.6584051724137931,43.020833333333336,1027.9166666666672,35.445402298850595,0
552,4,0,0,30,0.0,0.0,1.0,30,450,200,250,0.4444444444444444,7,2,5,435.4786956011768,0.6708812260536399,0.054083288263926166,0.25890678719182525,131898.18672839517,5487.7700617284045,137385.95679012357,551,64,402.6666666666667,29,1,17,32.01110960879755,0.6566091954022988,43.19444444444445,1027.222222222223,35.42145593869735,0
553,4,0,0,30,0.0,0.0,1.0,30,1000,700,300,0.7,13,7,6,436.5885793211221,0.6710249042145594,0.05603623090442045,0.25981059704250525,131933.85657793208,5520.163001543209,137454.01957947528,552,65,403.6666666666667,29,1,17,31.94636902347799,0.6569683908045977,43.15972222222222,1027.361111111111,35.42624521072797,0
554,4,0,0,30,0.0,0.0,1.0,30,500,400,100,0.8,6,4,2,436.1421560951069,0.6720785440613027,0.051290714961480965,0.26003350628103905,132005.21074459868,5514.607445987641,137519.81819058632,553,66,404.6666666666667,29,1,17,31.88536176059828,0.6576867816091954,43.09027777777777,1027.6388888888882,35.43582375478925,0
555,4,0,0,30,0.0,0.0,1.0,30,650,500,150,0.7692307692307693,8,5,3,436.5595325054786,0.6722222222222223,0.05351351351351341,0.2605274629468177,132040.8950617283,5528.742283950605,137569.63734567893,554,67,405.6666666666667,29,1,17,31.8384009009009,0.6580459770114944,43.05555555555555,1027.7777777777771,35.4406130268199,0
556,4,0,0,30,0.0,0.0,1.0,30,450,200,250,0.4444444444444444,7,2,5,436.70255401006375,0.6727969348659004,0.05660632261550913,0.26110438649293144,132112.27816358022,5538.753858024685,137651.03202160491,555,68,406.6666666666667,29,1,17,31.762248941727453,0.6587643678160919,42.98611111111111,1028.0555555555552,35.450191570881216,0
557,4,2,0,32,0.0625,0.0,1.0,32,1150,1000,150,0.8695652173913043,13,10,3,416.5856125309683,0.6932123655913979,0.05324103308916395,0.2541236425285214,132867.44011772997,4670.132785373261,137537.57290310322,556,0,382.1875,31,1,19,31.515218489517554,0.6606182795698925,42.252604166666664,1030.989583333333,33.25772849462365,0
558,4,0,0,32,0.0,0.0,1.0,32,800,600,200,0.75,10,6,4,418.5044968349155,0.6906502016129032,0.052388429491225796,0.25598255748489307,132968.1417677137,4729.553053114145,137697.69482082786,557,1,383.1875,31,1,19,31.36401653831587,0.6616263440860215,42.154947916666664,1031.380208333333,33.27032930107526,0
559,4,0,0,32,0.0,0.0,1.0,32,700,400,300,0.5714285714285714,10,4,6,418.7903976631471,0.6912382392473119,0.05446969219124531,0.25754472321767,133169.6595085991,4754.034932454423,137923.69444105355,558,2,384.1875,31,1,19,31.1531527269669,0.6636424731182796,41.959635416666664,1032.161458333333,33.29553091397848,0
560,4,0,0,32,0.0,0.0,1.0,32,1000,800,200,0.8,12,8,4,418.8476482781403,0.6895161290322581,0.05220940494200699,0.2587460705718231,133337.70751953125,4769.637044270833,138107.3445638021,559,3,385.1875,31,1,19,30.98209783156833,0.6653225806451613,41.796875,1032.8125,33.31653225806452,0
561,4,0,0,32,0.0,0.0,1.0,32,650,600,50,0.9230769230769231,7,6,1,418.5367446292007,0.6880880376344086,0.05685184018149769,0.2590226623937657,133404.95639377163,4766.975233289921,138171.93162706154,560,4,386.1875,31,1,19,30.92229644567683,0.665994623655914,41.73177083333333,1033.072916666666,33.324932795698906,0
562,4,0,0,32,0.0,0.0,1.0,32,1000,800,200,0.8,12,8,4,418.6909312391283,0.6885500672043011,0.05513941398865807,0.25935304757084177,133438.5871887207,4773.905266655817,138212.49245537652,561,5,387.1875,31,1,19,30.88439928586432,0.6663306451612903,41.69921875,1033.203125,33.32913306451613,0
563,4,0,0,32,0.0,0.0,1.0,32,900,600,300,0.6666666666666666,12,6,6,417.4650086418674,0.6871639784946237,0.05680744520030245,0.2592986884662867,133539.5050048828,4749.614122178819,138289.11912706163,562,6,388.1875,31,1,19,30.81433190560174,0.6673387096774194,41.6015625,1033.59375,33.341733870967744,0
564,4,0,0,32,0.0,0.0,1.0,32,350,300,50,0.8571428571428571,4,3,1,418.5521796036382,0.6872899865591399,0.05308052021665177,0.26021031745288037,133573.15275404177,4781.46684434677,138354.61959838856,563,7,389.1875,31,1,19,30.75232501994372,0.6676747311827957,41.56901041666666,1033.7239583333323,33.345934139784916,0
565,4,0,0,32,0.0,0.0,1.0,32,600,300,300,0.5,9,3,6,418.5521796036382,0.6872899865591399,0.05308052021665177,0.26021031745288037,133573.15275404177,4781.46684434677,138354.61959838856,564,8,390.1875,31,1,19,30.75232501994372,0.6676747311827957,41.56901041666666,1033.7239583333323,33.345934139784916,0
566,4,0,0,32,0.0,0.0,1.0,32,650,300,350,0.46153846153846156,10,3,7,417.1209401485561,0.6882140456989247,0.05016292028711744,0.259792736134877,133640.46096801746,4748.846944173163,138389.30791219062,565,9,391.1875,31,1,20,30.72149288502707,0.6683467741935485,41.50390624999999,1033.984374999999,33.354334677419324,0
567,4,0,1,31,0.0,0.03125,0.96875,32,950,800,150,0.8421052631578947,11,8,3,416.6831465779082,0.6878360215053764,0.0551044813695869,0.2602304179571465,133741.45507812503,4745.562065972223,138487.01714409725,566,10,392.1875,31,1,18,30.6310842564619,0.6693548387096775,41.40625,1034.3750000000002,33.366935483870975,0
568,4,0,0,31,0.0,0.0,1.0,31,1200,900,300,0.75,15,9,6,422.8570884148146,0.6747311827956989,0.06588292511131444,0.26365173729850744,133680.63685108098,5105.560975257248,138786.19782633823,567,11,403.0967741935484,30,1,20,30.532720301533658,0.6715277777777778,41.46505376344086,1034.139784946236,34.47132616487453,0
569,4,0,0,31,0.0,0.0,1.0,31,850,500,350,0.5882352941176471,12,5,7,422.1615516444002,0.6760752688172043,0.06469217356314161,0.2637139043389044,133750.14452537854,5092.8337090993045,138842.97823447784,568,12,404.0967741935484,30,1,18,30.480660949410964,0.6722222222222223,41.397849462365585,1034.4086021505366,34.48028673835122,0
570,4,0,0,31,0.0,0.0,1.0,31,900,700,200,0.7777777777777778,11,7,4,424.85714285714283,0.6752688172043011,0.06387096774193535,0.2664006514657979,133889.21407099083,5176.7577899179,139065.97186090873,569,13,405.0967741935484,30,1,18,30.27083333333332,0.6736111111111112,41.26344086021505,1034.9462365591394,34.498207885304645,0
571,4,0,0,31,0.0,0.0,1.0,31,450,200,250,0.4444444444444444,7,2,5,422.0880081126345,0.6738351254480287,0.0608639565760043,0.26516491341627324,133958.77594230548,5108.478581338881,139067.25452364437,570,14,406.0967741935484,30,1,18,30.27244005885918,0.6743055555555555,41.196236559139784,1035.215053763441,34.507168458781365,0
572,4,0,0,31,0.0,0.0,1.0,31,700,400,300,0.5714285714285714,10,4,6,425.4313816830195,0.6727598566308244,0.0617525876796301,0.26777151670637095,134028.35587929236,5203.973725286154,139232.32960457852,571,15,407.0967741935484,30,1,18,30.11584890965732,0.675,41.12903225806451,1035.4838709677415,34.51612903225805,0
573,4,0,0,31,0.0,0.0,1.0,31,750,400,350,0.5333333333333333,11,4,7,425.4313816830195,0.6727598566308244,0.0617525876796301,0.26777151670637095,134028.35587929236,5203.973725286154,139232.32960457852,572,16,408.0967741935484,30,1,18,30.11584890965732,0.675,41.12903225806451,1035.4838709677415,34.51612903225805,0
574,4,0,0,31,0.0,0.0,1.0,31,900,700,200,0.7777777777777778,11,7,4,427.92620620336527,0.6703405017921147,0.0650098962670358,0.27062207740949457,134202.38475907609,5285.743474679139,139488.1282337552,573,17,409.0967741935484,30,1,18,29.876064772776406,0.6767361111111112,40.96102150537634,1036.1559139784938,34.53853046594979,0
575,4,0,1,30,0.0,0.03225806451612903,0.967741935483871,31,950,800,150,0.8421052631578947,11,8,3,438.8017282651443,0.6703405017921147,0.06526329044850687,0.27129455202877156,133368.0758794368,5504.428438258741,138872.50431769554,574,18,410.0967741935484,30,1,19,30.436185209282147,0.6684027777777779,41.76747311827956,1032.9301075268806,34.43100358422935,1
576,4,0,0,30,0.0,0.0,1.0,30,650,500,150,0.7692307692307693,8,5,3,448.183743531137,0.6587164750957855,0.07229320780094128,0.2765349488094606,133292.88435570968,5947.940779320961,139240.82513503064,575,19,424.1666666666667,29,1,20,30.26997870432639,0.670617816091954,41.840277777777764,1032.6388888888873,35.608237547892664,0
577,4,0,0,30,0.0,0.0,1.0,30,350,200,150,0.5714285714285714,5,2,3,449.16621839698774,0.659051724137931,0.06858526089295314,0.27740863787375414,133328.74228395053,5977.353395061719,139306.09567901224,576,20,425.1666666666667,29,1,20,30.20833333333333,0.670977011494253,41.80555555555555,1032.7777777777771,35.61302681992335,0
578,4,0,0,30,0.0,0.0,1.0,30,400,200,200,0.5,6,2,4,451.11327242422493,0.6582375478927204,0.07213930348258679,0.278880249960013,133364.605034722,6032.508680555515,139397.1137152775,577,21,426.1666666666667,29,1,20,30.12177289229527,0.6713362068965518,41.770833333333314,1032.9166666666647,35.617816091953955,0
579,4,0,0,30,0.0,0.0,1.0,30,700,500,200,0.7142857142857143,9,5,4,454.97058018381,0.6585727969348659,0.07332974862212649,0.2818090046617288,133436.345003858,6141.922260802463,139578.26726466048,578,22,427.1666666666667,29,1,20,29.949561993099422,0.6720545977011495,41.701388888888886,1033.1944444444443,35.627394636015325,0
580,4,0,0,30,0.0,0.0,1.0,30,450,400,50,0.8888888888888888,5,4,1,455.8530330640642,0.658860153256705,0.07075661873404071,0.28290262043617176,133508.10426311716,6172.014853395046,139680.1191165122,579,23,428.1666666666667,29,1,20,29.854158267257983,0.6727729885057472,41.631944444444436,1033.4722222222213,35.636973180076595,0
581,4,1,1,30,0.03225806451612903,0.03225806451612903,0.967741935483871,31,950,700,250,0.7368421052631579,12,7,5,444.0605175899878,0.6733870967741935,0.059789918254988805,0.2781791639483574,133854.43990996052,5687.894373626979,139542.3342835875,580,0,415.3225806451613,30,1,18,29.809066112482125,0.673263888888889,41.297043010752674,1034.8118279569878,34.49372759856626,0
582,4,0,0,30,0.0,0.0,1.0,30,850,800,50,0.9411764705882353,9,8,1,456.1479462043169,0.655411877394636,0.07330827067669166,0.28501593148739524,133759.41358024688,6202.816358024685,139962.22993827157,581,25,430.1666666666667,29,1,18,29.59239616899391,0.6752873563218391,41.388888888888886,1034.4444444444443,35.67049808429118,0
583,4,0,0,30,0.0,0.0,1.0,30,800,500,300,0.625,11,5,6,450.3281549420318,0.6564655172413794,0.07353730542136327,0.28247856991818343,133903.12499999988,6060.06944444443,139963.19444444432,582,26,431.1666666666667,29,1,18,29.597758990874937,0.6767241379310346,41.24999999999999,1034.999999999999,35.689655172413765,0
584,4,0,0,30,0.0,0.0,1.0,30,350,100,250,0.2857142857142857,6,1,5,448.8472139077236,0.656992337164751,0.0706426942170939,0.2818246238630378,133939.06491126522,6023.635223765405,139962.7001350306,583,27,432.1666666666667,29,1,18,29.59979762064494,0.6770833333333335,41.215277777777764,1035.138888888887,35.694444444444386,0
585,4,0,0,30,0.0,0.0,1.0,30,1100,900,200,0.8181818181818182,13,9,4,444.52311868426193,0.6583812260536399,0.07763475462590508,0.2804782926520493,134118.83680555545,5923.784722222203,140042.62152777764,584,28,433.1666666666667,29,1,19,29.530370072405464,0.6788793103448276,41.04166666666666,1035.8333333333323,35.71839080459767,0
586,4,0,0,30,0.0,0.0,1.0,30,650,500,150,0.7692307692307693,8,5,3,445.30615471972067,0.6562739463601532,0.07426273458445021,0.28152406052619616,134190.77932098752,5951.195987654305,140141.97530864182,585,29,434.1666666666667,29,1,19,29.43755585344056,0.6795977011494254,40.972222222222214,1036.1111111111102,35.727969348658974,0
587,4,0,0,30,0.0,0.0,1.0,30,550,300,250,0.5454545454545454,8,3,5,442.8110736495988,0.6579022988505747,0.07276869471991398,0.2804971334102973,134262.741126543,5890.605709876516,140153.3468364195,586,30,435.1666666666667,29,1,19,29.429665862592678,0.6803160919540231,40.902777777777764,1036.3888888888873,35.73754789272025,0
588,4,0,0,30,0.0,0.0,1.0,30,450,200,250,0.4444444444444444,7,2,5,442.8110736495988,0.6579022988505747,0.07276869471991398,0.2804971334102973,134262.741126543,5890.605709876516,140153.3468364195,587,31,436.1666666666667,29,1,19,29.429665862592678,0.6803160919540231,40.902777777777764,1036.3888888888873,35.73754789272025,0
589,4,0,0,30,0.0,0.0,1.0,30,900,600,300,0.6666666666666666,12,6,6,441.8895586273923,0.6582854406130269,0.06966773847802821,0.28046459741452845,134334.72222222216,5872.222222222212,140206.94444444438,588,32,437.1666666666667,29,1,19,29.381028938906745,0.6810344827586208,40.83333333333333,1036.666666666666,35.747126436781585,0
590,4,0,0,30,0.0,0.0,1.0,30,1100,1000,100,0.9090909090909091,12,10,2,445.44537253586907,0.6579980842911878,0.07139030270559843,0.2832789737097783,134406.72260802466,5974.170524691353,140380.893132716,589,33,438.1666666666667,29,1,19,29.21633628002499,0.6817528735632185,40.763888888888886,1036.9444444444443,35.75670498084291,0
591,4,0,0,30,0.0,0.0,1.0,30,250,200,50,0.8,3,2,1,444.1382178007501,0.656896551724138,0.07171554841301697,0.2827263488762319,134442.73003472216,5942.230902777772,140384.96093749994,590,34,439.1666666666667,29,1,19,29.21395808222848,0.6821120689655173,40.729166666666664,1037.083333333333,35.761494252873554,0
592,4,0,0,30,0.0,0.0,1.0,30,550,200,350,0.36363636363636365,9,2,7,445.0418986239209,0.6572796934865901,0.07129468469674638,0.28386148085585505,134514.75935570977,5972.940779320971,140487.70013503075,591,35,440.1666666666667,29,1,19,29.117993261034485,0.682830459770115,40.659722222222214,1037.3611111111104,35.77107279693484,0
593,4,0,0,30,0.0,0.0,1.0,30,600,400,200,0.6666666666666666,8,4,4,452.98688011345905,0.6572796934865901,0.053821313240043134,0.2786919282287441,133185.33950617292,6066.242283950627,139251.58179012354,592,36,441.1666666666667,29,1,17,30.254866343738794,0.6695402298850575,41.94444444444445,1032.2222222222229,35.59386973180079,3
594,4,1,0,31,0.03225806451612903,0.0,1.0,31,800,500,300,0.625,11,5,6,441.2721123829342,0.6707885304659498,0.05150884495317376,0.2735887096774194,133472.22222222228,5579.513888888899,139051.73611111118,593,0,427.9032258064516,30,1,18,30.267137096774192,0.6694444444444445,41.66666666666667,1033.333333333334,34.444444444444464,0
595,4,0,0,31,0.0,0.0,1.0,31,1050,700,350,0.6666666666666666,14,7,7,433.8753171282839,0.6710573476702509,0.05047265715064242,0.2707762015654617,133715.38843002077,5403.1613120013835,139118.54974202215,594,1,428.9032258064516,30,1,17,30.21280051981806,0.671875,41.431451612903224,1034.2741935483868,34.4758064516129,0
596,4,0,0,31,0.0,0.0,1.0,31,550,500,50,0.9090909090909091,6,5,1,433.519275612571,0.6708781362007168,0.050658909529877505,0.2708087942462942,133750.14452537856,5396.653153543748,139146.7976789223,595,2,429.9032258064516,30,1,18,30.18694776507276,0.6722222222222223,41.397849462365585,1034.4086021505368,34.480286738351225,0
597,4,0,0,31,0.0,0.0,1.0,31,700,600,100,0.8571428571428571,8,6,2,431.80229015563566,0.671326164874552,0.052070500087999516,0.2702450430583807,133819.67026534854,5356.728017689901,139176.39828303843,596,3,430.9032258064516,30,1,18,30.16124318004677,0.6729166666666667,41.33064516129032,1034.6774193548383,34.489247311827945,0
598,4,0,0,31,0.0,0.0,1.0,31,400,200,200,0.5,6,2,4,429.31115160995205,0.6718637992831541,0.04146089112850837,0.2694478548124075,133923.99274843908,5299.012711007047,139223.00545944614,597,4,431.9032258064516,30,1,18,30.120547115093274,0.6739583333333334,41.229838709677416,1035.08064516129,34.502688172043,0
599,4,0,0,31,0.0,0.0,1.0,31,700,500,200,0.7142857142857143,9,5,4,428.9935424841677,0.6722222222222223,0.04358020969416798,0.2700135826223878,134028.35587929236,5299.459836397264,139327.81571568962,598,5,432.9032258064516,30,1,19,30.023634908272754,0.675,41.12903225806451,1035.4838709677415,34.51612903225805,0
600,4,0,1,30,0.0,0.03225806451612903,0.967741935483871,31,400,200,200,0.5,6,2,4,427.57119798406603,0.6719534050179211,0.04454585417931378,0.2693733508149818,134063.15262241298,5264.3085544571595,139327.46117687013,599,6,433.9032258064516,30,1,19,30.02541639627948,0.6753472222222222,41.09543010752688,1035.6182795698924,34.520609318996414,0
601,4,0,0,30,0.0,0.0,1.0,30,500,300,200,0.6,7,3,4,433.22308094037055,0.6646551724137931,0.06297786720321907,0.2725466724397016,134010.95920138893,5611.3281250000055,139622.28732638893,600,7,447.93333333333334,29,1,19,29.93167337357478,0.677801724137931,41.145833333333336,1035.416666666667,35.704022988505756,0
602,4,1,1,30,0.03225806451612903,0.03225806451612903,0.967741935483871,31,950,800,150,0.8421052631578947,11,8,3,422.82746832010474,0.6780465949820789,0.055707067326997706,0.2681616312240662,134306.85628396337,5157.725604116066,139464.58188807944,601,0,434.4516129032258,30,1,19,29.903073132780083,0.6777777777777778,40.86021505376343,1036.5591397849455,34.55197132616485,0
603,4,0,0,30,0.0,0.0,1.0,30,550,400,150,0.7272727272727273,7,4,3,432.949801588632,0.6617337164750958,0.06750234615900252,0.27344390940301466,134154.80565200603,5616.459297839488,139771.26494984553,602,9,449.93333333333334,29,1,19,29.793845242883307,0.6792385057471265,41.006944444444436,1035.9722222222213,35.72318007662832,0
604,4,0,0,30,0.0,0.0,1.0,30,500,500,0,1.0,5,5,0,400.7395116039267,0.6617816091954023,0.02759884786593303,0.23727506896362732,131741.75663371486,4558.825442247653,136300.5820759625,603,10,450.93333333333334,30,0,20,33.061665357423394,0.6520833333333333,43.346774193548384,1026.6129032258063,34.22043010752688,7
605,4,0,0,30,0.0,0.0,1.0,30,750,500,250,0.6666666666666666,10,5,5,400.0247042545486,0.662116858237548,0.02773050573809832,0.23706661875876628,131776.255293242,4542.751510290205,136319.0068035322,604,11,451.93333333333334,30,0,20,33.045064799057464,0.6524305555555556,43.31317204301075,1026.747311827957,34.22491039426523,0
606,4,0,0,30,0.0,0.0,1.0,30,550,400,150,0.7272727272727273,7,4,3,400.0247042545486,0.662116858237548,0.02773050573809832,0.23706661875876628,131776.255293242,4542.751510290205,136319.0068035322,605,12,452.93333333333334,30,0,20,33.045064799057464,0.6524305555555556,43.31317204301075,1026.747311827957,34.22491039426523,0
607,4,0,0,30,0.0,0.0,1.0,30,450,200,250,0.4444444444444444,7,2,5,400.0247042545486,0.662116858237548,0.02773050573809832,0.23706661875876628,131776.255293242,4542.751510290205,136319.0068035322,606,13,453.93333333333334,30,0,20,33.045064799057464,0.6524305555555556,43.31317204301075,1026.747311827957,34.22491039426523,0
608,4,0,0,30,0.0,0.0,1.0,30,750,600,150,0.8,9,6,3,400.6164167648911,0.6633141762452107,0.030296684118673367,0.2376327192611621,131810.75846918716,4561.110749797653,136371.86921898482,607,14,454.93333333333334,30,0,20,32.99492801047119,0.6527777777777779,43.27956989247311,1026.8817204301072,34.22939068100357,0
609,4,0,0,30,0.0,0.0,1.0,30,950,600,350,0.631578947368421,13,6,7,398.4749083923804,0.6646551724137931,0.029207013870714338,0.2367920101037769,131879.77837033186,4510.156520985081,136389.93489131692,608,15,455.93333333333334,30,0,20,32.98002268167146,0.6534722222222222,43.21236559139785,1027.1505376344087,34.23835125448029,0
610,4,0,0,30,0.0,0.0,1.0,30,800,600,200,0.75,10,6,4,398.1980213661161,0.6634578544061303,0.035538991325574365,0.23770650034244228,132052.40716050973,4516.601449589523,136569.00861009926,609,16,456.93333333333334,30,0,20,32.81243189050172,0.6552083333333334,43.044354838709666,1027.8225806451599,34.260752688172,0
611,4,0,0,30,0.0,0.0,1.0,30,450,300,150,0.6666666666666666,6,3,3,396.8938797807128,0.662595785440613,0.02823462762016793,0.23736053842397742,132121.49029150757,4487.6421768412365,136609.1324683488,610,17,457.93333333333334,30,0,20,32.776070946093164,0.6559027777777778,42.9771505376344,1028.0913978494616,34.26971326164872,0
612,4,0,0,30,0.0,0.0,1.0,30,1000,800,200,0.8,12,8,4,399.15899813182256,0.6633620689655173,0.035250294079205435,0.23915156575619204,132190.5914881778,4553.012812174812,136743.6043003526,611,18,458.93333333333334,30,0,20,32.64796540757199,0.6565972222222223,42.909946236559136,1028.360215053763,34.27867383512544,0
613,4,1,1,30,0.03225806451612903,0.03225806451612903,0.967741935483871,31,600,400,200,0.6666666666666666,8,4,4,389.02641324837384,0.6754480286738351,0.026571411722087213,0.2345798639886651,132432.58794369295,4104.117528037933,136536.70547173088,612,0,445.0967741935484,30,1,20,32.66409854618265,0.6590277777777778,42.6747311827957,1029.3010752688176,34.31003584229392,0
614,4,0,0,30,0.0,0.0,1.0,30,600,400,200,0.6666666666666666,8,4,4,399.7411658322306,0.6624521072796935,0.025594025797691433,0.23090930873367677,130794.81336805559,4456.814236111116,135251.62760416672,613,20,460.93333333333334,29,1,20,34.04828581126951,0.6454741379310345,44.270833333333336,1022.916666666667,35.272988505747136,2
615,4,0,0,30,0.0,0.0,1.0,30,700,300,400,0.42857142857142855,11,3,8,398.41493791849956,0.6628831417624521,0.024574081373450518,0.23024571697021273,130812.00003251826,4423.49097439011,135235.49100690839,614,21,461.93333333333334,30,0,20,34.064730871983535,0.6427083333333332,44.25403225806452,1022.9838709677423,34.09946236559141,0
616,4,0,0,30,0.0,0.0,1.0,30,450,300,150,0.6666666666666666,6,3,3,411.0471267684562,0.6632183908045978,0.011383776414451319,0.2310368333215805,129731.4453125,4666.163763513123,134397.60907601312,615,22,462.93333333333334,29,1,17,34.84364349011588,0.634698275862069,45.3125,1018.75,35.12931034482759,5
617,4,0,0,30,0.0,0.0,1.0,30,350,300,50,0.8571428571428571,4,3,1,409.875738652783,0.6637931034482759,0.012813522355507034,0.23058653518073738,129766.82098765422,4637.654320987642,134404.47530864188,616,23,463.93333333333334,29,1,17,34.837331879316615,0.635057471264368,45.27777777777777,1018.8888888888881,35.13409961685821,0
618,4,0,0,30,0.0,0.0,1.0,30,400,300,100,0.75,5,3,2,410.8431407026271,0.6647509578544062,0.01621695284818747,0.2315489221563656,129837.5868055557,4668.576388888909,134506.1631944446,617,24,464.93333333333334,29,1,17,34.740392477514305,0.6357758620689654,45.20833333333334,1019.1666666666678,35.14367816091958,0
619,4,0,0,30,0.0,0.0,1.0,30,900,800,100,0.8888888888888888,10,8,2,413.97226422412604,0.6654214559386974,0.02274584581857786,0.23415904190551104,129979.17631172846,4761.554783950628,134740.73109567908,618,25,465.93333333333334,29,1,17,34.51602651411968,0.6372126436781609,45.06944444444445,1019.7222222222227,35.16283524904216,0
620,4,0,0,30,0.0,0.0,1.0,30,400,200,200,0.5,6,2,4,415.79894485027137,0.6661877394636015,0.02587145969498872,0.23561940208182042,130049.99999999999,4814.930555555555,134864.93055555553,619,26,466.93333333333334,29,1,18,34.39712690631808,0.6379310344827587,45.0,1019.9999999999999,35.172413793103445,0
621,4,2,1,31,0.0625,0.03125,0.96875,32,450,300,150,0.6666666666666666,6,3,3,395.95924540109974,0.6993027553763441,0.011648922187171618,0.2282165105311794,130708.89698231014,3951.252854376236,134660.14983668638,620,0,438.6875,30,2,15,34.23233219418157,0.6416666666666666,44.35483870967742,1022.5806451612907,34.08602150537636,0
622,4,1,0,32,0.03125,0.0,1.0,32,550,400,150,0.7272727272727273,7,4,3,393.6820585578706,0.6992187500000001,0.02630714661061484,0.2277133609226833,130846.37674875717,3902.3741906578907,134748.75093941507,621,0,439.65625,30,2,16,34.15084734629532,0.6430555555555555,44.22043010752689,1023.1182795698932,34.10394265232977,0
623,4,0,1,31,0.0,0.03125,0.96875,32,750,600,150,0.8,9,6,3,395.6729146305131,0.6995127688172044,0.019226034143138282,0.22947823647458945,130949.53399598229,3962.636757139564,134912.17075312184,622,1,440.65625,30,2,16,33.99513022543226,0.6440972222222221,44.11962365591398,1023.5215053763449,34.117383512544826,0
624,4,1,0,32,0.03125,0.0,1.0,32,550,300,250,0.5454545454545454,8,3,5,393.2464642707064,0.7023269489247312,0.02786253280839901,0.22909312368064078,131121.55306971897,3912.617426870147,135034.17049658913,623,0,440.71875,30,2,17,33.88260061242344,0.6458333333333335,43.9516129032258,1024.1935483870961,34.13978494623654,0
625,4,0,0,32,0.0,0.0,1.0,32,550,300,250,0.5454545454545454,8,3,5,392.5312941497567,0.7027469758064516,0.02068846759380727,0.22908679356887016,131190.39231414025,3899.2668950167476,135089.659209157,624,1,441.71875,30,2,17,33.83107014781771,0.6465277777777778,43.88440860215053,1024.462365591397,34.14874551971323,0
626,4,0,0,32,0.0,0.0,1.0,32,550,400,150,0.7272727272727273,7,4,3,380.73608052340876,0.7054351478494624,-0.01267041851616968,0.2255525165234468,131762.2396681043,3633.327738444005,135395.5674065483,625,2,442.71875,31,1,19,33.55434897484676,0.6495295698924731,43.326822916666664,1026.6927083333328,33.1191196236559,2
627,4,2,3,31,0.058823529411764705,0.08823529411764706,0.9117647058823529,34,400,200,200,0.5,6,2,4,363.59472592264126,0.727124183006536,-0.018785397857903563,0.21794906713877177,132208.88600538246,2814.090734332946,135022.9767397154,626,0,417.61764705882354,33,1,19,33.543851286939955,0.648989898989899,42.8921568627451,1028.431372549019,31.16458704693997,0
628,4,0,0,31,0.0,0.0,1.0,31,1050,900,150,0.8571428571428571,12,9,3,391.9188723372322,0.6943548387096774,-0.005652342891904416,0.23163254714915635,131672.7728639147,4121.008931668372,135793.78179558305,627,6,458.93548387096774,30,1,19,33.35788807403526,0.651388888888889,43.41397849462364,1026.3440860215037,34.211469534050124,0
629,4,0,0,31,0.0,0.0,1.0,31,550,500,50,0.9090909090909091,6,5,1,393.43736002000634,0.6937275985663083,-0.009256404950825026,0.2331627613027793,131776.25529324185,4169.14039917908,135945.39569242092,628,7,459.93548387096774,30,1,20,33.214153248680034,0.6524305555555556,43.313172043010745,1026.7473118279559,34.224910394265194,0
630,4,2,0,33,0.06060606060606061,0.0,1.0,33,750,500,250,0.6666666666666666,10,5,5,371.9935262900374,0.7269570707070707,-0.005086447295036045,0.22391043126025154,132365.51914345482,3247.8232450770483,135613.34238853186,629,0,433.0,32,1,23,33.16998977505114,0.6529947916666666,42.739898989899,1029.0404040404046,32.157512626262644,0
631,4,0,0,33,0.0,0.0,1.0,33,650,500,150,0.7692307692307693,8,5,3,405.74278845096677,0.7279040404040404,-0.06548698293207256,0.24839987404239247,133001.7174614801,4232.757154857252,137234.47461633733,630,1,434.0,31,2,17,31.65919801396954,0.6619623655913978,42.122395833333336,1031.510416666667,33.274529569892486,5
632,4,0,1,32,0.0,0.030303030303030304,0.9696969696969697,33,500,400,100,0.8,6,4,2,405.3744987031161,0.7273516414141414,-0.06664142370314285,0.24839769166471679,133035.29739379883,4185.823398166233,137221.12079196505,631,2,435.0,31,2,18,31.634823719971397,0.6622983870967742,42.08984375,1031.640625,33.27872983870968,0
633,4,0,1,31,0.0,0.03125,0.96875,32,700,500,200,0.7142857142857143,9,5,4,414.14659288194434,0.7144237231182796,-0.04296875,0.2548594417735042,133194.58896982312,4632.417042432655,137827.00601225576,632,3,449.25,30,2,18,31.24782986111111,0.6666666666666666,41.935483870967744,1032.2580645161293,34.40860215053764,0
634,4,0,1,30,0.0,0.03225806451612903,0.967741935483871,31,450,200,250,0.4444444444444444,7,2,5,419.09509513453,0.7011648745519713,-0.018663842494531124,0.25784062475495273,133185.33950617292,4963.46450617285,138148.80401234576,633,4,464.38709677419354,29,2,18,31.129462683889496,0.6695402298850575,41.94444444444445,1032.2222222222229,35.59386973180079,0
635,4,0,0,30,0.0,0.0,1.0,30,650,500,150,0.7692307692307693,8,5,3,412.9490617524222,0.6826149425287357,-0.02444560623883607,0.24741372525197988,132190.59148817786,4917.596145508159,137108.18763368603,634,5,480.73333333333335,30,0,19,32.29343658780988,0.6565972222222222,42.90994623655914,1028.3602150537638,34.27867383512546,2
636,4,0,0,30,0.0,0.0,1.0,30,750,500,250,0.6666666666666666,10,5,5,414.0466500935808,0.6817528735632185,-0.024162856520792975,0.24898091959672908,132328.84807853508,4958.063251531967,137286.91133006706,635,6,481.73333333333335,30,0,19,32.125244937949056,0.657986111111111,42.7755376344086,1028.8978494623655,34.29659498207885,0
637,4,1,1,30,0.03225806451612903,0.03225806451612903,0.967741935483871,31,650,500,150,0.7692307692307693,8,5,3,400.9283790320521,0.6976702508960574,-0.0258358104884584,0.24304554839253356,132632.61795043945,4435.236104329428,137067.8540547689,636,0,467.16129032258067,31,0,17,32.15577992668436,0.658266129032258,42.48046875,1030.078125,33.228326612903224,0
638,4,1,1,30,0.03225806451612903,0.03225806451612903,0.967741935483871,31,850,700,150,0.8235294117647058,10,7,3,398.7786168644412,0.6951612903225807,-0.01982853858289535,0.2421746120681755,132699.68880547432,4383.55967203778,137083.2484775121,637,0,468.1290322580645,31,0,17,32.14344011963435,0.6589381720430106,42.41536458333334,1030.3385416666679,33.236727150537675,0
639,4,1,1,30,0.03225806451612903,0.03225806451612903,0.967741935483871,31,650,500,150,0.7692307692307693,8,5,3,401.22073637903816,0.6931899641577061,-0.02294776043385549,0.24453152963147404,132833.88137817392,4459.141540527357,137293.02291870126,638,0,469.0967741935484,31,0,18,31.945102311481634,0.660282258064516,42.28515625000001,1030.8593750000007,33.25352822580648,0
640,4,0,0,30,0.0,0.0,1.0,30,550,400,150,0.7272727272727273,7,4,3,413.37366488407326,0.68227969348659,-0.019679972171493088,0.2511032103804521,132709.4263065094,4971.716383396925,137681.14268990635,639,10,485.73333333333335,30,0,18,31.75765283937735,0.6618055555555555,42.405913978494624,1030.3763440860214,34.34587813620071,0
641,4,0,0,30,0.0,0.0,1.0,30,600,500,100,0.8333333333333334,7,5,2,412.30769147040905,0.68227969348659,-0.016710137367414113,0.25091868080913476,132778.6810613944,4949.134292981858,137727.81535437625,640,11,486.73333333333335,30,0,18,31.715136498000348,0.6624999999999999,42.33870967741936,1030.645161290323,34.35483870967743,0
642,4,0,0,30,0.0,0.0,1.0,30,700,600,100,0.8571428571428571,8,6,2,405.80341172645706,0.6819923371647509,-0.013468891206117828,0.24787609671698893,132917.24476818144,4787.654280841728,137704.89904902317,641,12,487.73333333333335,30,0,18,31.74286366006255,0.6638888888888888,42.20430107526882,1031.1827956989257,34.37275985663086,0
643,4,1,0,31,0.03225806451612903,0.0,1.0,31,850,600,250,0.7058823529411765,11,6,5,395.9939508530662,0.6985663082437276,-0.01640157832648592,0.24418600546382715,133270.47559950096,4354.86043294272,137625.33603244368,642,0,472.96774193548384,31,0,19,31.639869693148377,0.6646505376344085,41.86197916666667,1032.5520833333342,33.30813172043013,0
644,4,0,0,31,0.0,0.0,1.0,31,950,700,250,0.7368421052631579,12,7,5,395.59718236824165,0.6982078853046595,-0.01899302803016445,0.24504790336393428,133438.5871887207,4357.585822211372,137796.17301093208,643,1,473.96774193548384,31,0,19,31.480912623398446,0.6663306451612903,41.69921875,1033.203125,33.32913306451613,0
645,4,1,0,32,0.03125,0.0,1.0,32,1200,1000,200,0.8333333333333334,14,10,4,405.77063550036553,0.7151377688172044,-0.021790540540540526,0.24215344376634695,132040.8950617282,4315.663580246891,136356.55864197508,644,0,460.125,32,0,19,32.6295045045045,0.6497395833333335,43.05555555555554,1027.7777777777762,32.11805555555551,2
646,4,0,0,32,0.0,0.0,1.0,32,700,300,400,0.42857142857142855,11,3,8,401.8373284526685,0.7129116263440861,-0.018616449711408523,0.24042331855915325,132138.2404378378,4219.615504795407,136357.8559426332,645,1,461.125,32,0,20,32.632066396495965,0.6507161458333335,42.960858585858574,1028.1565656565642,32.12989267676763,0
647,4,0,0,32,0.0,0.0,1.0,32,750,500,250,0.6666666666666666,10,5,5,401.3804643348535,0.7155997983870969,-0.02392368356450225,0.240976171181728,132268.09007052841,4217.965481838573,136486.05555236698,646,2,462.125,32,0,20,32.512479031136195,0.6520182291666667,42.83459595959595,1028.6616161616153,32.14567550505048,0
648,4,0,0,32,0.0,0.0,1.0,32,500,300,200,0.6,7,3,4,403.22273517799977,0.7151797715053764,-0.024424009080868947,0.24249904568011177,132333.03880024972,4271.937971890591,136604.9767721403,647,3,463.125,32,0,20,32.399425287356316,0.6526692708333335,42.77146464646463,1028.9141414141393,32.15356691919185,0
649,4,1,1,32,0.030303030303030304,0.030303030303030304,0.9696969696969697,33,1000,600,400,0.6,14,6,8,394.7346448038067,0.7333491161616162,-0.03284810993590437,0.2394039988615291,132650.37035034577,3872.3393646674026,136522.70971501316,648,0,450.06060606060606,33,0,17,32.29736696010786,0.653409090909091,42.46323529411763,1030.1470588235272,31.216577540106886,0
650,4,0,0,32,0.0,0.0,1.0,32,800,600,200,0.75,10,6,4,403.5805351630976,0.7152637768817205,-0.026682250153280185,0.24397325902557856,132527.98064291888,4297.142670390746,136825.12331330962,649,5,465.125,32,0,20,32.19318414060904,0.6546223958333335,42.58207070707069,1029.6717171717153,32.1772411616161,0
651,4,0,1,31,0.0,0.03125,0.96875,32,850,700,150,0.8235294117647058,10,7,3,390.8180231724619,0.7152637768817205,-0.019536264441591733,0.21349736328986546,128606.37240939685,3655.6895047131466,132262.06191411,650,6,466.125,31,1,18,36.508878904578516,0.6176075268817203,46.41927083333334,1014.3229166666679,32.72009408602155,7
652,4,2,2,31,0.06060606060606061,0.06060606060606061,0.9393939393939394,33,700,600,100,0.8571428571428571,8,6,2,381.0519019761509,0.7350063131313131,-0.024708103037084594,0.20977415794621368,128912.72454660237,3224.487775482093,132137.21232208447,651,0,452.3030303030303,32,1,19,36.4431804053214,0.6181640625,46.11742424242424,1015.530303030303,31.73532196969697,0
653,4,2,1,32,0.06060606060606061,0.030303030303030304,0.9696969696969697,33,750,400,350,0.5333333333333333,11,4,7,379.36252459395837,0.7357165404040404,-0.012249200075286959,0.2100322092834504,129137.21335833096,3197.9638557290295,132335.17721405998,652,0,453.24242424242425,32,1,20,36.25672877846791,0.6204427083333333,45.89646464646466,1016.4141414141429,31.762941919191967,0
654,4,0,0,32,0.0,0.0,1.0,32,900,800,100,0.8888888888888888,10,8,2,392.69208474995816,0.7221522177419355,-0.008723724685977707,0.21667493954873965,129002.8974745011,3731.683349609408,132734.5808241105,653,1,468.40625,31,1,20,36.055391779885504,0.6216397849462364,46.02864583333335,1015.8854166666684,32.77049731182802,0
655,4,1,0,33,0.030303030303030304,0.0,1.0,33,850,600,250,0.7058823529411765,11,6,5,380.85581401682686,0.7446338383838385,-0.02016691677855853,0.21206325456348138,129361.89746263146,3253.646152178366,132615.54361480984,654,0,455.1818181818182,32,1,21,35.98940879566423,0.6227213541666665,45.67550505050506,1017.2979797979806,31.790561868686893,0
656,4,1,2,32,0.029411764705882353,0.058823529411764705,0.9411764705882353,34,550,400,150,0.7272727272727273,7,4,3,368.6759350337452,0.7540849673202615,-0.023466419415798967,0.20689167427855876,129669.02941476837,2761.170132881587,132430.19954764997,655,0,442.7647058823529,33,1,17,35.9863183331328,0.6234217171717171,45.37377450980392,1018.5049019607844,30.86378490790256,0
657,4,2,2,32,0.058823529411764705,0.058823529411764705,0.9411764705882353,34,700,500,200,0.7142857142857143,9,5,4,367.8987982453668,0.7501856803327392,-0.02107713424556734,0.20694929692909197,129762.65889321415,2747.9052527873882,132510.56414600153,656,0,443.6764705882353,33,1,18,35.910813086360356,0.6243686868686869,45.28186274509804,1018.8725490196078,30.874925727866906,0
658,4,2,1,33,0.058823529411764705,0.029411764705882353,0.9705882352941176,34,700,500,200,0.7142857142857143,9,5,4,367.2784460550562,0.7422385620915033,-0.006382798252682065,0.20792457333810724,130012.50270328722,2750.1579921184216,132762.66069540565,657,0,444.61764705882354,33,1,19,35.67251461988305,0.6268939393939394,45.036764705882355,1019.8529411764707,30.904634581105174,0
659,4,0,0,33,0.0,0.0,1.0,33,1100,600,500,0.5454545454545454,16,6,10,374.06850891412955,0.7340593434343435,-0.001193653367566272,0.21103110219872606,129876.19447314063,3116.5188820018543,132992.71335514248,658,1,459.09090909090907,32,1,19,35.638083735909824,0.6279296875,45.170454545454554,1019.3181818181829,31.853693181818215,0
660,4,0,0,33,0.0,0.0,1.0,33,300,100,200,0.3333333333333333,5,1,4,375.79163851539494,0.7346117424242425,0.0018165304268851212,0.21217774051561525,129908.37191358028,3163.6959876543297,133072.0679012346,659,2,460.09090909090907,32,1,19,35.561421435059046,0.6282552083333333,45.13888888888889,1019.4444444444447,31.857638888888896,0
661,4,0,0,33,0.0,0.0,1.0,33,1100,700,400,0.6363636363636364,15,7,8,376.5325249652811,0.7350063131313131,0.0038723040208921145,0.21294654563162563,129972.73875114803,3187.7926997245368,133160.53145087257,660,3,461.09090909090907,32,1,19,35.4770307082714,0.62890625,45.075757575757585,1019.6969696969712,31.86553030303035,0
662,4,0,0,33,0.0,0.0,1.0,33,850,700,150,0.8235294117647058,10,7,3,374.55005660893994,0.7358743686868687,0.0019284087626294522,0.21200005656835377,130004.92814827575,3138.6706394755747,133143.59878775134,661,4,462.09090909090907,32,1,19,35.494820684247465,0.6292317708333333,45.044191919191924,1019.8232323232328,31.869476010101025,0
663,4,3,2,34,0.08333333333333333,0.05555555555555555,0.9444444444444444,36,850,700,150,0.8235294117647058,10,7,3,347.57804864703246,0.7593584656084656,0.0006916151099041201,0.20046995025099076,130735.62349965703,1888.1665809327826,132623.79008058982,662,0,424.5,35,1,16,35.44213067753131,0.6297619047619047,44.3287037037037,1022.6851851851849,29.21957671957671,0
664,4,0,0,34,0.0,0.0,1.0,34,500,200,300,0.4,8,2,6,365.30814035957025,0.7443924539512775,0.010086251923375533,0.20881193702034692,130387.71896626304,2726.339028258366,133114.0579945214,663,1,450.47058823529414,33,1,20,35.34167266618668,0.6306818181818181,44.669117647058826,1021.3235294117653,30.949197860962585,0
665,4,0,0,34,0.0,0.0,1.0,34,950,600,350,0.631578947368421,13,6,7,363.4445401388364,0.7440953654188949,0.010208400942530949,0.20841819640148698,130512.91120001939,2686.8409986543793,133199.75219867376,664,2,451.47058823529414,33,1,16,35.26225313824258,0.6319444444444444,44.54656862745099,1021.8137254901974,30.96405228758174,0
666,4,0,0,34,0.0,0.0,1.0,34,1000,800,200,0.8,12,8,4,375.816936337864,0.7468062982768866,-0.04703695080047099,0.21533923012019043,130481.60750973184,3007.439596549407,133489.04710628124,665,3,452.47058823529414,33,1,20,34.97798468673784,0.6316287878787878,44.57720588235294,1021.6911764705882,30.960338680926913,4
667,4,1,1,34,0.02857142857142857,0.02857142857142857,0.9714285714285714,35,800,600,200,0.75,10,6,4,364.2836918739498,0.7610644257703081,-0.07398619080034996,0.20661495882734804,130085.41907793198,2477.5993441357896,132563.01842206778,666,0,440.51428571428573,35,0,18,35.67477876106196,0.6232142857142857,44.96527777777777,1020.1388888888879,29.146825396825367,6
668,4,0,0,34,0.0,0.0,1.0,34,950,600,350,0.631578947368421,13,6,7,373.72811095000554,0.7466206179441474,-0.07558071670363031,0.2116145886654789,130019.64462868468,2918.3992346938644,132938.04386337855,667,5,454.47058823529414,34,0,18,35.500807361581266,0.6246936274509804,45.0297619047619,1019.8809523809514,29.996498599439747,0
669,4,1,0,35,0.02857142857142857,0.0,1.0,35,550,400,150,0.7272727272727273,7,4,3,366.2136016696677,0.7622549019607843,-0.06501682043766444,0.20914648968857555,130353.74858276625,2547.6899092970307,132901.4384920633,668,0,442.45714285714286,34,1,19,35.35303489546903,0.6280637254901962,44.70238095238094,1021.1904761904746,30.035014005602193,0
670,4,0,0,35,0.0,0.0,1.0,35,700,500,200,0.7142857142857143,9,5,4,363.49165521725376,0.7633053221288515,-0.06432212853420483,0.2082116054901164,130469.4348663621,2484.9101669667134,132954.3450333288,669,1,443.45714285714286,35,0,19,35.30514803066349,0.6270833333333334,44.58912037037036,1021.6435185185169,29.189814814814767,0
671,4,3,4,34,0.07894736842105263,0.10526315789473684,0.8947368421052632,38,1000,800,200,0.8,12,8,4,343.8428895130154,0.7922593646277857,-0.0683353656527046,0.1996789434735582,130999.80481591042,1408.6702827087247,132408.47509861915,670,0,409.36842105263156,38,0,16,35.2705593821749,0.6266447368421053,44.07051282051281,1023.7179487179475,26.939946018893355,0
672,4,0,1,33,0.0,0.029411764705882353,0.9705882352941176,34,550,300,250,0.5454545454545454,8,3,5,374.2046773233553,0.7548276886512181,-0.05808292074115695,0.213710234492659,130353.74858276623,2955.7964852607493,133309.545068027,671,3,458.29411764705884,34,0,20,35.149024636667455,0.6280637254901962,44.70238095238094,1021.1904761904744,30.03501400560219,0
673,4,0,0,33,0.0,0.0,1.0,33,450,200,250,0.4444444444444444,7,2,5,376.9865903240475,0.7456597222222223,-0.03684511016804315,0.21531386272585923,130356.43029423773,3228.5252366878026,133584.95553092554,672,4,472.75757575757575,33,0,20,35.075278011120446,0.6303661616161617,44.69975490196078,1021.2009803921563,30.945484254307768,0
674,4,0,0,33,0.0,0.0,1.0,33,750,400,350,0.5333333333333333,11,4,7,376.58805371499204,0.7452651515151516,-0.034116813001036195,0.21543317966468464,130419.0113928535,3222.848333573601,133641.8597264271,673,5,473.75757575757575,33,0,20,35.02187062587483,0.6309974747474748,44.63848039215685,1021.4460784313709,30.952911467617298,0
675,4,1,0,34,0.029411764705882353,0.0,1.0,34,600,300,300,0.5,9,3,6,368.7857527162241,0.7560903149138444,-0.029000890228035203,0.2126086990491518,130718.71456916087,2841.4399092970375,133560.1544784579,674,0,460.79411764705884,34,0,17,34.91705471478464,0.6317401960784315,44.34523809523809,1022.6190476190466,30.0770308123249,0
676,4,1,0,35,0.02857142857142857,0.0,1.0,35,850,700,150,0.8235294117647058,10,7,3,351.33862883776544,0.7654061624649859,-0.0063081041615964395,0.19792300875985439,129819.89354263117,2122.14867862654,131942.0422212577,675,0,448.6,35,0,18,36.27448892674617,0.6205357142857143,45.22569444444444,1019.0972222222222,29.11706349206349,3
677,4,1,0,36,0.027777777777777776,0.0,1.0,36,1050,900,150,0.8571428571428571,12,9,3,343.99773092603505,0.7777116402116403,0.003402486573971686,0.19556508391792554,130176.38204082474,1756.0760084408828,131932.4580492656,676,0,437.1111111111111,36,0,19,36.09992275435885,0.6221064814814814,44.87612612612613,1020.4954954954966,28.347097097097127,0
678,4,1,0,37,0.02702702702702703,0.0,1.0,37,750,700,50,0.9333333333333333,8,7,1,339.19557117303924,0.787474974974975,0.021160649410979948,0.1948442407573739,130578.91506371247,1458.3864692395236,132037.301532952,677,0,426.27027027027026,36,1,19,35.81492397531952,0.6261574074074073,44.48198198198199,1022.072072072073,28.390890890890915,0
679,4,0,1,36,0.0,0.02702702702702703,0.972972972972973,37,750,500,250,0.6666666666666666,10,5,5,341.5768305226183,0.7854729729729729,0.02664007619954778,0.19679680337216857,130694.03863322787,1528.4110969077271,132222.4497301356,678,1,427.27027027027026,36,1,19,35.63761930983848,0.6273148148148149,44.36936936936937,1022.5225225225229,28.403403403403413,0
680,4,0,0,36,0.0,0.0,1.0,36,1100,800,300,0.7272727272727273,14,8,6,348.7354573426072,0.7760912698412699,0.031452120296967756,0.20021678077602217,130558.13426997601,1906.0501328875216,132464.18440286352,679,2,439.4166666666667,35,1,19,35.59220460551152,0.6279761904761905,44.50231481481482,1021.9907407407409,29.199735449735453,0
681,4,0,0,36,0.0,0.0,1.0,36,750,500,250,0.6666666666666666,10,5,5,344.84286389413967,0.7769510582010583,0.0288345410628017,0.19828464673913043,130617.2839506173,1808.4876543209853,132425.7716049383,680,3,440.4166666666667,35,1,19,35.63179347826085,0.6285714285714286,44.44444444444444,1022.2222222222224,29.206349206349213,0
682,4,0,0,36,0.0,0.0,1.0,36,900,500,400,0.5555555555555556,13,5,8,343.9261705836918,0.7750992063492064,0.03039334037523278,0.19836368428704315,130735.62349965704,1792.6804698216713,132528.3039694787,681,4,441.4166666666667,35,1,19,35.53549871736834,0.6297619047619047,44.3287037037037,1022.685185185185,29.219576719576715,0
683,4,0,1,35,0.0,0.027777777777777776,0.9722222222222222,36,1150,900,250,0.782608695652174,14,9,5,347.1714338363263,0.775628306878307,0.030367018602312612,0.20085048920897378,130854.01663237285,1885.7553155006553,132739.7719478735,682,5,442.4166666666667,35,1,19,35.33276772247362,0.6309523809523812,44.21296296296295,1023.148148148146,29.23280423280417,0
684,4,1,0,36,0.027777777777777776,0.0,1.0,36,1050,700,350,0.6666666666666666,14,7,7,349.26514583858796,0.7780753968253968,0.02875772651892028,0.2026837893567238,130972.46334876532,1948.8233024691208,132921.28665123443,683,0,443.19444444444446,35,1,20,35.159430122116675,0.6321428571428572,44.097222222222214,1023.6111111111103,29.246031746031722,0
685,4,0,0,36,0.0,0.0,1.0,36,1100,900,200,0.8181818181818182,13,9,4,350.8726034877981,0.7784722222222222,0.0244374120956401,0.20424478918816014,131090.9636488339,1999.2455418381192,133090.209190672,684,1,444.19444444444446,35,1,20,34.99849306811331,0.6333333333333333,43.981481481481474,1024.074074074073,29.259259259259228,0
686,4,1,1,36,0.02702702702702703,0.02702702702702703,0.972972972972973,37,900,600,300,0.6666666666666666,12,6,6,340.73633419261023,0.7822822822822822,0.020215337288508106,0.19957413859852882,131328.125,1549.6527777777787,132877.77777777778,685,0,433.1621621621622,36,1,20,35.018631436314365,0.6336805555555556,43.75,1025.0,28.47222222222222,0
687,4,1,0,37,0.02702702702702703,0.0,1.0,37,800,400,400,0.5,12,4,8,340.98384187650265,0.7848473473473473,0.020689552814758594,0.20017136558901072,131414.71021274658,1562.0585534859179,132976.7687662325,686,0,434.13513513513516,36,1,21,34.924949661358205,0.6345486111111112,43.66554054054054,1025.3378378378382,28.481606606606615,0
688,4,0,0,37,0.0,0.0,1.0,37,600,300,300,0.5,9,3,6,341.9831492526374,0.7830955955955956,0.02122513421514216,0.2010613647671896,131472.44953991144,1592.2724667234706,133064.7220066349,687,1,435.13513513513516,36,1,21,34.84110208264705,0.6351273148148149,43.60923423423423,1025.5630630630624,28.487862862862844,0
689,4,0,0,37,0.0,0.0,1.0,37,1050,700,350,0.6666666666666666,14,7,7,338.1331476128448,0.7832207207207207,0.022137834871094775,0.1992492221703116,131559.0823086601,1496.8973196169188,133055.979628277,688,2,436.13513513513516,36,1,17,34.85249725576289,0.6359953703703705,43.52477477477478,1025.9009009009014,28.497247247247262,0
690,4,0,0,37,0.0,0.0,1.0,37,750,500,250,0.6666666666666666,10,5,5,339.58178966263955,0.7845970970970971,0.02386586718383943,0.20071001497959134,131674.6370525931,1542.8617806996172,133217.49883329272,689,3,437.13513513513516,36,1,18,34.698906444298146,0.6371527777777778,43.41216216216216,1026.3513513513512,28.509759759759756,0
691,4,0,1,36,0.0,0.02702702702702703,0.972972972972973,37,650,500,150,0.7692307692307693,8,5,3,338.24683907190166,0.7854729729729729,0.015283104995761354,0.20052891278658003,131790.2425229284,1515.5265907799771,133305.76911370837,690,4,438.13513513513516,36,1,18,34.61673795422973,0.6383101851851851,43.29954954954955,1026.8018018018024,28.52227227227229,0
692,4,0,1,35,0.0,0.027777777777777776,0.9722222222222222,36,750,400,350,0.5333333333333333,11,4,7,344.99319618986624,0.7789021164021165,0.01587212071083033,0.20364245522099572,131624.87809713656,1881.9374785665389,133506.8155757031,691,8,451.19444444444446,35,1,18,34.61021505376344,0.6386904761904761,43.46064814814815,1026.157407407408,29.318783068783087,0
693,4,0,0,35,0.0,0.0,1.0,35,750,400,350,0.5333333333333333,11,4,7,352.91351583987085,0.7684873949579831,0.019944965686437444,0.20803068943283232,131572.28599773248,2286.7276077097604,133859.01360544225,692,9,463.74285714285713,34,1,18,34.46009321574998,0.6403186274509803,43.511904761904766,1025.9523809523814,30.17507002801122,0
694,4,0,0,35,0.0,0.0,1.0,35,850,500,350,0.5882352941176471,12,5,7,349.9187127545609,0.767156862745098,0.0175008286377194,0.20659584273591208,131633.3616780046,2212.1952947845884,133845.5569727892,693,10,464.74285714285713,34,1,18,34.47529969064192,0.6409313725490196,43.452380952380956,1026.1904761904768,30.18207282913167,0
695,4,0,0,35,0.0,0.0,1.0,35,800,400,400,0.5,12,4,8,347.5007420033928,0.7680672268907562,0.01824356786666881,0.20566224422067647,131725.001771542,2154.9071712018203,133879.90894274384,694,11,465.74285714285713,34,1,18,34.44494375507363,0.6418504901960784,43.36309523809524,1026.5476190476195,30.192577030812338,0
696,4,1,1,35,0.027777777777777776,0.027777777777777776,0.9722222222222222,36,1200,900,300,0.75,15,9,6,341.86070915933607,0.7750992063492064,0.016540276057113612,0.20385367606620192,132011.1577958892,1825.8856042095485,133837.04340009874,695,0,453.77777777777777,35,1,18,34.301558921800506,0.6425595238095237,43.08449074074075,1027.662037037038,29.361772486772516,0
697,4,0,0,35,0.0,0.0,1.0,35,450,300,150,0.6666666666666666,6,3,3,361.07971731724746,0.7665966386554621,0.01952874270415883,0.20833014449109946,130749.15143140576,2442.173327664382,133191.32475907015,696,13,467.74285714285713,34,1,18,35.08322663252241,0.632046568627451,44.31547619047618,1022.738095238094,30.080532212885117,7
698,4,1,0,36,0.027777777777777776,0.0,1.0,36,1200,1000,200,0.8333333333333334,14,10,4,352.40684050941456,0.7776785714285714,0.018909990705152424,0.20482200467452552,131031.70680084001,2035.2939600479872,133067.00076088798,697,0,455.72222222222223,35,1,19,35.01912352098877,0.6327380952380953,44.03935185185184,1023.8425925925911,29.25264550264546,0
699,4,0,1,35,0.0,0.027777777777777776,0.9722222222222222,36,800,600,200,0.75,10,6,4,355.05702900643354,0.7771825396825397,0.01883765899473877,0.2068400032704364,131120.59709630048,2111.057929312401,133231.65502561288,698,1,456.72222222222223,35,1,19,34.86140147662636,0.6336309523809525,43.95254629629629,1024.189814814814,29.262566137566118,0
700,4,0,0,35,0.0,0.0,1.0,35,800,300,500,0.375,13,3,10,361.14618181047774,0.7648459383753501,0.03761478553992781,0.21035481395501288,131114.67013888893,2470.3125000000036,133584.98263888893,699,2,469.9142857142857,34,1,20,34.711486303227545,0.6357230392156863,43.958333333333336,1024.166666666667,30.122549019607852,0
701,4,0,0,35,0.0,0.0,1.0,35,600,500,100,0.8333333333333334,7,5,2,364.169073033752,0.7662464985994397,0.04416188041565694,0.21262137330586617,131206.1295351473,2556.242913832187,133762.3724489795,700,3,470.9142857142857,34,1,20,34.54155046866527,0.6366421568627452,43.86904761904761,1024.5238095238087,30.133053221288492,0
702,4,0,0,35,0.0,0.0,1.0,35,1000,800,200,0.8,12,8,4,364.40558949915174,0.7654061624649859,0.046473350438108296,0.21294275140831587,131239.1643759643,2564.8570119598508,133804.02138792415,701,4,471.9142857142857,35,0,20,34.5020755676042,0.6348214285714286,43.83680555555554,1024.652777777776,29.2757936507936,0
703,4,0,0,35,0.0,0.0,1.0,35,1050,700,350,0.6666666666666666,14,7,7,363.4174937490059,0.7647759103641456,0.04317887823808442,0.21353876474447023,131450.17715419485,2554.288927665956,134004.46608186082,702,5,472.9142857142857,34,1,20,34.314052704899005,0.639093137254902,43.63095238095237,1025.4761904761892,30.16106442577027,0
704,4,1,1,35,0.027777777777777776,0.027777777777777776,0.9722222222222222,36,1050,600,450,0.5714285714285714,15,6,9,355.49185771255287,0.7719907407407408,0.03574388980313303,0.2102730878033691,131703.53366457668,2163.9067699456136,133867.4404345223,703,0,460.75,36,0,15,34.261519473395495,0.6374421296296298,43.384009009009006,1026.4639639639634,28.51288788788787,0
705,4,1,1,35,0.027777777777777776,0.027777777777777776,0.9722222222222222,36,500,300,200,0.6,7,3,4,357.0187776158569,0.773941798941799,0.043960663888279905,0.2116578162744722,131790.24252292822,2210.3182574466277,134000.56078037486,704,0,461.72222222222223,36,0,16,34.13486144622359,0.6383101851851853,43.299549549549546,1026.801801801801,28.52227227227225,0
706,4,1,1,35,0.027777777777777776,0.027777777777777776,0.9722222222222222,36,750,700,50,0.9333333333333333,8,7,1,358.5002814787016,0.7757605820105821,0.05259969558599753,0.21367178762202163,131992.6741564199,2263.882167640615,134256.5563240605,705,0,462.69444444444446,36,0,18,33.89269406392694,0.6403356481481481,43.10247747747748,1027.59009009009,28.544169169169166,0
707,4,0,0,35,0.0,0.0,1.0,35,1050,900,150,0.8571428571428571,12,9,3,369.6759580345985,0.7640056022408963,0.05075645400115891,0.21992250693800913,131921.96609224967,2753.6758401920465,134675.6419324417,706,1,476.6857142857143,35,0,18,33.67695658705122,0.6416666666666666,43.1712962962963,1027.314814814815,29.35185185185186,0
708,4,1,1,35,0.027777777777777776,0.027777777777777776,0.9722222222222222,36,1200,1100,100,0.9166666666666666,13,11,2,360.35138266164233,0.7726851851851853,0.049059679342140505,0.21625818194687543,132253.17166829004,2331.522654411184,134584.69432270122,707,0,464.4166666666667,36,0,20,33.58263082986644,0.6429398148148149,42.84909909909911,1028.6036036036048,28.572322322322357,0
709,4,1,1,35,0.027777777777777776,0.027777777777777776,0.9722222222222222,36,350,200,150,0.5714285714285714,5,2,3,362.8806963838955,0.7723214285714286,0.04534148269780447,0.21794314013589,132282.13168827622,2400.5264132375723,134682.65810151378,708,0,465.3888888888889,36,0,20,33.48841452289729,0.6432291666666666,42.82094594594595,1028.716216216217,28.57545045045047,0
710,4,0,0,35,0.0,0.0,1.0,35,650,400,250,0.6153846153846154,9,4,5,371.97251159293904,0.7601540616246498,0.04560625060287493,0.22303291079722368,132219.38898533946,2836.3956404320966,135055.78462577157,709,4,479.6857142857143,35,0,20,33.31785955435517,0.6446428571428571,42.88194444444444,1028.472222222222,29.384920634920626,0
711,4,1,1,35,0.027777777777777776,0.027777777777777776,0.9722222222222222,36,700,400,300,0.5714285714285714,10,4,6,361.1089467053794,0.7665343915343916,0.03986321903691192,0.21806273461943995,132487.35592689048,2368.5944733796314,134855.9504002701,710,0,467.3333333333333,35,1,20,33.32736087689713,0.6473214285714286,42.62152777777778,1029.5138888888891,29.41468253968255,0
712,4,0,0,35,0.0,0.0,1.0,35,1000,800,200,0.8,12,8,4,371.02827395721755,0.757703081232493,0.04823473045977966,0.2238856584025164,132459.27047902485,2829.22689909296,135288.4973781178,711,6,481.6857142857143,34,1,20,33.100352723487916,0.649203431372549,42.64880952380952,1029.4047619047612,30.276610644257683,0
713,4,1,1,35,0.027777777777777776,0.027777777777777776,0.9722222222222222,36,500,300,200,0.6,7,3,4,365.20596786343117,0.7677910052910053,0.04209879316584941,0.22194052777393358,132725.77649444874,2494.449133016121,135220.22562746485,712,0,469.27777777777777,35,1,15,32.981977048934816,0.649702380952381,42.3900462962963,1030.439814814815,29.44113756613757,0
714,4,0,1,34,0.0,0.02857142857142857,0.9714285714285714,35,1100,900,200,0.8181818181818182,13,9,4,356.313335237148,0.757422969187675,-0.02782743127687315,0.2111459984561615,131773.38023244584,2390.522521219119,134163.90275366497,713,8,483.6857142857143,35,0,17,34.169978018261745,0.6401785714285715,43.315972222222214,1026.73611111111,29.335317460317427,7
715,4,0,0,34,0.0,0.0,1.0,34,1100,800,300,0.7272727272727273,14,8,6,365.6735013670639,0.7433897801544861,-0.02101327657019647,0.21624395945039945,131694.4515306122,2831.4342403628043,134525.885770975,714,31,498.6764705882353,34,0,18,34.009413902420164,0.6415441176470589,43.39285714285714,1026.4285714285709,30.189075630252084,0
716,4,0,0,34,0.0,0.0,1.0,34,600,400,200,0.6666666666666666,8,4,4,362.5980350818012,0.7420528817587642,-0.014085179526355907,0.2147696053946054,131755.55555555562,2754.861111111117,134510.41666666674,715,32,499.6764705882353,34,0,18,34.02665043290043,0.642156862745098,43.333333333333336,1026.6666666666672,30.196078431372566,0
717,4,0,0,34,0.0,0.0,1.0,34,1200,700,500,0.5833333333333334,17,7,10,365.653514688567,0.7419414735591207,-0.013960957050027645,0.21710205583057599,131847.23816609988,2842.0812074830105,134689.3193735829,716,33,500.6764705882353,34,0,18,33.85567597851707,0.6430759803921567,43.24404761904763,1027.0238095238105,30.20658263305325,0
718,4,0,0,34,0.0,0.0,1.0,34,850,700,150,0.8235294117647058,10,7,3,366.3149244933663,0.7396761734997029,-0.013359689182741441,0.21802053781915542,131938.95266439923,2866.241496598655,134805.1941609979,717,34,501.6764705882353,34,0,18,33.74613750482812,0.6439950980392156,43.15476190476191,1027.3809523809534,30.217086834733923,0
719,4,1,0,35,0.02857142857142857,0.0,1.0,35,650,500,150,0.7692307692307693,8,5,3,339.93041207373705,0.7521008403361344,0.045319749521430364,0.19164066637140373,129849.38298396763,1827.9508530521139,131677.33383701975,718,0,488.3142857142857,35,0,18,36.53522219698691,0.6208333333333333,45.19675925925925,1019.2129629629618,29.12037037037034,7
720,4,1,1,35,0.027777777777777776,0.027777777777777776,0.9722222222222222,36,1000,800,200,0.8,12,8,4,333.5459643501022,0.764649470899471,0.04367970465221793,0.18920431377880872,130090.20580969485,1478.2126298595863,131568.41843955443,719,0,475.72222222222223,36,0,18,36.45384884277146,0.6212384259259259,44.960585585585584,1020.1576576576578,28.337712712712715,0
721,4,2,0,37,0.05405405405405406,0.0,1.0,37,800,600,200,0.75,10,6,4,331.5592178505319,0.7657032032032032,0.06280500004349365,0.1904167264069505,130570.58572108718,1258.376255193894,131828.96197628108,720,0,463.81081081081084,37,0,15,36.018466366269706,0.6241554054054055,44.49013157894736,1022.03947368421,27.62268847795162,0
722,4,0,0,37,0.0,0.0,1.0,37,500,400,100,0.8,6,4,2,331.8848299533017,0.7662037037037037,0.06438040397786837,0.1794732577131717,128201.54772593555,1111.8209523710748,129313.36867830662,721,1,464.81081081081084,36,1,22,38.41599021461138,0.6021412037037036,46.8186936936937,1012.7252252252266,28.131256256256293,8
723,4,2,1,38,0.05128205128205128,0.02564102564102564,0.9743589743589743,39,1050,600,450,0.5714285714285714,15,6,9,314.22936336481484,0.7866059379217274,0.07127335940895208,0.17223685646868905,128740.17373666835,290.7885665498053,129030.96230321816,722,0,441.9230769230769,38,1,17,38.31499806997227,0.603892543859649,46.28739316239317,1014.8504273504292,26.706590193432348,0
724,4,1,0,39,0.02564102564102564,0.0,1.0,39,900,400,500,0.4444444444444444,14,4,10,317.0889597960708,0.7848627980206928,0.08663726243947223,0.1745182723139348,128902.8613873366,374.7348464095353,129277.59623374614,723,0,442.8974358974359,38,1,18,38.07710853936526,0.6055372807017543,46.12713675213676,1015.4914529914533,26.723459289248773,0
725,4,0,0,39,0.0,0.0,1.0,39,900,700,200,0.7777777777777778,11,7,4,318.5502890863674,0.784919028340081,0.08975167839521125,0.17592411435606015,129038.51290269566,421.051117685735,129459.5640203814,724,1,443.8974358974359,38,1,18,37.90220820189272,0.606907894736842,45.993589743589745,1016.0256410256416,26.73751686909583,0
726,4,2,2,39,0.04878048780487805,0.04878048780487805,0.9512195121951219,41,700,500,200,0.7142857142857143,9,5,4,297.5158768445887,0.8013719512195122,0.05086212301711712,0.16118896391719367,128276.40109592021,-561.2656050963491,127715.13549082386,725,0,423.1951219512195,39,2,18,39.21004712939159,0.5974893162393162,46.74479166666667,1013.0208333333339,25.97489316239318,8
727,4,2,3,38,0.04878048780487805,0.07317073170731707,0.926829268292683,41,800,600,200,0.75,10,6,4,294.5372480631351,0.8041666666666667,0.06287530199592983,0.16031524038872677,128461.13281250013,-632.6822916666515,127828.45052083347,726,0,423.9512195121951,39,2,16,39.097821619399916,0.5993589743589742,46.56250000000001,1013.750000000001,25.99358974358977,0
728,4,2,0,40,0.05,0.0,1.0,40,950,900,50,0.9473684210526315,10,9,1,307.3140909274113,0.7933226495726495,0.09720467466835125,0.1683315591481289,128713.06911571347,-88.93203484548474,128624.137080868,727,0,433.375,38,2,18,38.51797746894082,0.6036184210526315,46.31410256410257,1014.7435897435907,26.703778677462914,0
729,4,1,1,40,0.024390243902439025,0.024390243902439025,0.975609756097561,41,900,700,200,0.7777777777777778,11,7,4,297.58210407545175,0.8014735772357724,0.09060876828393005,0.16425117493196872,129016.12548828153,-521.4219835069142,128494.70350477462,728,0,423.780487804878,39,2,18,38.45750452852114,0.6049679487179487,46.015625000000014,1015.9375000000022,26.049679487179542,0
730,4,0,0,40,0.0,0.0,1.0,40,950,800,150,0.8421052631578947,11,8,3,306.6509749706749,0.7926014957264957,0.09808784850078922,0.16877345206116182,128902.86138733652,-94.36237581270086,128808.49901152382,729,2,435.375,38,2,18,38.34210064878134,0.6055372807017544,46.12713675213675,1015.4914529914528,26.72345928924876,0
731,4,1,1,40,0.024390243902439025,0.024390243902439025,0.975609756097561,41,1000,700,300,0.7,13,7,6,299.5952160472571,0.8045223577235773,0.09510219314614354,0.16559715673059852,129072.2714344142,-466.1129907792817,128606.15844363492,730,0,425.7317073170732,40,1,18,38.3494599459946,0.6039062499999999,45.960365853658544,1016.1585365853672,25.40396341463418,0
732,4,2,2,40,0.047619047619047616,0.047619047619047616,0.9523809523809523,42,1200,800,400,0.6666666666666666,16,8,8,294.05785262540326,0.8073219125048393,0.10434292562525904,0.16403349740045461,129433.96297053662,-787.720809372733,128646.24216116389,731,0,416.54761904761904,40,2,14,38.12398049202703,0.6075520833333334,45.604674796747965,1017.5813008130074,25.439532520325184,0
733,4,1,0,41,0.024390243902439025,0.0,1.0,41,850,600,250,0.7058823529411765,11,6,5,303.9719065633416,0.796239837398374,0.12342412062810482,0.16970317297850568,129466.281467014,-329.1775173611006,129137.10394965291,732,0,427.6829268292683,39,2,15,37.83904810644831,0.6095085470085471,45.57291666666667,1017.7083333333343,26.095085470085493,0
734,4,1,0,42,0.023809523809523808,0.0,1.0,42,1050,500,550,0.47619047619047616,16,5,11,294.60369240012176,0.8029423151374371,0.12621873322980326,0.1658613825769803,129796.16057117115,-752.3143672747826,129043.84620389636,733,0,418.4761904761905,40,2,16,37.74392473654465,0.6111979166666668,45.24898373983739,1019.0040650406495,25.475101626016237,0
735,4,0,0,42,0.0,0.0,1.0,42,1000,700,300,0.7,13,7,6,317.044654653166,0.8026277584204413,0.0715906512366693,0.1798218523882239,130085.41907793182,-151.42264660496514,129933.99643132686,734,1,419.4761904761905,41,1,19,36.87953823462672,0.6125508130081302,44.965277777777764,1020.1388888888866,24.88143631436309,7
736,4,0,1,41,0.0,0.023809523809523808,0.9761904761904762,42,600,300,300,0.5,9,3,6,317.3273164474448,0.801296941540844,0.0728544577465442,0.18033308160101752,130161.33334120679,-139.25067712270732,130022.08266408408,735,2,420.4761904761905,41,1,20,36.79556354916067,0.6133130081300813,44.89087301587301,1020.4365079365074,24.888695315524572,0
737,4,0,1,40,0.0,0.024390243902439025,0.975609756097561,41,1050,800,250,0.7619047619047619,13,8,5,323.58399624686035,0.7967479674796748,0.09125700576002171,0.18424476520994698,130236.65229030343,228.49928118184198,130465.15157148527,736,3,431.3658536585366,40,1,21,36.55976204699323,0.615625,44.81707317073171,1020.7317073170735,25.518292682926838,0
738,4,0,1,39,0.0,0.025,0.975,40,1050,700,350,0.6666666666666666,14,7,7,330.1511861556149,0.788568376068376,0.08734561600489954,0.18772438599922003,130182.84640842026,596.0042317708424,130778.8506401911,737,4,442.925,39,1,21,36.44663757612874,0.6167200854700854,44.86979166666667,1020.5208333333343,26.16720085470088,0
739,4,0,0,39,0.0,0.0,1.0,39,1300,1100,200,0.8461538461538461,15,11,4,340.1333486843711,0.7796333783175888,0.09278893149860923,0.1928499532801885,130071.79578493675,1048.351093944038,131120.1468788808,738,5,454.9230769230769,38,1,21,36.304505306521435,0.6173245614035088,44.97863247863248,1020.0854700854696,26.84435447593341,0
740,4,0,0,39,0.0,0.0,1.0,39,1000,700,300,0.7,13,7,6,338.85739795996386,0.7794646873594242,0.08957844961614936,0.19226080173022564,130099.04308431962,1017.0046433267644,131116.0477276464,739,6,455.9230769230769,38,1,21,36.309430306838394,0.6175986842105262,44.95192307692308,1020.1923076923085,26.847165991902855,0
741,4,1,1,39,0.025,0.025,0.975,40,800,600,200,0.75,10,6,4,334.7375273364118,0.7906784188034188,0.08981640541120939,0.19127271960805764,130374.54433094796,728.4559763268105,131103.00030727478,740,0,445.5,37,3,21,36.13556653067069,0.6221846846846846,44.68201754385965,1021.2719298245612,27.601944049312465,0
742,4,0,0,39,0.0,0.0,1.0,39,800,500,300,0.625,11,5,6,343.2360547007558,0.7800269905533064,0.0932874023542456,0.1957093126991858,130291.32806793285,1144.1362815518269,131435.46434948468,741,8,457.9230769230769,36,3,22,36.002877049783066,0.6232638888888888,44.763513513513516,1020.9459459459463,28.35960960960962,0
743,4,1,1,39,0.025,0.025,0.975,40,1300,1000,300,0.7692307692307693,16,10,6,337.18865225797623,0.7857905982905983,0.09137533512064322,0.19421149983357805,130682.67549871115,812.9430449753736,131495.61854368652,742,0,447.45,37,3,18,35.761282394995526,0.6252815315315315,44.38048245614035,1022.4780701754387,27.63454243717402,0
744,4,0,0,39,0.0,0.0,1.0,39,1050,800,250,0.7619047619047619,13,8,5,342.369484335524,0.7756972559604138,0.09466440017823796,0.19676746812427587,130598.60365689438,1142.5953177900792,131741.19897468446,743,10,459.9230769230769,37,2,18,35.71390259600943,0.6244369369369369,44.46271929824561,1022.1491228070172,27.62565196775722,0
745,4,0,0,39,0.0,0.0,1.0,39,950,700,250,0.7368421052631579,12,7,5,343.83112075843263,0.7759221772379667,0.08861758438165945,0.19803738116568162,130682.67549871112,1186.5541560864845,131869.22965479761,744,11,460.9230769230769,37,2,19,35.59148793565683,0.6252815315315315,44.38048245614035,1022.4780701754385,27.634542437174012,0
746,4,0,1,38,0.0,0.02564102564102564,0.9743589743589743,39,1000,900,100,0.9,11,9,2,342.77422880509556,0.7742352676563203,0.0971338602917553,0.19821292361338125,130835.79881656796,1169.4280078895376,132005.2268244575,745,12,461.9230769230769,38,1,20,35.46365914786968,0.625,44.230769230769226,1023.0769230769223,26.923076923076902,0
747,4,2,2,38,0.05,0.05,0.95,40,800,500,300,0.625,11,5,6,336.53492899122267,0.7799679487179487,0.09031027466937891,0.19574783147832678,131061.33355034736,821.3433159722322,131882.67686631958,746,0,451.025,39,1,20,35.395473041709046,0.625534188034188,44.01041666666667,1023.9583333333345,26.25534188034191,0
748,4,0,0,38,0.0,0.0,1.0,38,950,700,250,0.7368421052631579,12,7,5,351.2316712686961,0.7645211000474158,0.09588963836939146,0.20333089058805617,130878.94833025514,1593.7663511849464,132472.7146814401,747,15,475.7631578947368,37,1,20,35.2036898128304,0.6272522522522525,44.188596491228054,1023.2456140350852,27.655286865813114,0
749,4,0,0,38,0.0,0.0,1.0,38,350,100,250,0.2857142857142857,6,1,5,351.03571759628414,0.7637505926979611,0.09725057232754075,0.20351350236296326,130935.05333371778,1592.5760811018488,132527.62941481962,748,16,476.7631578947368,37,1,20,35.151953431897724,0.6278153153153154,44.13377192982455,1023.4649122806994,27.66121384542431,0
750,4,0,0,38,0.0,0.0,1.0,38,900,500,400,0.5555555555555556,13,5,8,352.5422549599065,0.7613501659554291,0.09850880010820506,0.20513346536265173,131075.36844269364,1641.921192097535,132717.28963479117,749,17,477.7631578947368,37,1,20,34.97151283149514,0.6292229729729731,43.99671052631577,1024.0131578947346,27.676031294452287,0
751,4,0,0,38,0.0,0.0,1.0,38,750,400,350,0.5333333333333333,11,4,7,350.8961937557606,0.7611723565670934,0.09683308914684963,0.2043248410024187,131103.44048168627,1600.739650661696,132704.18013234797,750,18,478.7631578947368,37,1,20,34.985278372591004,0.6295045045045047,43.96929824561401,1024.1228070175407,27.678994784257856,0
752,4,0,1,37,0.0,0.02631578947368421,0.9736842105263158,38,800,600,200,0.75,10,6,4,354.51054430189583,0.7598980559506875,0.10336756479661124,0.20688269927624017,131187.6746330598,1701.4827879731824,132889.15742103299,751,19,479.7631578947368,37,1,20,34.807587677048765,0.6303490990990992,43.88706140350875,1024.451754385962,27.687885253674647,0
753,4,0,0,37,0.0,0.0,1.0,37,700,500,200,0.7142857142857143,9,5,4,361.48272191356114,0.7586961961961962,0.10073420674127398,0.21033564734895577,131075.36844269364,2076.2961920975354,133151.66463479117,752,20,479.18918918918916,37,0,20,34.74263393653851,0.6292229729729731,43.99671052631577,1024.0131578947346,27.676031294452287,0
754,4,1,1,37,0.02631578947368421,0.02631578947368421,0.9736842105263158,38,750,500,250,0.6666666666666666,10,5,5,357.18016920113695,0.7647285443338075,0.11667626916291929,0.21001814726551263,131476.4596863211,1792.8872163508654,133269.34690267197,753,0,467.55263157894734,35,3,21,34.44741470112477,0.637202380952381,43.60532407407407,1025.5787037037032,29.302248677248663,0
755,4,0,0,37,0.0,0.0,1.0,37,700,400,300,0.5714285714285714,10,4,6,366.58043031843783,0.75757007007007,0.1172039534599052,0.2148825109238986,131358.63272392293,2230.700821995464,133589.3335459184,754,1,479.2972972972973,34,3,21,34.32552355514264,0.6381740196078431,43.720238095238095,1025.1190476190477,30.150560224089638,0
756,4,0,0,37,0.0,0.0,1.0,37,1300,900,400,0.6923076923076923,17,9,8,364.77288877444016,0.7565065065065065,0.11326279445001974,0.21448258576179913,131476.45968632106,2191.809601123103,133668.26928744416,755,2,480.2972972972973,35,2,21,34.25274141368544,0.637202380952381,43.60532407407407,1025.578703703703,29.302248677248656,0
757,4,0,0,37,0.0,0.0,1.0,37,1650,1400,250,0.8484848484848485,19,14,5,365.19698918087954,0.7553178178178178,0.11556997576969041,0.21568633586554478,131645.74361100968,2215.32584104375,133861.06945205343,756,3,481.2972972972973,36,1,19,34.070832876111055,0.6368634259259259,43.44031531531532,1026.238738738739,28.506631631631635,0
758,4,0,0,37,0.0,0.0,1.0,37,600,600,0,1.0,6,6,0,365.7846861311312,0.7546921921921922,0.11644509801596281,0.21652553238775274,131732.43344696047,2237.141364337313,133969.5748112978,757,4,482.2972972972973,36,1,19,33.96820608454002,0.6377314814814815,43.35585585585586,1026.5765765765766,28.516016016016017,0
759,4,0,0,37,0.0,0.0,1.0,37,950,500,450,0.5263157894736842,14,5,9,364.02498845798715,0.7539414414414415,0.11819582740635393,0.2161398368969298,131848.0642804967,2199.198015583148,134047.26229607986,758,5,483.2972972972973,36,1,19,33.89665570175439,0.6388888888888888,43.24324324324324,1027.0270270270269,28.528528528528525,0
760,4,0,1,36,0.0,0.02702702702702703,0.972972972972973,37,850,600,250,0.7058823529411765,11,6,5,364.0916391183184,0.7537537537537538,0.11972709309111784,0.21667371322090168,131934.82069485038,2207.2730247139143,134142.0937195643,759,6,484.2972972972973,36,1,19,33.80740984325331,0.6397569444444444,43.15878378378379,1027.364864864866,28.537912912912944,0
761,4,0,0,36,0.0,0.0,1.0,36,950,700,250,0.7368421052631579,12,7,5,371.73574052968763,0.7462962962962963,0.11725264818571146,0.22080207238691074,131862.52170138882,2603.60243055555,134466.12413194438,760,7,497.6111111111111,35,1,20,33.68407707910751,0.6410714285714285,43.229166666666664,1027.0833333333328,29.34523809523808,0
762,4,0,0,36,0.0,0.0,1.0,36,1100,800,300,0.7272727272727273,14,8,6,375.8018192696058,0.7468915343915344,0.11951515606618135,0.22391735244802388,131981.42387902932,2719.7718407064285,134701.19571973576,761,8,498.6111111111111,35,1,20,33.45958173762859,0.6422619047619048,43.11342592592592,1027.546296296295,29.35846560846557,0
763,4,0,0,36,0.0,0.0,1.0,36,1050,800,250,0.7619047619047619,13,8,5,378.609871593122,0.7455357142857143,0.11873803895080504,0.22647754137115836,132130.12695312488,2805.154079861097,134935.28103298598,762,9,499.6111111111111,35,1,20,33.23729314420803,0.64375,42.96874999999999,1028.124999999999,29.374999999999975,0
764,4,0,0,36,0.0,0.0,1.0,36,1200,1000,200,0.8333333333333334,14,10,4,379.52256833234526,0.746031746031746,0.11840723235051431,0.22755988813773373,132219.3889853392,2836.0484182098444,135055.43740354903,763,10,500.6111111111111,35,1,20,33.12373396353816,0.6446428571428573,42.88194444444443,1028.47222222222,29.38492063492057,0
765,4,2,2,36,0.05263157894736842,0.05263157894736842,0.9473684210526316,38,600,400,200,0.6666666666666666,8,4,4,360.5979203590903,0.7671882408724514,0.1138419515425273,0.21896607687835062,132695.96220207462,1970.2187285665145,134666.18093064113,764,0,475.2105263157895,35,3,17,33.130663521306076,0.649404761904762,42.418981481481474,1030.324074074073,29.437830687830658,0
766,4,0,0,36,0.0,0.0,1.0,36,650,400,250,0.6153846153846154,9,4,5,377.2173585163499,0.7466269841269841,0.1220159980002502,0.22689190238229692,132338.45191400874,2784.072252229065,135122.5241662378,765,12,502.6111111111111,35,1,21,33.062898387701544,0.6458333333333335,42.766203703703695,1028.9351851851839,29.39814814814811,0
767,4,1,0,37,0.02702702702702703,0.0,1.0,37,900,500,400,0.5555555555555556,13,5,8,371.36713500142355,0.7546921921921922,0.12431495620403821,0.225556670416654,132704.4802295918,2456.443316781443,135160.92354637326,766,0,490.0,34,3,19,32.84469478143655,0.6516544117647058,42.410714285714285,1030.3571428571427,30.30462184873949,0
768,4,0,0,37,0.0,0.0,1.0,37,1000,600,400,0.6,14,6,8,370.7821282476467,0.7523773773773774,0.11824893266456171,0.22604766709800028,132845.06715374204,2451.3153452931833,135296.38249903522,767,1,491.0,35,2,19,32.7182974065342,0.6508928571428573,42.27430555555554,1030.9027777777758,29.454365079365022,0
769,4,0,0,37,0.0,0.0,1.0,37,950,500,450,0.5263157894736842,14,5,9,369.3441198169595,0.7521896896896897,0.12088915309653725,0.22589055948448328,132964.41139671192,2421.924698859714,135386.33609557163,768,2,492.0,35,2,20,32.63534302173344,0.6520833333333333,42.1585648148148,1031.365740740739,29.467592592592545,0
770,4,0,0,37,0.0,0.0,1.0,37,700,400,300,0.5714285714285714,10,4,6,364.91236046101955,0.7521896896896897,0.11911338975934238,0.2056625884072933,129837.58680555534,2086.243194873089,131923.83000042842,769,3,493.0,34,3,19,35.910670482420265,0.6228553921568629,45.20833333333332,1019.1666666666649,29.97549019607838,5
771,4,0,0,37,0.0,0.0,1.0,37,1250,1100,150,0.88,14,11,3,368.2960140478131,0.7525025025025025,0.12229798746652665,0.2084172241345715,129996.88042534703,2175.4665798610854,132172.3470052081,770,4,494.0,35,2,19,35.6624531835206,0.6223214285714287,45.05208333333332,1019.791666666665,29.136904761904717,0
772,4,1,0,38,0.02631578947368421,0.0,1.0,38,1150,900,250,0.782608695652174,14,9,5,360.96307324267855,0.7629800853485064,0.11975444164707882,0.2059777640457247,130321.66950660123,1808.5333344049789,132130.20284100622,771,0,481.9736842105263,35,3,20,35.51962895790827,0.6255952380952381,44.73379629629628,1021.0648148148126,29.17328042328036,0
773,4,0,0,38,0.0,0.0,1.0,38,650,600,50,0.9230769230769231,7,6,1,362.3097529070935,0.7631875296348981,0.12231698225734311,0.20721863703208662,130410.31867551846,1849.7860671724654,132260.10474269092,772,1,482.9736842105263,35,3,20,35.39530217186024,0.6264880952380953,44.646990740740726,1021.4120370370351,29.183201058201004,0
774,4,1,1,38,0.02564102564102564,0.02564102564102564,0.9743589743589743,39,1150,700,450,0.6086956521739131,16,7,9,351.53966698364036,0.7747413405308142,0.1192590082457925,0.20253681321138658,130694.03863322765,1388.8277635743632,132082.866396802,773,0,471.56410256410254,36,3,19,35.38293869309838,0.6273148148148149,44.36936936936936,1022.5225225225212,28.403403403403367,0
775,4,0,2,36,0.0,0.05263157894736842,0.9473684210526316,38,750,500,250,0.6666666666666666,10,5,5,359.1621576862874,0.7647285443338075,0.11970362337407003,0.20667617842625233,130646.86381440733,1784.6819005057996,132431.54571491314,774,3,484.9736842105263,35,3,19,35.23588154269972,0.6288690476190478,44.415509259259245,1022.337962962961,29.20965608465603,0
776,4,0,0,36,0.0,0.0,1.0,36,850,500,350,0.5882352941176471,12,5,7,376.3382746136169,0.7451719576719578,0.1350482743905692,0.21477058247127745,130325.14537677797,2609.268069973065,132934.41344675104,775,22,512.6111111111111,33,3,19,35.12361977916466,0.6300505050505052,44.730392156862735,1021.0784313725475,30.941770647652955,0
777,4,0,0,36,0.0,0.0,1.0,36,800,600,200,0.75,10,6,4,382.3618001385324,0.7451719576719578,0.13690213392200157,0.21355176530938197,129481.87183114653,2701.784319732777,132183.6561508793,776,23,513.6111111111111,33,3,19,35.82869255468592,0.6215277777777779,45.55759803921568,1017.7696078431362,30.841503267973824,1
778,4,2,0,38,0.05263157894736842,0.0,1.0,38,900,800,100,0.8888888888888888,10,8,2,362.6201299819189,0.7648174490279753,0.13593355195957235,0.20520526430768668,129996.88042534702,1827.8971354166436,131824.77756076367,777,0,487.5263157894737,35,3,21,35.80715866530474,0.6223214285714287,45.05208333333332,1019.7916666666649,29.136904761904713,0
779,4,4,3,39,0.09523809523809523,0.07142857142857142,0.9285714285714286,42,1050,800,250,0.7619047619047619,13,8,5,333.3545319111621,0.7949574138598529,0.14415454652046034,0.19425231956220604,131131.51552641185,343.19953014387704,131474.71505655572,778,0,442.0,37,5,19,35.40607269029011,0.6297860360360361,43.941885964912274,1024.23245614035,27.681958274063515,0
780,4,1,0,40,0.025,0.0,1.0,40,1250,900,350,0.72,16,9,7,347.46072135840893,0.777991452991453,0.15060230743128655,0.20117224869218658,130883.6232880013,1095.3836323302198,131979.0069203315,779,0,465.025,35,5,20,35.29542755344418,0.6312500000000001,44.184027777777764,1023.263888888887,29.236111111111057,0
781,4,0,0,40,0.0,0.0,1.0,40,950,500,450,0.5263157894736842,14,5,9,347.9395915451734,0.7784989316239316,0.1488127544097697,0.20191455036912784,130972.46334876513,1114.101080246883,132086.564429012,780,1,466.025,35,5,20,35.19335142469472,0.6321428571428573,44.09722222222221,1023.6111111111087,29.246031746031676,0
782,4,0,0,40,0.0,0.0,1.0,40,800,500,300,0.625,11,5,6,348.2238913831838,0.7772435897435898,0.15219258589511786,0.20270295993147405,131090.96364883377,1129.8010973936593,132220.76474622742,781,2,467.025,35,5,22,35.06630500301385,0.6333333333333335,43.98148148148147,1024.074074074072,29.259259259259203,0
783,4,0,1,39,0.0,0.025,0.975,40,1300,1000,300,0.7692307692307693,16,10,6,348.012117769971,0.7766025641025641,0.1545087372238707,0.20337586766788457,131241.56832085445,1134.731226158564,132376.299547013,782,3,468.025,36,4,22,34.91958823313916,0.6328125000000002,43.834459459459445,1024.6621621621605,28.462837837837792,0
784,4,1,0,40,0.025,0.0,1.0,40,1100,800,300,0.7272727272727273,14,8,6,346.35468305902623,0.7819444444444444,0.15548780487804947,0.20286488579171474,131328.1249999996,1097.2507558233483,132425.37575582293,783,0,467.75,35,5,23,34.874661246612476,0.6357142857142859,43.74999999999998,1024.9999999999968,29.285714285714196,0
785,4,1,1,40,0.024390243902439025,0.024390243902439025,0.975609756097561,41,900,600,300,0.6666666666666666,12,6,6,338.3082719823388,0.7871951219512195,0.15883618780644082,0.20020493314150767,131721.78578985817,712.5139465989239,132434.2997364571,784,0,457.3170731707317,37,4,21,34.68409527878658,0.6356981981981983,43.366228070175424,1026.5350877192964,27.744191559980983,0
786,4,0,1,39,0.0,0.025,0.975,40,1050,600,450,0.5714285714285714,15,6,9,351.24362898553414,0.7781784188034188,0.18363016710642022,0.2048020544392575,131155.04017531034,1213.4744541838993,132368.51462949422,785,2,469.75,36,4,22,34.924234095573155,0.6319444444444444,43.91891891891891,1024.3243243243235,28.45345345345343,1
787,4,0,0,39,0.0,0.0,1.0,39,900,500,400,0.5555555555555556,13,5,8,359.45523702762375,0.7692869995501574,0.18734037773042966,0.20875781822122952,131002.08340031267,1617.8769879543622,132619.96038826703,786,7,482.7435897435897,35,4,22,34.8686875824383,0.6324404761904763,44.068287037037024,1023.7268518518497,29.249338624338563,0
788,4,0,0,39,0.0,0.0,1.0,39,1250,900,350,0.72,16,9,7,358.28012959611584,0.77046783625731,0.1806342475117897,0.20920156379847066,131209.51753257873,1601.9525891632213,132811.47012174194,787,8,483.7435897435897,35,4,23,34.68895918059948,0.6345238095238095,43.86574074074073,1024.537037037036,29.272486772486744,0
789,4,0,0,39,0.0,0.0,1.0,39,1050,400,650,0.38095238095238093,17,4,13,353.71674863412613,0.7692869995501574,0.17984487805459648,0.20586410498990218,131084.19075963716,1478.69311819377,132562.88387783093,788,9,484.7435897435897,34,5,22,34.93252538169418,0.6354166666666667,43.988095238095234,1024.0476190476188,30.119047619047613,2
790,4,0,0,39,0.0,0.0,1.0,39,1300,700,600,0.5384615384615384,19,7,12,354.28646969396533,0.7668690958164642,0.18115488847196182,0.20751064653503676,131328.12499999997,1505.5555555555547,132833.68055555553,789,10,485.7435897435897,34,5,22,34.671409214092144,0.6378676470588236,43.75,1024.9999999999998,30.147058823529406,0
791,4,0,0,39,0.0,0.0,1.0,39,1300,1100,200,0.8461538461538461,15,11,4,355.07465468527204,0.7670377867746289,0.18377457810806708,0.20830401404288545,131389.1439909295,1530.5909863945408,132919.73497732403,790,11,486.7435897435897,34,5,22,34.589574624554906,0.6384803921568627,43.69047619047618,1025.2380952380936,30.154061624649813,0
792,4,0,0,39,0.0,0.0,1.0,39,1150,800,350,0.6956521739130435,15,8,7,336.04895095804517,0.7672627080521818,0.06755012128685656,0.1971338812971101,131387.44882758908,1030.522869513025,132417.9716971021,791,12,487.7435897435897,35,4,20,35.078930533604286,0.6363095238095239,43.692129629629626,1025.2314814814808,29.292328042328023,5
793,4,1,1,39,0.025,0.025,0.975,40,950,700,250,0.7368421052631579,12,7,5,329.871717289767,0.7723290598290599,0.06562637121544546,0.19526692044243613,131732.43344696047,690.9608087817578,132423.39425574223,792,0,476.525,36,4,18,34.889891399736726,0.6377314814814814,43.35585585585586,1026.5765765765766,28.516016016016017,0
794,4,1,1,39,0.025,0.025,0.975,40,850,700,150,0.8235294117647058,10,7,3,329.21276373304477,0.775534188034188,0.06258227292672225,0.19487685416821013,131732.43344696047,673.599697670647,132406.0331446311,793,0,477.5,36,4,18,34.9068030568963,0.6377314814814814,43.35585585585586,1026.5765765765766,28.516016016016017,0
795,4,0,0,39,0.0,0.0,1.0,39,850,500,350,0.5882352941176471,12,5,7,335.70563529078333,0.7664754835807468,0.06653650917610365,0.19800601842001278,131595.18771701376,1035.4492187499905,132630.63693576376,794,15,490.7435897435897,35,4,18,34.87838409475465,0.6383928571428572,43.48958333333333,1026.0416666666656,29.31547619047616,0
796,4,0,0,39,0.0,0.0,1.0,39,700,300,400,0.42857142857142855,11,3,8,336.1709218286791,0.7652384165542061,0.06717324173345851,0.19874424898511503,131684.26890432098,1053.6844135802485,132737.95331790124,795,16,491.7435897435897,35,4,18,34.7767253044655,0.6392857142857142,43.40277777777778,1026.388888888889,29.325396825396826,0
797,4,0,0,39,0.0,0.0,1.0,39,550,300,250,0.5454545454545454,8,3,5,337.8613036355019,0.7659131803868646,0.0675974908218433,0.20005539140500003,131743.6731074245,1102.2178283607627,132845.89093578525,796,17,492.7435897435897,35,4,18,34.67352499060504,0.6398809523809523,43.344907407407405,1026.6203703703698,29.332010582010565,0
798,4,0,0,39,0.0,0.0,1.0,39,750,500,250,0.6666666666666666,10,5,5,339.73664697994144,0.7662505623031939,0.06325325568227758,0.20211142617921984,131921.96609224967,1163.7452846364904,133085.71137688617,797,18,493.7435897435897,35,4,19,34.44588403184616,0.6416666666666666,43.1712962962963,1027.314814814815,29.35185185185186,0
799,4,0,0,39,0.0,0.0,1.0,39,750,500,250,0.6666666666666666,10,5,5,338.90167897944855,0.7669815564552407,0.06097937801958553,0.20208918788841645,132011.15779588898,1147.7606042095326,133158.9184000985,798,19,494.7435897435897,35,4,19,34.37758099635847,0.6425595238095239,43.08449074074074,1027.6620370370365,29.36177248677247,0
800,4,0,0,39,0.0,0.0,1.0,39,600,300,300,0.5,9,3,6,339.62613527172357,0.7665879442195231,0.06431907805472314,0.2029986092519146,132100.37964034645,1172.9482810356749,133273.32792138212,799,20,495.7435897435897,35,4,19,34.26921489154093,0.6434523809523809,42.99768518518519,1028.00925925926,29.371693121693145,0
801,4,0,0,39,0.0,0.0,1.0,39,750,500,250,0.6666666666666666,10,5,5,337.6901202397823,0.7645636527215475,0.05686208319267849,0.20263687363747113,132249.14969403733,1131.8462523576961,133380.99594639504,800,21,496.7435897435897,35,4,19,34.16940943700536,0.644940476190476,42.85300925925927,1028.587962962964,29.38822751322754,0
802,4,0,0,39,0.0,0.0,1.0,39,850,500,350,0.5882352941176471,12,5,7,334.66708111862357,0.7646761133603239,0.05993007503184833,0.2014616460646894,132369.03077063567,1059.911431701996,133428.94220233767,801,22,497.7435897435897,36,3,21,34.126723571897585,0.6440972222222221,42.7364864864865,1029.0540540540555,28.584834834834876,0
803,4,0,0,39,0.0,0.0,1.0,39,1000,600,400,0.6,14,6,8,333.674024241263,0.7643949617633828,0.058280180172166185,0.2013453794566786,132459.2704790251,1039.6499065599153,133498.920385585,802,23,498.7435897435897,34,5,22,34.06166878686249,0.6492034313725489,42.64880952380953,1029.404761904763,30.276610644257737,0
804,4,2,2,39,0.04878048780487805,0.04878048780487805,0.9512195121951219,41,1350,1000,350,0.7407407407407407,17,10,7,313.81681523996014,0.7814532520325204,0.08017315072479603,0.18919707415912035,132426.21678064385,111.51472087563198,132537.73150151948,803,0,475.3658536585366,37,4,18,34.60581566705728,0.6427364864864865,42.68092105263157,1029.2763157894722,27.81827880512087,1
805,4,0,0,39,0.0,0.0,1.0,39,1200,1000,200,0.8333333333333334,14,10,4,331.5229499592629,0.763101664417454,0.08843325367413657,0.19846697354704113,132159.87761488333,962.8064986282467,133122.68411351158,804,25,500.7435897435897,35,4,19,34.41767972384812,0.644047619047619,42.93981481481481,1028.24074074074,29.378306878306855,0
806,4,0,0,39,0.0,0.0,1.0,39,700,600,100,0.8571428571428571,8,6,2,331.2678578674464,0.7634390463337832,0.08843643414879065,0.19862659817882108,132219.38898533946,960.0067515432067,133179.39573688267,805,26,501.7435897435897,35,4,19,34.36444969615124,0.6446428571428571,42.88194444444444,1028.472222222222,29.384920634920626,0
807,4,0,0,39,0.0,0.0,1.0,39,650,500,150,0.7692307692307693,8,5,3,329.66199809950643,0.7636077372919479,0.09342678319056286,0.1982879000747369,132338.45191400888,925.3916966735228,133263.8436106824,806,27,502.7435897435897,35,4,21,34.28618297712786,0.6458333333333334,42.7662037037037,1028.935185185185,29.39814814814814,0
808,4,0,0,39,0.0,0.0,1.0,39,900,600,300,0.6666666666666666,12,6,6,327.9831456277276,0.7645074224021593,0.06366806608884068,0.19009635379239703,130924.43795146485,788.2017997727271,131712.63975123758,807,28,503.7435897435897,36,3,15,35.75250330105633,0.6296296296296298,44.144144144144136,1023.4234234234224,28.4284284284284,8
809,4,0,0,39,0.0,0.0,1.0,39,550,500,50,0.9090909090909091,6,5,1,326.9853718045073,0.763888888888889,0.06112098389326093,0.18980185374859299,130982.06948502533,765.8441380569475,131747.91362308228,808,29,504.7435897435897,36,3,16,35.71988448844885,0.6302083333333335,44.087837837837824,1023.6486486486467,28.43468468468463,0
810,4,0,0,39,0.0,0.0,1.0,39,650,400,250,0.6153846153846154,9,4,5,329.8481771091168,0.7618645973909132,0.0650020018834625,0.19203836892639592,131097.37059694808,848.4457430403185,131945.8163399884,809,30,505.7435897435897,36,3,16,35.53029469980207,0.6313657407407408,43.975225225225216,1024.0990990990974,28.447197197197152,0
811,4,2,0,41,0.04878048780487805,0.0,1.0,41,800,500,300,0.625,11,5,6,334.5963789655275,0.7816565040650406,0.06960155261850742,0.18683265568731613,129473.07715136233,464.4474632823466,129937.52461464467,810,0,482.0243902439024,38,3,17,37.05297781510252,0.6112938596491229,45.56623931623931,1017.7350427350422,26.782501124606373,6
812,4,0,0,41,0.0,0.0,1.0,41,1000,500,500,0.5,15,5,10,339.1259712231717,0.7808434959349594,0.0768020144790682,0.1900182029234594,129609.02829141993,590.7575197238493,130199.78581114378,811,1,483.0243902439024,38,3,17,36.799653761410134,0.6126644736842106,45.4326923076923,1018.2692307692292,26.7965587044534,0
813,4,0,1,40,0.0,0.024390243902439025,0.975609756097561,41,950,600,350,0.631578947368421,13,6,7,339.0561526479444,0.7797764227642277,0.07980168536738841,0.19037463835956997,129690.63321827732,594.48142669295,130285.11464497026,812,2,484.0243902439024,38,3,17,36.71858611285923,0.6134868421052633,45.352564102564095,1018.5897435897425,26.804993252361644,0
814,4,0,0,40,0.0,0.0,1.0,40,850,500,350,0.5882352941176471,12,5,7,341.79348530660246,0.7756944444444445,0.09115541922290404,0.19211151070681412,129731.44531249974,868.2725694444157,130599.71788194415,813,3,496.275,37,3,18,36.60744717109748,0.6157094594594597,45.312499999999986,1018.749999999998,27.53378378378373,0
815,4,2,0,42,0.047619047619047616,0.0,1.0,42,850,600,250,0.7058823529411765,11,6,5,328.63422430406234,0.79045683313976,0.09835065774447327,0.18711718558718787,130236.00396050341,160.0016276041576,130396.00558810757,814,0,473.5952380952381,39,3,20,36.43154488553254,0.6172542735042736,44.81770833333333,1020.7291666666661,26.172542735042718,0
816,4,1,0,43,0.023255813953488372,0.0,1.0,43,400,300,100,0.75,5,3,2,322.51979955692514,0.7993263196751569,0.09792152074831151,0.184666725949899,130453.51765103343,-185.226101791377,130268.29154924204,815,0,463.5581395348837,38,5,21,36.36769678588861,0.6211622807017545,44.604700854700845,1021.5811965811946,26.88371569950512,0
817,4,1,1,43,0.022727272727272728,0.022727272727272728,0.9772727272727273,44,1200,900,300,0.75,15,9,6,315.4079745356114,0.8029642353770261,0.0963490064630832,0.18194333102177596,130741.54188368034,-552.6150173611303,130188.92686631922,816,0,454.0,39,5,16,36.258657567732755,0.6223290598290598,44.32291666666666,1022.7083333333317,26.223290598290557,0
818,4,0,1,42,0.0,0.023255813953488372,0.9767441860465116,43,950,700,250,0.7368421052631579,12,7,5,322.225218427047,0.7949889258028793,0.09562452289844336,0.1850183937258783,130562.68376981514,-185.88214076997076,130376.80162904516,817,1,465.5348837209302,38,5,16,36.264940065509776,0.6222587719298246,44.49786324786324,1022.0085470085467,26.894961763382806,0
819,4,2,1,43,0.045454545454545456,0.022727272727272728,0.9772727272727273,44,1050,900,150,0.8571428571428571,12,9,3,315.5009918041444,0.7998150105708246,0.09452999916707538,0.18262617810796156,130874.74093967007,-541.777886284733,130332.96305338533,818,0,455.84090909090907,39,5,18,36.121962910176784,0.62366452991453,44.19270833333333,1023.2291666666661,26.236645299145284,0
820,4,0,0,43,0.0,0.0,1.0,43,1200,1000,200,0.8333333333333334,14,10,4,318.04416294481587,0.7949427833148763,0.09310581796018069,0.18404283676873115,130863.12601587031,-275.94932518812107,130587.17669068219,819,1,467.4418604651163,38,5,18,36.06861926142493,0.6252741228070176,44.20405982905982,1023.1837606837598,26.92588843904631,0
821,4,0,0,43,0.0,0.0,1.0,43,1400,1200,200,0.8571428571428571,16,12,4,316.4528135773465,0.7952657807308969,0.09479535854736088,0.18351198269194802,130945.12473518889,-312.40937066257356,130632.71536452632,820,2,468.4418604651163,38,5,19,36.02666144745998,0.6260964912280702,44.123931623931625,1023.504273504274,26.93432298695458,0
822,4,0,0,43,0.0,0.0,1.0,43,1150,700,450,0.6086956521739131,16,7,9,315.4727777064367,0.7926356589147286,0.09833630211031563,0.1836242082671393,131088.00048828137,-329.06087239581814,130758.93961588555,821,3,469.4418604651163,39,4,19,35.907778964500054,0.6258012820512819,43.98437500000001,1024.062500000001,26.258012820512842,0
823,4,0,0,43,0.0,0.0,1.0,43,900,400,500,0.4444444444444444,14,4,10,316.0427879442066,0.7921280915466962,0.1029991556670824,0.18421154320423164,131141.34250217036,-310.7449001735864,130830.59760199678,822,4,470.4418604651163,39,4,20,35.839456422251615,0.62633547008547,43.93229166666668,1024.270833333335,26.263354700854745,0
824,4,1,1,43,0.022727272727272728,0.022727272727272728,0.9772727272727273,44,1200,700,500,0.5833333333333334,17,7,10,310.6418437861681,0.7989341085271319,0.10736481109553164,0.18220777096406301,131382.88498064154,-637.1298315195991,130745.75514912193,823,0,460.72727272727275,38,6,20,35.73472453800192,0.6304824561403508,43.6965811965812,1025.2136752136762,26.979307242465165,0
825,4,0,0,43,0.0,0.0,1.0,43,1000,600,400,0.6,14,6,8,317.9324476171589,0.7948966408268734,0.10361126867082637,0.18621757646147896,131328.12500000015,-249.3055555555406,131078.8194444446,824,6,472.4418604651163,40,3,20,35.602981029810316,0.6265624999999999,43.75000000000001,1025.0000000000011,25.62500000000003,0
826,4,0,0,43,0.0,0.0,1.0,43,1050,900,150,0.8571428571428571,12,9,3,314.91260994052834,0.7934662236987818,0.10112171681557447,0.18484503471555047,131410.26925131492,-323.4498274161711,131086.81942389876,825,7,473.4418604651163,38,5,20,35.59771282692507,0.6307565789473684,43.669871794871796,1025.320512820513,26.982118758434552,0
827,4,1,1,43,0.022727272727272728,0.022727272727272728,0.9772727272727273,44,1000,600,400,0.6,14,6,8,312.4735349529104,0.8017309725158562,0.09813892348138942,0.1849505517694255,131728.82080078125,-567.6459418402783,131161.17485894097,826,0,463.65909090909093,39,5,16,35.34003466937258,0.6322115384615385,43.359375,1026.5625,26.322115384615383,0
828,4,0,0,43,0.0,0.0,1.0,43,1100,700,400,0.6363636363636364,15,7,8,321.3283788627434,0.7923126614987079,0.10081714850028045,0.19010610000697267,131711.68456424854,-135.4595843378081,131576.22497991074,827,9,475.4418604651163,38,5,17,35.13001318345821,0.6337719298245614,43.37606837606837,1026.4957264957254,27.013045434098036,0
829,4,1,1,43,0.022727272727272728,0.022727272727272728,0.9772727272727273,44,1350,900,450,0.6666666666666666,18,9,9,311.50958246111395,0.7982954545454546,0.10398822630656546,0.18611455561690285,132084.41904826814,-570.8875545310435,131513.5314937371,828,0,465.6136363636364,40,4,18,35.00782666007579,0.6341145833333334,43.013211382113816,1027.947154471544,25.6986788617886,0
830,4,0,1,42,0.0,0.023255813953488372,0.9767441860465116,43,1050,900,150,0.8571428571428571,12,9,3,317.71819823296863,0.7934200812107789,0.10366822396862108,0.18951679224706597,132023.0523003473,-210.77473958332385,131812.277560764,829,1,477.1162790697674,39,4,18,34.90987566727482,0.6351495726495726,43.07291666666667,1027.7083333333342,26.35149572649575,0
831,4,0,0,42,0.0,0.0,1.0,42,1100,800,300,0.7272727272727273,14,8,6,327.09236677290954,0.7890534262485482,0.09345306179038171,0.1947769220591373,131958.5539141828,232.52714314411787,132191.0810573269,830,2,489.1666666666667,38,4,18,34.73384804686147,0.6362390350877194,43.135683760683754,1027.457264957264,27.038349077822737,0
832,4,0,0,42,0.0,0.0,1.0,42,400,100,300,0.25,7,1,6,325.1278305332361,0.7900938830816879,0.0862290862290862,0.19402789886660837,132040.89506172817,186.03395061725803,132226.9290123454,831,3,490.1666666666667,38,4,19,34.70157657657657,0.637061403508772,43.05555555555554,1027.777777777776,27.04678362573095,0
833,4,0,0,42,0.0,0.0,1.0,42,1400,1100,300,0.7857142857142857,17,11,6,324.7664103769746,0.7892228029423152,0.08686424326618858,0.19454453903164384,132183.68055555545,185.7638888888839,132369.44444444432,832,4,491.1666666666667,39,3,19,34.567463533225286,0.6367521367521367,42.916666666666664,1028.3333333333326,26.36752136752135,0
834,4,1,0,43,0.023255813953488372,0.0,1.0,43,800,500,300,0.625,11,5,6,320.80974199184243,0.7985880398671096,0.0880006966623752,0.19340579991588733,132424.80604383664,-103.1928168402975,132321.61322699633,833,0,480.72093023255815,39,4,20,34.427288904631766,0.639155982905983,42.68229166666666,1029.270833333332,26.39155982905979,0
835,4,0,0,43,0.0,0.0,1.0,43,1100,700,400,0.6363636363636364,15,7,8,319.8223637483834,0.798172757475083,0.08352537206548005,0.19334368672426122,132528.77338224594,-122.86688644326068,132405.9064958027,834,1,481.72093023255815,40,3,20,34.348475128306355,0.6385416666666668,42.58130081300813,1029.6747967479669,25.741869918699173,0
836,4,0,0,43,0.0,0.0,1.0,43,1150,700,450,0.6086956521739131,16,7,9,319.9405947678713,0.7979420450350683,0.08618533518431426,0.19381936210235334,132607.2663118016,-114.71046913215463,132492.55584266945,835,2,482.72093023255815,40,3,21,34.26677355698077,0.6393229166666667,42.505081300812996,1029.979674796746,25.74949186991865,0
837,4,0,0,43,0.0,0.0,1.0,43,1450,1000,450,0.6896551724137931,19,10,9,326.3877529505716,0.7960502030269472,0.09077195363509616,0.1989709955487139,132842.88452640624,71.65811520919581,132914.54264161544,836,3,483.72093023255815,40,3,14,33.864640838590944,0.6416666666666667,42.27642276422764,1030.8943089430893,25.772357723577233,0
838,4,0,1,42,0.0,0.023255813953488372,0.9767441860465116,43,1300,1000,300,0.7692307692307693,16,10,6,329.21818049455237,0.7946659283868586,0.09889792645205642,0.201541889747871,133000.07952442302,157.20883733224798,133157.2883617553,837,4,484.72093023255815,40,3,16,33.634236453201964,0.6432291666666667,42.123983739837385,1031.5040650406484,25.787601626016208,0
839,4,0,0,42,0.0,0.0,1.0,42,1150,800,350,0.6956521739130435,15,8,7,334.0904464518858,0.7853755323267518,0.10005099120161276,0.2040198229134616,132907.71620008664,480.63964843748,133388.3558485241,838,10,497.1666666666667,39,3,17,33.60114237128329,0.6439636752136753,42.21354166666666,1031.145833333332,26.439636752136714,0
840,4,0,0,42,0.0,0.0,1.0,42,950,800,150,0.8421052631578947,11,8,3,334.1595072706515,0.7849883855981417,0.09283093097859307,0.20435536019065567,132961.42713758658,486.06499565969744,133447.49213324627,839,11,498.1666666666667,39,3,18,33.545538329461664,0.6444978632478634,42.16145833333332,1031.354166666665,26.444978632478588,0
841,4,0,1,41,0.0,0.023809523809523808,0.9761904761904762,42,1200,1000,200,0.8333333333333334,14,10,4,339.51595697779254,0.784673828881146,0.10064978756944853,0.20868015519453917,133149.50086805565,641.2760416666761,133790.77690972234,840,12,499.1666666666667,39,3,18,33.21894765172924,0.6463675213675213,41.97916666666667,1032.0833333333342,26.463675213675234,0
842,4,0,0,41,0.0,0.0,1.0,41,1000,600,400,0.6,14,6,8,345.41434772819554,0.7796239837398374,0.09331787632880983,0.2117883400642022,133058.54752218936,992.0662804076286,134050.61380259698,841,23,512.0487804878048,38,3,18,33.157942425183826,0.647203947368421,42.06730769230769,1031.7307692307693,27.15080971659919,0
843,4,0,1,40,0.0,0.024390243902439025,0.975609756097561,41,600,200,400,0.3333333333333333,10,2,8,349.9698007697964,0.7796239837398374,0.136292126414024,0.20716394180632883,131732.4334469605,1029.437756513514,132761.871203474,842,24,513.0487804878048,36,5,19,34.37408585636974,0.6377314814814814,43.35585585585586,1026.5765765765768,28.516016016016025,5
844,4,0,0,40,0.0,0.0,1.0,40,950,800,150,0.8421052631578947,11,8,3,358.91313463499836,0.7710470085470086,0.14895128552097425,0.21218944519621113,131684.268904321,1452.642746913582,133136.9116512346,843,25,526.075,35,5,19,34.193166441136675,0.6392857142857142,43.40277777777778,1026.3888888888891,29.325396825396833,0
845,4,0,0,40,0.0,0.0,1.0,40,1300,800,500,0.6153846153846154,18,8,10,359.4487401836419,0.7722489316239316,0.13686273434930385,0.2135851439228012,131876.97991488117,1480.6028579255008,133357.58277280667,844,26,527.075,36,4,20,33.98498885356139,0.6391782407407407,43.215090090090094,1027.13963963964,28.53165665665667,0
846,4,0,0,40,0.0,0.0,1.0,40,850,600,250,0.7058823529411765,11,6,5,361.7747089484643,0.7721955128205128,0.13317992548761803,0.215787973455143,132021.60564280505,1552.4155912669546,133574.02123407202,845,27,528.075,36,4,21,33.77940317042882,0.640625,43.07432432432433,1027.7027027027034,28.547297297297316,0
847,4,0,0,40,0.0,0.0,1.0,40,1000,700,300,0.7,13,7,6,360.6928267524783,0.7712339743589743,0.1341740606857269,0.21563620271272932,132108.41912436092,1530.1118263533917,133638.5309507143,846,28,529.075,36,4,21,33.71969365027204,0.6414930555555556,42.98986486486487,1028.0405405405413,28.556681681681702,0
848,4,0,0,40,0.0,0.0,1.0,40,1250,1200,50,0.96,13,12,1,364.8331670399937,0.7696581196581197,0.13978441672138242,0.21962091438810727,132369.03077063576,1658.5225428131075,134027.55331344885,847,29,530.075,36,4,21,33.350660246589314,0.6440972222222221,42.7364864864865,1029.0540540540562,28.584834834834894,0
849,4,1,0,41,0.024390243902439025,0.0,1.0,41,550,200,350,0.36363636363636365,9,2,7,356.1894517822917,0.777489837398374,0.14029654229445798,0.2165773869275585,132745.92318247314,1256.542691340006,134002.46587381314,848,0,518.1219512195122,36,5,20,33.19400429825521,0.6478587962962963,42.370495495495504,1030.5180180180191,28.625500500500532,0
850,4,1,0,42,0.023809523809523808,0.0,1.0,42,1200,1000,200,0.8333333333333334,14,10,4,348.84514650017314,0.7799554781262098,0.14437291549630826,0.21382957546710946,133047.67001625506,882.6067876654438,133930.2768039205,849,0,506.76190476190476,37,5,21,33.08036188755447,0.6489301801801801,42.077850877192986,1031.6885964912285,27.883475580844014,0
851,4,0,0,42,0.0,0.0,1.0,42,1250,1000,250,0.8,15,10,5,348.755006788979,0.7796167247386759,0.1519206316349766,0.21462871819077176,133196.36774965306,890.5800277595242,134086.94777741257,850,1,507.76190476190476,38,4,21,32.93357137928656,0.6485745614035088,41.93376068376069,1032.2649572649577,27.164867296446257,0
852,4,0,1,41,0.0,0.023809523809523808,0.9761904761904762,42,1150,800,350,0.6956521739130435,15,8,7,350.89799948291545,0.7779713511420828,0.14143108365721369,0.21674958217260995,133334.25931633078,957.3449713273601,134291.60428765815,851,2,508.76190476190476,38,4,21,32.7400348263853,0.6499451754385963,41.80021367521368,1032.7991452991464,27.178924876293326,0
853,4,0,0,41,0.0,0.0,1.0,41,800,500,300,0.625,11,5,6,359.6773274889498,0.7729674796747967,0.15076475249781107,0.22198172151316725,133302.32018505695,1389.1644544475193,134691.48463950446,852,3,520.390243902439,37,4,21,32.54539180293054,0.6514639639639639,41.83114035087719,1032.6754385964914,27.91014698909436,0
854,4,0,0,41,0.0,0.0,1.0,41,1150,1000,150,0.8695652173913043,13,10,3,359.3152205796098,0.7734756097560975,0.15202794558999821,0.22192721722225225,133330.62967691995,1381.54492247616,134712.17459939612,853,4,521.390243902439,37,4,21,32.52634303004565,0.6517454954954953,41.803728070175445,1032.7850877192993,27.91311047889998,0
855,4,0,0,41,0.0,0.0,1.0,41,450,400,50,0.8888888888888888,5,4,1,343.05239400405804,0.7735264227642277,0.10656473224470342,0.2050217475221769,132095.8034279349,863.1563207685103,132958.9597487034,854,5,522.390243902439,38,3,19,34.185763528026065,0.6376096491228069,43.00213675213676,1027.9914529914536,27.05240665766983,3
856,4,0,0,41,0.0,0.0,1.0,41,500,400,100,0.8,6,4,2,343.05239400405804,0.7735264227642277,0.10656473224470342,0.2050217475221769,132095.8034279349,863.1563207685103,132958.9597487034,855,6,523.390243902439,38,3,19,34.185763528026065,0.6376096491228069,43.00213675213676,1027.9914529914536,27.05240665766983,0
857,4,0,0,41,0.0,0.0,1.0,41,1150,800,350,0.6956521739130435,15,8,7,344.0236886977447,0.7735264227642277,0.11517727765561836,0.20650000466221247,132260.59701219967,900.1556907005757,133160.75270290024,856,7,524.390243902439,38,3,20,33.99503185154412,0.6392543859649122,42.84188034188035,1028.6324786324794,27.069275753486302,0
858,4,0,0,41,0.0,0.0,1.0,41,950,700,250,0.7368421052631579,12,7,5,343.39195856349056,0.7737296747967479,0.12145748987854255,0.20687271650044456,132398.00347222236,893.0246228723988,133291.02809509475,857,8,525.390243902439,36,5,20,33.87314439946021,0.644386574074074,42.70833333333334,1029.1666666666679,28.587962962962997,0
859,4,0,0,41,0.0,0.0,1.0,41,600,300,300,0.5,9,3,6,343.77127122400157,0.7727642276422764,0.12592333732590277,0.2077396386517549,132513.92598257068,910.8961579823354,133424.822140553,858,9,526.390243902439,36,5,20,33.74690109008714,0.6455439814814814,42.595720720720735,1029.6171171171193,28.600475475475534,0
860,4,0,0,41,0.0,0.0,1.0,41,1300,1000,300,0.7692307692307693,16,10,6,343.2233683775726,0.773119918699187,0.12468198812755671,0.20788880312458832,132600.90115453317,902.3455888321033,133503.24674336528,859,10,527.390243902439,36,5,20,33.67364603834099,0.646412037037037,42.511261261261275,1029.954954954957,28.609859859859917,0
861,4,0,0,41,0.0,0.0,1.0,41,1000,700,300,0.7,13,7,6,340.7258588238168,0.7728150406504065,0.12152127950147196,0.20692444474161772,132700.54879830522,842.901691138871,133543.45048944408,860,11,528.390243902439,38,3,19,33.63792686298909,0.643640350877193,42.414529914529915,1030.3418803418804,27.11426000899685,0
862,4,0,0,41,0.0,0.0,1.0,41,1300,900,400,0.6923076923076923,17,9,8,342.699005303683,0.7724085365853659,0.13154665391875153,0.20912668030184084,132880.8648003473,907.628038194449,133788.49283854174,861,12,529.390243902439,39,2,20,33.40615949350036,0.6436965811965811,42.239583333333336,1031.0416666666672,26.436965811965827,0
863,4,0,0,41,0.0,0.0,1.0,41,1000,700,300,0.7,13,7,6,345.1935974700165,0.7717987804878049,0.12972978300345717,0.21080021106450908,132907.71620008672,975.7785373263839,133883.4947374131,862,13,530.390243902439,39,2,20,33.3149181735529,0.6439636752136753,42.213541666666664,1031.1458333333328,26.43963675213674,0
864,4,0,0,41,0.0,0.0,1.0,41,1050,800,250,0.7619047619047619,13,8,5,345.1147033699389,0.770630081300813,0.12881359272085913,0.21120678570884663,132988.2866753473,979.2426215277873,133967.5292968751,863,14,531.390243902439,39,2,20,33.23613074799704,0.6447649572649572,42.13541666666667,1031.4583333333342,26.447649572649595,0
865,4,0,0,41,0.0,0.0,1.0,41,950,800,150,0.8421052631578947,11,8,3,346.88108646304414,0.771900406504065,0.12584351542516115,0.21305337406009806,133122.62505425364,1035.5441623264087,134158.16921658005,864,15,532.390243902439,39,2,20,33.05585696981933,0.6461004273504274,42.00520833333334,1031.979166666668,26.46100427350431,0
866,4,0,0,41,0.0,0.0,1.0,41,1150,900,250,0.782608695652174,14,9,5,345.60605479093675,0.7721036585365854,0.12400874870053968,0.21291764163863702,133236.04630386995,1009.4368638046053,134245.48316767457,865,16,533.390243902439,40,1,20,32.97507136529185,0.6455729166666667,41.89532520325203,1032.418699186991,25.810467479674777,0
867,4,0,0,41,0.0,0.0,1.0,41,750,400,350,0.5333333333333333,11,4,7,344.12568200136417,0.7722560975609756,0.12441425004801254,0.21215515346686029,133262.2777447285,971.7944427919698,134234.07218752045,866,17,534.390243902439,40,1,20,32.986999671916,0.6458333333333335,41.86991869918698,1032.5203252032506,25.813008130081265,0
868,4,0,0,41,0.0,0.0,1.0,41,1200,1000,200,0.8333333333333334,14,10,4,346.59002822038156,0.7709349593495934,0.13370960155882572,0.21427865248369543,133367.22932778092,1044.750355277924,134411.97968305886,867,18,535.390243902439,40,1,21,32.81823921028465,0.6468750000000001,41.76829268292682,1032.9268292682914,25.823170731707286,0
869,4,0,0,41,0.0,0.0,1.0,41,900,500,400,0.5555555555555556,13,5,8,347.8580725960221,0.769969512195122,0.13029177718832896,0.2158368883619159,133500.54974848006,1087.9727193692784,134588.52246784934,868,19,536.390243902439,37,4,21,32.651967285587965,0.6534346846846848,41.6392543859649,1033.4429824561382,27.930891417733466,0
870,4,0,0,41,0.0,0.0,1.0,41,1200,900,300,0.75,15,9,6,349.16979707670816,0.7697662601626016,0.12915342984571154,0.21714860467277067,133585.55036164963,1128.807902431506,134714.35826408112,869,20,537.390243902439,37,4,21,32.532969169848684,0.6542792792792793,41.557017543859644,1033.7719298245604,27.939781887150282,0
871,4,0,0,41,0.0,0.0,1.0,41,750,500,250,0.6666666666666666,10,5,5,353.32315214329657,0.7686483739837399,0.1374501837479407,0.22023731975303557,133670.57802641182,1245.7819954216482,134916.36002183348,870,21,538.390243902439,37,4,21,32.340486162655054,0.6551238738738739,41.474780701754376,1034.1008771929812,27.94867235656706,0
872,4,0,0,41,0.0,0.0,1.0,41,1100,700,400,0.6363636363636364,15,7,8,355.12082670770457,0.7684959349593496,0.14122245950040613,0.2218682039179128,133755.63274276687,1299.8821752846898,135055.51491805157,871,22,539.390243902439,37,4,17,32.20885449791534,0.6559684684684686,41.392543859649116,1034.4298245614025,27.95756282598385,0
873,4,0,0,41,0.0,0.0,1.0,41,650,400,250,0.6153846153846154,9,4,5,359.0171184216406,0.7682418699186991,0.14495127894387339,0.22516694888916022,133897.45071800923,1414.2953841566464,135311.74610216587,872,23,540.390243902439,37,4,18,31.966111346540938,0.6573761261261262,41.25548245614034,1034.9780701754373,27.97238027501182,0
874,4,0,0,41,0.0,0.0,1.0,41,950,600,350,0.631578947368421,13,6,7,356.2047523790013,0.7668191056910569,0.14315586052796458,0.22434650193694963,134052.44545118322,1350.0236275476432,135402.46907873085,873,24,541.390243902439,38,3,19,31.883833694418648,0.6570723684210528,41.10576923076922,1035.5769230769213,27.25202429149793,0
875,4,0,0,41,0.0,0.0,1.0,41,900,600,300,0.6666666666666666,12,6,6,355.7745907209608,0.7667174796747968,0.1436848262242294,0.22441344548078782,134107.77043839917,1342.4274280443838,135450.19786644354,874,25,542.390243902439,38,3,19,31.83965102286402,0.6576206140350879,41.05235042735041,1035.790598290596,27.25764732343674,0
876,4,0,0,41,0.0,0.0,1.0,41,1050,600,450,0.5714285714285714,15,6,9,352.73550680079006,0.7658028455284552,0.14070447944032116,0.22278722158161418,134155.68300118967,1264.2945667261442,135419.9775679158,875,26,543.390243902439,40,1,19,31.87046301746125,0.6546875000000001,41.006097560975604,1035.9756097560967,25.899390243902417,0
877,4,0,0,41,0.0,0.0,1.0,41,1300,1000,300,0.7692307692307693,16,10,6,353.02667339118557,0.7666158536585366,0.1352962833686362,0.2242576663721591,134366.32977229153,1286.979683059015,135653.30945535054,876,27,544.390243902439,40,1,19,31.65249460890022,0.6567708333333333,40.80284552845528,1036.7886178861781,25.919715447154452,0
878,4,1,0,42,0.023809523809523808,0.0,1.0,42,700,500,200,0.7142857142857143,9,5,4,346.94228939772836,0.7729142469996129,0.1433074233391194,0.22202899047663952,134636.1154994805,942.698493913211,135578.81399339373,877,0,532.4047619047619,37,5,20,31.541094382813874,0.6646959459459459,40.54276315789473,1037.8289473684204,28.049431009957306,0
879,4,0,0,42,0.0,0.0,1.0,42,1650,1200,450,0.7272727272727273,21,12,9,347.7713420071875,0.7730594270228417,0.14158312017953922,0.22322601728043912,134744.82819234423,972.0779457958939,135716.90613814013,878,1,533.4047619047619,38,4,21,31.411212869589068,0.6639254385964912,40.43803418803419,1038.2478632478633,27.322312190733243,0
880,4,0,0,42,0.0,0.0,1.0,42,1050,900,150,0.8571428571428571,12,9,3,352.47860063350953,0.7719947735191638,0.15253573142896348,0.22694019571913768,134855.7749379063,1106.7549674921434,135962.52990539843,879,2,534.4047619047619,38,4,17,31.178426935472807,0.6650219298245614,40.33119658119658,1038.6752136752134,27.333558254610878,0
881,4,0,0,42,0.0,0.0,1.0,42,600,300,300,0.5,9,3,6,353.311251122302,0.7713898567557104,0.1507838556588943,0.2276504502758212,134883.51875821818,1131.172953648907,136014.69171186708,880,3,535.4047619047619,38,4,17,31.129152524940853,0.665296052631579,40.304487179487175,1038.7820512820506,27.33636977058028,0
882,4,0,0,42,0.0,0.0,1.0,42,750,600,150,0.8,9,6,3,354.14845483077784,0.7706397599690282,0.1554595928439233,0.2287149981197972,134966.76734056548,1159.6544214332755,136126.42176199876,881,4,536.4047619047619,38,4,18,31.024444787168413,0.6661184210526315,40.22435897435898,1039.1025641025647,27.344804318488542,0
883,4,0,0,42,0.0,0.0,1.0,42,1000,700,300,0.7,13,7,6,355.4137591840157,0.770591366627952,0.1611205748746869,0.22988464423817198,135022.28066330642,1197.7552688290004,136220.03593213542,882,5,537.4047619047619,38,4,18,30.93625788103071,0.6666666666666665,40.17094017094018,1039.3162393162402,27.350427350427374,0
884,4,0,1,41,0.0,0.023809523809523808,0.9761904761904762,42,900,600,300,0.6666666666666666,12,6,6,366.0565154979811,0.770591366627952,0.1383203521123022,0.23467911990717608,134700.92438539528,1465.7735845221976,136166.69796991747,883,6,538.4047619047619,35,7,19,30.9804372468131,0.669345238095238,40.480324074074076,1038.0787037037042,29.659391534391546,1
885,4,0,0,41,0.0,0.0,1.0,41,900,700,200,0.7777777777777778,11,7,4,372.77005400753694,0.7675304878048781,0.14256371797311385,0.23820115767812994,134581.66099773246,1833.6026077097501,136415.26360544222,884,7,551.7073170731708,34,7,19,30.92540538473305,0.670343137254902,40.595238095238095,1037.6190476190477,30.518207282913167,0
886,4,0,0,41,0.0,0.0,1.0,41,1250,900,350,0.72,16,9,7,365.514582895149,0.7651422764227642,0.14057763362161557,0.2347194934253672,134761.00508241166,1651.4225126457454,136412.4275950574,885,8,552.7073170731708,35,6,19,30.934515847360007,0.6699404761904761,40.4224537037037,1038.310185185185,29.666005291005284,0
887,4,0,0,41,0.0,0.0,1.0,41,1100,800,300,0.7272727272727273,14,8,6,384.0428226700145,0.7658028455284552,0.18779953878971734,0.22477869419606167,131300.74929003217,1885.0220752063753,133185.77136523853,886,9,553.7073170731708,38,3,15,33.93663782619271,0.6296600877192982,43.776709401709404,1024.8931623931626,26.97087269455691,6
888,4,1,1,41,0.023809523809523808,0.023809523809523808,0.9761904761904762,42,1150,700,450,0.6086956521739131,16,7,9,373.7736248402964,0.7732046070460704,0.17903835681969715,0.2203780597120763,131581.12502164114,1436.3165191177172,133017.44154075885,887,0,541.5,37,5,14,33.91611894838091,0.6342905405405406,43.503289473684205,1025.9868421052622,27.72937411095303,0
889,4,2,1,42,0.046511627906976744,0.023255813953488372,0.9767441860465116,43,950,700,250,0.7368421052631579,12,7,5,368.9935508722461,0.7774547803617571,0.18487688237208366,0.21948217121242997,131916.02105034713,1135.2322048611022,133051.25325520823,888,0,529.8604651162791,39,4,15,33.70048333671332,0.6340811965811967,43.17708333333333,1027.2916666666658,26.340811965811945,0
890,4,0,0,42,0.0,0.0,1.0,42,1100,800,300,0.7272727272727273,14,8,6,376.70343189706426,0.7708575300038715,0.1952509732830101,0.2238335472347573,131876.23844875433,1535.6463218642564,133411.88477061858,889,1,543.4761904761905,38,4,16,33.542663476874004,0.6354166666666667,43.21581196581196,1027.136752136751,27.029914529914503,0
891,4,0,0,42,0.0,0.0,1.0,42,1100,800,300,0.7272727272727273,14,8,6,383.5459416277054,0.7707849399922571,0.19982029614008057,0.2287246380977615,132013.4451589778,1726.6442262034998,133740.0893851813,890,2,544.4761904761905,38,4,16,33.22828949648265,0.6367872807017545,43.08226495726495,1027.6709401709384,27.043972109761537,0
892,4,0,0,42,0.0,0.0,1.0,42,1350,1000,350,0.7407407407407407,17,10,7,384.40117345090795,0.7679297328687572,0.19891547853953084,0.23090448528751037,132288.0725970669,1770.3380679742795,134058.41066504118,891,3,545.4761904761905,38,4,18,32.928955931734,0.6395285087719298,42.81517094017094,1028.7393162393157,27.072087269455675,0
893,4,2,2,42,0.045454545454545456,0.045454545454545456,0.9545454545454546,44,1250,900,350,0.72,16,9,7,367.8729248169723,0.7818446088794926,0.1874929301308399,0.22341098784224703,132700.54879830533,963.4791164438757,133664.0279147492,892,0,521.6363636363636,38,6,14,32.938657887460266,0.6436403508771928,42.41452991452992,1030.3418803418813,27.114260008996876,0
894,4,0,0,42,0.0,0.0,1.0,42,950,600,350,0.631578947368421,13,6,7,382.118445656744,0.766792489353465,0.19831971557394956,0.2307209058695284,132482.65241468514,1724.8130434364243,134207.46545812156,893,5,547.4761904761905,37,5,19,32.791364895089984,0.6432995495495495,42.62609649122806,1029.4956140350866,27.824205784732072,0
895,4,0,0,42,0.0,0.0,1.0,42,1150,1000,150,0.8695652173913043,13,10,3,384.0868171780477,0.7651229190863337,0.2039650435434981,0.23278139100455322,132623.79410010754,1787.810191597393,134411.60429170492,894,6,548.4761904761905,37,5,19,32.59837839755871,0.6447072072072073,42.48903508771929,1030.0438596491213,27.839023233760035,0
896,4,0,1,41,0.0,0.023809523809523808,0.9761904761904762,42,1700,1400,300,0.8235294117647058,20,14,6,360.06576689607886,0.7653164924506388,0.1739422708233227,0.20670598238838078,130555.17713758674,1001.6899956597115,131556.86713324644,895,7,549.4761904761905,39,3,15,35.30571552339209,0.6204594017094018,44.50520833333333,1021.9791666666661,26.204594017094003,7
897,4,0,0,41,0.0,0.0,1.0,41,1100,700,400,0.6363636363636364,15,7,8,369.3257123028307,0.7581808943089431,0.18440336869736473,0.2121676750067546,130581.79253472199,1445.4427083333126,132027.2352430553,896,19,563.7073170731708,39,2,16,35.04212528876206,0.6207264957264957,44.47916666666666,1022.0833333333314,26.207264957264908,0
898,4,0,0,41,0.0,0.0,1.0,41,1000,900,100,0.9,11,9,2,364.81063713337653,0.758130081300813,0.17675782463377399,0.2100068271826443,130661.65500216992,1333.3523220485904,131995.00732421852,897,20,564.7073170731708,39,2,16,35.07651978264562,0.6215277777777779,44.40104166666666,1022.3958333333316,26.215277777777732,0
899,4,0,0,41,0.0,0.0,1.0,41,1100,700,400,0.6363636363636364,15,7,8,360.0897180198514,0.7574186991869919,0.1691354047317415,0.20849588100873367,130885.78976014591,1226.125425507285,132111.9151856532,898,21,565.7073170731708,40,1,16,34.9701642003509,0.6221354166666667,44.18191056910568,1023.272357723576,25.5818089430894,0
900,4,0,0,41,0.0,0.0,1.0,41,600,200,400,0.3333333333333333,10,2,8,359.89298839118936,0.7574695121951219,0.17119511249397146,0.2085761836091857,130921.69390904496,1223.5599332325423,132145.2538422775,899,22,566.7073170731708,41,0,16,34.93884903709449,0.6209349593495934,44.14682539682539,1023.4126984126973,24.96128532713896,0
901,4,0,0,41,0.0,0.0,1.0,41,800,500,300,0.625,11,5,6,361.0053932147124,0.7584857723577236,0.1637991958948566,0.20963503953756973,130997.8517593378,1258.1861969324577,132256.03795627027,900,23,567.7073170731708,41,0,16,34.833296992602634,0.6216971544715447,44.072420634920626,1023.710317460316,24.96854432830039,0
902,4,1,0,42,0.023809523809523808,0.0,1.0,42,600,300,300,0.5,9,3,6,357.6473796869149,0.7664779326364692,0.16584262073623823,0.20907247320006225,131253.64428407254,988.5043905113977,132242.14867458394,901,0,555.1666666666666,42,0,17,34.66055949566589,0.6227678571428571,43.822674418604656,1024.709302325582,24.397840531561478,0
903,4,1,0,43,0.023255813953488372,0.0,1.0,43,1050,800,250,0.7619047619047619,13,8,5,355.3542687188068,0.7749630860095976,0.17429580790810983,0.20930196401571838,131541.7534722223,748.8692273601448,132290.62269958245,902,0,543.2325581395348,39,4,18,34.42831031681559,0.6303418803418803,43.54166666666667,1025.8333333333342,26.303418803418825,0
904,4,0,0,43,0.0,0.0,1.0,43,600,100,500,0.16666666666666666,11,1,10,329.89820107236216,0.7743170911775563,0.1303940787796618,0.19031452461415677,130744.07837498421,26.44725135424241,130770.52562633845,903,1,544.2325581395348,41,2,16,35.885613703236665,0.6191565040650406,44.320436507936506,1022.7182539682536,24.944347657762282,5
905,4,0,1,42,0.0,0.023255813953488372,0.9767441860465116,43,900,600,300,0.6666666666666666,12,6,6,328.85255640787966,0.7750553709856035,0.1276465242559066,0.19021067942986333,130845.55820302654,5.7792619362552955,130851.3374649628,904,2,545.2325581395348,41,2,16,35.809879925013746,0.6201727642276422,44.22123015873016,1023.1150793650789,24.954026325977534,0
906,4,0,0,42,0.0,0.0,1.0,42,1200,700,500,0.5833333333333334,17,7,10,338.56095235326967,0.7677119628339141,0.13549473843591509,0.19537141195431812,130755.83316808783,453.76388062661806,131209.59704871444,905,3,559.1428571428571,40,2,16,35.65224231584524,0.6208333333333333,44.3089430894309,1022.7642276422769,25.569105691056922,0
907,4,1,0,43,0.023255813953488372,0.0,1.0,43,650,400,250,0.6153846153846154,9,4,5,332.1801749691198,0.7787006275378368,0.13744346058411083,0.19289629856535423,130997.85175933785,102.97786359912408,131100.82962293696,906,0,547.1162790697674,41,2,17,35.571013825629066,0.6216971544715447,44.072420634920626,1023.7103174603163,24.9685443283004,0
908,4,0,0,43,0.0,0.0,1.0,43,1050,800,250,0.7619047619047619,13,8,5,333.89759640749793,0.7785622000738279,0.1341996998959094,0.19427795885671884,131074.03175390518,153.06083081379228,131227.09258471898,907,1,548.1162790697674,41,2,18,35.450171155460815,0.622459349593496,43.998015873015866,1024.0079365079357,24.975803329461847,0
909,4,0,0,43,0.0,0.0,1.0,43,1050,700,350,0.6666666666666666,14,7,7,336.924938551208,0.7789774824658545,0.13573360416699543,0.19668874168560313,131201.0476210158,240.9809815129616,131442.02860252876,908,2,549.1162790697674,41,2,18,35.244484522772034,0.623729674796748,43.87400793650793,1024.5039682539668,24.9879016647309,0
910,4,0,0,43,0.0,0.0,1.0,43,750,500,250,0.6666666666666666,10,5,5,339.5941073907352,0.7783314876338132,0.1403632778294277,0.19877318546479786,131302.70460325322,317.9249535462226,131620.62955679945,909,3,550.1162790697674,41,2,18,35.073544832704165,0.6247459349593496,43.77480158730158,1024.9007936507926,24.99758033294616,0
911,4,0,0,43,0.0,0.0,1.0,43,1200,900,300,0.75,15,9,6,337.8194118783171,0.7782853451458103,0.13322947226748227,0.1985402262821256,131458.36560785567,281.8400117010417,131740.2056195567,910,4,551.1162790697674,40,3,18,34.96205364516235,0.6278645833333334,43.62296747967479,1025.5081300813,25.637703252032498,0
912,4,0,0,43,0.0,0.0,1.0,43,850,600,250,0.7058823529411765,11,6,5,337.2928904595591,0.7787929125138427,0.12563300325774884,0.1986367815810263,131536.5409561108,273.2680200277616,131809.80897613856,911,5,552.1162790697674,40,3,18,34.8967621028994,0.6286458333333333,43.546747967479675,1025.8130081300817,25.645325203252042,0
913,4,0,0,43,0.0,0.0,1.0,43,750,400,350,0.5333333333333333,11,4,7,336.02142098296946,0.7777777777777778,0.12523034681015743,0.19815842676659212,131588.67076475633,243.32242712670376,131831.99319188303,912,6,553.1162790697674,40,3,13,34.87684891706286,0.6291666666666667,43.49593495934959,1026.016260162601,25.650406504065025,0
914,4,0,0,43,0.0,0.0,1.0,43,1250,600,650,0.48,19,6,13,331.80753120418245,0.7774086378737541,0.12675059167807357,0.1962957418736233,131709.72620819142,140.45581774374875,131850.18202593518,913,7,554.1162790697674,41,2,14,34.8630641731903,0.6288109756097562,43.37797619047618,1026.4880952380938,25.036295005807165,0
915,4,0,0,43,0.0,0.0,1.0,43,850,500,350,0.5882352941176471,12,5,7,332.83987847255,0.7767165005537098,0.12835519767778836,0.19743413077761393,131811.5800284233,174.4300555870366,131986.01008401034,914,8,555.1162790697674,41,2,15,34.7340635365343,0.6298272357723578,43.278769841269835,1026.8849206349198,25.045973674022434,0
916,4,0,0,43,0.0,0.0,1.0,43,1250,1000,250,0.8,15,10,5,328.8962026374188,0.7769010705057217,0.15916656477878033,0.19198625470688002,131197.94894118904,31.403031353353754,131229.35197254238,915,9,556.1162790697674,40,3,17,35.453245379095996,0.6252604166666667,43.8770325203252,1024.4918699186987,25.61229674796747,3
917,4,0,0,43,0.0,0.0,1.0,43,1000,800,200,0.8,12,8,4,330.8159650680369,0.7770856404577334,0.1535810908990265,0.19336912323368213,131250.0116188281,83.91985177474015,131333.93147060284,916,10,557.1162790697674,40,3,17,35.351581870475066,0.62578125,43.826219512195124,1024.6951219512198,25.617378048780495,0
918,4,0,0,43,0.0,0.0,1.0,43,850,700,150,0.8235294117647058,10,7,3,330.4911097891467,0.7772240679217423,0.15787483456229934,0.19357336430507163,131328.125,80.57879321171322,131408.70379321172,917,11,558.1162790697674,39,4,17,35.28116531165312,0.6282051282051282,43.75,1025.0,26.28205128205128,0
919,4,0,0,43,0.0,0.0,1.0,43,1450,1100,350,0.7586206896551724,18,11,7,328.97265400394514,0.7777316352897748,0.15373824160823402,0.19362783765551964,131515.04041883658,52.97037760414241,131568.0107964407,918,12,559.1162790697674,39,4,18,35.131787177143615,0.6300747863247864,43.56770833333332,1025.729166666665,26.300747863247818,0
920,4,1,0,44,0.022727272727272728,0.0,1.0,44,1150,800,350,0.6956521739130435,15,8,7,320.6120860648364,0.7822630373502467,0.1544286792982945,0.19056357859444992,131887.99622858415,-343.02288044846955,131544.97334813568,919,0,547.3863636363636,41,3,16,34.97118665894018,0.630589430894309,43.20436507936508,1027.1825396825404,25.053232675183914,0
921,4,1,0,45,0.022222222222222223,0.0,1.0,45,950,700,250,0.7368421052631579,12,7,5,314.6202300570036,0.7875420875420875,0.15813593046392316,0.18816914548505106,132123.90049426112,-686.2296060933879,131437.67088816772,920,0,536.2,42,3,17,34.888273641218966,0.6314484126984127,42.974806201550386,1028.1007751937982,24.478589885566624,0
922,4,0,0,45,0.0,0.0,1.0,45,800,500,300,0.625,11,5,6,315.98499217926957,0.7866582491582492,0.16349894269622922,0.18948388175089081,132223.54144131963,-643.8690583498596,131579.67238296976,921,1,537.2,42,3,17,34.7532347214371,0.6324404761904763,42.877906976744185,1028.4883720930231,24.487818383167216,0
923,4,0,0,45,0.0,0.0,1.0,45,1550,1200,350,0.7741935483870968,19,12,7,318.08624094885033,0.7868686868686869,0.16367308074625164,0.19137437918616665,132348.1454408539,-580.3751840334154,131767.77025682048,922,2,538.2,42,3,17,34.57423015349846,0.6336805555555556,42.75678294573643,1028.972868217054,24.49935400516795,0
924,4,1,0,46,0.021739130434782608,0.0,1.0,46,1350,1100,250,0.8148148148148148,16,11,5,315.3800402138325,0.7910426731078906,0.1587990490070892,0.1881674540815627,132032.19112507434,-822.1464929057404,131210.0446321686,923,0,527.4782608695652,40,6,16,34.96077655822539,0.63359375,43.0640243902439,1027.7439024390242,25.693597560975604,4
925,4,0,0,46,0.0,0.0,1.0,46,750,500,250,0.6666666666666666,10,5,5,316.76716279835773,0.7901972624798712,0.15905994111199462,0.18925575024839855,132084.41904826812,-831.9986656421546,131252.42038262595,924,1,528.4782608695652,40,6,16,34.872713791398915,0.6341145833333334,43.013211382113816,1027.9471544715439,25.698678861788597,0
926,4,1,0,47,0.02127659574468085,0.0,1.0,47,1500,1200,300,0.8,18,12,6,312.18324927943456,0.7969858156028369,0.16715121229911056,0.1878228852180347,132348.14544085378,-1136.6251840334285,131211.52025682037,925,0,518.2127659574468,42,5,17,34.72608061022695,0.6336805555555556,42.756782945736425,1028.972868217053,24.49935400516793,0
927,4,0,0,47,0.0,0.0,1.0,47,700,600,100,0.8571428571428571,8,6,2,311.2655509842811,0.7967160037002775,0.16452752175036633,0.18751851486126192,132398.00347222213,-1157.7937210804744,131240.20975114167,926,1,519.2127659574468,40,7,17,34.699730094466936,0.6372395833333333,42.70833333333333,1029.1666666666658,25.729166666666647,0
928,4,1,1,47,0.020833333333333332,0.020833333333333332,0.9791666666666666,48,1250,1000,250,0.8,15,10,5,303.1316995923561,0.8026558806146572,0.15643457883923917,0.18386212433218593,132653.37616528085,-1557.7113252708618,131095.66484001,927,0,509.375,41,7,16,34.65347329224447,0.6382113821138211,42.460317460317455,1030.1587301587297,25.125822686798283,0
929,4,0,0,47,0.0,0.0,1.0,47,1350,1100,250,0.8148148148148148,16,11,5,352.15882956654525,0.7970629047178538,0.17415855240578537,0.2087329875548667,131782.29302300332,107.71820844944794,131890.01123145278,928,3,521.2127659574468,39,8,18,34.267631294173334,0.6327457264957266,43.30729166666666,1026.7708333333321,26.327457264957236,6
930,4,0,0,47,0.0,0.0,1.0,47,700,400,300,0.5714285714285714,10,4,6,350.5054536328066,0.7971785383903792,0.17332009839886053,0.20819179354334158,131862.52170138876,-156.29340277779716,131706.22829861095,929,4,522.2127659574468,39,8,19,34.229208924949276,0.6335470085470087,43.22916666666666,1027.0833333333321,26.335470085470053,0
931,4,1,0,48,0.020833333333333332,0.0,1.0,48,950,700,250,0.7368421052631579,12,7,5,344.6980583399656,0.8034131205673759,0.17835516559565034,0.2059433467282191,132084.41904826812,-494.1514434199315,131590.2676048482,930,0,512.3125,40,8,20,34.15492667655298,0.6341145833333335,43.013211382113816,1027.9471544715439,25.698678861788597,0
932,4,0,0,48,0.0,0.0,1.0,48,1650,1300,350,0.7878787878787878,20,13,7,343.08288323045304,0.8038933215130023,0.17296006944444486,0.20584972993827153,132244.89795918346,-525.8078231292734,131719.0901360542,931,1,513.3125,41,7,20,34.03501157407408,0.6341463414634148,42.85714285714285,1028.5714285714268,25.08710801393724,0
933,4,0,0,48,0.0,0.0,1.0,48,900,700,200,0.7777777777777778,11,7,4,343.57766678595215,0.8021202718676123,0.1792249524510705,0.20671732709281018,132349.27847365692,-505.5487402433523,131843.72973341355,932,2,514.3125,43,5,21,33.9173415546966,0.6322674418604652,42.75568181818181,1028.9772727272718,23.9297040169133,0
934,4,1,3,46,0.02040816326530612,0.061224489795918366,0.9387755102040817,49,1400,1000,400,0.7142857142857143,18,10,8,331.74419839667524,0.808531746031746,0.17506000032214897,0.20110999969788837,132633.43578557717,-999.8895628790945,131633.54622269806,933,0,504.7959183673469,40,9,16,33.936587411207555,0.6395833333333335,42.47967479674796,1030.0813008130067,25.752032520325166,0
935,4,0,0,46,0.0,0.0,1.0,46,1150,800,350,0.6956521739130435,15,8,7,349.59671855026596,0.7878019323671498,0.1879238884702339,0.209916219690589,132273.37599903814,48.46764016581801,132321.84363920396,934,4,537.8478260869565,42,4,21,33.83885958301933,0.6329365079365081,42.82945736434107,1028.6821705426325,24.492432631967443,0
936,4,0,0,46,0.0,0.0,1.0,46,1150,800,350,0.6956521739130435,15,8,7,346.97626723291484,0.7876811594202899,0.18646370192524642,0.209184565614637,132425.49332493235,-10.064591433347118,132415.428733499,935,5,538.8478260869565,38,8,21,33.75328696975985,0.6408991228070176,42.681623931623925,1029.2735042735035,27.086144849302723,0
937,4,0,1,45,0.0,0.021739130434782608,0.9782608695652174,46,950,600,350,0.631578947368421,13,6,7,335.96987446034376,0.7882045088566828,0.14521255462852523,0.19439912046360605,130859.79327781097,-364.4921645848707,130495.3011132261,936,6,539.8478260869565,40,6,15,35.61345351609057,0.621875,44.207317073170735,1023.1707317073182,25.579268292682954,8
938,4,1,1,45,0.021739130434782608,0.021739130434782608,0.9782608695652174,46,1000,800,200,0.8,12,8,4,334.3763656630408,0.7899959742351047,0.16566701762259006,0.19452518824600487,131067.83743142331,-434.8025728732677,130633.03485855005,937,0,540.4565217391304,40,6,17,35.444166005028464,0.6239583333333333,44.00406504065042,1023.9837398374,25.599593495935,0
939,4,0,0,45,0.0,0.0,1.0,45,1500,1200,300,0.8,18,12,6,343.72097343055884,0.7839646464646465,0.17329127234489983,0.1995124634319026,130981.34901258718,4.207356770872309,130985.55636935805,938,8,553.4666666666667,39,6,18,35.29232810962995,0.6247329059829059,44.088541666666686,1023.6458333333363,26.247329059829138,0
940,4,0,0,45,0.0,0.0,1.0,45,850,500,350,0.5882352941176471,12,5,7,342.3239040300458,0.7823232323232323,0.1712672577301395,0.19914870998884238,131067.83743142348,-26.469239539919954,131041.36819188356,939,9,554.4666666666667,40,5,19,35.24071225353976,0.6239583333333332,44.004065040650424,1023.9837398374015,25.599593495935036,0
941,4,0,0,45,0.0,0.0,1.0,45,1250,900,350,0.72,16,9,7,342.15914966963487,0.7822390572390573,0.1751563088512238,0.19948013666510364,131150.2338927471,-25.149498456768583,131125.08439429034,940,10,555.4666666666667,41,4,19,35.1617231638418,0.623221544715447,43.92361111111112,1024.3055555555572,24.983062330623348,0
942,4,0,0,45,0.0,0.0,1.0,45,1900,1300,600,0.6842105263157895,25,13,12,343.58154034130536,0.7805134680134681,0.17902767097538064,0.20139232206869934,131356.983567182,26.969766078010593,131383.95333326003,941,11,556.4666666666667,36,9,21,34.9166025852283,0.6339699074074074,43.721846846846844,1025.1126126126123,28.475350350350343,0
943,4,1,1,45,0.021739130434782608,0.021739130434782608,0.9782608695652174,46,1050,1000,50,0.9523809523809523,11,10,1,336.00174810230885,0.7856280193236715,0.17514373554517304,0.19883997254954605,131721.78578985855,-348.24994228992074,131373.53584756862,942,0,545.3478260869565,37,9,16,34.743288471124416,0.6356981981981982,43.366228070175445,1026.5350877192993,27.74419155998106,0
944,4,0,0,45,0.0,0.0,1.0,45,1550,1100,450,0.7096774193548387,20,11,9,341.963437796771,0.7795875420875421,0.17695156695156666,0.20206930415263755,131665.51246537408,4.958256386591472,131670.47072176068,943,13,558.4666666666667,37,8,18,34.64699074074075,0.6351351351351351,43.42105263157895,1026.315789473685,27.738264580369865,0
945,4,0,1,44,0.0,0.022222222222222223,0.9777777777777777,45,1600,1300,300,0.8125,19,13,6,341.4099977837413,0.778956228956229,0.1797666939608622,0.20218986775769596,131749.9269606995,-3.851545667895209,131746.0754150316,944,14,559.4666666666667,37,8,19,34.57614635622485,0.6359797297297296,43.338815789473685,1026.6447368421057,27.747155049786638,0
946,4,0,0,44,0.0,0.0,1.0,44,1350,1000,350,0.7407407407407407,17,10,7,345.9191686755788,0.778343023255814,0.1774281274281273,0.20440678149011487,131665.51246537408,309.12492305325816,131974.63738842733,945,15,567.0909090909091,37,7,19,34.54549501424501,0.6351351351351351,43.42105263157895,1026.315789473685,27.738264580369865,0
947,4,0,0,44,0.0,0.0,1.0,44,1000,700,300,0.7,13,7,6,348.1244848576198,0.7771978505990135,0.18143955574540827,0.20631884026624994,131778.07113727287,375.0346260387715,132153.10576331164,946,16,568.0909090909091,37,7,19,34.375444966538524,0.6362612612612613,43.311403508771924,1026.7543859649113,27.750118539592197,0
948,4,0,0,44,0.0,0.0,1.0,44,850,700,150,0.8235294117647058,10,7,3,346.47334488107356,0.7775722339675828,0.18186428176286196,0.2057968181040593,131862.52170138882,337.36979166666276,132199.89149305547,947,17,569.0909090909091,37,7,19,34.33274171737661,0.6371058558558559,43.229166666666664,1027.0833333333328,27.759009009008995,0
949,4,0,0,44,0.0,0.0,1.0,44,750,400,350,0.5333333333333333,11,4,7,345.4372694906262,0.7777704369274137,0.17992700039714804,0.205255494986581,131876.23844875445,310.99354408649384,132187.23199284094,948,18,570.0909090909091,38,6,19,34.34552908952224,0.6354166666666666,43.215811965811966,1027.136752136752,27.029914529914524,0
950,4,0,0,44,0.0,0.0,1.0,44,1350,1000,350,0.7407407407407407,17,10,7,348.14274733091634,0.7777043692741368,0.18508181534593127,0.20731200006696077,131958.55391418267,388.0826986996593,132346.63661288234,949,19,571.0909090909091,38,6,20,34.19313888600049,0.6362390350877194,43.13568376068375,1027.4572649572629,27.038349077822705,0
951,4,0,0,44,0.0,0.0,1.0,44,1000,800,200,0.8,12,8,4,346.82249817384974,0.7774180761099366,0.18083538083538087,0.20697471665213593,132040.89506172817,358.95061728392545,132399.8456790121,950,20,572.0909090909091,38,6,21,34.144144144144136,0.637061403508772,43.05555555555554,1027.777777777776,27.04678362573095,0
952,4,0,0,44,0.0,0.0,1.0,44,950,600,350,0.631578947368421,13,6,7,348.71109712823153,0.7761627906976745,0.17751268268258835,0.2085548096746406,132123.26189139066,414.56952206148674,132537.83141345214,951,21,573.0909090909091,38,6,22,34.01269527867261,0.6378837719298247,42.97542735042734,1028.098290598289,27.055218173639183,0
953,4,0,0,44,0.0,0.0,1.0,44,950,500,450,0.5263157894736842,14,5,9,346.80482397497565,0.7767133544749825,0.17751076853321246,0.20756527524472396,132150.72320841523,366.1016600920177,132516.82486850725,952,22,574.0909090909091,38,6,22,34.034055486284274,0.6381578947368423,42.948717948717935,1028.2051282051261,27.05802968960858,0
954,4,0,0,44,0.0,0.0,1.0,44,1000,800,200,0.8,12,8,4,346.20416259065627,0.7774180761099366,0.18008736717827611,0.2073562579299978,132178.18737900854,352.12773486009013,132530.31511386862,953,23,575.0909090909091,38,6,22,34.02186147186146,0.6384320175438598,42.92200854700854,1028.3119658119647,27.06084120557802,0
955,4,0,0,44,0.0,0.0,1.0,44,1200,800,400,0.6666666666666666,16,8,8,346.02730951757064,0.7755461592670896,0.17326536391956937,0.2080051804403374,132315.5510355029,356.9588264299705,132672.50986193286,954,24,576.0909090909091,38,6,22,33.888239875389395,0.6398026315789473,42.78846153846153,1028.8461538461534,27.074898785425088,0
956,4,0,0,44,0.0,0.0,1.0,44,850,400,450,0.47058823529411764,13,4,9,347.3435042228624,0.7760086328400282,0.16976666257633943,0.20894848776829397,132343.03232750736,393.69852162318665,132736.73084913054,955,25,577.0909090909091,38,6,22,33.82674869345515,0.640076754385965,42.76175213675213,1028.9529914529905,27.07771030139449,0
957,4,0,0,44,0.0,0.0,1.0,44,800,600,200,0.75,10,6,4,346.99798390401446,0.7762508809020437,0.1716047110783956,0.20904512688851568,132398.00347222202,388.3794698297663,132786.38294205177,956,26,578.0909090909091,37,7,22,33.78036437246964,0.642454954954955,42.70833333333332,1029.166666666665,27.815315315315267,0
958,4,0,0,44,0.0,0.0,1.0,44,1000,500,500,0.5,15,5,10,350.109260223778,0.7752598661028894,0.17101134911105098,0.21123558708102988,132454.4330947982,474.70471683592984,132929.13781163414,957,27,579.0909090909091,37,7,22,33.64356980542538,0.6430180180180181,42.653508771929815,1029.3859649122792,27.821242294926464,0
959,4,0,1,43,0.0,0.022727272727272728,0.9772727272727273,44,1200,500,700,0.4166666666666667,19,5,14,351.90273066923817,0.7764270613107823,0.1706761599396458,0.21308682937509113,132590.49236613314,531.7912648841874,133122.28363101732,958,28,580.0909090909091,38,6,22,33.46062413554633,0.6425438596491229,42.52136752136751,1029.914529914528,27.10301394511916,0
960,4,1,1,43,0.022727272727272728,0.022727272727272728,0.9772727272727273,44,1150,900,250,0.782608695652174,14,9,5,350.16114450123575,0.7781668428470755,0.18187707907309836,0.21312331615163527,132783.12108490383,499.09792990721223,133282.21901481104,959,0,576.4090909090909,38,6,19,33.311953629798545,0.6444627192982457,42.3344017094017,1030.6623931623924,27.122694556905063,0
961,4,0,0,43,0.0,0.0,1.0,43,1250,1000,250,0.8,15,10,5,356.7729485948869,0.7720099667774086,0.18148198571729157,0.21639004855061075,132652.03145438977,865.3312798168602,133517.36273420663,960,30,590.8139534883721,37,6,20,33.273350186269305,0.6449887387387387,42.46162280701754,1030.1535087719294,27.84198672356566,0
962,4,0,0,43,0.0,0.0,1.0,43,1250,900,350,0.72,16,9,7,358.4067554928587,0.7717792543373938,0.180364341910209,0.21770835690797624,132708.51518015156,912.7256703985818,133621.24085055015,961,31,591.8139534883721,37,6,20,33.17448387783336,0.6455518018018018,42.406798245614034,1030.3728070175437,27.847913703176857,0
963,4,0,0,43,0.0,0.0,1.0,43,1300,900,400,0.6923076923076923,17,9,8,356.555195540683,0.7716869693613879,0.17569850295180434,0.21756576921927595,132878.03849501777,875.6709997306957,133753.70949474847,962,32,592.8139534883721,37,6,21,33.05184072459146,0.6472409909909909,42.242324561403514,1031.0307017543864,27.865694642010443,0
964,4,1,0,44,0.022727272727272728,0.0,1.0,44,550,200,350,0.36363636363636365,9,2,7,352.34356119159304,0.7764931289640592,0.19071465257905929,0.2171908817494449,133257.03125000015,590.4513888889026,133847.48263888905,963,0,580.3181818181819,39,5,22,32.780131826741986,0.6474358974358974,41.87500000000001,1032.5000000000011,26.474358974359003,0
965,4,0,0,44,0.0,0.0,1.0,44,1100,700,400,0.6363636363636364,15,7,8,351.0788226356602,0.7754800916138126,0.19241751996113154,0.2171958006286867,133391.50526258704,566.1865234375239,133957.69178602457,964,1,581.3181818181819,39,5,22,32.67799821854727,0.6487713675213674,41.74479166666668,1033.0208333333353,26.487713675213726,0
966,4,0,0,44,0.0,0.0,1.0,44,1200,900,300,0.75,15,9,6,354.4484911550465,0.7750836856941509,0.1951979472140759,0.21975806451612906,133472.2222222223,661.8055555555637,134134.02777777787,965,2,582.3181818181819,39,5,22,32.51008064516128,0.6495726495726495,41.66666666666667,1033.3333333333342,26.49572649572652,0
967,4,0,0,44,0.0,0.0,1.0,44,1200,700,500,0.5833333333333334,17,7,10,359.27380766048515,0.7726391825229035,0.19690204154373148,0.223802720619985,133646.82883897427,803.1610157454971,134449.98985471975,966,3,583.3181818181819,36,8,22,32.21043890219996,0.6568287037037036,41.49774774774776,1034.0090090090105,28.722472472472514,0
968,4,0,0,44,0.0,0.0,1.0,44,900,700,200,0.7777777777777778,11,7,4,361.7811407355921,0.7723749119097957,0.20345165505226492,0.22571997258938045,133705.05640775923,874.3935658631733,134579.4499736224,967,4,584.3181818181819,36,8,17,32.08728041521487,0.6574074074074073,41.44144144144145,1034.2342342342351,28.728728728728754,0
969,4,1,0,45,0.022222222222222223,0.0,1.0,45,1250,600,650,0.48,19,6,13,353.9752739642087,0.7801346801346801,0.16929622654669751,0.2021084628763385,130344.39718934907,233.07135397831468,130577.46854332738,968,0,572.3111111111111,38,7,18,35.67495815024064,0.6200657894736842,44.71153846153846,1021.1538461538457,26.87246963562752,8
970,4,1,1,45,0.021739130434782608,0.021739130434782608,0.9782608695652174,46,900,600,300,0.6666666666666666,12,6,6,349.3829115791061,0.7913244766505636,0.1664598805366988,0.20071107309216554,130581.79253472213,-75.39062500000608,130506.40190972213,969,0,560.8478260869565,39,7,15,35.55170539475473,0.6207264957264957,44.479166666666664,1022.0833333333326,26.207264957264936,0
971,4,2,2,45,0.0425531914893617,0.0425531914893617,0.9574468085106383,47,1050,600,450,0.5714285714285714,15,6,9,344.26172191986797,0.7930928152944804,0.16917302766718212,0.19919695495915146,130859.79327781103,-389.99644722054796,130469.79683059048,970,0,549.8723404255319,40,7,16,35.401354125281415,0.621875,44.20731707317074,1023.1707317073186,25.579268292682965,0
972,4,0,0,45,0.0,0.0,1.0,45,1100,600,500,0.5454545454545454,16,6,10,357.46036119330677,0.7818181818181819,0.17761057117311663,0.2056847983318553,130644.58832137122,340.05234586164727,130984.64066723287,971,3,575.3111111111111,38,7,16,35.281682168112305,0.6230811403508771,44.417735042735046,1022.3290598290603,26.90339631129106,0
973,4,1,1,45,0.021739130434782608,0.021739130434782608,0.9782608695652174,46,1000,600,400,0.6,14,6,8,351.67854761118537,0.7896135265700484,0.18328354906516187,0.20384906963303248,130928.03955078151,8.916558159752043,130936.95610894126,972,0,563.7826086956521,39,7,16,35.14259966072946,0.6241987179487178,44.140625000000014,1023.437500000002,26.241987179487232,0
974,4,1,0,46,0.021739130434782608,0.0,1.0,46,950,600,350,0.631578947368421,13,6,7,350.64130148791844,0.7851851851851852,0.18826055992250024,0.20381155247337396,131034.669325087,-10.76660156247982,131023.90272352452,973,0,564.7608695652174,39,7,17,35.061319394987635,0.6252670940170939,44.03645833333334,1023.8541666666682,26.25267094017098,0
975,4,0,0,46,0.0,0.0,1.0,46,950,600,350,0.631578947368421,13,6,7,361.2208075904515,0.7853260869565217,0.16010166675271864,0.199047492011324,128950.68825263555,224.77495329093415,129175.46320592648,974,1,565.7608695652174,37,9,16,36.90792669761417,0.6078265765765765,46.08004385964913,1015.6798245614044,27.450806069227145,7
976,4,1,2,45,0.02127659574468085,0.0425531914893617,0.9574468085106383,47,1000,700,300,0.7,13,7,6,355.40365642212737,0.7926302806043786,0.16170212765957448,0.19695199713783015,129174.23575726867,-218.20085926655537,128956.03489800212,975,0,554.7021276595744,38,9,16,36.82781572954983,0.6082785087719298,45.86004273504274,1016.5598290598296,26.751574448942883,0
977,4,0,0,45,0.0,0.0,1.0,45,1400,900,500,0.6428571428571429,19,9,10,368.82393910351357,0.7860690235690236,0.1743036306069905,0.203202388929419,128943.91593874284,511.52059999189055,129455.43653873472,976,3,560.9777777777778,36,9,18,36.72178179399048,0.6096643518518519,46.086711711711715,1015.6531531531534,28.212587587587596,0
978,4,0,0,45,0.0,0.0,1.0,45,900,700,200,0.7777777777777778,11,7,4,371.38434628208256,0.7867003367003368,0.18293554028424364,0.2050568893608906,129029.71172185714,583.9230277575093,129613.63474961465,977,4,561.9777777777778,36,9,18,36.56917350181039,0.6105324074074073,46.00225225225226,1015.9909909909923,28.221971971972007,0
979,4,2,1,46,0.0425531914893617,0.02127659574468085,0.9787234042553191,47,900,600,300,0.6666666666666666,12,6,6,360.8641552941588,0.8034998458217699,0.1830373921732198,0.2018230613102994,129536.03512619268,-50.90348640172647,129485.13163979095,978,0,539.0212765957447,37,10,15,36.320551486428265,0.6137387387387387,45.50438596491228,1017.9824561403509,27.51303935514462,0
980,4,3,0,49,0.061224489795918366,0.0,1.0,49,1050,700,350,0.6666666666666666,14,7,7,360.9679668070724,0.8100907029478458,0.22842281922185093,0.20610106491887673,130344.39718934907,-387.9377171810735,129956.45947216799,979,0,517.9591836734694,38,11,19,35.496442770454074,0.6200657894736842,44.71153846153846,1021.1538461538457,26.87246963562752,0
981,4,0,2,47,0.0,0.04081632653061224,0.9591836734693877,49,1050,900,150,0.8571428571428571,12,9,3,370.6654130660825,0.8107993197278912,0.22483227370121828,0.20908408251591665,129871.11418898134,-164.85751305361782,129706.25667592773,980,1,518.9591836734694,37,12,13,35.72997346528972,0.617117117117117,45.17543859649123,1019.2982456140361,27.548601232811787,4
982,4,1,1,47,0.020833333333333332,0.020833333333333332,0.9791666666666666,48,550,300,250,0.5454545454545454,8,3,5,371.1837206613482,0.8147163120567376,0.2346236559139787,0.2099761923449233,129982.90339335182,49.5075407817838,130032.4109341336,981,0,525.4583333333334,37,11,13,35.60304659498208,0.6182432432432432,45.06578947368421,1019.7368421052633,27.560455192034144,0
983,4,0,0,47,0.0,0.0,1.0,47,1050,700,350,0.6666666666666666,14,7,7,378.4949177375536,0.8075855689176688,0.2343387798283767,0.21328636398037748,129831.8483179126,428.1389497605837,130259.98726767319,982,3,537.6382978723404,36,11,13,35.570441988950265,0.6186342592592593,45.21396396396397,1019.144144144145,28.309559559559585,0
984,4,1,0,48,0.020833333333333332,0.0,1.0,48,650,500,150,0.7692307692307693,8,5,3,370.20986503994277,0.8141437647754137,0.2325743327959875,0.21017710763860084,130122.70752779703,34.54199849953832,130157.24952629657,983,0,527.4166666666666,37,11,14,35.48573795450473,0.6196509009009008,44.92872807017544,1020.2850877192984,27.57527264106212,0
985,4,2,1,49,0.04,0.02,0.98,50,1100,800,300,0.7272727272727273,14,8,6,361.4459330461528,0.8256632653061224,0.26065385464987845,0.20427787002496064,129946.64216581461,-589.5901368714754,129357.05202894314,984,0,507.28,36,14,17,35.888143362049924,0.6197916666666665,45.10135135135136,1019.5945945945958,28.322072072072107,4
986,4,0,0,49,0.0,0.0,1.0,49,850,500,350,0.5882352941176471,12,5,7,368.142644441713,0.8216765873015873,0.2692978655873748,0.2080159432255963,129937.8714018561,-232.8656817986996,129705.0057200574,985,1,518.6122448979592,35,14,17,35.72636413516479,0.6217261904761904,45.1099537037037,1019.5601851851849,29.130291005290996,0
987,4,0,0,49,0.0,0.0,1.0,49,1600,1200,400,0.75,20,12,8,366.3443137539076,0.8211451247165533,0.2758250305566874,0.20809867719422973,130144.46159122066,-264.4633058985108,129879.99828532216,986,2,519.6122448979592,35,14,19,35.562235329703576,0.6238095238095238,44.9074074074074,1020.3703703703688,29.15343915343911,0
988,4,0,0,49,0.0,0.0,1.0,49,1250,800,450,0.64,17,8,9,370.82142136385744,0.8207553854875284,0.2784820083798176,0.21144251828381275,130292.12648158851,-136.97769311558477,130155.14878847293,987,3,520.6122448979592,35,14,20,35.29798681177493,0.6252976190476192,44.762731481481474,1020.9490740740729,29.169973544973512,0
989,4,0,0,49,0.0,0.0,1.0,49,1550,1100,450,0.7096774193548387,20,11,9,372.0559874778231,0.8206136621315193,0.27547551991564845,0.21295500294936873,130439.8750964505,-93.81269290124561,130346.06240354925,988,4,521.6122448979592,35,14,22,35.11641740312712,0.6267857142857143,44.61805555555555,1021.5277777777768,29.18650793650791,0
990,4,0,0,49,0.0,0.0,1.0,49,1450,1100,350,0.7586206896551724,18,11,7,368.68187187455544,0.8196215986394558,0.27603485335244016,0.2116684609006711,130558.13426997587,-173.11653377916014,130385.0177361967,989,5,522.6122448979592,35,14,18,35.08257833144583,0.6279761904761905,44.50231481481481,1021.9907407407397,29.19973544973542,0
991,4,0,0,49,0.0,0.0,1.0,49,1350,1100,250,0.8148148148148148,16,11,5,366.73536611006625,0.8196570294784581,0.27164048724460943,0.2107117773661674,130587.70743580667,-221.77386081105078,130365.93357499562,990,6,523.6122448979592,35,14,18,35.102314762390066,0.6282738095238096,44.473379629629626,1022.1064814814808,29.20304232804231,0
992,4,0,0,49,0.0,0.0,1.0,49,750,600,150,0.8,9,6,3,366.1584133051706,0.8194090136054422,0.26827701875407195,0.2108633261497963,130676.44702717755,-230.3439000343048,130446.10312714324,991,7,524.6122448979592,35,14,18,35.0270734284205,0.6291666666666667,44.38657407407407,1022.453703703703,29.212962962962944,0
993,4,0,2,47,0.0,0.04081632653061224,0.9591836734693877,49,1050,800,250,0.7619047619047619,13,8,5,335.78446551409615,0.8190192743764173,0.151773100165022,0.19434797852482555,130870.93431122463,-999.8486862594724,129871.08562496516,992,8,525.6122448979592,41,8,13,35.606942020554584,0.6204268292682926,44.19642857142858,1023.2142857142868,24.956445993031384,7
994,4,0,0,47,0.0,0.0,1.0,47,1200,600,600,0.5,18,6,12,350.0289379374858,0.8114785692260252,0.16185557402595108,0.20177534255621263,130714.91021050356,-249.19976128471706,130465.71044921884,993,9,548.1914893617021,39,8,14,35.40043207361379,0.6220619658119659,44.348958333333336,1022.6041666666673,26.220619658119674,0
995,4,0,0,47,0.0,0.0,1.0,47,1400,1000,400,0.7142857142857143,18,10,8,348.8024527487256,0.8107462226333642,0.1530216578501582,0.20176311489387425,130848.09570312501,-271.97265624999955,130576.12304687501,994,10,549.1914893617021,39,8,14,35.29703726328649,0.6233974358974359,44.21875,1023.1250000000001,26.23397435897436,0
996,4,0,0,47,0.0,0.0,1.0,47,900,800,100,0.8888888888888888,10,8,2,350.65440957912364,0.8103607770582794,0.15395911895876102,0.20297455894494604,130874.74093967023,-221.6389973958281,130653.1019422744,995,11,550.1914893617021,39,8,14,35.22271285079235,0.62366452991453,44.192708333333336,1023.2291666666674,26.23664529914532,0
997,4,0,0,47,0.0,0.0,1.0,47,750,400,350,0.5333333333333333,11,4,7,349.03479197312765,0.809204440333025,0.1512195018915108,0.20264135213517692,130989.80150910518,-256.0003759336264,130733.80113317155,996,12,551.1914893617021,40,7,14,35.14779608855356,0.6231770833333332,44.080284552845534,1023.6788617886191,25.591971544715477,0
998,4,0,0,47,0.0,0.0,1.0,47,1550,1100,450,0.7096774193548387,20,11,9,347.1352357217589,0.8085877274128892,0.15002354212985547,0.20208444658394947,131093.85456945281,-298.5407784717971,130795.31379098102,997,13,552.1914893617021,40,7,15,35.09125566471504,0.6242187499999999,43.97865853658537,1024.0853658536594,25.602134146341484,0
999,4,0,0,47,0.0,0.0,1.0,47,1450,1200,250,0.8275862068965517,17,12,5,345.1063349472192,0.8095898859081098,0.14398267649063912,0.20144857918951473,131197.94894118918,-344.5513376627542,130853.39760352643,998,14,553.1914893617021,40,7,15,35.03806666005357,0.6252604166666667,43.87703252032521,1024.4918699186999,25.6122967479675,0
1000,4,1,0,48,0.020833333333333332,0.0,1.0,48,1350,900,450,0.6666666666666666,18,9,9,341.4961847374981,0.8143469267139479,0.1597447874356892,0.20113961885734943,131541.7534722223,-615.6695130213382,130926.08395920097,999,0,542.6458333333334,39,9,16,34.78371242891958,0.6303418803418803,43.54166666666667,1025.8333333333342,26.303418803418825,0
1001,4,0,0,48,0.0,0.0,1.0,48,1250,600,650,0.48,19,6,13,339.30535700124165,0.8145500886524822,0.16231731452349463,0.2005504308658211,131675.3594292536,-664.3690321180493,131010.99039713557,1000,1,543.6458333333334,39,9,14,34.705271660069684,0.6316773504273505,43.411458333333336,1026.3541666666677,26.31677350427353,0
1002,4,0,0,48,0.0,0.0,1.0,48,800,400,400,0.5,12,4,8,342.3717110811264,0.8131094858156028,0.1710971320346315,0.20278939810189808,131755.55555555565,-578.1249999999947,131177.43055555565,1001,2,544.6458333333334,39,9,14,34.54579274891774,0.6324786324786325,43.333333333333336,1026.6666666666674,26.324786324786345,0
1003,4,0,0,48,0.0,0.0,1.0,48,1550,1100,450,0.7096774193548387,20,11,9,340.5556750059391,0.811114804964539,0.1735795079804774,0.2024903978211783,131901.66650142104,-616.0277860400615,131285.63871538098,1002,3,545.6458333333334,40,8,14,34.4452826144308,0.6322916666666667,43.1910569105691,1027.2357723577231,25.680894308943078,0
1004,4,1,0,49,0.02040816326530612,0.0,1.0,49,1050,700,350,0.6666666666666666,14,7,7,333.56508273319605,0.8173540249433107,0.17991780045351424,0.20013904963991758,132244.89795918367,-977.543934240367,131267.3540249433,1003,0,535.4897959183673,41,8,16,34.27975501543208,0.6341463414634146,42.857142857142854,1028.5714285714284,25.08710801393728,0
1005,4,0,0,49,0.0,0.0,1.0,49,850,500,350,0.5882352941176471,12,5,7,335.07326550607377,0.8158659297052154,0.1874575690849083,0.20145187458339084,132321.43964356583,-932.5246244331056,131388.91501913272,1004,1,536.4897959183673,41,8,16,34.1640753061421,0.634908536585366,42.782738095238095,1028.8690476190482,25.094367015098737,0
1006,4,0,0,49,0.0,0.0,1.0,49,1050,800,250,0.7619047619047619,13,8,5,334.7262225514855,0.8159013605442177,0.18702793948968788,0.201515676525047,132372.47973552853,-938.2919776706879,131434.18775785784,1005,2,537.4897959183673,41,8,16,34.12173832706707,0.6354166666666665,42.733134920634924,1029.067460317461,25.099206349206366,0
1007,4,0,0,49,0.0,0.0,1.0,49,1150,700,450,0.6086956521739131,16,7,9,338.55942203539195,0.8163265306122449,0.19299796000958058,0.20454286842284936,132505.2300347223,-827.816259605682,131677.4137751166,1006,3,538.4897959183673,39,10,17,33.889788209901525,0.6399572649572649,42.60416666666667,1029.5833333333342,26.399572649572672,0
1008,4,0,0,49,0.0,0.0,1.0,49,1300,1000,300,0.7692307692307693,16,10,6,340.4988967627097,0.8161493764172336,0.19129634254834738,0.20615508832167248,132585.6784396702,-770.9445529513778,131814.73388671884,1007,4,539.4897959183673,39,10,18,33.75908179090388,0.6407585470085471,42.52604166666667,1029.895833333334,26.407585470085486,0
1009,4,0,0,49,0.0,0.0,1.0,49,800,500,300,0.625,11,5,6,339.36575337849195,0.8148738662131519,0.18831384540470708,0.20605688561489663,132692.98095703142,-793.7093098958177,131899.2716471356,1008,5,540.4897959183673,39,10,16,33.680555555555564,0.641826923076923,42.42187500000001,1030.3125000000014,26.418269230769265,0
1010,4,0,1,48,0.0,0.02040816326530612,0.9795918367346939,49,1550,1300,250,0.8387096774193549,18,13,5,336.84287739205257,0.8146612811791384,0.18217665615141931,0.20534460025630932,132842.88452640647,-850.5641070129956,131992.32041939348,1009,6,541.4897959183673,40,9,16,33.59518763144059,0.6416666666666666,42.276422764227654,1030.8943089430913,25.772357723577283,0
1011,4,0,0,48,0.0,0.0,1.0,48,800,600,200,0.75,10,6,4,343.4631895006507,0.8096187943262411,0.18486245316505645,0.20908785521702278,132790.50684942826,-478.26979641747414,132312.2370530108,1010,7,553.25,40,8,16,33.477124827450226,0.6411458333333333,42.327235772357724,1030.6910569105692,25.76727642276423,0
1012,4,1,1,48,0.02040816326530612,0.02040816326530612,0.9795918367346939,49,1350,1100,250,0.8148148148148148,16,11,5,333.4026894476403,0.8159722222222222,0.1839972216172303,0.20458533173716276,133088.07442247745,-925.6156108276516,132162.4588116498,1011,0,542.9387755102041,41,8,17,33.43819103932313,0.6425304878048781,42.03869047619048,1031.8452380952392,25.166957026713153,0
1013,4,0,1,47,0.0,0.020833333333333332,0.9791666666666666,48,950,600,350,0.631578947368421,13,6,7,340.082538624587,0.8103760342789598,0.18306196012743414,0.20804687670288954,132973.8739031828,-555.581478451965,132418.29242473084,1012,9,555.25,40,8,17,33.3803412487273,0.6429687499999999,42.149390243902445,1031.4024390243915,25.785060975609788,0
1014,4,0,1,46,0.0,0.02127659574468085,0.9787234042553191,47,950,700,250,0.7368421052631579,12,7,5,325.6286372911859,0.8034613012642614,0.14372022942595275,0.19976480691343912,133078.71187991634,-733.1520796152797,132345.55980030107,1013,14,567.8723404255319,40,7,17,33.648100725565506,0.6440104166666666,42.04776422764229,1031.8089430894331,25.795223577235827,3
1015,4,0,0,46,0.0,0.0,1.0,46,1550,1300,250,0.8387096774193549,18,13,5,325.503689896104,0.8021739130434783,0.13842478012520187,0.19982856512726982,133104.9278290041,-534.7709696608988,132570.1568593432,1014,15,580.1304347826087,40,6,17,33.625090276409956,0.6442708333333333,42.022357723577244,1031.9105691056925,25.79776422764231,0
1016,4,0,0,46,0.0,0.0,1.0,46,1100,600,500,0.5454545454545454,16,6,10,327.2036805672573,0.8012077294685991,0.1331313079431924,0.20143848407286113,133209.81744497357,-482.6514888624178,132727.16595611116,1015,16,581.1304347826087,40,6,18,33.47628306097001,0.6453124999999998,41.92073170731709,1032.3170731707344,25.80792682926836,0
1017,4,1,0,47,0.02127659574468085,0.0,1.0,47,800,500,300,0.625,11,5,6,321.97888135398046,0.8084720937403638,0.14956661963313844,0.19991705011227762,133526.04709201405,-800.9701527798238,132725.07693923422,1016,0,569.7446808510638,39,8,20,33.2951185916818,0.6501068376068375,41.61458333333334,1033.541666666668,26.501068376068414,0
1018,4,0,1,46,0.0,0.02127659574468085,0.9787234042553191,47,1700,1400,300,0.8235294117647058,20,14,6,323.54481565061246,0.8068532223250077,0.15192907383123022,0.20131017795802364,133603.5214344143,-754.6546574459355,132848.86677696835,1017,1,570.7446808510638,40,7,20,33.177283004030286,0.6492187499999998,41.53963414634148,1033.841463414636,25.8460365853659,0
1019,4,0,0,46,0.0,0.0,1.0,46,1100,800,300,0.7272727272727273,14,8,6,329.6185614353611,0.80006038647343,0.15477722253807658,0.2047984354526,133550.99400365213,-395.82269565071454,133155.17130800142,1018,2,583.304347826087,40,6,20,33.07278864746173,0.6486979166666667,41.590447154471555,1033.6382113821155,25.840955284552887,0
1020,4,0,0,46,0.0,0.0,1.0,46,1300,900,400,0.6923076923076923,17,9,8,332.0932595322998,0.7990942028985507,0.16207164643262928,0.2073647359214572,133734.885195651,-317.50921243965314,133417.37598321136,1019,3,584.304347826087,40,6,18,32.82508842601691,0.6505208333333332,41.412601626016276,1034.3495934959371,25.858739837398428,0
1021,4,0,0,46,0.0,0.0,1.0,46,1150,700,450,0.6086956521739131,16,7,9,331.08399302552067,0.7977455716586151,0.1590665476612445,0.20717677523004502,133813.73443593454,-339.2828962588129,133474.45153967573,1020,4,585.304347826087,40,6,18,32.77244376780277,0.6513020833333332,41.33638211382115,1034.6544715447176,25.86636178861794,0
1022,4,0,0,46,0.0,0.0,1.0,46,1450,1200,250,0.8275862068965517,17,12,5,334.1029827729269,0.7969605475040258,0.16094554332886535,0.2098133774676348,133945.20147564294,-249.70173177339842,133695.49974386956,1021,5,586.304347826087,40,6,18,32.56307677204006,0.6526041666666667,41.20934959349594,1035.1626016260175,25.87906504065044,0
1023,4,0,0,46,0.0,0.0,1.0,46,1650,1200,450,0.7272727272727273,21,12,9,331.3828270689298,0.7960547504025766,0.15719818136840935,0.20930090081416805,134155.6830011898,-308.62209994050875,133847.0609012493,1022,6,587.304347826087,40,6,18,32.42348440258976,0.6546875,41.00609756097561,1035.9756097560978,25.899390243902445,0
1024,4,1,1,46,0.02127659574468085,0.02127659574468085,0.9787234042553191,47,900,600,300,0.6666666666666666,12,6,6,324.91434688066533,0.7982963305581251,0.16120619629191557,0.20642430633737577,134370.72000385798,-668.2050540123536,133702.51494984562,1023,0,575.7872340425532,41,6,18,32.37678611297165,0.6552337398373984,40.79861111111111,1036.805555555555,25.28794037940378,0
1025,4,0,0,46,0.0,0.0,1.0,46,800,500,300,0.625,11,5,6,329.17051134179167,0.7951086956521739,0.16238704177323093,0.20880219003024103,134313.65258774534,-357.5812595016228,133956.0713282437,1024,8,589.304347826087,40,6,18,32.323325163398685,0.65625,40.853658536585364,1036.5853658536582,25.914634146341456,0
1026,4,0,0,46,0.0,0.0,1.0,46,950,600,350,0.631578947368421,13,6,7,332.5956831096438,0.794585346215781,0.16130076866701915,0.2115839370605239,134419.017284685,-258.5630246546406,134160.45426003035,1025,9,590.304347826087,40,6,18,32.12955703645629,0.6572916666666667,40.7520325203252,1036.9918699186987,25.92479674796747,0
1027,4,0,0,46,0.0,0.0,1.0,46,1250,1000,250,0.8,15,10,5,333.34604144671323,0.7935789049919485,0.15747439295179433,0.21299057595595253,134578.49368105773,-227.62927542182217,134350.86440563592,1026,10,591.304347826087,38,8,18,31.951237300933563,0.6622807017543859,40.598290598290596,1037.6068376068372,27.305443094916768,0
1028,4,0,0,46,0.0,0.0,1.0,46,1150,600,550,0.5217391304347826,17,6,11,330.8240456490418,0.7922302737520129,0.16173878135199815,0.2118464518539235,134658.87586805542,-290.3211805555659,134368.55468749985,1027,11,592.304347826087,39,7,18,31.936638565502474,0.6613247863247864,40.52083333333333,1037.9166666666656,26.613247863247835,0
1029,4,0,0,46,0.0,0.0,1.0,46,1550,1300,250,0.8387096774193549,18,13,5,327.2515423883948,0.7913647342995169,0.162720156555773,0.2106115090182237,134840.88918633075,-374.62220735014097,134466.26697898062,1028,12,593.304347826087,40,6,16,31.848295825179385,0.6614583333333335,40.345528455284544,1038.6178861788605,25.965447154471512,0
1030,4,0,0,46,0.0,0.0,1.0,46,1100,600,500,0.5454545454545454,16,6,10,326.9105857123467,0.7915861513687601,0.16375705601851265,0.2105452486809006,134867.27812685887,-382.09182282373075,134485.18630403513,1029,13,594.304347826087,40,6,16,31.830911848155747,0.6617187500000001,40.320121951219505,1038.7195121951208,25.96798780487802,0
1031,4,0,0,46,0.0,0.0,1.0,46,850,500,350,0.5882352941176471,12,5,7,325.909505740757,0.7915257648953301,0.16578106136607063,0.21097483700737124,135052.07300548628,-397.0491275034593,134655.0238779828,1030,14,595.304347826087,40,6,16,31.67326619736672,0.6635416666666667,40.14227642276423,1039.430894308944,25.9857723577236,0
1032,4,0,0,46,0.0,0.0,1.0,46,550,200,350,0.36363636363636365,9,2,7,326.6837085432194,0.789512882447665,0.1658425390872924,0.2120106470118566,135143.25992260335,-370.17973277273524,134773.08018983062,1031,15,596.304347826087,41,5,16,31.562569570333608,0.6628556910569106,40.054563492063494,1039.7817460317465,25.360530391018205,0
1033,4,0,0,46,0.0,0.0,1.0,46,1250,900,350,0.72,16,9,7,324.9067995194529,0.7882246376811595,0.16946654450022947,0.21176492271973285,135298.03363764478,-408.14978190351707,134889.88385574127,1032,16,597.304347826087,41,5,16,31.45511506309397,0.664380081300813,39.90575396825396,1040.3769841269834,25.37504839334106,0
1034,4,0,0,46,0.0,0.0,1.0,46,1000,700,300,0.7,13,7,6,323.8352821662155,0.7875805152979066,0.1663267336583425,0.2112179377710987,135323.83786848068,-435.4733560090735,134888.3645124716,1033,17,598.304347826087,41,5,16,31.457379862700225,0.6646341463414633,39.88095238095238,1040.4761904761901,25.377468060394882,0
1035,4,0,0,46,0.0,0.0,1.0,46,1250,900,350,0.72,16,9,7,324.2824371461643,0.7874194847020934,0.16995972086392985,0.2121179133751591,135427.07939657327,-416.6753275384378,135010.40406903485,1034,18,599.304347826087,41,5,16,31.343325073071544,0.6656504065040652,39.781746031746025,1040.8730158730145,25.387146728610112,0
1036,4,0,0,46,0.0,0.0,1.0,46,1050,700,350,0.6666666666666666,14,7,7,323.1740153493091,0.7860708534621579,0.16524431924104643,0.2118495497246092,135504.53637762953,-441.6909761590058,135062.84540147052,1035,19,600.304347826087,41,5,16,31.295358901063995,0.6664126016260163,39.70734126984126,1041.1706349206331,25.394405729771538,0
1037,4,0,0,46,0.0,0.0,1.0,46,750,300,450,0.4,12,3,9,323.9634262529745,0.7859702093397746,0.16645678685047716,0.2125200076219511,135530.36029226496,-418.6240236835595,135111.7362685814,1036,20,601.304347826087,41,5,16,31.24920604674795,0.6666666666666667,39.68253968253968,1041.2698412698405,25.396825396825378,0
1038,4,0,0,46,0.0,0.0,1.0,46,1200,800,400,0.6666666666666666,16,8,8,325.32282497960756,0.7855877616747182,0.1612223938511741,0.2138737845623607,135607.84679902048,-376.734437988165,135231.1123610323,1037,21,602.304347826087,41,5,16,31.13699320570212,0.6674288617886179,39.60813492063492,1041.56746031746,25.40408439798683,0
1039,4,0,0,46,0.0,0.0,1.0,46,850,600,250,0.7058823529411765,11,6,5,336.8053205785357,0.7855877616747182,0.1699863364716534,0.2167188015449716,134833.97822381262,-117.43728741497046,134716.54093639765,1038,22,603.304347826087,41,5,15,31.60710589995861,0.6598069105691057,40.35218253968254,1038.5912698412694,25.331494386372427,1
1040,4,0,0,46,0.0,0.0,1.0,46,850,500,350,0.5882352941176471,12,5,7,339.7704503646114,0.7837962962962963,0.17903802323988383,0.21924928691734918,134937.03275581077,-30.476721938762978,134906.556033872,1039,23,604.304347826087,41,5,15,31.427539864413262,0.6608231707317073,40.2529761904762,1038.988095238096,25.34117305458771,0
1041,4,0,0,46,0.0,0.0,1.0,46,1550,1200,350,0.7741935483870968,19,12,7,340.0003228025264,0.7831924315619968,0.1875108923873623,0.22018067875926273,135065.90628149404,-15.509652935251324,135050.39662855878,1040,24,605.304347826087,41,5,15,31.29334478590061,0.6620934959349594,40.12896825396825,1039.4841269841268,25.35327138985675,0
1042,4,0,0,46,0.0,0.0,1.0,46,1250,1000,250,0.8,15,10,5,339.0266379114917,0.7829307568438003,0.19020219619919754,0.21993686969711665,135129.4665660118,-37.50225347033245,135091.96431254147,1041,25,606.304347826087,42,4,15,31.255436470953722,0.6612103174603174,40.06782945736435,1039.7286821705436,24.755444813584372,0
1043,4,0,0,46,0.0,0.0,1.0,46,1250,800,450,0.64,17,8,9,336.71165646962396,0.7837359098228663,0.18191963833605396,0.21889316831547406,135205.03880663737,-94.97748407545942,135110.0613225619,1042,26,607.304347826087,42,4,15,31.240488835057004,0.661954365079365,39.9951550387597,1040.0193798449625,24.76236618678482,0
1044,4,1,0,47,0.02127659574468085,0.0,1.0,47,900,400,500,0.4444444444444444,14,4,10,333.82421328309147,0.7891998149861239,0.1853649119752292,0.21844306203309188,135440.84790809345,-357.3131001371589,135083.53480795628,1043,0,595.3617021276596,44,3,16,31.081361560813622,0.6614583333333333,39.768518518518526,1040.9259259259272,23.657407407407437,0
1045,4,0,1,46,0.0,0.02127659574468085,0.9787234042553191,47,1550,1200,350,0.7741935483870968,19,12,7,334.92727179025616,0.7885831020659883,0.19142858300546628,0.2206653832083605,135685.35545005024,-310.64329281096775,135374.71215723926,1044,1,596.3617021276596,41,6,17,30.81000444359804,0.6681910569105691,39.53373015873015,1041.8650793650781,25.411343399148247,0
1046,4,0,0,46,0.0,0.0,1.0,46,1400,900,500,0.6428571428571429,19,9,10,340.98497348164136,0.7875402576489533,0.20043503701630772,0.22499742072591683,135739.56164485414,57.03016557603627,135796.59181043017,1045,2,605.4130434782609,40,6,18,30.598425004876134,0.6703125000000001,39.481707317073166,1042.0731707317066,26.051829268292664,0
1047,4,0,0,46,0.0,0.0,1.0,46,1450,1300,150,0.896551724137931,16,13,3,341.03961075470085,0.7866344605475041,0.2050625023843735,0.22553470583565235,135818.9995724272,63.93174945469062,135882.9313218819,1046,3,606.4130434782609,40,6,18,30.518182704494482,0.67109375,39.40548780487805,1042.3780487804881,26.059451219512205,0
1048,4,0,0,46,0.0,0.0,1.0,46,950,600,350,0.631578947368421,13,6,7,341.34168538087715,0.7868961352657005,0.20534367319264346,0.2262380937989534,135898.4607376561,77.56192577169566,135976.0226634278,1047,4,607.4130434782609,40,6,14,30.431489603638724,0.671875,39.329268292682926,1042.682926829268,26.067073170731696,0
1049,4,0,0,46,0.0,0.0,1.0,46,1350,1100,250,0.8148148148148148,16,11,5,341.57740855069414,0.7862721417069244,0.20393099056330688,0.22701295028457624,135995.6114969135,90.6057098765362,136086.21720679005,1048,5,608.4130434782609,41,5,15,30.329005770084336,0.671239837398374,39.23611111111111,1043.055555555555,25.440379403794022,0
1050,4,0,0,46,0.0,0.0,1.0,46,750,300,450,0.4,12,3,9,345.62956039122514,0.7846618357487923,0.2102799489123195,0.23054390271117944,136124.98941995786,209.76405029605073,136334.7534702539,1049,6,609.4130434782609,41,5,16,30.095046265487856,0.672510162601626,39.11210317460318,1043.551587301588,25.45247773906312,0
1051,4,0,1,45,0.0,0.021739130434782608,0.9782608695652174,46,1600,1000,600,0.625,22,10,12,347.6425825821918,0.7836553945249598,0.2077540294758069,0.23256471052208533,136228.53604694185,271.76801855000735,136500.30406549186,1050,7,610.4130434782609,41,5,17,29.93987376857043,0.6735264227642277,39.01289682539682,1043.948412698412,25.462156407278343,0
1052,4,1,2,44,0.021739130434782608,0.043478260869565216,0.9565217391304348,46,900,600,300,0.6666666666666666,12,6,6,348.78621548211856,0.7812600644122384,0.21478954671600348,0.2341850303951369,136358.0246913581,311.95987654321925,136669.98456790132,1051,0,608.7826086956521,41,5,18,29.781693262411356,0.6747967479674797,38.88888888888889,1044.444444444445,25.47425474254744,0
1053,4,0,0,44,0.0,0.0,1.0,44,1600,1200,400,0.75,20,12,8,363.14508915570264,0.7701286116983792,0.2297153250900381,0.2427669738778718,136203.9401584202,1092.3583984375057,137296.2985568577,1052,36,637.2727272727273,39,5,18,29.55969547284037,0.6765491452991453,39.036458333333336,1043.8541666666672,26.765491452991466,0
1054,4,0,0,44,0.0,0.0,1.0,44,1350,900,450,0.6666666666666666,18,9,9,361.37702960160533,0.7693137773079634,0.2277691143004792,0.24270110353752833,136367.09120008687,1055.9868706597258,137423.0780707466,1053,37,638.2727272727273,39,5,18,29.44393886506432,0.6781517094017094,38.880208333333336,1044.4791666666672,26.781517094017108,0
1055,4,0,0,44,0.0,0.0,1.0,44,1150,600,550,0.5217391304347826,17,6,11,358.2353978909023,0.7686090556730092,0.22991680336411613,0.2413337324542407,136475.91281467027,978.1005859375099,137454.01340060777,1054,38,639.2727272727273,39,5,18,29.418074801448835,0.6792200854700854,38.77604166666667,1044.8958333333344,26.792200854700884,0
1056,4,1,1,44,0.022222222222222223,0.022222222222222223,0.9777777777777777,45,1450,1200,250,0.8275862068965517,17,12,5,357.7291209454284,0.7726851851851853,0.23213090689290383,0.24322744854770395,136800.644664221,787.5148720999326,137588.15953632095,1055,0,626.0444444444445,40,5,18,29.109594585842874,0.6807291666666668,38.46544715447154,1046.1382113821135,26.153455284552837,0
1057,4,0,0,44,0.0,0.0,1.0,44,1200,900,300,0.75,15,9,6,361.10537927969415,0.7659223044397463,0.22989858746830882,0.2449660816194681,136720.92013888882,1074.1319444444391,137795.05208333326,1056,40,641.2727272727273,39,5,18,29.10026560424966,0.6816239316239316,38.541666666666664,1045.8333333333328,26.8162393162393,0
1058,4,0,0,44,0.0,0.0,1.0,44,1500,1300,200,0.8666666666666667,17,13,4,359.05351013448865,0.7660984848484849,0.22831791938899304,0.24471177495326113,136884.38042534702,1029.763454861092,137914.1438802081,1057,41,642.2727272727273,39,5,18,28.99205322184617,0.6832264957264957,38.38541666666666,1046.4583333333317,26.832264957264915,0
1059,4,0,0,44,0.0,0.0,1.0,44,1350,900,450,0.6666666666666666,18,9,9,358.5534671531527,0.7658121916842847,0.22662363509711536,0.24494247392399937,136966.1471896701,1021.9373914930507,137988.08458116316,1058,42,643.2727272727273,39,5,17,28.92420887650512,0.6840277777777779,38.307291666666664,1046.770833333333,26.84027777777777,0
1060,4,0,0,44,0.0,0.0,1.0,44,1250,1000,250,0.8,15,10,5,358.71976625605095,0.7642485905567301,0.22970956833101286,0.2460142244159845,137102.47938368045,1036.2738715277687,138138.75325520823,1059,43,644.2727272727273,39,5,17,28.784977786618917,0.6853632478632479,38.17708333333333,1047.2916666666658,26.853632478632456,0
1061,4,0,0,44,0.0,0.0,1.0,44,700,600,100,0.8571428571428571,8,6,2,359.55155644452833,0.7643587033121917,0.23282175308530428,0.2467775358395718,137129.75396050327,1061.0432942708148,138190.79725477408,1060,44,645.2727272727273,39,5,17,28.736221614453832,0.685630341880342,38.15104166666666,1047.3958333333317,26.856303418803375,0
1062,4,0,0,44,0.0,0.0,1.0,44,1100,700,400,0.6363636363636364,15,7,8,362.4553330296912,0.7635879140239605,0.24012899201822324,0.2491601698072185,137184.3112521702,1144.6370442708387,138328.94829644106,1061,45,646.2727272727273,39,5,17,28.606215405521866,0.68616452991453,38.098958333333336,1047.6041666666672,26.861645299145312,0
1063,4,0,0,44,0.0,0.0,1.0,44,900,700,200,0.7777777777777778,11,7,4,361.05434984526266,0.7626189217758985,0.23969817458883091,0.24878128489337947,137266.16753472213,1112.10937499999,138378.27690972213,1062,46,647.2727272727273,39,5,17,28.561961563949634,0.686965811965812,38.02083333333333,1047.9166666666658,26.869658119658098,0
1064,4,0,0,44,0.0,0.0,1.0,44,1050,900,150,0.8571428571428571,12,9,3,363.94858980842395,0.7614517265680056,0.24677843002450395,0.2512560746508754,137332.73535098133,1196.4110731046117,138529.14642408595,1063,47,648.2727272727273,40,4,17,28.420310581087183,0.6859375000000001,37.95731707317072,1048.1707317073153,26.204268292682883,0
1065,4,0,0,44,0.0,0.0,1.0,44,1100,700,400,0.6363636363636364,15,7,8,365.7128660747826,0.7600422832980973,0.2547881665770999,0.2534446652132761,137465.91939528385,1254.611073930857,138720.53046921472,1064,48,649.2727272727273,40,4,17,28.24240074942663,0.6872395833333333,37.83028455284553,1048.6788617886175,26.216971544715438,0
1066,4,0,0,44,0.0,0.0,1.0,44,1400,1000,400,0.7142857142857143,18,10,8,351.39567178626726,0.7594476744186047,0.21744278154177987,0.23752233754575536,136594.27393185522,800.1636816317412,137394.43761348695,1065,49,650.2727272727273,42,2,17,29.479514275120504,0.675595238095238,38.662790697674424,1045.3488372093036,24.889258028792945,2
1067,4,0,0,44,0.0,0.0,1.0,44,950,500,450,0.5263157894736842,14,5,9,354.76927650068797,0.7585887949260043,0.2182521629977836,0.24032110877080565,136670.25461398088,897.2814697133894,137567.5360836943,1066,50,651.2727272727273,42,2,17,29.3160967472894,0.6763392857142856,38.59011627906978,1045.6395348837236,24.896179401993418,0
1068,4,0,0,44,0.0,0.0,1.0,44,750,600,150,0.8,9,6,3,356.0108290053311,0.7576638477801269,0.21790751570675848,0.24188503009956291,136775.39605034742,938.7325954626577,137714.1286458101,1067,51,652.2727272727273,39,5,17,29.17952931023036,0.6821581196581196,38.48958333333334,1046.0416666666683,26.82158119658124,0
1069,4,0,0,44,0.0,0.0,1.0,44,1100,800,300,0.7272727272727273,14,8,6,355.8827482372643,0.7573995771670191,0.21221924601379105,0.24255075229250764,136884.38042534742,942.9578993055801,137827.338324653,1068,52,653.2727272727273,39,5,17,29.075004977105323,0.6832264957264955,38.38541666666668,1046.4583333333348,26.832264957264996,0
1070,4,0,0,44,0.0,0.0,1.0,44,600,300,300,0.5,9,3,6,357.73251207529995,0.7568049682875264,0.2145529647022626,0.24400125925461952,136911.63330078154,995.5485026041961,137907.18180338573,1069,53,654.2727272727273,39,5,17,28.99963919577985,0.6834935897435896,38.359375000000014,1046.5625000000023,26.834935897435955,0
1071,4,0,0,44,0.0,0.0,1.0,44,1100,600,500,0.5454545454545454,16,6,10,355.38270128467235,0.7556597956307259,0.20822010869565166,0.24347495705035024,137066.56090951167,942.216934364481,138008.77784387616,1070,54,655.2727272727273,40,4,17,28.907867494824018,0.6833333333333332,38.211382113821145,1047.1544715447167,26.178861788617915,0
1072,4,0,0,44,0.0,0.0,1.0,44,1050,600,450,0.5714285714285714,15,6,9,356.19312467719857,0.7544045102184638,0.20372542103870872,0.24515027472776513,137226.23459085223,975.8082573203999,138202.04284817263,1071,55,656.2727272727273,40,4,17,28.728782735208537,0.6848958333333333,38.058943089430905,1047.764227642278,26.19410569105695,0
1073,4,0,0,44,0.0,0.0,1.0,44,450,400,50,0.8888888888888888,5,4,1,356.19312467719857,0.7544265327695561,0.20372542103870872,0.24515027472776513,137226.23459085223,975.8082573203999,138202.04284817263,1072,56,657.2727272727273,40,4,17,28.728782735208537,0.6848958333333333,38.058943089430905,1047.764227642278,26.19410569105695,0
1074,4,0,0,44,0.0,0.0,1.0,44,1600,1200,400,0.75,20,12,8,354.08106487970934,0.7544705778717407,0.20174642076310012,0.24406978215505137,137279.47980699348,921.6128792385775,138201.09268623206,1073,57,658.2727272727273,40,4,17,28.731494052236894,0.6854166666666666,38.00813008130083,1047.9674796747988,26.199186991869972,0
1075,4,0,0,44,0.0,0.0,1.0,44,1100,800,300,0.7272727272727273,14,8,6,354.6485418479316,0.7535676532769556,0.20465121403075837,0.24502342325260656,137359.3669959185,942.8598428514881,138302.22683877,1074,58,659.2727272727273,40,4,17,28.637703990951707,0.6861979166666666,37.931910569105696,1048.272357723578,26.20680894308945,0
1076,4,0,0,44,0.0,0.0,1.0,44,1250,1000,250,0.8,15,10,5,348.964149643275,0.7535896758280479,0.17177937749893402,0.23436460338065124,136367.09120008702,718.1913909518962,137085.2825910389,1075,59,660.2727272727273,39,5,16,29.768063727934578,0.6781517094017093,38.88020833333334,1044.4791666666683,26.781517094017136,3
1077,4,0,0,44,0.0,0.0,1.0,44,1250,900,350,0.72,16,9,7,345.5770014617262,0.7519159619450317,0.16647876488845204,0.23267040943209,136455.3395486321,631.1654149316198,137086.50496356373,1076,60,661.2727272727273,40,4,16,29.7691129267581,0.6773437499999999,38.79573170731709,1044.8170731707344,26.12042682926836,0
1078,4,0,0,44,0.0,0.0,1.0,44,1400,1100,300,0.7857142857142857,17,11,6,345.38748017821143,0.7522903453136012,0.16340117769800644,0.23271782904275068,136481.88598882966,627.8269383303798,137109.71292716003,1077,61,662.2727272727273,40,4,16,29.747779290669776,0.6776041666666666,38.77032520325204,1044.9186991869938,26.122967479674845,0
1079,4,0,0,44,0.0,0.0,1.0,44,1000,600,400,0.6,14,6,8,345.9103244985945,0.7519159619450317,0.16686329612838802,0.23395000053366494,136614.65691924456,651.2840612400128,137265.94098048456,1078,62,663.2727272727273,40,4,17,29.602694339133542,0.6789062499999999,38.643292682926834,1045.4268292682932,26.13567073170733,0
1080,4,0,0,44,0.0,0.0,1.0,44,400,200,200,0.5,6,2,4,343.96279424136105,0.7502862931642001,0.16235059760956183,0.23333692257995065,136720.9201388891,605.3819444444692,137326.30208333358,1079,63,664.2727272727273,40,4,17,29.548472775564413,0.6799479166666667,38.54166666666668,1045.833333333335,26.14583333333338,0
1081,4,0,0,44,0.0,0.0,1.0,44,1250,900,350,0.72,16,9,7,340.82871208691716,0.7494714587737844,0.14089700193423593,0.22884213525835875,136358.0246913581,499.2862654321071,136857.3109567902,1080,64,665.2727272727273,41,3,16,29.9894725177305,0.6747967479674796,38.88888888888889,1044.444444444445,25.47425474254744,7
1082,4,0,0,44,0.0,0.0,1.0,44,750,600,150,0.8,9,6,3,341.5524224641033,0.7496696617336153,0.14088319088319068,0.22966455993275917,136409.837372449,518.2220804988686,136928.05945294787,1081,65,666.2727272727273,41,3,16,29.919278252611587,0.6753048780487805,38.839285714285715,1044.6428571428573,25.479094076655056,0
1083,4,0,0,44,0.0,0.0,1.0,44,1350,900,450,0.6666666666666666,18,9,9,339.7203729744032,0.7492732558139535,0.13939221370884214,0.22944191343963558,136565.33446712032,478.8052721088576,137044.13973922917,1082,66,667.2727272727273,41,3,16,29.813259301442667,0.6768292682926829,38.6904761904762,1045.2380952380963,25.49361207897796,0
1084,4,0,0,44,0.0,0.0,1.0,44,1000,600,400,0.6,14,6,8,341.40120761655584,0.7503083157152924,0.13964366120642824,0.23108717579132176,136643.11623086722,530.0249787414864,137173.1412096087,1083,67,668.2727272727273,41,3,16,29.692392541986916,0.677591463414634,38.61607142857142,1045.5357142857133,25.500871080139348,0
1085,4,0,0,44,0.0,0.0,1.0,44,1300,900,400,0.6923076923076923,17,9,8,398.8537683535534,0.7496035940803383,0.23476210220794047,0.26701889682905816,136254.42885487518,2092.724277210876,138347.15313208607,1084,68,669.2727272727273,41,3,18,28.5775370581528,0.6737804878048781,38.988095238095234,1044.0476190476184,25.464576074332154,7
1086,4,0,0,44,0.0,0.0,1.0,44,800,600,200,0.75,10,6,4,395.8946355817113,0.7499119097956307,0.23452611218568675,0.2658149696048633,136358.02469135795,1996.6820987654255,138354.70679012337,1085,69,670.2727272727273,41,3,18,28.55164007092198,0.6747967479674797,38.888888888888886,1044.444444444444,25.474254742547412,0
1087,4,0,0,44,0.0,0.0,1.0,44,1250,700,550,0.56,18,7,11,398.2262684333095,0.7489869626497534,0.2383407839549858,0.2685605321175721,136513.4922603298,2072.651722726104,138586.1439830559,1086,70,671.2727272727273,41,3,18,28.33602303651667,0.6763211382113822,38.74007936507935,1045.0396825396806,25.488772744870257,0
1088,4,0,0,44,0.0,0.0,1.0,44,900,500,400,0.5555555555555556,13,5,8,400.3640036234677,0.748062015503876,0.24335737331562002,0.27079819449191883,136617.1865158098,2139.3207514487053,138756.5072672585,1087,71,672.2727272727273,41,3,18,28.1769943695831,0.6773373983739839,38.640873015873005,1045.4365079365061,25.498451413085515,0
1089,4,0,0,44,0.0,0.0,1.0,44,1300,1000,300,0.7692307692307693,16,10,6,397.86507463683245,0.747643587033122,0.2461324171232242,0.2701178280648117,136748.85514829404,2081.636794812137,138830.49194310617,1088,72,673.2727272727273,38,6,18,28.111380660537954,0.6836622807017545,38.51495726495725,1045.9401709401693,27.52474134053077,0
1090,4,0,0,44,0.0,0.0,1.0,44,750,500,250,0.6666666666666666,10,5,5,397.15697960732416,0.7480399929527837,0.24661098782741142,0.2698517687255591,136776.79301126802,2064.371598546264,138841.1646098143,1089,73,674.2727272727273,38,6,18,28.102126102202703,0.6839364035087719,38.48824786324786,1046.0470085470074,27.527552856500193,0
1091,4,0,0,44,0.0,0.0,1.0,44,1200,900,300,0.75,15,9,6,398.3101855835157,0.7473572938689218,0.2525787887836264,0.27167837301816555,136911.6333007811,2106.6596137152633,139018.29291449636,1090,74,675.2727272727273,39,5,19,27.937962410006296,0.6834935897435899,38.35937499999999,1046.5624999999989,26.83493589743587,0
1092,4,0,0,44,0.0,0.0,1.0,44,550,400,150,0.7272727272727273,7,4,3,396.89678204423024,0.7468727977448908,0.24886917739440406,0.2711363536888147,136966.14718966995,2072.2846137152583,139038.4318033852,1091,75,676.2727272727273,39,5,18,27.92079228447276,0.6840277777777779,38.30729166666666,1046.7708333333317,26.840277777777736,0
1093,4,0,0,44,0.0,0.0,1.0,44,750,400,350,0.5333333333333333,11,4,7,395.45200385406855,0.7467406624383369,0.2502261195177322,0.27057100685753854,137020.67192925338,2037.019856770824,139057.6917860242,1092,76,677.2727272727273,39,5,18,27.904458097038443,0.6845619658119659,38.25520833333333,1046.9791666666658,26.845619658119638,0
1094,4,0,0,44,0.0,0.0,1.0,44,1300,1100,200,0.8461538461538461,15,11,4,400.0646864918231,0.7458597603946442,0.2551082681614749,0.2745836465989956,137129.7539605036,2172.1544053819553,139301.90836588558,1093,77,678.2727272727273,39,5,18,27.67538952428311,0.6856303418803419,38.15104166666667,1047.3958333333344,26.856303418803446,0
1095,4,0,0,44,0.0,0.0,1.0,44,800,500,300,0.625,11,5,6,397.58258563964574,0.7457716701902749,0.2469724082458944,0.27373601840856954,137238.8793945314,2112.757703993071,139351.63709852446,1094,78,679.2727272727273,39,5,19,27.63207492461146,0.6866987179487178,38.04687500000001,1047.8125000000011,26.866987179487207,0
1096,4,0,0,44,0.0,0.0,1.0,44,1000,700,300,0.7,13,7,6,395.6209699472451,0.7446485200845666,0.2484646785759439,0.27388725471038333,137429.95334201405,2074.0342881944644,139503.98763020852,1095,79,680.2727272727273,39,5,19,27.493956553414133,0.688568376068376,37.86458333333334,1048.541666666668,26.885683760683797,0
1097,4,0,0,44,0.0,0.0,1.0,44,1150,700,450,0.6086956521739131,16,7,9,399.273024482387,0.7439658210007047,0.25433416404810916,0.2768512954882009,137484.57031250026,2178.7760416666956,139663.34635416695,1096,80,681.2727272727273,39,5,19,27.34406038935241,0.689102564102564,37.812500000000014,1048.750000000002,26.891025641025692,0
1098,4,0,0,44,0.0,0.0,1.0,44,800,600,200,0.75,10,6,4,380.71705339697047,0.7449348132487668,0.21062931916154515,0.2526866639817575,135947.9614520814,1573.5466682056006,137521.508120287,1097,81,682.2727272727273,37,7,15,29.355811691725375,0.6776463963963963,39.281798245614034,1042.8728070175437,28.185751541014692,5
1099,4,0,0,44,0.0,0.0,1.0,44,1050,700,350,0.6666666666666666,14,7,7,383.97454859371345,0.7435473925299507,0.20954322090685773,0.2561928545535104,136134.9441157133,1654.4707429322812,137789.41485864558,1098,82,683.2727272727273,38,6,15,29.08476658476659,0.6776315789473684,39.1025641025641,1043.5897435897432,27.462887989203768,0
1100,4,0,1,43,0.0,0.022727272727272728,0.9772727272727273,44,600,400,200,0.6666666666666666,8,4,4,384.1934608587062,0.7434152572233967,0.2104401228249746,0.2567421417639918,136190.69713821317,1664.7150540580074,137855.41219227118,1099,83,684.2727272727273,38,6,15,29.02358410098944,0.6781798245614035,39.0491452991453,1043.803418803419,27.468511021142604,0
1101,4,0,0,43,0.0,0.0,1.0,43,1050,500,550,0.47619047619047616,16,5,11,380.5714163883206,0.74312476928756,0.2036530273374082,0.2557888849559036,136394.29253472236,1781.5538194444543,138175.84635416683,1100,84,691.3720930232558,39,4,16,28.915702699109154,0.6784188034188035,38.85416666666667,1044.5833333333344,26.784188034188062,0
1102,4,0,0,43,0.0,0.0,1.0,43,1050,900,150,0.8571428571428571,12,9,3,381.572565740869,0.742017349575489,0.206588026952915,0.2574524244840714,136530.33989800359,1819.246419270838,138349.58631727443,1101,85,692.3720930232558,39,4,16,28.754381374796502,0.6797542735042735,38.723958333333336,1045.1041666666674,26.797542735042754,0
1103,4,0,0,43,0.0,0.0,1.0,43,800,600,200,0.75,10,6,4,380.66746075104675,0.7419250645994832,0.2040226022222118,0.2570401952339167,136557.55750868047,1796.6037326388832,138354.16124131935,1102,86,693.3720930232558,39,4,16,28.750996611520826,0.6800213675213675,38.697916666666664,1045.2083333333328,26.800213675213662,0
1104,4,0,0,43,0.0,0.0,1.0,43,1000,800,200,0.8,12,8,4,384.25832787720043,0.7424787744555186,0.20355846159906044,0.2600674873164839,136639.2266167533,1900.9521484374804,138540.17876519077,1103,87,694.3720930232558,39,4,17,28.576039487230577,0.6808226495726497,38.61979166666666,1045.520833333332,26.80822649572646,0
1105,4,0,0,43,0.0,0.0,1.0,43,950,600,350,0.631578947368421,13,6,7,384.598184423115,0.7418327796234773,0.20658501611158342,0.26070095701712676,136693.68625217004,1914.4287109374905,138608.11496310754,1104,88,695.3720930232558,39,4,17,28.513069860875916,0.6813568376068377,38.56770833333333,1045.7291666666658,26.813568376068353,0
1106,4,0,0,43,0.0,0.0,1.0,43,850,600,250,0.7058823529411765,11,6,5,385.86689100173055,0.7423403469915097,0.20476234596497744,0.26176375578766015,136720.92013888873,1951.226128472203,138672.14626736092,1105,89,696.3720930232558,35,8,17,28.452855245683928,0.6892857142857143,38.54166666666666,1045.833333333332,29.88095238095234,0
1107,4,0,0,43,0.0,0.0,1.0,43,650,300,350,0.46153846153846156,10,3,7,384.3575516679129,0.7428940568475452,0.20345813464542406,0.2609646276801598,136751.1831945515,1912.2699920696004,138663.4531866211,1106,90,697.3720930232558,35,8,17,28.462270849470688,0.6895833333333334,38.512731481481474,1045.9490740740732,29.884259259259235,0
1108,4,0,0,43,0.0,0.0,1.0,43,850,500,350,0.5882352941176471,12,5,7,386.1638510676354,0.7426633444075305,0.20176302786016165,0.2630977677093057,136872.26890699993,1971.0244930983927,138843.29340009834,1107,91,698.3720930232558,35,8,17,28.29482819009696,0.6907738095238096,38.396990740740726,1046.4120370370351,29.89748677248672,0
1109,4,0,0,43,0.0,0.0,1.0,43,1000,800,200,0.8,12,8,4,384.0002932895261,0.74109449981543,0.19878667554757734,0.26207657752582514,136932.8318571029,1916.4495188185654,138849.28137592145,1108,92,699.3720930232558,35,8,17,28.29133491835303,0.6913690476190477,38.33912037037036,1046.6435185185173,29.904100529100496,0
1110,4,0,0,43,0.0,0.0,1.0,43,1500,1100,400,0.7333333333333333,19,11,8,377.3295976245804,0.739202657807309,0.1934778532870054,0.25871320796212227,137093.86692299537,1745.9147285703086,138839.7816515657,1109,93,700.3720930232558,37,6,14,28.30626374201654,0.6889076576576578,38.18530701754385,1047.258771929823,28.30429113323846,0
1111,4,0,0,43,0.0,0.0,1.0,43,900,400,500,0.4444444444444444,14,4,10,376.0801690257863,0.739110372831303,0.1881856860299107,0.258614455642837,137196.20338410384,1719.3542716779702,138915.5576557818,1110,94,701.3720930232558,38,5,15,28.237601128560737,0.6880482456140351,38.08760683760683,1047.6495726495712,27.569725596041348,0
1112,4,0,0,43,0.0,0.0,1.0,43,750,300,450,0.4,12,3,9,373.84903090057327,0.7386489479512734,0.18456716355810965,0.2577995270658442,137293.45838758675,1665.405273437495,138958.86366102425,1111,95,702.3720930232558,39,4,15,28.19975234403472,0.6872329059829061,37.994791666666664,1048.020833333333,26.872329059829053,0
1113,4,0,0,43,0.0,0.0,1.0,43,1200,900,300,0.75,15,9,6,371.0858910147547,0.738141380583241,0.18198072911493002,0.25710403749797206,137457.2604709201,1601.6899956597174,139058.95046657982,1112,96,703.3720930232558,39,4,15,28.11009983113141,0.6888354700854702,37.838541666666664,1048.645833333333,26.888354700854695,0
1114,4,0,1,42,0.0,0.023255813953488372,0.9767441860465116,43,950,800,150,0.8421052631578947,11,8,3,369.64030857520606,0.738187523071244,0.1799170722913288,0.25636343981828785,137492.56395002958,1564.5587530570276,139057.1227030866,1113,97,704.3720930232558,40,3,15,28.113089470284233,0.6875,37.80487804878048,1048.7804878048769,26.219512195121922,0
1115,4,0,0,42,0.0,0.0,1.0,42,1050,500,550,0.47619047619047616,16,5,11,373.7019731854383,0.7385065814943864,0.181139678755889,0.2591206243822995,137484.57031249985,1875.6510416666515,139360.2213541665,1114,98,714.1666666666666,39,3,15,28.014501390544297,0.6891025641025641,37.81249999999999,1048.7499999999989,26.89102564102561,0
1116,4,0,0,42,0.0,0.0,1.0,42,800,500,300,0.625,11,5,6,373.46825722654705,0.7389663182346109,0.18201315683687325,0.2591627761553483,137511.88286675353,1871.264648437506,139383.14751519103,1115,99,715.1666666666666,39,3,15,27.99361489058827,0.6893696581196581,37.786458333333336,1048.854166666667,26.89369658119659,0
1117,4,0,0,42,0.0,0.0,1.0,42,1500,1100,400,0.7333333333333333,19,11,8,368.0806502794551,0.7381436314363143,0.17994932735849978,0.2564346107133629,137648.48632812485,1733.148871527763,139381.6351996526,1116,100,716.1666666666666,39,3,15,27.999884190324924,0.6907051282051282,37.65624999999999,1049.3749999999989,26.907051282051253,0
1118,4,0,1,41,0.0,0.023809523809523808,0.9761904761904762,42,900,600,300,0.6666666666666666,12,6,6,367.3796627690205,0.736449864498645,0.1822307972467716,0.2565696103273303,137732.48113102323,1720.0224940511632,139452.5036250744,1117,101,717.1666666666666,40,2,15,27.935303514376997,0.68984375,37.576219512195124,1049.6951219512198,26.242378048780495,0
1119,4,0,0,41,0.0,0.0,1.0,41,1200,800,400,0.6666666666666666,16,8,8,371.5068456588719,0.7355182926829268,0.20708659211474667,0.2602722063551582,137841.28439760295,2041.8426289364925,139883.12702653944,1118,102,732.1463414634146,37,4,15,27.719514635759285,0.6962274774774775,37.47258771929824,1050.1096491228059,28.38134186818394,0
1120,4,0,0,41,0.0,0.0,1.0,41,1350,1300,50,0.9629629629629629,14,13,1,373.51281016603804,0.7357215447154472,0.21123657941217377,0.2623127106823201,137924.70231572777,2103.3286306523314,140028.0309463801,1119,103,733.1463414634146,38,3,15,27.58446060482776,0.6951754385964912,37.393162393162385,1050.427350427349,27.642825011246025,0
1121,4,0,0,41,0.0,0.0,1.0,41,1050,800,250,0.7619047619047619,13,8,5,370.0398724350878,0.7354166666666667,0.20880627921683415,0.2605112487758829,138008.88401499361,2013.7579671633998,140022.64198215702,1120,104,734.1463414634146,38,3,15,27.592569056092188,0.6959978070175439,37.31303418803418,1050.747863247862,27.651259559154262,0
1122,4,0,0,41,0.0,0.0,1.0,41,1100,900,200,0.8181818181818182,13,9,4,368.83822965760015,0.734349593495935,0.2052529399950911,0.2600904419456495,138065.01941568038,1984.7314677843424,140049.75088346473,1121,105,735.1463414634146,38,3,14,27.568745552505842,0.696546052631579,37.25961538461538,1050.9615384615377,27.656882591093098,0
1123,4,0,0,41,0.0,0.0,1.0,41,1150,800,350,0.6956521739130435,15,8,7,365.4048185750953,0.7333841463414634,0.20092761756970146,0.2580917451514976,138121.16623064133,1894.0279375776136,140015.19416821894,1122,106,736.1463414634146,38,3,14,27.60358437510587,0.6970942982456141,37.20619658119658,1051.1752136752134,27.662505623031933,0
1124,4,0,0,41,0.0,0.0,1.0,41,1500,1100,400,0.7333333333333333,19,11,8,364.007112586597,0.7329268292682927,0.2015619225222658,0.25828389429282267,138277.73573133664,1866.8158637152587,140144.5515950519,1123,107,737.1463414634146,39,2,15,27.485990063055027,0.6968482905982907,37.05729166666666,1051.770833333332,26.96848290598287,0
1125,4,0,0,41,0.0,0.0,1.0,41,800,500,300,0.625,11,5,6,366.312709550861,0.7316565040650407,0.2041904283624112,0.26096551423715064,138414.7189670138,1940.6141493055466,140355.33311631932,1124,108,738.1463414634146,39,2,15,27.29038804197189,0.6981837606837608,36.92708333333333,1052.2916666666658,26.981837606837587,0
1126,4,0,0,41,0.0,0.0,1.0,41,1100,900,200,0.8181818181818182,13,9,4,365.92361060176097,0.730640243902439,0.20292373945117137,0.26110820349718855,138469.53124999985,1933.8541666666524,140403.3854166665,1125,109,739.1463414634146,39,2,15,27.246634996041166,0.6987179487179488,36.87499999999999,1052.4999999999989,26.987179487179457,0
1127,4,0,0,41,0.0,0.0,1.0,41,1350,1100,250,0.8148148148148148,16,11,5,371.074390929354,0.7302845528455284,0.20786596826300663,0.2658533676757503,138606.6094292533,2086.6726345485913,140693.2820638019,1126,110,740.1463414634146,39,2,15,26.97606505753948,0.7000534188034189,36.74479166666666,1053.020833333332,27.000534188034152,0
1128,4,0,0,41,0.0,0.0,1.0,41,1100,800,300,0.7272727272727273,14,8,6,365.6565708121194,0.7299288617886179,0.20166749872779088,0.2628205330933164,138716.3208007811,1944.5068359374854,140660.82763671858,1127,111,741.1463414634146,39,2,15,27.0107164046277,0.7011217948717949,36.64062499999999,1053.4374999999989,27.01121794871792,0
1129,4,0,0,41,0.0,0.0,1.0,41,1450,1200,250,0.8275862068965517,17,12,5,367.61852074748725,0.7297764227642276,0.20713027171777854,0.26551975813303486,138880.96923828108,2011.043294270818,140892.0125325519,1128,112,742.1463414634146,39,2,16,26.79705257436506,0.702724358974359,36.48437499999999,1054.0624999999986,27.027243589743556,0
1130,4,0,0,41,0.0,0.0,1.0,41,800,500,300,0.625,11,5,6,371.3851534255266,0.7292174796747968,0.21404236255092135,0.26916800129076124,138997.4687525365,2124.3273897049694,141121.79614224145,1129,113,743.1463414634146,36,5,16,26.583190944041014,0.7094907407407407,36.37387387387388,1054.5045045045058,29.291791791791827,0
1131,4,0,0,41,0.0,0.0,1.0,41,850,600,250,0.7058823529411765,11,6,5,372.50696963483114,0.7291158536585366,0.21772055644963895,0.2704573858604519,139056.85034696865,2159.9291859427094,141216.77953291137,1130,114,744.1463414634146,36,5,16,26.49521318243291,0.7100694444444444,36.31756756756757,1054.7297297297303,29.298048048048063,0
1132,4,0,0,41,0.0,0.0,1.0,41,950,600,350,0.631578947368421,13,6,7,371.09723965371495,0.7284044715447154,0.21580991856032994,0.2699098556736028,139116.2446230015,2125.130874117375,141241.37549711886,1131,115,745.1463414634146,36,5,16,26.473989467691435,0.7106481481481481,36.26126126126127,1054.9549549549558,29.304304304304328,0
1133,4,0,0,41,0.0,0.0,1.0,41,1100,700,400,0.6363636363636364,15,7,8,370.4065678534049,0.7266260162601627,0.21836215375168422,0.270841744700298,139294.50354070298,2119.119795471161,141413.62333617415,1132,116,746.1463414634146,36,5,14,26.31702937202191,0.7123842592592593,36.09234234234235,1055.6306306306317,29.323073073073104,0
1134,4,0,0,41,0.0,0.0,1.0,41,1150,800,350,0.6956521739130435,15,8,7,368.6545264401057,0.7251524390243902,0.2228141965805044,0.270646371849931,139429.0550938749,2080.2304555247592,141509.28554939965,1133,117,747.1463414634146,37,4,14,26.23113925802878,0.7117117117117118,35.964912280701746,1056.1403508771918,28.54433380749167,0
1135,4,0,0,41,0.0,0.0,1.0,41,1100,900,200,0.8181818181818182,13,9,4,372.1414396623621,0.724390243902439,0.23133140101509952,0.27391770596996634,139515.92226694757,2183.931233648819,141699.8535005964,1134,118,748.1463414634146,37,4,14,26.05377529839128,0.7125563063063063,35.88267543859649,1056.4692982456145,28.553224276908498,0
1136,4,0,0,41,0.0,0.0,1.0,41,650,300,350,0.46153846153846156,10,3,7,371.4077023627186,0.7227134146341463,0.23338995545014574,0.2744089917456592,139641.44483024697,2172.7816358024775,141814.22646604944,1135,119,749.1463414634146,38,3,14,25.949956197985113,0.7118969298245614,35.76388888888889,1056.944444444445,27.814327485380133,0
1137,4,0,0,41,0.0,0.0,1.0,41,1300,1100,200,0.8461538461538461,15,11,4,370.52055197824535,0.7223577235772358,0.2264575980440482,0.2744514507767005,139726.1487325591,2154.281950836448,141880.43068339553,1136,120,750.1463414634146,38,3,15,25.890300794933975,0.712719298245614,35.68376068376069,1057.264957264958,27.822762033288367,0
1138,4,0,0,41,0.0,0.0,1.0,41,1050,800,250,0.7619047619047619,13,8,5,374.4237457603601,0.7214939024390243,0.22932051174682622,0.2787627015427886,139895.63358353433,2276.049428373159,142171.6830119075,1137,121,751.1463414634146,38,3,16,25.620876253955437,0.7143640350877192,35.52350427350428,1057.9059829059838,27.839631129104838,0
1139,4,0,0,41,0.0,0.0,1.0,41,850,600,250,0.7058823529411765,11,6,5,373.13195188114133,0.7210873983739837,0.22566701886346285,0.27803805263197484,139923.89104618682,2242.0149161735785,142165.9059623604,1138,122,752.1463414634146,38,3,16,25.627335150964353,0.7146381578947367,35.496794871794876,1058.0128205128212,27.842442645074243,0
1140,4,0,0,41,0.0,0.0,1.0,41,850,700,150,0.8235294117647058,10,7,3,370.31271240717587,0.7206808943089431,0.22490670156882908,0.27688835111281684,140037.69338883102,2171.5732977295065,142209.26668656053,1139,123,753.1463414634146,37,4,16,25.59038209192306,0.7176238738738739,35.389254385964904,1058.4429824561391,28.606567093409165,0
1141,4,0,1,40,0.0,0.024390243902439025,0.975609756097561,41,1000,600,400,0.6,14,6,8,371.8452091795711,0.7207825203252033,0.22689468273993074,0.2790139226920836,140153.77477925888,2223.101940019997,142376.87671927887,1140,124,754.1463414634146,37,4,16,25.436104207655934,0.71875,35.27960526315789,1058.8815789473676,28.618421052631557,0
1142,4,0,0,40,0.0,0.0,1.0,40,1150,700,450,0.6086956521739131,16,7,9,375.08920594625295,0.718215811965812,0.21197501329080293,0.2819915253336937,140217.32617330173,2518.801106850097,142736.12728015182,1141,125,745.625,36,4,18,25.28796739323055,0.7213541666666667,35.2195945945946,1059.121621621622,29.420045045045054,0
1143,4,0,0,40,0.0,0.0,1.0,40,1650,1200,450,0.7272727272727273,21,12,9,374.00992785652465,0.7175747863247863,0.20866989053034368,0.2822020377868517,140336.62198938802,2497.457973175877,142834.0799625639,1142,126,746.625,36,4,14,25.19972012612038,0.7225115740740741,35.10698198198198,1059.572072072072,29.432557557557555,0
1144,4,0,0,40,0.0,0.0,1.0,40,800,500,300,0.625,11,5,6,371.5661066186902,0.7165331196581196,0.19995218869528264,0.28112380992725977,140426.12714065416,2435.517865838809,142861.64500649297,1143,127,747.625,36,4,14,25.17685755772772,0.7233796296296297,35.02252252252252,1059.9099099099099,29.44194194194194,0
1145,4,0,0,40,0.0,0.0,1.0,40,1100,900,200,0.8181818181818182,13,9,4,369.6897374593948,0.715892094017094,0.19781176970469527,0.28021410534965735,140485.81309349896,2387.232671861052,142873.04576536,1144,128,748.625,36,4,14,25.16818922172651,0.7239583333333334,34.96621621621622,1060.1351351351354,29.448198198198206,0
1146,4,0,0,40,0.0,0.0,1.0,40,1050,800,250,0.7619047619047619,13,8,5,368.35758781790986,0.7157051282051282,0.19303122013380047,0.27996960488145745,140575.365800767,2356.4005305981677,142931.76633136516,1145,129,749.625,36,4,15,25.115925099996463,0.724826388888889,34.88175675675676,1060.4729729729731,29.45758258258259,0
1147,4,0,0,40,0.0,0.0,1.0,40,800,600,200,0.75,10,6,4,370.1022619411282,0.7158653846153846,0.19442881409916146,0.2818102833648734,140635.08345761296,2409.87249918837,143044.95595680134,1146,130,750.625,36,4,15,25.011280390699664,0.7254050925925926,34.82545045045045,1060.6981981981976,29.46383883883882,0
1148,4,0,0,40,0.0,0.0,1.0,40,1300,1000,300,0.7692307692307693,16,10,6,369.37489010466356,0.7118589743589744,0.1896752971137523,0.28254780554759334,140784.43308173036,2400.4468996023015,143184.87998133266,1147,131,751.625,36,4,15,24.884603140916802,0.7268518518518519,34.68468468468468,1061.261261261261,29.479479479479476,0
1149,4,0,0,40,0.0,0.0,1.0,40,1400,1000,400,0.7142857142857143,18,10,8,368.8864752425952,0.7116452991452992,0.18403160797624096,0.28321349255595996,140903.96984822667,2395.5137570002503,143299.4836052269,1148,132,752.625,36,4,17,24.780794795644187,0.7280092592592593,34.572072072072075,1061.711711711712,29.491991991992002,0
1150,4,0,0,40,0.0,0.0,1.0,40,300,200,100,0.6666666666666666,4,2,2,368.7431093686873,0.7118856837606837,0.18021794463888052,0.2833642036053262,140933.861965851,2393.6780953250563,143327.54006117606,1149,133,753.625,36,4,18,24.755408845052504,0.728298611111111,34.54391891891892,1061.8243243243244,29.49512012012012,0
1151,4,0,0,40,0.0,0.0,1.0,40,1000,700,300,0.7,13,7,6,366.3607817478842,0.7100961538461539,0.17135891456434216,0.282835320377213,141083.370109975,2337.482753023314,143420.8528629983,1150,134,754.625,36,4,18,24.672726309094777,0.7297453703703702,34.40315315315316,1062.3873873873886,29.510760760760792,0
1152,4,0,1,39,0.0,0.025,0.975,40,1100,800,300,0.7272727272727273,14,8,6,369.28590548613016,0.7090010683760684,0.17569709182006266,0.28562880356092346,141144.0265587492,2424.5031007413545,143568.52965949057,1151,135,755.625,35,5,18,24.53583941473332,0.7324404761904761,34.34606481481482,1062.6157407407413,30.360449735449752,0
1153,4,0,0,39,0.0,0.0,1.0,39,600,300,300,0.5,9,3,6,368.3980870208069,0.7070400359874044,0.1839384749426134,0.2852134262247091,141174.77521647813,2601.7034250685947,143776.4786415467,1152,136,767.2564102564103,35,4,18,24.529423509765486,0.7327380952380952,34.31712962962963,1062.731481481482,30.363756613756628,0
1154,4,0,0,39,0.0,0.0,1.0,39,1050,800,250,0.7619047619047619,13,8,5,366.597263533611,0.7063652721547459,0.1830608415974273,0.28436058009228743,141236.28257887517,2555.3669410150897,143791.64951989026,1153,137,768.2564102564103,35,4,18,24.517276422764226,0.7333333333333334,34.25925925925926,1062.9629629629628,30.370370370370367,0
1155,4,0,0,39,0.0,0.0,1.0,39,800,500,300,0.625,11,5,6,366.2987566772657,0.7065901934322987,0.17796312113751722,0.2846717748593368,141297.80333719126,2551.441936728388,143849.24527391966,1154,138,769.2564102564103,35,4,19,24.46521881123449,0.7339285714285715,34.201388888888886,1063.194444444444,30.376984126984112,0
1156,4,0,0,39,0.0,0.0,1.0,39,850,500,350,0.5882352941176471,12,5,7,365.65837327520563,0.7050157444894287,0.18050299722045482,0.28471772319089744,141359.33749142662,2537.8450788751725,143897.18257030178,1155,139,770.2564102564103,35,4,16,24.422253664199683,0.7345238095238095,34.14351851851852,1063.425925925926,30.38359788359789,0
1157,4,0,0,39,0.0,0.0,1.0,39,450,400,50,0.8888888888888888,5,4,1,362.83512973011995,0.7051844354475933,0.17641248849083424,0.28306068270117196,141420.88504158103,2462.4930341220943,143883.37807570313,1156,140,771.2564102564103,35,4,16,24.4373413130214,0.7351190476190477,34.08564814814815,1063.657407407408,30.39021164021166,0
1158,4,0,0,39,0.0,0.0,1.0,39,1050,900,150,0.8571428571428571,12,9,3,367.209909670024,0.7034975258659469,0.1782768025970114,0.2875747793446507,141544.02032964674,2595.2733839163184,144139.29371356306,1157,141,772.2564102564103,35,4,16,24.20101878036401,0.7363095238095239,33.969907407407405,1064.12037037037,30.40343915343914,0
1159,4,0,0,39,0.0,0.0,1.0,39,1400,1300,100,0.9285714285714286,15,13,2,368.84554603948015,0.7004610886189834,0.1748927329633907,0.2901053071761437,141682.19528650277,2651.7693369044787,144333.96462340726,1158,142,773.2564102564103,36,3,16,24.02290035963614,0.7355324074074074,33.840090090090094,1064.63963963964,29.573323323323336,0
1160,4,0,0,39,0.0,0.0,1.0,39,1300,900,400,0.6923076923076923,17,9,8,370.70703922531413,0.6992240215924427,0.17446633158200142,0.29266670926485994,141802.11250101455,2713.4082562292033,144515.52075724376,1159,143,774.2564102564103,36,3,16,23.856567632339473,0.7366898148148149,33.72747747747748,1065.0900900900901,29.585835835835837,0
1161,4,0,0,39,0.0,0.0,1.0,39,400,100,300,0.25,7,1,6,395.4947934678863,0.6992240215924427,0.2147379870255992,0.28024284250602244,138231.01579020085,3151.043228061305,141382.05901826217,1160,144,775.2564102564103,33,6,15,26.704225420502667,0.70864898989899,37.10171568627451,1051.5931372549019,31.866458704693997,7
1162,4,0,0,39,0.0,0.0,1.0,39,900,700,200,0.7777777777777778,11,7,4,396.4570509385242,0.6997300944669366,0.20468611847922213,0.28172080507088504,138327.68646674353,3168.1973279507847,141495.88379469432,1161,145,776.2564102564103,33,6,16,26.583372165268727,0.7095959595959596,37.009803921568626,1051.9607843137253,31.877599524658343,0
1163,4,0,0,39,0.0,0.0,1.0,39,950,600,350,0.631578947368421,13,6,7,410.03779123520724,0.7001799370220423,0.21023791913215018,0.2881346641112266,137945.10764207726,3523.9102743426292,141469.0179164199,1162,146,777.2564102564103,32,7,18,26.605068108974365,0.7083333333333334,37.37373737373737,1050.50505050505,32.82828282828281,3
1164,4,0,0,39,0.0,0.0,1.0,39,600,300,300,0.5,9,3,6,412.05408954176596,0.6997863247863249,0.21390427062822215,0.2898311140386335,137978.2695165034,3570.9020444342395,141549.17156093766,1163,147,778.2564102564103,32,7,18,26.519248487761885,0.7086588541666667,37.342171717171716,1050.631313131313,32.83222853535353,0
1165,4,0,0,39,0.0,0.0,1.0,39,1500,1000,500,0.6666666666666666,20,10,10,413.22459361803755,0.6983243364822312,0.21757440765010183,0.2912166208876315,138044.60522204373,3608.6851788082945,141653.290400852,1164,148,779.2564102564103,32,7,14,26.422764227642272,0.7093098958333333,37.27904040404041,1050.8838383838388,32.84011994949496,0
1166,4,0,0,39,0.0,0.0,1.0,39,900,800,100,0.8888888888888888,10,8,2,410.8978167356546,0.697199730094467,0.21616077616077622,0.2901377713591454,138110.95686983474,3549.8981290174524,141660.85499885218,1165,149,780.2564102564103,32,7,14,26.41816816816818,0.7099609375,37.21590909090909,1051.136363636364,32.848011363636374,0
1167,4,0,0,39,0.0,0.0,1.0,39,1200,1000,200,0.8333333333333334,14,10,4,411.29145846278914,0.6955128205128205,0.21962095875139376,0.29069717174543147,138144.13867207436,3563.5008545046535,141707.639526579,1166,150,781.2564102564103,32,7,14,26.374959964769005,0.7102864583333333,37.18434343434344,1051.2626262626268,32.85195707070709,0
1168,4,0,1,38,0.0,0.02564102564102564,0.9743589743589743,39,450,300,150,0.6666666666666666,6,3,3,409.16221823962707,0.6944444444444444,0.2194221454459233,0.28947270953962384,138177.32445987646,3507.388117283938,141684.7125771604,1167,151,782.2564102564103,32,7,14,26.398062527520906,0.7106119791666667,37.15277777777777,1051.3888888888882,32.85590277777776,0
1169,4,0,0,38,0.0,0.0,1.0,38,1250,1000,250,0.8,15,10,5,418.3355347027197,0.6916192508297772,0.21526152843408863,0.2960613008522751,138188.7329949272,3961.8515014648333,142150.58449639205,1168,152,792.2105263157895,31,7,14,26.145639834881326,0.7133736559139785,37.14192708333333,1051.4322916666658,33.91717069892471,0
1170,4,0,0,38,0.0,0.0,1.0,38,900,600,300,0.6666666666666666,12,6,6,419.8476318891117,0.6908783783783784,0.21759968200804103,0.2977268940095132,138257.19409518767,4009.391106499561,142266.58520168724,1169,153,793.2105263157895,31,7,14,26.038055589946765,0.7140456989247312,37.076822916666664,1051.692708333333,33.92557123655913,0
1171,4,0,0,38,0.0,0.0,1.0,38,650,600,50,0.9230769230769231,7,6,1,419.74887146502175,0.689337363679469,0.21284877622947063,0.29825427727052867,138325.67214965823,4012.4089558919277,142338.08110555017,1170,154,794.2105263157895,31,7,14,25.972815323678667,0.714717741935484,37.01171875,1051.9531250000002,33.93397177419356,0
1172,4,0,0,38,0.0,0.0,1.0,38,900,600,300,0.6666666666666666,12,6,6,422.34689091599506,0.6879445234708392,0.2117701454824883,0.30100595876393943,138428.42102050784,4092.9626464843755,142521.38366699222,1171,155,795.2105263157895,31,7,14,25.802709725315513,0.715725806451613,36.9140625,1052.3437500000002,33.94657258064517,0
1173,4,0,0,38,0.0,0.0,1.0,38,750,500,250,0.6666666666666666,10,5,5,422.6569201920382,0.6870258416311048,0.21673339192136165,0.3021380371134066,138531.20803833008,4110.234747992622,142641.4427863227,1172,156,796.2105263157895,31,7,15,25.692769532055244,0.716733870967742,36.81640625,1052.734375,33.959173387096776,0
1174,4,0,0,38,0.0,0.0,1.0,38,1250,1000,250,0.8,15,10,5,412.030912883923,0.6849217638691323,0.16650247518656247,0.28312220605560884,137169.8685601692,3703.645232602854,140873.51379277208,1173,157,797.2105263157895,33,5,17,27.32218062704726,0.6982323232323231,38.11274509803922,1047.5490196078435,31.74390968508617,4
1175,4,0,0,38,0.0,0.0,1.0,38,1200,1000,200,0.8333333333333334,14,10,4,413.4145750941421,0.6847735893788526,0.16420818686088223,0.28433477091551285,137201.96446378817,3744.258368175724,140946.2228319639,1174,158,798.2105263157895,33,5,17,27.25404043357898,0.6985479797979797,38.082107843137265,1047.6715686274524,31.747623291740982,0
1176,4,0,0,38,0.0,0.0,1.0,38,800,400,400,0.5,12,4,8,410.2334171362163,0.6833807491702228,0.16151346560976787,0.2829287244636231,137298.27470203783,3664.8680795847954,140963.14278162262,1175,159,799.2105263157895,33,5,18,27.241678359837863,0.6994949494949494,37.99019607843138,1048.0392156862756,31.75876411170532,0
1177,4,0,0,38,0.0,0.0,1.0,38,700,500,200,0.7142857142857143,9,5,4,411.07722199089255,0.6823731626363205,0.15882063428588955,0.2842979494043725,137394.61873137747,3695.95963691851,141090.57836829597,1176,160,800.2105263157895,33,5,18,27.123879797389446,0.7004419191919191,37.8982843137255,1048.406862745099,31.769904931669668,0
1178,4,0,0,38,0.0,0.0,1.0,38,850,500,350,0.5882352941176471,12,5,7,414.67481885833956,0.6808025130393551,0.16177537791663088,0.2875840437430852,137490.99655180707,3802.810817954645,141293.80736976172,1177,161,801.2105263157895,33,5,18,26.933863052114987,0.7013888888888888,37.80637254901961,1048.7745098039222,31.781045751634007,0
1179,4,0,1,37,0.0,0.02631578947368421,0.9736842105263158,38,1000,800,200,0.8,12,8,4,416.9174163682418,0.6804172593646278,0.16346532218396437,0.28967638669741474,137555.26720492123,3869.837322183785,141425.10452710502,1178,162,802.2105263157895,33,5,18,26.81123442367602,0.702020202020202,37.74509803921569,1049.0196078431377,31.788472964943566,0
1180,4,0,0,37,0.0,0.0,1.0,37,1000,800,200,0.8,12,8,4,418.78681189759516,0.6769894894894894,0.1653626065631204,0.29178775185346695,137651.70134383414,4129.343431612848,141781.044775447,1179,163,797.0540540540541,33,4,19,26.666447701350776,0.7029671717171717,37.65318627450981,1049.3872549019611,31.799613784907912,0
1181,4,0,0,37,0.0,0.0,1.0,37,1300,900,400,0.6923076923076923,17,9,8,419.34037832486234,0.6769894894894894,0.17303924913012558,0.2943875617961628,137911.949753214,4166.503701145223,142078.45345435923,1180,164,798.0540540540541,32,5,20,26.3936470729655,0.7080078125,37.40530303030303,1050.378787878788,32.824337121212125,0
1182,4,0,0,37,0.0,0.0,1.0,37,400,200,200,0.5,6,2,4,418.03077544069384,0.6773648648648649,0.1659948615843343,0.2940350027423513,137978.26951650353,4135.832599989811,142114.10211649333,1181,165,799.0540540540541,32,5,20,26.36226615390779,0.7086588541666666,37.34217171717172,1050.6313131313138,32.83222853535356,0
1183,4,0,0,37,0.0,0.0,1.0,37,850,600,250,0.7058823529411765,11,6,5,417.31193995224265,0.6764264264264265,0.16238297651249756,0.2940971444726941,138044.60522204373,4121.532401030518,142166.13762307423,1182,166,800.0540540540541,32,5,15,26.31538107252994,0.7093098958333333,37.27904040404041,1050.8838383838388,32.84011994949496,0
1184,4,0,0,37,0.0,0.0,1.0,37,700,300,400,0.42857142857142855,11,3,8,418.83189178612645,0.6778653653653653,0.1629671949153093,0.29602668344747796,138144.1386720744,4171.834187837987,142315.97285991238,1183,167,801.0540540540541,32,5,17,26.176785571302744,0.7102864583333333,37.18434343434344,1051.262626262627,32.851957070707094,0
1185,4,0,0,37,0.0,0.0,1.0,37,800,600,200,0.75,10,6,4,418.83189178612645,0.6776151151151151,0.1629671949153093,0.29602668344747796,138144.1386720744,4171.834187837987,142315.97285991238,1184,168,802.0540540540541,32,5,17,26.176785571302744,0.7102864583333333,37.18434343434344,1051.262626262627,32.851957070707094,0
1186,4,0,0,37,0.0,0.0,1.0,37,650,300,350,0.46153846153846156,10,3,7,417.78788886768604,0.6773648648648649,0.15895583265353674,0.2960394611373754,138231.01579020103,4150.248852604783,142381.26464280582,1185,169,803.0540540540541,33,4,17,26.118143767237697,0.7086489898989898,37.10171568627452,1051.593137254903,31.86645870469403,0
1187,4,0,0,37,0.0,0.0,1.0,37,1250,1000,250,0.8,15,10,5,412.75626631239226,0.6766141141141141,0.16052568637570963,0.2944145195258159,138456.63326605147,4029.7685986159095,142486.4018646674,1186,170,804.0540540540541,33,4,18,26.027111473373694,0.7108585858585859,36.88725490196078,1052.4509803921565,31.892453951277467,0
1188,4,0,0,37,0.0,0.0,1.0,37,1000,700,300,0.7,13,7,6,415.0717886976136,0.6753628628628628,0.16284798359062114,0.29690938690268104,138553.3827884708,4101.9200848231485,142655.30287329396,1187,171,805.0540540540541,33,4,18,25.87046036549878,0.7118055555555556,36.7953431372549,1052.8186274509806,31.903594771241835,0
1189,4,0,0,37,0.0,0.0,1.0,37,700,500,200,0.7142857142857143,9,5,4,415.0717886976136,0.6757382382382382,0.16284798359062114,0.29690938690268104,138553.3827884708,4101.9200848231485,142655.30287329396,1188,172,806.0540540540541,33,4,18,25.87046036549878,0.7118055555555556,36.7953431372549,1052.8186274509806,31.903594771241835,0
1190,4,0,0,37,0.0,0.0,1.0,37,900,600,300,0.6666666666666666,12,6,6,416.3574775389303,0.6739864864864865,0.16525078552310046,0.29839531313528184,138617.9012429115,4142.919940647844,142760.82118355934,1189,173,807.0540540540541,33,4,18,25.77279471662983,0.7124368686868687,36.73406862745099,1053.063725490197,31.91102198455142,0
1191,4,0,0,37,0.0,0.0,1.0,37,500,400,100,0.8,6,4,2,416.3574775389303,0.6739864864864865,0.16525078552310046,0.29839531313528184,138617.9012429115,4142.919940647844,142760.82118355934,1190,174,808.0540540540541,33,4,18,25.77279471662983,0.7124368686868687,36.73406862745099,1053.063725490197,31.91102198455142,0
1192,4,0,0,37,0.0,0.0,1.0,37,950,600,350,0.631578947368421,13,6,7,419.17690598064604,0.6736736736736737,0.1681625772852211,0.30070169699479743,138650.16610198002,4223.789528066129,142873.95563004614,1191,175,809.0540540540541,33,4,18,25.666647273291435,0.7127525252525253,36.70343137254902,1053.186274509804,31.91473559120618,0
1193,4,0,0,37,0.0,0.0,1.0,37,900,600,300,0.6666666666666666,12,6,6,417.5868482121067,0.6726101101101101,0.1656458692289311,0.30013181833037383,138714.70708381402,4185.087466359106,142899.79455017313,1192,176,810.0540540540541,33,4,18,25.644679695982628,0.7133838383838385,36.642156862745104,1053.4313725490204,31.922162804515768,0
1194,4,0,1,36,0.0,0.02702702702702703,0.972972972972973,37,1050,800,250,0.7619047619047619,13,8,5,415.6832817223815,0.6709834834834835,0.1655637258754623,0.2990484663570975,138746.9832065793,4134.960261678212,142881.9434682575,1193,177,811.0540540540541,33,4,18,25.66290081811485,0.7136994949494949,36.61151960784314,1053.553921568628,31.92587641117055,0
1195,4,0,0,36,0.0,0.0,1.0,36,1100,900,200,0.8181818181818182,13,9,4,423.44931077592673,0.670271164021164,0.15637422511327959,0.2770093118120095,135430.30632866747,4269.761702886951,139700.06803155443,1194,178,802.1111111111111,31,5,20,28.759590526228006,0.6861559139784947,39.77864583333333,1040.885416666666,33.57694892473116,6
1196,4,0,0,36,0.0,0.0,1.0,36,950,700,250,0.7368421052631579,12,7,5,423.300053465248,0.6702050264550266,0.1556076714613297,0.27717313083166745,135464.1914367676,4268.399895562066,139732.59133232967,1195,179,803.1111111111111,31,5,20,28.729544506983533,0.686491935483871,39.74609375,1041.0156250000002,33.58114919354839,0
1197,4,0,0,36,0.0,0.0,1.0,36,850,400,450,0.47058823529411764,13,4,9,424.39154424765195,0.6693783068783069,0.158643827623572,0.27867681206015776,135565.87219238287,4306.601969401041,139872.4741617839,1196,180,804.1111111111111,31,5,20,28.599337334333583,0.6875,39.6484375,1041.4062500000005,33.593750000000014,0
1198,4,0,1,35,0.0,0.027777777777777776,0.9722222222222222,36,750,400,350,0.5333333333333333,11,4,7,424.20088734369716,0.6685515873015874,0.1565438735397482,0.2788153572606601,135599.77425469286,4304.308912489144,139904.08316718202,1197,181,805.1111111111111,31,5,20,28.57036817102137,0.6878360215053764,39.615885416666664,1041.536458333333,33.59795026881719,0
1199,4,0,0,35,0.0,0.0,1.0,35,400,200,200,0.5,6,2,4,424.20088734369716,0.6655462184873949,0.1538120836533139,0.2788153572606601,135599.77425469286,4504.308912489144,140104.08316718202,1198,182,800.6,31,4,20,28.57036817102137,0.6878360215053764,39.615885416666664,1041.536458333333,33.59795026881719,0
1200,4,0,0,35,0.0,0.0,1.0,35,1000,900,100,0.9,11,9,2,418.9028853912182,0.6684173669467787,0.1497356544165056,0.2769473040246288,135808.74821149837,4378.139535985729,140186.8877474841,1199,183,801.6,30,5,20,28.499355254674402,0.6927083333333334,39.41532258064515,1042.3387096774186,34.744623655913955,0
1201,4,0,0,35,0.0,0.0,1.0,35,700,400,300,0.5714285714285714,10,4,6,416.6389607101169,0.6681372549019607,0.1483238782877776,0.2757211415757392,135843.77529194104,4319.561871314575,140163.3371632556,1200,184,802.6,30,5,20,28.52334751590167,0.6930555555555555,39.381720430107514,1042.473118279568,34.74910394265227,0
1202,4,0,0,35,0.0,0.0,1.0,35,600,500,100,0.8333333333333334,7,5,2,418.410287179276,0.669047619047619,0.1516248411982406,0.2777113274785284,135948.883631778,4376.482288414816,140325.36592019282,1201,185,803.6,30,5,18,28.37215921295699,0.6940972222222224,39.28091397849461,1042.8763440860196,34.76254480286732,0
1203,4,0,0,35,0.0,0.0,1.0,35,400,300,100,0.75,5,3,2,418.410287179276,0.669047619047619,0.1516248411982406,0.2777113274785284,135948.883631778,4376.482288414816,140325.36592019282,1202,186,804.6,30,5,18,28.37215921295699,0.6940972222222224,39.28091397849461,1042.8763440860196,34.76254480286732,0
1204,4,0,0,35,0.0,0.0,1.0,35,400,100,300,0.25,7,1,6,418.65966096290805,0.6686974789915966,0.14952871870397644,0.2781505966671374,135983.9287778933,4386.197103711401,140370.1258816047,1203,187,805.6,30,5,18,28.330648625429557,0.6944444444444445,39.247311827956985,1043.0107526881714,34.76702508960571,0
1205,4,0,0,35,0.0,0.0,1.0,35,700,400,300,0.5714285714285714,10,4,6,419.9810670250844,0.6679271708683473,0.15351208111738868,0.27985519513439727,136089.09131474726,4430.968356168331,140520.0596709156,1204,188,806.6,30,5,18,28.191152475417592,0.6954861111111112,39.14650537634408,1043.4139784946228,34.78046594982076,0
1206,4,0,0,35,0.0,0.0,1.0,35,650,300,350,0.46153846153846156,10,3,7,418.65533902443553,0.6684173669467787,0.14928074758103094,0.2798001172860382,136194.29449936398,4403.693707365001,140597.98820672897,1205,189,807.6,30,5,18,28.120707786076064,0.6965277777777779,39.04569892473118,1043.8172043010745,34.793906810035814,0
1207,4,0,0,35,0.0,0.0,1.0,35,650,500,150,0.7692307692307693,8,5,3,418.192639033374,0.6668767507002801,0.14673067372951487,0.2797676337099237,136229.3712604057,4394.024056249254,140623.39531665493,1206,190,808.6,30,5,19,28.09777477361485,0.6968750000000001,39.01209677419354,1043.9516129032247,34.79838709677416,0
1208,4,0,0,35,0.0,0.0,1.0,35,600,300,300,0.5,9,3,6,418.6524086137986,0.6678571428571428,0.14660783232211827,0.28090925862946586,136334.6286420395,4415.3641316915155,140749.992773731,1207,191,809.6,30,5,19,27.980748605748612,0.6979166666666667,38.91129032258064,1044.3548387096769,34.81182795698923,0
1209,4,0,0,35,0.0,0.0,1.0,35,800,400,400,0.5,12,4,8,420.387987929394,0.665266106442577,0.15122937263405523,0.28319724594134377,136475.0350474043,4474.493077234356,140949.52812463866,1208,192,810.6,30,5,19,27.795375611011064,0.6993055555555556,38.776881720430104,1044.8924731182792,34.82974910394264,0
1210,4,0,0,35,0.0,0.0,1.0,35,1000,500,500,0.5,15,5,10,420.4299518864864,0.6643557422969187,0.15407718449193086,0.28438349483543374,136618.80705091686,4487.727695041228,141106.53474595808,1209,193,811.6,31,4,19,27.65093722755013,0.6979166666666667,38.639322916666664,1045.4427083333333,33.72395833333333,0
1211,4,0,0,35,0.0,0.0,1.0,35,500,400,100,0.8,6,4,2,420.4299518864864,0.6643557422969187,0.15407718449193086,0.28438349483543374,136618.80705091686,4487.727695041228,141106.53474595808,1210,194,812.6,31,4,19,27.65093722755013,0.6979166666666667,38.639322916666664,1045.4427083333333,33.72395833333333,0
1212,4,0,0,35,0.0,0.0,1.0,35,650,500,150,0.7692307692307693,8,5,3,421.51210668585594,0.665266106442577,0.1579647749510762,0.2853914179331722,136652.84050835497,4520.165337456588,141173.00584581157,1211,195,813.6,31,4,19,27.588729763387295,0.698252688172043,38.60677083333333,1045.572916666666,33.728158602150515,0
1213,4,0,0,35,0.0,0.0,1.0,35,600,300,300,0.5,9,3,6,419.83460579990793,0.6626750700280112,0.15458167330677286,0.2848067190696671,136720.9201388888,4480.051676432272,141200.97181532107,1212,196,814.6,30,5,19,27.564741035856574,0.7017361111111111,38.54166666666666,1045.8333333333323,34.86111111111108,0
1214,4,0,0,35,0.0,0.0,1.0,35,900,400,500,0.4444444444444444,14,4,10,417.90051881669757,0.661624649859944,0.1489119665333385,0.2849188651056748,136896.68783963454,4441.839374494149,141338.5272141287,1213,197,815.6,30,5,19,27.440277421012066,0.7034722222222223,38.37365591397849,1046.5053763440853,34.88351254480285,0
1215,4,0,0,35,0.0,0.0,1.0,35,950,800,150,0.8421052631578947,11,8,3,416.8057764256362,0.6626050420168067,0.14333033765566872,0.2850307456171447,137002.20265709897,4420.661890102888,141422.86454720187,1214,198,816.6,30,5,17,27.36391064321479,0.7045138888888889,38.272849462365585,1046.9086021505366,34.89695340501789,0
1216,4,0,0,35,0.0,0.0,1.0,35,950,700,250,0.7368421052631579,12,7,5,414.27155526120026,0.6598039215686274,0.14481019850147359,0.28489136184885616,137197.95227050784,4367.441813151041,141565.39408365887,1215,199,817.6,31,4,17,27.23558289833457,0.7036290322580645,38.0859375,1047.6562500000002,33.795362903225815,0
1217,4,0,0,35,0.0,0.0,1.0,35,850,500,350,0.5882352941176471,12,5,7,411.9616298234451,0.6589635854341737,0.14098267537631393,0.2838584928783463,137266.16753472216,4309.678819444433,141575.8463541666,1216,200,818.6,31,4,17,27.22829688535454,0.7043010752688172,38.02083333333333,1047.916666666666,33.803763440860195,0
1218,4,0,0,35,0.0,0.0,1.0,35,500,400,100,0.8,6,4,2,413.16309575523417,0.657843137254902,0.1446355359139555,0.28496570331909854,137300.2815246582,4345.481872558593,141645.7633972168,1217,201,819.6,31,4,17,27.16292396571002,0.7046370967741936,37.98828125,1048.046875,33.807963709677416,0
1219,4,0,0,35,0.0,0.0,1.0,35,950,700,250,0.7368421052631579,12,7,5,413.08961845607803,0.6570028011204482,0.1448802129547473,0.2851948051948051,137334.39975314666,4346.2829589843695,141680.68271213103,1218,202,820.6,31,4,17,27.130952380952383,0.70497311827957,37.955729166666664,1048.177083333333,33.81216397849462,0
1220,4,0,0,35,0.0,0.0,1.0,35,550,200,350,0.36363636363636365,9,2,7,412.88565075379864,0.6560224089635854,0.14814578345304574,0.28645942436019367,137505.05447387698,4354.772779676649,141859.82725355364,1219,203,821.6,31,4,17,26.966816677012208,0.7066532258064516,37.79296875,1048.8281250000002,33.833165322580655,0
1221,4,0,0,35,0.0,0.0,1.0,35,750,500,250,0.6666666666666666,10,5,5,413.2377278565167,0.6568627450980392,0.14931470416142179,0.2872697474840339,137573.34603203658,4370.099385579416,141943.445417616,1220,204,822.6,31,4,17,26.889790451367347,0.7073252688172044,37.72786458333333,1049.0885416666658,33.84156586021503,0
1222,4,0,1,34,0.0,0.02857142857142857,0.9714285714285714,35,1000,800,200,0.8,12,8,4,408.6448411110225,0.655952380952381,0.14709677419354894,0.28492019198571267,137675.81515842004,4252.102322048601,141927.91748046863,1221,205,823.6,31,4,17,26.908602150537632,0.7083333333333334,37.63020833333333,1049.4791666666658,33.85416666666664,0
1223,4,0,0,34,0.0,0.0,1.0,34,500,300,200,0.6,7,3,4,410.03669437115605,0.6533348187759953,0.14766449936878345,0.2861736617598174,137709.98001098636,4493.228997124565,142203.20900811092,1222,206,826.4411764705883,31,3,17,26.838197287350614,0.7086693548387097,37.59765625,1049.6093750000002,33.85836693548388,0
1224,4,0,0,34,0.0,0.0,1.0,34,650,500,150,0.7692307692307693,8,5,3,411.9425547996975,0.6527035056446822,0.14985994397759073,0.2883597883597883,137812.50000000003,4554.166666666666,142366.6666666667,1223,207,827.4411764705883,31,3,18,26.68650793650793,0.7096774193548387,37.5,1050.0000000000002,33.870967741935495,0
1225,4,0,0,34,0.0,0.0,1.0,34,550,200,350,0.36363636363636365,9,2,7,412.49536372498505,0.650772430184195,0.14248681994181078,0.28960836372231985,137915.05813598636,4577.8644137912315,142492.92254977758,1224,208,828.4411764705883,31,3,18,26.57031217718276,0.7106854838709677,37.40234375,1050.3906250000002,33.8835685483871,0
1226,4,0,0,34,0.0,0.0,1.0,34,650,400,250,0.6153846153846154,9,4,5,410.08659341559303,0.6504753416518123,0.13594147536322754,0.28849073428687166,137983.45141940637,4517.032708062056,142500.48412746843,1225,209,829.4411764705883,31,3,18,26.565791919692646,0.7113575268817205,37.33723958333333,1050.6510416666658,33.891969086021476,0
1227,4,0,0,34,0.0,0.0,1.0,34,550,300,250,0.5454545454545454,8,3,5,409.84039539681294,0.6495840760546643,0.13499675672523992,0.28889273635350876,138051.86165703656,4515.845913357184,142567.70757039374,1226,210,830.4411764705883,31,3,17,26.50448622640729,0.7120295698924732,37.27213541666666,1050.9114583333323,33.900369623655884,0
1228,4,0,0,34,0.0,0.0,1.0,34,850,700,150,0.8235294117647058,10,7,3,403.369696930363,0.6495840760546643,0.14432106696032565,0.25102910265277917,133611.14724245577,3981.586689264844,137592.7339317206,1227,211,831.4411764705883,30,4,18,31.106452591436984,0.6708333333333334,41.53225806451613,1033.8709677419354,34.46236559139785,7
1229,4,0,1,33,0.0,0.029411764705882353,0.9705882352941176,34,750,600,150,0.8,9,6,3,404.01296843051006,0.6487299465240642,0.14309903298551419,0.252139480297873,133715.38843002077,4004.5502008902727,137719.93863091106,1228,212,832.4411764705883,30,4,16,30.98494693523933,0.671875,41.431451612903224,1034.2741935483868,34.4758064516129,0
1230,4,0,0,33,0.0,0.0,1.0,33,600,400,200,0.6666666666666666,8,4,4,403.8530769696788,0.6385732323232324,0.14918899345448255,0.25299144341656277,133854.43990996067,4211.50548473812,138065.9453946988,1229,213,841.8787878787879,30,3,16,30.84924449062649,0.6732638888888889,41.29704301075269,1034.8118279569892,34.49372759856631,0
1231,4,0,0,33,0.0,0.0,1.0,33,850,800,50,0.9411764705882353,9,8,1,406.85127812956756,0.6410984848484849,0.1527776139067507,0.256319631887843,134063.1526224131,4308.752998901618,138371.9056213147,1230,214,842.8787878787879,30,3,17,30.561864590093016,0.6753472222222222,41.09543010752689,1035.6182795698933,34.52060931899644,0
1232,4,0,0,33,0.0,0.0,1.0,33,1000,800,200,0.8,12,8,4,407.1309896196646,0.6392834595959597,0.15449708851744814,0.25731066595740026,134179.53703138558,4325.729539659284,138505.26657104486,1231,215,843.8787878787879,31,2,18,30.437691131498475,0.67372311827957,40.983072916666664,1036.067708333333,33.42153897849462,0
1233,4,0,0,33,0.0,0.0,1.0,33,900,600,300,0.6666666666666666,12,6,6,405.01309000056375,0.6377051767676768,0.152447962474348,0.2564438491101421,134246.99783325195,4274.358283148872,138521.35611640083,1232,216,844.8787878787879,31,2,18,30.42480734598149,0.6743951612903225,40.91796875,1036.328125,33.42993951612903,0
1234,4,0,0,33,0.0,0.0,1.0,33,900,700,200,0.7777777777777778,11,7,4,404.26251862326717,0.6378630050505051,0.15252017664077977,0.25620458982812144,134280.73459201385,4256.933593749995,138537.66818576385,1233,217,845.8787878787879,31,2,18,30.410385259631497,0.674731182795699,40.885416666666664,1036.458333333333,33.434139784946225,0
1235,4,0,0,33,0.0,0.0,1.0,33,650,300,350,0.46153846153846156,10,3,7,400.12304172373666,0.6356534090909092,0.14666755207295745,0.2547760205208351,134452.5510789715,4159.51274104683,138612.06382001835,1234,218,846.8787878787879,32,1,19,30.345294618943264,0.673828125,40.71969696969697,1037.121212121212,32.410037878787875,0
1236,4,0,0,33,0.0,0.0,1.0,33,600,400,200,0.6666666666666666,8,4,4,398.00330227006197,0.634469696969697,0.14357056445664074,0.2538816095846917,134518.03387409452,4107.724339353136,138625.75821344764,1235,219,847.8787878787879,32,1,19,30.334611327491086,0.6744791666666666,40.65656565656566,1037.3737373737376,32.4179292929293,0
1237,4,0,0,33,0.0,0.0,1.0,33,550,400,150,0.7272727272727273,7,4,3,396.7335717283569,0.6332859848484849,0.14538153526734288,0.2535340684124519,134584.55615573455,4078.8463181907314,138663.4024739253,1236,220,848.8787878787879,31,2,19,30.30087944953361,0.677755376344086,40.592447916666664,1037.630208333333,33.471942204301065,0
1238,4,0,0,33,0.0,0.0,1.0,33,750,500,250,0.6666666666666666,10,5,5,395.4407410381898,0.6339962121212122,0.14681688941598625,0.2534126678100037,134685.90630425332,4052.058919270814,138737.96522352414,1237,221,849.8787878787879,31,2,19,30.232898478006355,0.6787634408602151,40.49479166666666,1038.0208333333321,33.48454301075265,0
1239,4,1,1,33,0.029411764705882353,0.029411764705882353,0.9705882352941176,34,700,500,200,0.7142857142857143,9,5,4,386.4222177834065,0.6497697563874035,0.14360744297719075,0.2500807937730349,135042.4701561066,3636.6821625344437,138679.15231864105,1238,0,825.8529411764706,32,2,16,30.11039237123421,0.6796875,40.151515151515156,1039.39393939394,32.48106060606062,0
1240,4,0,0,33,0.0,0.0,1.0,33,350,200,150,0.5714285714285714,5,2,3,396.36462044106264,0.6340751262626263,0.15075529619160544,0.2549519526320898,134821.09917534713,4087.6627604166565,138908.7619357638,1239,223,851.8787878787879,31,2,16,30.0735539953193,0.6801075268817205,40.36458333333333,1038.5416666666658,33.501344086021476,0
1241,4,0,0,33,0.0,0.0,1.0,33,850,500,350,0.5882352941176471,12,5,7,395.7982722730678,0.6347853535353536,0.15357384322037104,0.2550628930690254,134888.72104220916,4077.744547526037,138966.4655897352,1240,224,852.8787878787879,31,2,16,30.02057742124175,0.6807795698924732,40.299479166666664,1038.802083333333,33.509744623655905,0
1242,4,0,0,33,0.0,0.0,1.0,33,750,500,250,0.6666666666666666,10,5,5,399.0502572220024,0.636126893939394,0.15955039112933855,0.257639243740419,134956.35986328125,4170.8740234375,139127.23388671875,1241,225,853.8787878787879,31,2,16,29.868421052631575,0.6814516129032258,40.234375,1039.0625,33.51814516129032,0
1243,4,0,0,33,0.0,0.0,1.0,33,650,500,150,0.7692307692307693,8,5,3,400.00738318696415,0.6354166666666667,0.1538613395290922,0.2587405942138044,135024.01563856326,4202.120632595476,139226.13627115873,1242,226,854.8787878787879,31,2,16,29.775849828781432,0.6821236559139785,40.16927083333333,1039.3229166666658,33.52654569892471,0
1244,4,0,0,33,0.0,0.0,1.0,33,550,200,350,0.36363636363636365,9,2,7,402.20722005132507,0.635022095959596,0.1576486305945224,0.2606511724748196,135091.68836805545,4266.970486111091,139358.65885416654,1243,227,855.8787878787879,31,2,17,29.650968603874407,0.6827956989247312,40.10416666666666,1039.5833333333323,33.53494623655911,0
1245,4,0,0,33,0.0,0.0,1.0,33,550,400,150,0.7272727272727273,7,4,3,406.9464321128687,0.635022095959596,0.1656892732025541,0.24559683147208689,132465.01498752163,4208.359781901023,136673.37476942266,1244,228,856.8787878787879,31,2,19,32.170187199595226,0.6565860215053765,42.64322916666666,1029.4270833333326,33.20732526881718,7
1246,4,0,0,33,0.0,0.0,1.0,33,900,700,200,0.7777777777777778,11,7,4,403.3350308111693,0.6382575757575758,0.16524074775115816,0.24441463114404285,132618.811349601,4097.962472366381,136716.77382196736,1245,229,857.8787878787879,33,0,19,32.10774836406899,0.6530934343434345,42.4938725490196,1030.0245098039206,31.21286393345214,0
1247,4,0,0,33,0.0,0.0,1.0,33,750,500,250,0.6666666666666666,10,5,5,403.7928596068612,0.6380997474747475,0.16324058955199683,0.24510372351731977,132681.93310565632,4115.203437379834,136797.13654303615,1246,230,858.8787878787879,33,0,15,32.03221026129019,0.6537247474747476,42.43259803921568,1030.269607843136,31.2202911467617,0
1248,4,0,0,33,0.0,0.0,1.0,33,550,200,350,0.36363636363636365,9,2,7,404.66082322938314,0.6392834595959597,0.15954502205691545,0.2458372978116079,132713.4996155325,4140.790801614758,136854.29041714725,1247,231,859.8787878787879,33,0,15,31.97797732318426,0.6540404040404041,42.40196078431372,1030.392156862745,31.224004753416516,0
1249,4,0,0,33,0.0,0.0,1.0,33,750,600,150,0.8,9,6,3,403.28110621538474,0.6400726010101011,0.15605826424991798,0.2456189271815785,132808.22167255377,4111.809310121099,136920.03098267489,1248,232,860.8787878787879,33,0,15,31.91790017041175,0.6549873737373737,42.31004901960784,1030.7598039215682,31.235145573380855,0
1250,4,0,0,33,0.0,0.0,1.0,33,1000,700,300,0.7,13,7,6,421.09129166423867,0.6400726010101011,0.20522495951885267,0.25074072367279676,131956.93963860057,4513.183631295662,136470.12326989623,1249,233,861.8787878787879,33,0,15,32.32098839058524,0.6464646464646464,43.13725490196079,1027.4509803921571,31.13487819370173,7
1251,4,0,0,33,0.0,0.0,1.0,33,400,100,300,0.25,7,1,6,422.9477666802855,0.6409406565656566,0.20861609175465623,0.2522645783343437,132019.90370290267,4567.504685697799,136587.40838860045,1250,234,862.8787878787879,33,0,16,32.20943636219095,0.6470959595959596,43.07598039215686,1027.696078431372,31.14230540701127,0
1252,4,0,0,33,0.0,0.0,1.0,33,600,400,200,0.6666666666666666,8,4,4,428.1368147448015,0.6421243686868687,0.2122859025032937,0.2461786684782608,130617.28395061727,4584.9542376863565,135202.23818830363,1251,235,863.8787878787879,32,1,13,33.50317028985506,0.6354166666666667,44.44444444444444,1022.2222222222222,31.944444444444443,2
1253,4,1,0,34,0.029411764705882353,0.0,1.0,34,700,500,200,0.7142857142857143,9,5,4,421.75170409717504,0.6622846108140226,0.21197944168690808,0.24521471730910904,131045.64838343422,4253.745104046517,135299.39348748073,1252,0,839.4411764705883,33,1,16,33.22997705964492,0.6373106060606061,44.025735294117645,1023.8970588235292,31.027183600713006,0
1254,4,0,0,34,0.0,0.0,1.0,34,550,300,250,0.5454545454545454,8,3,5,420.16800945754983,0.6612819370172311,0.21199279137217397,0.24449330689605062,131077.01965590162,4214.874086889667,135291.8937427913,1253,1,840.4411764705883,33,1,16,33.23859103239191,0.6376262626262625,43.99509803921569,1024.0196078431377,31.030897207367808,0
1255,4,0,0,34,0.0,0.0,1.0,34,500,400,100,0.8,6,4,2,419.6205219628151,0.6614304812834225,0.20890868910378213,0.24457380213146485,131139.7734645328,4205.78803825451,135345.5615027873,1254,2,841.4411764705883,33,1,16,33.18876126665071,0.6382575757575758,43.93382352941176,1024.2647058823525,31.03832442067735,0
1256,4,0,0,34,0.0,0.0,1.0,34,300,100,200,0.3333333333333333,5,1,4,419.66281596432253,0.6605020796197267,0.20533345531058456,0.24479842837723453,131171.1560006968,4209.5313401095655,135380.68734080635,1255,3,842.4411764705883,33,1,16,33.155755273756824,0.6385732323232323,43.9031862745098,1024.3872549019602,31.042038027332126,0
1257,4,0,0,34,0.0,0.0,1.0,34,350,200,150,0.5714285714285714,5,2,3,420.3566768160071,0.6596479500891266,0.20917534477905986,0.24540375825292024,131202.54229142627,4230.3729334871105,135432.9152249134,1256,4,843.4411764705883,33,1,16,33.10606060606061,0.638888888888889,43.87254901960784,1024.509803921568,31.045751633986907,0
1258,4,0,0,34,0.0,0.0,1.0,34,900,700,200,0.7777777777777778,11,7,4,431.00548552861,0.6596479500891266,0.19975475386529262,0.23510681560641036,128548.11137843604,4286.4098243463895,132834.52120278243,1257,5,844.4411764705883,33,1,13,35.54972306143002,0.6120580808080809,46.4767156862745,1014.0931372549009,30.73009506833033,5
1259,4,2,1,35,0.05555555555555555,0.027777777777777776,0.9722222222222222,36,450,400,50,0.8888888888888888,5,4,1,411.17885440611076,0.6929232804232804,0.19439382434826658,0.22733944217164026,129083.7459276404,3415.301354595311,132499.0472822357,1258,0,798.4722222222222,35,1,14,35.50303720577068,0.6130952380952381,45.94907407407406,1016.2037037037021,29.03439153439149,0
1260,4,2,0,37,0.05405405405405406,0.0,1.0,37,650,500,150,0.7692307692307693,8,5,3,411.2321369258583,0.7077077077077077,0.22138727978144046,0.23038172131868706,129602.41280131477,3259.3354334063724,132861.74823472113,1259,0,777.8378378378378,36,1,15,34.97083056845831,0.6163194444444444,45.439189189189186,1018.2432432432428,28.284534534534522,0
1261,4,1,0,38,0.02631578947368421,0.0,1.0,38,600,400,200,0.6666666666666666,8,4,4,405.75629293668436,0.7238620199146515,0.22393332729413928,0.22887806426816837,129871.11418898105,2939.2043705755427,132810.3185595566,1260,0,758.3421052631579,37,1,16,34.8357716580608,0.6171171171171171,45.17543859649122,1019.2982456140337,27.548601232811723,0
1262,4,0,0,38,0.0,0.0,1.0,38,600,200,400,0.3333333333333333,10,2,8,404.84933259076263,0.7238027501185396,0.22113980369292774,0.2286931406092897,129927.00277970132,2920.1720721760385,132847.17485187735,1261,1,759.3421052631579,37,1,16,34.8018391051839,0.6176801801801803,45.12061403508771,1019.5175438596482,27.554528212422923,0
1263,4,0,0,38,0.0,0.0,1.0,38,950,700,250,0.7368421052631579,12,7,5,399.25734589874867,0.7250770507349454,0.21738601582964168,0.2263431498413196,130066.77685682116,2786.023223491826,132852.800080313,1262,2,760.3421052631579,37,1,16,34.801833637894575,0.6190878378378379,44.98355263157894,1020.0657894736828,27.569345661450885,0
1264,4,1,0,39,0.02564102564102564,0.0,1.0,39,750,500,250,0.6666666666666666,10,5,5,389.96860928676864,0.7365047233468286,0.2105692431108359,0.2225032835196206,130317.12420784925,2363.9175387172054,132681.04174656645,1263,0,741.8205128205128,38,1,17,34.78384081476056,0.6197916666666667,44.73824786324786,1021.0470085470076,26.869658119658094,0
1265,4,0,0,39,0.0,0.0,1.0,39,1200,900,300,0.75,15,9,6,392.12190172087753,0.7362235717498876,0.21516899584047366,0.22436131073329207,130426.23325525969,2428.596523668638,132854.82977892834,1264,1,742.8205128205128,38,1,17,34.617848551406745,0.6208881578947368,44.631410256410255,1021.4743589743589,26.880904183535762,0
1266,4,0,1,38,0.0,0.02564102564102564,0.9743589743589743,39,1150,800,350,0.6956521739130435,15,8,7,393.1356332703212,0.7357737291947819,0.21160813823857327,0.22605298913043484,130617.28395061739,2470.0617283950737,133087.34567901248,1265,2,743.8205128205128,38,1,14,34.39764492753623,0.6228070175438596,44.44444444444445,1022.2222222222231,26.90058479532166,0
1267,4,0,0,38,0.0,0.0,1.0,38,750,500,250,0.6666666666666666,10,5,5,405.3399990357393,0.7212837837837838,0.21913634284229677,0.23245313544701895,130514.55886667065,2980.554233033256,133495.1130997039,1266,3,764.2368421052631,37,1,14,34.19034141717637,0.6235923423423422,44.544956140350884,1021.8201754385975,27.616761498340473,0
1268,4,0,0,38,0.0,0.0,1.0,38,950,600,350,0.631578947368421,13,6,7,404.5202527215455,0.7208392603129445,0.21860176191551783,0.23215078542886752,130542.57079101277,2961.422745460159,133503.99353647293,1267,4,765.2368421052631,37,1,14,34.18276108726752,0.6238738738738738,44.51754385964913,1021.9298245614046,27.61972498814607,0
1269,4,0,1,37,0.0,0.02631578947368421,0.9736842105263158,38,650,500,150,0.7692307692307693,8,5,3,444.01007803951484,0.7206021811284969,0.26967200968164207,0.24323534095172375,128717.71541950104,3861.2915041362676,132579.0069236373,1268,5,766.2368421052631,34,4,14,35.04541099640232,0.6115196078431373,46.3095238095238,1014.7619047619039,29.845938375350116,4
1270,4,1,0,38,0.02631578947368421,0.0,1.0,38,400,200,200,0.5,6,2,4,444.3742529350358,0.719387150308203,0.28838143547401773,0.2443628628809102,128868.76594387741,3853.1923185940877,132721.9582624715,1269,0,767.078947368421,34,4,15,34.88074999022941,0.6130514705882353,46.16071428571428,1015.3571428571418,29.863445378151226,0
1271,4,0,0,38,0.0,0.0,1.0,38,1050,800,250,0.7619047619047619,13,8,5,444.35217344196775,0.7198020388809863,0.2867967704330556,0.24509742055464204,128989.67013888896,3863.368055555567,132853.03819444453,1270,1,768.078947368421,34,4,15,34.756972928630034,0.6142769607843137,46.04166666666667,1015.8333333333339,29.877450980392176,0
1272,4,1,0,39,0.02564102564102564,0.0,1.0,39,1050,500,550,0.47619047619047616,16,5,11,436.5561284131285,0.729757085020243,0.2892096393208414,0.24264795088050506,129292.1786422905,3488.832199546518,132781.010841837,1271,0,749.3589743589744,34,5,16,34.64434819930548,0.6173406862745097,45.744047619047635,1017.0238095238116,29.912464985994458,0
1273,4,0,0,39,0.0,0.0,1.0,39,500,400,100,0.8,6,4,2,436.3130786713429,0.7293072424651372,0.2854416821184902,0.24307246221155798,129383.00028344682,3490.299036281194,132873.29931972802,1272,1,750.3589743589744,34,5,17,34.557346516889,0.6182598039215685,45.65476190476191,1017.3809523809533,29.922969187675097,0
1274,4,0,0,39,0.0,0.0,1.0,39,900,500,400,0.5555555555555556,13,5,8,437.3224961849767,0.7293072424651372,0.2827261248129187,0.24419791116168296,129473.85381235828,3524.365787981859,132998.21960034015,1273,2,751.3589743589744,34,5,13,34.438482083674494,0.6191789215686274,45.56547619047619,1017.7380952380953,29.933473389355743,0
1275,4,0,1,38,0.0,0.02564102564102564,0.9743589743589743,39,750,400,350,0.5333333333333333,11,4,7,438.4698423072906,0.728463787674314,0.28037265516807275,0.24578447123830685,129625.34722222219,3567.3611111111068,133192.70833333328,1274,3,752.3589743589744,34,5,13,34.25395526459357,0.6207107843137255,45.416666666666664,1018.333333333333,29.950980392156854,0
1276,4,0,0,38,0.0,0.0,1.0,38,1100,700,400,0.6363636363636364,15,7,8,449.7377054290427,0.7164532954006638,0.28650147343071697,0.25118168416867515,129481.87183114664,4046.5759863994563,133528.44781754608,1275,6,773.078947368421,33,5,13,34.11436383704596,0.6215277777777778,45.557598039215684,1017.769607843137,30.84150326797385,0
1277,4,1,1,38,0.02564102564102564,0.02564102564102564,0.9743589743589743,39,1500,1300,200,0.8666666666666667,17,13,4,442.0419190121244,0.7286887089518669,0.28585243375655756,0.24864504875806562,129760.9247068971,3671.9536340449004,133432.878340942,1276,0,754.2307692307693,35,4,13,34.024030633496146,0.6199404761904763,45.2835648148148,1018.8657407407393,29.110449735449695,0
1278,4,2,1,39,0.05,0.025,0.975,40,900,500,400,0.5555555555555556,13,5,8,438.55483921270525,0.7438301282051282,0.2855794701986758,0.2489540628613476,130118.92804967123,3412.857113870618,133531.78516354185,1277,0,736.325,36,4,14,33.74632082413539,0.6215277777777779,44.93243243243243,1020.2702702702697,28.340840840840826,0
1279,4,1,0,40,0.025,0.0,1.0,40,1050,1000,50,0.9523809523809523,11,10,1,482.47078983158394,0.7444444444444445,0.31757775683317657,0.2572369386991508,127632.76643990916,4369.662402336131,132002.42884224528,1278,0,737.3,34,6,15,35.19282123782594,0.6004901960784315,47.38095238095237,1010.4761904761893,29.71988795518204,6
1280,4,4,3,41,0.09090909090909091,0.06818181818181818,0.9318181818181819,44,1050,800,250,0.7619047619047619,13,8,5,443.3721013623517,0.7881650810429881,0.2902038753899556,0.24204139253791668,128579.18228565915,2606.804204524918,131185.98649018406,1279,0,671.1818181818181,33,11,15,35.204204929917815,0.6123737373737375,46.446078431372534,1014.215686274508,30.73380867498509,0
1281,4,2,1,42,0.046511627906976744,0.023255813953488372,0.9767441860465116,43,900,500,400,0.5555555555555556,13,5,8,436.66282632791,0.7781469176818013,0.26700140944327,0.2260372277462121,126432.65306122445,2441.687925170063,128874.34098639451,1280,0,687.7441860465116,34,9,14,37.59247750946972,0.588235294117647,48.57142857142857,1005.7142857142853,29.579831932773097,8
1282,4,4,3,43,0.08695652173913043,0.06521739130434782,0.9347826086956522,46,1250,1000,250,0.8,15,10,5,416.4483615723599,0.802999194847021,0.3081271689242129,0.21591022715762587,126496.56994409962,1337.5727121564605,127834.14265625608,1281,0,643.7391304347826,36,10,13,38.03453487070413,0.5847800925925926,48.50788288288289,1005.9684684684694,27.943568568568594,1
1283,4,5,3,45,0.10416666666666667,0.0625,0.9375,48,1200,800,400,0.6666666666666666,16,8,8,403.21546214727266,0.8206080082742316,0.31279897803870393,0.2124155682033572,127147.3013331026,654.9497200183782,127802.25105312098,1282,0,617.75,37,11,15,37.69524171921432,0.5895270270270269,47.861842105263165,1008.5526315789483,27.25817923186347,0
1284,4,1,0,46,0.021739130434782608,0.0,1.0,46,1450,900,550,0.6206896551724138,20,9,11,418.28335332470385,0.8031803542673108,0.3385460939511249,0.21959262730847096,127006.86486740141,1424.9714663988561,128431.83633380027,1283,0,645.5869565217391,36,10,16,37.460432726324804,0.5899884259259258,48.00112612612614,1007.9954954954974,27.999874874874926,0
1285,4,2,2,46,0.041666666666666664,0.041666666666666664,0.9583333333333334,48,1100,900,200,0.8181818181818182,13,9,4,408.26602164595255,0.8160091607565012,0.3368884787957733,0.217144722367351,127534.65008464157,813.6413760142322,128348.2914606558,1284,0,619.6458333333334,37,11,15,37.16845780865536,0.5934684684684683,47.4780701754386,1010.0877192982468,27.299668089141807,0
1286,4,0,0,46,0.0,0.0,1.0,46,1350,800,550,0.5925925925925926,19,8,11,423.4741238320568,0.800462962962963,0.3462034741861466,0.22419365457216345,127347.63215495911,1585.6853897816836,128933.3175447408,1285,1,647.4782608695652,36,10,15,36.977481498010334,0.5934606481481481,47.66328828828829,1009.3468468468476,28.037412412412433,0
1287,4,0,1,45,0.0,0.021739130434782608,0.9782608695652174,46,1150,1000,150,0.8695652173913043,13,10,3,427.61986454989017,0.7998590982286635,0.3510459804672721,0.2268662547665277,127432.89531085145,1698.567486405333,129131.46279725678,1286,2,648.4782608695652,36,10,15,36.784798126254756,0.5943287037037037,47.57882882882883,1009.6846846846852,28.046796796796812,0
1288,4,1,2,44,0.021739130434782608,0.043478260869565216,0.9565217391304348,46,650,300,350,0.46153846153846156,10,3,7,426.1345324559679,0.7984903381642512,0.34608075088236423,0.22639659283561137,127489.75326678027,1665.5572802532242,129155.3105470335,1287,0,649.3913043478261,36,10,15,36.76358534046981,0.5949074074074074,47.52252252252252,1009.9099099099099,28.053053053053052,0
1289,4,3,2,45,0.06382978723404255,0.0425531914893617,0.9574468085106383,47,900,700,200,0.7777777777777778,11,7,4,417.72750324806265,0.8124807277212457,0.33510003761072693,0.22355573461696962,127783.97108966221,1275.7758396814422,129059.74692934366,1288,0,636.4042553191489,37,10,16,36.67251834580488,0.5960022522522522,47.23135964912281,1011.0745614035088,27.32633949739213,0
1290,4,2,2,45,0.0425531914893617,0.0425531914893617,0.9574468085106383,47,1550,1200,350,0.7741935483870968,19,12,7,413.2050191563757,0.8110931236509404,0.3317285965931627,0.22220605575612074,127978.05574792232,1176.234995383182,129154.29074330551,1289,0,637.3617021276596,37,10,16,36.58701777199826,0.597972972972973,47.03947368421052,1011.8421052631569,27.347083926031267,0
1291,4,0,0,45,0.0,0.0,1.0,45,1450,1200,250,0.8275862068965517,17,12,5,429.97279832247864,0.7936868686868688,0.33757025507998306,0.23049707433998876,127851.72994898827,1994.5532193072613,129846.28316829553,1290,2,666.6888888888889,35,10,16,36.29310673685816,0.6005952380952382,47.16435185185185,1011.342592592592,28.89550264550263,0
1292,4,2,1,46,0.0425531914893617,0.02127659574468085,0.9787234042553191,47,1050,700,350,0.6666666666666666,14,7,7,420.7622222222225,0.8071615787850754,0.3378392434988182,0.22867512077294688,128401.20525931322,1405.6101901607399,129806.81544947397,1291,0,639.2765957446809,36,11,16,35.96041666666667,0.6041666666666667,46.621621621621614,1013.5135135135124,28.153153153153124,0
1293,4,1,1,46,0.02127659574468085,0.02127659574468085,0.9787234042553191,47,1950,1700,250,0.8717948717948718,22,17,5,416.9409246081749,0.8112473018809744,0.3311399104516406,0.22741084349464638,128543.91289515857,1319.0435790520146,129862.95647421059,1292,0,640.2553191489362,36,11,16,35.91060521932259,0.605613425925926,46.48085585585585,1014.0765765765758,28.16879379379377,0
1294,4,3,2,47,0.061224489795918366,0.04081632653061224,0.9591836734693877,49,1400,900,500,0.6428571428571429,19,9,10,403.6481604951793,0.8194090136054422,0.33573681838666136,0.22292067400169271,129038.51290269532,617.2316732412603,129655.74457593658,1293,0,615.0612244897959,38,11,18,35.74066771819137,0.6069078947368423,45.99358974358973,1016.0256410256388,26.73751686909576,0
1295,4,1,1,47,0.020833333333333332,0.020833333333333332,0.9791666666666666,48,750,500,250,0.6666666666666666,10,5,5,408.7047200585396,0.8244126773049645,0.3698310981325257,0.2225491072827596,128477.80687326878,901.8972183748949,129379.70409164368,1294,0,602.2916666666666,37,11,15,36.187270170884716,0.6030405405405406,46.54605263157895,1013.815789473685,27.400426742532026,1
1296,4,2,2,47,0.04081632653061224,0.04081632653061224,0.9591836734693877,49,1400,1100,300,0.7857142857142857,17,11,6,402.9191442099457,0.8317743764172336,0.36103774983721926,0.22054888256840705,128685.96734832741,570.007967163446,129255.97531549085,1295,0,590.9591836734694,38,11,15,36.12039766943948,0.6033442982456139,46.34081196581198,1014.6367521367545,26.700967161493537,0
1297,4,1,1,47,0.020833333333333332,0.020833333333333332,0.9791666666666666,48,1050,600,450,0.5714285714285714,15,6,9,409.8649769724936,0.8279218380614657,0.37048825098208793,0.22364844672676096,128561.19340806801,938.5461151508322,129499.73952321884,1296,0,604.25,37,11,15,36.07225555915956,0.6038851351351351,46.46381578947369,1014.1447368421065,27.409317211948824,0
1298,4,1,1,47,0.020833333333333332,0.020833333333333332,0.9791666666666666,48,700,400,300,0.5714285714285714,10,4,6,409.8649769724936,0.827164598108747,0.37048825098208793,0.22364844672676096,128561.19340806801,938.5461151508322,129499.73952321884,1297,0,605.2291666666666,37,11,15,36.07225555915956,0.6038851351351351,46.46381578947369,1014.1447368421065,27.409317211948824,0
1299,4,3,3,47,0.06,0.06,0.94,50,1250,700,550,0.56,18,7,11,405.3614466494799,0.8361054421768708,0.36842747175847257,0.22464435184680057,129175.56023407046,472.5583936479755,129648.11862771845,1298,0,581.96,40,10,16,35.55683295011497,0.6049479166666667,45.85873983739838,1016.5650406504076,25.41412601626019,0
1300,4,2,0,49,0.04081632653061224,0.0,1.0,49,1450,1100,350,0.7586206896551724,18,11,7,409.4266232744189,0.8308177437641724,0.390193415423971,0.2275404206025399,129287.2702728065,786.7378459178373,130074.00811872435,1299,0,594.795918367347,36,13,18,35.33915587052006,0.6131365740740742,45.74887387387387,1017.0045045045038,28.250125125125106,0
1301,4,1,1,49,0.02,0.02,0.98,50,1100,800,300,0.7272727272727273,14,8,6,403.4529278150367,0.8363435374149659,0.38323677581864013,0.22559269344023833,129527.4490466795,451.64571005913774,129979.09475673863,1300,0,583.88,38,12,16,35.2454607472712,0.611842105263158,45.5128205128205,1017.9487179487154,26.78812415654514,0
1302,4,0,0,49,0.0,0.0,1.0,49,1000,700,300,0.7,13,7,6,410.5230577603512,0.8295422335600907,0.38839512526640196,0.22878339056806563,129396.54659366318,824.0531942520519,130220.59978791523,1301,2,596.795918367347,37,12,18,35.19944228903977,0.6123310810810811,45.64144736842104,1017.4342105263138,27.49822190611659,0
1303,4,0,0,49,0.0,0.0,1.0,49,1150,900,250,0.782608695652174,14,9,5,410.4414709380682,0.8299674036281179,0.3906265803024509,0.22922489369718063,129480.2306959831,828.8112688519211,130309.04196483502,1302,3,597.795918367347,37,12,16,35.115905336493555,0.6131756756756758,45.55921052631577,1017.7631578947346,27.507112375533367,0
1304,4,0,1,48,0.0,0.02040816326530612,0.9795918367346939,49,1400,800,600,0.5714285714285714,20,8,12,413.58474848376574,0.8303217120181406,0.3912249512704835,0.23180214599690585,129619.76431450043,921.7515245075165,130541.51583900795,1303,4,598.795918367347,37,12,16,34.89319748034886,0.6145833333333335,45.42214912280701,1018.3114035087705,27.521929824561365,0
1305,4,2,1,49,0.04,0.02,0.98,50,1550,1300,250,0.8387096774193549,18,13,5,402.1727561309144,0.8397959183673469,0.38690348946872155,0.2272311789080703,129935.60209155134,451.31184253777934,130386.91393408911,1304,0,587.7,38,12,17,34.86128575919521,0.6159539473684212,45.112179487179475,1019.5512820512798,26.83029689608631,0
1306,4,1,1,49,0.02,0.02,0.98,50,1250,1000,250,0.8,15,10,5,398.94520435295067,0.8402891156462585,0.3859099476439787,0.22651169450479655,130126.29323727073,382.6521294469901,130508.94536671771,1305,0,588.68,38,12,18,34.74912739965094,0.6178728070175439,44.92521367521367,1020.2991452991448,26.849977507872232,0
1307,4,0,0,49,0.0,0.0,1.0,49,1500,1000,500,0.6666666666666666,20,10,10,406.2649642572522,0.8342545351473923,0.394369163337698,0.23031584171146968,130066.77685682134,768.3148901585046,130835.09174697984,1306,1,601.2244897959183,37,12,19,34.62312784406462,0.6190878378378378,44.983552631578945,1020.0657894736843,27.569345661450928,0
1308,4,1,0,50,0.02,0.0,1.0,50,1050,700,350,0.6666666666666666,14,7,7,396.8242878361083,0.8401530612244897,0.387597461468721,0.22678610854053236,130380.76560356662,348.0927343147456,130728.85833788136,1307,0,590.18,35,15,20,34.54404653974011,0.6261904761904762,44.67592592592593,1021.296296296297,29.179894179894198,0
1309,4,0,0,50,0.0,0.0,1.0,50,1550,1200,350,0.7741935483870968,19,12,7,401.21118790142185,0.8385544217687074,0.38799184505606554,0.23016852358555245,130528.56445312496,473.9040798611096,131002.46853298607,1308,1,591.18,35,15,18,34.28155793408089,0.6276785714285715,44.53125,1021.8749999999997,29.196428571428562,0
1310,4,1,0,51,0.0196078431372549,0.0,1.0,51,1300,900,400,0.6923076923076923,17,9,8,398.91346706408297,0.8397712418300655,0.3961694700985243,0.23137999375529364,130953.25213304526,247.80316634202327,131201.05529938728,1309,0,580.5686274509804,36,15,19,33.9084332709869,0.6299189814814814,44.115990990990994,1023.5360360360365,28.431556556556572,0
1311,4,0,1,50,0.0,0.0196078431372549,0.9803921568627451,51,1650,1200,450,0.7272727272727273,21,12,9,396.2098427635236,0.8393137254901961,0.3903580572037417,0.23015614572288798,131010.89000740614,181.56082602874275,131192.45083343488,1310,1,581.5686274509804,36,15,19,33.91907747589192,0.6304976851851851,44.05968468468469,1023.761261261262,28.437812812812833,0
1312,4,0,0,50,0.0,0.0,1.0,50,1400,1100,300,0.7857142857142857,17,11,6,406.0911809682983,0.8344897959183674,0.3955620900248815,0.23529870393982247,130913.23329260966,632.5419024348323,131545.7751950445,1311,2,594.1,35,15,19,33.7654565332127,0.631547619047619,44.15509259259259,1023.379629629629,29.239417989417973,0
1313,4,0,0,50,0.0,0.0,1.0,50,1100,700,400,0.6363636363636364,15,7,8,401.3599088647663,0.8334183673469387,0.39557510446448196,0.23367266397030645,131097.3705969484,523.4457430403484,131620.81633998876,1312,3,595.1,36,14,19,33.699417198152624,0.6313657407407407,43.97522522522523,1024.0990990991,28.44719719719722,0
1314,4,0,0,50,0.0,0.0,1.0,50,1700,1300,400,0.7647058823529411,21,13,8,401.90024040050037,0.8323809523809523,0.40063386155129277,0.23506262840985376,131273.37643363292,551.760309372499,131825.13674300542,1313,4,596.1,38,12,19,33.506872046149574,0.6293859649122806,43.80341880341881,1024.7863247863254,26.96806117858751,0
1315,4,0,0,50,0.0,0.0,1.0,50,600,100,500,0.16666666666666666,11,1,10,402.55418356245434,0.8320068027210884,0.40202439278640645,0.2356133180545836,131300.7492900322,571.1331863174864,131871.88247634968,1314,5,597.1,38,12,19,33.46233364606135,0.6296600877192982,43.776709401709404,1024.8931623931628,26.970872694556917,0
1316,4,1,2,49,0.0196078431372549,0.0392156862745098,0.9607843137254902,51,1300,900,400,0.6923076923076923,17,9,8,390.5889837707448,0.8385620915032681,0.3855793030713939,0.23015948526206217,131559.08230865988,77.114213655914,131636.1965223158,1315,0,586.3725490196078,36,15,17,33.50713501646544,0.6359953703703705,43.52477477477477,1025.9009009008998,28.497247247247216,0
1317,4,1,2,48,0.02,0.04,0.96,50,1600,1300,300,0.8125,19,13,6,388.848060616411,0.8378571428571429,0.3846950416849497,0.23017785198566248,131732.43344696047,244.7802532262014,131977.21370018666,1316,0,574.92,36,14,17,33.376298083954964,0.6377314814814815,43.35585585585586,1026.5765765765766,28.516016016016017,0
1318,4,0,0,48,0.0,0.0,1.0,48,1650,1300,350,0.7878787878787878,20,13,7,398.5068458323144,0.826315011820331,0.39048664471277017,0.23482518535138297,131559.0823086599,885.4389862835708,132444.5212949435,1317,8,599.1458333333334,36,12,18,33.304061470911094,0.6359953703703705,43.52477477477477,1025.9009009009,28.497247247247223,0
1319,4,0,0,48,0.0,0.0,1.0,48,1250,800,450,0.64,17,8,9,401.13360701606626,0.8250036938534279,0.39573731665386513,0.23691060017740803,131645.74361100944,961.5063965992778,132607.25000760873,1318,9,600.1458333333334,36,12,19,33.1488441420681,0.636863425925926,43.4403153153153,1026.2387387387369,28.506631631631578,0
1320,4,0,0,48,0.0,0.0,1.0,48,1450,1100,350,0.7586206896551724,18,11,7,402.0124676654504,0.8245973699763594,0.39211420741689884,0.23860892092234476,131834.36850761742,999.8119613726947,132834.18046899012,1319,10,601.1458333333334,37,11,19,32.93517332194461,0.6368243243243243,43.2565789473684,1026.9736842105237,27.756045519203344,0
1321,4,0,0,48,0.0,0.0,1.0,48,800,500,300,0.625,11,5,6,402.4291398030854,0.8244865543735225,0.39465010141987866,0.23903321195532637,131862.52170138873,1013.0642361110929,132875.58593749983,1320,11,602.1458333333334,37,11,19,32.89596010818119,0.6371058558558559,43.22916666666666,1027.083333333332,27.75900900900897,0
1322,4,0,0,48,0.0,0.0,1.0,48,950,700,250,0.7368421052631579,12,7,5,400.0586865840909,0.8235630910165485,0.3929609966919223,0.23833121118750855,131975.16453379864,959.562197022135,132934.72673082078,1321,12,603.1458333333334,37,11,19,32.84279070181055,0.638231981981982,43.11951754385964,1027.5219298245595,27.770862968231338,0
1323,4,0,0,48,0.0,0.0,1.0,48,1750,1300,450,0.7428571428571429,22,13,9,401.82926562918647,0.8238585992907801,0.39549559158134295,0.2402774996517378,132116.0357032932,1017.6179208987243,133133.6536241919,1322,13,604.1458333333334,37,11,19,32.654739050056875,0.6396396396396398,42.98245614035087,1028.0701754385955,27.785680417259336,0
1324,4,0,0,48,0.0,0.0,1.0,48,1250,900,350,0.72,16,9,7,399.7277652217918,0.8237662529550828,0.39039610389610413,0.2394137983982415,132178.18737900848,967.0582904156419,133145.24566942413,1323,14,605.1458333333334,38,10,19,32.64588744588746,0.6384320175438598,42.92200854700854,1028.3119658119642,27.060841205578004,0
1325,4,0,0,48,0.0,0.0,1.0,48,1200,800,400,0.6666666666666666,16,8,8,398.47903620242323,0.8231567671394799,0.3926002389113954,0.23901293965861195,132233.1242809005,938.4255834976719,133171.54986439817,1324,15,606.1458333333334,38,10,19,32.62244208995532,0.6389802631578949,42.86858974358973,1028.525641025639,27.06646423751682,0
1326,4,0,0,48,0.0,0.0,1.0,48,950,600,350,0.631578947368421,13,6,7,395.07005315937863,0.8228243203309692,0.38674234754142667,0.237498899272987,132317.61203341992,854.9452039930316,133172.55723741296,1325,16,607.1458333333334,39,9,19,32.62472157537714,0.6380876068376069,42.78645833333332,1028.854166666665,26.380876068376022,0
1327,4,0,0,48,0.0,0.0,1.0,48,1150,600,550,0.5217391304347826,17,6,11,399.23640061776695,0.8216238179669031,0.38729665654634693,0.24070571597924112,132427.78427479873,974.0960433813658,133401.8803181801,1326,17,608.1458333333334,35,13,19,32.40622305933506,0.6467261904761903,42.67939814814816,1029.282407407409,29.408068783068828,0
1328,4,0,0,48,0.0,0.0,1.0,48,1300,900,400,0.6923076923076923,17,9,8,394.6154378456553,0.8215314716312057,0.3830410873625236,0.23860122898095495,132535.48127145867,860.1093944042474,133395.59066586292,1327,18,609.1458333333334,38,10,19,32.416389984090756,0.6419956140350878,42.57478632478632,1029.7008547008534,27.09739091318035,0
1329,4,0,0,48,0.0,0.0,1.0,48,1200,800,400,0.6666666666666666,16,8,8,397.21016755800406,0.8211436170212766,0.38896235220908526,0.2408742412323442,132645.51487508215,937.6294378698167,133583.14431295198,1328,19,610.1458333333334,38,10,18,32.2385137938187,0.6430921052631579,42.467948717948715,1030.1282051282049,27.108636977058023,0
1330,4,0,0,48,0.0,0.0,1.0,48,1150,700,450,0.6086956521739131,16,7,9,415.6911866676529,0.8210328014184397,0.4188246121952961,0.23960049486171414,130710.70545744858,1272.1940757602397,131982.8995332088,1329,20,611.1458333333334,37,11,18,33.72605261276717,0.625563063063063,44.3530701754386,1022.5877192982467,27.637505926979642,4
1331,4,0,0,48,0.0,0.0,1.0,48,1500,1300,200,0.8666666666666667,17,13,4,411.6358281807083,0.8211805555555556,0.41213881636205363,0.23786439679120622,130808.4744708345,1169.090944371418,131977.5654152059,1330,21,612.1458333333334,38,10,18,33.7302001740644,0.6247258771929823,44.257478632478644,1022.9700854700874,26.920265407107564,0
1332,4,0,0,48,0.0,0.0,1.0,48,850,700,150,0.8235294117647058,10,7,3,413.43372529067005,0.821697695035461,0.4136904761904763,0.23907254549417029,130835.79881656822,1218.3863412229018,132054.18515779113,1331,22,613.1458333333334,38,10,18,33.656406641604015,0.6249999999999998,44.23076923076924,1023.0769230769243,26.923076923076955,0
1333,4,0,1,47,0.0,0.020833333333333332,0.9791666666666666,48,750,500,250,0.6666666666666666,10,5,5,405.3550665859961,0.8216792257683215,0.40636554051762075,0.23528790545425837,130981.34901258718,1018.7906901042052,132000.13970269138,1332,23,614.1458333333334,39,9,18,33.71504104338389,0.6247329059829059,44.088541666666686,1023.6458333333363,26.247329059829138,0
1334,4,0,0,47,0.0,0.0,1.0,47,1200,900,300,0.75,15,9,6,416.8845149733479,0.8184936786925685,0.409510060853729,0.24175264246033157,130945.12473518899,1517.7989626707754,132462.92369785978,1333,24,626.6382978723404,38,9,18,33.456854558107175,0.62609649122807,44.12393162393163,1023.5042735042748,26.9343229869546,0
1335,4,0,0,47,0.0,0.0,1.0,47,900,800,100,0.8888888888888888,10,8,2,417.1413235042241,0.8184551341350601,0.4097681843512784,0.24241754415651792,131027.14913662431,1531.3676811673654,132558.51681779168,1334,25,627.6382978723404,38,9,18,33.36681275870465,0.6269188596491228,44.04380341880342,1023.8247863247864,26.9427575348628,0
1336,4,0,0,47,0.0,0.0,1.0,47,900,700,200,0.7777777777777778,11,7,4,420.20178212853006,0.8176071538698735,0.4090854006890221,0.24475260200756596,131114.67013888908,1618.9236111111297,132733.5937500002,1335,26,628.6382978723404,39,8,18,33.19941687008407,0.626068376068376,43.95833333333334,1024.1666666666683,26.260683760683804,0
1337,4,0,2,45,0.0,0.0425531914893617,0.9574468085106383,47,1500,1100,400,0.7333333333333333,19,11,8,423.6135044149449,0.816759173604687,0.40658670461475843,0.24777108540037066,131274.74500868074,1721.9509548611295,132996.69596354186,1336,27,629.6382978723404,39,8,18,32.949193603035845,0.6276709401709402,43.80208333333334,1024.7916666666683,26.276709401709443,0
1338,4,1,1,45,0.021739130434782608,0.021739130434782608,0.9782608695652174,46,1600,1200,400,0.75,20,12,8,413.4650918889953,0.8204710144927536,0.38038348293749036,0.2438239774887143,131587.9662390431,1681.4278118912825,133269.39405093438,1337,0,603.9782608695652,36,10,16,32.89110233051622,0.6362847222222222,43.49662162162162,1026.0135135135135,28.500375375375377,0
1339,4,0,0,45,0.0,0.0,1.0,45,1150,800,350,0.6956521739130435,15,8,7,420.23275348378274,0.8178872053872054,0.3848725375866784,0.24709239738684774,131476.45968632103,2050.1429344564363,133526.60262077747,1338,29,618.4,35,10,18,32.830780009780696,0.637202380952381,43.60532407407407,1025.5787037037028,29.302248677248652,0
1340,4,1,1,45,0.021739130434782608,0.021739130434782608,0.9782608695652174,46,950,600,350,0.631578947368421,13,6,7,393.86372300614806,0.8224838969404187,0.3293861863746217,0.23303384652044867,131713.9693313828,1181.9076056669992,132895.8769370498,1339,0,605.9347826086956,35,11,14,33.26626921486827,0.6395833333333334,43.37384259259259,1026.504629629629,29.328703703703688,1
1341,4,0,0,45,0.0,0.0,1.0,45,1050,700,350,0.6666666666666666,14,7,7,401.3398953850914,0.8173400673400674,0.33579244218838133,0.23671844129000866,131595.1877170137,1562.8797743055336,133158.06749131923,1340,31,620.4,35,10,14,33.19479695431472,0.6383928571428572,43.48958333333332,1026.0416666666652,29.315476190476147,0
1342,4,0,1,44,0.0,0.022222222222222223,0.9777777777777777,45,1000,600,400,0.6,14,6,8,398.9923356971276,0.8156565656565657,0.32746998232461766,0.2360035781881454,131703.53366457683,1509.7401032789637,133213.27376785578,1341,32,621.4,36,9,14,33.14522764673615,0.6374421296296295,43.38400900900901,1026.4639639639645,28.512887887887903,0
1343,4,0,0,44,0.0,0.0,1.0,44,1400,900,500,0.6428571428571429,19,9,10,401.81060058781696,0.8076109936575053,0.34754960972389437,0.23813635847495657,131778.07113727287,1789.9651815943248,133568.0363188672,1342,33,635.3181818181819,37,7,15,32.99738359675353,0.6362612612612613,43.311403508771924,1026.7543859649113,27.750118539592197,0
1344,4,0,0,44,0.0,0.0,1.0,44,1200,800,400,0.6666666666666666,16,8,8,395.26675606805884,0.8081175123326286,0.3419302226634522,0.23503338649315916,131903.67408366202,1627.4274737015076,133531.10155736352,1343,34,636.3181818181819,38,6,15,33.03822152886115,0.6356907894736842,43.18910256410256,1027.2435897435894,27.03272604588393,0
1345,4,0,0,44,0.0,0.0,1.0,44,1150,700,450,0.6086956521739131,16,7,9,394.29734251397826,0.8072806553911206,0.3447087846651169,0.23496603719327372,131985.998109796,1608.3456607494886,133594.3437705455,1344,35,637.3181818181819,38,6,16,32.9798294863797,0.636513157894737,43.10897435897435,1027.5641025641012,27.041160593792135,0
1346,4,0,0,44,0.0,0.0,1.0,44,1300,800,500,0.6153846153846154,18,8,10,392.825509104901,0.8064217758985202,0.3419081425006676,0.2354806467147958,132210.46142578125,1587.128363715277,133797.58978949653,1345,36,638.3181818181819,39,5,17,32.79071288699821,0.6370192307692308,42.890625,1028.4375,26.370192307692307,0
1347,4,0,0,44,0.0,0.0,1.0,44,750,400,350,0.5333333333333333,11,4,7,393.30876462105425,0.8057610993657506,0.34309551208285405,0.23610480550959953,132264.03130425353,1604.1205512152878,133868.1518554688,1346,37,639.3181818181819,39,5,17,32.72415611814347,0.6375534188034189,42.83854166666667,1028.645833333334,26.375534188034205,0
1348,4,2,2,44,0.043478260869565216,0.043478260869565216,0.9565217391304348,46,1200,900,300,0.75,15,9,6,377.56905186609805,0.8197262479871176,0.33032402116774207,0.22941726419284048,132719.8133680556,822.3144531250035,133542.1278211806,1347,0,612.4782608695652,39,7,14,32.669497236824384,0.642094017094017,42.395833333333336,1030.416666666667,26.420940170940177,0
1349,4,0,0,44,0.0,0.0,1.0,44,1200,800,400,0.6666666666666666,16,8,8,391.83233698641675,0.805650986610289,0.34293252008907027,0.23676355497441756,132510.87474030454,1584.4091451215575,134095.2838854261,1348,39,641.3181818181819,37,7,18,32.512868299609515,0.6435810810810811,42.59868421052631,1029.6052631578934,27.82716927453766,0
1350,4,0,0,44,0.0,0.0,1.0,44,1050,700,350,0.6666666666666666,14,7,7,395.8320699694725,0.8051224453840733,0.34697421114743987,0.24062288444845406,132736.76155163112,1708.29341720528,134445.0549688364,1349,40,642.3181818181819,37,7,15,32.18193587288076,0.6458333333333334,42.379385964912274,1030.4824561403498,27.850877192982427,0
1351,4,0,0,44,0.0,0.0,1.0,44,1300,800,500,0.6153846153846154,18,8,10,394.0210868158827,0.8045939041578577,0.34715534412407445,0.2402455420391002,132849.77709487517,1669.1227108340822,134518.89980570925,1350,41,643.3181818181819,37,7,15,32.11462100262355,0.6469594594594594,42.26973684210525,1030.9210526315776,27.8627311522048,0
1352,4,0,0,44,0.0,0.0,1.0,44,1700,1300,400,0.7647058823529411,21,13,8,396.75066329003135,0.8045278365045807,0.3479756132008853,0.24290600216013,133003.43940618364,1753.840560851761,134757.2799670354,1351,42,644.3181818181819,38,6,15,31.88934921456931,0.646655701754386,42.12072649572649,1031.5170940170929,27.145186684660338,0
1353,4,0,0,44,0.0,0.0,1.0,44,1050,800,250,0.7619047619047619,13,8,5,399.402951549591,0.804131430584919,0.3489232839838494,0.24525321735648414,133113.66705246895,1833.198302469115,134946.86535493808,1352,43,645.3181818181819,38,6,15,31.70984746523104,0.6477521929824562,42.01388888888888,1031.944444444443,27.156432748537974,0
1354,4,0,0,44,0.0,0.0,1.0,44,1150,600,550,0.5217391304347826,17,6,11,403.8683580789341,0.8038891825229035,0.3544565493494405,0.2487303979679244,133223.94035585117,1960.9868096646708,135184.92716551584,1353,44,646.3181818181819,38,6,16,31.483493739004444,0.6488486842105264,41.90705128205127,1032.3717948717929,27.167678812415602,0
1355,4,0,0,44,0.0,0.0,1.0,44,1100,1000,100,0.9090909090909091,12,10,2,410.7837237571374,0.8021714235377027,0.3611894621047591,0.2541182229691463,133389.43591798138,2158.8418392504723,135548.27775723184,1354,45,647.3181818181819,38,6,16,31.138173544316896,0.6504934210526316,41.74679487179486,1033.0128205128187,27.184547908232073,0
1356,4,0,0,44,0.0,0.0,1.0,44,1400,1100,300,0.7857142857142857,17,11,6,411.14615014724455,0.8011583861874559,0.35979302895279996,0.25530063315467244,133528.88028047088,2180.0026942746144,135708.8829747455,1355,46,648.3181818181819,37,7,16,30.988312469057224,0.6537162162162162,41.61184210526316,1033.5526315789473,27.933854907539114,0
1357,4,0,0,44,0.0,0.0,1.0,44,900,700,200,0.7777777777777778,11,7,4,412.97828386083455,0.8006959126145173,0.3631855309218208,0.2566345604453582,133557.21381819388,2231.24579197444,135788.45961016833,1356,47,649.3181818181819,37,7,16,30.912427955164254,0.6539977477477478,41.5844298245614,1033.6622807017532,27.93681839734468,0
1358,4,0,0,44,0.0,0.0,1.0,44,1300,1000,300,0.7692307692307693,16,10,6,406.64287319618666,0.8001673713883016,0.36360350040374856,0.25400750311519216,133748.36205164727,2077.5636459931293,135825.9256976404,1357,48,650.3181818181819,38,6,15,30.883770570818704,0.6540570175438596,41.39957264957265,1034.401709401709,27.22109761583445,0
1359,4,0,0,44,0.0,0.0,1.0,44,1200,1000,200,0.8333333333333334,14,10,4,406.6788716464263,0.7994186046511629,0.362003940332114,0.25555890183228736,133969.4793721236,2096.5113412228825,136065.9907133465,1358,49,651.3181818181819,38,6,15,30.660474716202273,0.65625,41.18589743589744,1035.2564102564104,27.243589743589748,0
1360,4,1,0,45,0.022222222222222223,0.0,1.0,45,950,700,250,0.7368421052631579,12,7,5,401.6827465130838,0.803409090909091,0.3531884009423949,0.25475748951891036,134307.72705078154,1789.8193359375296,136097.54638671907,1359,0,637.8222222222222,39,6,17,30.450143201688284,0.6578525641025641,40.859375000000014,1036.5625000000023,26.5785256410257,0
1361,4,0,0,45,0.0,0.0,1.0,45,800,400,400,0.5,12,4,8,404.3460055210345,0.8036616161616162,0.35519828510182205,0.2566359341164119,134334.72222222236,1863.5416666666874,136198.26388888905,1360,1,638.8222222222222,39,6,17,30.354032690246527,0.658119658119658,40.83333333333334,1036.6666666666679,26.58119658119661,0
1362,4,0,0,45,0.0,0.0,1.0,45,1300,1200,100,0.9230769230769231,14,12,2,405.4987776485897,0.8031144781144781,0.3619398403928793,0.25793867932854403,134415.72401258696,1901.0823567708528,136316.8063693578,1361,2,639.8222222222222,39,6,18,30.242863720073675,0.6589209401709402,40.75520833333334,1036.9791666666679,26.589209401709432,0
1363,4,1,1,45,0.021739130434782608,0.021739130434782608,0.9782608695652174,46,1150,700,450,0.6086956521739131,16,7,9,396.93118400561485,0.8050322061191627,0.34195012217352505,0.2542627755830254,134670.88906035668,1491.354173364628,136162.24323372132,1362,0,626.8913043478261,35,11,18,30.20926256318762,0.669047619047619,40.50925925925926,1037.962962962963,29.65608465608466,0
1364,4,0,0,45,0.0,0.0,1.0,45,750,500,250,0.6666666666666666,10,5,5,389.91378274900177,0.8028198653198654,0.3214307699072241,0.23183814800158295,131901.66650142116,1289.4849025744927,133191.15140399567,1363,4,641.8222222222222,40,5,16,33.17772226619179,0.6322916666666667,43.19105691056911,1027.235772357724,25.680894308943103,8
1365,4,1,1,45,0.021739130434782608,0.021739130434782608,0.9782608695652174,46,850,500,350,0.5882352941176471,12,5,7,382.4242636539134,0.8045893719806764,0.321808756050298,0.2291450819096223,132193.88247197025,910.829632779037,133104.71210474928,1364,0,628.8478260869565,41,5,18,33.074876197826235,0.6336382113821137,42.90674603174603,1028.3730158730157,25.08226867982965,0
1366,4,0,0,45,0.0,0.0,1.0,45,1100,500,600,0.45454545454545453,17,5,12,390.1637714904208,0.8010521885521886,0.33043739215244994,0.23394030185316297,132219.38898533932,1317.4430941357857,133536.8320794751,1365,1,643.7111111111111,41,4,19,32.850129417060536,0.6338922764227644,42.881944444444436,1028.4722222222208,25.084688346883436,0
1367,4,0,0,45,0.0,0.0,1.0,45,1200,900,300,0.75,15,9,6,388.21091288158743,0.8005471380471381,0.3308584835920685,0.23339915231854705,132321.43964356548,1273.7253755668646,133595.16501913234,1366,2,644.7111111111111,41,4,19,32.797283289943095,0.634908536585366,42.78273809523808,1028.8690476190454,25.09436701509867,0
1368,4,0,0,45,0.0,0.0,1.0,45,1400,800,600,0.5714285714285714,20,8,12,382.3358501226257,0.7997895622895623,0.322015798881393,0.23067037670203494,132452.98603121119,1128.371435927808,133581.357467139,1367,3,645.7111111111111,38,7,19,32.81568932710603,0.6411732456140351,42.65491452991453,1029.3803418803418,27.088956365272153,0
1369,4,0,0,45,0.0,0.0,1.0,45,1450,1200,250,0.8275862068965517,17,12,5,388.048321573824,0.8014309764309765,0.32293438429094956,0.23531835953552266,132645.51487508212,1294.5738823142624,133940.08875739638,1368,4,646.7111111111111,38,7,18,32.474460692802325,0.6430921052631579,42.467948717948715,1030.1282051282046,27.108636977058016,0
1370,4,0,0,45,0.0,0.0,1.0,45,1350,1100,250,0.8148148148148148,16,11,5,390.5620471289791,0.8014309764309765,0.3240116521015399,0.23173348129652752,131821.37573964492,1296.8852728468041,133118.2610124917,1369,5,647.7111111111111,38,7,18,33.242301290054094,0.6348684210526316,43.26923076923077,1026.9230769230765,27.024291497975696,1
1371,4,0,0,45,0.0,0.0,1.0,45,1350,900,450,0.6666666666666666,18,9,9,390.85548435471486,0.8012626262626263,0.32844694080392034,0.2322425603576161,131876.23844875448,1308.9102107531594,133185.14865950763,1370,6,648.7111111111111,38,7,18,33.17926114693849,0.6354166666666666,43.215811965811966,1027.1367521367522,27.02991452991453,0
1372,4,0,0,45,0.0,0.0,1.0,45,950,700,250,0.7368421052631579,12,7,5,388.4821920481946,0.8012205387205388,0.32512941393973005,0.23116613606036146,131931.11257213829,1250.5775622762849,133181.69013441456,1371,7,649.7111111111111,38,7,18,33.18470951192456,0.6359649122807017,43.162393162393165,1027.350427350428,27.035537561853367,0
1373,4,0,0,45,0.0,0.0,1.0,45,1300,700,600,0.5384615384615384,19,7,12,387.91088385682974,0.799537037037037,0.32570570570570556,0.23149520488230166,132040.89506172843,1244.0200617283983,133284.91512345683,1372,8,650.7111111111111,38,7,18,33.08840090090091,0.6370614035087719,43.05555555555556,1027.777777777778,27.046783625731003,0
1374,4,0,0,45,0.0,0.0,1.0,45,1150,900,250,0.782608695652174,14,9,5,388.93037154506874,0.8002946127946129,0.3292702634069766,0.23311604959482152,132205.65440317048,1283.758857476812,133489.4132606473,1373,9,651.7111111111111,38,7,19,32.89571646235889,0.6387061403508771,42.89529914529915,1028.4188034188037,27.063652721547466,0
1375,4,0,1,44,0.0,0.022222222222222223,0.9777777777777777,45,1350,800,550,0.5925925925925926,19,8,11,392.56503138881135,0.7983585858585859,0.3282051282051279,0.2364964945196011,132398.0034722223,1395.2449274965347,133793.24839971884,1374,10,652.7111111111111,36,9,19,32.60796221322536,0.6443865740740742,42.708333333333336,1029.1666666666672,28.587962962962976,0
1376,4,0,0,44,0.0,0.0,1.0,44,550,400,150,0.7272727272727273,7,4,3,395.6663098168582,0.796665785764623,0.33820623110904435,0.23800850328983314,132341.5858725762,1672.6213835026178,134014.2072560788,1375,11,666.7045454545455,37,7,19,32.58516268826371,0.6418918918918919,42.76315789473684,1028.9473684210527,27.809388335704128,0
1377,4,0,0,44,0.0,0.0,1.0,44,1050,700,350,0.6666666666666666,14,7,7,391.0693632226653,0.7962914023960536,0.3255800441569505,0.23594853354334092,132454.4330947985,1559.774161280402,134014.2072560789,1376,12,667.7045454545455,37,7,19,32.58947592671495,0.6430180180180181,42.65350877192983,1029.3859649122815,27.821242294926527,0
1378,4,0,0,44,0.0,0.0,1.0,44,1600,1200,400,0.75,20,12,8,387.20187070846373,0.7955426356589148,0.32538826261551157,0.2348458086059402,132652.03145438974,1472.6229464835276,134124.65440087326,1377,13,668.7045454545455,37,7,18,32.489688664183085,0.6449887387387387,42.46162280701754,1030.1535087719292,27.841986723565654,0
1379,4,0,1,43,0.0,0.022727272727272728,0.9772727272727273,44,1000,600,400,0.6,14,6,8,385.695570514589,0.7946837561663144,0.3278792392965624,0.23446099428823441,132736.76155163112,1439.196194983058,134175.95774661418,1378,14,669.7045454545455,37,7,18,32.443072994254095,0.6458333333333334,42.379385964912274,1030.4824561403498,27.850877192982427,0
1380,4,0,0,43,0.0,0.0,1.0,43,800,500,300,0.625,11,5,6,391.8894154504204,0.7899593946105574,0.3328520149276497,0.23773238544697906,132658.9004545085,1797.5237906825628,134456.42424519104,1379,15,684.4418604651163,36,7,18,32.36203723946946,0.6469907407407408,42.45495495495495,1030.1801801801796,28.6161161161161,0
1381,4,0,0,43,0.0,0.0,1.0,43,1750,1300,450,0.7428571428571429,22,13,9,390.7485650522092,0.7893595422665189,0.3328159729719431,0.23832798887761333,132861.99787202742,1783.12700369288,134645.1248757203,1380,16,685.4418604651163,36,7,19,32.18664664117968,0.6490162037037037,42.25788288288288,1030.9684684684685,28.638013013013012,0
1382,4,0,0,43,0.0,0.0,1.0,43,750,400,350,0.5333333333333333,11,4,7,386.8745312364333,0.7888058324104835,0.3270144700029112,0.24156645611194033,133734.1749477519,1747.6692486405423,135481.84419639243,1381,17,686.4418604651163,36,7,19,31.409227000544377,0.6576967592592593,41.41328828828829,1034.3468468468475,28.731856856856876,1
1383,4,0,0,43,0.0,0.0,1.0,43,1100,900,200,0.8181818181818182,13,9,4,388.4729432714083,0.7865909929863418,0.3334978374041764,0.24333182520252017,133850.68081172393,1799.473586762441,135650.15439848637,1382,18,687.4418604651163,36,7,19,31.250906881416185,0.6588541666666666,41.30067567567568,1034.7972972972975,28.744369369369377,0
1384,4,0,0,43,0.0,0.0,1.0,43,1350,1100,250,0.8148148148148148,16,11,5,387.99717533386735,0.7865909929863418,0.3265729419085244,0.24399767647192722,133996.38447569188,1798.043736303865,135794.42821199575,1383,19,688.4418604651163,36,7,19,31.116987528098026,0.6603009259259259,41.159909909909906,1035.3603603603601,28.760010010010003,0
1385,4,0,0,43,0.0,0.0,1.0,43,1500,1000,500,0.6666666666666666,20,10,10,385.19413003374797,0.7851144333702473,0.3221648977019871,0.24326966180206197,134152.9124345951,1734.9828793474778,135887.8953139426,1384,20,689.4418604651163,37,6,19,31.032581851538243,0.6599099099099099,41.008771929824555,1035.9649122807007,27.99905168326218,0
1386,4,0,0,43,0.0,0.0,1.0,43,1550,1200,350,0.7741935483870968,19,12,7,386.18897020990664,0.7830380214101144,0.32642777706699233,0.2446553717442384,134266.5291243459,1770.4505232379138,136036.9796475838,1385,21,690.4418604651163,37,6,19,30.892932712653405,0.661036036036036,40.89912280701754,1036.4035087719294,28.01090564248458,0
1387,4,0,0,43,0.0,0.0,1.0,43,700,300,400,0.42857142857142855,11,3,8,390.2722664559482,0.780454042081949,0.3331169086687915,0.24801173061877996,134380.19390581717,1888.972568482613,136269.1664742998,1386,22,691.4418604651163,37,6,19,30.673205724760297,0.6621621621621621,40.78947368421053,1036.842105263158,28.02275960170697,0
1388,4,0,0,43,0.0,0.0,1.0,43,1200,800,400,0.6666666666666666,16,8,8,389.4459136638589,0.7793927648578811,0.33168361865283935,0.24806524561255505,134465.4740521123,1873.4058796937604,136338.87993180603,1387,23,692.4418604651163,37,6,20,30.609186136659968,0.6630067567567567,40.70723684210527,1037.1710526315796,28.031650071123774,0
1389,4,0,0,43,0.0,0.0,1.0,43,850,800,50,0.9411764705882353,9,8,1,387.3199337512208,0.7789774824658545,0.331425888710307,0.24691327884376926,134495.3649485902,1818.5471683468575,136313.91211693705,1388,24,693.4418604651163,38,5,20,30.634377038486626,0.6614583333333333,40.67841880341881,1037.2863247863256,27.29700854700857,0
1390,4,0,0,43,0.0,0.0,1.0,43,1050,700,350,0.6666666666666666,14,7,7,396.13390104471216,0.7769472129937246,0.34477370663181306,0.25370795042552413,134664.5662607726,2069.051407349036,136733.61766812165,1389,25,694.4418604651163,37,6,20,30.236284245369397,0.6649774774774775,40.515350877192986,1037.9385964912285,28.052394499762933,0
1391,4,0,0,43,0.0,0.0,1.0,43,850,600,250,0.7058823529411765,11,6,5,391.50125213076706,0.7763473606496862,0.3360586688017446,0.25133053263906663,134749.93657904354,1950.9537790473994,136700.89035809095,1390,26,695.4418604651163,37,6,20,30.271037948392998,0.665822072072072,40.43311403508772,1038.267543859649,28.061284969179706,0
1392,4,0,0,43,0.0,0.0,1.0,43,1250,900,350,0.72,16,9,7,389.87505005722375,0.775516795865633,0.33417065067660645,0.25067933462946124,134806.86515322013,1911.566659933816,136718.43181315396,1391,27,696.4418604651163,37,6,18,30.25628673494527,0.6663851351351351,40.378289473684205,1038.4868421052624,28.067211948790877,0
1393,4,0,0,43,0.0,0.0,1.0,43,800,700,100,0.875,9,7,2,387.69483843185105,0.7753783684016242,0.33385863882056643,0.249865367299548,134892.2805574792,1859.408183287162,136751.68874076635,1392,28,697.4418604651163,37,6,18,30.227464640067545,0.6672297297297298,40.296052631578945,1038.815789473684,28.076102418207675,0
1394,4,0,0,43,0.0,0.0,1.0,43,1350,1100,250,0.8148148148148148,16,11,5,387.27149844774596,0.7744093761535622,0.33532940010013035,0.24998533510155593,134949.2391889812,1852.3988150200055,136801.63800400123,1393,29,698.4418604651163,37,6,18,30.181511186154495,0.6677927927927928,40.24122807017544,1039.0350877192982,28.08202939781887,0
1395,4,0,0,43,0.0,0.0,1.0,43,1200,1000,200,0.8333333333333334,14,10,4,384.27744370353093,0.7740863787375415,0.33151365950429024,0.24893605374403152,135077.80540032135,1781.4707520636898,136859.27615238505,1394,30,699.4418604651163,38,5,18,30.130823912298723,0.6672149122807018,40.11752136752136,1039.5299145299139,27.356050382366153,0
1396,4,0,0,43,0.0,0.0,1.0,43,550,200,350,0.36363636363636365,9,2,7,370.77375649086866,0.7740863787375415,0.3026394150338667,0.22761590491425723,133104.2379025276,1281.386357971177,134385.62426049876,1395,31,700.4418604651163,37,6,17,32.45791715368539,0.6494932432432433,42.023026315789465,1031.9078947368412,27.889402560455167,4
1397,4,0,0,43,0.0,0.0,1.0,43,750,300,450,0.4,12,3,9,375.03365626504626,0.7738095238095237,0.30778882061211976,0.231107127447099,133245.71021852858,1394.325176977512,134640.0353955061,1396,32,701.4418604651163,37,6,17,32.20581988105351,0.650900900900901,41.88596491228069,1032.4561403508758,27.90422000948313,0
1398,4,0,0,43,0.0,0.0,1.0,43,1300,1100,200,0.8461538461538461,15,11,4,362.8565097986608,0.7743170911775563,0.2994830007400644,0.2187717248569147,132427.7842747986,1011.0338211110385,133438.81809590966,1397,33,702.4418604651163,35,8,22,33.342352599422775,0.6467261904761905,42.67939814814815,1029.282407407408,29.408068783068803,2
1399,4,0,0,43,0.0,0.0,1.0,43,1000,700,300,0.7,13,7,6,365.3174840776754,0.7743170911775563,0.26248073940251926,0.2138105738000595,131299.26960321813,993.1837665368125,132292.45336975495,1398,34,703.4418604651163,36,7,19,34.417921107570606,0.6333912037037037,43.778153153153156,1024.8873873873877,28.469094094094103,3
1400,4,2,2,43,0.044444444444444446,0.044444444444444446,0.9555555555555556,45,950,500,450,0.5263157894736842,14,5,9,351.31548889663844,0.7888047138047138,0.25319641039874186,0.20784724244574498,131711.68456424854,254.47097121774888,131966.1555354663,1399,0,673.1333333333333,38,7,16,34.360472175964446,0.6337719298245614,43.37606837606837,1026.4957264957254,27.013045434098036,0
1401,4,0,0,43,0.0,0.0,1.0,43,1300,800,500,0.6153846153846154,18,8,10,372.52706959335694,0.7731635289774824,0.2603445721962008,0.21885364488497475,131443.57829112894,1193.258207531851,132636.8364986608,1400,36,705.4418604651163,36,7,19,34.087186104400004,0.634837962962963,43.637387387387385,1025.4504504504503,28.48473473473473,0
1402,4,1,1,43,0.022727272727272728,0.022727272727272728,0.9772727272727273,44,600,200,400,0.3333333333333333,10,2,8,364.55084862087404,0.7832980972515856,0.24895093687165493,0.21525750108787123,131637.3803117305,797.7037405740172,132435.0840523045,1401,0,690.3863636363636,37,7,17,34.09585692915908,0.6348536036036037,43.4484649122807,1026.206140350877,27.735301090564242,0
1403,4,0,0,43,0.0,0.0,1.0,43,1000,800,200,0.8,12,8,4,373.22479454091,0.7731635289774824,0.25141089355315427,0.22009392252829993,131587.96623904322,1222.3783327246304,132810.34457176784,1402,38,707.4418604651163,36,7,17,33.92327955218966,0.6362847222222221,43.49662162162163,1026.0135135135145,28.500375375375402,0
1404,4,0,0,43,0.0,0.0,1.0,43,950,600,350,0.631578947368421,13,6,7,374.75810768748875,0.7722868217054263,0.249804138733575,0.2213331584806277,131645.74361100968,1267.061952154861,132912.80556316453,1403,39,708.4418604651163,36,7,17,33.8255331211822,0.6368634259259258,43.44031531531532,1026.238738738739,28.506631631631635,0
1405,4,0,0,43,0.0,0.0,1.0,43,1350,1100,250,0.8148148148148148,16,11,5,374.0874198891668,0.771640826873385,0.24470513811407701,0.22160851248405064,131761.33639974458,1258.0516749858234,133019.3880747304,1404,40,709.4418604651163,36,7,17,33.72591495740558,0.6380208333333333,43.327702702702716,1026.6891891891912,28.5191441441442,0
1406,4,1,0,44,0.022727272727272728,0.0,1.0,44,650,400,250,0.6153846153846154,9,4,5,366.99124622222234,0.7777043692741368,0.25196848484848533,0.2192825323985555,132087.85545792943,895.0173370652624,132982.87279499468,1405,0,694.2954545454545,37,7,18,33.57855555555557,0.6393581081081081,43.00986842105264,1027.96052631579,27.782716927453784,0
1407,4,0,0,44,0.0,0.0,1.0,44,1250,1000,250,0.8,15,10,5,372.8771555459912,0.7764270613107823,0.2576347771891552,0.22365659666300675,132233.12428090078,1061.3422501643677,133294.46653106515,1406,1,695.2954545454545,38,6,19,33.28074685779577,0.6389802631578947,42.868589743589745,1028.5256410256413,27.06646423751688,0
1408,4,0,0,44,0.0,0.0,1.0,44,950,700,250,0.7368421052631579,12,7,5,372.9179218440209,0.7747313248766737,0.2574821325730037,0.2240066543628247,132288.07259706705,1066.518623529849,133354.5912205969,1407,2,696.2954545454545,38,6,19,33.22428774189082,0.6395285087719298,42.815170940170944,1028.7393162393168,27.072087269455707,0
1409,4,0,0,44,0.0,0.0,1.0,44,1300,900,400,0.6923076923076923,17,9,8,370.9469438803104,0.7740486257928119,0.26148633343400784,0.22331006021594685,132370.51647308053,1020.4877091094979,133391.00418219002,1408,3,697.2954545454545,38,6,19,33.19187776854927,0.6403508771929824,42.73504273504273,1029.0598290598286,27.080521817363913,0
1410,4,0,0,44,0.0,0.0,1.0,44,1050,700,350,0.6666666666666666,14,7,7,368.5691148366588,0.772881430584919,0.25983877888800366,0.22309714175623047,132576.73852237652,972.7467937303663,133549.48531610687,1409,4,698.2954545454545,35,9,20,33.04534726904923,0.6482142857142856,42.53472222222222,1029.8611111111109,29.424603174603167,0
1411,4,0,0,44,0.0,0.0,1.0,44,1300,1000,300,0.7692307692307693,16,10,6,369.59486451532734,0.7713398520084567,0.25954192785686603,0.22472841230430307,132745.92318247305,1012.4422987176412,133758.3654811907,1410,5,699.2954545454545,36,8,18,32.84864131424615,0.6478587962962963,42.3704954954955,1030.5180180180184,28.62550050050051,0
1412,4,0,0,44,0.0,0.0,1.0,44,1400,900,500,0.6428571428571429,19,9,10,365.6343299320687,0.7703047921071178,0.2520453552563646,0.2231831949905344,132891.02447041616,917.9041372453325,133808.92860766148,1411,6,700.2954545454545,36,8,18,32.804763725061896,0.6493055555555557,42.22972972972972,1031.0810810810794,28.641141141141095,0
1413,4,0,0,44,0.0,0.0,1.0,44,1250,900,350,0.72,16,9,7,365.9915619734801,0.7692036645525018,0.25502844321780693,0.2235746986651871,132920.0542392053,929.5236537212779,133849.57789292658,1412,7,701.2954545454545,36,8,18,32.76637181027265,0.6495949074074074,42.20157657657657,1031.1936936936927,28.64426926926924,0
1414,4,1,1,44,0.022222222222222223,0.022222222222222223,0.9777777777777777,45,1600,1100,500,0.6875,21,11,10,358.10529349866863,0.7736111111111111,0.25264648610373563,0.22050760878286205,133217.40974386327,541.171923091698,133758.58166695497,1413,0,686.6888888888889,37,8,19,32.67115861214374,0.6506193693693694,41.913377192982445,1032.3464912280685,27.901256519677528,0
1415,4,0,0,44,0.0,0.0,1.0,44,1500,1000,500,0.6666666666666666,20,10,10,370.6164871972931,0.7671555673009162,0.259365579882596,0.22834757759575147,133239.59094229355,1076.1578301274155,134315.74877242098,1414,9,703.2954545454545,36,8,19,32.32597985747528,0.6527777777777779,41.89189189189189,1032.4324324324316,28.678678678678654,0
1416,4,0,0,44,0.0,0.0,1.0,44,600,300,300,0.5,9,3,6,368.5833617786849,0.7669133192389007,0.2583086288779386,0.22727241722587507,133268.65875588427,1024.1220527960422,134292.7808086803,1415,10,704.2954545454545,36,8,19,32.34926564147308,0.6530671296296295,41.86373873873874,1032.545045045045,28.681806806806808,0
1417,4,0,0,44,0.0,0.0,1.0,44,1650,1300,350,0.7878787878787878,20,13,7,373.1265953418615,0.7654818534179,0.2598538518702007,0.23115709063211198,133443.1322158306,1158.2363190893457,134601.36853491995,1416,11,705.2954545454545,36,8,19,32.05676657584014,0.6548032407407408,41.69481981981981,1033.22072072072,28.700575575575556,0
1418,4,1,1,44,0.022222222222222223,0.022222222222222223,0.9777777777777777,45,1200,900,300,0.75,15,9,6,366.9749940056333,0.7750841750841752,0.2610820751064653,0.22896048539047098,133705.056407759,813.2856251521649,134518.34203291117,1417,0,690.6,36,9,18,31.95298889372821,0.6574074074074074,41.441441441441434,1034.2342342342333,28.728728728728704,0
1419,4,0,0,44,0.0,0.0,1.0,44,1000,600,400,0.6,14,6,8,372.31246295498784,0.766935341789993,0.2673603688887538,0.23139336163194088,133561.93636670502,1145.3546971450392,134707.29106385005,1418,13,707.2954545454545,35,9,19,31.9585572724219,0.6580357142857144,41.5798611111111,1033.6805555555536,29.533730158730105,0
1420,4,0,0,44,0.0,0.0,1.0,44,550,400,150,0.7272727272727273,7,4,3,369.28521266994454,0.7667371388301621,0.2696898467549911,0.23006932287261395,133651.6806520061,1071.117862654311,134722.7985146604,1419,14,708.2954545454545,35,9,19,31.946776359973125,0.6589285714285715,41.49305555555555,1034.0277777777771,29.543650793650777,0
1421,4,0,0,44,0.0,0.0,1.0,44,1100,800,300,0.7272727272727273,14,8,6,365.2049746006539,0.766803206483439,0.26322896640117177,0.22808084262795533,133741.45507812488,968.6089409722085,134710.0640190971,1420,15,709.2954545454545,35,9,18,31.962277609936223,0.6598214285714286,41.40624999999999,1034.374999999999,29.553571428571402,0
1422,4,0,0,44,0.0,0.0,1.0,44,950,700,250,0.7368421052631579,12,7,5,384.5575176358993,0.766384778012685,0.227110339179305,0.2357886950990398,133058.54752218927,1436.174353324282,134494.72187551355,1421,16,710.2954545454545,38,6,20,32.14831210520865,0.647203947368421,42.067307692307686,1031.7307692307686,27.150809716599174,7
1423,4,0,0,44,0.0,0.0,1.0,44,1000,700,300,0.7,13,7,6,381.66641893645453,0.7664728682170543,0.22563557328616324,0.23488286240535172,133196.36774965297,1367.316138870621,134563.68388852358,1422,17,711.2954545454545,38,6,20,32.084238942937965,0.6485745614035088,41.93376068376068,1032.264957264957,27.16486729644624,0
1424,4,0,0,44,0.0,0.0,1.0,44,900,400,500,0.4444444444444444,14,4,10,379.8317618491586,0.765349718111346,0.2228072238160188,0.23427402541621667,133279.09412895376,1324.726628132059,134603.8207570858,1423,18,712.2954545454545,38,6,20,32.048413519572335,0.6493969298245614,41.85363247863247,1032.5854700854688,27.173301844354445,0
1425,4,0,0,44,0.0,0.0,1.0,44,900,700,200,0.7777777777777778,11,7,4,375.96957080149923,0.7665169133192389,0.21557998269831113,0.23240881141361222,133361.84619037184,1227.9992146979314,134589.84540506976,1424,19,713.2954545454545,38,6,20,32.064973796717695,0.6502192982456141,41.77350427350427,1032.905982905983,27.181736392262707,0
1426,4,1,0,45,0.022222222222222223,0.0,1.0,45,1000,700,300,0.7,13,7,6,368.21311163771213,0.7742845117845119,0.21555249172175683,0.22916709106481753,133613.88991083787,839.7685466115363,134453.6584574494,1425,0,698.4222222222222,37,8,21,32.01238643192985,0.6545608108108107,41.52960526315789,1033.8815789473679,27.942745376955887,0
1427,4,0,0,45,0.0,0.0,1.0,45,1000,800,200,0.8,12,8,4,369.204025802383,0.7750420875420876,0.21334526719221603,0.2307942273624576,133775.99172921665,878.1269404265965,134654.11866964324,1426,1,699.4222222222222,38,7,17,31.824245240800025,0.6543311403508772,41.372863247863236,1034.508547008545,27.22390913180382,0
1428,4,0,1,44,0.0,0.022222222222222223,0.9777777777777777,45,950,700,250,0.7368421052631579,12,7,5,368.42666936916635,0.7746212121212122,0.2114002478314747,0.23048086990768749,133803.62426035493,859.3647271531756,134662.9889875081,1427,2,700.4222222222222,38,7,17,31.81665634035523,0.6546052631578948,41.34615384615384,1034.6153846153836,27.226720647773252,0
1429,4,0,0,44,0.0,0.0,1.0,44,950,600,350,0.631578947368421,13,6,7,373.94172964625244,0.765834214235377,0.21044919123034478,0.2328834015132837,133637.8718770544,1194.5553911899906,134832.42726824438,1428,23,717.2954545454545,38,6,20,31.84025625129158,0.6529605263157896,41.50641025641025,1033.9743589743578,27.209851551956785,0
1430,4,0,0,44,0.0,0.0,1.0,44,800,500,300,0.625,11,5,6,372.03238210600864,0.7652836504580691,0.20964447699805655,0.23221440948860517,133720.73522764613,1149.6887327416032,134870.42396038774,1429,24,718.2954545454545,38,6,17,31.806502427435184,0.6537828947368423,41.426282051282044,1034.2948717948707,27.21828609986502,0
1431,4,0,0,44,0.0,0.0,1.0,44,1250,800,450,0.64,17,8,9,369.8529132031301,0.7648431994362227,0.20514162590481932,0.23119985529670142,133775.9917292168,1095.4880515377238,134871.4797807545,1430,25,719.2954545454545,38,6,17,31.807463251747055,0.6543311403508772,41.37286324786324,1034.5085470085462,27.223909131803847,0
1432,4,0,0,44,0.0,0.0,1.0,44,1100,900,200,0.8181818181818182,13,9,4,371.85712355299324,0.764997357293869,0.20009151921903623,0.23280130844284033,133831.25964506168,1153.2214506172816,134984.48109567896,1431,26,720.2954545454545,38,6,17,31.70022371364654,0.6548793859649124,41.31944444444444,1034.722222222222,27.229532163742682,0
1433,4,0,0,44,0.0,0.0,1.0,44,1400,1100,300,0.7857142857142857,17,11,6,372.9230927507382,0.7649753347427767,0.19468727722958024,0.2346993905805297,134024.78723792837,1196.1876324055909,135220.97487033394,1432,27,721.2954545454545,38,6,17,31.478710964369245,0.656798245614035,41.13247863247864,1035.4700854700864,27.249212775528587,0
1434,4,1,0,45,0.022222222222222223,0.0,1.0,45,1050,700,350,0.6666666666666666,14,7,7,367.83635404927577,0.7713804713804714,0.20432297249017517,0.23346348185576482,134334.72222222228,882.6388888888946,135217.36111111118,1433,0,706.2444444444444,39,6,18,31.30024115755627,0.6581196581196581,40.833333333333336,1036.666666666667,26.58119658119659,0
1435,4,0,0,45,0.0,0.0,1.0,45,900,600,300,0.6666666666666666,12,6,6,368.0945053373453,0.771422558922559,0.2031873577072454,0.2343189830651286,134442.73003472228,897.526041666677,135340.25607638896,1434,1,707.2444444444444,39,6,18,31.18554975224321,0.6591880341880341,40.72916666666667,1037.083333333334,26.59188034188036,0
1436,4,0,0,45,0.0,0.0,1.0,45,800,600,200,0.75,10,6,4,366.5244330877872,0.7721380471380471,0.1993773224866926,0.23349224441811248,134469.73876953125,857.2889539930561,135327.0277235243,1435,2,708.2444444444444,39,6,18,31.19926098891901,0.6594551282051282,40.703125,1037.1875,26.59455128205128,0
1437,4,1,1,45,0.021739130434782608,0.021739130434782608,0.9782608695652174,46,950,600,350,0.631578947368421,13,6,7,358.9449814083813,0.7820652173913044,0.19809024904154526,0.23057410933959396,134772.56059838188,475.23567979421864,135247.7962781761,1436,0,693.8260869565217,38,8,18,31.093519566484893,0.6641995614035088,40.41132478632478,1038.3547008547005,27.325123706702644,0
1438,4,0,0,45,0.0,0.0,1.0,45,1250,700,550,0.56,18,7,11,367.63743283348754,0.7736952861952863,0.20136849641444554,0.23564140667803832,134693.02002779697,903.639220721757,135596.65924851873,1437,4,710.2444444444444,37,8,18,30.947303792120003,0.665259009009009,40.487938596491226,1038.0482456140348,28.05535798956851,0
1439,4,0,0,45,0.0,0.0,1.0,45,950,600,350,0.631578947368421,13,6,7,367.6659492200936,0.7732744107744108,0.1997395008272611,0.236029076146784,134749.93657904342,908.5926679362734,135658.52924697968,1438,5,711.2444444444444,37,8,18,30.889723483648396,0.6658220720720721,40.43311403508771,1038.2675438596482,28.06128496917968,0
1440,4,0,0,45,0.0,0.0,1.0,45,1150,900,250,0.782608695652174,14,9,5,368.47221649202896,0.7723063973063974,0.20053032969611628,0.23673214994433603,134778.39936326552,932.4191097260576,135710.81847299158,1439,6,712.2444444444444,37,8,18,30.840373108060547,0.6661036036036037,40.40570175438596,1038.3771929824554,28.064248458985283,0
1441,4,0,0,45,0.0,0.0,1.0,45,650,400,250,0.6153846153846154,9,4,5,369.7944737226835,0.7719276094276095,0.20002579888595684,0.23851617689056673,134920.75837036397,978.5901671668186,135899.34853753078,1440,7,713.2444444444444,37,8,18,30.66391820580473,0.6675112612612613,40.26864035087719,1038.9254385964914,28.07906590801328,0
1442,4,0,0,45,0.0,0.0,1.0,45,1400,900,500,0.6428571428571429,19,9,10,372.33078447235874,0.7718434343434344,0.20020926556690943,0.2416518784527364,135145.8387586806,1063.7912326388941,136209.6299913195,1441,8,714.2444444444444,39,6,18,30.3734221598878,0.6661324786324787,40.052083333333336,1039.791666666667,26.661324786324794,0
1443,4,0,0,45,0.0,0.0,1.0,45,950,800,150,0.8421052631578947,11,8,3,371.01670364891527,0.7721380471380471,0.20455840455840457,0.24116085737179488,135200.0,1032.2916666666665,136232.29166666666,1442,9,715.2444444444444,39,6,18,30.353565705128208,0.6666666666666666,40.0,1040.0,26.666666666666668,0
1444,4,0,0,45,0.0,0.0,1.0,45,1000,800,200,0.8,12,8,4,370.23106255195745,0.7721801346801347,0.2047467048835041,0.24072075566434137,135210.56931224803,1011.8305489457377,136222.39986119376,1443,10,716.2444444444444,40,5,18,30.363453520943267,0.6651041666666667,39.989837398373986,1040.0406504065043,26.001016260162608,0
1445,4,0,1,44,0.0,0.022222222222222223,0.9777777777777777,45,900,400,500,0.4444444444444444,14,4,10,365.96841295305603,0.7730639730639731,0.20299842132587487,0.23852770333366655,135298.03363764472,902.9613292075951,136200.9949668523,1444,11,717.2444444444444,41,4,18,30.38712612440799,0.664380081300813,39.90575396825396,1040.376984126983,25.375048393341046,0
1446,4,0,0,44,0.0,0.0,1.0,44,900,500,400,0.5555555555555556,13,5,8,370.1084721904288,0.7716261451726568,0.19872432442032895,0.2411712558760931,135289.8523221133,1214.3841091612294,136504.23643127453,1445,12,731.4772727272727,40,4,18,30.287600534010622,0.6658854166666666,39.91361788617887,1040.3455284552856,26.00863821138214,0
1447,4,0,0,44,0.0,0.0,1.0,44,750,500,250,0.6666666666666666,10,5,5,370.1084721904288,0.7716261451726568,0.19872432442032895,0.2411712558760931,135289.8523221133,1214.3841091612294,136504.23643127453,1446,13,732.4772727272727,40,4,18,30.287600534010622,0.6658854166666666,39.91361788617887,1040.3455284552856,26.00863821138214,0
1448,4,0,0,44,0.0,0.0,1.0,44,750,500,250,0.6666666666666666,10,5,5,373.4407424926756,0.7705470401691332,0.2001109730113635,0.2438796685666454,135369.1585696346,1310.4718173706242,136679.63038700522,1447,14,733.4772727272727,40,4,18,30.121866861979168,0.6666666666666666,39.837398373983746,1040.650406504066,26.01626016260165,0
1449,4,0,0,44,0.0,0.0,1.0,44,500,400,100,0.8,6,4,2,373.4407424926756,0.7705470401691332,0.2001109730113635,0.2438796685666454,135369.1585696346,1310.4718173706242,136679.63038700522,1448,15,734.4772727272727,40,4,18,30.121866861979168,0.6666666666666666,39.837398373983746,1040.650406504066,26.01626016260165,0
1450,4,0,0,44,0.0,0.0,1.0,44,1250,1000,250,0.8,15,10,5,371.07212452692903,0.7684548978153629,0.2007510785383857,0.2430730883137073,135478.71492346932,1254.4749149659797,136733.1898384353,1449,16,735.4772727272727,41,3,18,30.074328187535734,0.666158536585366,39.732142857142854,1041.071428571428,25.391986062717756,0
1451,4,0,0,44,0.0,0.0,1.0,44,1100,800,300,0.7272727272727273,14,8,6,376.2125177928452,0.767904334038055,0.20424672479630135,0.24732969469674868,135607.8467990203,1403.4738953451538,137011.32069436545,1450,17,736.4772727272727,41,3,18,29.811867003206647,0.6674288617886179,39.60813492063491,1041.5674603174587,25.404084397986797,0
1452,4,0,0,44,0.0,0.0,1.0,44,1450,1100,350,0.7586206896551724,18,11,7,375.099710411493,0.7660103946441156,0.20132067030775236,0.24754550577494586,135744.9925578931,1383.5888610799775,137128.58141897307,1451,18,737.4772727272727,38,6,19,29.704266625657834,0.6737938596491229,39.47649572649572,1042.0940170940164,27.423526765632012,0
1453,4,0,0,44,0.0,0.0,1.0,44,1150,1000,150,0.8695652173913043,13,10,3,358.40100168230424,0.7650854474982383,0.15455387378622643,0.23004893886054367,134744.8281923442,858.5362791292268,135603.3644714734,1452,19,738.4772727272727,38,6,17,31.13530733347054,0.6639254385964912,40.43803418803419,1038.247863247863,27.32231219073324,3
1454,4,0,0,44,0.0,0.0,1.0,44,1050,600,450,0.5714285714285714,15,6,9,356.8014757979949,0.7653276955602537,0.15507806799941615,0.22916218497128965,134767.013888889,817.0138888888999,135584.0277777779,1453,20,739.4772727272727,39,5,17,31.154695024077053,0.6623931623931624,40.41666666666667,1038.3333333333342,26.623931623931647,0
1455,4,0,0,44,0.0,0.0,1.0,44,1350,800,550,0.5925925925925926,19,8,11,357.771998897035,0.7671996124031009,0.15604489425659462,0.23058924165986738,134893.6696493491,852.2355658007984,135745.9052151499,1454,21,740.4772727272727,40,4,16,31.003187569295,0.6619791666666666,40.29471544715448,1038.8211382113834,25.970528455284587,0
1456,4,0,0,44,0.0,0.0,1.0,44,900,800,100,0.8888888888888888,10,8,2,355.9515826345709,0.7659443269908387,0.15918869903810262,0.23008602301018483,134999.26155892672,810.640161279681,135809.9017202064,1455,22,741.4772727272727,40,4,16,30.945221331247176,0.6630208333333333,40.19308943089432,1039.227642276424,25.980691056910597,0
1457,4,0,0,44,0.0,0.0,1.0,44,1050,700,350,0.6666666666666666,14,7,7,356.84295235802483,0.7666490486257929,0.1591086873427736,0.2308306688023735,135025.66599122566,836.591459283517,135862.25745050918,1456,23,742.4772727272727,40,4,16,30.89574981258761,0.6632812499999998,40.16768292682928,1039.3292682926844,25.98323170731711,0
1458,4,0,0,44,0.0,0.0,1.0,44,950,700,250,0.7368421052631579,12,7,5,354.64798395457717,0.7647551092318534,0.1605083088954058,0.22991437743062917,135104.8947798931,782.935711216887,135887.83049110998,1457,24,743.4772727272727,40,4,16,30.87385956337569,0.6640624999999998,40.091463414634156,1039.6341463414649,25.990853658536622,0
1459,4,0,0,44,0.0,0.0,1.0,44,950,700,250,0.7368421052631579,12,7,5,356.03609244419204,0.7644908386187457,0.1636265903760037,0.2311523666173208,135157.726882147,824.2057885518002,135981.9326706988,1458,25,744.4772727272727,40,4,17,30.785159304143864,0.6645833333333333,40.04065040650407,1039.8373983739848,25.99593495934962,0
1460,4,0,0,44,0.0,0.0,1.0,44,1100,700,400,0.6363636363636364,15,7,8,346.3080853405846,0.7640063424947147,0.16775295124647815,0.21904201229110432,134208.32920219455,522.1420781281095,134730.47128032267,1459,26,745.4772727272727,40,4,19,31.984356610435462,0.6552083333333333,40.955284552845534,1036.1788617886186,25.904471544715467,4
1461,4,0,0,44,0.0,0.0,1.0,44,900,700,200,0.7777777777777778,11,7,4,328.0776554777633,0.76396229739253,0.11865825392737617,0.1982102412434113,132505.23003472202,-97.1972546516813,132408.03278007032,1460,27,746.4772727272727,39,5,18,34.15958451369217,0.6399572649572651,42.60416666666666,1029.5833333333317,26.399572649572608,8
1462,4,0,0,44,0.0,0.0,1.0,44,850,500,350,0.5882352941176471,12,5,7,325.4404997980162,0.7633897110641297,0.1175487554824064,0.19703798049620216,132585.67843966995,-170.25010850696333,132415.42833116298,1461,28,747.4772727272727,39,5,19,34.14679629816931,0.6407585470085471,42.52604166666666,1029.8958333333317,26.407585470085426,0
1463,4,0,0,44,0.0,0.0,1.0,44,700,300,400,0.42857142857142855,11,3,8,325.0908557723526,0.7640063424947147,0.11484995586937319,0.1969668126150137,132612.5,-177.77777777777692,132434.72222222222,1462,29,748.4772727272727,39,5,19,34.12891046386192,0.6410256410256411,42.5,1030.0,26.41025641025641,0
1464,4,0,0,44,0.0,0.0,1.0,44,1250,800,450,0.64,17,8,9,301.4778151562181,0.7666490486257929,0.0531884437319019,0.181507282646057,132374.1812414268,-818.4242112482725,131555.75703017853,1463,30,749.4772727272727,44,0,17,34.97540639433747,0.631155303030303,42.73148148148149,1029.0740740740755,23.38804713804717,5
1465,4,0,1,43,0.0,0.022727272727272728,0.9772727272727273,44,850,700,150,0.8235294117647058,10,7,3,295.4344303590637,0.7668472515856237,0.053086212680308664,0.17480945551813593,131716.6695362719,-1017.2700100046409,130699.39952626725,1464,31,750.4772727272727,43,1,15,35.78951414514145,0.625968992248062,43.371212121212125,1026.5151515151522,23.872445384073306,2
1466,4,0,0,43,0.0,0.0,1.0,43,1150,900,250,0.782608695652174,14,9,5,300.49500514304054,0.758813215208564,0.07845133879487576,0.17819505145499737,131800.32680014736,-678.9320240670523,131121.3947760803,1465,60,768.2093023255813,42,1,15,35.575713252178275,0.6282242063492063,43.28972868217055,1026.841085271319,24.448597268364736,0
1467,4,0,0,43,0.0,0.0,1.0,43,900,500,400,0.5555555555555556,13,5,8,303.2454610181558,0.7584440753045404,0.07386134269416389,0.18017947795921818,131874.96244216096,-601.9032434949812,131273.059198666,1466,61,769.2093023255813,42,1,15,35.430227987421375,0.628968253968254,43.21705426356589,1027.1317829457366,24.455518641565156,0
1468,4,0,0,43,0.0,0.0,1.0,43,900,600,300,0.6666666666666666,12,6,6,304.9355051393165,0.7590900701365817,0.07530997150872176,0.18154021117305855,131949.61921045915,-552.7752426236353,131396.8439678355,1467,62,770.2093023255813,42,1,15,35.31194001697632,0.6297123015873016,43.14437984496124,1027.4224806201553,24.4624400147656,0
1469,4,0,0,43,0.0,0.0,1.0,43,1250,800,450,0.64,17,8,9,302.55257849165895,0.7604743447766703,0.07011820828510351,0.18071383742339636,132074.0941049216,-608.1284553211909,131465.9656496004,1468,63,771.2093023255813,42,1,16,35.24835815736552,0.6309523809523809,43.02325581395349,1027.906976744186,24.473975636766333,0
1470,4,0,0,43,0.0,0.0,1.0,43,1350,1100,250,0.8148148148148148,16,11,5,303.3327560248349,0.7591823551125877,0.07437389878943579,0.18165729158778463,132173.71627306036,-581.4764737696153,131592.23979929075,1469,64,772.2093023255813,42,1,17,35.12847091343135,0.6319444444444444,42.92635658914728,1028.2945736434096,24.483204134366897,0
1471,4,1,1,43,0.022727272727272728,0.022727272727272728,0.9772727272727273,44,1350,1100,250,0.8148148148148148,16,11,5,301.3132632185368,0.7640063424947147,0.07682862130339574,0.18188364252464415,132472.80812451182,-816.6470426957428,131656.16108181607,1470,0,755.6363636363636,42,2,18,34.88092996987952,0.6349206349206349,42.63565891472869,1029.4573643410858,24.510889627168712,0
1472,4,1,1,43,0.022727272727272728,0.022727272727272728,0.9772727272727273,44,1000,800,200,0.8,12,8,4,301.12554483458956,0.7655258985200846,0.07627441251700184,0.18213210955931608,132547.63390308578,-817.3043048795149,131730.32959820627,1471,0,756.6136363636364,42,2,18,34.81089834070448,0.6356646825396826,42.56298449612403,1029.748062015504,24.517811000369143,0
1473,4,0,0,43,0.0,0.0,1.0,43,1000,700,300,0.7,13,7,6,305.87667457447094,0.7582133628645257,0.07758810005064376,0.18477230085761684,132500.12302374648,-494.26059775762997,132005.86242598886,1472,67,775.2093023255813,41,2,18,34.73614055373546,0.6366869918699187,42.60912698412698,1029.5634920634916,25.111304684475403,0
1474,4,0,0,43,0.0,0.0,1.0,43,1000,700,300,0.7,13,7,6,306.5036018458691,0.7570598006644518,0.0778748294625915,0.185528506749969,132576.73852237655,-472.9504243827179,132103.78809799382,1473,68,776.2093023255813,41,2,18,34.6433187233086,0.6374491869918699,42.53472222222222,1029.861111111111,25.118563685636857,0
1475,4,0,0,43,0.0,0.0,1.0,43,1100,600,500,0.5454545454545454,16,6,10,311.4987540049843,0.7543373938722776,0.07591048705572634,0.189452520878441,132755.59413580224,-329.3595679012579,132426.23456790097,1474,69,777.2093023255813,41,2,14,34.33569182389937,0.6392276422764228,42.3611111111111,1030.5555555555536,25.135501355013503,0
1476,4,0,0,43,0.0,0.0,1.0,43,750,600,150,0.8,9,6,3,309.4779540019859,0.7527224067921742,0.07477097209258599,0.1886840087465402,132847.14828022648,-377.347271047423,132469.80100917906,1475,70,778.2093023255813,42,1,14,34.29618228530251,0.6386408730158731,42.27228682170542,1030.9108527131775,24.545496493170894,0
1477,4,1,0,44,0.022727272727272728,0.0,1.0,44,1000,700,300,0.7,13,7,6,303.0766175256093,0.7622225158562368,0.07636513789018817,0.1861853989737367,133129.95455262848,-730.2847365702585,132399.66981605822,1476,0,761.5,43,1,16,34.178671927570804,0.6400193798449614,41.998106060606055,1032.007575757575,24.000176180408722,0
1478,4,0,0,44,0.0,0.0,1.0,44,650,400,250,0.6153846153846154,9,4,5,303.2295280904147,0.7628171247357294,0.009507228451327343,0.18472415035562018,132816.6943969363,-689.4423046596199,132127.2520922767,1477,1,762.5,40,4,17,34.487659798218786,0.6414062500000001,42.30182926829268,1030.792682926829,25.769817073170724,7
1479,4,0,0,44,0.0,0.0,1.0,44,1250,900,350,0.72,16,9,7,300.47507844177954,0.7636760042283298,0.015505438775692992,0.18343081503431358,132895.27253123128,-813.6565123273316,132081.61601890397,1478,2,763.5,40,4,17,34.48013174321572,0.6421875000000001,42.225609756097555,1031.0975609756088,25.77743902439022,0
1480,4,0,0,44,0.0,0.0,1.0,44,1350,1100,250,0.8148148148148148,16,11,5,299.752430060592,0.7635658914728682,0.013377544532110486,0.183632282289986,133026.28772762566,-825.0093983409433,132201.27832928472,1479,3,764.5,40,4,17,34.36791941680622,0.6434895833333334,42.09857723577235,1031.60569105691,25.79014227642275,0
1481,4,2,2,44,0.043478260869565216,0.043478260869565216,0.9565217391304348,46,800,400,400,0.5,12,4,8,288.57374120740957,0.7731682769726248,0.017563782115319615,0.17879499142908814,133447.19109616306,-1498.128962352023,131949.06213381104,1480,0,732.2173913043479,42,4,18,34.23676888930571,0.644593253968254,41.690891472868216,1033.236434108527,24.60086747877445,0
1482,4,0,0,44,0.0,0.0,1.0,44,1050,700,350,0.6666666666666666,14,7,7,302.6059296326123,0.7618481324876674,0.014856956214372552,0.18642653966875136,133236.04630387016,-736.3964695287136,132499.64983434146,1481,5,766.5,40,4,18,34.08492469731272,0.6455729166666667,41.895325203252035,1032.4186991869926,25.810467479674816,0
1483,4,0,0,44,0.0,0.0,1.0,44,550,200,350,0.36363636363636365,9,2,7,302.0743157851272,0.760989252995067,0.012408080012882072,0.18649326834802316,133314.74837233117,-745.807720272337,132568.94065205884,1482,6,767.5,40,4,18,34.02012399134029,0.6463541666666668,41.819105691056905,1032.7235772357715,25.818089430894286,0
1484,4,0,0,44,0.0,0.0,1.0,44,1200,700,500,0.5833333333333334,17,7,10,302.2285306872664,0.7593375616631431,0.015439164416146234,0.18711664086277402,133419.720611078,-735.3507750016649,132684.36983607634,1483,7,768.5,40,4,18,33.91144501278771,0.6473958333333334,41.71747967479674,1033.1300813008124,25.82825203252031,0
1485,4,0,0,44,0.0,0.0,1.0,44,1650,1200,450,0.7272727272727273,21,12,9,302.49153491457935,0.7575757575757576,0.0150087491869213,0.18795388233922183,133552.96359592024,-720.2614820486428,132832.7021138716,1484,8,769.5,39,5,19,33.77181379959018,0.6503739316239316,41.58854166666667,1033.6458333333342,26.503739316239336,0
1486,4,0,0,44,0.0,0.0,1.0,44,950,600,350,0.631578947368421,13,6,7,306.4204567959809,0.757950140944327,0.02769498261301573,0.18486245140768529,132451.61132812512,-666.7399088541517,131784.87141927096,1485,9,770.5,39,5,19,34.770711057140936,0.6394230769230769,42.65625000000001,1029.375000000001,26.39423076923079,3
1487,4,1,1,44,0.022222222222222223,0.022222222222222223,0.9777777777777777,45,600,500,100,0.8333333333333334,7,5,2,301.994052406247,0.7664983164983166,0.02506740316959255,0.18333028163440332,132685.78247901387,-985.9365704937524,131699.8459085201,1486,0,754.3555555555556,40,5,15,34.65036660748338,0.6401041666666667,42.42886178861789,1030.2845528455289,25.757113821138223,0
1488,4,1,1,44,0.022222222222222223,0.022222222222222223,0.9777777777777777,45,1050,600,450,0.5714285714285714,15,6,9,301.3924938433767,0.7625420875420876,0.030737639169634567,0.1834309676941322,132781.15477962006,-996.1513251133899,131785.00345450666,1487,0,755.3333333333334,41,4,15,34.57051929925883,0.6394817073170731,42.33630952380952,1030.654761904761,25.137921022067342,0
1489,4,1,1,44,0.022222222222222223,0.022222222222222223,0.9777777777777777,45,800,700,100,0.875,9,7,2,299.1415528120688,0.7680555555555556,0.032513336968258644,0.18255890536557998,132883.4219596401,-1049.8093624023923,131833.61259723772,1488,0,756.3111111111111,41,4,16,34.52634385323456,0.6404979674796749,42.23710317460316,1031.0515873015854,25.147599690282572,0
1490,4,0,0,44,0.0,0.0,1.0,44,1200,800,400,0.6666666666666666,16,8,8,299.035061538579,0.765349718111346,0.03872684272763194,0.18280769906587324,132947.67086390348,-848.7970123603883,132098.8738515431,1489,1,769.3181818181819,40,4,16,34.464919195900684,0.6427083333333334,42.17479674796747,1031.300813008128,25.7825203252032,0
1491,4,0,0,44,0.0,0.0,1.0,44,1450,1200,250,0.8275862068965517,17,12,5,298.3440126158049,0.7649092670894997,0.03412672827566432,0.18289785121229757,133052.4985127898,-860.9167410271871,132191.58177176263,1490,2,770.3181818181819,40,4,16,34.37807821118991,0.6437500000000002,42.07317073170731,1031.7073170731692,25.79268292682923,0
1492,4,0,1,43,0.0,0.022727272727272728,0.9772727272727273,44,1450,1200,250,0.8275862068965517,17,12,5,300.80832661665374,0.7657681465821001,0.028239083750895677,0.1854497935937618,133262.27774472826,-782.7194460969353,132479.5582986313,1491,3,771.3181818181819,40,4,18,34.10515091863519,0.6458333333333335,41.869918699186975,1032.5203252032488,25.813008130081222,0
1493,4,1,0,44,0.022727272727272728,0.0,1.0,44,950,800,150,0.8421052631578947,11,8,3,318.96566148534976,0.77184637068358,0.06970471323111838,0.18537905276425817,131030.32889399704,-441.1648939366366,130589.1640000604,1492,0,757.6818181818181,42,2,16,35.876474856457804,0.6205357142857141,44.04069767441862,1023.8372093023279,24.37707641196019,5
1494,4,0,0,44,0.0,0.0,1.0,44,1000,600,400,0.6,14,6,8,317.09189267566984,0.7710315362931642,0.07104584157564253,0.18476633437606602,131129.55670482575,-483.97613574902607,130645.58056907673,1493,1,758.6818181818181,42,2,16,35.82446389151687,0.6215277777777777,43.943798449612416,1024.2248062015528,24.38630490956078,0
1495,4,1,0,45,0.022222222222222223,0.0,1.0,45,1500,1400,100,0.9333333333333333,16,14,2,316.4157684302438,0.7790824915824917,0.07435152155723013,0.18608787499988463,131484.42147531232,-678.8004543877321,130805.62102092459,1494,0,742.8,40,5,17,35.484583498480674,0.628125,43.59756097560976,1025.609756097561,25.64024390243903,0
1496,4,1,3,43,0.021739130434782608,0.06521739130434782,0.9347826086956522,46,1150,700,450,0.6086956521739131,16,7,9,313.0991117353114,0.7824275362318841,0.0408013178796256,0.18510419485791618,131684.26890432098,-953.9544753086408,130730.31442901235,1495,0,727.6304347826087,44,2,13,35.368741542625166,0.6242897727272727,43.40277777777778,1026.388888888889,23.327020202020204,5
1497,4,1,1,43,0.022727272727272728,0.022727272727272728,0.9772727272727273,44,1150,900,250,0.782608695652174,14,9,5,323.1252770533497,0.7768895348837209,0.05028068428597243,0.19086557776196442,131651.1188949731,-292.0391465356788,131359.07974843742,1496,0,761.5909090909091,42,2,13,35.1448163535077,0.6267361111111112,43.43507751937984,1026.2596899224793,24.434754521963793,0
1498,4,0,0,43,0.0,0.0,1.0,43,600,200,400,0.3333333333333333,10,2,8,329.3815709433094,0.764765596160945,0.06148491879350382,0.19447048914598086,131633.36167800426,71.52069160995526,131704.8823696142,1497,9,780.3023255813954,41,2,13,35.00217517401393,0.628048780487805,43.45238095238094,1026.190476190474,25.02903600464571,0
1499,4,0,0,43,0.0,0.0,1.0,43,750,600,150,0.8,9,6,3,328.44038711808525,0.7646733111849391,0.05969404385895882,0.19404430638130132,131658.81406092504,48.41437153562575,131707.22843246066,1498,10,781.3023255813954,41,2,13,35.000704849363615,0.6283028455284554,43.42757936507935,1026.2896825396804,25.031455671699522,0
1500,4,0,0,43,0.0,0.0,1.0,43,950,800,150,0.8421052631578947,11,8,3,327.0727973922455,0.7646733111849391,0.06291423573225563,0.18955522347743892,130921.69390904545,-35.81506676741333,130885.87884227803,1499,11,782.3023255813954,41,2,15,35.77856404291068,0.6209349593495933,44.14682539682541,1023.4126984127013,24.961285327139056,1
1501,4,0,0,43,0.0,0.0,1.0,43,650,400,250,0.6153846153846154,9,4,5,324.1481882098426,0.7643964562569213,0.05914007571660296,0.18835637963544943,131023.24263038575,-105.81065759635018,130917.4319727894,1500,12,783.3023255813954,41,2,16,35.75096899224806,0.621951219512195,44.04761904761906,1023.8095238095259,24.97096399535429,0
1502,4,0,0,43,0.0,0.0,1.0,43,1050,700,350,0.6666666666666666,14,7,7,322.9702475840802,0.7643041712809154,0.05914664095204225,0.1879198926472874,131074.03175390538,-133.39750251951003,130940.63425138587,1501,13,784.3023255813954,41,2,16,35.7299134534651,0.6224593495934958,43.99801587301588,1024.0079365079375,24.97580332946189,0
1503,4,0,0,43,0.0,0.0,1.0,43,1150,800,350,0.6956521739130435,15,8,7,321.56809104182105,0.7641196013289037,0.06231907011940252,0.18761687960784426,131179.18469442963,-163.39199867794352,131015.79269575169,1502,14,785.3023255813954,42,1,17,35.65984045907428,0.6220238095238094,43.89534883720931,1024.4186046511645,24.39091915836106,0
1504,4,0,0,43,0.0,0.0,1.0,43,1050,900,150,0.8571428571428571,12,9,3,318.8442890705643,0.7636581764488741,0.06299915561341174,0.18650980095189656,131278.46884201677,-228.52198635898532,131049.94685565778,1503,15,786.3023255813954,42,1,17,35.629609493192135,0.623015873015873,43.798449612403104,1024.806201550388,24.40014765596162,0
1505,4,1,1,43,0.022727272727272728,0.022727272727272728,0.9772727272727273,44,1450,1200,250,0.8275862068965517,17,12,5,319.75960538815184,0.7723528893587034,0.06910877716912589,0.18884113589053955,131643.77371907988,-381.12777275597756,131262.6459463239,1504,0,769.4090909090909,43,1,14,35.23855387407339,0.6252422480620157,43.442234848484844,1026.2310606060598,23.865838618745578,0
1506,4,0,0,43,0.0,0.0,1.0,43,1300,900,400,0.6923076923076923,17,9,8,321.5670807814828,0.7644887412329272,0.06080499543314888,0.19006911381905484,131675.98101075648,-131.46783546662087,131544.51317528987,1505,17,788.3023255813954,42,1,15,35.159790407855,0.626984126984127,43.41085271317829,1026.3565891472863,24.437061646363958,0
1507,4,0,0,43,0.0,0.0,1.0,43,1050,800,250,0.7619047619047619,13,8,5,322.3833469521834,0.7644887412329272,0.11963942820567541,0.17569892408893986,128512.70957274195,-313.92851240911625,128198.78106033284,1506,18,789.3023255813954,42,1,14,38.33958492609583,0.5952380952380953,46.51162790697674,1013.9534883720925,24.141749723145058,7
1508,4,0,0,43,0.0,0.0,1.0,43,800,500,300,0.625,11,5,6,323.1591483362397,0.7643964562569213,0.11770353003922218,0.1762303536914407,128537.27357317763,-292.400828525939,128244.8727446517,1507,19,790.3023255813954,42,1,14,38.294911610129,0.5954861111111112,46.48740310077519,1014.0503875968988,24.144056847545208,0
1509,4,0,0,43,0.0,0.0,1.0,43,1000,800,200,0.8,12,8,4,322.99805813516923,0.7643503137689184,0.11975622165788025,0.17635997258741848,128586.40861614367,-293.36794288205385,128293.04067326162,1508,20,791.3023255813954,42,1,14,38.2489809241744,0.5959821428571429,46.438953488372086,1014.2441860465101,24.148671096345478,0
1510,4,5,3,45,0.10416666666666667,0.0625,0.9375,48,850,700,150,0.8235294117647058,10,7,3,309.27565223959,0.7987588652482269,0.1584120181011226,0.17378418190147304,129720.15621856276,-1574.6757122877548,128145.480506275,1509,0,709.7708333333334,46,2,13,37.447060017985066,0.602128623188406,45.32358156028368,1018.7056737588637,22.145775516497036,0
1511,4,0,1,44,0.0,0.022222222222222223,0.9777777777777777,45,1200,900,300,0.75,15,9,6,326.22371871362753,0.7802609427609428,0.16544978960536838,0.18212604181897943,129466.28146701382,-553.0056423611157,128913.27582465271,1510,1,758.0888888888888,43,2,14,37.27290174002047,0.6034399224806202,45.572916666666664,1017.7083333333327,23.667635658914715,0
1512,4,3,2,45,0.06382978723404255,0.0425531914893617,0.9574468085106383,47,1350,900,450,0.6666666666666666,18,9,9,312.6412993068727,0.795713845205057,0.17770303465477566,0.17707952868186017,130031.52239550493,-1269.3551774837383,128762.16721802119,1511,0,724.531914893617,45,2,16,37.04632918886915,0.6064814814814815,45.01811594202898,1019.9275362318823,22.665056360708494,0
1513,4,1,0,46,0.021739130434782608,0.0,1.0,46,650,400,250,0.6153846153846154,9,4,5,318.10318585779106,0.7934782608695652,0.18125814476957736,0.17960595263047574,129908.37191358018,-935.1466049382786,128973.22530864191,1512,0,741.2608695652174,44,2,17,37.031675749318794,0.6065340909090909,45.138888888888886,1019.4444444444439,23.169191919191906,0
1514,4,2,1,47,0.041666666666666664,0.020833333333333332,0.9791666666666666,48,1150,1000,150,0.8695652173913043,13,10,3,315.75621079439986,0.8100805260047281,0.19399942811215198,0.18024347384838588,130335.09926143521,-1367.7298254801976,128967.36943595501,1513,0,711.3333333333334,43,5,18,36.6600397230208,0.6121608527131783,44.72064393939393,1021.117424242423,23.746916842847046,0
1515,4,2,2,47,0.04081632653061224,0.04081632653061224,0.9591836734693877,49,850,400,450,0.47058823529411764,13,4,9,313.0650205830609,0.8111536281179138,0.22195193679677905,0.1754475055530793,129616.12335249953,-1680.5765363223045,127935.54681617723,1514,0,697.7755102040817,45,4,14,37.45589456205896,0.6023148148148147,45.425724637681164,1018.2971014492758,22.628824476650575,2
1516,4,0,0,47,0.0,0.0,1.0,47,600,300,300,0.5,9,3,6,325.80194464791055,0.7997995683009559,0.22339336252601827,0.1814458419571026,129369.92550684427,-970.2053381829425,128399.72016866133,1515,1,728.4255319148937,43,4,16,37.38141502994197,0.6024709302325579,45.66761363636365,1017.3295454545477,23.65882663847785,0
1517,4,0,0,47,0.0,0.0,1.0,47,1250,1000,250,0.8,15,10,5,328.23518195885055,0.7991057662658032,0.22692131797295234,0.18324901301359856,129466.28146701412,-900.9223090277521,128565.35915798637,1516,2,729.4255319148937,43,4,15,37.22172466734905,0.6034399224806201,45.57291666666668,1017.7083333333353,23.667635658914776,0
1518,4,0,1,46,0.0,0.02127659574468085,0.9787234042553191,47,1150,600,550,0.5217391304347826,17,6,11,332.6872741284009,0.8002235584335491,0.2317629179331302,0.18630487351190483,129586.77685950442,-777.6256887052073,128809.15117079922,1517,3,730.4255319148937,43,4,15,36.98614211309524,0.6046511627906975,45.45454545454547,1018.1818181818205,23.678646934460943,0
1519,4,2,2,46,0.041666666666666664,0.041666666666666664,0.9583333333333334,48,950,700,250,0.7368421052631579,12,7,5,322.68091761911916,0.8115026595744681,0.22482370921856965,0.1826314299412633,130002.78206447209,-1210.1165980795427,128792.66546639254,1518,0,694.5,44,4,15,36.81942679014586,0.6074810606060606,45.046296296296305,1019.8148148148165,23.177609427609465,0
1520,4,1,2,45,0.02127659574468085,0.0425531914893617,0.9574468085106383,47,1200,600,600,0.5,18,6,12,327.7734733599135,0.807200123342584,0.2259832965087094,0.18514214135324406,129924.4621283863,-882.841554752047,129041.62057363425,1519,0,710.2553191489362,43,4,15,36.76891758003593,0.6080426356589147,45.12310606060607,1019.507575757577,23.709478505990162,0
1521,4,1,1,45,0.021739130434782608,0.021739130434782608,0.9782608695652174,46,850,500,350,0.5882352941176471,12,5,7,337.735146116672,0.7979468599033817,0.23782869044519628,0.19073062116443956,129916.60399202285,-424.51935355446136,129492.08463846838,1520,0,726.0,42,4,15,36.52298577448278,0.609375,45.13081395348838,1019.4767441860475,24.27325581395351,0
1522,4,0,0,45,0.0,0.0,1.0,45,650,300,350,0.46153846153846156,10,3,7,342.9065857280111,0.7900673400673401,0.24016095534787096,0.19311055090998527,129807.25623582772,-97.64739229024315,129709.60884353748,1521,7,743.1333333333333,41,4,15,36.50214174454828,0.6097560975609755,45.23809523809524,1019.0476190476195,24.854819976771207,0
1523,4,0,0,45,0.0,0.0,1.0,45,850,400,450,0.47058823529411764,13,4,9,344.38595579445996,0.7904040404040404,0.23784438389343054,0.19444560888702572,129908.3719135802,-52.276234567907494,129856.09567901229,1522,8,744.1333333333333,41,4,15,36.361830154405084,0.6107723577235773,45.138888888888886,1019.444444444444,24.86449864498644,0
1524,4,1,1,45,0.021739130434782608,0.021739130434782608,0.9782608695652174,46,1350,1100,250,0.8148148148148148,16,11,5,335.8152521757483,0.798389694041868,0.22650931205178892,0.19085107504926088,130163.68762581871,-457.80968316207543,129705.87794265663,1523,0,728.9347826086956,42,4,15,36.32153483366569,0.6118551587301587,44.888565891472865,1020.4457364341081,24.296327057954954,0
1525,4,2,1,46,0.0425531914893617,0.02127659574468085,0.9787234042553191,47,700,500,200,0.7142857142857143,9,5,4,327.08559569902354,0.8093971631205673,0.21952651855320027,0.18731468959558967,130460.49783854632,-865.6125120185108,129594.8853265278,1524,0,714.3829787234042,42,5,17,36.24403237535175,0.6148313492063493,44.59786821705426,1021.6085271317826,24.324012550756727,0
1526,4,1,1,46,0.02127659574468085,0.02127659574468085,0.9787234042553191,47,900,500,400,0.5555555555555556,13,5,8,329.46934652264747,0.8064292321924144,0.23014877073489592,0.18904155214514912,130534.7532074395,-798.5600324499695,129736.19317498953,1525,0,715.3617021276596,42,5,13,36.108082053227136,0.6155753968253967,44.525193798449614,1021.8992248062018,24.330933923957186,0
1527,4,1,0,47,0.02127659574468085,0.0,1.0,47,1050,700,350,0.6666666666666666,14,7,7,331.685211150251,0.804232192414431,0.22914377636810657,0.1866062062731348,129768.46648526231,-791.5437586382991,128976.922726624,1526,0,716.3191489361702,42,5,16,36.82734981772073,0.6078869047619048,45.276162790697676,1018.8953488372093,24.259413067552604,2
1528,4,0,0,47,0.0,0.0,1.0,47,1450,1000,450,0.6896551724137931,19,10,9,327.6627262552066,0.8030758556891766,0.21764685663217964,0.18527645719417202,129966.00193986246,-882.9970967790343,129083.00484308343,1527,1,717.3191489361702,42,5,16,36.729663594032125,0.6098710317460316,45.082364341085274,1019.6705426356594,24.277870062753795,0
1529,4,1,1,47,0.020833333333333332,0.020833333333333332,0.9791666666666666,48,1050,700,350,0.6666666666666666,14,7,7,321.9117409257629,0.8131464243498818,0.207128993844917,0.18307350036712114,130190.09452658682,-1218.0560039313652,128972.03852265545,1528,0,703.3541666666666,43,5,18,36.64951981070799,0.6107073643410853,44.86268939393939,1020.5492424242418,23.73370331219167,0
1530,4,1,0,48,0.020833333333333332,0.0,1.0,48,800,400,400,0.5,12,4,8,323.0320699708457,0.8073286052009456,0.20960884353741527,0.1840531561461795,130262.58680555547,-1184.1610350665792,129078.4257704889,1529,0,704.3333333333334,41,7,19,36.54761904761906,0.6143292682926829,44.791666666666664,1020.8333333333327,24.898373983739823,0
1531,4,0,0,48,0.0,0.0,1.0,48,1500,1200,300,0.8,18,12,6,324.7251255519251,0.8059618794326241,0.20832321515298724,0.1856216084151619,130389.20899667729,-1131.8695475875606,129257.33944908973,1530,1,705.3333333333334,41,7,19,36.37637607252714,0.6155995934959348,44.66765873015873,1021.3293650793645,24.91047231900889,0
1532,4,0,0,48,0.0,0.0,1.0,48,1150,800,350,0.6956521739130435,15,8,7,329.0231887196711,0.8057771867612293,0.21467339780053063,0.1890270476369876,130584.26852352635,-1006.9495147527078,129577.31900877364,1531,2,706.3333333333334,42,6,15,36.069436544052586,0.6160714285714286,44.47674418604652,1022.093023255815,24.3355481727575,0
1533,4,0,1,47,0.0,0.020833333333333332,0.9791666666666666,48,1200,700,500,0.5833333333333334,17,7,10,327.5472301030377,0.8041703605200945,0.21030514763934938,0.189024659034312,130757.64607182577,-1034.1390428760133,129723.50702894977,1532,3,707.3333333333334,42,6,15,35.93202273803884,0.6178075396825395,44.30717054263567,1022.7713178294587,24.35169804355854,0
1534,4,1,0,48,0.020833333333333332,0.0,1.0,48,900,500,400,0.5555555555555556,13,5,8,329.3214570114373,0.8044104609929078,0.22489862412824646,0.19102814664534962,130955.93268320734,-974.680288894876,129981.25239431247,1533,0,708.25,42,6,16,35.68647637981634,0.6197916666666665,44.113372093023266,1023.5465116279086,24.370155038759727,0
1535,4,0,1,47,0.0,0.020833333333333332,0.9791666666666666,48,1750,1400,350,0.8,21,14,7,331.2216238364551,0.804188829787234,0.22493927061644192,0.1925020724673263,131030.32889399704,-919.9843383810812,130110.34455561596,1534,1,709.25,42,6,16,35.562772099186056,0.6205357142857141,44.04069767441862,1023.8372093023279,24.37707641196019,0
1536,4,1,1,47,0.020833333333333332,0.020833333333333332,0.9791666666666666,48,1200,1000,200,0.8333333333333334,14,10,4,330.73998270427666,0.80007018321513,0.2214189444812258,0.19309297830658861,131204.00221027897,-921.1181156480806,130282.88409463089,1535,0,709.7916666666666,42,6,16,35.39991803020272,0.6222718253968254,43.87112403100776,1024.5155038759701,24.393226282761194,0
1537,4,0,0,47,0.0,0.0,1.0,47,1250,900,350,0.72,16,9,7,335.29642899657966,0.79563675609004,0.2275287344753314,0.19537393905699288,131129.55670482558,-606.5455801934868,130523.01112463209,1536,3,725.8936170212766,42,5,16,35.35832544938505,0.6215277777777777,43.94379844961241,1024.2248062015515,24.38630490956075,0
1538,4,1,0,48,0.020833333333333332,0.0,1.0,48,1400,1100,300,0.7857142857142857,17,11,6,329.5563539373778,0.803764036643026,0.2299108549108544,0.1935274882000744,131427.46548434623,-937.2985021933473,130490.16698215289,1537,0,711.75,42,6,17,35.205025830025846,0.6245039682539681,43.65310077519381,1025.3875968992274,24.413990402362558,0
1539,4,0,0,48,0.0,0.0,1.0,48,1700,1500,200,0.8823529411764706,19,15,4,333.90900068748374,0.8030437352245863,0.2386724897702237,0.1971068181315749,131626.25912655494,-809.7614701640473,130816.4976563909,1538,1,712.75,42,6,16,34.89317752596791,0.6264880952380951,43.4593023255814,1026.1627906976748,24.432447397563685,0
1540,4,0,0,48,0.0,0.0,1.0,48,1250,1000,250,0.8,15,10,5,325.3966197533308,0.8038379137115839,0.19440920776672765,0.19246448325626156,131702.0887586804,-1000.9529421402908,130701.1358165401,1539,2,713.75,39,9,18,35.03526486705906,0.6319444444444446,43.38541666666666,1026.458333333332,26.319444444444407,2
1541,4,0,0,48,0.0,0.0,1.0,48,1550,1000,550,0.6451612903225806,21,10,11,328.98615160013304,0.8025265957446809,0.2052931582327686,0.19554746479378604,131889.27001953113,-922.0513237847363,130967.2186957464,1540,3,714.75,39,9,18,34.75486343508095,0.6338141025641026,43.20312499999999,1027.187499999999,26.338141025641,0
1542,4,0,0,48,0.0,0.0,1.0,48,1500,1200,300,0.8,18,12,6,324.73215518058083,0.8008828309692672,0.19365986084371967,0.19411154690957907,132103.35422092007,-1020.3586154513937,131082.99560546866,1541,4,715.75,39,9,18,34.64900614719493,0.6359508547008548,42.994791666666664,1028.0208333333328,26.359508547008534,0
1543,4,0,0,48,0.0,0.0,1.0,48,1300,1100,200,0.8461538461538461,15,11,4,323.2289825542826,0.800956708037825,0.1852337182214121,0.19376076167325032,132210.46142578125,-1053.1494140624998,131157.31201171875,1542,5,716.75,39,9,19,34.58010483135825,0.6370192307692308,42.890625,1028.4375,26.370192307692307,0
1544,4,0,0,48,0.0,0.0,1.0,48,1300,900,400,0.6923076923076923,17,9,8,320.78559329349656,0.7995530437352246,0.1909365534044516,0.19285233649069822,132319.57250974944,-1110.7574856236438,131208.8150241258,1543,6,717.75,40,8,19,34.53345186355855,0.6364583333333333,42.78455284552845,1028.8617886178856,25.72154471544714,0
1545,4,0,0,48,0.0,0.0,1.0,48,850,500,350,0.5882352941176471,12,5,7,321.7558065203495,0.7989804964539007,0.19542847503373828,0.19383825417201533,132398.00347222216,-1079.9882469099189,131318.01522531224,1544,7,718.75,38,10,19,34.42982456140351,0.640625,42.70833333333333,1029.166666666666,27.083333333333318,0
1546,4,1,0,49,0.02040816326530612,0.0,1.0,49,850,400,450,0.47058823529411764,13,4,9,312.13445466239995,0.8038194444444444,0.19671062033650655,0.1896184083775957,132711.95969867468,-1515.2049664551623,131196.7547322195,1545,0,705.0612244897959,40,9,17,34.36297958378539,0.6403645833333333,42.40345528455284,1030.386178861788,25.7596544715447,0
1547,4,0,0,49,0.0,0.0,1.0,49,1100,700,400,0.6363636363636364,15,7,8,309.7974838927926,0.8015164399092971,0.19581936501676167,0.1885934022593459,132790.50684942826,-1572.3670186396976,131218.13983078857,1546,1,706.0612244897959,40,9,17,34.344598369815294,0.6411458333333333,42.327235772357724,1030.6910569105692,25.76727642276423,0
1548,4,0,0,49,0.0,0.0,1.0,49,1000,600,400,0.6,14,6,8,312.8856444772866,0.8007015306122449,0.19842543759076703,0.19100708476934705,132895.27253123125,-1483.7954012162213,131411.47713001503,1547,2,707.0612244897959,40,9,17,34.16021913397728,0.6421875000000001,42.225609756097555,1031.0975609756085,25.777439024390212,0
1549,4,0,0,49,0.0,0.0,1.0,49,1100,700,400,0.6363636363636364,15,7,8,316.93786362188354,0.8004535147392291,0.21147939081069778,0.19429669030732866,133052.4985127901,-1366.125074360491,131686.3734384296,1548,3,708.0612244897959,40,9,17,33.898492907801426,0.6437499999999999,42.07317073170732,1031.7073170731715,25.792682926829286,0
1550,4,1,0,50,0.02,0.0,1.0,50,1250,900,350,0.72,16,9,7,316.27500536803615,0.8061054421768707,0.221455909943715,0.19556215529137258,133372.11180217515,-1563.546924764158,131808.564877411,1549,0,694.88,42,8,18,33.596192933083174,0.6438492063492064,41.76356589147286,1032.945736434107,24.593946105573973,0
1551,4,0,0,50,0.0,0.0,1.0,50,1300,1000,300,0.7692307692307693,16,10,6,316.46591177746353,0.8067006802721088,0.22341025899425548,0.19663689684206467,133552.96359592024,-1546.8952474897178,132006.06834843053,1550,1,695.88,39,11,19,33.410699889146436,0.6503739316239316,41.58854166666667,1033.6458333333342,26.503739316239336,0
1552,4,0,0,50,0.0,0.0,1.0,50,1350,800,550,0.5925925925925926,19,8,11,317.56720809696054,0.8064455782312925,0.23023864666196747,0.1984745087231539,133768.3932834202,-1503.9089626736045,132264.48432074662,1551,2,696.88,39,11,16,33.16729181351323,0.6525106837606838,41.380208333333336,1034.4791666666672,26.525106837606852,0
1553,4,0,0,50,0.0,0.0,1.0,50,1200,800,400,0.6666666666666666,16,8,8,317.67993703074853,0.8059353741496599,0.22703845379504695,0.19898061125242486,133849.22417534734,-1495.757378472216,132353.46679687512,1552,3,697.88,39,11,16,33.08376954566805,0.6533119658119659,41.302083333333336,1034.7916666666674,26.533119658119677,0
1554,4,0,0,50,0.0,0.0,1.0,50,1000,600,400,0.6,14,6,8,316.2959842904395,0.8056632653061224,0.2254353296426772,0.19825871318142052,133876.17323133675,-1531.100802951393,132345.07242838535,1553,4,698.88,39,11,16,33.09270676061063,0.6535790598290598,41.276041666666664,1034.895833333333,26.53579059829059,0
1555,4,0,1,49,0.0,0.02,0.98,50,1100,800,300,0.7272727272727273,14,8,6,315.7733106717634,0.8056632653061224,0.22335715004528467,0.19822106052718355,133930.0794813369,-1541.6910807291608,132388.38840060774,1554,5,699.88,39,11,17,33.05250159337155,0.6541132478632479,41.223958333333336,1035.1041666666674,26.5411324786325,0
1556,4,0,0,49,0.0,0.0,1.0,49,950,600,350,0.631578947368421,13,6,7,324.3114384820554,0.8007015306122449,0.22309890498950513,0.20288320221319248,133803.6242603548,-1121.1908284023948,132682.4334319524,1555,10,715.0612244897959,38,11,17,32.957713754646846,0.6546052631578949,41.34615384615383,1034.6153846153827,27.22672064777323,0
1557,4,0,0,49,0.0,0.0,1.0,49,1150,700,450,0.6086956521739131,16,7,9,323.53497590198646,0.8002054988662132,0.22122996849746612,0.20254920760250397,133831.25964506157,-1140.1813271605122,132691.07831790106,1556,11,716.0612244897959,38,11,17,32.95022371364652,0.6548793859649124,41.319444444444436,1034.722222222221,27.229532163742658,0
1558,4,0,0,49,0.0,0.0,1.0,49,1750,1300,450,0.7428571428571429,22,13,9,324.53424797984053,0.7997448979591837,0.224643525762384,0.20409223862249398,133997.13187824152,-1102.6683148878815,132894.46356335364,1557,12,717.0612244897959,38,11,19,32.758917208406416,0.6565241228070176,41.15918803418803,1035.363247863247,27.24640125955913,0
1559,4,0,0,49,0.0,0.0,1.0,49,1600,1100,500,0.6875,21,11,10,325.33737587361696,0.7998511904761905,0.22461089434265102,0.2051255249404803,134091.86333550356,-1074.9810112847172,133016.88232421884,1558,13,718.0612244897959,39,10,19,32.643673103355795,0.655715811965812,41.067708333333336,1035.7291666666672,26.557158119658133,0
1560,4,0,0,49,0.0,0.0,1.0,49,1100,800,300,0.7272727272727273,14,8,6,325.6497968590951,0.798859126984127,0.22564923405259552,0.20562458601674288,134145.81298828125,-1063.0886501736093,133082.72433810766,1559,14,719.0612244897959,39,10,19,32.58180408915701,0.65625,41.015625,1035.9375,26.5625,0
1561,4,0,0,49,0.0,0.0,1.0,49,1400,1000,400,0.7142857142857143,18,10,8,323.8013790435158,0.7978316326530612,0.23007430285952224,0.20536313083887972,134307.7270507811,-1102.1945529514016,133205.5324978297,1560,15,720.0612244897959,39,10,19,32.46836582588015,0.6578525641025642,40.85937499999999,1036.5624999999989,26.57852564102561,0
1562,4,0,0,49,0.0,0.0,1.0,49,1150,900,250,0.782608695652174,14,9,5,322.01692062255785,0.7971584467120182,0.22516993466667157,0.20455894297579913,134366.32977229153,-1146.3536502743182,133219.97612201722,1561,16,721.0612244897959,40,9,19,32.456258576749654,0.6567708333333333,40.80284552845528,1036.7886178861781,25.919715447154452,0
1563,4,0,0,49,0.0,0.0,1.0,49,1100,700,400,0.6363636363636364,15,7,8,322.01692062255785,0.7971584467120182,0.22516993466667157,0.20455894297579913,134366.32977229153,-1146.3536502743182,133219.97612201722,1562,17,722.0612244897959,40,9,19,32.456258576749654,0.6567708333333333,40.80284552845528,1036.7886178861781,25.919715447154452,0
1564,4,0,0,49,0.0,0.0,1.0,49,1300,800,500,0.6153846153846154,18,8,10,326.76674065613264,0.797406462585034,0.23010618962976626,0.20832655352137044,134498.0679179884,-1010.1009443783677,133487.96697361005,1563,18,723.0612244897959,40,9,19,32.20196107246661,0.6580729166666668,40.67581300813007,1037.296747967478,25.93241869918695,0
1565,4,0,0,49,0.0,0.0,1.0,49,1050,800,250,0.7619047619047619,13,8,5,325.2833160084574,0.7965206916099773,0.23172259018928876,0.2078389187548771,134578.49368105747,-1044.7516067061392,133533.74207435132,1564,19,724.0612244897959,38,11,20,32.16038577704557,0.6622807017543861,40.59829059829058,1037.6068376068351,27.305443094916715,0
1566,4,0,0,49,0.0,0.0,1.0,49,1000,700,300,0.7,13,7,6,326.35154569264904,0.7959183673469388,0.23442501743389865,0.20915775843995849,134689.37194097415,-1008.7830557382183,133680.58888523592,1565,20,725.0612244897959,38,11,20,32.02235144778373,0.6633771929824563,40.491452991452974,1038.0341880341853,27.31668915879435,0
1567,4,0,0,49,0.0,0.0,1.0,49,1000,700,300,0.7,13,7,6,327.3846088567501,0.7959183673469388,0.2299808286314835,0.21030079401710178,134772.56059838177,-975.5075927752417,133797.05300560652,1566,21,726.0612244897959,38,11,21,31.912791096477672,0.6641995614035088,40.411324786324776,1038.3547008546996,27.32512370670262,0
1568,4,0,0,49,0.0,0.0,1.0,49,1400,1100,300,0.7857142857142857,17,11,6,328.39800966570397,0.7958829365079365,0.22836407290188832,0.21176009588788483,134911.26543209865,-939.0817901234697,133972.18364197516,1567,22,727.0612244897959,38,11,18,31.74855169340464,0.6655701754385965,40.27777777777777,1038.888888888888,27.339181286549685,0
1569,4,0,0,49,0.0,0.0,1.0,49,1100,800,300,0.7272727272727273,14,8,6,330.1868239210248,0.7949617346938775,0.22852724974535832,0.21365785532321568,135037.548828125,-882.4761284722224,134155.07269965278,1568,23,728.0612244897959,39,10,18,31.576551747177128,0.6650641025641025,40.15625,1039.375,26.650641025641026,0
1570,4,0,0,49,0.0,0.0,1.0,49,1450,900,550,0.6206896551724138,20,9,11,328.4869646276428,0.7942885487528345,0.22506844637464263,0.2130362829076349,135118.76220703125,-923.0495876736094,134195.71261935766,1569,24,729.0612244897959,39,10,18,31.54003022409243,0.6658653846153846,40.078125,1039.6875,26.658653846153847,0
1571,4,0,0,49,0.0,0.0,1.0,49,1100,600,500,0.5454545454545454,16,6,10,330.38792038834373,0.7942885487528345,0.22574678344046673,0.21491357557508914,135227.08468967033,-864.5209418402574,134362.56374783008,1570,25,730.0612244897959,39,10,18,31.383012018027035,0.6669337606837606,39.97395833333334,1040.1041666666683,26.66933760683765,0
1572,4,0,0,49,0.0,0.0,1.0,49,1600,900,700,0.5625,23,9,14,329.1591078697718,0.793686224489796,0.22016624030469178,0.21459798755896117,135308.35503472242,-892.4045138888694,134415.95052083355,1571,26,731.0612244897959,39,10,18,31.334267788012273,0.6677350427350426,39.89583333333334,1040.4166666666683,26.67735042735047,0
1573,4,0,0,49,0.0,0.0,1.0,49,1200,900,300,0.75,15,9,6,333.27068736969767,0.7926232993197279,0.21755775847107195,0.2184288865744349,135498.08078342036,-768.49229600692,134729.58848741345,1572,27,732.0612244897959,39,10,19,31.03895697848925,0.6696047008547008,39.71354166666668,1041.145833333335,26.696047008547055,0
1574,4,0,0,49,0.0,0.0,1.0,49,900,800,100,0.8888888888888888,10,8,2,333.9615157787803,0.7919501133786848,0.22087202227829894,0.21904719893206642,135525.19531250026,-747.9600694444144,134777.23524305585,1573,28,733.0612244897959,39,10,19,30.994064292383623,0.6698717948717947,39.687500000000014,1041.250000000002,26.698717948718002,0
1575,4,0,0,49,0.0,0.0,1.0,49,1100,700,400,0.6363636363636364,15,7,8,333.0203022851663,0.7917375283446713,0.2077504193973132,0.2192672135836015,135662.23651748637,-764.2573916974239,134897.97912578893,1574,29,734.0612244897959,37,12,20,30.882604462688143,0.6748310810810809,39.55592105263159,1041.7763157894753,28.156116642958793,0
1576,4,0,0,49,0.0,0.0,1.0,49,1150,900,250,0.782608695652174,14,9,5,330.72472980180413,0.7904974489795918,0.2065173039378776,0.2180904861228533,135717.16027695616,-822.9957675870908,134894.16450936906,1575,30,735.0612244897959,38,11,20,30.88793191838409,0.6735197368421051,39.50320512820514,1041.987179487181,27.42071524966266,0
1577,4,0,0,49,0.0,0.0,1.0,49,1300,1000,300,0.7692307692307693,16,10,6,333.7732045870698,0.7910643424036281,0.20506848369918607,0.22147928279907472,135939.8984243737,-725.3808943311994,135214.5175300425,1576,31,736.0612244897959,38,11,16,30.587713007547052,0.6757127192982455,39.28952991452992,1042.8418803418813,27.443207377417927,0
1578,4,0,0,49,0.0,0.0,1.0,49,850,600,250,0.7058823529411765,11,6,5,334.91378773002737,0.7904974489795918,0.20843420342937402,0.22241009495377756,135967.75353385942,-692.5049309664588,135275.24860289297,1577,32,737.0612244897959,38,11,16,30.530372874410993,0.675986842105263,39.26282051282052,1042.9487179487187,27.446018893387333,0
1579,4,0,0,49,0.0,0.0,1.0,49,1300,1000,300,0.7692307692307693,16,10,6,334.454142392302,0.7889030612244898,0.20499702185021507,0.222627450610827,136051.3359837279,-699.41342044706,135351.92256328085,1578,33,738.0612244897959,38,11,17,30.459549411162307,0.6768092105263157,39.182692307692314,1043.2692307692316,27.45445344129557,0
1580,4,0,0,49,0.0,0.0,1.0,49,700,600,100,0.8571428571428571,8,6,2,336.7889332262796,0.7880881519274376,0.21117685403399644,0.22470999315261622,136134.94411571347,-630.2514792899265,135504.69263642354,1579,34,739.0612244897959,38,11,17,30.3158271908272,0.6776315789473684,39.10256410256411,1043.5897435897446,27.462887989203804,0
1581,4,0,0,49,0.0,0.0,1.0,49,1100,500,600,0.45454545454545453,17,5,12,333.82834875222227,0.7881944444444444,0.20640736086870604,0.2231683711038041,136203.94015842033,-706.25271267359,135497.68744574673,1580,35,740.0612244897959,39,10,17,30.324755513421824,0.6765491452991452,39.03645833333334,1043.8541666666683,26.765491452991494,0
1582,4,0,0,49,0.0,0.0,1.0,49,1250,1000,250,0.8,15,10,5,335.2588384580065,0.7883361678004536,0.20979151988075206,0.22429666749173197,136231.1252170141,-665.4622395833082,135565.6629774308,1581,36,741.0612244897959,39,10,17,30.26051021086943,0.6768162393162392,39.01041666666668,1043.958333333335,26.768162393162438,0
1583,4,0,0,49,0.0,0.0,1.0,49,1400,900,500,0.6428571428571429,19,9,10,333.49525762501185,0.7878401360544218,0.20812539322822743,0.22328810735975257,136258.31298828142,-711.6997612847063,135546.6132269967,1582,37,742.0612244897959,39,10,17,30.279627689647143,0.6770833333333333,38.98437500000001,1044.0625000000014,26.770833333333368,0
1584,4,0,0,49,0.0,0.0,1.0,49,1100,700,400,0.6363636363636364,15,7,8,328.7022901492095,0.7873441043083901,0.2045212181402276,0.22092671351315515,136394.29253472228,-833.3767361111012,135560.91579861118,1583,38,743.0612244897959,39,10,17,30.27024331870761,0.6784188034188035,38.85416666666667,1044.583333333334,26.78418803418805,0
1585,4,0,0,49,0.0,0.0,1.0,49,1400,1000,400,0.7142857142857143,18,10,8,327.00823671171133,0.785218253968254,0.20599574555472433,0.2205316751293964,136513.49226033024,-871.7927217182976,135641.69953861195,1584,39,744.0612244897959,41,8,17,30.196664768052674,0.6763211382113821,38.740079365079374,1045.039682539684,25.488772744870342,0
1586,4,0,0,49,0.0,0.0,1.0,49,1250,1100,150,0.88,14,11,3,330.8688447769083,0.7839781746031746,0.21108552812058368,0.22348667680704518,136568.95173254324,-762.7177415720053,135806.23399097123,1585,40,745.0612244897959,42,7,17,30.04098297333211,0.6753472222222221,38.687015503875976,1045.251937984497,24.886950904392787,0
1587,4,0,0,49,0.0,0.0,1.0,49,1300,800,500,0.6153846153846154,18,8,10,335.31059112329984,0.7831986961451247,0.21440215281910602,0.2271472114836493,136671.4059989098,-634.5260129705929,136036.8799859392,1586,41,746.0612244897959,43,6,17,29.82362796594821,0.6749031007751937,38.58901515151516,1045.6439393939413,24.31730091613817,0
1588,4,0,0,49,0.0,0.0,1.0,49,1300,1000,300,0.7692307692307693,16,10,6,308.29445589512756,0.7844742063492064,0.16287303194260883,0.21073266026381637,136986.75892532573,-1353.5214359077172,135633.237489418,1587,42,747.0612244897959,40,9,18,30.219153480244636,0.6825520833333332,38.28760162601627,1046.8495934959365,26.17123983739841,2
1589,4,0,0,49,0.0,0.0,1.0,49,1600,1300,300,0.8125,19,13,6,313.8529107726236,0.7834467120181406,0.172557407242373,0.2151865765476971,137093.1667348305,-1194.5821146473622,135898.58462018313,1588,43,748.0612244897959,40,9,18,29.968866246158818,0.68359375,38.1859756097561,1047.256097560976,26.181402439024403,0
1590,4,0,0,49,0.0,0.0,1.0,49,750,500,250,0.6666666666666666,10,5,5,314.29431785823976,0.7835530045351474,0.17108962327655197,0.2159830552321821,137172.9997025578,-1177.4611259832254,135995.5385765746,1589,44,749.0612244897959,40,9,18,29.87869454145648,0.6843750000000001,38.10975609756097,1047.5609756097547,26.189024390243866,0
1591,4,0,0,49,0.0,0.0,1.0,49,1300,700,600,0.5384615384615384,19,7,12,316.66202651914153,0.7825255102040817,0.1722691985744167,0.21844384478206708,137306.10628800633,-1104.074025877465,136202.03226212887,1590,45,750.0612244897959,40,9,19,29.68563140372992,0.6856770833333334,37.98272357723577,1048.0691056910557,26.201727642276392,0
1592,4,0,0,49,0.0,0.0,1.0,49,1000,700,300,0.7,13,7,6,319.4388836609588,0.782171201814059,0.17031597439285884,0.22086672411839486,137386.00122281714,-1022.713827748033,136363.2873950691,1591,46,751.0612244897959,40,9,19,29.5342186894145,0.6864583333333334,37.90650406504065,1048.3739837398375,26.209349593495936,0
1593,4,0,0,49,0.0,0.0,1.0,49,1400,700,700,0.5,21,7,14,319.931316688123,0.7819231859410432,0.17112083713221726,0.22171734431865275,137465.91939528382,-1004.0694816246986,136461.84991365913,1592,47,752.0612244897959,40,9,19,29.44265432696968,0.6872395833333333,37.83028455284553,1048.6788617886173,26.21697154471543,0
1594,4,0,0,49,0.0,0.0,1.0,49,1350,1000,350,0.7407407407407407,17,10,7,314.3544139801302,0.7810019841269842,0.1742805828258145,0.21921920537216835,137682.32242260312,-1143.790843883864,136538.53157871927,1593,48,753.0612244897959,41,8,18,29.376102813750528,0.6877540650406505,37.62400793650793,1049.5039682539668,25.597657762291874,1
1595,4,0,0,49,0.0,0.0,1.0,49,1350,1100,250,0.8148148148148148,16,11,5,315.61702178952544,0.7792304421768708,0.18005320777299616,0.22110309736618072,137839.17812024907,-1099.0603112809501,136740.11780896812,1594,49,754.0612244897959,40,9,19,29.18884480144522,0.6908854166666667,37.474593495934954,1050.1016260162594,26.252540650406484,0
1596,4,0,0,49,0.0,0.0,1.0,49,750,500,250,0.6666666666666666,10,5,5,316.03820364671213,0.77859268707483,0.1812826126871374,0.22208612583929724,137945.91642086382,-1080.7640747901467,136865.15234607368,1595,50,755.0612244897959,40,9,20,29.072949920995782,0.6919270833333334,37.37296747967479,1050.5081300813001,26.2627032520325,0
1597,4,0,0,49,0.0,0.0,1.0,49,750,200,550,0.26666666666666666,13,2,11,316.03820364671213,0.77859268707483,0.1812826126871374,0.22208612583929724,137945.91642086382,-1080.7640747901467,136865.15234607368,1596,51,756.0612244897959,40,9,20,29.072949920995782,0.6919270833333334,37.37296747967479,1050.5081300813001,26.2627032520325,0
1598,4,0,0,49,0.0,0.0,1.0,49,1550,1200,350,0.7741935483870968,19,12,7,318.2364407065012,0.7773880385487528,0.1801405281648445,0.22415291532051917,138025.99725692364,-1015.0195815982702,137010.97767532538,1597,52,757.0612244897959,40,9,20,28.936573178594443,0.6927083333333335,37.29674796747967,1050.8130081300803,26.270325203252007,0
1599,4,0,0,49,0.0,0.0,1.0,49,1500,1000,500,0.6666666666666666,20,10,10,321.527971311643,0.7751204648526078,0.19134157287854747,0.22735521963219038,138159.5169562594,-915.5701591314794,137243.94679712792,1598,53,758.0612244897959,40,9,16,28.718986628000646,0.6940104166666667,37.169715447154466,1051.3211382113814,26.283028455284533,0
1600,4,0,1,48,0.0,0.02040816326530612,0.9795918367346939,49,1100,700,400,0.6363636363636364,15,7,8,319.2079155983797,0.7741992630385488,0.18572671167626242,0.2260673718478052,138212.94290972632,-976.2669170136862,137236.67599271264,1599,54,759.0612244897959,40,9,16,28.727529718759065,0.69453125,37.11890243902439,1051.5243902439022,26.288109756097555,0
1601,4,0,0,48,0.0,0.0,1.0,48,1750,1300,450,0.7428571428571429,22,13,9,334.21066741726685,0.7707963947990544,0.20094019011533226,0.22480206462292213,136421.49658203125,-469.70568895261243,135951.79089307864,1600,55,774.0416666666666,39,9,18,30.0994823345631,0.6786858974358975,38.828125,1044.6875,26.786858974358974,4
1602,4,0,0,48,0.0,0.0,1.0,48,1100,800,300,0.7272727272727273,14,8,6,335.01955919502694,0.7700760933806147,0.20006521450171144,0.22569383467329174,136475.9128146701,-455.57996961806145,136020.33284505203,1601,56,775.0416666666666,39,9,18,30.024528129465317,0.6792200854700855,38.776041666666664,1044.895833333333,26.792200854700848,0
1603,4,0,0,48,0.0,0.0,1.0,48,1400,900,500,0.6428571428571429,19,9,10,336.6115661977949,0.769355791962175,0.2102284049018628,0.2278199790915219,136639.22661675359,-401.1311848958232,136238.09543185777,1602,57,776.0416666666666,39,9,18,29.821431536647733,0.6808226495726495,38.61979166666667,1045.5208333333342,26.80822649572652,0
1604,4,0,0,48,0.0,0.0,1.0,48,800,500,300,0.625,11,5,6,336.01784993897854,0.7686724290780141,0.20569985390311163,0.227770641157151,136693.68625217016,-413.6962890624942,136279.98996310766,1603,58,777.0416666666666,39,9,18,29.783116678288014,0.6813568376068376,38.567708333333336,1045.7291666666667,26.81356837606838,0
1605,4,0,0,48,0.0,0.0,1.0,48,1150,900,250,0.782608695652174,14,9,5,341.0706915262536,0.7673057033096926,0.2389828635961897,0.21373063703457507,133866.31350593248,-468.42477609225193,133397.88872984023,1604,59,778.0416666666666,40,8,14,32.461578120396744,0.6518229166666666,41.28556910569107,1034.8577235772373,25.871443089430933,4
1606,4,0,0,48,0.0,0.0,1.0,48,1800,1400,400,0.7777777777777778,22,14,8,337.1097331202848,0.7676750886524822,0.23341144044230666,0.2121563354393199,134024.11268300976,-563.8334283494974,133460.27925466027,1605,60,779.0416666666666,40,8,16,32.406475938103185,0.6533854166666666,41.13313008130083,1035.467479674799,25.886686991869976,0
1607,4,1,0,49,0.02040816326530612,0.0,1.0,49,1150,800,350,0.6956521739130435,15,8,7,358.6116671113617,0.7750496031746031,0.25202534691585776,0.22568458626336935,134023.5008788534,-187.52178354666597,133835.97909530674,1606,0,764.1224489795918,42,7,16,31.850474140620115,0.6502976190476191,41.133720930232556,1035.4651162790697,24.65393133997785,2
1608,4,0,0,49,0.0,0.0,1.0,49,1100,1000,100,0.9090909090909091,12,10,2,376.50182759920636,0.7754747732426304,0.27877385772122576,0.22681939370000997,132398.0034722224,172.72361937385404,132570.72709159626,1607,1,765.1224489795918,39,10,18,33.02125506072875,0.6388888888888888,42.70833333333334,1029.166666666668,26.388888888888925,2
1609,4,0,0,49,0.0,0.0,1.0,49,1250,900,350,0.72,16,9,7,379.61428300132843,0.7759353741496599,0.278725913941378,0.22936318779208797,132507.9800044744,260.3843642705838,132768.36436874498,1608,2,766.1224489795918,38,11,18,32.830280861955664,0.6417214912280702,42.60149572649573,1029.594017094017,27.094579397210975,0
1610,4,0,0,49,0.0,0.0,1.0,49,1150,1000,150,0.8695652173913043,13,10,3,376.12622888724354,0.7766439909297053,0.2757176729613007,0.22775482703976313,132590.49236613343,174.1523759953282,132764.64474212876,1609,3,767.1224489795918,38,11,18,32.83692081604426,0.6425438596491228,42.52136752136752,1029.9145299145302,27.103013945119216,0
1611,4,0,0,49,0.0,0.0,1.0,49,1300,800,500,0.6153846153846154,18,8,10,379.3204827658935,0.7765022675736961,0.2816131844691421,0.230363144571428,132700.54879830522,267.2072466944272,132967.75604499964,1610,4,768.1224489795918,38,11,17,32.643785427899914,0.643640350877193,42.414529914529915,1030.3418803418804,27.11426000899685,0
1612,4,0,0,49,0.0,0.0,1.0,49,1050,600,450,0.5714285714285714,15,6,9,380.48738407326204,0.7761125283446713,0.2745945589230028,0.23185364241311607,132827.17013888902,307.8125000000109,133134.98263888902,1611,5,769.1224489795918,39,10,17,32.48618970627862,0.6431623931623931,42.29166666666667,1030.8333333333344,26.43162393162396,0
1613,4,0,0,49,0.0,0.0,1.0,49,1050,700,350,0.6666666666666666,14,7,7,378.74506732265445,0.7761833900226758,0.27156033677490377,0.23095748190340798,132854.01611328125,263.5606553819441,133117.5767686632,1612,6,770.1224489795918,39,10,17,32.50406267892628,0.6434294871794872,42.265625,1030.9375,26.434294871794872,0
1614,4,0,0,49,0.0,0.0,1.0,49,1550,1400,150,0.9032258064516129,17,14,3,379.85989586982816,0.7764314058956916,0.27690874349941974,0.2323034483636301,132961.42713758687,301.3427734375051,133262.76991102437,1613,7,771.1224489795918,39,10,17,32.36720617446049,0.6444978632478633,42.161458333333336,1031.3541666666672,26.444978632478644,0
1615,4,0,0,49,0.0,0.0,1.0,49,1050,700,350,0.6666666666666666,14,7,7,382.9721709672961,0.776608560090703,0.2770432890442125,0.23471264735520406,133042.01388888876,390.27777777776726,133432.29166666654,1614,8,772.1224489795918,39,10,17,32.20584275713517,0.6452991452991453,42.08333333333333,1031.6666666666656,26.452991452991427,0
1616,4,0,0,49,0.0,0.0,1.0,49,700,400,300,0.5714285714285714,10,4,6,383.52194244375676,0.7757936507936508,0.2855165481614528,0.23572800283701856,133149.5008680555,413.1510416666615,133562.65190972216,1615,9,773.1224489795918,39,10,17,32.08350154757098,0.6463675213675215,41.979166666666664,1032.083333333333,26.463675213675206,0
1617,4,0,0,49,0.0,0.0,1.0,49,1400,1100,300,0.7857142857142857,17,11,6,382.8584318192279,0.7742701247165533,0.28126833184105715,0.23651347984346702,133337.70751953125,409.8931206597222,133747.60064019097,1616,10,774.1224489795918,39,10,17,31.9113506471676,0.6482371794871795,41.796875,1032.8125,26.482371794871796,0
1618,4,0,0,49,0.0,0.0,1.0,49,700,500,200,0.7142857142857143,9,5,4,382.9659522834525,0.7744118480725624,0.27899731032878994,0.23692285394853385,133391.50526258675,416.88096788193866,133808.3862304687,1617,11,775.1224489795918,39,10,17,31.85449648751302,0.6487713675213675,41.744791666666664,1033.020833333333,26.487713675213666,0
1619,4,1,1,49,0.02,0.02,0.98,50,1200,700,500,0.5833333333333334,17,7,10,374.192481755011,0.7809013605442177,0.2707238497936171,0.23420629623645403,133822.27783203128,15.082465277778454,133837.36029730906,1618,0,760.6,39,11,17,31.648817913352794,0.6530448717948718,41.328125,1034.6875000000002,26.530448717948723,0
1620,4,0,0,49,0.0,0.0,1.0,49,1450,900,550,0.6206896551724138,20,9,11,385.4262108210633,0.772640306122449,0.2775451190493752,0.24093492571855116,133775.99172921694,512.1547182044026,134288.14644742134,1619,13,777.1224489795918,38,11,17,31.404695514475545,0.6543311403508771,41.37286324786325,1034.5085470085476,27.223909131803882,0
1621,4,0,1,48,0.0,0.02040816326530612,0.9795918367346939,49,1250,800,450,0.64,17,8,9,384.52334789982507,0.7714356575963719,0.2713672647752192,0.24109240589680295,133886.53897518083,496.5000410913881,134383.0390162722,1620,14,778.1224489795918,38,11,17,31.317100237431603,0.6554276315789473,41.26602564102564,1034.9358974358977,27.235155195681518,0
1622,4,0,0,48,0.0,0.0,1.0,48,1650,1200,450,0.7272727272727273,21,12,9,386.2612293479185,0.7708518026004728,0.27477364185110664,0.24300231770369057,134010.95920138893,752.6475694444498,134763.60677083337,1621,15,788.8125,37,11,17,31.14730046948357,0.6585022522522521,41.145833333333336,1035.416666666667,27.984234234234243,0
1623,4,0,0,48,0.0,0.0,1.0,48,1350,900,450,0.6666666666666666,18,9,9,381.63527658143573,0.7717013888888888,0.27631950324583676,0.2410220650495593,134152.9124345954,639.496768236397,134792.4092028318,1622,16,789.8125,37,11,17,31.12475303415187,0.6599099099099097,41.00877192982457,1035.9649122807027,27.999051683262234,0
1624,4,0,0,48,0.0,0.0,1.0,48,1200,700,500,0.5833333333333334,17,7,10,377.46620208073074,0.7717013888888888,0.2760400134024614,0.23894394346048153,134238.12044330966,534.0706996383713,134772.19114294802,1623,17,790.8125,37,11,17,31.147387401685883,0.6607545045045045,40.92653508771931,1036.2938596491242,28.007942152679032,0
1625,4,1,1,48,0.02040816326530612,0.02040816326530612,0.9795918367346939,49,1700,1200,500,0.7058823529411765,22,12,10,368.17701533997933,0.7741638321995465,0.27323235719328953,0.23524573506459728,134578.49368105773,109.74162648841616,134688.23530754616,1624,0,775.6530612244898,38,11,18,31.0477158841296,0.6622807017543859,40.598290598290596,1037.6068376068372,27.305443094916768,0
1626,4,0,0,48,0.0,0.0,1.0,48,950,800,150,0.8421052631578947,11,8,3,374.13923939380743,0.7726433215130023,0.2751567342913499,0.2392468757853373,134607.6677439211,472.4020852569921,135080.0698291781,1625,1,785.9166666666666,37,11,18,30.863887714849245,0.6644144144144144,40.570175438596486,1037.7192982456133,28.04646752015171,0
1627,4,0,0,48,0.0,0.0,1.0,48,1750,1200,550,0.6857142857142857,23,12,11,378.9156506795849,0.7724216903073285,0.27737359600014133,0.24287030907133556,134693.02002779683,607.4586651661864,135300.47869296302,1626,2,786.9166666666666,37,11,18,30.654620435900142,0.6652590090090091,40.48793859649122,1038.0482456140337,28.055357989568478,0
1628,4,0,0,48,0.0,0.0,1.0,48,1700,1400,300,0.8235294117647058,20,14,6,380.3816346043842,0.7716829196217494,0.2806206872271515,0.24400090219744602,134721.4768005537,649.115112342229,135370.59191289594,1627,3,787.9166666666666,37,11,18,30.588121391353337,0.6655405405405406,40.46052631578946,1038.1578947368398,28.058321479374047,0
1629,4,0,0,48,0.0,0.0,1.0,48,1150,900,250,0.782608695652174,14,9,5,380.3816346043842,0.771590573286052,0.2806206872271515,0.24400090219744602,134721.4768005537,649.115112342229,135370.59191289594,1628,4,788.9166666666666,37,11,18,30.588121391353337,0.6655405405405406,40.46052631578946,1038.1578947368398,28.058321479374047,0
1630,4,0,0,48,0.0,0.0,1.0,48,900,500,400,0.5555555555555556,13,5,8,379.90569936341274,0.7715351654846335,0.276844175731334,0.24388658083201015,134749.93657904328,638.45377904737,135388.39035809066,1629,5,789.9166666666666,37,11,18,30.5720201006794,0.6658220720720722,40.433114035087705,1038.267543859647,28.06128496917965,0
1631,4,0,0,48,0.0,0.0,1.0,48,1200,800,400,0.6666666666666666,16,8,8,382.34041812574463,0.7717198581560284,0.27859938434476783,0.24660826832821123,134920.75837036368,717.1318338334544,135637.89020419715,1630,6,790.9166666666666,37,11,17,30.338060686015822,0.6675112612612614,40.26864035087718,1038.925438596489,28.079065908013213,0
1632,4,0,0,48,0.0,0.0,1.0,48,1200,900,300,0.75,15,9,6,384.0552685498517,0.7706671099290779,0.2783347403967926,0.24790924555711072,134949.23918898084,765.5932594644078,135714.83244844523,1631,7,791.9166666666666,37,11,17,30.265055579006614,0.6677927927927929,40.24122807017542,1039.035087719295,28.082029397818783,0
1633,4,0,0,48,0.0,0.0,1.0,48,900,600,300,0.6666666666666666,12,6,6,383.036372226908,0.7710180260047281,0.27620485634912306,0.24783629845316388,135034.69967922775,744.6402979762474,135779.33997720398,1632,8,792.9166666666666,37,11,17,30.20613549249215,0.6686373873873876,40.15899122807015,1039.3640350877156,28.090919867235556,0
1634,4,0,0,48,0.0,0.0,1.0,48,850,700,150,0.8235294117647058,10,7,3,362.08360889313104,0.7710180260047281,0.2973481021184874,0.220797379988621,132854.01611328125,112.13641907846693,132966.15253235973,1633,9,793.9166666666666,39,9,15,32.933485736418454,0.6434294871794872,42.265625,1030.9375,26.434294871794872,7
1635,4,0,0,48,0.0,0.0,1.0,48,1400,1100,300,0.7857142857142857,17,11,6,364.37685463812875,0.7700391548463357,0.2983306408185249,0.22331611190198178,133042.01388888882,95.48611111110367,133137.4999999999,1634,10,794.9166666666666,39,9,16,32.68544695745826,0.6452991452991453,42.08333333333333,1031.666666666666,26.452991452991437,0
1636,4,0,1,47,0.0,0.020833333333333332,0.9791666666666666,48,500,300,200,0.6,7,3,4,366.3965944316028,0.7700576241134751,0.30045922387471724,0.22477490170779818,133078.7118799159,151.91736482912222,133230.62924474504,1635,11,795.9166666666666,40,8,16,32.5964821563413,0.6440104166666667,42.04776422764227,1031.8089430894297,25.795223577235742,0
1637,4,0,0,47,0.0,0.0,1.0,47,1000,800,200,0.8,12,8,4,364.81847949592753,0.7695806352143076,0.2988445059031817,0.22412169747617314,133131.14636005345,313.7404777248926,133444.88683777835,1636,12,799.8936170212766,40,7,17,32.584523223371086,0.64453125,41.99695121951219,1032.0121951219505,25.800304878048763,0
1638,4,0,0,47,0.0,0.0,1.0,47,1050,600,450,0.5714285714285714,15,6,9,364.18667018389255,0.7695806352143076,0.2928281302696605,0.2240486983075586,133183.59116803802,300.737718124117,133484.32888616214,1637,13,800.8936170212766,40,7,17,32.54816054609301,0.6450520833333334,41.946138211382106,1032.2154471544702,25.805386178861756,0
1639,4,0,0,47,0.0,0.0,1.0,47,1200,900,300,0.75,15,9,6,360.41040207080414,0.7696577243293247,0.2932526386329366,0.22219476244170933,133262.27774472864,205.82222056976212,133468.0999652984,1638,14,801.8936170212766,40,7,17,32.56664206036744,0.6458333333333334,41.86991869918699,1032.5203252032518,25.813008130081293,0
1640,4,0,0,47,0.0,0.0,1.0,47,900,600,300,0.6666666666666666,12,6,6,339.3821549438397,0.7704671600370028,0.24517675874737987,0.20272536955119932,132076.584201389,-422.54902112663785,131654.03518026235,1639,15,802.8936170212766,39,8,17,34.29941899743277,0.6356837606837606,43.020833333333336,1027.9166666666674,26.356837606837626,6
1641,4,0,1,46,0.0,0.02127659574468085,0.9787234042553191,47,950,700,250,0.7368421052631579,12,7,5,337.0154459852449,0.770891150169596,0.2402293647200846,0.2015965122348101,132130.12695312503,-494.0212673611098,131636.1056857639,1640,16,803.8936170212766,39,8,17,34.3063998649105,0.6362179487179487,42.96875,1028.1250000000002,26.362179487179493,0
1642,4,0,0,46,0.0,0.0,1.0,46,950,600,350,0.631578947368421,13,6,7,342.47394541612994,0.7659621578099839,0.2578583795547764,0.2047168605276672,132103.35422092007,-151.60861545139232,131951.74560546866,1641,35,822.0217391304348,39,7,17,34.19303289762558,0.6359508547008548,42.994791666666664,1028.0208333333328,26.359508547008534,0
1643,4,0,0,46,0.0,0.0,1.0,46,1250,1100,150,0.88,14,11,3,343.5826837153125,0.765378421900161,0.2595946785039569,0.2059618601287967,132210.46142578125,-114.95496961805406,132095.5064561632,1642,36,823.0217391304348,39,7,17,34.056792092913334,0.6370192307692308,42.890625,1028.4375,26.370192307692307,0
1644,4,0,0,46,0.0,0.0,1.0,46,1100,600,500,0.5454545454545454,16,6,10,344.0475995344948,0.7653582930756844,0.2609575778912161,0.2072677002073665,132398.0034722223,-89.62402343749454,132308.3794487848,1643,37,824.0217391304348,38,8,17,33.85627530364372,0.640625,42.708333333333336,1029.1666666666672,27.083333333333346,0
1645,4,0,0,46,0.0,0.0,1.0,46,1150,800,350,0.6956521739130435,15,8,7,342.6860372458246,0.7646135265700483,0.25762279731955506,0.20674890224568054,132452.98603121116,-122.04221911754314,132330.9438120936,1644,38,825.0217391304348,38,8,18,33.836057775471374,0.6411732456140351,42.65491452991453,1029.3803418803416,27.088956365272146,0
1646,4,0,0,46,0.0,0.0,1.0,46,1100,500,600,0.45454545454545453,17,5,12,340.77301527177553,0.763425925925926,0.2535134403752477,0.20634747909672857,132590.49236613355,-163.34762400465672,132427.1447421289,1645,39,826.0217391304348,38,8,18,33.74719052558783,0.6425438596491228,42.52136752136753,1029.9145299145312,27.10301394511924,0
1647,4,0,0,46,0.0,0.0,1.0,46,1150,800,350,0.6956521739130435,15,8,7,343.62375067841305,0.7643317230273752,0.25768091905120305,0.20914437367789598,132783.12108490395,-74.51318120388487,132708.60790370006,1646,40,827.0217391304348,38,8,16,33.48039977886044,0.6444627192982456,42.33440170940171,1030.6623931623933,27.12269455690509,0
1648,4,0,0,46,0.0,0.0,1.0,46,1200,1000,200,0.8333333333333334,14,10,4,342.8085883570158,0.7654589371980677,0.2603182343353936,0.2090435365970047,132854.01611328125,-91.30045572916595,132762.7156575521,1647,41,828.0217391304348,39,7,16,33.43026927351723,0.6434294871794872,42.265625,1030.9375,26.434294871794872,0
1649,4,0,0,46,0.0,0.0,1.0,46,900,600,300,0.6666666666666666,12,6,6,343.02563455796286,0.7659822866344606,0.25873035395819954,0.20932600066921817,132880.8648003473,-83.69140624999545,132797.1733940973,1648,42,829.0217391304348,39,7,17,33.397740284232505,0.6436965811965811,42.239583333333336,1031.0416666666672,26.436965811965827,0
1650,4,0,0,46,0.0,0.0,1.0,46,1250,1000,250,0.8,15,10,5,341.5246837712876,0.7663848631239936,0.2560703590842428,0.20900972921528388,132988.2866753473,-116.24348958332473,132872.043185764,1649,43,830.0217391304348,39,7,18,33.3287046387935,0.6447649572649572,42.13541666666667,1031.4583333333342,26.447649572649595,0
1651,4,0,0,46,0.0,0.0,1.0,46,1250,900,350,0.72,16,9,7,374.34593309099114,0.7666666666666667,0.22579964324132917,0.21693041095454385,130917.78897518103,628.6397980358544,131546.42877321687,1650,44,831.0217391304348,38,8,16,34.57302432404217,0.6258223684210525,44.150641025641036,1023.3974358974377,26.931511470985203,7
1652,4,0,0,46,0.0,0.0,1.0,46,1500,1000,500,0.6666666666666666,20,10,10,373.29411801231265,0.7686996779388084,0.22603830333053176,0.21712906390893721,131061.33355034745,584.8849826389145,131646.21853298636,1651,45,832.0217391304348,39,7,16,34.454476093591055,0.6255341880341879,44.01041666666668,1023.9583333333352,26.255341880341927,0
1653,4,1,0,47,0.02127659574468085,0.0,1.0,47,850,600,250,0.7058823529411765,11,6,5,363.1247528325474,0.7770968239284612,0.22341336085227792,0.20429410251654567,129768.46648526232,24.42846358392353,129792.89494884625,1652,0,815.2978723404256,42,5,15,36.026509747979084,0.6078869047619047,45.276162790697676,1018.8953488372094,24.259413067552607,5
1654,4,0,1,46,0.0,0.02127659574468085,0.9787234042553191,47,1600,1300,300,0.8125,19,13,6,363.8134496667583,0.775555041628122,0.2267049591457002,0.2053281915501233,129891.90853915029,51.28466588546519,129943.19320503576,1653,1,816.2978723404256,42,5,15,35.88343631178708,0.6091269841269842,45.15503875968992,1019.3798449612402,24.27094868955334,0
1655,4,1,1,46,0.02127659574468085,0.02127659574468085,0.9787234042553191,47,1000,600,400,0.6,14,6,8,361.1713609471278,0.7811054579093432,0.21688100911738584,0.20474156794240247,130064.826003921,-4.861956162496313,130059.9640477585,1654,0,809.8510638297872,42,5,15,35.77507045375384,0.6108630952380952,44.985465116279066,1020.0581395348835,24.28709856035437,0
1656,4,1,0,47,0.02127659574468085,0.0,1.0,47,1100,700,400,0.6363636363636364,15,7,8,366.1455673526927,0.7821461609620721,0.23190964213145748,0.20848526521585187,130237.85848957376,137.20291749292454,130375.06140706668,1655,0,810.8297872340426,42,5,16,35.47243845326245,0.6125992063492064,44.81589147286821,1020.7364341085256,24.30324843115537,0
1657,4,0,1,46,0.0,0.02127659574468085,0.9787234042553191,47,1700,1200,500,0.7058823529411765,22,12,10,368.19949125543724,0.7821461609620721,0.23545506333000832,0.21006815949138985,130314.46358194518,196.34853354935768,130510.81211549454,1656,1,811.8297872340426,40,7,16,35.34222487641417,0.61640625,44.74085365853658,1021.0365853658529,25.525914634146325,0
1658,4,1,0,47,0.02127659574468085,0.0,1.0,47,1050,600,450,0.5714285714285714,15,6,9,360.9219396022304,0.7887758248535306,0.23197313473525072,0.2072585184939898,130566.58340419494,24.868905895680086,130591.45231009062,1657,0,777.8510638297872,41,6,17,35.27227722772276,0.6173780487804879,44.49404761904761,1022.023809523809,24.927409988385584,0
1659,4,1,0,48,0.020833333333333332,0.0,1.0,48,700,400,300,0.5714285714285714,10,4,6,353.17310058230555,0.791832890070922,0.22947057244798064,0.2040748999916474,130807.20364048121,-360.4828623580497,130446.72077812316,1658,0,762.625,42,6,18,35.226626882637085,0.6183035714285714,44.25872093023255,1022.9651162790688,24.35631229235878,0
1660,4,0,0,48,0.0,0.0,1.0,48,1450,1200,250,0.8275862068965517,17,12,5,351.1859789688919,0.7921653368794326,0.22649888971132492,0.2036275783635075,130940.15438475646,-403.1307392103056,130537.02364554616,1659,1,763.625,43,5,18,35.14294966691338,0.618217054263566,44.12878787878787,1023.4848484848469,23.801973220577835,0
1661,4,1,0,49,0.02040816326530612,0.0,1.0,49,1000,700,300,0.7,13,7,6,348.75708061699345,0.8003472222222222,0.2439870780260065,0.2040192055110403,131280.67558299043,-642.9869684499288,130637.6886145405,1660,0,749.0204081632653,44,5,20,34.861010721599804,0.6202651515151516,43.7962962962963,1024.814814814815,23.291245791245796,0
1662,4,0,0,49,0.0,0.0,1.0,49,1300,1000,300,0.7692307692307693,16,10,6,345.8351835957829,0.8000637755102041,0.23543748284177646,0.20269511923398928,131353.54785722186,-714.6386120034165,130638.90924521844,1661,1,750.0204081632653,41,8,20,34.86231410690668,0.6252540650406502,43.725198412698425,1025.0992063492085,25.002419667053868,0
1663,4,0,0,49,0.0,0.0,1.0,49,1250,1000,250,0.8,15,10,5,346.32001856671667,0.7994260204081632,0.22945511763765136,0.20351961523161785,131455.26389085758,-694.8821137250918,130760.38177713248,1662,2,751.0204081632653,41,8,20,34.747246944632565,0.6262703252032519,43.62599206349208,1025.496031746034,25.012098335269123,0
1664,4,0,0,49,0.0,0.0,1.0,49,1000,400,600,0.4,16,4,12,345.81513377621525,0.7985048185941044,0.23026911625135438,0.20403684704206482,131607.91175555877,-697.598478048617,130910.31327751015,1663,3,752.0204081632653,41,8,15,34.606235296013416,0.6277947154471544,43.477182539682545,1026.0912698412703,25.02661633759196,0
1665,4,0,0,49,0.0,0.0,1.0,49,1200,800,400,0.6666666666666666,16,8,8,344.00027371462727,0.7996031746031746,0.22180933840628136,0.2035089097841769,131709.72620819177,-738.3636267006676,130971.3625814911,1664,4,753.0204081632653,41,8,15,34.5501715473084,0.628810975609756,43.3779761904762,1026.4880952380965,25.036295005807233,0
1666,4,0,0,49,0.0,0.0,1.0,49,1200,800,400,0.6666666666666666,16,8,8,346.9985532736282,0.7996386054421769,0.22644404171950017,0.2055574143004451,131760.64819735754,-655.8491394242956,131104.79905793324,1665,5,754.0204081632653,41,8,15,34.42190469288498,0.6293191056910569,43.32837301587301,1026.686507936507,25.041134339914805,0
1667,4,0,0,49,0.0,0.0,1.0,49,800,400,400,0.5,12,4,8,346.26868611622274,0.7994260204081632,0.2264483787286733,0.20533907480546257,131800.32680014736,-672.3348018448306,131127.99199830252,1666,6,755.0204081632653,42,7,16,34.40065584599414,0.6282242063492063,43.28972868217055,1026.841085271319,24.448597268364736,0
1668,4,1,1,49,0.02,0.02,0.98,50,1150,800,350,0.6956521739130435,15,8,7,344.04971302490566,0.8064285714285714,0.23098010316875484,0.2056720090637874,132105.78799357222,-909.8083103764774,131195.97968319574,1667,0,740.9,43,7,17,34.15008597396219,0.6298449612403101,42.99242424242425,1028.0303030303041,23.907681465821028,0
1669,4,0,1,48,0.0,0.02040816326530612,0.9795918367346939,49,550,200,350,0.36363636363636365,9,2,7,347.31275021673486,0.8033588435374149,0.2323657070642482,0.20708999809626433,132008.4545741507,-630.3561179981524,131378.09845615254,1668,1,756.8367346938776,43,6,17,34.164209362329515,0.6288759689922481,43.08712121212122,1027.6515151515162,23.898872445384097,0
1670,4,0,0,48,0.0,0.0,1.0,48,950,700,250,0.7368421052631579,12,7,5,349.3430620932268,0.793181146572104,0.22382176318933533,0.2078414783564756,131924.73127366154,-382.60208220658944,131542.12919145497,1669,2,773.375,42,6,17,34.19637804187889,0.6294642857142857,43.168604651162795,1027.3255813953497,24.46013289036547,0
1671,4,0,0,48,0.0,0.0,1.0,48,1150,900,250,0.782608695652174,14,9,5,350.93421621631785,0.7921468676122931,0.22862059211766872,0.2093367996170006,132024.2971050419,-333.6313547863616,131690.66575025552,1670,3,774.375,42,6,17,34.05521245835691,0.6304563492063491,43.071705426356594,1027.7131782945746,24.469361387966064,0
1672,4,0,0,48,0.0,0.0,1.0,48,750,500,250,0.6666666666666666,10,5,5,350.93421621631785,0.7916481973995272,0.22862059211766872,0.2093367996170006,132024.2971050419,-333.6313547863616,131690.66575025552,1671,4,775.375,42,6,17,34.05521245835691,0.6304563492063491,43.071705426356594,1027.7131782945746,24.469361387966064,0
1673,4,0,0,48,0.0,0.0,1.0,48,1150,600,550,0.5217391304347826,17,6,11,349.7697919822051,0.7915189125295508,0.22683003455859252,0.2091915159487709,132123.90049426115,-357.41016164894256,131766.49033261221,1672,5,776.375,42,6,17,33.9848413446434,0.6314484126984127,42.974806201550386,1028.1007751937984,24.478589885566628,0
1674,4,0,0,48,0.0,0.0,1.0,48,900,700,200,0.7777777777777778,11,7,4,348.54337538219437,0.7914080969267139,0.22481130518291725,0.2089191187463592,132207.48563957482,-383.99134087791356,131823.4942986969,1673,6,777.375,44,4,17,33.93224242969896,0.6294981060606061,42.89351851851852,1028.4259259259265,23.373316498316512,0
1675,4,1,1,48,0.02040816326530612,0.02040816326530612,0.9795918367346939,49,1400,1100,300,0.7857142857142857,17,11,6,341.05805011500695,0.7961663832199547,0.22124858234676803,0.20603811006053263,132502.61423631755,-761.0974796278851,131741.51675668967,1674,0,762.4897959183673,40,9,18,33.82810186556115,0.6382812500000001,42.606707317073166,1029.5731707317063,25.739329268292657,0
1676,4,0,0,48,0.0,0.0,1.0,48,900,200,700,0.2222222222222222,16,2,14,347.98144536052087,0.7916851359338061,0.22444331983805732,0.20963760244889904,132398.0034722221,-385.5902777777879,132012.41319444432,1675,8,779.375,39,9,18,33.755060728744944,0.6388888888888891,42.70833333333333,1029.1666666666656,26.38888888888886,0
1677,4,1,0,49,0.02040816326530612,0.0,1.0,49,1200,1100,100,0.9166666666666666,13,11,2,341.1838560173492,0.7957412131519275,0.22945330645256368,0.20722429991790553,132704.48022959154,-744.6747448979904,131959.80548469356,1676,0,764.4489795918367,41,8,16,33.622183708838804,0.6387195121951221,42.41071428571427,1030.3571428571406,25.13066202090587,0
1678,4,0,0,49,0.0,0.0,1.0,49,1050,600,450,0.5714285714285714,15,6,9,339.4884114848844,0.7950325963718821,0.22454734855024938,0.2068429393686253,132822.1758382909,-781.6821029385342,132040.49373535236,1677,1,765.4489795918367,42,7,16,33.54777683775146,0.6383928571428572,42.29651162790697,1030.8139534883715,24.543189368770747,0
1679,4,1,1,49,0.02,0.02,0.98,50,1450,1000,450,0.6896551724137931,19,10,9,332.4008386718743,0.8017006802721088,0.21795405599425677,0.20397989791626475,133089.78052126203,-1152.1690672153609,131937.61145404668,1678,0,751.12,44,6,17,33.462326513519976,0.6382575757575758,42.03703703703704,1031.8518518518522,23.45117845117846,0
1680,4,0,0,49,0.0,0.0,1.0,49,950,700,250,0.7368421052631579,12,7,5,336.8471052684461,0.793296485260771,0.22278849108501286,0.20612015003280415,132983.40292125804,-840.9851354453629,132142.41778581266,1679,3,767.4489795918367,43,6,17,33.454217162443385,0.6385658914728682,42.140151515151516,1031.439393939394,23.986962649753348,0
1681,4,0,0,49,0.0,0.0,1.0,49,850,500,350,0.5882352941176471,12,5,7,336.9489859080833,0.7925878684807256,0.22470895655187295,0.20658746209727422,133056.66864848757,-833.3380861168641,132223.3305623707,1680,4,768.4489795918367,43,6,17,33.37817423894754,0.6392926356589148,42.06912878787878,1031.7234848484836,23.993569415081016,0
1682,4,0,0,49,0.0,0.0,1.0,49,1050,600,450,0.5714285714285714,15,6,9,340.30907413234877,0.7931901927437642,0.22103784700947338,0.19945022888374006,131352.3922194245,-850.9278688877268,130501.46435053679,1681,5,769.4489795918367,43,6,18,35.00510007698229,0.6223352713178294,43.726325757575765,1025.0946969696981,23.83941155743484,4
1683,4,1,1,49,0.02,0.02,0.98,50,600,500,100,0.8333333333333334,7,5,2,335.8023157429428,0.7993877551020407,0.22165011734970141,0.19766302092456564,131518.00840192064,-1167.1896433470324,130350.8187585736,1682,0,755.04,44,6,18,34.95366191249925,0.6226325757575757,43.564814814814824,1025.7407407407425,23.312289562289603,0
1684,4,0,0,49,0.0,0.0,1.0,49,1250,600,650,0.48,19,6,13,347.7292451776938,0.792906746031746,0.2418508041823404,0.1980045040722571,130238.95747599455,-736.5526406035628,129502.40483539099,1683,7,771.4489795918367,44,5,17,35.941279632317375,0.6098484848484849,44.81481481481482,1020.740740740741,23.198653198653204,3
1685,4,0,0,49,0.0,0.0,1.0,49,1600,1300,300,0.8125,19,13,6,344.6004918463684,0.7928004535147393,0.2393912403671148,0.19696796009006076,130386.26359593765,-813.761600271834,129572.50199566582,1684,8,772.4489795918367,42,7,17,35.87187697659709,0.6140873015873016,44.67054263565891,1021.3178294573636,24.317091177556275,0
1686,4,0,0,49,0.0,0.0,1.0,49,950,600,350,0.631578947368421,13,6,7,343.0945024177755,0.7926941609977325,0.23892323270262472,0.19623218393845737,130411.0059961089,-851.3401575927032,129559.6658385162,1685,9,773.4489795918367,42,7,17,35.88527337697244,0.6143353174603174,44.64631782945736,1021.4147286821697,24.31939830195642,0
1687,4,0,0,49,0.0,0.0,1.0,49,1700,1100,600,0.6470588235294118,23,11,12,345.23913958494,0.7900722789115646,0.2442285910936226,0.19830580274296208,130576.95316983758,-783.9450076044521,129793.00816223313,1686,10,774.4489795918367,43,6,15,35.66248571605052,0.6145833333333334,44.483901515151516,1022.0643939393939,23.76893939393939,0
1688,4,1,1,49,0.02,0.02,0.98,50,1050,900,150,0.8571428571428571,12,9,3,343.34542285627674,0.7988945578231292,0.24509775524981858,0.19839331755837586,130806.65294924557,-1017.6268861454046,129789.02606310017,1687,0,759.94,44,6,15,35.47851798213853,0.615530303030303,44.25925925925926,1022.9629629629633,23.249158249158256,0
1689,4,0,0,49,0.0,0.0,1.0,49,1150,800,350,0.6956521739130435,15,8,7,347.8609928278993,0.791843820861678,0.24473919962502433,0.20043772681727087,130697.9641945019,-707.0552829430649,129990.90891155883,1688,12,776.4489795918367,43,6,15,35.47300426004814,0.615794573643411,44.365530303030305,1022.5378787878793,23.779950669485565,0
1690,4,1,1,49,0.02,0.02,0.98,50,1500,1100,400,0.7333333333333333,19,11,8,344.22886231575524,0.7999149659863946,0.24451963090284057,0.19963829192226418,130948.76971879278,-984.7307956104337,129964.03892318235,1689,0,761.9,44,6,16,35.31225499065193,0.6169507575757576,44.12037037037037,1023.5185185185179,23.261784511784498,0
1691,4,0,0,49,0.0,0.0,1.0,49,1000,700,300,0.7,13,7,6,353.38833354996825,0.792375283446712,0.25376384704737975,0.20451852940585982,130867.47378795042,-550.5923044364175,130316.88148351401,1690,14,778.4489795918367,43,6,17,35.160130340891556,0.6174903100775195,44.1998106060606,1023.2007575757567,23.795366455250157,0
1692,4,0,0,49,0.0,0.0,1.0,49,1200,800,400,0.6666666666666666,16,8,8,350.2160462372405,0.7925170068027211,0.2506792336695993,0.2031929814159063,130964.38573411679,-626.8341260617456,130337.55160805504,1691,15,779.4489795918367,43,6,17,35.143264100903586,0.6184593023255813,44.10511363636364,1023.5795454545458,23.804175475687114,0
1693,4,1,0,50,0.02,0.0,1.0,50,1000,700,300,0.7,13,7,6,346.112196130527,0.7986394557823129,0.25900252981568483,0.20247197604506756,131280.6755829906,-912.4314128943577,130368.24417009625,1692,0,764.84,44,6,18,34.92877364172992,0.6202651515151515,43.796296296296305,1024.8148148148164,23.291245791245828,0
1694,4,0,1,49,0.0,0.02,0.98,50,1850,1300,550,0.7027027027027027,24,13,11,348.86632789430706,0.7977210884353741,0.2641235944439193,0.20500013037787082,131452.30647384483,-828.1261626701289,130624.1803111747,1693,1,765.84,42,8,18,34.68495070710888,0.624751984126984,43.628875968992254,1025.484496124032,24.416297526762666,0
1695,4,2,1,50,0.0392156862745098,0.0196078431372549,0.9803921568627451,51,1300,1100,200,0.8461538461538461,15,11,4,346.8388066584869,0.8117973856209151,0.2788189021921452,0.20627781659162664,131911.1570247935,-1049.618342516059,130861.53868227745,1694,0,743.6862745098039,43,8,17,34.27436701081613,0.627906976744186,43.18181818181819,1027.2727272727282,23.890063424947165,0
1696,4,0,0,50,0.0,0.0,1.0,50,1600,1100,500,0.6875,21,11,10,356.87144284190805,0.8029081632653061,0.28120954807057275,0.21190366513621203,131850.08154745813,-589.2942318670732,131260.78731559106,1695,1,759.56,42,8,17,34.07829354970595,0.628720238095238,43.241279069767444,1027.0348837209306,24.453211517165013,0
1697,4,0,0,50,0.0,0.0,1.0,50,800,400,400,0.5,12,4,8,345.67428706565875,0.8029081632653061,0.3012857532007627,0.19552701199045194,129979.17631172836,-973.1015868604361,129006.07472486793,1696,2,760.56,44,6,17,36.257150640152545,0.6072443181818181,45.06944444444444,1019.722222222222,23.175505050505045,6
1698,4,1,1,50,0.0196078431372549,0.0196078431372549,0.9803921568627451,51,1700,1400,300,0.8235294117647058,20,14,6,333.61550288230654,0.8060130718954249,0.2947724820478481,0.19068912149563474,130386.2635959375,-1499.2982943733587,128886.96530156414,1697,0,746.6274509803922,42,9,18,36.15235610373182,0.6140873015873016,44.670542635658904,1021.3178294573624,24.31709117755625,0
1699,4,0,0,50,0.0,0.0,1.0,50,900,500,400,0.5555555555555556,13,5,8,339.58464684054115,0.801734693877551,0.31060140390817725,0.194348607328609,130435.75074364492,-1141.2043296677198,129294.54641397721,1698,1,762.46,42,8,19,35.94985138809838,0.6145833333333335,44.6220930232558,1021.5116279069744,24.321705426356534,0
1700,4,1,0,51,0.0196078431372549,0.0,1.0,51,1350,900,450,0.6666666666666666,18,9,9,336.92139682903485,0.8086601307189544,0.3255714886660741,0.19456197965344182,130782.97432270211,-1387.283521947895,129395.69080075421,1699,0,748.4901960784314,44,7,17,35.66673455840198,0.6152935606060608,44.2824074074074,1022.8703703703686,23.247053872053833,0
1701,4,0,0,51,0.0,0.0,1.0,51,1000,500,500,0.5,15,5,10,335.284354778721,0.808921568627451,0.31559306912992735,0.19414184294901085,130887.4852725921,-1423.0947903539454,129464.39048223814,1700,1,749.4901960784314,45,6,17,35.603017762827875,0.6150462962962964,44.18025362318839,1023.2789855072438,22.739533011272083,0
1702,4,0,0,51,0.0,0.0,1.0,51,1700,1200,500,0.7058823529411765,22,12,10,314.702207413578,0.8090196078431373,0.2802721088435376,0.17930707166587542,130262.58680555523,-1955.6485146240652,128306.93829093117,1701,2,750.4901960784314,41,10,18,36.76020408163264,0.6143292682926831,44.79166666666665,1020.8333333333308,24.898373983739774,5
1703,4,3,2,52,0.05555555555555555,0.037037037037037035,0.962962962962963,54,1450,1000,450,0.6896551724137931,19,10,9,303.5335227157661,0.827422548334498,0.29446203326800324,0.17614504428466116,130972.46334876542,-2849.0933641975325,128123.3699845679,1702,0,709.7407407407408,44,10,16,36.32971506105833,0.6171875,44.09722222222222,1023.6111111111111,23.26388888888889,0
1704,4,0,0,52,0.0,0.0,1.0,52,900,700,200,0.7777777777777778,11,7,4,312.46244531362873,0.8206385118149824,0.3012357678422659,0.18060630266041378,130819.0312661416,-2224.793119404264,128594.23814673733,1703,1,737.9423076923077,43,9,16,36.25584328427286,0.6170058139534884,44.24715909090909,1023.0113636363642,23.790961945031725,0
1705,4,2,0,54,0.037037037037037035,0.0,1.0,54,1400,1000,400,0.7142857142857143,18,10,8,305.0045646413847,0.8294607500582344,0.31110502423537634,0.17853963401615416,131305.40878382616,-2790.2501917660184,128515.15859206015,1704,0,711.574074074074,46,8,18,35.95709713692586,0.6179800724637681,43.77216312056737,1024.9113475177296,22.28068146777673,0
1706,4,1,1,54,0.01818181818181818,0.01818181818181818,0.9818181818181818,55,1500,1100,400,0.7333333333333333,19,11,8,298.11157408694396,0.8347362514029181,0.30371457445406236,0.17612588429065887,131658.81406092545,-3150.184950681522,128508.62911024393,1705,0,699.6181818181818,41,14,12,35.77885854680202,0.6283028455284552,43.427579365079374,1026.2896825396838,25.031455671699604,0
1707,4,0,0,54,0.0,0.0,1.0,54,1050,800,250,0.7619047619047619,13,8,5,330.1597001138717,0.8294170743070114,0.26880580296455814,0.17952323874738807,128420.90778730455,-2085.3201176304033,126335.58766967415,1706,2,713.574074074074,41,13,12,38.23600779746175,0.5957825203252034,46.60218253968253,1013.5912698412683,24.721738288811423,8
1708,4,2,1,55,0.03571428571428571,0.017857142857142856,0.9821428571428571,56,1850,1200,650,0.6486486486486487,25,12,13,331.81280863649596,0.8397862554112554,0.2527333316692044,0.18171911041403482,128706.14924425312,-2643.253838781099,126062.89540547202,1707,0,689.0535714285714,46,10,14,37.90352524899527,0.5919384057971016,46.320921985815595,1014.7163120567361,22.05905026210296,2
1709,4,0,0,55,0.0,0.0,1.0,55,1350,800,550,0.5925925925925926,19,8,11,331.9692133058935,0.8346240179573513,0.26675642138216893,0.18249352191985072,128856.28450069559,-2444.736120956748,126411.54837973884,1708,1,702.4363636363636,45,10,14,37.746732536354706,0.594675925925926,46.173007246376805,1015.3079710144915,22.562399355877588,0
1710,4,0,0,55,0.0,0.0,1.0,55,1800,1400,400,0.7777777777777778,22,14,8,328.83606530173046,0.8349607182940516,0.2638212123856605,0.18142188118885508,128998.675910731,-2516.1165968764417,126482.55931385457,1709,2,703.4363636363636,46,9,14,37.6814439887134,0.5948822463768118,46.0328014184397,1015.8687943262383,22.084104224483443,0
1711,4,1,2,54,0.017857142857142856,0.03571428571428571,0.9642857142857143,56,1300,900,400,0.6923076923076923,17,9,8,324.6425175847421,0.8394209956709957,0.27531982942430644,0.18037455001415686,129277.04480229603,-2805.2800414859903,126471.76476081004,1710,0,691.8571428571429,41,15,15,37.50518242122719,0.604420731707317,45.75892857142858,1016.9642857142867,24.80400696864114,0
1712,4,1,2,53,0.01818181818181818,0.03636363636363636,0.9636363636363636,55,1000,600,400,0.6,14,6,8,329.55559201910137,0.8379910213243547,0.2947444884320629,0.18371439795630543,129408.1110780621,-2470.566668319117,126937.54440974297,1711,0,704.3636363636364,40,15,16,37.24717838593687,0.6072916666666666,45.63008130081301,1017.4796747967487,25.436991869918717,0
1713,4,1,1,53,0.018518518518518517,0.018518518518518517,0.9814814814814815,54,1250,800,450,0.64,17,8,9,328.66576321239546,0.8337264150943396,0.29872783417466375,0.18357990064540675,129485.67450137169,-2288.4983929869613,127197.17610838472,1712,0,717.2592592592592,40,14,12,37.19108836744882,0.6080729166666666,45.553861788617894,1017.7845528455297,25.44461382113824,0
1714,4,2,3,52,0.03636363636363636,0.05454545454545454,0.9454545454545454,55,1150,700,450,0.6086956521739131,16,7,9,325.6648733813007,0.8370089786756454,0.29281805213331613,0.1832191623116306,129768.46648526228,-2547.793758638299,127220.67272662398,1713,0,705.1818181818181,42,13,12,36.98070217150106,0.6078869047619048,45.276162790697676,1018.8953488372091,24.259413067552597,0
1715,4,1,1,52,0.018867924528301886,0.018867924528301886,0.9811320754716981,53,1400,1000,400,0.7142857142857143,18,10,8,337.5394647555509,0.8272859216255443,0.29112928131296045,0.1891105385508174,129605.14298311916,-1850.6298815822622,127754.5131015369,1714,0,732.7169811320755,41,12,12,36.84398545076644,0.6077235772357723,45.43650793650794,1018.2539682539682,24.835462640340687,0
1716,4,0,1,51,0.0,0.019230769230769232,0.9807692307692307,52,1700,1200,500,0.7058823529411765,22,12,10,343.23250443931033,0.8204656862745097,0.2863705857665324,0.19230013239984067,129605.14298311918,-1503.0604371378179,128102.08254598136,1715,4,747.8076923076923,41,11,13,36.69906144453105,0.6077235772357723,45.43650793650794,1018.2539682539683,24.83546264034069,0
1717,4,1,0,52,0.019230769230769232,0.0,1.0,52,1500,1100,400,0.7333333333333333,19,11,8,341.15629338698744,0.8238122171945701,0.29071473485642363,0.19262209180465326,129908.37191358047,-1536.1882716049147,128372.18364197556,1716,0,744.1923076923077,44,8,14,36.4441416893733,0.6065340909090908,45.1388888888889,1019.4444444444463,23.16919191919196,0
1718,4,3,4,51,0.05454545454545454,0.07272727272727272,0.9272727272727272,55,1150,800,350,0.6956521739130435,15,8,7,327.5017523269272,0.8339786756453423,0.2961432506887054,0.18733100233100228,130414.54081632647,-2454.9083522297874,127959.63246409668,1717,0,704.5454545454545,41,14,15,36.27986596736597,0.6158536585365854,44.64285714285714,1021.4285714285709,24.912891986062704,0
1719,4,1,0,52,0.019230769230769232,0.0,1.0,52,1200,700,500,0.5833333333333334,17,7,10,344.45849312156724,0.8295468828557063,0.2963291934026553,0.1963921692337834,130288.5239027695,-1424.2022770837475,128864.32162568576,1718,0,714.9615384615385,40,12,16,35.97451722078438,0.6161458333333334,44.766260162601625,1020.9349593495933,25.523373983739834,0
1720,4,0,0,52,0.0,0.0,1.0,52,1200,800,400,0.6666666666666666,16,8,8,342.56565422081354,0.8289184263448969,0.2943998898037894,0.1960973779172902,130444.20070725087,-1462.859409081906,128981.34129816896,1719,1,715.9615384615385,40,12,16,35.86516779413714,0.6177083333333333,44.61382113821138,1021.5447154471537,25.538617886178844,0
1721,4,0,0,52,0.0,0.0,1.0,52,1400,1100,300,0.7857142857142857,17,11,6,341.70749798316297,0.8297197083961789,0.29012114352142193,0.19639394369798016,130599.97046235709,-1474.6021713265914,129125.36829103049,1720,2,716.9615384615385,40,12,15,35.72943593822495,0.6192708333333334,44.46138211382114,1022.1544715447156,25.55386178861789,0
1722,4,1,1,52,0.018867924528301886,0.018867924528301886,0.9811320754716981,53,1150,800,350,0.6956521739130435,15,8,7,339.13556585496696,0.8358732462506047,0.28953015885793554,0.19615844591487766,130845.55820302642,-1725.1235158415361,129120.43468718488,1721,0,704.4150943396227,41,12,15,35.54686237434953,0.6201727642276423,44.22123015873015,1023.115079365078,24.954026325977512,0
1723,4,0,2,50,0.0,0.038461538461538464,0.9615384615384616,52,1600,1000,600,0.625,22,10,12,357.52844264774336,0.8318093262946203,0.3030632072236823,0.20219885874111906,129972.73875114806,-1054.4783401097468,128918.26041103831,1722,4,718.9615384615385,43,9,16,35.96149083704804,0.6085271317829457,45.075757575757585,1019.6969696969715,23.713883016208637,5
1724,4,1,0,51,0.0196078431372549,0.0,1.0,51,1250,800,450,0.64,17,8,9,355.4752369911615,0.8356535947712419,0.3010260269610061,0.20204706482102075,130168.08234739373,-945.6940157750323,129222.3883316187,1723,0,700.156862745098,44,7,17,35.8155264192602,0.6091382575757576,44.88425925925926,1020.4629629629634,23.192340067340076,0
1725,4,0,0,51,0.0,0.0,1.0,51,1300,1000,300,0.7692307692307693,16,10,6,354.11921010455194,0.8344444444444445,0.30012530594559106,0.2019002034455354,130288.52390276968,-972.3289917613743,129316.19491100831,1724,1,701.156862745098,40,11,18,35.72794312827659,0.6161458333333333,44.76626016260163,1020.9349593495948,25.52337398373987,0
1726,4,3,1,53,0.05555555555555555,0.018518518518518517,0.9814814814814815,54,1250,800,450,0.64,17,8,9,341.1974467723313,0.8474988353133007,0.3234378139441425,0.19861282954221002,131090.9636488342,-1854.4195816186411,129236.54406721557,1725,0,663.1481481481482,44,10,16,35.24619499698613,0.6183712121212122,43.98148148148149,1024.0740740740755,23.274410774410807,0
1727,4,1,1,53,0.018518518518518517,0.018518518518518517,0.9814814814814815,54,1300,1000,300,0.7692307692307693,16,10,6,342.23527261065516,0.8455043093407874,0.3216077768606951,0.1994843537464582,131142.50223167407,-1823.681999579911,129318.82023209415,1726,0,664.0925925925926,45,9,16,35.16758047400074,0.6175925925925925,43.93115942028986,1024.275362318841,22.761674718196467,0
1728,4,0,0,53,0.0,0.0,1.0,53,1500,900,600,0.6,21,9,12,355.86462588355414,0.8416485244315433,0.3455832800316896,0.20008065807852568,129743.23666838142,-1365.6630494747628,128377.57361890665,1727,2,677.622641509434,44,9,17,36.23708685510013,0.6048768939393938,45.30092592592593,1018.7962962962969,23.15446127946129,4
1729,4,1,1,53,0.018518518518518517,0.018518518518518517,0.9814814814814815,54,1550,1200,350,0.7741935483870968,19,12,7,354.4301483633155,0.8450093174935942,0.34742490470223353,0.20086753400701038,130054.61960624086,-1580.9443755250916,128473.67523071576,1728,0,666.0555555555555,45,9,18,35.95734171032769,0.6067129629629628,44.99547101449276,1020.0181159420293,22.667069243156206,0
1730,4,1,1,53,0.018518518518518517,0.018518518518518517,0.9814814814814815,54,1000,700,300,0.7,13,7,6,353.5380572470003,0.8444852084789192,0.35096398893788483,0.2005994528349105,130100.82018122538,-1600.881757377625,128499.93842384775,1729,0,666.9814814814815,45,9,18,35.93319941401049,0.6071759259259257,44.9501811594203,1020.1992753623215,22.671095008051587,0
1731,4,0,1,52,0.0,0.018867924528301886,0.9811320754716981,53,1200,800,400,0.6666666666666666,16,8,8,356.16923546489363,0.8389574262215771,0.34603917816266794,0.1964332847728493,128984.86036680748,-1400.2881934205377,127584.57217338694,1730,2,680.566037735849,43,10,18,37.00135561356079,0.5985949612403101,46.04640151515152,1015.8143939393956,23.62359055673013,3
1732,4,2,1,53,0.037037037037037035,0.018518518518518517,0.9814814814814815,54,850,500,350,0.5882352941176471,12,5,7,346.7186484730347,0.845198579082227,0.3409140134286337,0.19375453885257804,129504.1454081631,-1818.9731776836252,127685.17223047947,1731,0,640.5185185185185,41,13,18,36.71296296296295,0.6067073170731708,45.53571428571428,1017.8571428571415,24.825783972125404,0
1733,4,1,1,53,0.018518518518518517,0.018518518518518517,0.9814814814814815,54,1200,700,500,0.5833333333333334,17,7,10,348.284441833545,0.8425197996738878,0.34516606231170344,0.19525613301044967,129630.3985280453,-1770.349800799966,127860.04872724533,1732,0,641.5,41,13,18,36.54479217405424,0.6079776422764228,45.41170634920634,1018.3531746031732,24.83788230739447,0
1734,4,2,2,53,0.03636363636363636,0.03636363636363636,0.9636363636363636,55,1050,500,550,0.47619047619047616,16,5,11,344.1166033029666,0.8494668911335578,0.3372579487396028,0.19425355189074123,129900.3271798238,-2059.8281285869994,127840.4990512368,1733,0,630.8,43,12,18,36.37685787273573,0.6078003875968991,45.146780303030305,1019.4128787878788,23.707276250880902,0
1735,4,1,0,54,0.018518518518518517,0.0,1.0,54,1500,1000,500,0.6666666666666666,20,10,10,354.0451600707131,0.8431749359422316,0.3586623304859542,0.2001943696627684,129966.00193986262,-1597.233207890131,128368.76873197248,1734,0,643.4629629629629,42,12,20,36.05712882891444,0.6098710317460316,45.08236434108528,1019.6705426356607,24.277870062753827,0
1736,4,0,0,54,0.0,0.0,1.0,54,1750,1100,650,0.6285714285714286,24,11,13,354.4883214463628,0.8424178895877009,0.3613792788135204,0.20146338441185366,130163.68762581886,-1571.69857205095,128591.9890537679,1735,1,644.4629629629629,42,12,21,35.84516348558223,0.6118551587301586,44.88856589147287,1020.4457364341092,24.296327057954983,0
1737,4,1,0,55,0.01818181818181818,0.0,1.0,55,1250,800,450,0.64,17,8,9,351.173194169822,0.8465207631874299,0.3593949280735578,0.2011861383421508,130475.34722222255,-1835.9608797547871,128639.38634246777,1736,0,633.7272727272727,39,16,22,35.61378466557913,0.6196581196581195,44.58333333333335,1021.6666666666692,26.196581196581263,0
1738,4,0,0,55,0.0,0.0,1.0,55,1050,800,250,0.7619047619047619,13,8,5,348.7625426440883,0.8457912457912458,0.35613828633908096,0.2002170453997166,130555.17713758713,-1893.4488932291329,128661.728244358,1737,1,634.7272727272727,39,16,19,35.594507015934504,0.6204594017094016,44.50520833333335,1021.9791666666692,26.204594017094085,0
1739,4,0,0,55,0.0,0.0,1.0,55,1150,600,550,0.5217391304347826,17,6,11,345.650897382047,0.8451178451178452,0.35520054937607815,0.19906088600805846,130677.89019639461,-1966.2139971247036,128711.6761992699,1738,2,635.7272727272727,40,15,19,35.54981280853459,0.6200520833333332,44.38516260162603,1022.4593495934981,25.561483739837453,0
1740,4,0,0,55,0.0,0.0,1.0,55,1250,800,450,0.64,17,8,9,347.13468268475435,0.84503367003367,0.35598428397236126,0.2004538486071177,130781.81932257621,-1920.2189297044995,128861.60039287171,1739,3,636.7272727272727,40,15,19,35.40673124689519,0.6210937499999998,44.28353658536587,1022.8658536585395,25.571646341463488,0
1741,4,0,0,55,0.0,0.0,1.0,55,900,800,100,0.8888888888888888,10,8,2,347.13468268475435,0.844949494949495,0.35598428397236126,0.2004538486071177,130781.81932257621,-1920.2189297044995,128861.60039287171,1740,4,637.7272727272727,40,15,19,35.40673124689519,0.6210937499999998,44.28353658536587,1022.8658536585395,25.571646341463488,0
1742,4,1,0,56,0.017857142857142856,0.0,1.0,56,950,600,350,0.631578947368421,13,6,7,340.4964061562105,0.845900974025974,0.350862605121548,0.1978924657561346,131030.32889399705,-2276.928782825524,128753.40011117153,1741,0,627.3214285714286,42,14,20,35.325375418007425,0.6205357142857141,44.04069767441862,1023.837209302328,24.37707641196019,0
1743,4,0,1,55,0.0,0.017857142857142856,0.9821428571428571,56,2200,1800,400,0.8181818181818182,26,18,8,346.27167748015415,0.8470238095238095,0.350395065151095,0.20243143284779871,131255.3367930013,-2109.998870092944,129145.33792290837,1742,1,628.3214285714286,43,13,20,34.95027030773497,0.6213662790697673,43.82102272727274,1024.7159090909113,23.830602536997937,0
1744,4,0,0,55,0.0,0.0,1.0,55,1550,1200,350,0.7741935483870968,19,12,7,353.77453489323244,0.8453423120089787,0.3534167598140976,0.20629537164097556,131158.3172366421,-1719.905464445578,129438.41177219652,1743,2,640.5454545454545,43,12,20,34.85610998120244,0.6203972868217054,43.9157196969697,1024.337121212122,23.821793516560977,0
1745,4,2,3,54,0.03508771929824561,0.05263157894736842,0.9473684210526316,57,1450,1000,450,0.6896551724137931,19,10,9,341.8576715964281,0.8498329156223893,0.34632118340906826,0.2017018766298837,131607.911755559,-2401.325736427847,129206.58601913115,1744,0,619.0350877192982,41,16,17,34.70775323084855,0.6277947154471544,43.47718253968255,1026.0912698412722,25.026616337592003,0
1746,4,0,0,54,0.0,0.0,1.0,54,1350,1000,350,0.7407407407407407,17,10,7,356.9996681152948,0.8413987887258327,0.34571037202616095,0.20939158126285684,131381.5158420141,-1419.3684895833094,129962.1473524308,1745,4,627.4629629629629,39,15,20,34.5479407979408,0.6287393162393162,43.69791666666668,1025.208333333335,26.287393162393208,0
1747,4,0,0,54,0.0,0.0,1.0,54,1150,700,450,0.6086956521739131,16,7,9,356.7098044060792,0.8421412764966224,0.3446287831762682,0.2096601805598722,131461.6224500872,-1421.2700737846837,130040.3523763025,1746,5,628.4629629629629,39,15,20,34.47445826984932,0.6295405982905982,43.619791666666686,1025.5208333333364,26.29540598290606,0
1748,4,0,0,54,0.0,0.0,1.0,54,1550,1400,150,0.9032258064516129,17,14,3,351.50674829829813,0.8415298159795015,0.3387173701685833,0.20714889807771888,131562.604569453,-1550.9713340273306,130011.63323542566,1747,6,629.4629629629629,40,14,17,34.50594353640417,0.6289062499999998,43.52134146341465,1025.9146341463438,25.647865853658594,0
1749,4,0,0,54,0.0,0.0,1.0,54,1000,700,300,0.7,13,7,6,351.53249392549196,0.8412240857209411,0.3394279195507284,0.20744731684194606,131614.73954202214,-1546.6284742877656,130068.11106773438,1748,7,630.4629629629629,40,14,18,34.452683965534334,0.6294270833333332,43.470528455284565,1026.1178861788635,25.652947154471587,0
1750,4,0,0,54,0.0,0.0,1.0,54,1000,600,400,0.6,14,6,8,350.85733588023237,0.841267761472164,0.338834291033421,0.20728835749177657,131658.81406092545,-1561.3078506865513,130097.50621023889,1749,8,631.4629629629629,41,13,18,34.425547768648315,0.6283028455284552,43.427579365079374,1026.2896825396838,25.031455671699604,0
1751,4,0,0,54,0.0,0.0,1.0,54,850,600,250,0.7058823529411765,11,6,5,311.57570487471276,0.8422431865828093,0.251309901279543,0.17898138024417354,130579.52728893163,-2650.5150944231436,127929.01219450848,1750,9,632.4629629629629,46,8,11,36.52004365802179,0.6107336956521738,44.4813829787234,1022.0744680851062,22.219010175763177,8
1752,4,1,1,54,0.01818181818181818,0.01818181818181818,0.9818181818181818,55,1500,1200,300,0.8,18,12,6,310.03227446968543,0.8441919191919192,0.2623019607238173,0.17929540661922042,130839.21456042635,-2887.1241440007693,127952.09041642558,1751,0,621.9454545454546,47,8,12,36.2976554103739,0.612145390070922,44.22743055555556,1023.090277777778,21.76787825059102,0
1753,4,0,0,54,0.0,0.0,1.0,54,1100,900,200,0.8181818181818182,13,9,4,315.79195564219447,0.8443541812252504,0.26276397714872624,0.18257711263080748,130828.82211659347,-2537.06208188725,128291.76003470621,1752,1,634.2777777777778,46,8,12,36.16081744656268,0.6132246376811595,44.23758865248226,1023.0496453900688,22.2402096823928,0
1754,4,2,0,56,0.03571428571428571,0.0,1.0,56,1450,900,550,0.6206896551724138,20,9,11,308.3256765060561,0.8519345238095238,0.27662345744870076,0.1802830047343265,131262.76323667177,-3105.6639449998106,128157.09929167197,1753,0,612.5892857142857,48,8,16,35.91489641246921,0.6152343750000002,43.81377551020406,1024.74489795918,21.34885204081625,0
1755,4,1,0,57,0.017543859649122806,0.0,1.0,57,750,500,250,0.6666666666666666,10,5,5,304.62235547394226,0.8543494152046783,0.28153393973453045,0.17900157623435417,131452.3064738442,-3391.223869051388,128061.0826047928,1754,0,602.8245614035088,42,15,17,35.819238401209475,0.6247519841269844,43.628875968992226,1025.484496124027,24.416297526762545,0
1756,4,1,0,58,0.017241379310344827,0.0,1.0,58,1550,1000,550,0.6451612903225806,21,10,11,289.6779711012689,0.8570906432748538,0.25516729765680957,0.16546012925614842,130359.27456381998,-3977.273164930193,126382.00139888978,1755,0,593.4137931034483,43,15,18,37.30140331355095,0.6124031007751938,44.696969696969695,1021.2121212121209,23.7491190979563,5
1757,4,0,0,58,0.0,0.0,1.0,58,1900,1500,400,0.7894736842105263,23,15,8,291.39792655770543,0.8561327888687236,0.25812858096945446,0.16717038944626275,130528.56445312515,-3992.849392361096,126535.71506076405,1756,1,594.4137931034483,43,15,11,37.08694359497113,0.6140988372093023,44.53125000000001,1021.8750000000011,23.764534883720955,0
1758,4,1,2,57,0.01694915254237288,0.03389830508474576,0.9661016949152542,59,1800,1300,500,0.7222222222222222,23,13,10,284.6072285682533,0.8580751996882914,0.2644420291983669,0.1645474658155132,130828.8221165938,-4353.034304109445,126475.78781248436,1757,0,585.3220338983051,46,13,12,36.95840554592722,0.6132246376811594,44.23758865248227,1023.0496453900714,22.240209682392855,0
1759,4,0,0,57,0.0,0.0,1.0,57,1250,1000,250,0.8,15,10,5,293.4154392291833,0.8516081871345029,0.259023476058998,0.16840489874011932,130546.30594135805,-3739.1396604938177,126807.16628086423,1758,3,606.8070175438596,44,13,12,37.01753193802667,0.6129261363636364,44.51388888888889,1021.9444444444446,23.226010101010104,0
1760,4,1,2,56,0.017241379310344827,0.034482758620689655,0.9655172413793104,58,850,700,150,0.8235294117647058,10,7,3,287.70296891438454,0.8551119177253479,0.2606426193457745,0.16589205919527078,130725.33097694816,-4077.986833123286,126647.34414382487,1759,0,597.3275862068965,45,13,12,36.983318571006784,0.6134259259259258,44.33876811594203,1022.6449275362322,22.725442834138494,0
1761,4,0,0,56,0.0,0.0,1.0,56,1650,1200,450,0.7272727272727273,21,12,9,299.36899797164244,0.8486742424242424,0.2556832470781325,0.17195793481149235,130576.95316983777,-3381.861674271107,127195.09149556667,1760,5,618.9107142857143,43,13,13,36.834541678248236,0.6145833333333333,44.48390151515152,1022.0643939393955,23.76893939393943,0
1762,4,1,0,57,0.017543859649122806,0.0,1.0,57,1450,1000,450,0.6896551724137931,19,10,9,304.95170970361517,0.8504594820384294,0.25782109969861966,0.17787566913807532,131169.15274791245,-3397.7940760941315,127771.35867181832,1761,0,609.0350877192982,46,11,15,36.09548535987308,0.6166213768115942,43.90514184397163,1024.3794326241125,22.269118100524185,1
1763,4,0,2,55,0.0,0.03508771929824561,0.9649122807017544,57,1150,800,350,0.6956521739130435,15,8,7,319.39931818502646,0.8486581035923141,0.2895593104235641,0.18638365276366717,131185.80246913564,-3002.6806198268814,128183.12184930877,1762,1,610.0350877192982,44,13,16,35.708717462039026,0.6193181818181819,43.88888888888888,1024.444444444443,23.28282828282825,2
1764,4,0,0,55,0.0,0.0,1.0,55,1000,500,500,0.5,15,5,10,322.72457668145984,0.8418911335578002,0.2948631950573699,0.1879518738185236,131109.8209097364,-2537.5277096246755,128572.29320011172,1763,2,632.0181818181818,43,12,16,35.700127138233924,0.6199127906976745,43.96306818181817,1024.147727272726,23.817389006342463,0
1765,4,0,0,55,0.0,0.0,1.0,55,1250,800,450,0.64,17,8,9,326.3263852143375,0.8417789001122334,0.2953288533263243,0.1906614455534242,131233.23473936884,-2435.02657750344,128798.2081618654,1764,3,633.0181818181818,44,11,17,35.483500512079054,0.6197916666666667,43.84259259259259,1024.6296296296284,23.28703703703701,0
1766,4,0,0,55,0.0,0.0,1.0,55,1300,1000,300,0.7692307692307693,16,10,6,324.21899632740406,0.8419753086419753,0.29455626633029963,0.19041732671382458,131432.31232236107,-2477.29234855959,128955.01997380148,1765,4,634.0181818181818,40,15,19,35.33696729435082,0.6276041666666667,43.64837398373984,1025.406504065041,25.635162601626025,0
1767,4,0,0,55,0.0,0.0,1.0,55,1400,1100,300,0.7857142857142857,17,11,6,323.81746171774745,0.8420594837261504,0.28806007779858867,0.1909615124709334,131588.67076475648,-2477.8581284288393,129110.81263632764,1766,5,635.0181818181818,40,15,13,35.189885433174865,0.6291666666666667,43.4959349593496,1026.016260162602,25.650406504065053,0
1768,4,0,0,55,0.0,0.0,1.0,55,1250,600,650,0.48,19,6,13,323.5939741525264,0.8410213243546577,0.285553642337562,0.19156467073972225,131735.18597253726,-2474.257527084899,129260.92844545236,1767,6,636.0181818181818,41,14,15,35.048237984795776,0.6290650406504064,43.35317460317461,1026.5873015873024,25.038714672861033,0
1769,4,0,3,52,0.0,0.05454545454545454,0.9454545454545454,55,1800,1400,400,0.7777777777777778,22,14,8,321.31511545935604,0.840712682379349,0.28342628292391603,0.19059786590944386,131811.58002842346,-2529.3893888573925,129282.19063956606,1768,7,637.0181818181818,41,14,16,35.02992867033781,0.6298272357723577,43.27876984126984,1026.884920634921,25.045973674022463,0
1770,4,0,0,52,0.0,0.0,1.0,52,1850,1300,550,0.7027027027027027,24,13,11,332.7234584844621,0.8329091251885369,0.29035795887281,0.1967509912583764,131692.96136558938,-1636.5324872760827,130056.4288783133,1769,8,668.1923076923077,40,12,17,34.856435643564346,0.6302083333333333,43.394308943089435,1026.422764227643,25.660569105691074,0
1771,4,0,0,52,0.0,0.0,1.0,52,1900,1600,300,0.8421052631578947,22,16,6,334.18497170114597,0.8316993464052287,0.29756594222205335,0.19829354897475507,131823.38271077067,-1589.3213158503545,130234.06139492033,1770,9,669.1923076923077,40,12,18,34.687654626422564,0.6315104166666667,43.267276422764226,1026.9308943089427,25.67327235772357,0
1772,4,0,0,52,0.0,0.0,1.0,52,950,700,250,0.7368421052631579,12,7,5,333.80100308991223,0.8312280040221216,0.29735528163520075,0.19826975243774292,131862.5217013888,-1596.8315972222288,130265.69010416656,1771,10,670.1923076923077,41,11,18,34.65813049357675,0.6303353658536586,43.229166666666664,1027.0833333333326,25.050813008130064,0
1773,4,0,0,52,0.0,0.0,1.0,52,1100,800,300,0.7272727272727273,14,8,6,338.2559232857304,0.8312908496732025,0.30148134669231474,0.20145581354055833,131964.434573019,-1472.4496685248193,130491.9849044942,1772,11,671.1923076923077,41,11,19,34.44117907373435,0.6313516260162602,43.129960317460316,1027.4801587301586,25.060491676345332,0
1774,4,0,0,52,0.0,0.0,1.0,52,1800,1300,500,0.7222222222222222,23,13,10,337.12909599245006,0.8297825540472599,0.3008057512303388,0.20159658521464263,132117.37769471196,-1491.8775785777473,130625.50011613421,1773,12,672.1923076923077,41,11,20,34.316297565055166,0.6328760162601628,42.981150793650784,1028.0753968253953,25.075009678668177,0
1775,4,0,1,51,0.0,0.019230769230769232,0.9807692307692307,52,1050,800,250,0.7619047619047619,13,8,5,314.8590759647345,0.8301596279537455,0.26175410926649856,0.17951328259019855,130287.90632283017,-2128.618964947084,128159.28735788308,1774,13,673.1923076923077,41,11,19,36.7306181776957,0.6145833333333333,44.76686507936508,1020.9325396825406,24.900793650793673,6
1776,4,0,0,51,0.0,0.0,1.0,51,1200,700,500,0.5833333333333334,17,7,10,316.34001875133407,0.8286928104575164,0.2580264130525902,0.1804751370836324,130313.22830057937,-1955.3421831695755,128357.8861174098,1775,14,686.4313725490196,41,10,19,36.66723344992876,0.6148373983739838,44.74206349206349,1021.0317460317451,24.90321331784744,0
1777,4,0,0,51,0.0,0.0,1.0,51,1150,700,450,0.6086956521739131,16,7,9,315.80364801025746,0.8273202614379086,0.2591003197598176,0.1806232367702724,130411.00599610888,-1963.1457131482593,128447.86028296062,1776,15,687.4313725490196,42,9,19,36.58215539322644,0.6143353174603174,44.64631782945736,1021.4147286821695,24.31939830195642,0
1778,4,0,0,51,0.0,0.0,1.0,51,1000,700,300,0.7,13,7,6,314.83618941439113,0.828202614379085,0.2561267695215257,0.18050385142302217,130504.37345758708,-1982.5000717401465,128521.87338584693,1777,16,688.4313725490196,43,8,16,36.512588816805675,0.6138565891472869,44.554924242424235,1021.7803030303019,23.76233262861167,0
1779,4,0,0,51,0.0,0.0,1.0,51,1850,1500,350,0.8108108108108109,22,15,7,315.6146718916605,0.8280065359477125,0.25560160669955434,0.18170058430801422,130664.61334019195,-1952.0661865569323,128712.54715363502,1778,17,689.4313725490196,44,7,16,36.33097868743586,0.6141098484848485,44.398148148148145,1022.4074074074067,23.236531986531972,0
1780,4,0,0,51,0.0,0.0,1.0,51,1100,600,500,0.5454545454545454,16,6,10,316.345536430093,0.8276470588235295,0.2576158552494945,0.18268003873200425,130782.9743227025,-1925.477966392306,128857.49635631019,1779,18,690.4313725490196,44,7,16,36.192895507075804,0.6152935606060606,44.28240740740741,1022.8703703703718,23.247053872053904,0
1781,4,0,0,51,0.0,0.0,1.0,51,1300,1000,300,0.7692307692307693,16,10,6,312.66253893004665,0.8272875816993465,0.25619874295506606,0.1812196666383751,130925.0782321677,-2012.9265260630696,128912.15170610463,1780,19,691.4313725490196,44,7,16,36.14384480834766,0.616714015151515,44.14351851851853,1023.4259259259287,23.2596801346802,0
1782,4,0,0,51,0.0,0.0,1.0,51,1600,1200,400,0.75,20,12,8,313.0214751855696,0.8272222222222223,0.24840029148470943,0.1820991317242096,131067.25930212664,-1994.6266289437212,129072.63267318292,1781,20,692.4313725490196,44,7,16,35.99142478222865,0.6181344696969695,44.00462962962965,1023.9814814814849,23.272306397306476,0
1783,4,0,0,51,0.0,0.0,1.0,51,1700,1300,400,0.7647058823529411,21,13,8,314.4048658636777,0.8269607843137255,0.2552689098422114,0.18312965883718527,131114.67013888923,-1955.38194444441,129159.28819444482,1782,21,693.4313725490196,44,7,17,35.90825874694875,0.6186079545454544,43.95833333333335,1024.1666666666695,23.276515151515216,0
1784,4,1,1,51,0.019230769230769232,0.019230769230769232,0.9807692307692307,52,1950,1600,350,0.8205128205128205,23,16,7,308.2691796733256,0.8297825540472599,0.2518754795260154,0.18101619726153864,131425.20732897168,-2296.7846074379986,129128.42272153369,1783,0,681.0769230769231,43,9,18,35.752986085457465,0.623062015503876,43.65530303030304,1025.3787878787891,23.84601832276254,0
1785,4,0,0,51,0.0,0.0,1.0,51,1150,700,450,0.6086956521739131,16,7,9,317.8916489782413,0.8270588235294118,0.2238469251336901,0.18048042006506596,130123.92354547358,-1874.3886303532022,128249.53491512037,1784,23,695.4313725490196,45,6,18,36.81899562026515,0.6074074074074074,44.927536231884055,1020.2898550724633,22.673107890499185,6
1786,4,1,1,51,0.019230769230769232,0.019230769230769232,0.9807692307692307,52,1600,1100,500,0.6875,21,11,10,314.0019743602392,0.8342288838612367,0.22247965523733826,0.17956224879045105,130404.40779320992,-2210.4040132208424,128194.00377998907,1785,0,683.0384615384615,44,8,18,36.63482458525972,0.6115056818181819,44.65277777777778,1021.3888888888891,23.213383838383844,0
1787,4,0,0,51,0.0,0.0,1.0,51,1550,1100,450,0.7096774193548387,20,11,9,320.1867701966645,0.8263398692810459,0.22361161121840722,0.1826589289026685,130310.9262009297,-1855.2330836776873,128455.69311725201,1786,25,697.4313725490196,43,8,18,36.571368948247084,0.6119186046511628,44.74431818181818,1021.0227272727268,23.744714587737832,0
1788,4,2,1,52,0.03773584905660377,0.018867924528301886,0.9811320754716981,53,1500,1200,300,0.8,18,12,6,315.3932016181668,0.8360849056603773,0.2424179986067363,0.1821324704840045,130783.4781009507,-2350.356024596347,128433.12207635435,1787,0,672.0754716981132,46,7,16,36.2167403362801,0.6127717391304348,44.28191489361702,1022.8723404255322,22.236355226642004,0
1789,4,2,1,53,0.037037037037037035,0.018518518518518517,0.9814814814814815,54,1300,1000,300,0.7692307692307693,16,10,6,311.43605910701143,0.837424295364547,0.2590473409749501,0.18125363538655212,131083.55581024534,-2635.1707929446493,128448.3850173007,1788,0,660.5925925925926,47,7,17,36.015600717696586,0.6145833333333334,43.98871527777777,1024.0451388888878,21.78819444444442,0
1790,4,0,0,53,0.0,0.0,1.0,53,1150,900,250,0.782608695652174,14,9,5,316.29576994580543,0.8330309627479439,0.2527095986705685,0.18362329087804,130987.5880630376,-2313.8359960515045,128673.7520669861,1789,1,674.0566037735849,46,7,18,35.987882855575755,0.6148097826086957,44.08244680851064,1023.6702127659577,22.253700277520817,0
1791,4,0,0,53,0.0,0.0,1.0,53,1250,700,550,0.56,18,7,11,316.2497554116376,0.8327285921625543,0.2519207651701252,0.18413897048967917,131101.0512549669,-2307.86492128164,128793.18633368527,1790,2,675.0566037735849,46,7,18,35.874740304709135,0.6159420289855073,43.97163120567375,1024.1134751773038,22.26333641689791,0
1792,4,0,1,52,0.0,0.018867924528301886,0.9811320754716981,53,1300,700,600,0.5384615384615384,19,7,12,318.0086761091287,0.8311865021770681,0.25911274878738855,0.18571128195013628,131214.56356728775,-2254.5260707459506,128960.0374965418,1791,3,676.0566037735849,46,7,19,35.71536730985549,0.6170742753623188,43.86081560283687,1024.5567375886515,22.272972556275032,0
1793,4,0,0,52,0.0,0.0,1.0,52,1200,1000,200,0.8333333333333334,14,10,4,321.7692929344372,0.826734539969834,0.26532605295906664,0.18813005852448927,131259.98224592555,-1952.9136644283715,129307.06858149718,1792,4,688.7884615384615,46,6,19,35.57329065374745,0.6175271739130436,43.81648936170212,1024.7340425531897,22.276827012025866,0
1794,4,0,0,52,0.0,0.0,1.0,52,1200,900,300,0.75,15,9,6,326.1947253618877,0.8264988687782805,0.26782363977485923,0.1910569105691055,131328.12499999988,-1832.1855666214128,129495.93943337847,1793,5,689.7884615384615,40,12,19,35.39126016260162,0.6265625000000001,43.74999999999999,1024.999999999999,25.62499999999998,0
1795,4,0,0,52,0.0,0.0,1.0,52,900,500,400,0.5555555555555556,13,5,8,345.86837490385517,0.8264517345399698,0.21446438720451266,0.18987255854136037,128801.62144204398,-1455.5962791495142,127346.02516289447,1794,6,690.7884615384615,44,8,16,37.44964121742832,0.595407196969697,46.226851851851855,1015.0925925925932,23.070286195286208,7
1796,4,0,0,52,0.0,0.0,1.0,52,1100,800,300,0.7272727272727273,14,8,6,347.4634345269543,0.826734539969834,0.21343940652085847,0.1910111641791384,128856.2845006958,-1445.4305654011746,127410.85393529462,1795,7,691.7884615384615,45,7,17,37.35344737859457,0.5946759259259259,46.17300724637681,1015.3079710144931,22.562399355877623,0
1797,4,1,0,53,0.018867924528301886,0.0,1.0,53,1150,900,250,0.782608695652174,14,9,5,347.5881445530843,0.8326378809869376,0.21603493840690602,0.19253360702636058,129156.32780669985,-1621.3583320758544,127534.969474624,1796,0,679.7169811320755,46,7,18,37.044668294668284,0.5964673913043477,45.87765957446808,1016.4893617021276,22.09759481961147,0
1798,4,1,0,54,0.018518518518518517,0.0,1.0,54,1200,700,500,0.5833333333333334,17,7,10,341.4044444444445,0.8366818075937573,0.21391887125220488,0.19027317763623505,129398.4924283397,-1964.51661979774,127433.97580854196,1797,0,668.1111111111111,42,12,19,36.95555555555556,0.6041666666666666,45.639534883720934,1017.4418604651167,24.2248062015504,0
1799,4,1,3,52,0.01818181818181818,0.05454545454545454,0.9454545454545454,55,1950,1500,450,0.7692307692307693,24,15,9,339.13821343528366,0.8400953984287318,0.22228648385151195,0.190676431396445,129743.23666838146,-2199.8221021947766,127543.41456618668,1798,0,656.9454545454546,44,11,13,36.66310703141568,0.6048768939393938,45.30092592592593,1018.7962962962972,23.1544612794613,0
1800,4,0,0,52,0.0,0.0,1.0,52,1300,800,500,0.6153846153846154,18,8,10,324.1918079435899,0.8325634741075917,0.20045281484493405,0.17045051852718796,127067.58838298466,-2078.4125620585473,124989.17582092612,1791,3,661.25,42,10,19,39.76934166266217,0.5806051587301587,47.94089147286821,1008.2364341085259,24.00562938353633,7
1801,4,5,4,53,0.08771929824561403,0.07017543859649122,0.9298245614035088,57,1450,1000,450,0.6896551724137931,19,10,9,292.08761056803263,0.8479793233082706,0.19864697228921813,0.1570228873958055,127965.07284750488,-3924.5951797966886,124040.4776677082,1792,0,604.1578947368421,46,11,15,39.664016180379114,0.5844655797101449,47.052304964539,1011.7907801418418,21.99545174221395,0
1802,4,0,0,53,0.0,0.0,1.0,53,900,600,300,0.6666666666666666,12,6,6,313.7605494047496,0.8378084179970972,0.20103817943810864,0.1665664129061078,127458.67816124336,-2601.6990227450233,124856.97913849833,1793,1,650.7547169811321,42,11,15,39.63251287464416,0.5845734126984127,47.55329457364341,1009.7868217054267,24.04254337393873,0
1803,4,1,1,53,0.018518518518518517,0.018518518518518517,0.9814814814814815,54,1250,700,550,0.56,18,7,11,314.99064122690504,0.842359655252737,0.22278184778184795,0.16861263736263732,127793.20987654316,-2749.2669753086443,125043.94290123452,1794,0,639.6851851851852,44,10,16,39.25995879120881,0.5852272727272728,47.22222222222222,1011.1111111111107,22.979797979797972,0
1804,4,1,2,52,0.018518518518518517,0.037037037037037035,0.962962962962963,54,1050,500,550,0.47619047619047616,16,5,11,329.01717884132444,0.8431312601910086,0.23795235497363088,0.1695021047825038,126236.59593576891,-2482.106446748554,123754.48948902036,1795,0,640.5555555555555,37,17,17,40.500431896708506,0.5802364864864864,48.76644736842106,1004.9342105263175,27.16038406827885,4
1805,4,4,1,55,0.07142857142857142,0.017857142857142856,0.9821428571428571,56,900,700,200,0.7777777777777778,11,7,4,320.46952306552,0.8630952380952381,0.27817460317460174,0.16805109136362695,126960.75439453173,-3062.589518229122,123898.1648763026,1796,0,610.5,39,17,18,39.97254521963823,0.5841346153846152,48.04687500000002,1007.812500000004,25.841346153846256,0
1806,4,1,0,56,0.017857142857142856,0.0,1.0,56,1450,900,550,0.6206896551724138,20,9,11,319.73353552330275,0.8653814935064935,0.2843585373411839,0.1683164957803752,127118.27392578151,-3071.2049696180256,124047.06895616348,1797,0,611.4821428571429,39,17,19,39.829842819267995,0.5857371794871793,47.890625000000014,1008.437500000002,25.85737179487185,0
1807,4,1,2,55,0.017543859649122806,0.03508771929824561,0.9649122807017544,57,1250,700,550,0.56,18,7,11,343.94236484222,0.8700918964076858,0.3033625730994154,0.17713031789374337,126222.48661511017,-2602.5339808764224,123619.95263423375,1798,0,601.7368421052631,40,17,18,40.13998449298814,0.575,48.78048780487806,1004.8780487804887,25.12195121951222,8
1808,4,5,4,56,0.08333333333333333,0.06666666666666667,0.9333333333333333,60,1450,1200,250,0.8275862068965517,17,12,5,326.1494561798894,0.8774835216572504,0.32103313123889987,0.17118915043270394,126998.6668381346,-3715.8907750342773,123282.77606310032,1799,0,572.5166666666667,44,16,16,39.79059495376324,0.5771780303030303,48.00925925925927,1007.9629629629643,22.908249158249188,0
1809,4,6,8,54,0.0967741935483871,0.12903225806451613,0.8709677419354839,62,2500,2100,400,0.84,29,21,8,317.8879457890292,0.8851467477525119,0.33871545895255983,0.1698090754935265,127709.26969288198,-4280.5182262697335,123428.75146661224,1800,0,554.9354838709677,45,17,14,39.27239223944797,0.5831018518518519,47.30525362318839,1010.778985507244,22.461755233494312,0
1810,4,0,0,54,0.0,0.0,1.0,54,1150,700,450,0.6086956521739131,16,7,9,351.55635263330635,0.8557098765432098,0.33688936256173463,0.1834372057852098,126758.03220414359,-1887.48170626723,124870.55049787636,1801,1,636.9074074074074,43,11,17,39.39760830042003,0.5760658914728682,48.248106060606055,1007.0075757575748,23.418780831571507,0
1811,4,2,1,55,0.03571428571428571,0.017857142857142856,0.9821428571428571,56,1150,600,550,0.5217391304347826,17,6,11,338.00489460682775,0.864258658008658,0.3220423193827451,0.17580655184181873,126628.33067611621,-2449.6985139527073,124178.6321621635,1802,0,615.125,42,14,17,39.87195532877634,0.576140873015873,48.376937984496124,1006.4922480620154,23.9641011443337,7
1812,4,1,0,56,0.017857142857142856,0.0,1.0,56,1800,1100,700,0.6111111111111112,25,11,14,339.0436654984289,0.8634334415584416,0.32041189239688905,0.17751138136216826,126896.67556787448,-2595.297195180585,124301.3783726939,1803,0,616.1071428571429,42,14,18,39.57030999551194,0.5788690476190477,48.110465116279066,1007.5581395348834,23.98947951273532,0
1813,4,1,1,56,0.017543859649122806,0.017543859649122806,0.9824561403508771,57,1400,1000,400,0.7142857142857143,18,10,8,334.2080479123784,0.866906850459482,0.32270700504229777,0.17616420946845696,127170.8021375866,-2899.097967804034,124271.70416978256,1804,0,606.280701754386,39,18,18,39.41110279183451,0.5862713675213677,47.83854166666666,1008.6458333333317,25.862713675213634,0
1814,4,7,5,58,0.1111111111111111,0.07936507936507936,0.9206349206349207,63,1300,900,400,0.6923076923076923,17,9,8,296.49302411649194,0.8891449052739375,0.3197706679155048,0.16075009572190763,128305.07742760154,-4991.68791679798,123313.38951080356,1805,0,549.4285714285714,45,18,17,39.206805990165385,0.5891203703703705,46.71648550724636,1013.1340579710119,22.514090177133596,0
1815,4,0,0,58,0.0,0.0,1.0,58,1650,1200,450,0.7272727272727273,21,12,9,324.4252128711539,0.8717105263157895,0.3267567701534946,0.1736981578404563,127801.37466385741,-3307.6023638903907,124493.77229996702,1806,1,597.7586206896551,42,16,17,39.01313687909276,0.5880456349206349,47.21414728682171,1011.1434108527137,24.0748431155408,0
1816,4,1,0,59,0.01694915254237288,0.0,1.0,59,1750,1300,450,0.7428571428571429,22,13,9,321.29300500059037,0.8756088057666082,0.33640959495974676,0.17329533417224718,128097.66053669399,-3568.6235425240175,124529.03699416998,1807,0,588.6101694915254,44,15,18,38.790054574834585,0.5883049242424243,46.92129629629629,1012.314814814814,23.007154882154865,0
1817,4,2,2,59,0.03278688524590164,0.03278688524590164,0.9672131147540983,61,1450,1300,150,0.896551724137931,16,13,3,308.98110878338275,0.8803506375227687,0.32348502242427,0.1686639997487273,128576.35750258272,-4254.44117894007,124321.91632364264,1808,0,570.2786885245902,43,18,13,38.61461251167135,0.5944767441860466,46.44886363636364,1014.204545454546,23.58615221987316,0
1818,4,4,4,59,0.06349206349206349,0.06349206349206349,0.9365079365079365,63,1350,800,550,0.5925925925925926,19,8,11,304.25497848968297,0.8862647209421404,0.3504562397295963,0.1643960831222932,128168.50254139418,-4788.318285841354,123380.18425555283,1809,0,553.1111111111111,43,20,16,39.14915131394371,0.5903585271317829,46.851325757575765,1012.5946969696979,23.54871388301623,2
1819,4,3,1,61,0.04838709677419355,0.016129032258064516,0.9838709677419355,62,1500,1000,500,0.6666666666666666,20,10,10,307.0598647681834,0.8864357482813326,0.35936853928423784,0.1663214417765073,128267.19867345724,-4522.8582642269,123744.34040923034,1810,0,561.1451612903226,42,20,19,38.97770390918947,0.5927579365079365,46.753875968992254,1012.9844961240319,24.118678479143618,0
1820,4,1,1,61,0.016129032258064516,0.016129032258064516,0.9838709677419355,62,1650,1200,450,0.7272727272727273,21,12,9,309.13616419546776,0.8846840296139609,0.36284134972362025,0.16821186509005903,128449.39986282612,-4458.329046639198,123991.07081618693,1811,0,562.0806451612904,44,18,14,38.739762209231515,0.5918560606060606,46.57407407407409,1013.7037037037063,23.038720538720597,0
1821,4,1,3,59,0.016129032258064516,0.04838709677419355,0.9516129032258065,62,1450,900,550,0.6206896551724138,20,9,11,289.1068927392599,0.8867993125330513,0.2771391622961419,0.15392370929635701,127575.63281250004,-5008.498349622769,122567.13446287728,1812,0,563.0645161290323,49,13,11,40.135744040254046,0.5771683673469388,47.4375,1010.2500000000003,20.617346938775515,6
1822,4,1,1,59,0.016666666666666666,0.016666666666666666,0.9833333333333333,60,1450,700,750,0.4827586206896552,22,7,15,297.49014003510433,0.8773187382297551,0.29546322022957505,0.15808905562402392,127499.617672324,-4414.02417684761,123085.5934954764,1813,0,582.6333333333333,48,12,12,40.00150851786365,0.5774739583333333,47.51275510204081,1009.9489795918365,21.040603741496593,0
1823,4,1,1,59,0.016666666666666666,0.016666666666666666,0.9833333333333333,60,1650,1200,450,0.7272727272727273,21,12,9,298.0802706893771,0.8748940677966102,0.30397346349126253,0.15890928024234488,127628.47023375674,-4391.294209010142,123237.1760247466,1814,0,583.4,48,12,13,39.85525540688378,0.5787760416666666,47.38520408163265,1010.4591836734692,21.051232993197274,0
1824,4,1,0,60,0.016666666666666666,0.0,1.0,60,1800,1100,700,0.6111111111111112,25,11,14,299.4879761680088,0.8754237288135593,0.3147173489278754,0.1609598724504557,127954.7578125,-4335.817708333332,123618.94010416667,1815,0,584.3166666666667,49,11,14,39.487326002800444,0.5809948979591837,47.0625,1011.75,20.647959183673468,0
1825,4,1,1,60,0.01639344262295082,0.01639344262295082,0.9836065573770492,61,1600,1000,600,0.625,22,10,12,289.0807512354689,0.8783925318761384,0.3061826351140875,0.1566809938818367,128292.23003472235,-4782.496527777768,123509.73350694458,1816,0,575.7213114754098,49,12,15,39.40759439006333,0.5843962585034014,46.72916666666667,1013.0833333333344,20.67517006802723,0
1826,4,0,2,58,0.0,0.03333333333333333,0.9666666666666667,60,1250,900,350,0.72,16,9,7,296.1907952243006,0.8765654425612053,0.3085550798847192,0.16046025209218234,128273.70919668878,-4401.301613332423,123872.40758335635,1817,2,586.3166666666667,48,12,16,39.24634153166008,0.5852864583333333,46.74744897959183,1013.0102040816319,21.104379251700664,0
1827,4,1,0,59,0.01694915254237288,0.0,1.0,59,1750,1200,550,0.6857142857142857,23,12,11,297.1981508553755,0.8778735632183907,0.3197335368197083,0.16236516571865503,128609.013888889,-4155.527777777765,124453.48611111124,1818,0,594.9661016949152,49,10,12,38.88021689122576,0.5875850340136054,46.41666666666667,1014.3333333333344,20.700680272108865,0
1828,4,0,1,58,0.0,0.01694915254237288,0.9830508474576272,59,1900,1400,500,0.7368421052631579,24,14,10,293.9786359030539,0.8779222676797194,0.3187475825683346,0.1614629279788552,128820.42013888912,-4225.909722222199,124594.51041666692,1819,1,595.9661016949152,49,10,14,38.74740053631041,0.5897108843537414,46.20833333333334,1015.1666666666686,20.71768707482997,0
1829,4,2,2,58,0.03333333333333333,0.03333333333333333,0.9666666666666667,60,2150,1500,650,0.6976744186046512,28,15,13,291.5989806882689,0.8811793785310734,0.31896619003818616,0.1619708411542503,129266.23545889447,-4460.09450055532,124806.14095833915,1820,0,585.35,48,12,16,38.35622404325892,0.5952690972222222,45.769557823129254,1016.9217687074832,21.1858701814059,0
1830,4,0,0,58,0.0,0.0,1.0,58,1250,1000,250,0.8,15,10,5,297.5960662340429,0.8791969147005445,0.31536472537017946,0.16440015697783536,129050.14349489793,-3919.0369897959235,125131.10650510201,1821,1,606.4310344827586,48,10,16,38.4226713532513,0.5930989583333333,45.982142857142854,1016.0714285714283,21.168154761904756,0
1831,4,4,1,61,0.06451612903225806,0.016129032258064516,0.9838709677419355,62,1550,1100,450,0.7096774193548387,20,11,9,294.9727128012917,0.8906883483165874,0.2894310839965555,0.1612200786072068,128626.47130493858,-4514.032539508396,124112.43876543018,1822,0,568.241935483871,45,17,15,38.918932493972676,0.5923611111111111,46.39945652173913,1014.4021739130436,22.54227053140097,8
1832,4,2,1,62,0.031746031746031744,0.015873015873015872,0.9841269841269842,63,1750,1100,650,0.6285714285714286,24,11,13,289.97515439265766,0.8914277180406213,0.3045397410038302,0.15992812531739087,128985.35115576831,-5119.490576842988,123865.86057892532,1823,0,560.1904761904761,48,15,17,38.681880964339534,0.5924479166666666,46.045918367346935,1015.8163265306113,21.162840136054403,0
1833,4,2,1,63,0.03125,0.015625,0.984375,64,1750,1300,450,0.7428571428571429,22,13,9,288.3227989606966,0.8918340773809523,0.31855707002514144,0.16018099006926664,129273.6054167385,-5344.409833380574,123929.19558335793,1824,0,552.40625,43,21,18,38.43205838532452,0.6015019379844961,45.76231060606061,1016.9507575757584,23.650017618040895,0
1834,4,1,0,64,0.015625,0.0,1.0,64,1650,1200,450,0.7272727272727273,21,12,9,305.53507642678204,0.8923507771164021,0.37145591002394784,0.16755704097476254,128760.50407503865,-4928.061310708085,123832.44276433057,1825,0,553.390625,47,17,13,38.51493898962256,0.5913120567375887,46.267361111111114,1014.9305555555561,21.594267139479918,2
1835,4,1,1,64,0.015384615384615385,0.015384615384615385,0.9846153846153847,65,2250,1700,550,0.7555555555555555,28,17,11,316.44719161515764,0.8934895833333333,0.4017654476670873,0.17548435171385976,129201.38888888861,-4819.902584876561,124381.48630401205,1826,0,545.8615384615384,44,21,14,37.79030054644809,0.5994318181818183,45.83333333333332,1016.6666666666645,23.106060606060556,0
1836,4,3,1,66,0.04477611940298507,0.014925373134328358,0.9850746268656716,67,1550,900,650,0.5806451612903226,22,9,13,305.99227834015704,0.8990275893260967,0.4079788498929906,0.17208583473303385,129753.55454433085,-5459.282844449291,124294.27169988156,1827,0,530.0746268656717,47,20,13,37.49689372639232,0.6012854609929079,45.2907986111111,1018.8368055555534,21.677378841607517,0
1837,4,1,3,64,0.014925373134328358,0.04477611940298507,0.9552238805970149,67,2100,1600,500,0.7619047619047619,26,16,10,310.64320985815425,0.8984245439469319,0.4161849854904316,0.17542635153035352,129915.59596840416,-5328.520451547979,124587.07551685617,1828,0,531.0597014925373,48,19,13,37.21449523174021,0.6017795138888891,45.13180272108843,1019.4727891156446,21.23901643990926,0
1838,4,0,1,63,0.0,0.015625,0.984375,64,2200,1700,500,0.7727272727272727,27,17,10,319.14316863872483,0.8941075562169312,0.4183922858158553,0.17990976620856358,129846.81855177473,-4512.054977945816,125334.76357382891,1829,2,556.59375,45,19,14,37.06748429908758,0.6046296296296296,45.199275362318836,1019.2028985507238,22.648953301127197,0
1839,4,0,1,62,0.0,0.015873015873015872,0.9841269841269842,63,1250,900,350,0.72,16,9,7,325.09929908220107,0.8920464243044889,0.4172211982497278,0.1831137607829432,129813.9960562416,-4159.512174211238,125654.48388203036,1830,3,565.952380952381,44,19,14,36.94897480162334,0.6055871212121211,45.23148148148149,1019.0740740740755,23.160774410774444,0
1840,4,0,1,61,0.0,0.016129032258064516,0.9838709677419355,62,1650,1300,350,0.7878787878787878,20,13,7,335.05991384911454,0.8887823902696985,0.42853118519317723,0.18902436649223647,129876.19447314064,-3696.738693755716,126179.45577938492,1831,4,575.6290322580645,43,19,14,36.632137990833655,0.6075581395348837,45.170454545454554,1019.318181818183,23.7050739957717,0
1841,4,0,2,59,0.0,0.03278688524590164,0.9672131147540983,61,1700,1200,500,0.7058823529411765,22,12,10,346.03024346853454,0.8874772313296904,0.4400353324411945,0.19566234562167575,129966.00193986228,-3205.566541223492,126760.43539863879,1832,5,585.9508196721312,42,19,15,36.261443187937545,0.6098710317460319,45.08236434108527,1019.6705426356581,24.277870062753763,0
1842,4,1,0,60,0.016666666666666666,0.0,1.0,60,1150,800,350,0.6956521739130435,15,8,7,358.34212114887015,0.8888300376647834,0.457641454404045,0.20364127393023596,130161.33334120651,-2671.5423437894037,127489.7909974171,1833,0,593.4166666666666,41,19,16,35.749238447080174,0.6133130081300815,44.890873015873,1020.4365079365052,24.88869531552452,0
1843,4,1,0,61,0.01639344262295082,0.0,1.0,61,1450,900,550,0.6206896551724138,20,9,11,356.6625166794572,0.8882969034608379,0.47418089833066546,0.20498923387211315,130599.97046235707,-2883.8984361288085,127716.07202622827,1834,0,584.672131147541,40,21,15,35.34727745741367,0.6192708333333334,44.46138211382114,1022.1544715447155,25.553861788617887,0
1844,4,0,0,61,0.0,0.0,1.0,61,1550,1100,450,0.7096774193548387,20,11,9,363.06315550758006,0.888683970856102,0.43463704012558413,0.20712487653402128,130312.05047961367,-2692.1404345648853,127619.91004504877,1835,1,585.672131147541,42,19,16,35.475783746164296,0.613343253968254,44.74321705426357,1021.0271317829462,24.310169804355862,6
1845,4,0,2,59,0.0,0.03278688524590164,0.9672131147540983,61,1650,1100,550,0.6666666666666666,22,11,11,367.48624315801993,0.8881830601092896,0.43847073766777744,0.21066029575318201,130498.99798525391,-2608.682698902595,127890.31528635131,1836,2,586.672131147541,44,17,13,35.173123395257505,0.6124526515151515,44.56018518518519,1021.7592592592604,23.22180134680137,0
1846,4,1,0,60,0.016666666666666666,0.0,1.0,60,1800,1400,400,0.7777777777777778,22,14,8,363.5504042169969,0.8908545197740113,0.4310774105930286,0.20968220441653962,130735.62349965716,-2494.2022462276927,128241.42125342946,1837,0,569.8333333333334,44,16,14,35.03376339218351,0.6148200757575757,44.32870370370371,1022.6851851851859,23.242845117845135,0
1847,4,0,1,59,0.0,0.016666666666666666,0.9833333333333333,60,1750,1300,450,0.7428571428571429,22,13,9,361.4641860938336,0.889289077212806,0.43622218201556007,0.20963405630016985,130948.76971879293,-2533.3419067215323,128415.4278120714,1838,1,570.8333333333334,44,16,15,34.8712381641638,0.6169507575757576,44.120370370370374,1023.518518518519,23.261784511784523,0
1848,4,1,2,58,0.016666666666666666,0.03333333333333333,0.9666666666666667,60,1750,1300,450,0.7428571428571429,22,13,9,360.9037159958686,0.890560263653484,0.42795161908129353,0.21100277721246805,131258.5010780953,-2525.6638409735506,128732.83723712174,1839,0,544.9166666666666,45,15,16,34.57222885176345,0.6187500000000001,43.81793478260869,1024.7282608695639,22.771739130434753,0
1849,4,0,2,56,0.0,0.034482758620689655,0.9655172413793104,58,1700,1200,500,0.7058823529411765,22,12,10,355.1825905064469,0.8832677959265981,0.37607728595997414,0.2007480814689192,129948.59931882736,-2368.903972250927,127579.69534657642,1840,1,564.0344827586207,43,15,12,36.04580740534348,0.6082848837209303,45.09943181818181,1019.6022727272717,23.71168076109934,6
1850,4,0,1,55,0.0,0.017857142857142856,0.9821428571428571,56,1750,1300,450,0.7428571428571429,22,13,9,363.4951569907176,0.8788961038961038,0.39738679270909705,0.20488971389219562,129842.52467550036,-1760.5742218015655,128081.9504536988,1841,7,585.1071428571429,42,14,12,35.94175857260569,0.6086309523809523,45.20348837209303,1019.1860465116287,24.266334440753063,0
1851,4,1,1,55,0.017857142857142856,0.017857142857142856,0.9821428571428571,56,1300,900,400,0.6923076923076923,17,9,8,357.5208482588156,0.881439393939394,0.3869312906220985,0.20244477054402993,130021.0243414258,-1902.9546171946513,128118.06972423114,1842,0,585.5178571428571,43,13,12,35.91264314453731,0.6090116279069766,45.0284090909091,1019.8863636363651,23.718287526427094,0
1852,4,1,0,56,0.017857142857142856,0.0,1.0,56,1900,1200,700,0.631578947368421,26,12,14,359.20682100388774,0.8787608225108225,0.40500895789788016,0.20493758833765224,130314.46358194517,-1837.3585974752916,128477.10498446987,1843,0,586.5,40,16,14,35.57177100958826,0.61640625,44.74085365853658,1021.0365853658528,25.52591463414632,0
1853,4,1,1,56,0.017543859649122806,0.017543859649122806,0.9824561403508771,57,1200,800,400,0.6666666666666666,16,8,8,355.09527232454434,0.8781589390142022,0.4032806643038802,0.20444759087020947,130667.99433893907,-2120.082593222495,128547.91174571657,1844,0,577.1929824561404,41,16,11,35.31842292515686,0.6183943089430894,44.39484126984126,1022.4206349206332,24.93708865660081,0
1854,4,1,0,57,0.017543859649122806,0.0,1.0,57,1650,1100,550,0.6666666666666666,22,11,11,353.42842491909556,0.8795164995822891,0.40516924584541303,0.20429113888821226,130820.18455530332,-2152.8856449987707,128667.29891030455,1845,0,578.1754385964912,41,16,12,35.206959529350904,0.619918699186992,44.24603174603173,1023.0158730158709,24.95160665892368,0
1855,4,1,0,58,0.017241379310344827,0.0,1.0,58,1600,900,700,0.5625,23,9,14,343.49686664720036,0.8834694494857834,0.3858767772511853,0.19759498054132837,130633.79322907265,-2624.556079542777,128009.23714952987,1846,0,569.1896551724138,42,16,17,35.64948657187993,0.6165674603174605,44.428294573643406,1022.2868217054253,24.340162421557743,3
1856,4,0,0,58,0.0,0.0,1.0,58,1500,1000,500,0.6666666666666666,20,10,10,347.56989576723083,0.8825872151643477,0.39018683195574266,0.20109537147431195,130856.77059859692,-2503.625176521839,128353.14542207509,1847,1,570.1896551724138,42,16,18,35.319790384190405,0.6187996031746031,44.21027131782946,1023.1589147286828,24.360926541159113,0
1857,4,2,1,59,0.03333333333333333,0.016666666666666666,0.9833333333333333,60,2400,1700,700,0.7083333333333334,31,17,14,332.5285256867188,0.8889124293785311,0.38761103761103755,0.1952728556502143,131427.46548434603,-3257.628936061518,128169.83654828451,1848,0,552.15,42,18,19,35.128835128835135,0.6245039682539681,43.653100775193806,1025.3875968992259,24.413990402362522,0
1858,4,0,1,58,0.0,0.01694915254237288,0.9830508474576272,59,1650,1100,550,0.6666666666666666,22,11,11,331.73699723016534,0.8849113578803818,0.36503674091307525,0.19599196095637125,131658.81406092533,-3061.2097308319903,128597.60433009334,1849,1,562.5084745762712,41,18,14,34.91612292572902,0.6283028455284553,43.42757936507937,1026.2896825396829,25.031455671699582,1
1859,4,0,0,58,0.0,0.0,1.0,58,1750,1000,750,0.5714285714285714,25,10,15,341.6219978433485,0.8820956846138335,0.3791737794469101,0.20201300809237832,131692.96136558938,-2602.157487276085,129090.8038783133,1850,2,572.8275862068965,40,18,14,34.62809405940594,0.6302083333333333,43.394308943089435,1026.422764227643,25.660569105691074,0
1860,4,0,0,58,0.0,0.0,1.0,58,1850,1400,450,0.7567567567567568,23,14,9,344.0716922041079,0.8801043557168784,0.3836121510983024,0.2045711726896102,131899.84568422884,-2523.399378793329,129376.44630543551,1851,3,573.8275862068965,42,16,15,34.35682168348898,0.6292162698412698,43.19282945736435,1027.2286821705436,24.457825765965325,0
1861,4,0,0,58,0.0,0.0,1.0,58,1500,1000,500,0.6666666666666666,20,10,10,346.71018255604946,0.8792599314377899,0.3807689430772674,0.2064103349602359,131949.6192104595,-2450.344687068049,129499.27452339145,1852,4,574.8275862068965,42,16,16,34.23893394951114,0.6297123015873014,43.14437984496126,1027.422480620158,24.46244001476567,0
1862,4,1,0,59,0.01694915254237288,0.0,1.0,59,1800,1400,400,0.7777777777777778,22,14,8,344.3891107298481,0.8794321059809078,0.37781133770999187,0.2069382355624487,132300.56244260806,-2687.425390266283,129613.13705234177,1853,0,566.0677966101695,43,16,17,33.9454467353952,0.631782945736434,42.80303030303031,1028.7878787878801,23.925299506694888,0
1863,4,1,3,57,0.016666666666666666,0.05,0.95,60,1200,800,400,0.6666666666666666,16,8,8,341.1096697692317,0.8791902071563088,0.3790729043295169,0.2062125998867454,132528.77338224597,-2958.4872950750328,129570.28608717094,1854,0,557.6166666666667,40,20,17,33.800500065798126,0.6385416666666668,42.58130081300813,1029.674796747967,25.741869918699177,0
1864,4,1,1,57,0.017241379310344827,0.017241379310344827,0.9827586206896551,58,2000,1500,500,0.75,25,15,10,345.37945339398965,0.8752646702964307,0.3363664283642447,0.2049359586932627,131823.38271077067,-2484.143759501621,129339.23895126906,1855,0,546.2241379310345,40,18,16,34.40025564901863,0.6315104166666667,43.267276422764226,1026.9308943089427,25.67327235772357,2
1865,4,0,1,56,0.0,0.017543859649122806,0.9824561403508771,57,1550,900,650,0.5806451612903226,22,9,13,349.9674037666777,0.8718410609857978,0.33650969903712546,0.20772598637782494,131835.77609592004,-2172.355143229176,129663.42095269087,1856,3,556.8070175438596,39,18,17,34.26997751631335,0.6332799145299146,43.25520833333333,1026.9791666666658,26.332799145299123,0
1866,4,1,1,56,0.017543859649122806,0.017543859649122806,0.9824561403508771,57,1350,1000,350,0.7407407407407407,17,10,7,345.9908280794391,0.8725981620718463,0.33893470753713806,0.2063812279221128,132023.05230034713,-2264.2469618055593,129758.80533854157,1857,0,557.561403508772,39,18,17,34.18347523481317,0.6351495726495726,43.072916666666664,1027.7083333333328,26.351495726495713,0
1867,4,0,0,56,0.0,0.0,1.0,56,1450,600,850,0.41379310344827586,23,6,17,354.8457663227702,0.8693722943722944,0.3444932931598925,0.21106688464868253,131916.02105034713,-1838.0316840277883,130077.98936631935,1858,5,568.5178571428571,39,17,17,34.06383086595012,0.6340811965811967,43.17708333333333,1027.2916666666658,26.340811965811945,0
1868,4,0,1,55,0.0,0.017857142857142856,0.9821428571428571,56,1750,1300,450,0.7428571428571429,22,13,9,354.55602147229763,0.8693722943722944,0.35340901066308916,0.21183308666227346,132084.41904826823,-1833.7347767532524,130250.68427151498,1859,6,569.5178571428571,40,16,17,33.90159004778384,0.6341145833333333,43.01321138211382,1027.9471544715448,25.69867886178862,0
1869,4,0,2,53,0.0,0.03636363636363636,0.9636363636363636,55,1850,1600,250,0.8648648648648649,21,16,5,331.81981389678947,0.8665263748597082,0.302228216886971,0.19756762770886538,131953.86860499662,-2235.7656446229516,129718.10296037367,1860,7,579.709090909091,40,15,18,34.61712825585227,0.6328125000000002,43.140243902439,1027.4390243902408,25.68597560975602,4
1870,4,0,0,53,0.0,0.0,1.0,53,1000,600,400,0.6,14,6,8,340.6958023574799,0.8618166424770198,0.31625843053708347,0.203024301553546,131985.9981097957,-1606.5848948060934,130379.41321498962,1861,8,600.3396226415094,38,15,19,34.356804949053846,0.6365131578947371,43.108974358974336,1027.564102564099,27.041160593792075,0
1871,4,1,1,53,0.018518518518518517,0.018518518518518517,0.9814814814814815,54,1150,800,350,0.6956521739130435,15,8,7,334.5694600224325,0.8657261821569998,0.3128457571495544,0.20084336885845083,132264.03130425318,-1949.6988932292002,130314.33241102398,1862,0,590.2037037037037,39,15,19,34.2347046413502,0.6375534188034191,42.83854166666665,1028.645833333331,26.375534188034127,0
1872,4,0,0,53,0.0,0.0,1.0,53,1750,1400,350,0.8,21,14,7,341.3332614589835,0.85836961780358,0.319202115861694,0.20506330004446777,132293.43401951523,-1568.770139302027,130724.66388021321,1863,10,602.3396226415094,40,13,19,34.031207810596335,0.6361979166666668,42.809959349593484,1028.760162601624,25.7190040650406,0
1873,4,0,0,53,0.0,0.0,1.0,53,1450,1100,350,0.7586206896551724,18,11,7,345.6867019620056,0.8580672472181906,0.3255671835612257,0.20825515947467182,132398.00347222236,-1446.1889211117534,130951.81455111061,1864,11,603.3396226415094,36,17,19,33.81410256410258,0.644386574074074,42.70833333333334,1029.1666666666679,28.587962962962997,0
1874,4,0,2,51,0.0,0.03773584905660377,0.9622641509433962,53,1250,900,350,0.72,16,9,7,347.0163136228451,0.8564042089985486,0.3247635061947449,0.21002410245406494,132571.90626014542,-1399.0771599301822,131172.82910021523,1865,12,604.3396226415094,36,17,19,33.605112083105524,0.6461226851851851,42.53941441441442,1029.8423423423435,28.606731731731763,0
1875,4,0,0,51,0.0,0.0,1.0,51,1400,900,500,0.6428571428571429,19,9,10,354.34266312654586,0.8477450980392157,0.3465175756854817,0.21499686738168922,132666.15125868042,-798.1445312500184,131868.0067274304,1866,13,625.3529411764706,35,16,18,33.321747556454326,0.6491071428571429,42.44791666666666,1030.2083333333321,29.434523809523775,0
1876,4,0,0,51,0.0,0.0,1.0,51,1800,1200,600,0.6666666666666666,24,12,12,356.5945500085577,0.847124183006536,0.34847199369258175,0.2169915772392502,132774.93709926156,-730.636210534845,132044.30088872672,1867,14,626.3529411764706,36,15,18,33.154410693473196,0.6481481481481481,42.34234234234235,1030.6306306306317,28.628628628628658,0
1877,4,0,0,51,0.0,0.0,1.0,51,1300,800,500,0.6153846153846154,18,8,10,360.3677308183205,0.8463071895424837,0.3565007870980177,0.21979790643848945,132861.99787202754,-624.1646629737716,132237.83320905376,1868,15,627.3529411764706,36,15,18,32.96968869470235,0.6490162037037037,42.25788288288289,1030.9684684684694,28.638013013013037,0
1878,4,1,1,51,0.019230769230769232,0.019230769230769232,0.9807692307692307,52,1450,1000,450,0.6896551724137931,19,10,9,345.9660812551403,0.8515271493212668,0.34535608158303477,0.20417376505160872,131616.85333982628,-1290.2103116630199,130326.64302816326,1869,0,616.2692307692307,36,16,18,34.59334760023412,0.6365740740740742,43.468468468468465,1026.1261261261259,28.503503503503495,3
1879,4,1,2,50,0.019230769230769232,0.038461538461538464,0.9615384615384616,52,1550,900,650,0.5806451612903226,22,9,13,343.70974198093467,0.8548108345902463,0.331091571877004,0.20345831220118188,131732.4334469605,-1344.4558578849092,130387.97758907558,1870,0,610.4807692307693,36,16,18,34.53474659938568,0.6377314814814814,43.35585585585586,1026.5765765765768,28.516016016016025,0
1880,4,0,0,50,0.0,0.0,1.0,50,1350,1000,350,0.7407407407407407,17,10,7,361.6814071854285,0.8487755102040816,0.3366836971667442,0.21217985549597482,131389.1439909297,-495.7979024943329,130893.34608843537,1871,2,634.6,34,16,19,34.420237265830615,0.6384803921568627,43.69047619047619,1025.2380952380952,30.15406162464986,0
1881,4,0,0,50,0.0,0.0,1.0,50,2550,2100,450,0.8235294117647058,30,21,9,361.0434125298123,0.8476700680272109,0.3314259927797829,0.21278516015054907,131565.5006858711,-499.8285322359372,131065.67215363517,1872,3,635.6,35,15,18,34.2584235860409,0.638095238095238,43.51851851851852,1025.9259259259263,29.312169312169324,0
1882,4,1,1,50,0.0196078431372549,0.0196078431372549,0.9803921568627451,51,1150,600,550,0.5217391304347826,17,6,11,353.0563795777804,0.8501960784313727,0.3265322356122973,0.20970698208656127,131862.521701389,-889.0190972222132,130973.50260416677,1873,0,624.1176470588235,37,14,18,34.16370858688303,0.6371058558558558,43.22916666666667,1027.0833333333342,27.75900900900903,0
1883,4,0,0,50,0.0,0.0,1.0,50,1800,1300,500,0.7222222222222222,23,13,10,340.9526305025165,0.847704081632653,0.25393289656541573,0.19808286041997397,131015.81090124912,-1065.9629271597719,129949.84797408935,1874,5,637.6,40,10,15,35.3283617894249,0.6234375000000001,44.05487804878048,1023.780487804877,25.594512195121926,7
1884,4,0,0,50,0.0,0.0,1.0,50,1200,700,500,0.5833333333333334,17,7,10,340.0058720063366,0.8470408163265306,0.25700674870980533,0.19780018281384795,131067.83743142305,-1087.2331284288514,129980.6043029942,1875,6,638.6,40,10,15,35.300052931057294,0.6239583333333334,44.0040650406504,1023.9837398373979,25.599593495934947,0
1885,4,0,0,50,0.0,0.0,1.0,50,1300,700,600,0.5384615384615384,19,7,12,331.4346126868978,0.8474319727891156,0.22078231638993562,0.19105658207558854,130714.91021050341,-1335.0526762163202,129379.85753428709,1876,7,639.6,39,11,14,35.87579793555396,0.6220619658119659,44.34895833333333,1022.6041666666661,26.22061965811964,1
1886,4,1,1,50,0.0196078431372549,0.0196078431372549,0.9803921568627451,51,1650,1300,350,0.7878787878787878,20,13,7,330.0204257799412,0.8504248366013073,0.2230124529462374,0.19173158992543976,131015.8109012491,-1552.4212604931054,129463.389640756,1877,0,628.0392156862745,40,11,15,35.608166236516425,0.6234375000000001,44.05487804878048,1023.7804878048769,25.594512195121922,0
1887,4,0,1,49,0.0,0.02,0.98,50,1050,600,450,0.5714285714285714,15,6,9,336.7622854936553,0.8469557823129251,0.22843390658390228,0.19547330062292673,130981.34901258671,-1178.0843098958399,129803.26470269087,1878,9,641.6,39,11,16,35.4704089074319,0.6247329059829061,44.088541666666664,1023.6458333333326,26.247329059829042,0
1888,4,0,1,48,0.0,0.02040816326530612,0.9795918367346939,49,1350,800,550,0.5925925925925926,19,8,11,341.62832116241236,0.8468324829931974,0.23102688299236696,0.19926292469224002,131168.01757812515,-837.8580729166518,130330.15950520849,1879,10,648.5714285714286,39,10,17,35.15736221273134,0.6266025641025641,43.90625000000001,1024.3750000000011,26.26602564102567,0
1889,4,0,0,48,0.0,0.0,1.0,48,1750,1400,350,0.8,21,14,7,322.6596334410117,0.8409796099290779,0.19814059182590205,0.18420931800086854,130340.40584308287,-1188.8824856236317,129151.52335745924,1880,27,662.875,40,8,17,36.47844513004247,0.6166666666666667,44.71544715447155,1021.1382113821143,25.528455284552855,3
1890,4,1,1,48,0.02040816326530612,0.02040816326530612,0.9795918367346939,49,1550,1200,350,0.7741935483870968,19,12,7,319.7020171372031,0.8432539682539683,0.20336847610331232,0.18358808141290214,130566.58340419491,-1451.5199829932087,129115.0634212017,1881,0,650.3265306122449,41,8,13,36.32547078237234,0.6173780487804879,44.49404761904761,1022.0238095238087,24.927409988385577,0
1891,4,0,0,48,0.0,0.0,1.0,48,1400,900,500,0.6428571428571429,19,9,10,324.68493489048143,0.840056146572104,0.20037215701876532,0.1861107374794128,130496.11363110579,-1125.9755684447105,129370.13806266108,1882,29,664.875,40,8,14,36.2693538226908,0.6182291666666667,44.5630081300813,1021.7479674796746,25.543699186991866,0
1892,4,1,1,48,0.02040816326530612,0.02040816326530612,0.9795918367346939,49,1450,1100,350,0.7586206896551724,18,11,7,320.91454155559893,0.8467261904761905,0.21025632906382086,0.18549723949110622,130820.18455530345,-1403.580089443198,129416.60446586025,1883,0,652.2857142857143,41,8,15,36.038514998707015,0.6199186991869918,44.24603174603174,1023.0158730158719,24.951606658923705,0
1893,4,1,0,49,0.02040816326530612,0.0,1.0,49,1400,1200,200,0.8571428571428571,16,12,4,314.5416441319632,0.8483560090702948,0.2092785951589935,0.1827741986172218,131023.24263038544,-1557.5467687074906,129465.69586167796,1884,0,650.4489795918367,41,8,15,35.99685077519378,0.6219512195121951,44.047619047619044,1023.8095238095234,24.97096399535423,1
1894,4,0,1,48,0.0,0.02040816326530612,0.9795918367346939,49,1600,1100,500,0.6875,21,11,10,313.7085635096463,0.8484977324263039,0.20925944874213065,0.18291302950140462,131154.36952594473,-1571.1502276005233,129583.21929834421,1885,1,651.4489795918367,42,7,15,35.88611137388452,0.6217757936507937,43.91957364341084,1024.3217054263548,24.38861203396083,0
1895,4,0,1,47,0.0,0.020833333333333332,0.9791666666666666,48,1600,1200,400,0.75,20,12,8,319.5554302228095,0.8411827718676123,0.20801244793180285,0.18605587739368648,131099.43000637754,-1221.293048469389,129878.13695790815,1886,2,665.9791666666666,41,7,15,35.79173931996514,0.6227134146341464,43.973214285714285,1024.1071428571427,24.978222996515676,0
1896,4,1,1,47,0.020833333333333332,0.020833333333333332,0.9791666666666666,48,1550,1200,350,0.7741935483870968,19,12,7,321.6651790471773,0.8455784574468085,0.2188646277386741,0.18853205468035314,131354.16795764753,-1149.3883105926745,130204.77964705485,1887,0,665.0416666666666,40,8,15,35.48110604408315,0.6268229166666668,43.72459349593496,1025.10162601626,25.6275406504065,0
1897,4,1,0,48,0.020833333333333332,0.0,1.0,48,1400,1000,400,0.7142857142857143,18,10,8,320.8637531189612,0.8420323581560284,0.22914603347529017,0.18934899563075122,131614.739542022,-1153.9201409544469,130460.81940106755,1888,0,666.0208333333334,40,8,14,35.23942755273846,0.6294270833333333,43.47052845528456,1026.1178861788624,25.65294715447156,0
1898,4,0,0,48,0.0,0.0,1.0,48,1350,1000,350,0.7407407407407407,17,10,7,321.9466246817924,0.8420508274231678,0.22092835974745495,0.19058945493176138,131735.18597253718,-1117.6603048626894,130617.52566767449,1889,1,667.0208333333334,41,7,14,35.09051668599405,0.6290650406504066,43.3531746031746,1026.5873015873017,25.038714672861015,0
1899,4,0,0,48,0.0,0.0,1.0,48,1300,900,400,0.6923076923076923,17,9,8,331.0690965923661,0.8411827718676123,0.22484550019312488,0.19704319335118073,131938.9526643991,-863.8180272108824,131075.13463718822,1890,2,668.0208333333334,41,7,14,34.65140981073773,0.6310975609756098,43.154761904761905,1027.3809523809525,25.058072009291525,0
1900,4,0,0,48,0.0,0.0,1.0,48,1250,900,350,0.72,16,9,7,332.7163781839088,0.8417737884160756,0.22083011614065584,0.19869016682210253,132066.38681224803,-811.8700199987396,131254.51679224928,1891,3,669.0208333333334,41,7,14,34.48096628382075,0.6323678861788617,43.03075396825397,1027.876984126984,25.070170344560587,0
1901,4,0,1,47,0.0,0.020833333333333332,0.9791666666666666,48,1100,900,200,0.8181818181818182,13,9,4,333.6250028796959,0.8419584810874704,0.22548842257597657,0.19977025735690604,132168.3784190759,-781.0648738662237,131387.31354520968,1892,4,670.0208333333334,41,7,14,34.355101302460206,0.6333841463414633,42.93154761904761,1028.2738095238087,25.079849012775824,0
1902,4,1,0,48,0.020833333333333332,0.0,1.0,48,1250,800,450,0.64,17,8,9,329.16908246435037,0.8427341903073285,0.21365466203837613,0.19790217705726254,132321.43964356577,-888.7746244331075,131432.66501913266,1893,0,670.8333333333334,41,7,15,34.315941085719786,0.634908536585366,42.782738095238095,1028.8690476190477,25.094367015098726,0
1903,4,0,0,48,0.0,0.0,1.0,48,1650,1200,450,0.7272727272727273,21,12,9,331.3672572022758,0.8406102245862884,0.2171526544306297,0.20060189871492612,132581.09941998814,-813.3708013928826,131767.72861859525,1894,1,671.8333333333334,40,8,17,33.99879119794751,0.6390625,42.53048780487805,1029.878048780488,25.746951219512198,0
1904,4,0,0,48,0.0,0.0,1.0,48,1950,1400,550,0.717948717948718,25,14,11,328.8137477094813,0.8402593085106382,0.21529695564980078,0.19975090401596363,132711.95969867482,-872.4966331218131,131839.46306555302,1895,2,672.8333333333334,40,8,13,33.933326758062925,0.6403645833333333,42.40345528455285,1030.3861788617892,25.759654471544728,0
1905,4,0,1,47,0.0,0.020833333333333332,0.9791666666666666,48,1450,1100,350,0.7586206896551724,18,11,7,340.17060819495447,0.8404070626477541,0.20377566454270468,0.20273228766877643,131989.9189421137,-620.1817995716989,131369.737142542,1896,3,673.8333333333334,41,7,13,34.366351290467904,0.6316056910569107,43.10515873015872,1027.5793650793637,25.062911343399115,1
1906,4,1,0,48,0.020833333333333332,0.0,1.0,48,1400,1000,400,0.7142857142857143,18,10,8,337.7861295868963,0.8403701241134751,0.20314862169899328,0.2019894784136758,132117.37769471196,-674.5164674666355,131442.86122724533,1897,0,674.75,41,7,14,34.29941056322171,0.6328760162601628,42.981150793650784,1028.0753968253953,25.075009678668177,0
1907,4,0,0,48,0.0,0.0,1.0,48,1400,900,500,0.6428571428571429,19,9,10,338.10016264082486,0.8400746158392435,0.20770226381117785,0.20258649051646163,132193.8824719701,-661.0453672209771,131532.83710474914,1898,1,675.75,41,7,14,34.214418933693494,0.633638211382114,42.906746031746025,1028.3730158730145,25.082268679829625,0
1908,4,0,1,47,0.0,0.020833333333333332,0.9791666666666666,48,700,400,300,0.5714285714285714,10,4,6,343.27351973069017,0.8404255319148936,0.21365466203837613,0.2063820100363471,132321.43964356577,-515.5107355442182,131805.92890802154,1899,2,676.75,41,7,15,33.95315061228425,0.634908536585366,42.782738095238095,1028.8690476190477,25.094367015098726,0
1909,4,0,1,46,0.0,0.02127659574468085,0.9787234042553191,47,1400,1100,300,0.7857142857142857,17,11,6,346.533279263401,0.8370721554116558,0.22136316906446707,0.20821413842328979,132298.2967989454,-225.86501212504626,132072.43178682035,1900,3,690.5744680851063,42,5,16,33.89257794103797,0.6331845238095237,42.80523255813954,1028.7790697674423,24.49473975636767,5
1910,4,1,0,47,0.02127659574468085,0.0,1.0,47,1150,900,250,0.782608695652174,14,9,5,346.2560243194321,0.8371492445266727,0.24887945322172378,0.20982113956402543,132618.0021938235,-215.8933300799003,132402.10886374358,1901,0,691.4893617021277,38,9,18,33.57838052760779,0.6428179824561404,42.49465811965812,1030.0213675213674,27.105825461088617,0
1911,4,0,0,47,0.0,0.0,1.0,47,1300,800,500,0.6153846153846154,18,8,10,329.2926050463628,0.8378045020043169,0.2193197114901655,0.19438175515278616,131626.2591265549,-717.3067620042118,130908.9523645507,1902,1,692.4893617021277,42,5,13,35.01160686181933,0.6264880952380951,43.4593023255814,1026.1627906976746,24.43244739756368,6
1912,4,0,0,47,0.0,0.0,1.0,47,700,500,200,0.7142857142857143,9,5,4,331.12600372167077,0.8375346901017576,0.22475814745773537,0.19571912005691625,131675.9810107567,-679.7317243554959,130996.24928640119,1903,2,693.4893617021277,42,5,13,34.914518819234644,0.6269841269841269,43.4108527131783,1026.3565891472879,24.437061646363997,0
1913,4,0,0,47,0.0,0.0,1.0,47,900,600,300,0.6666666666666666,12,6,6,334.9676771055646,0.8377659574468085,0.23394816904802562,0.1983780066480414,131750.5814422963,-573.5627553932889,131177.018686903,1904,3,694.4893617021277,42,5,14,34.74083687273872,0.6277281746031744,43.33817829457365,1026.6472868217068,24.443983019564445,0
1914,4,0,0,47,0.0,0.0,1.0,47,1200,800,400,0.6666666666666666,16,8,8,333.3770473440904,0.8365325316065371,0.23511080054295852,0.19756505557371276,131775.45294753936,-613.817716783833,131161.63523075552,1905,4,695.4893617021277,42,5,14,34.756629860324644,0.6279761904761904,43.3139534883721,1026.7441860465128,24.446290143964593,0
1915,4,0,0,47,0.0,0.0,1.0,47,700,400,300,0.5714285714285714,10,4,6,331.1618007805791,0.8363398088189947,0.23536355715450075,0.1965091133635263,131825.20300012027,-668.9056772429474,131156.2973228773,1906,5,696.4893617021277,42,5,14,34.763438070076106,0.6284722222222221,43.265503875968996,1026.9379844961247,24.450904392764876,0
1916,4,0,0,47,0.0,0.0,1.0,47,750,300,450,0.4,12,3,9,332.56600043857264,0.8355303731113166,0.2484202584174282,0.1979897418669396,131949.61921045952,-623.6085759569376,131326.0106345026,1907,6,697.4893617021277,42,5,15,34.602235216448165,0.6297123015873014,43.14437984496126,1027.4224806201582,24.462440014765672,0
1917,4,0,1,46,0.0,0.02127659574468085,0.9787234042553191,47,1200,800,400,0.6666666666666666,16,8,8,333.48082151590194,0.8335646006783841,0.24132999283893208,0.1990563350489125,132049.1944312993,-592.8252321074372,131456.36919919186,1908,7,698.4893617021277,42,5,15,34.47860689481788,0.630704365079365,43.04748062015504,1027.8100775193807,24.471668512366207,0
1918,4,0,0,46,0.0,0.0,1.0,46,1150,600,550,0.5217391304347826,17,6,11,342.65505146200496,0.8335950080515299,0.21640747708718067,0.19934135672812725,131067.83743142316,-217.32860045575893,130850.5088309674,1908,8,673.195652173913,40,6,14,35.23223501389441,0.6239583333333333,44.00406504065041,1023.9837398373988,25.599593495934972,3
1919,4,1,0,47,0.02127659574468085,0.0,1.0,47,1000,500,500,0.5,15,5,10,341.65262104135127,0.8378430465618254,0.23199060278415717,0.20051967967924333,131406.26161882802,-420.68306315685396,130985.57855567116,1909,0,659.8510638297872,40,7,15,34.91632801400865,0.6273437500000001,43.673780487804876,1025.3048780487802,25.632621951219505,0
1920,4,0,0,47,0.0,0.0,1.0,47,1400,800,600,0.5714285714285714,20,8,12,338.49764097642156,0.8360699969164354,0.22817101922752547,0.19958623734196954,131582.46429358752,-491.9292485513005,131090.5350450362,1910,1,660.8510638297872,41,6,13,34.81958679816927,0.6275406504065042,43.50198412698411,1025.992063492061,25.024196670538075,0
1921,4,1,1,47,0.020833333333333332,0.020833333333333332,0.9791666666666666,48,1100,700,400,0.6363636363636364,15,7,8,335.0722461659487,0.8407579787234042,0.22749166430750867,0.1986995295254924,131800.32680014693,-767.4736907337627,131032.85310941316,1911,0,648.0625,42,6,13,34.68807995973701,0.6282242063492065,43.28972868217053,1026.8410852713153,24.448597268364647,0
1922,4,0,0,47,0.0,0.0,1.0,47,1600,1300,300,0.8125,19,13,6,338.3776004349179,0.8363783533765031,0.22458941312592473,0.20000533168563878,131675.98101075634,-488.759502133302,131187.22150862304,1912,3,662.8510638297872,42,5,13,34.72845071752267,0.6269841269841271,43.410852713178286,1026.3565891472851,24.437061646363933,0
1923,4,2,1,48,0.04081632653061224,0.02040816326530612,0.9795918367346939,49,1000,700,300,0.7,13,7,6,328.11261056020805,0.8422264739229025,0.238247798443884,0.1961784768470643,132112.27816358005,-1130.4591049382946,130981.81905864175,1913,0,636.7551020408164,44,5,15,34.55316130775465,0.6285511363636365,42.9861111111111,1028.0555555555538,23.36489898989895,0
1924,4,0,0,48,0.0,0.0,1.0,48,700,300,400,0.42857142857142855,11,3,8,330.7791882052596,0.8387632978723404,0.23679717951078771,0.19837618791260728,132227.50521012658,-852.3786336375392,131375.12657648904,1914,1,644.4375,43,5,16,34.36886182978853,0.6310562015503878,42.87405303030302,1028.5037878787857,23.91869274136711,0
1925,4,0,0,48,0.0,0.0,1.0,48,1100,800,300,0.7272727272727273,14,8,6,330.2110641646668,0.8377844267139479,0.23687106918239054,0.1985469403513615,132324.91933719284,-860.9695140323802,131463.94982316045,1915,2,645.4375,43,5,16,34.28564580457125,0.6320251937984496,42.779356060606055,1028.8825757575748,23.927501761804066,0
1926,4,0,1,47,0.0,0.020833333333333332,0.9791666666666666,48,1150,700,450,0.6086956521739131,16,7,9,329.9331406582863,0.8370456560283688,0.2304165801674627,0.19890962935556528,132425.49332493255,-861.587332260621,131563.90599267193,1916,3,646.4375,38,10,16,34.191837935090994,0.6408991228070174,42.68162393162394,1029.2735042735053,27.08614484930277,0
1927,4,1,0,48,0.020833333333333332,0.0,1.0,48,900,600,300,0.6666666666666666,12,6,6,326.7641564983845,0.8407764479905437,0.23972031155168905,0.1976983140234414,132558.85959201405,-936.9032118055356,131621.95638020852,1917,0,646.8125,39,9,17,34.13960820014837,0.6404914529914529,42.55208333333334,1029.791666666668,26.404914529914567,0
1928,4,1,3,46,0.02040816326530612,0.061224489795918366,0.9387755102040817,49,1250,1000,250,0.8,15,10,5,318.7453663948284,0.8458049886621315,0.2430126785125135,0.19438977978726876,132857.851473923,-1330.435090702937,131527.41638322006,1918,0,634.5918367346939,41,8,15,34.046622401847586,0.6402439024390243,42.261904761904766,1030.9523809523816,25.14518002322882,0
1929,4,1,0,47,0.02127659574468085,0.0,1.0,47,1550,1100,450,0.7096774193548387,20,11,9,331.4584410133278,0.8341813135985199,0.2595520988376592,0.20139968664028532,132719.81336805588,-601.7795138888558,132118.03385416704,1919,0,660.9787234042553,39,8,16,33.85732578514626,0.642094017094017,42.39583333333335,1030.4166666666692,26.420940170940238,0
1930,4,0,0,47,0.0,0.0,1.0,47,1050,800,250,0.7619047619047619,13,8,5,333.2804991858508,0.8332176996608078,0.2583641923538438,0.20279687939390026,132773.48632812547,-549.8372395832882,132223.64908854218,1920,1,661.9787234042553,39,8,17,33.75656963816455,0.642628205128205,42.34375000000002,1030.6250000000036,26.426282051282143,0
1931,4,0,0,47,0.0,0.0,1.0,47,1750,1400,350,0.8,21,14,7,335.8627094756636,0.8327551649707061,0.26142274649305275,0.2047470748149723,132842.88452640662,-476.60577367964896,132366.27875272697,1921,2,662.9787234042553,40,7,17,33.62044886961094,0.6416666666666665,42.27642276422766,1030.8943089430925,25.77235772357731,0
1932,4,1,0,48,0.020833333333333332,0.0,1.0,48,1500,1000,500,0.6666666666666666,20,10,10,328.19578467201023,0.8384493203309692,0.17328909182675645,0.1908665303593355,131055.13232565628,-985.2556036385488,130069.87672201773,1922,0,650.1458333333334,42,6,15,35.61520141320463,0.6207837301587302,44.01647286821704,1023.93410852713,24.379383536360237,8
1933,4,0,1,47,0.0,0.020833333333333332,0.9791666666666666,48,1000,500,500,0.5,15,5,10,308.54749334364794,0.8383015661938534,0.08226042256178112,0.18357017533273584,131924.73127366134,-1445.3011387536874,130479.43013490766,1923,1,651.1458333333334,42,6,15,35.2441363264793,0.6294642857142858,43.16860465116279,1027.325581395348,24.46013289036543,5
1934,4,0,0,47,0.0,0.0,1.0,47,1950,1500,450,0.7692307692307693,24,15,9,312.827582909647,0.8343354918285537,0.0932446206569979,0.18636088141426377,131974.50949462163,-1142.9466378222598,130831.56285679937,1924,2,665.7872340425532,42,5,16,35.08424493901672,0.6299603174603176,43.120155038759684,1027.5193798449604,24.464747139165723,0
1935,4,0,0,47,0.0,0.0,1.0,47,1150,800,350,0.6956521739130435,15,8,7,314.99842280221685,0.8328707986432315,0.09359776825377097,0.18827145169063209,132098.99612590892,-1077.8049133165061,131021.19121259241,1925,3,666.7872340425532,42,5,16,34.90354101863199,0.6312003968253969,42.99903100775194,1028.0038759689924,24.476282761166484,0
1936,4,0,2,45,0.0,0.0425531914893617,0.9574468085106383,47,1200,900,300,0.75,15,9,6,312.51810124087916,0.8317530064754856,0.1004345107344995,0.18765227165006626,132273.37599903846,-1132.4351376119303,131140.94086142653,1926,4,667.7872340425532,42,5,16,34.79241239638282,0.6329365079365079,42.82945736434108,1028.682170542635,24.4924326319675,0
1937,4,0,0,45,0.0,0.0,1.0,45,1500,1100,400,0.7333333333333333,19,11,8,328.45387338428196,0.8225589225589226,0.1064232678704804,0.19637348600209203,132110.53688280794,-321.55648919293225,131788.980393615,1927,8,698.0888888888888,40,5,16,34.54613977856861,0.634375,42.987804878048784,1028.0487804878055,25.701219512195138,0
1938,4,1,1,45,0.021739130434782608,0.021739130434782608,0.9782608695652174,46,950,700,250,0.7368421052631579,12,7,5,323.9060606150448,0.8268317230273752,0.11356615628366296,0.1950015999280242,132372.47973552835,-624.7503110040377,131747.72942452432,1928,0,683.8913043478261,41,5,17,34.400105241170984,0.6354166666666666,42.73313492063492,1029.0674603174596,25.09920634920633,0
1939,4,1,1,45,0.021739130434782608,0.021739130434782608,0.9782608695652174,46,800,400,400,0.5,12,4,8,325.12161863689784,0.8286030595813205,0.11053300364035978,0.1960018900925299,132424.15229030346,-589.206591676558,131834.9456986269,1929,0,684.8695652173913,40,6,17,34.31699249605057,0.6375,42.6829268292683,1029.2682926829275,25.731707317073187,0
1940,4,0,0,45,0.0,0.0,1.0,45,1300,1200,100,0.9230769230769231,14,12,2,330.6662978213302,0.822516835016835,0.09540350142986731,0.18879978940121084,130344.39718934892,-371.6378701842848,129972.75931916463,1930,11,701.0888888888888,38,7,19,36.270009416195855,0.6200657894736843,44.71153846153845,1021.1538461538446,26.87246963562749,3
1941,4,1,1,45,0.021739130434782608,0.021739130434782608,0.9782608695652174,46,1550,1300,250,0.8387096774193549,18,13,5,322.516138173136,0.8277576489533012,0.109399701103154,0.18636322886629064,130807.80805902554,-762.4741803820629,130045.33387864348,1931,0,686.8260869565217,40,6,15,36.0100420557653,0.6213541666666667,44.258130081300806,1022.9674796747954,25.574186991869887,0
1942,4,2,0,47,0.0425531914893617,0.0,1.0,47,1450,800,650,0.5517241379310345,21,8,13,345.1587506909687,0.8315217391304347,0.1664392905866301,0.19313081240952687,129554.63927469145,-455.58372762758074,129099.05554706386,1932,0,672.9148936170212,41,6,14,36.701341518872205,0.6072154471544715,45.486111111111114,1018.0555555555563,24.830623306233083,8
1943,4,2,1,48,0.04081632653061224,0.02040816326530612,0.9795918367346939,49,1400,1100,300,0.7857142857142857,17,11,6,341.1035056588186,0.8408801020408163,0.18707388274162362,0.19350753377896018,130093.46954093497,-924.9322952536652,129168.5372456813,1933,0,646.4081632653061,43,6,16,36.25779340326126,0.6097383720930232,44.95738636363637,1020.170454545455,23.724894291754765,0
1944,4,1,0,49,0.02040816326530612,0.0,1.0,49,1200,800,400,0.6666666666666666,16,8,8,334.51903743399174,0.8422619047619048,0.2091441227653852,0.19112031719130856,130368.94531250001,-1077.3817722681342,129291.56354023187,1934,0,646.7142857142857,39,10,17,36.14681082551339,0.6185897435897436,44.6875,1021.2500000000001,26.185897435897438,0
1945,4,1,1,49,0.02,0.02,0.98,50,1250,1000,250,0.8,15,10,5,326.8330007448994,0.8433163265306122,0.20872465415956087,0.18849155682304167,130732.87080854492,-1454.4367075296198,129278.4341010153,1935,0,634.76,42,8,15,35.975301623397115,0.617559523809524,44.3313953488372,1022.6744186046492,24.349390919158314,0
1946,4,0,0,49,0.0,0.0,1.0,49,1450,1000,450,0.6896551724137931,19,10,9,330.8475382577057,0.8390376984126985,0.21020447767696226,0.19048685638457594,130667.99433893905,-1153.7631487780545,129514.231190161,1936,1,648.6938775510204,41,8,15,35.93820751665695,0.6183943089430896,44.39484126984126,1022.4206349206331,24.937088656600807,0
1947,4,1,1,49,0.02,0.02,0.98,50,1600,1000,600,0.625,22,10,12,327.33287458274657,0.8423639455782312,0.2152589226545487,0.1898746377933856,130955.9326832072,-1426.763622228225,129529.16906097897,1937,0,636.7,42,8,16,35.73736154501561,0.6197916666666666,44.11337209302326,1023.5465116279074,24.3701550387597,0
1948,4,0,0,49,0.0,0.0,1.0,49,1550,800,750,0.5161290322580645,23,8,15,333.27665375222915,0.8380810657596373,0.21428185056680782,0.19344695440871132,130980.72907277192,-1069.43618171986,129911.29289105206,1938,1,650.6122448979592,42,7,16,35.56023602170895,0.6200396825396826,44.0891472868217,1023.643410852712,24.37246216315981,0
1949,4,0,0,49,0.0,0.0,1.0,49,1150,900,250,0.782608695652174,14,9,5,331.4544257126341,0.8378684807256236,0.2124086576341364,0.19288603364158094,131079.93810468094,-1110.5948786130893,129969.34322606785,1939,2,651.6122448979592,42,7,16,35.50675782235679,0.6210317460317462,43.99224806201549,1024.031007751936,24.38169066076038,0
1950,4,0,0,49,0.0,0.0,1.0,49,850,600,250,0.7058823529411765,11,6,5,331.06235339739385,0.838045634920635,0.21011390647658446,0.19278225967256485,131104.74623107072,-1119.230834234736,129985.51539683598,1940,3,652.6122448979592,42,7,16,35.49176837922225,0.621279761904762,43.96802325581395,1024.1279069767431,24.383997785160552,0
1951,4,1,0,50,0.02,0.0,1.0,50,1800,1300,500,0.7222222222222222,23,13,10,326.8291585298235,0.8410374149659864,0.2100875364735304,0.19170248198363005,131382.8849806415,-1411.0977685097519,129971.78721213176,1941,0,640.54,38,12,17,35.31983812699735,0.6304824561403508,43.6965811965812,1025.213675213676,26.979307242465158,0
1952,4,1,1,50,0.0196078431372549,0.0196078431372549,0.9803921568627451,51,1250,900,350,0.72,16,9,7,323.25719817504944,0.8445424836601308,0.21409989231709337,0.19079728335664567,131621.90890842036,-1690.4541015624745,129931.45480685789,1942,0,628.9607843137255,39,12,14,35.17081599160831,0.6311431623931623,43.46354166666668,1026.145833333335,26.311431623931668,0
1953,4,0,0,50,0.0,0.0,1.0,50,1250,700,550,0.56,18,7,11,329.84063368385387,0.8413435374149659,0.21400541553842922,0.19430243954799803,131547.23340821112,-1322.0754346555539,130225.15797355557,1943,2,642.54,38,12,19,35.07711067138789,0.6321271929824561,43.53632478632479,1025.8547008547018,26.99617633828163,0
1954,4,0,0,50,0.0,0.0,1.0,50,1400,900,500,0.6428571428571429,19,9,10,328.2587776787476,0.8404761904761905,0.21263300364393545,0.19378768036904573,131629.44614517142,-1358.2957803710904,130271.15036480033,1944,3,643.54,38,12,14,35.03492104806525,0.6329495614035088,43.456196581196586,1026.1752136752145,27.004610886189855,0
1955,4,0,1,49,0.0,0.02,0.98,50,1000,500,500,0.5,15,5,10,329.95503080059916,0.8392006802721088,0.21808532778355905,0.1954912358812428,131766.52444480968,-1304.5944736649817,130461.9299711447,1945,4,644.54,38,12,14,34.85345126604231,0.6343201754385964,43.322649572649574,1026.7094017094016,27.018668466036885,0
1956,4,0,1,48,0.0,0.02040816326530612,0.9795918367346939,49,1450,1000,450,0.6896551724137931,19,10,9,333.059790477024,0.8342545351473923,0.20986702517410305,0.1971886338073768,131739.10307774495,-1024.6003862590328,130714.50269148592,1946,9,658.6122448979592,38,11,15,34.801358101779584,0.634046052631579,43.34935897435898,1026.6025641025647,27.01585695006749,0
1957,4,0,2,46,0.0,0.041666666666666664,0.9583333333333334,48,1550,1100,450,0.7096774193548387,20,11,9,336.39744300194076,0.835014036643026,0.2084655327854643,0.19973987767619855,131848.80566741532,-729.2797821243441,131119.52588529096,1947,10,668.1041666666666,38,10,15,34.60526543916224,0.6351425438596492,43.24252136752136,1027.0299145299136,27.027103013945094,0
1958,4,1,1,46,0.02127659574468085,0.02127659574468085,0.9787234042553191,47,1400,800,600,0.5714285714285714,20,8,12,340.30215319404255,0.8342198581560283,0.203259806725536,0.20170525099420802,131782.2930230036,-430.84038628471285,131351.4526367189,1948,0,682.2765957446809,39,8,15,34.571983531162275,0.6327457264957265,43.30729166666667,1026.7708333333346,26.3274572649573,0
1959,4,0,0,46,0.0,0.0,1.0,46,1100,600,500,0.5454545454545454,16,6,10,348.40095677304544,0.8272544283413849,0.20990363299099624,0.20642004898822258,131766.52444480988,-18.48336255385766,131748.04108225604,1949,14,698.1086956521739,38,8,15,34.37998612556364,0.6343201754385963,43.32264957264958,1026.7094017094032,27.018668466036928,0
1960,4,0,0,46,0.0,0.0,1.0,46,1150,700,450,0.6086956521739131,16,7,9,345.56817761027565,0.8261674718196458,0.2132022224182022,0.2052591705564653,131862.52170138914,-86.5017361110871,131776.01996527804,1950,15,699.1086956521739,39,7,15,34.35598377281947,0.6335470085470085,43.22916666666668,1027.0833333333353,26.335470085470135,0
1961,4,1,0,47,0.02127659574468085,0.0,1.0,47,1500,900,600,0.6,21,9,12,341.76665601078537,0.8285923527597903,0.22215633955924452,0.20475647082138196,132188.9058781977,-364.44793525677136,131824.45794294094,1951,0,685.2127659574468,40,7,17,34.125160588991015,0.6351562499999999,42.91158536585367,1028.3536585365869,25.70884146341467,0
1962,4,1,1,47,0.020833333333333332,0.020833333333333332,0.9791666666666666,48,950,700,250,0.7368421052631579,12,7,5,334.30120437135463,0.8334626182033097,0.22178099285039732,0.2019702386312028,132505.23003472263,-740.3379116679502,131764.89212305468,1952,0,671.9166666666666,39,9,18,33.99939295831647,0.6399572649572648,42.604166666666686,1029.5833333333364,26.39957264957273,0
1963,4,0,0,47,0.0,0.0,1.0,47,1150,700,450,0.6086956521739131,16,7,9,340.0934661162378,0.8265880357693494,0.2222624658236123,0.2050350721253966,132425.49332493255,-392.59099459418405,132032.90233033837,1953,2,687.2127659574468,38,9,18,33.93039409037438,0.6408991228070174,42.68162393162394,1029.2735042735053,27.08614484930277,0
1964,4,0,0,47,0.0,0.0,1.0,47,700,500,200,0.7142857142857143,9,5,4,341.33751234861757,0.8264724020968238,0.2254047322540469,0.20608573113980477,132480.48159105875,-355.8883957922203,132124.59319526653,1954,3,688.2127659574468,38,9,18,33.8431403071814,0.6414473684210525,42.62820512820514,1029.4871794871813,27.091767881241612,0
1965,4,0,0,47,0.0,0.0,1.0,47,750,600,150,0.8,9,6,3,339.5420876501695,0.8259713228492136,0.22588839043543407,0.20513655222092175,132505.23003472242,-401.77951388886527,132103.45052083355,1955,4,689.2127659574468,39,8,18,33.86449480642116,0.6399572649572649,42.60416666666668,1029.583333333335,26.399572649572693,0
1966,4,0,0,47,0.0,0.0,1.0,47,1350,1100,250,0.8148148148148148,16,11,5,338.14914772295833,0.8247764415664508,0.22575266307072317,0.20502494922331937,132639.32427300367,-429.6251085069248,132209.69916449673,1956,5,690.2127659574468,39,8,14,33.765737182728294,0.641292735042735,42.47395833333334,1030.1041666666683,26.412927350427392,0
1967,4,0,0,47,0.0,0.0,1.0,47,950,600,350,0.631578947368421,13,6,7,343.00274151966005,0.8250847980265186,0.2232161095760805,0.20886228475920232,132800.32687717024,-289.82476128471694,132510.50211588552,1957,6,691.2127659574468,39,8,14,33.47913508505979,0.6428952991452992,42.317708333333336,1030.7291666666674,26.42895299145301,0
1968,4,0,0,47,0.0,0.0,1.0,47,700,400,300,0.5714285714285714,10,4,6,344.54047093953835,0.8252389762565525,0.22204263056874463,0.21040136470268278,132907.71620008672,-241.58257378472695,132666.133626302,1958,7,692.2127659574468,39,8,14,33.33175489106645,0.6439636752136753,42.213541666666664,1031.1458333333328,26.43963675213674,0
1969,4,0,0,47,0.0,0.0,1.0,47,1300,700,600,0.5384615384615384,19,7,12,350.9249161726727,0.8246993524514338,0.22211151100765392,0.21569256013888558,133149.50086805536,-54.904513888906905,133094.59635416645,1959,8,693.2127659574468,39,8,16,32.92457273583637,0.6463675213675215,41.97916666666666,1032.0833333333317,26.46367521367517,0
1970,4,1,2,46,0.020833333333333332,0.041666666666666664,0.9583333333333334,48,1000,700,300,0.7,13,7,6,347.4888617800551,0.8289561170212766,0.23077892462794103,0.21529425909811242,133446.5951455812,-325.75890888764474,133120.83623669355,1960,0,679.75,41,7,18,32.71553448551767,0.6460873983739839,41.691468253968246,1033.2341269841256,25.20083236546648,0
1971,4,0,0,46,0.0,0.0,1.0,46,950,600,350,0.631578947368421,13,6,7,322.5235736909895,0.8230072463768117,0.15704234984356025,0.20053238334870052,133577.2564280519,-583.6347181224852,132993.6217099294,1961,1,709.5,40,6,18,33.229903984794866,0.6489583333333334,41.565040650406495,1033.7398373983724,25.84349593495931,7
1972,4,0,1,45,0.0,0.021739130434782608,0.9782608695652174,46,1100,700,400,0.6363636363636364,15,7,8,319.43606592977113,0.8215177133655395,0.15514280588139817,0.1994613668118532,133734.88519565063,-656.0508791063645,133078.83431654426,1962,2,710.5,40,6,15,33.15238750245628,0.6505208333333334,41.412601626016254,1034.349593495934,25.85873983739835,0
1973,4,0,0,45,0.0,0.0,1.0,45,1400,1000,400,0.7142857142857143,18,10,8,324.0564506919313,0.8164983164983165,0.1627362132044443,0.20253018324868288,133768.39328342027,-330.29785156248175,133438.0954318578,1963,28,727.2444444444444,39,6,15,32.99946715671467,0.6525106837606838,41.38020833333334,1034.4791666666679,26.52510683760687,0
1974,4,0,0,45,0.0,0.0,1.0,45,1150,700,450,0.6086956521739131,16,7,9,326.0298373967703,0.8150673400673402,0.17081013394154887,0.20480938837225698,133957.03667534728,-265.20182291665833,133691.83485243062,1964,29,728.2444444444444,39,6,16,32.76019655195546,0.6543803418803419,41.19791666666667,1035.208333333334,26.543803418803435,0
1975,4,0,0,45,0.0,0.0,1.0,45,1250,1100,150,0.88,14,11,3,323.5560813928876,0.8135942760942761,0.17534638419594173,0.2041523904423146,134118.83680555565,-321.006944444435,133797.8298611112,1965,30,729.2444444444444,39,6,16,32.66291230893,0.655982905982906,41.04166666666667,1035.8333333333342,26.55982905982908,0
1976,4,0,0,45,0.0,0.0,1.0,45,1450,1300,150,0.896551724137931,16,13,3,323.9882748831199,0.8126262626262627,0.17234006903253962,0.2048767558971641,134199.77349175335,-304.1693793402825,133895.60411241307,1966,31,730.2444444444444,39,6,16,32.5710641399417,0.656784188034188,40.963541666666664,1036.1458333333326,26.56784188034186,0
1977,4,0,0,45,0.0,0.0,1.0,45,1200,900,300,0.75,15,9,6,326.96556460300064,0.8106902356902357,0.1632487218985108,0.20782983589133258,134388.720703125,-211.9032118055554,134176.81749131944,1967,32,731.2444444444444,39,6,16,32.3056895050566,0.6586538461538461,40.78125,1036.875,26.58653846153846,0
1978,4,0,0,45,0.0,0.0,1.0,45,1400,1000,400,0.7142857142857143,18,10,8,326.544816205569,0.8106060606060607,0.16591461917832695,0.20817754672055405,134496.7502170138,-216.1566840277877,134280.593532986,1968,33,732.2444444444444,39,6,16,32.209027917252456,0.6597222222222223,40.67708333333333,1037.2916666666658,26.5972222222222,0
1979,4,0,0,45,0.0,0.0,1.0,45,1050,600,450,0.5714285714285714,15,6,9,329.11013714315374,0.810395622895623,0.1589667913563726,0.21044415813505257,134606.2089656839,-139.93557070232072,134466.27339498157,1969,34,733.2444444444444,38,7,16,32.03352894745873,0.6625548245614037,40.571581196581185,1037.7136752136735,27.308254610886145,0
1980,4,0,0,45,0.0,0.0,1.0,45,1550,1100,450,0.7096774193548387,20,11,9,324.22699152607316,0.8090067340067341,0.15575840661606533,0.20839580132323793,134794.05517578113,-259.22580295140233,134534.82937282973,1970,35,734.2444444444444,39,6,15,31.973388337178587,0.6626602564102565,40.39062499999999,1038.437499999999,26.62660256410254,0
1981,4,0,0,45,0.0,0.0,1.0,45,1150,800,350,0.6956521739130435,15,8,7,322.4996859561871,0.8084175084175085,0.15245545415036932,0.2075948591781238,134848.14588758667,-302.30305989585264,134545.84282769082,1971,36,735.2444444444444,39,6,15,31.9644677899241,0.6631944444444446,40.33854166666666,1038.6458333333321,26.631944444444414,0
1982,4,1,0,46,0.021739130434782608,0.0,1.0,46,1500,1100,400,0.7333333333333333,19,11,8,320.12532611557754,0.8136272141706925,0.15541904433117382,0.2041061117371804,134500.51947186174,-588.5954682711312,133911.9240035906,1972,0,720.2391304347826,42,4,16,32.37174996107739,0.6550099206349207,40.673449612403104,1037.306201550388,24.69776670358067,1
1983,4,0,0,46,0.0,0.0,1.0,46,1250,800,450,0.64,17,8,9,320.54955628184234,0.8133454106280193,0.16376101860920644,0.20480669396981288,134577.1417889484,-572.252603855264,134004.8891850931,1973,1,721.2391304347826,40,6,17,32.28452497551421,0.6588541666666666,40.59959349593496,1037.6016260162603,25.94004065040651,0
1984,4,0,0,46,0.0,0.0,1.0,46,1000,800,200,0.8,12,8,4,320.71359624833866,0.8135064412238325,0.16290192806269932,0.2053572387764443,134656.2388975644,-562.7826731773271,134093.45622438708,1974,2,722.2391304347826,40,6,18,32.201605796533826,0.6596354166666666,40.523373983739845,1037.9065040650416,25.947662601626043,0
1985,4,0,0,46,0.0,0.0,1.0,46,950,400,550,0.42105263157894735,15,4,11,313.90325458651597,0.812157809983897,0.15993745360736922,0.2020858249797517,134852.54909748514,-733.8691898022921,134118.67990768285,1975,3,723.2391304347826,42,4,12,32.183311565133565,0.6584821428571428,40.3343023255814,1038.6627906976746,24.73006644518273,0
1986,4,0,0,46,0.0,0.0,1.0,46,900,400,500,0.4444444444444444,14,4,10,315.43946047758186,0.8105273752012883,0.1606035786545783,0.20363981545461232,134953.21349565836,-686.0862290427203,134267.12726661563,1976,4,724.2391304347826,42,4,13,32.04346575896049,0.6594742063492063,40.2374031007752,1039.0503875968996,24.739294942783324,0
1987,4,0,0,46,0.0,0.0,1.0,46,1100,800,300,0.7272727272727273,14,8,6,317.4740399312712,0.8099235104669887,0.15949055120025268,0.20538157734033882,135028.7364416202,-626.3763070127897,134402.3601346074,1977,5,725.2391304347826,42,4,13,31.91563335197961,0.660218253968254,40.16472868217055,1039.3410852713187,24.746216315983776,0
1988,4,0,2,44,0.0,0.043478260869565216,0.9565217391304348,46,1300,800,500,0.6153846153846154,18,8,10,317.7981170770696,0.8092391304347827,0.16092466252896642,0.2064533530551523,135179.8457123973,-608.019913166256,134571.82579923104,1978,6,726.2391304347826,42,4,13,31.757244688781217,0.6617063492063491,40.01937984496125,1039.9224806201566,24.76005906238468,0
1989,4,0,0,44,0.0,0.0,1.0,44,850,500,350,0.5882352941176471,12,5,7,381.1163222705257,0.802677942212826,0.14743990583561684,0.23058237221336705,132558.85959201393,1456.8942049662785,134015.75379698022,1979,44,752.5,39,5,16,32.74032301571246,0.6404914529914529,42.552083333333336,1029.791666666667,26.40491452991454,8
1990,4,1,0,45,0.022222222222222223,0.0,1.0,45,900,600,300,0.6666666666666666,12,6,6,376.16690702648197,0.8044612794612795,0.15616219353284544,0.22979925379877875,132921.47040658674,1000.1316800515622,133921.6020866383,1980,0,736.7555555555556,40,5,16,32.50262803455866,0.6424479166666668,42.20020325203252,1031.1991869918702,25.779979674796756,0
1991,4,0,0,45,0.0,0.0,1.0,45,1800,1400,400,0.7777777777777778,22,14,8,377.38669116080814,0.8041666666666667,0.15809135899794158,0.23070603264457118,132947.6708639037,1034.5363209729596,133982.20718487666,1981,1,737.7555555555556,40,5,16,32.44481671265274,0.6427083333333334,42.17479674796748,1031.3008130081298,25.782520325203244,0
1992,4,0,0,45,0.0,0.0,1.0,45,1550,1200,350,0.7741935483870968,19,12,7,377.67605628924343,0.8029882154882155,0.1606321747023336,0.2323902640857226,133190.45970529385,1060.5695113693312,134251.02921666318,1982,2,738.7555555555556,41,4,16,32.193156335095296,0.6435467479674798,41.93948412698411,1032.242063492061,25.17663569492832,0
1993,4,1,0,46,0.021739130434782608,0.0,1.0,46,1050,800,250,0.7619047619047619,13,8,5,372.21832491655397,0.8068438003220613,0.16399394253377442,0.23047116486036293,133423.29993830313,732.5194415748031,134155.81937987794,1983,0,723.6739130434783,43,3,17,32.100137488542615,0.6429263565891474,41.714015151515135,1033.1439393939365,24.026603241719453,0
1994,4,0,1,45,0.0,0.021739130434782608,0.9782608695652174,46,800,600,200,0.75,10,6,4,374.19223381575875,0.8067834138486313,0.16808903240687356,0.2321765506065522,133500.5497484804,791.0275902995702,134291.57733877999,1984,1,724.6739130434783,37,9,17,31.97159593280284,0.6534346846846846,41.63925438596492,1033.4429824561412,27.930891417733545,0
1995,4,0,0,45,0.0,0.0,1.0,45,950,400,550,0.42105263157894735,15,4,11,365.9677873779111,0.8032407407407408,0.15119375573921,0.2282582591377695,133693.11125721398,785.474422894313,134478.58568010828,1985,2,719.6888888888889,38,7,18,31.991003787878785,0.6535087719298245,41.45299145299146,1034.1880341880355,27.215474583895674,0
1996,4,0,0,45,0.0,0.0,1.0,45,1350,1000,350,0.7407407407407407,17,10,7,366.01954866897887,0.8029040404040404,0.14896346010439987,0.22914669223394066,133831.2596450618,796.971450617295,134628.2310956791,1986,3,720.6888888888889,38,7,17,31.851230425055927,0.6548793859649122,41.31944444444445,1034.7222222222229,27.229532163742707,0
1997,4,0,0,45,0.0,0.0,1.0,45,1100,800,300,0.7272727272727273,14,8,6,360.8190997467399,0.8015993265993266,0.1470106112956071,0.2264977507380516,133930.07948133693,664.906141493075,134594.98562283,1987,4,721.6888888888889,39,6,17,31.886824494314183,0.6541132478632478,41.22395833333334,1035.1041666666679,26.54113247863251,0
1998,4,0,0,45,0.0,0.0,1.0,45,1350,800,550,0.5925925925925926,19,8,11,363.1346800591093,0.7998737373737375,0.15470295140592483,0.22886243194077843,134076.7330643964,737.5823129420544,134814.31537733844,1988,5,722.6888888888889,40,5,17,31.680118078042725,0.6539062499999999,41.08231707317074,1035.6707317073187,25.89176829268297,0
1999,4,0,0,45,0.0,0.0,1.0,45,1300,1100,200,0.8461538461538461,15,11,4,366.3235757210637,0.8006313131313132,0.14958690297124666,0.23136942570635258,134155.6830011901,828.8779000595201,134984.5609012496,1989,6,723.6888888888889,40,5,17,31.518540317834027,0.6546874999999999,41.006097560975626,1035.9756097561,25.899390243902502,0
2000,4,0,0,45,0.0,0.0,1.0,45,900,700,200,0.7777777777777778,11,7,4,365.5365781676138,0.7996632996632997,0.1477630646831234,0.23103815340476344,134182.00481071172,809.6861780356107,134991.69098874732,1990,7,724.6888888888889,40,5,17,31.51258786987086,0.6549479166666664,40.980691056910594,1036.0772357723617,25.901930894309043,0
2001,4,0,0,45,0.0,0.0,1.0,45,1100,800,300,0.7272727272727273,14,8,6,363.4816487282876,0.7993686868686869,0.14749002712621717,0.2299555312517852,134216.47775140184,757.0453239166425,134973.5230753185,1991,8,725.6888888888889,41,4,17,31.531334769427183,0.6537093495934958,40.947420634920654,1036.2103174603203,25.273422377080983,0
2002,4,0,0,45,0.0,0.0,1.0,45,1450,1000,450,0.6896551724137931,19,10,9,363.6463693256467,0.799452861952862,0.14824093982736608,0.23058240739042407,134299.5662539065,767.5099340484818,135067.07618795498,1992,9,726.6888888888889,42,3,17,31.44397962045436,0.6530257936507934,40.86724806201553,1036.5310077519416,24.679309708379563,0
2003,4,0,0,45,0.0,0.0,1.0,45,1100,700,400,0.6363636363636364,15,7,8,360.1268233033444,0.7990740740740742,0.1517673935617858,0.22882167513929919,134374.90610540283,678.4016134848187,135053.30771888763,1993,10,727.6888888888889,42,3,17,31.459890965732097,0.6537698412698411,40.79457364341088,1036.8217054263607,24.68623108158002,0
2004,4,0,0,45,0.0,0.0,1.0,45,1200,900,300,0.75,15,9,6,358.69953765552987,0.7977693602693603,0.1572077962513232,0.2288580006042973,134525.64918724867,650.8576332552454,135176.5068205039,1994,11,728.6888888888889,42,3,18,31.346324490939676,0.6552579365079363,40.649224806201566,1037.4031007751962,24.700073827980862,0
2005,4,0,0,45,0.0,0.0,1.0,45,800,700,100,0.875,9,7,2,346.9320672023381,0.7977693602693603,0.18474474474474523,0.20704010462074973,132040.8950617281,166.39098169511792,132207.28604342323,1995,12,729.6888888888889,41,4,15,34.14132882882882,0.6321138211382115,43.05555555555554,1027.7777777777756,25.06775067750672,4
2006,4,1,0,46,0.021739130434782608,0.0,1.0,46,1000,600,400,0.6,14,6,8,342.8071708267108,0.8052334943639292,0.1942804261835933,0.20611135559671634,132323.219946217,-127.73026711136566,132195.48967910564,1996,0,714.804347826087,42,4,17,33.96335625039242,0.6334325396825398,42.78100775193798,1028.8759689922467,24.49704688076778,0
2007,4,0,0,46,0.0,0.0,1.0,46,1750,1100,650,0.6285714285714286,24,11,13,342.6479779283478,0.8047302737520129,0.1955844929341055,0.20687693704997234,132480.48159105846,-121.08166843211563,132359.39992262635,1997,1,715.804347826087,38,8,17,33.809412619344116,0.6414473684210527,42.628205128205124,1029.487179487179,27.09176788124155,0
2008,4,0,0,46,0.0,0.0,1.0,46,950,500,450,0.5263157894736842,14,5,9,339.7104909740656,0.8045893719806764,0.19383024492317702,0.20585473560534046,132618.0021938235,-189.65467254730055,132428.34752127618,1998,2,716.804347826087,38,8,17,33.74693150779657,0.6428179824561404,42.49465811965812,1030.0213675213674,27.105825461088617,0
2009,4,0,0,46,0.0,0.0,1.0,46,1200,1000,200,0.8333333333333334,14,10,4,338.0669659290135,0.8039251207729469,0.1933446306804094,0.20576227257521745,132783.12108490412,-222.08262564831364,132561.0384592558,1999,3,717.804347826087,38,8,15,33.62357900556303,0.6444627192982455,42.33440170940172,1030.6623931623947,27.122694556905124,0
2010,4,0,0,46,0.0,0.0,1.0,46,1350,800,550,0.5925925925925926,19,8,11,341.8518956151484,0.8039855072463769,0.1914178633849255,0.20883256306819095,132920.79863393985,-112.15460406163118,132808.64402987823,2000,4,718.804347826087,38,8,16,33.387942050006906,0.6458333333333333,42.20085470085471,1031.1965811965829,27.136752136752182,0
2011,4,0,0,46,0.0,0.0,1.0,46,950,600,350,0.631578947368421,13,6,7,339.84373943800404,0.8033816425120773,0.19096387169994844,0.20791200637100732,132975.88962853403,-161.79528270872783,132814.09434582532,2001,5,719.804347826087,38,8,16,33.38447793660659,0.6463815789473684,42.147435897435905,1031.4102564102577,27.142375168690993,0
2012,4,0,1,45,0.0,0.021739130434782608,0.9782608695652174,46,1050,800,250,0.7619047619047619,13,8,5,341.7977488167688,0.8027979066022545,0.1866124870548178,0.2100826361834085,133149.50086805562,-97.96006944443491,133051.54079861118,2002,6,720.804347826087,39,7,17,33.160072668550676,0.6463675213675213,41.97916666666667,1032.083333333334,26.46367521367523,0
2013,4,0,0,45,0.0,0.0,1.0,45,1100,700,400,0.6363636363636364,15,7,8,339.7424013602559,0.8042087542087543,0.17198543163697244,0.20930521864274348,133236.04630387013,53.18686380462057,133289.23316767474,2003,7,720.9555555555555,40,5,17,33.12641500147652,0.6455729166666667,41.895325203252035,1032.4186991869924,25.81046747967481,0
2014,4,0,0,45,0.0,0.0,1.0,45,1350,1000,350,0.7407407407407407,17,10,7,338.9127088059538,0.8014730639730641,0.17315063815255893,0.20954626627598513,133369.7286785084,40.13920382967251,133409.86788233806,2004,8,721.9555555555555,41,4,17,33.013990267639905,0.6453252032520325,41.76587301587301,1032.9365079365075,25.19357336430506,0
2015,4,0,0,45,0.0,0.0,1.0,45,1000,700,300,0.7,13,7,6,337.5908595957588,0.8007996632996633,0.17510616051042427,0.20901731342629182,133420.97052941532,8.340025825131818,133429.31055524046,2005,9,722.9555555555555,41,4,17,32.996847192881376,0.6458333333333334,41.716269841269835,1033.1349206349194,25.198412698412668,0
2016,4,0,0,45,0.0,0.0,1.0,45,1550,1300,250,0.8387096774193549,18,13,5,335.664568429687,0.7997895622895623,0.1739010718851408,0.20825948727037777,133498.47690073715,-37.84843111897004,133460.62846961818,2006,10,723.9555555555555,40,5,17,32.9690726718458,0.6481770833333333,41.64126016260163,1033.4349593495947,25.835873983739866,0
2017,4,1,1,45,0.021739130434782608,0.021739130434782608,0.9782608695652174,46,800,500,300,0.625,11,5,6,330.0364362135766,0.8022342995169083,0.17326464321306312,0.2061887310005371,133754.28245661696,-371.2426579428021,133383.03979867414,2007,0,709.195652173913,41,5,15,32.85890396726447,0.6491361788617886,41.39384920634921,1034.4246031746036,25.229868370112282,0
2018,4,0,0,45,0.0,0.0,1.0,45,750,500,250,0.6666666666666666,10,5,5,338.1488452109963,0.7979377104377104,0.1817120083543795,0.21125692085171097,133754.2824566168,45.77123094607225,133800.05368756287,2008,12,725.9555555555555,41,4,15,32.649112080815826,0.6491361788617886,41.3938492063492,1034.4246031746025,25.229868370112253,0
2019,4,0,0,45,0.0,0.0,1.0,45,950,700,250,0.7368421052631579,12,7,5,340.20130956189547,0.7960016835016835,0.18658827539195677,0.2132800517638037,133882.5900730663,109.40649407911829,133991.99656714543,2009,13,726.9555555555555,41,4,16,32.46780738752556,0.6504065040650406,41.26984126984127,1034.9206349206352,25.241966705381344,0
2020,4,1,2,44,0.021739130434782608,0.043478260869565216,0.9565217391304348,46,1050,800,250,0.7619047619047619,13,8,5,334.6057487086101,0.798450080515298,0.1841420262740474,0.21115321450383964,134123.85542485438,-224.2773871762395,133899.57803767815,2010,0,712.1304347826087,42,4,16,32.37176488930466,0.6512896825396826,41.03682170542636,1035.8527131782953,24.66315983757846,0
2021,4,0,0,44,0.0,0.0,1.0,44,1100,600,500,0.5454545454545454,16,6,10,344.77515376754604,0.7960711768851304,0.18311363413394277,0.2176032905481484,134129.3637736301,448.8944039592831,134578.25817758936,2011,15,728.9545454545455,40,4,16,32.102913764348095,0.6544270833333332,41.03150406504065,1035.873983739837,25.896849593495926,0
2022,4,0,0,44,0.0,0.0,1.0,44,1450,900,550,0.6206896551724138,20,9,11,324.9921782833688,0.7956087033121917,0.15269231131675443,0.1978043876277387,132783.12108490392,-143.18572235002898,132639.9353625539,2012,16,729.9545454545455,38,6,16,33.96047130368681,0.6444627192982456,42.33440170940171,1030.662393162393,27.12269455690508,6
2023,4,0,0,44,0.0,0.0,1.0,44,1100,1000,100,0.9090909090909091,12,10,2,321.3081504394694,0.795630725863284,0.1541345764085933,0.1919291058436251,132076.58420138902,-312.5434027777592,131764.04079861127,2013,17,730.9545454545455,39,5,12,34.76388325901907,0.6356837606837606,43.02083333333334,1027.9166666666679,26.356837606837637,2
2024,4,0,0,44,0.0,0.0,1.0,44,1200,800,400,0.6666666666666666,16,8,8,320.75295777851994,0.7950801620859761,0.15686287721567882,0.1921669141362256,132188.9058781978,-320.003490812314,131868.9023873855,2014,18,731.9545454545455,40,4,13,34.665398425404355,0.6351562499999999,42.911585365853675,1028.3536585365878,25.708841463414693,0
2025,4,0,0,44,0.0,0.0,1.0,44,1000,700,300,0.7,13,7,6,318.56577964599484,0.7949700493305145,0.15162292755653706,0.19125283639245355,132267.29811124358,-372.83301110447155,131894.46510013912,2015,19,732.9545454545455,40,4,14,34.64298063623791,0.6359374999999998,42.83536585365855,1028.6585365853682,25.716463414634205,0
2026,4,0,0,44,0.0,0.0,1.0,44,1300,1000,300,0.7692307692307693,16,10,6,318.1877089106134,0.7931201550387598,0.14988591511716676,0.19182506111932754,132424.8060438372,-372.7463233509129,132052.0597204863,2016,20,733.9545454545455,39,5,16,34.494758458995385,0.6391559829059827,42.682291666666686,1029.2708333333364,26.391559829059908,0
2027,4,0,0,44,0.0,0.0,1.0,44,850,400,450,0.47058823529411764,13,4,9,320.2163305595412,0.7923713883016209,0.15741694566057185,0.19346077085883304,132505.23003472242,-313.9322916666422,132191.2977430558,2017,21,734.9545454545455,39,5,16,34.36193174153515,0.6399572649572649,42.60416666666668,1029.583333333335,26.399572649572693,0
2028,4,0,0,44,0.0,0.0,1.0,44,1000,600,400,0.6,14,6,8,318.87234109403965,0.7927457716701903,0.15206678434833787,0.1931991243099183,132612.50000000012,-342.70833333331785,132269.7916666668,2018,22,735.9545454545455,39,5,16,34.28903721682848,0.641025641025641,42.50000000000001,1030.000000000001,26.410256410256434,0
2029,4,0,1,43,0.0,0.022727272727272728,0.9772727272727273,44,900,400,500,0.4444444444444444,14,4,10,321.4929511763784,0.7927457716701903,0.09661807822861834,0.18686896612138543,131034.669325087,-374.65549045136856,130660.01383463564,2019,23,736.9545454545455,39,5,15,35.807410892935884,0.6252670940170939,44.03645833333334,1023.8541666666682,26.25267094017098,5
2030,4,0,0,43,0.0,0.0,1.0,43,1150,1000,150,0.8695652173913043,13,10,3,325.40567262041264,0.7889904023624954,0.08523110332053552,0.18940575296218343,131088.00048828128,-68.64420572916572,131019.35628255211,2020,24,714.8604651162791,39,4,15,35.65348133455395,0.625801282051282,43.984375,1024.0625000000002,26.258012820512825,0
2031,4,1,0,44,0.022727272727272728,0.0,1.0,44,1050,700,350,0.6666666666666666,14,7,7,324.6877806912209,0.7948379140239605,0.10542813879194113,0.19097227530978267,131488.330078125,-261.24945746527715,131227.08062065972,2021,0,699.5909090909091,39,5,17,35.26855237321417,0.6298076923076923,43.59375,1025.625,26.298076923076923,0
2032,4,0,0,44,0.0,0.0,1.0,44,1300,900,400,0.6923076923076923,17,9,8,325.34241860246516,0.7939570119802678,0.10559976734953924,0.19149114142130721,131515.04041883667,-242.51573350695355,131272.5246853297,2022,1,700.5909090909091,39,5,17,35.22487813547275,0.6300747863247864,43.56770833333333,1025.7291666666656,26.300747863247835,0
2033,4,0,0,44,0.0,0.0,1.0,44,950,600,350,0.631578947368421,13,6,7,323.9167050631924,0.7955866807610994,0.10831618386689024,0.1911865465295091,131621.90890842,-273.0929904513939,131348.8159179686,2023,2,701.5909090909091,39,5,15,35.15389723547526,0.6311431623931625,43.463541666666664,1026.1458333333323,26.3114316239316,0
2034,4,0,0,44,0.0,0.0,1.0,44,1450,1200,250,0.8275862068965517,17,12,5,328.3464308621665,0.7941992600422834,0.1139406849997231,0.1947556627821441,131809.03320312488,-144.19487847223718,131664.83832465264,2024,3,702.5909090909091,39,5,15,34.85198147021032,0.6330128205128207,43.28124999999999,1026.874999999999,26.330128205128183,0
2035,4,0,0,44,0.0,0.0,1.0,44,1050,800,250,0.7619047619047619,13,8,5,325.892160733145,0.7944194855532065,0.11462270238380556,0.19384490284380407,131916.02105034702,-201.92057291669187,131714.10047743033,2025,4,703.5909090909091,39,5,15,34.8074258095045,0.6340811965811968,43.17708333333332,1027.291666666665,26.34081196581192,0
2036,4,0,0,44,0.0,0.0,1.0,44,1050,700,350,0.6666666666666666,14,7,7,326.08216886526935,0.7934945384073291,0.06013676588897776,0.18728774256299333,130574.00238160155,-198.48087050326023,130375.52151109828,2026,5,704.5909090909091,40,4,14,36.154958403765185,0.6190104166666668,44.48678861788618,1022.0528455284552,25.55132113821138,6
2037,4,0,0,44,0.0,0.0,1.0,44,1000,800,200,0.8,12,8,4,325.08834124811347,0.7924374559548979,0.05960062901607799,0.18696761718780874,130625.94112507437,-307.0058951351683,130318.9352299392,2027,6,705.5909090909091,40,4,14,36.12788713258442,0.61953125,44.4359756097561,1022.2560975609757,25.556402439024392,0
2038,4,0,0,44,0.0,0.0,1.0,44,1850,1400,450,0.7567567567567568,23,14,9,323.36626632186756,0.7906316067653277,0.06283634918915038,0.18710641203037745,130859.79327781106,-336.8714472205477,130522.92183059051,2028,7,706.5909090909091,40,4,15,35.93584459012052,0.6218749999999998,44.20731707317074,1023.1707317073189,25.579268292682972,0
2039,4,0,0,44,0.0,0.0,1.0,44,1100,800,300,0.7272727272727273,14,8,6,322.64359711250074,0.791138125440451,0.05874552855556914,0.1872349063558371,130972.46334876545,-348.5146604938283,130623.94868827162,2029,8,707.5909090909091,41,3,15,35.8406829488919,0.6214430894308942,44.09722222222222,1023.6111111111113,24.966124661246617,0
2040,4,1,0,45,0.022222222222222223,0.0,1.0,45,1550,1200,350,0.7741935483870968,19,12,7,316.37836968861666,0.7986111111111112,0.055235010960202446,0.18543338843980683,131354.16795764753,-687.5119917781115,130666.65596586942,2030,0,692.8444444444444,40,5,17,35.61659396583062,0.6268229166666668,43.72459349593496,1025.10162601626,25.6275406504065,0
2041,4,0,0,45,0.0,0.0,1.0,45,1450,1000,450,0.6896551724137931,19,10,9,316.17497328166553,0.798989898989899,0.06048477643484551,0.18620012720566695,131536.54095611078,-682.2875355277936,130854.25342058299,2031,1,693.8444444444444,40,5,17,35.43833795654183,0.6286458333333333,43.546747967479675,1025.8130081300815,25.645325203252035,0
2042,4,0,0,45,0.0,0.0,1.0,45,1150,800,350,0.6956521739130435,15,8,7,318.86991066427896,0.7989057239057239,0.06074572988202109,0.18804384451323364,131588.6707647564,-608.0664617621856,130980.60430299421,2032,2,694.8444444444444,40,5,15,35.31679212889594,0.6291666666666667,43.49593495934959,1026.0162601626014,25.650406504065035,0
2043,4,0,0,45,0.0,0.0,1.0,45,1250,800,450,0.64,17,8,9,307.16860133962865,0.7984006734006734,0.07213038613380673,0.17401812151242918,130040.11646685905,-1011.1518613664945,129028.96460549255,2033,3,695.8444444444444,42,3,18,37.17718823231364,0.6106150793650793,45.009689922480625,1019.9612403100782,24.284791435954244,5
2044,4,2,1,46,0.0425531914893617,0.02127659574468085,0.9787234042553191,47,1400,1100,300,0.7857142857142857,17,11,6,293.9549439155432,0.8144465001541782,0.07888452799008472,0.16858217830345754,130515.89269967256,-1726.271206595223,128789.62149307734,2034,0,667.1914893617021,41,6,17,37.03438511326859,0.616869918699187,44.5436507936508,1021.8253968253975,24.92257065427799,0
2045,4,0,0,46,0.0,0.0,1.0,46,950,600,350,0.631578947368421,13,6,7,308.4866870189917,0.807890499194847,0.09462507373607698,0.17333355104699388,129718.50419723701,-1196.7136790270442,128521.79051820996,2035,1,682.695652173913,40,6,18,37.46882482043097,0.6104166666666667,45.325203252032516,1018.6991869918692,25.467479674796728,1
2046,4,1,1,46,0.02127659574468085,0.02127659574468085,0.9787234042553191,47,1850,1400,450,0.7567567567567568,23,14,9,306.5498389198889,0.8137141535615171,0.10126648809824612,0.17355766835028646,130015.40927716155,-1428.7594457965572,128586.649831365,2036,0,669.1489361702128,42,5,18,37.21793349168645,0.6103670634920636,45.033914728682156,1019.8643410852691,24.282484311554025,0
2047,4,0,0,46,0.0,0.0,1.0,46,900,500,400,0.5555555555555556,13,5,8,312.1011151458223,0.8056561996779388,0.10153457661674015,0.17655956866174502,129984.23450688137,-1086.3550918052558,128897.87941507612,2037,3,684.695652173913,41,5,18,37.10791824755973,0.6115345528455285,45.06448412698412,1019.7420634920628,24.871757646147874,0
2048,4,1,0,47,0.02127659574468085,0.0,1.0,47,1250,900,350,0.72,16,9,7,310.91285113445434,0.8135599753314832,0.11744799442619702,0.17738452103054325,130314.46358194544,-1296.1162818028206,129018.34730014262,2038,0,671.1063829787234,40,7,19,36.80451876181945,0.6164062499999999,44.740853658536594,1021.036585365855,25.525914634146375,0
2049,4,0,0,47,0.0,0.0,1.0,47,1200,800,400,0.6666666666666666,16,8,8,310.3046850484855,0.8139068763490594,0.11603049018615219,0.17761019132541714,130439.87509645052,-1304.7791280864317,129135.09596836408,2039,1,672.1063829787234,41,6,19,36.693434171765226,0.6161077235772358,44.61805555555555,1021.5277777777769,24.91531165311651,0
2050,4,0,0,47,0.0,0.0,1.0,47,1150,800,350,0.6956521739130435,15,8,7,308.06736160271953,0.8144079555966697,0.10996418790815254,0.17690690965614353,130566.58340419493,-1355.3394274376537,129211.24397675728,2040,2,673.1063829787234,41,6,17,36.62274315666861,0.6173780487804879,44.49404761904761,1022.0238095238088,24.92740998838558,0
2051,4,1,1,47,0.020833333333333332,0.020833333333333332,0.9791666666666666,48,1500,900,600,0.6,21,9,12,303.2444686727982,0.8209404550827423,0.10418209305195636,0.17538828905465254,130843.25140610643,-1664.5015495867863,129178.74985651964,2041,0,660.0625,43,5,17,36.467203504874746,0.6172480620155039,44.223484848484844,1023.1060606060598,23.793164200140925,0
2052,4,0,1,46,0.0,0.02127659574468085,0.9787234042553191,47,500,200,300,0.4,8,2,6,307.8473573518422,0.8125963613937711,0.10339300511501226,0.17742835402151771,130708.0978926296,-1352.371495853621,129355.72639677598,2042,4,675.1063829787234,42,5,17,36.485675479326574,0.6173115079365079,44.35562015503876,1022.5775193798445,24.347083794758202,0
2053,4,0,1,45,0.0,0.021739130434782608,0.9782608695652174,46,900,700,200,0.7777777777777778,11,7,4,308.3071173942431,0.8097222222222222,0.12040004047627062,0.17820980911263629,130820.18455530348,-1133.4412005543097,129686.74335474917,2043,5,688.4130434782609,41,5,17,36.36095487457978,0.6199186991869918,44.24603174603174,1023.0158730158721,24.95160665892371,0
2054,4,0,0,45,0.0,0.0,1.0,45,1050,600,450,0.5714285714285714,15,6,9,311.89835541614497,0.8062289562289563,0.12261739188025711,0.18022783269913406,130807.8080590257,-840.2519581598272,129967.55610086587,2044,6,703.3111111111111,40,5,17,36.28158321743161,0.6213541666666667,44.25813008130081,1022.9674796747967,25.574186991869915,0
2055,4,0,0,45,0.0,0.0,1.0,45,1600,1300,300,0.8125,19,13,6,305.14847256049495,0.8063973063973064,0.1088487829738205,0.17202552171496355,129847.94439693616,-1075.4196204309806,128772.52477650518,2045,7,704.3111111111111,40,5,15,37.42293183102336,0.6117187500000001,45.19817073170731,1019.2073170731692,25.48018292682923,2
2056,4,0,0,45,0.0,0.0,1.0,45,1000,800,200,0.8,12,8,4,302.3991723355983,0.8051346801346801,0.11039126438309133,0.17092793780524265,129951.54303200802,-1140.5521886773795,128810.99084333064,2046,8,705.3111111111111,40,5,15,37.38828532509386,0.6127604166666667,45.09654471544715,1019.613821138211,25.490345528455276,0
2057,4,0,0,45,0.0,0.0,1.0,45,1000,800,200,0.8,12,8,4,303.5813242308183,0.8047558922558923,0.11038506417736338,0.17229748004358345,130110.72137188188,-1100.1629818594258,129010.55839002246,2047,9,706.3111111111111,41,4,15,37.19734539089847,0.6128048780487806,44.94047619047618,1020.2380952380936,24.883855981416918,0
2058,4,0,1,44,0.0,0.022222222222222223,0.9777777777777777,45,1200,1000,200,0.8333333333333334,14,10,4,301.4849589558747,0.8028198653198654,0.10133828831818104,0.17189091360219694,130288.52390276923,-1143.9053666529376,129144.6185361163,2048,10,707.3111111111111,40,5,16,37.07134680469839,0.6161458333333335,44.76626016260161,1020.9349593495912,25.52337398373978,0
2059,4,0,0,44,0.0,0.0,1.0,44,900,500,400,0.5555555555555556,13,5,8,305.1891100960471,0.8028100775193798,0.09886815724314446,0.17424396309094625,130342.35161675331,-844.1867404514076,129498.1648763019,2049,11,712.0454545454545,39,5,16,36.922476962834516,0.6183226495726497,44.71354166666666,1021.145833333332,26.183226495726462,0
2060,4,1,1,44,0.022222222222222223,0.022222222222222223,0.9777777777777777,45,1350,900,450,0.6666666666666666,18,9,9,299.1658399503576,0.8114478114478115,0.09308151093439343,0.1721743907265785,130651.91436975327,-1182.6820592901277,129469.23231046315,2050,0,697.2,40,5,14,36.76420642809808,0.6197916666666667,44.410569105691046,1022.3577235772343,25.55894308943086,0
2061,4,0,0,44,0.0,0.0,1.0,44,1200,900,300,0.75,15,9,6,303.8468499266023,0.8035588442565187,0.09390171589519336,0.1745518320538535,130581.79253472204,-864.6267361111306,129717.16579861092,2051,13,714.0454545454545,39,5,15,36.71524663677128,0.6207264957264957,44.47916666666666,1022.0833333333319,26.207264957264922,0
2062,4,0,1,43,0.0,0.022727272727272728,0.9772727272727273,44,1250,800,450,0.64,17,8,9,305.94561778617344,0.8041094080338267,0.09344669185744969,0.176241912217669,130688.28125,-803.2986111111115,129884.98263888889,2052,14,715.0454545454545,39,5,17,36.55426514534094,0.6217948717948718,44.375,1022.5,26.21794871794872,0
2063,4,1,2,42,0.022727272727272728,0.045454545454545456,0.9545454545454546,44,1000,700,300,0.7,13,7,6,297.18550052884495,0.8108262861169838,0.07216024742922111,0.1723475440672337,130947.07739866752,-1016.8854520975332,129930.19194656999,2053,0,669.8409090909091,41,3,17,36.517701366676356,0.621189024390244,44.122023809523796,1023.5119047619025,24.963704994192746,0
2064,4,0,0,42,0.0,0.0,1.0,42,950,700,250,0.7368421052631579,12,7,5,308.85578916832606,0.7964576074332171,0.07470277506948575,0.17804094434911674,130714.91021050354,-325.5886501736061,130389.32156032993,2054,16,702.1904761904761,39,3,17,36.45302791076704,0.6220619658119659,44.348958333333336,1022.6041666666672,26.22061965811967,0
2065,4,1,1,42,0.023255813953488372,0.023255813953488372,0.9767441860465116,43,1400,900,500,0.6428571428571429,19,9,10,304.04984945415583,0.803063861203396,0.07243810952738206,0.17676296787366547,131041.82287535544,-631.3506965099953,130410.47217884545,2055,0,686.8372093023256,40,3,17,36.246691480562475,0.6236979166666665,44.029471544715456,1023.8821138211395,25.597052845528488,0
2066,4,0,0,42,0.0,0.0,1.0,42,850,400,450,0.47058823529411764,13,4,9,310.3879086250248,0.7966753774680604,0.07104079416782971,0.1797907319771375,130901.38888888928,-273.95833333329347,130627.43055555598,2056,18,704.1904761904761,39,3,17,36.22590933767644,0.6239316239316237,44.166666666666686,1023.3333333333364,26.23931623931632,0
2067,4,0,0,42,0.0,0.0,1.0,42,950,400,550,0.42105263157894735,15,4,11,312.40552849377644,0.7965301974448316,0.06575848332412582,0.18120996003422968,130954.69292534742,-217.80598958331313,130736.88693576411,2057,19,705.1904761904761,39,3,17,36.120581450573326,0.6244658119658119,44.11458333333334,1023.5416666666682,26.24465811965816,0
2068,4,1,0,43,0.023255813953488372,0.0,1.0,43,1200,1000,200,0.8333333333333334,14,10,4,314.3836403015643,0.8027408637873754,0.09096279353317249,0.18439593491346845,131381.51584201414,-338.62847222219705,131042.88736979195,2058,0,689.7674418604652,39,4,18,35.64019846914583,0.6287393162393162,43.69791666666668,1025.2083333333353,26.28739316239321,0
2069,4,0,0,43,0.0,0.0,1.0,43,850,500,350,0.5882352941176471,12,5,7,313.4647737249932,0.8036637135474345,0.09685907156252793,0.18437121637373266,131488.33007812512,-356.6080729166515,131131.72200520846,2059,1,690.7674418604652,39,4,18,35.556317286207616,0.6298076923076923,43.59375000000001,1025.625000000001,26.298076923076945,0
2070,4,0,0,43,0.0,0.0,1.0,43,1500,1100,400,0.7333333333333333,19,11,8,313.7313509752891,0.8034791435954226,0.09557313186164551,0.18504513815009588,131595.18771701405,-342.89279513886913,131252.29492187517,2060,2,691.7674418604652,39,4,14,35.44204737732656,0.6308760683760684,43.48958333333334,1026.041666666668,26.30876068376072,0
2071,4,1,0,44,0.022727272727272728,0.0,1.0,44,1050,700,350,0.6666666666666666,14,7,7,308.30837794713807,0.8092847075405215,0.1055734431773212,0.18331653436998074,131901.66650142116,-666.7222304844915,131234.94427093666,2061,0,677.0227272727273,40,4,16,35.273422041946986,0.6322916666666667,43.19105691056911,1027.235772357724,25.680894308943103,0
2072,4,0,0,44,0.0,0.0,1.0,44,1100,700,400,0.6363636363636364,15,7,8,310.9043789769762,0.8082276250880902,0.10498253436079241,0.18529042332816603,131989.9189421141,-592.7512440161003,131397.167698098,2062,1,678.0227272727273,41,3,16,35.11818562141984,0.6316056910569104,43.10515873015874,1027.5793650793669,25.062911343399193,0
2073,4,1,1,44,0.022222222222222223,0.022222222222222223,0.9777777777777777,45,1400,1200,200,0.8571428571428571,16,12,4,306.7265376808721,0.8140993265993266,0.10060484292919858,0.18441802814810312,132323.21994621726,-882.5913782224476,131440.6285679948,2063,0,663.9333333333333,42,3,17,34.89141866013689,0.6334325396825395,42.78100775193799,1028.8759689922488,24.49704688076783,0
2074,4,0,0,44,0.0,0.0,1.0,44,1300,900,400,0.6923076923076923,17,9,8,314.8943292953394,0.8053646934460889,0.11027877619005877,0.1891920159207805,132295.92328829685,-468.1527935248151,131827.77049477203,2064,3,680.0227272727273,41,3,17,34.70869495339119,0.6346544715447153,42.807539682539684,1028.7698412698417,25.09194734804492,0
2075,4,0,0,44,0.0,0.0,1.0,44,1100,700,400,0.6363636363636364,15,7,8,316.49529085906005,0.8043736786469345,0.11008360541264883,0.19080823730514287,132425.49332493232,-417.4728917975401,132008.02043313478,2065,4,681.0227272727273,38,6,18,34.53761850390977,0.6408991228070176,42.681623931623925,1029.2735042735032,27.086144849302716,0
2076,4,0,0,44,0.0,0.0,1.0,44,1050,600,450,0.5714285714285714,15,6,9,314.5854496306886,0.804549859055673,0.11746982270841233,0.19049018432411005,132590.4923661331,-457.79206844914546,132132.70029768397,2066,5,682.0227272727273,38,6,19,34.421464384508994,0.6425438596491229,42.52136752136751,1029.9145299145277,27.10301394511915,0
2077,4,0,0,44,0.0,0.0,1.0,44,1200,800,400,0.6666666666666666,16,8,8,314.1829109271365,0.8048141296687809,0.11630960575572136,0.19038576016646894,132618.00219382337,-466.7380058806493,132151.26418794272,2067,6,683.0227272727273,38,6,19,34.4042803305328,0.6428179824561404,42.49465811965811,1030.0213675213663,27.105825461088585,0
2078,4,0,0,44,0.0,0.0,1.0,44,1350,800,550,0.5925925925925926,19,8,11,309.18346307513355,0.8047921071176886,0.10624887932580251,0.18795685345214955,132738.13950029752,-591.9124694295633,132146.22703086794,2068,7,684.0227272727273,40,4,14,34.41280407626562,0.640625,42.37804878048781,1030.4878048780495,25.762195121951237,0
2079,4,0,0,44,0.0,0.0,1.0,44,950,900,50,0.9473684210526315,10,9,1,308.58373353921996,0.8045718816067654,0.10337201060562329,0.18780763958634758,132781.15477962006,-605.1791028911675,132175.9756767289,2069,8,685.0227272727273,41,3,14,34.38522716334584,0.6394817073170732,42.33630952380952,1030.654761904761,25.137921022067342,0
2080,4,0,0,44,0.0,0.0,1.0,44,1100,800,300,0.7272727272727273,14,8,6,311.8849639178831,0.8031844608879493,0.106025614108755,0.19020590053020195,132857.85147392287,-512.7267573696209,132345.12471655325,2070,9,686.0227272727273,41,3,14,34.22344110854502,0.6402439024390244,42.26190476190476,1030.9523809523807,25.1451800232288,0
2081,4,0,0,44,0.0,0.0,1.0,44,1000,700,300,0.7,13,7,6,307.2105877938523,0.8020613107822411,0.1075069731653362,0.18799696770410132,132985.7285072593,-629.0752354182474,132356.65327184106,2071,10,687.0227272727273,41,3,15,34.21609999679395,0.6415142276422765,42.13789682539682,1031.448412698412,25.157278358497855,0
2082,4,0,0,44,0.0,0.0,1.0,44,1300,1000,300,0.7692307692307693,16,10,6,306.98691166097035,0.803162438336857,0.1152620814432177,0.18837586242983773,133088.07442247713,-628.7406108276831,132459.33381164944,2072,11,688.0227272727273,41,3,15,34.119615902317086,0.6425304878048781,42.03869047619047,1031.8452380952367,25.166957026713092,0
2083,4,0,0,44,0.0,0.0,1.0,44,1100,800,300,0.7272727272727273,14,8,6,307.38776275826865,0.8026338971106414,0.11038586557617691,0.18901077327050964,133164.8596938774,-613.3503401360663,132551.50935374133,2073,12,689.0227272727273,41,3,15,34.03258362168397,0.6432926829268293,41.96428571428571,1032.142857142856,25.174216027874536,0
2084,4,0,0,44,0.0,0.0,1.0,44,1000,700,300,0.7,13,7,6,308.89589454336897,0.801642882311487,0.1063954300887433,0.19046140227531855,133267.27450239327,-566.8572058453258,132700.41729654794,2074,13,690.0227272727273,41,3,15,33.89139764283884,0.6443089430894309,41.86507936507935,1032.5396825396801,25.18389469608976,0
2085,4,0,0,44,0.0,0.0,1.0,44,1150,600,550,0.5217391304347826,17,6,11,312.8781486653084,0.7994846723044398,0.10735864212621782,0.19344936365220824,133369.72867850823,-454.3052406147857,132915.42343789345,2075,14,691.0227272727273,41,3,15,33.68629145857344,0.6453252032520326,41.765873015873005,1032.9365079365064,25.193573364305035,0
2086,4,1,0,45,0.022222222222222223,0.0,1.0,45,1450,1100,350,0.7586206896551724,18,11,7,320.66434112333855,0.8060185185185186,0.04842796809009875,0.1976100957009351,133247.02659282775,-435.43208432995516,132811.5945084978,2076,0,676.6444444444444,42,3,13,33.60785233849523,0.6426091269841271,41.88468992248061,1032.461240310076,24.582410483573238,8
2087,4,1,1,45,0.021739130434782608,0.021739130434782608,0.9782608695652174,46,750,500,250,0.6666666666666666,10,5,5,317.151239436774,0.8089371980676329,0.05286846540985768,0.1965040984380827,133447.75995932316,-735.375505767926,132712.38445355522,2077,0,662.9130434782609,43,3,13,33.49801805517368,0.6431686046511629,41.6903409090909,1033.2386363636347,24.028805496828713,0
2088,4,0,0,45,0.0,0.0,1.0,45,1100,800,300,0.7272727272727273,14,8,6,325.97669741386625,0.8046717171717173,0.054485396021549226,0.2019691763233036,133447.19109616306,-299.86507346313476,133147.32602269994,2078,2,678.6444444444444,42,3,14,33.27061646190878,0.644593253968254,41.690891472868216,1033.236434108527,24.60086747877445,0
2089,4,0,1,44,0.0,0.022222222222222223,0.9777777777777777,45,1350,1100,250,0.8148148148148148,16,11,5,324.9841133239638,0.8045875420875421,0.053323093661003185,0.20162951212005534,133497.8517593379,-323.06145570258906,133174.79030363532,2079,3,679.6444444444444,41,4,14,33.24563613964353,0.6465955284552847,41.641865079365076,1033.4325396825388,25.20567169957412,0
2090,4,0,0,44,0.0,0.0,1.0,44,1250,700,550,0.56,18,7,11,326.07850000152973,0.799638830162086,0.04619190561789943,0.20244849898783868,133523.4837569286,-92.17254031243164,133431.31121661616,2080,4,695.6818181818181,41,3,16,33.191751455813666,0.646849593495935,41.61706349206349,1033.5317460317451,25.20809136662793,0
2091,4,0,0,44,0.0,0.0,1.0,44,1250,800,450,0.64,17,8,9,325.4131474666102,0.7977228682170543,0.0494041751358707,0.20245554685071895,133600.39451255032,-104.9350237780352,133495.4594887723,2081,5,696.6818181818181,41,3,16,33.13211703931165,0.6476117886178863,41.54265873015873,1033.8293650793646,25.21535036778938,0
2092,4,0,0,44,0.0,0.0,1.0,44,800,400,400,0.5,12,4,8,325.1756862144615,0.798185341789993,0.050230282095567125,0.2024480885141645,133626.03635204062,-109.6123866213373,133516.4239654193,2082,6,697.6818181818181,41,3,16,33.11264632508156,0.6478658536585367,41.51785714285713,1033.9285714285697,25.217770034843163,0
2093,4,0,0,44,0.0,0.0,1.0,44,800,300,500,0.375,13,3,10,324.67727524120806,0.7985597251585624,0.05151573292402145,0.2024184160953558,133677.32741244632,-119.60191484002411,133557.7254976063,2083,7,698.6818181818181,41,3,17,33.074315681760034,0.6483739837398375,41.46825396825396,1034.1269841269832,25.22260936895081,0
2094,4,1,1,44,0.022222222222222223,0.022222222222222223,0.9777777777777777,45,1550,1000,550,0.6451612903225806,21,10,11,330.89247708560373,0.80496632996633,0.005414261366760265,0.1963398990575469,131823.38271077067,-270.4382533661048,131552.94445740458,2084,0,684.1333333333333,40,5,14,34.77218373742372,0.6315104166666667,43.267276422764226,1026.9308943089427,25.67327235772357,8
2095,4,1,1,44,0.022222222222222223,0.022222222222222223,0.9777777777777777,45,1250,800,450,0.64,17,8,9,326.98899597062893,0.7987373737373737,0.02338418283856658,0.19563262402335022,132136.65729930924,-358.5534197567622,131778.10387955248,2085,0,684.9333333333333,40,5,14,34.557551645744795,0.6346354166666668,42.96239837398374,1028.1504065040647,25.70376016260162,0
2096,4,0,0,44,0.0,0.0,1.0,44,1350,1000,350,0.7407407407407407,17,10,7,331.55073562110994,0.7954325229034531,0.020397214982363465,0.19846799947337634,132156.90239800353,-36.65635850694025,132120.2460394966,2086,2,701.5,39,5,15,34.41995491844798,0.6364850427350428,42.942708333333336,1028.229166666667,26.364850427350436,0
2097,4,0,0,44,0.0,0.0,1.0,44,1200,900,300,0.75,15,9,6,332.41829858069275,0.7960271317829458,0.015814978784503886,0.19983539470976872,132317.61203342007,-3.040907118065604,132314.571126302,2087,3,702.5,39,5,15,34.23620954405858,0.6380876068376069,42.78645833333333,1028.854166666666,26.380876068376054,0
2098,4,0,1,43,0.0,0.022727272727272728,0.9772727272727273,44,950,600,350,0.631578947368421,13,6,7,339.49172769559635,0.7964675828047921,0.012395230515866329,0.204668563841378,132424.80604383672,191.42523871527203,132616.231282552,2088,4,703.5,39,5,15,33.94656832979119,0.639155982905983,42.682291666666664,1029.2708333333328,26.391559829059815,0
2099,4,1,1,43,0.022727272727272728,0.022727272727272728,0.9772727272727273,44,1200,800,400,0.6666666666666666,16,8,8,333.52724253952226,0.7963354474982383,0.021716150381468458,0.20236714286600452,132666.15125868047,49.5551215277722,132715.70638020826,2089,0,703.3409090909091,39,5,13,33.85785305021908,0.6415598290598291,42.447916666666664,1030.2083333333328,26.415598290598275,0
2100,4,0,0,43,0.0,0.0,1.0,43,1450,1100,350,0.7586206896551724,18,11,7,339.5987238554453,0.7889442598744923,0.022218254293808304,0.20533579049678655,132535.48127145867,401.77606107091555,132937.25733252958,2090,6,720.6976744186046,38,5,17,33.83265891955454,0.6419956140350878,42.57478632478632,1029.7008547008534,27.09739091318035,0
2101,4,0,0,43,0.0,0.0,1.0,43,750,500,250,0.6666666666666666,10,5,5,344.292364315822,0.7893595422665189,0.018491761203966783,0.20863121837641999,132618.00219382363,531.8731052304906,133149.8752990541,2091,7,721.6976744186046,38,5,17,33.628945821664416,0.6428179824561402,42.494658119658126,1030.0213675213686,27.105825461088646,0
2102,4,0,0,43,0.0,0.0,1.0,43,1000,400,600,0.4,16,4,12,344.9312294429775,0.7887596899224806,0.017814912938352023,0.20994016217264405,132783.12108490418,560.2090410183671,133343.33012592254,2092,8,722.6976744186046,38,5,13,33.44671054904809,0.6444627192982454,42.334401709401725,1030.6623931623951,27.122694556905135,0
2103,4,0,0,43,0.0,0.0,1.0,43,850,500,350,0.5882352941176471,12,5,7,344.31265150593435,0.7878368401624215,0.01777747784443262,0.20987193773725632,132838.1835438129,547.5734394404644,133385.75698325335,2093,9,723.6976744186046,38,5,13,33.40739109406848,0.6450109649122805,42.280982905982924,1030.876068376071,27.128317588843977,0
2104,4,2,1,44,0.044444444444444446,0.022222222222222223,0.9777777777777777,45,1550,1100,450,0.7096774193548387,20,11,9,329.8741581783003,0.7988636363636364,0.031989679337902865,0.20380006501921433,133340.98755907567,-202.8507956573107,133138.13676341836,2094,0,692.4888888888889,40,5,14,33.27614057528944,0.6466145833333332,41.79369918699189,1032.8252032520356,25.82063008130089,0
2105,4,1,1,44,0.022222222222222223,0.022222222222222223,0.9777777777777777,45,900,600,300,0.6666666666666666,12,6,6,343.59689701686943,0.7995791245791246,-0.021200110609272516,0.20448067667229902,131935.47804931397,66.52417283629995,132002.00222215027,2095,0,693.4666666666667,43,2,14,34.33313746274617,0.6281492248062017,43.15814393939393,1027.3674242424227,23.89226568005634,7
2106,4,0,1,43,0.0,0.022727272727272728,0.9772727272727273,44,1150,900,250,0.782608695652174,14,9,5,348.00587397650446,0.7939570119802678,-0.017487135506003337,0.20677479059142062,131874.9624421608,378.6523120605601,132253.61475422134,2096,1,710.2045454545455,42,2,15,34.280856918238996,0.6289682539682541,43.217054263565885,1027.1317829457353,24.455518641565124,0
2107,4,0,0,43,0.0,0.0,1.0,43,1050,800,250,0.7619047619047619,13,8,5,354.7997792513529,0.7936507936507936,-0.0065623841981743425,0.21102537128935975,131913.47321625383,760.5742354812041,132674.04745173504,2097,2,721.4186046511628,41,2,15,34.06758007403831,0.6308434959349594,43.17956349206348,1027.281746031744,25.055652342237657,0
2108,4,1,1,43,0.022727272727272728,0.022727272727272728,0.9772727272727273,44,1150,800,350,0.6956521739130435,15,8,7,350.8674939663263,0.7985817477096547,-0.010516690508210358,0.21026294260105133,132198.62768350745,476.84024021992605,132675.46792372738,2098,0,706.0,42,2,15,33.88140331040548,0.6321924603174605,42.90213178294573,1028.391472868216,24.485511258767048,0
2109,4,0,0,43,0.0,0.0,1.0,43,1200,900,300,0.75,15,9,6,355.9563041968746,0.7931432262827611,-0.016832523127886967,0.21271160461868568,132091.88102324252,803.7875566893257,132895.66857993184,2099,4,723.4186046511628,41,2,16,33.858087241845205,0.6326219512195121,43.00595238095237,1027.9761904761895,25.072590011614377,0
2110,4,0,1,42,0.0,0.023255813953488372,0.9767441860465116,43,1350,1000,350,0.7407407407407407,17,10,7,353.40583730814217,0.7936046511627907,-0.010609068321348225,0.21192370379596723,132223.5414413196,745.7142749834733,132969.25571630307,2100,5,724.4186046511628,42,1,16,33.791062119213635,0.6324404761904763,42.877906976744185,1028.488372093023,24.487818383167212,0
2111,4,0,0,42,0.0,0.0,1.0,42,1000,300,700,0.3,17,3,14,360.2245953242121,0.7954413472706156,-0.012080490662256249,0.215697742954099,132168.3784190759,1122.0601261337756,133290.43854520968,2101,6,733.7380952380952,41,1,17,33.67130969609262,0.6333841463414634,42.93154761904761,1028.2738095238087,25.079849012775824,0
2112,4,0,1,41,0.0,0.023809523809523808,0.9761904761904762,42,1700,1100,600,0.6470588235294118,23,11,12,355.1934960415679,0.7956107239643825,-0.0155195681511473,0.21398242322504182,132398.00347222202,1005.7805413831954,133403.7840136052,2102,7,734.7380952380952,39,3,17,33.56950067476383,0.6388888888888891,42.70833333333332,1029.166666666665,26.388888888888843,0
2113,4,0,0,41,0.0,0.0,1.0,41,850,500,350,0.5882352941176471,12,5,7,361.3334322125463,0.789380081300813,-0.0016186296565707803,0.21753045984448502,132371.85723610254,1366.0755006940033,133737.93273679656,2103,8,752.0,40,1,17,33.4378497596945,0.6369791666666668,42.73373983739836,1029.0650406504042,25.726626016260106,0
2114,4,0,0,41,0.0,0.0,1.0,41,800,400,400,0.5,12,4,8,359.43085972975894,0.7891260162601627,0.0013316657974551394,0.216693172880882,132425.49332493232,1319.5669471071542,133745.06027203947,2104,9,753.0,38,3,17,33.43280741817175,0.6408991228070176,42.681623931623925,1029.2735042735032,27.086144849302716,0
2115,4,2,1,42,0.046511627906976744,0.023255813953488372,0.9767441860465116,43,1300,1100,200,0.8461538461538461,15,11,4,344.74017881821317,0.8057401255075674,0.02279748100209944,0.21074839365344702,132947.67086390342,566.4807654173758,133514.15162932078,2105,0,718.9302325581396,40,3,16,33.2865260806727,0.6427083333333334,42.17479674796746,1031.3008130081273,25.782520325203183,0
2116,4,0,1,41,0.0,0.023809523809523808,0.9761904761904762,42,1350,1000,350,0.7407407407407407,17,10,7,349.35745380470865,0.7961188540456833,0.018394552327091196,0.21380330701942069,132988.2866753473,892.0898437500094,133880.3765190973,2106,1,737.047619047619,39,3,17,33.12672524069212,0.6447649572649572,42.13541666666667,1031.4583333333342,26.447649572649595,0
2117,4,0,0,41,0.0,0.0,1.0,41,1050,700,350,0.6666666666666666,14,7,7,358.5049829379435,0.796239837398374,0.023384512751053688,0.21900570223525537,132920.79863393985,1330.5537292717015,134251.35236321154,2107,2,749.3414634146342,38,3,17,32.958626882166044,0.6458333333333333,42.20085470085471,1031.1965811965829,27.136752136752182,0
2118,4,0,1,40,0.0,0.024390243902439025,0.975609756097561,41,1050,800,250,0.7619047619047619,13,8,5,359.76684336101977,0.7955792682926829,0.022897582191105936,0.22058847024364275,133058.54752218953,1374.0107248520874,134432.55824704163,2108,3,750.3414634146342,38,3,17,32.78774464119291,0.647203947368421,42.0673076923077,1031.7307692307706,27.150809716599227,0
2119,4,0,0,40,0.0,0.0,1.0,40,950,600,350,0.631578947368421,13,6,7,355.8615536836421,0.794818376068376,0.02724614429148131,0.21884013177197129,133168.79799702327,1477.9310714807648,134646.72906850404,2109,4,765.775,38,2,17,32.77783528275196,0.6483004385964912,41.96047008547009,1032.1581196581205,27.162055780476855,0
2120,4,0,0,40,0.0,0.0,1.0,40,800,600,200,0.75,10,6,4,361.2374193671174,0.794818376068376,0.03622752898627857,0.22009027734739273,132821.51870046544,1596.711093946691,134418.22979441212,2110,5,766.775,37,3,17,32.987957841364384,0.646677927927928,42.297149122807014,1030.8114035087713,27.859767662399225,1
2121,4,0,0,40,0.0,0.0,1.0,40,850,700,150,0.8235294117647058,10,7,3,362.367043371369,0.7938301282051282,0.023936848819902323,0.22161407086808155,132962.84072983984,1636.270294706052,134599.11102454588,2111,6,767.775,37,3,17,32.81681905166914,0.6480855855855856,42.16008771929824,1031.359649122806,27.87458511142719,0
2122,4,0,0,40,0.0,0.0,1.0,40,1200,1100,100,0.9166666666666666,13,11,2,360.4192295261486,0.7938301282051282,0.017420006213109795,0.22098847616089,133058.54752218936,1591.3718359631848,134649.91935815255,2112,7,768.775,38,2,17,32.77091746919334,0.647203947368421,42.06730769230769,1031.7307692307693,27.15080971659919,0
2123,4,0,0,40,0.0,0.0,1.0,40,1050,800,250,0.7619047619047619,13,8,5,360.2859641923629,0.7912126068376069,0.022981836528758848,0.22176608106498863,133203.2606336806,1598.2530381944503,134801.51367187503,2113,8,769.775,39,1,17,32.6290783720148,0.6469017094017094,41.927083333333336,1032.291666666667,26.4690170940171,0
2124,4,0,0,40,0.0,0.0,1.0,40,1250,800,450,0.64,17,8,9,356.74604707199666,0.790892094017094,0.021530159370587,0.22022293341667354,133310.812717014,1511.6210937500098,134822.433810764,2114,9,770.775,39,1,18,32.61255127429225,0.6479700854700854,41.82291666666667,1032.7083333333342,26.479700854700877,0
2125,4,0,0,40,0.0,0.0,1.0,40,800,600,200,0.75,10,6,4,355.57903818456634,0.7916933760683761,0.017981040742234722,0.21982055752108234,133364.60503472228,1484.3315972222272,134848.9366319445,2115,10,771.775,39,1,18,32.58874546187981,0.6485042735042735,41.770833333333336,1032.916666666667,26.485042735042743,0
2126,4,0,0,40,0.0,0.0,1.0,40,1400,1100,300,0.7857142857142857,17,11,6,355.4240374609779,0.7907852564102564,0.023185483870967527,0.2203629032258065,133472.2222222223,1487.8472222222326,134960.06944444453,2116,11,772.775,39,1,18,32.48487903225806,0.6495726495726495,41.66666666666667,1033.3333333333342,26.49572649572652,0
2127,4,0,0,40,0.0,0.0,1.0,40,1300,1100,200,0.8461538461538461,15,11,4,360.6085584577547,0.7902510683760684,0.03120360551431567,0.22460625536701628,133642.23246575866,1638.5065597106732,135280.73902546935,2117,12,773.775,37,3,18,32.18054082714738,0.6548423423423424,41.50219298245614,1033.991228070175,27.94570886676149,0
2128,4,0,0,40,0.0,0.0,1.0,40,1250,1000,250,0.8,15,10,5,359.66849853128383,0.790892094017094,0.030684634448575165,0.22500192117422166,133803.62426035502,1624.9897271531902,135428.6139875082,2118,13,774.775,38,2,15,32.04318979760431,0.6546052631578947,41.34615384615385,1034.6153846153845,27.226720647773277,0
2129,4,0,0,40,0.0,0.0,1.0,40,750,500,250,0.6666666666666666,10,5,5,362.31815807615453,0.7899839743589744,0.029825557390586788,0.22734056447161818,133914.18292059313,1703.908019212504,135618.09093980564,2119,14,775.775,38,2,16,31.86394680704653,0.6557017543859649,41.23931623931624,1035.0427350427346,27.237966711650913,0
2130,4,0,0,40,0.0,0.0,1.0,40,650,300,350,0.46153846153846156,10,3,7,378.1519926438054,0.7905982905982906,0.015904893813481147,0.23137774465154848,132980.61224489778,2102.762708606321,135083.3749535041,2120,15,776.775,34,6,15,32.391937903970444,0.6544117647058825,42.14285714285713,1031.42857142857,30.33613445378147,5
2131,4,0,0,40,0.0,0.0,1.0,40,900,500,400,0.5555555555555556,13,5,8,381.3218356260733,0.7900106837606837,0.02377120110764963,0.23389358452733028,133072.72002551012,2148.7067743764073,135221.42679988654,2121,16,777.775,34,6,16,32.21751086496672,0.6553308823529412,42.05357142857142,1031.7857142857138,30.34663865546217,0
2132,4,0,1,39,0.0,0.025,0.975,40,950,500,450,0.5263157894736842,14,5,9,383.4811718424804,0.7919871794871794,0.013054882970137793,0.2363846626432005,133257.03124999985,2220.312499999986,135477.34374999985,2122,17,778.775,34,6,18,31.976392251815987,0.6571691176470589,41.87499999999999,1032.4999999999989,30.367647058823497,0
2133,4,0,0,39,0.0,0.0,1.0,39,1000,800,200,0.8,12,8,4,382.9524222255993,0.7902046783625731,0.022916777468517724,0.2370371697627495,133410.72137188193,2417.991780045333,135828.71315192725,2123,18,792.0512820512821,34,5,18,31.835532380732886,0.6587009803921569,41.72619047619047,1033.095238095237,30.385154061624615,0
2134,4,0,0,39,0.0,0.0,1.0,39,950,700,250,0.7368421052631579,12,7,5,384.7634197346134,0.7894736842105263,0.019474420994807673,0.2389496430712385,133533.73724489793,2475.7794784580437,136009.51672335598,2124,19,793.0512820512821,34,5,18,31.665130922214544,0.6599264705882353,41.607142857142854,1033.5714285714282,30.399159663865536,0
2135,4,0,1,38,0.0,0.02564102564102564,0.9743589743589743,39,1050,800,250,0.7619047619047619,13,8,5,387.07477108508033,0.7880116959064328,0.021079668748062774,0.2409852607078079,133626.03635204074,2544.653486394549,136170.6898384353,2125,20,794.0512820512821,34,5,18,31.5126655152562,0.6608455882352942,41.51785714285714,1033.9285714285706,30.409663865546197,0
2136,4,0,0,38,0.0,0.0,1.0,38,1100,900,200,0.8181818181818182,13,9,4,385.7524376964587,0.7869547178757705,0.03441621782094262,0.24056219858357045,133687.5868055556,2714.0625000000055,136401.6493055556,2126,21,812.2105263157895,34,4,18,31.485025517056137,0.6614583333333333,41.458333333333336,1034.166666666667,30.416666666666675,0
2137,4,0,0,38,0.0,0.0,1.0,38,1150,700,450,0.6086956521739131,16,7,9,403.74941197249734,0.7865101944049313,0.09943267798541333,0.23888282420173984,131713.96933138292,3035.8875332218845,134749.8568646048,2127,22,813.2105263157895,35,3,14,33.01257657759235,0.6395833333333333,43.373842592592595,1026.50462962963,29.328703703703713,5
2138,4,0,0,38,0.0,0.0,1.0,38,800,400,400,0.5,12,4,8,401.76700215202703,0.7865101944049313,0.09396970613886779,0.238081167407524,131773.38023244607,2988.439187885815,134761.81942033189,2128,23,814.2105263157895,35,3,14,33.00325498816369,0.6401785714285714,43.31597222222223,1026.7361111111118,29.33531746031748,0
2139,4,1,0,39,0.02564102564102564,0.0,1.0,39,1000,700,300,0.7,13,7,6,389.9801998032075,0.7903171390013496,0.09505269781343406,0.2329672293065236,132079.4781267756,2501.6762539566753,134581.15438073227,2129,0,794.3076923076923,36,3,15,32.996229550102235,0.6412037037037037,43.018018018018026,1027.9279279279292,28.553553553553588,0
2140,4,0,0,39,0.0,0.0,1.0,39,900,800,100,0.8888888888888888,10,8,2,389.2757262504436,0.7905982905982907,0.09768250517511179,0.23272417190178799,132108.4191243609,2485.3201596867248,134593.73928404762,2130,1,795.3076923076923,36,3,15,32.98508416401944,0.6414930555555556,42.98986486486487,1028.040540540541,28.556681681681695,0
2141,4,0,0,39,0.0,0.0,1.0,39,1050,800,250,0.7619047619047619,13,8,5,389.40768279283003,0.7905420602789024,0.0945561957388501,0.2333379894530267,132195.261139518,2495.570063306561,134690.83120282457,2131,2,796.3076923076923,36,3,15,32.89394437144108,0.642361111111111,42.90540540540541,1028.3783783783792,28.56606606606609,0
2142,4,0,0,39,0.0,0.0,1.0,39,1150,900,250,0.782608695652174,14,9,5,388.6903315073866,0.7903171390013496,0.09509856751537948,0.2336233466218085,132311.09487866264,2485.608666098551,134796.7035447612,2132,3,797.3076923076923,36,3,16,32.79539732924694,0.6435185185185185,42.7927927927928,1028.8288288288304,28.57857857857862,0
2143,4,0,0,39,0.0,0.0,1.0,39,700,500,200,0.7142857142857143,9,5,4,389.9424675047944,0.7897548358074674,0.09218312052320177,0.23491655969191286,132398.00347222234,2525.5208333333517,134923.52430555568,2133,4,798.3076923076923,36,3,16,32.67543859649125,0.6443865740740741,42.70833333333334,1029.1666666666677,28.58796296296299,0
2144,4,0,0,39,0.0,0.0,1.0,39,1450,1300,150,0.896551724137931,16,13,3,388.1199383449286,0.7894174538911382,0.08668558096237611,0.23458066713803555,132520.55165816328,2486.7736678004544,135007.32532596373,2134,5,799.3076923076923,34,5,16,32.59866265849617,0.6498161764705883,42.589285714285715,1029.6428571428573,30.28361344537816,0
2145,4,0,0,39,0.0,0.0,1.0,39,1350,1000,350,0.7407407407407407,17,10,7,384.4750807880776,0.7885739991003149,0.0812148235199237,0.23346501836121877,132695.96220207473,2403.6581575788737,135099.6203596536,2135,6,800.3076923076923,35,4,14,32.51563319104322,0.6494047619047618,42.41898148148148,1030.324074074074,29.437830687830683,0
2146,4,0,0,39,0.0,0.0,1.0,39,750,400,350,0.5333333333333333,11,4,7,380.457508236955,0.788855150697256,0.07922606239913921,0.2315124411824878,132774.93709926168,2303.044345020724,135077.9814442824,2136,7,801.3076923076923,36,3,14,32.53956330128206,0.6481481481481481,42.342342342342356,1030.6306306306326,28.628628628628682,0
2147,4,0,0,39,0.0,0.0,1.0,39,1400,900,500,0.6428571428571429,19,9,10,383.65019736465666,0.7873369320737742,0.09129996640913607,0.23490881068584646,133007.1625679737,2405.6448340232437,135412.80740199692,2137,8,802.3076923076923,36,3,16,32.22343522561863,0.6504629629629628,42.11711711711713,1031.531531531534,28.653653653653723,0
2148,4,2,2,39,0.04878048780487805,0.04878048780487805,0.9512195121951219,41,850,600,250,0.7058823529411765,11,6,5,369.7583706294656,0.802439024390244,0.09135686021320955,0.2290796414066345,133444.6239339069,1668.4533430126517,135113.07727691956,2138,0,764.1219512195122,38,3,17,32.14227242960053,0.6510416666666665,41.693376068376075,1033.2264957264968,27.19017094017097,0
2149,4,1,1,39,0.025,0.025,0.975,40,950,800,150,0.8421052631578947,11,8,3,375.5915922891521,0.789823717948718,0.08941766641894033,0.2319801447719034,133330.62967691995,2015.572700253938,135346.2023771739,2139,0,784.2,37,3,17,32.10609318045086,0.6517454954954953,41.803728070175445,1032.7850877192993,27.91311047889998,0
2150,4,0,0,39,0.0,0.0,1.0,39,800,500,300,0.625,11,5,6,385.19298092943586,0.7862685560053981,0.09313992801832227,0.23751408487841302,133268.65875588442,2466.8303861293875,135735.4891420138,2140,11,805.3076923076923,36,3,17,31.92051114261824,0.6530671296296295,41.863738738738746,1032.5450450450462,28.68180680680684,0
2151,4,0,0,39,0.0,0.0,1.0,39,1150,800,350,0.6956521739130435,15,8,7,390.36500382362345,0.7846378767431399,0.09829385872982632,0.24183652330059044,133443.13221583067,2618.305763533804,136061.43797936448,2141,12,806.3076923076923,36,3,17,31.611489554950047,0.6548032407407407,41.69481981981982,1033.2207207207205,28.70057557557557,0
2152,4,0,0,39,0.0,0.0,1.0,39,1150,800,350,0.6956521739130435,15,8,7,387.82216793801246,0.7828947368421053,0.09311166623596656,0.24083810568055974,133532.0283028977,2557.3393115180884,136089.3676144158,2142,13,807.3076923076923,35,4,17,31.587812616648,0.6577380952380952,41.60879629629629,1033.564814814814,29.53042328042326,0
2153,4,0,0,39,0.0,0.0,1.0,39,1000,900,100,0.9,11,9,2,387.73503593532956,0.782051282051282,0.0888609506095237,0.24136843735263397,133621.7625412593,2561.967780135444,136183.73032139475,2143,14,808.3076923076923,35,4,18,31.499892719877604,0.6586309523809524,41.52199074074073,1033.912037037036,29.540343915343886,0
2154,4,0,0,39,0.0,0.0,1.0,39,950,700,250,0.7368421052631579,12,7,5,393.4189772301562,0.7815452091767882,0.08120776838054322,0.24239685371277372,133239.59094229373,2683.79671901632,135923.38766131006,2144,15,809.3076923076923,36,3,15,31.73742910122164,0.6527777777777778,41.891891891891895,1032.432432432433,28.678678678678693,1
2155,4,0,1,38,0.0,0.02564102564102564,0.9743589743589743,39,1450,1200,250,0.8275862068965517,17,12,5,401.31218038231304,0.7835695006747638,0.08177009029445359,0.2490200884845504,133502.9779620181,2915.6800459104934,136418.6580079286,2145,16,810.3076923076923,34,5,16,31.268479053872433,0.6596200980392157,41.63690476190476,1033.4523809523807,30.395658263305315,0
2156,4,0,1,37,0.0,0.02631578947368421,0.9736842105263158,38,1100,900,200,0.8181818181818182,13,9,4,406.1524453694064,0.7773826458036984,0.09634974533106933,0.2518145161290324,133472.22222222245,3242.013888888913,136714.23611111136,2146,17,831.578947368421,36,2,17,31.174395161290327,0.6550925925925926,41.66666666666668,1033.333333333335,28.703703703703752,0
2157,4,0,0,37,0.0,0.0,1.0,37,850,500,350,0.5882352941176471,12,5,7,413.9221806369608,0.7705205205205206,0.09680672268907564,0.25601215954157136,133382.53821855705,3641.998215663579,137024.53643422062,2147,52,854.5945945945946,35,2,17,31.064075630252105,0.65625,41.75347222222222,1032.9861111111109,29.513888888888882,0
2158,4,0,0,37,0.0,0.0,1.0,37,800,600,200,0.75,10,6,4,414.70212746836893,0.7707707707707707,0.09345307664823732,0.2567011920792412,133412.4295374656,3665.283671982155,137077.71320944774,2148,53,855.5945945945946,35,2,17,31.01379864067519,0.656547619047619,41.72453703703703,1033.1018518518508,29.517195767195737,0
2159,4,0,0,37,0.0,0.0,1.0,37,750,300,450,0.4,12,3,9,414.82097897244114,0.7695195195195195,0.0903696610477307,0.25741544449502896,133504.84206012142,3676.162043945346,137181.00410406676,2149,54,856.5945945945946,32,5,17,30.91758297699043,0.6643880208333334,41.63510101010101,1033.459595959596,32.29561237373738,0
2160,4,0,0,37,0.0,0.0,1.0,37,900,600,300,0.6666666666666666,12,6,6,413.7764965900268,0.77002002002002,0.08576162875136961,0.2574469569968951,133602.72548719522,3656.3335373941454,137259.05902458937,2150,55,857.5945945945946,32,5,18,30.84595342778048,0.6653645833333334,41.54040404040404,1033.838383838384,32.3074494949495,0
2161,4,0,0,37,0.0,0.0,1.0,37,950,600,350,0.631578947368421,13,6,7,411.2249144410904,0.7699574574574575,0.08761125149322813,0.2564912825549417,133693.92368620244,3595.654465830451,137289.5781520329,2151,56,858.5945945945946,33,4,19,30.820076430856744,0.6638257575757576,41.45220588235294,1034.1911764705883,31.339126559714796,0
2162,4,0,0,37,0.0,0.0,1.0,37,850,600,250,0.7058823529411765,11,6,5,413.0719042626539,0.7702077077077077,0.09152376838269838,0.24664334864479617,132061.2882653061,3510.1615646258483,135571.44982993195,2152,57,859.5945945945946,34,3,16,32.421241602965026,0.6452205882352942,43.035714285714285,1027.8571428571427,30.231092436974784,2
2163,4,0,0,37,0.0,0.0,1.0,37,600,300,300,0.5,9,3,6,410.33494532282225,0.769019019019019,0.08471680756931943,0.24580258375163255,132183.68055555565,3447.9166666666765,135631.59722222234,2153,58,860.5945945945946,34,3,16,32.36763911399244,0.6464460784313726,42.91666666666667,1028.3333333333342,30.245098039215712,0
2164,4,1,0,38,0.02631578947368421,0.0,1.0,38,850,700,150,0.8235294117647058,10,7,3,399.4518325761106,0.7789532954006638,0.08502769063940163,0.24126890687597077,132495.48037190078,2985.633321854905,135481.11369375567,2154,0,838.921052631579,32,6,18,32.3322909001717,0.654296875,42.61363636363636,1029.5454545454543,32.173295454545446,0
2165,4,0,0,38,0.0,0.0,1.0,38,650,400,250,0.6153846153846154,9,4,5,399.4518325761106,0.7789532954006638,0.08502769063940163,0.24126890687597077,132495.48037190078,2985.1124885215713,135480.59286042236,2155,1,839.921052631579,32,6,18,32.3322909001717,0.654296875,42.61363636363636,1029.5454545454543,32.173295454545446,0
2166,4,0,0,38,0.0,0.0,1.0,38,800,600,200,0.75,10,6,4,399.0804600955284,0.7779457088667615,0.09169667178058183,0.2418364287745431,132618.811349601,2985.115250144157,135603.92659974514,2156,2,840.921052631579,33,5,19,32.21730616696409,0.6530934343434345,42.4938725490196,1030.0245098039206,31.21286393345214,0
2167,4,1,1,38,0.02564102564102564,0.02564102564102564,0.9743589743589743,39,1200,1000,200,0.8333333333333334,14,10,4,388.282306724198,0.7848627980206928,0.08396614354355991,0.23699175888218982,132888.5363520405,2519.6534863945226,135408.18983843504,2157,0,820.3333333333334,34,5,14,32.22347304006464,0.6534926470588237,42.23214285714284,1031.0714285714262,30.32563025210077,0
2168,4,0,0,38,0.0,0.0,1.0,38,650,400,250,0.6153846153846154,9,4,5,397.99830524920054,0.7782124229492651,0.08608258069361763,0.2419933296341668,132745.069879974,2966.4625684832686,135711.53244845726,2158,4,842.921052631579,33,5,14,32.117745867522885,0.6543560606060608,42.37132352941176,1030.5147058823527,31.227718360071293,0
2169,4,0,1,37,0.0,0.02631578947368421,0.9736842105263158,38,1050,700,350,0.6666666666666666,14,7,7,397.32191194793427,0.7762268847795164,0.09105105178091843,0.24270820883589575,132919.22477324243,2962.3441043083694,135881.5688775508,2159,5,843.921052631579,34,4,14,31.959516662818444,0.6537990196078433,42.20238095238094,1031.1904761904748,30.329131652661022,0
2170,4,0,0,37,0.0,0.0,1.0,37,850,600,250,0.7058823529411765,11,6,5,398.83916826140006,0.7703953953953954,0.10478237674359137,0.24383512453412165,132949.91673752814,3205.1268424036075,136155.04357993175,2160,6,864.0,34,3,15,31.88945323021278,0.6541053921568629,42.17261904761904,1031.3095238095223,30.332633053221244,0
2171,4,0,0,37,0.0,0.0,1.0,37,1100,800,300,0.7272727272727273,14,8,6,399.9463815712017,0.7673923923923924,0.11429195009275794,0.24558691033669605,133113.66705246884,3247.6658950616934,136361.33294753052,2161,7,865.0,35,2,15,31.69582772543741,0.6535714285714287,42.01388888888887,1031.944444444442,29.484126984126917,0
2172,4,0,0,37,0.0,0.0,1.0,37,1100,700,400,0.6363636363636364,15,7,8,399.3923153522411,0.767017017017017,0.11984265045489595,0.24564004609043305,133173.39275763006,3237.685935356625,136411.0786929867,2162,8,866.0,35,2,15,31.649940195858562,0.6541666666666668,41.956018518518505,1032.1759259259238,29.49074074074068,0
2173,4,0,0,37,0.0,0.0,1.0,37,1000,800,200,0.8,12,8,4,396.8588977170836,0.7652652652652653,0.12296025294680635,0.2452609974534108,133352.6502486281,3184.4371570644525,136537.08740569255,2163,9,867.0,35,2,16,31.53481249066188,0.6559523809523811,41.7824074074074,1032.870370370369,29.510582010581974,0
2174,4,0,0,37,0.0,0.0,1.0,37,1000,600,400,0.6,14,6,8,398.8844256819964,0.7650775775775776,0.11688803175304807,0.2471090401154184,133442.324205354,3245.612970464671,136687.93717581866,2164,10,868.0,35,2,16,31.392241701206075,0.6568452380952381,41.69560185185185,1033.217592592592,29.520502645502628,0
2175,4,0,0,37,0.0,0.0,1.0,37,1000,800,200,0.8,12,8,4,398.41410938775323,0.7658283283283284,0.12862338567415144,0.24845824610562883,133687.58680555545,3252.6075156464244,136940.19432120188,2165,11,869.0,34,3,17,31.157668546870816,0.6614583333333334,41.45833333333333,1034.1666666666658,30.416666666666643,0
2176,4,0,0,37,0.0,0.0,1.0,37,1250,1000,250,0.8,15,10,5,400.83668327162115,0.7655155155155156,0.1322150593810929,0.2508042918872323,133810.73022959175,3327.2498582766325,137137.98008786837,2166,12,870.0,34,3,13,30.9712154335903,0.6626838235294118,41.33928571428571,1034.6428571428564,30.430672268907543,0
2177,4,0,0,37,0.0,0.0,1.0,37,1050,700,350,0.6666666666666666,14,7,7,402.67220957895813,0.765015015015015,0.1401265570998782,0.2530084923770679,133964.73922902494,3388.7755102040805,137353.51473922902,2167,13,871.0,34,3,14,30.76893590923029,0.6642156862745099,41.19047619047619,1035.2380952380952,30.448179271708682,0
2178,4,0,0,37,0.0,0.0,1.0,37,800,500,300,0.625,11,5,6,403.40331380244487,0.7650775775775776,0.13593681057465812,0.25389305524266775,134026.3676303856,3413.336167800466,137439.70379818606,2168,14,872.0,34,3,14,30.6880892159117,0.664828431372549,41.13095238095239,1035.4761904761913,30.455182072829157,0
2179,4,0,0,37,0.0,0.0,1.0,37,1350,1200,150,0.8888888888888888,15,12,3,380.6839275336971,0.7652652652652653,0.07694678050972592,0.23362672520654001,133092.5905901576,2742.8225211653253,135835.41311132294,2169,15,873.0,33,4,17,32.213974663499606,0.6578282828282829,42.03431372549019,1031.8627450980389,31.268568033273905,3
2180,4,0,0,37,0.0,0.0,1.0,37,1050,900,150,0.8571428571428571,12,9,3,377.3402228586949,0.7656406406406406,0.07399944168316464,0.23216484274205879,133187.4478115388,2651.396247837362,135838.84405937616,2170,16,874.0,33,4,18,32.204850805334594,0.6587752525252526,41.94240196078431,1032.2303921568623,31.27970885323825,0
2181,4,0,0,37,0.0,0.0,1.0,37,500,400,100,0.8,6,4,2,378.4714825636902,0.7659534534534534,0.0669100146906938,0.23345539619924233,133282.33882400987,2688.7128748558134,135971.0516988657,2171,17,875.0,33,4,19,32.08026742622043,0.6597222222222223,41.850490196078425,1032.5980392156855,31.29084967320259,0
2182,4,0,0,37,0.0,0.0,1.0,37,550,300,250,0.5454545454545454,8,3,5,380.19806736484014,0.7657657657657657,0.06852080296063678,0.23494290829468328,133349.23469387757,2739.824263038547,136089.05895691612,2172,18,876.0,34,3,20,31.968457046257882,0.6580882352941178,41.785714285714285,1032.857142857143,30.378151260504204,0
2183,4,0,0,37,0.0,0.0,1.0,37,850,500,350,0.5882352941176471,12,5,7,381.76378772112355,0.7640765765765766,0.07759372275501275,0.23669354838709677,133472.2222222223,2791.0289115646365,136263.25113378695,2173,19,877.0,33,4,20,31.804435483870964,0.6616161616161615,41.66666666666667,1033.3333333333342,31.31313131313134,0
2184,4,1,1,37,0.02631578947368421,0.02631578947368421,0.9736842105263158,38,850,700,150,0.8235294117647058,10,7,3,373.359834797731,0.7749229492650546,0.07436807578850413,0.23322240147789264,133749.15143140595,2387.312216553292,136136.46364795923,2174,0,854.8947368421053,34,4,15,31.743679748340817,0.6620710784313726,41.398809523809526,1034.4047619047624,30.42366946778713,0
2185,4,0,0,37,0.0,0.0,1.0,37,800,500,300,0.625,11,5,6,383.21506353250015,0.7654529529529529,0.0823113298219984,0.23840724748968806,133598.88624567466,2839.4211361014904,136438.30738177616,2175,21,879.0,33,4,22,31.639698909435747,0.662878787878788,41.54411764705882,1033.8235294117642,31.32798573975043,0
2186,4,0,0,37,0.0,0.0,1.0,37,1350,1100,250,0.8148148148148148,16,11,5,381.8024751299574,0.7639514514514515,0.08205124921153817,0.23854882994611176,133757.30075271532,2813.773698817762,136571.0744515331,2176,22,880.0,33,4,16,31.517173123247638,0.6644570707070707,41.39093137254902,1034.436274509804,31.346553773024365,0
2187,4,0,0,37,0.0,0.0,1.0,37,850,800,50,0.9411764705882353,9,8,1,381.42225391752527,0.763013013013013,0.08150357842446909,0.2389265216676249,133852.39451172634,2810.8564013840937,136663.25091311042,2177,23,881.0,33,4,17,31.431588504658137,0.6654040404040404,41.29901960784314,1034.803921568628,31.35769459298873,0
2188,4,0,0,37,0.0,0.0,1.0,37,800,700,100,0.875,9,7,2,381.2411693501046,0.7617617617617618,0.07863396595790961,0.23984412805949612,134010.95920138885,2818.0989583333235,136829.05815972216,2178,24,882.0,33,4,18,31.277246814218636,0.6669823232323233,41.14583333333333,1035.4166666666663,31.376262626262616,0
2189,4,0,0,37,0.0,0.0,1.0,37,600,400,200,0.6666666666666666,8,4,4,382.45980248420193,0.7621371371371372,0.07740008378986052,0.2410266808944063,134074.4113592127,2855.614577326017,136930.02593653873,2179,25,883.0,33,4,18,31.18208397428312,0.6676136363636365,41.084558823529406,1035.6617647058815,31.383689839572167,0
2190,4,0,0,37,0.0,0.0,1.0,37,800,600,200,0.75,10,6,4,386.1381840574484,0.7613863863863863,0.0762740034263214,0.24440003625672024,134233.10745866972,2966.5056708958064,137199.61312956552,2180,26,884.0,33,4,19,30.927743614001898,0.6691919191919191,40.931372549019606,1036.2745098039213,31.4022578728461,0
2191,4,0,0,37,0.0,0.0,1.0,37,950,500,450,0.5263157894736842,14,5,9,389.56315356759484,0.7572572572572572,0.07232548705187836,0.24764040889071534,134391.89742226552,3070.826274750102,137462.72369701564,2181,27,885.0,33,4,20,30.67985955166844,0.670770202020202,40.77818627450981,1036.8872549019613,31.42082590612004,0
2192,4,0,0,37,0.0,0.0,1.0,37,700,500,200,0.7142857142857143,9,5,4,390.8635773559339,0.7565065065065065,0.07540227535500499,0.24868327756285064,134423.66667868133,3108.26304786621,137531.92972654753,2182,28,886.0,33,4,20,30.61431497675885,0.6710858585858586,40.747549019607845,1037.009803921569,31.42453951277482,0
2193,4,0,0,37,0.0,0.0,1.0,37,1200,900,300,0.75,15,9,6,391.4452992693663,0.7549424424424425,0.07337457939867575,0.2499227679950572,134550.78125000015,3133.8541666666815,137684.63541666683,2183,29,887.0,33,4,21,30.4718875502008,0.6723484848484848,40.62500000000001,1037.5000000000011,31.439393939393973,0
2194,4,0,0,37,0.0,0.0,1.0,37,1050,800,250,0.7619047619047619,13,8,5,389.3029078559878,0.7555055055055055,0.07434881800495496,0.24974880899332627,134725.14886113995,3089.778442594512,137814.92730373447,2184,30,888.0,30,7,22,30.352904367339907,0.6819444444444445,40.456989247311824,1038.172043010752,34.60573476702507,0
2195,4,0,0,37,0.0,0.0,1.0,37,950,700,250,0.7368421052631579,12,7,5,387.2272621157966,0.7558808808808809,0.07623424779180987,0.24861112625695345,134753.4942626953,3036.0453287760415,137789.53959147134,2185,31,889.0,31,6,22,30.37841735640833,0.6794354838709677,40.4296875,1038.28125,33.492943548387096,0
2196,4,0,0,37,0.0,0.0,1.0,37,700,500,200,0.7142857142857143,9,5,4,386.14525367171353,0.7556931931931932,0.07329615903193232,0.2488422321319007,134888.72104220916,3017.3278808593705,137906.04892306853,2186,32,890.0,31,6,17,30.271266817080306,0.6807795698924732,40.299479166666664,1038.802083333333,33.509744623655905,0
2197,4,0,0,37,0.0,0.0,1.0,37,750,500,250,0.6666666666666666,10,5,5,388.43536770060376,0.7544419419419419,0.0801126859758785,0.2512553569680892,135024.01563856337,3089.6206325954913,138113.63627115887,2187,33,891.0,31,6,17,30.076526350956325,0.6821236559139785,40.169270833333336,1039.3229166666667,33.526545698924735,0
2198,4,1,1,37,0.02631578947368421,0.02631578947368421,0.9736842105263158,38,1050,600,450,0.5714285714285714,15,6,9,378.52799220097745,0.759009009009009,0.07809167422317032,0.24721297240257176,135370.76095551468,2648.3244694418836,138019.08542495657,2188,0,868.5263157894736,32,6,18,29.987917576639987,0.6829427083333334,39.83585858585858,1040.6565656565651,32.52051767676766,0
2199,4,0,0,37,0.0,0.0,1.0,37,1050,900,150,0.8571428571428571,12,9,3,385.7821059022963,0.7533783783783784,0.0851128871739657,0.24381796796382627,134179.5370313857,2952.812872992631,137132.34990437832,2189,35,893.0,31,6,18,30.990663357211684,0.6737231182795698,40.98307291666667,1036.067708333334,33.421538978494645,1
2200,4,0,0,37,0.0,0.0,1.0,37,850,600,250,0.7058823529411765,11,6,5,383.57617231888077,0.7516891891891891,0.08425913350536485,0.24309445315750725,134280.73459201385,2901.3780381944384,137182.11263020828,2190,36,894.0,31,6,19,30.9463986599665,0.674731182795699,40.885416666666664,1036.458333333333,33.434139784946225,0
2201,4,0,0,37,0.0,0.0,1.0,37,1200,1000,200,0.8333333333333334,14,10,4,382.75454008129503,0.751438938938939,0.0871760761263527,0.24347101894628062,134415.72401258672,2889.645724826379,137305.3697374131,2191,37,895.0,31,6,19,30.83249623304873,0.6760752688172043,40.75520833333333,1036.979166666666,33.450940860215034,0
2202,4,0,0,37,0.0,0.0,1.0,37,750,500,250,0.6666666666666666,10,5,5,386.56437552304186,0.7515015015015015,0.03572031779359275,0.2349033409265487,132723.0659658455,2861.2018225181278,135584.26778836365,2192,38,896.0,32,5,20,32.43449536413019,0.6565755208333333,42.392676767676775,1030.4292929292944,32.20091540404045,7
2203,4,0,0,37,0.0,0.0,1.0,37,1050,700,350,0.6666666666666666,14,7,7,385.4785428659504,0.7506881881881882,0.030065333518676685,0.2352629133814165,132885.74667125815,2844.9207988980866,135730.66747015624,2193,39,897.0,32,5,21,32.29855498408033,0.658203125,42.23484848484849,1031.060606060607,32.220643939393966,0
2204,4,0,0,37,0.0,0.0,1.0,37,800,600,200,0.75,10,6,4,386.4894675505019,0.7507507507507507,0.04647759714173372,0.23304342036511944,132431.50711059562,2839.259178645011,135270.76628924062,2194,40,898.0,31,6,22,32.73047122074635,0.65625,42.67578124999999,1029.2968749999993,33.20312499999998,3
2205,4,0,0,37,0.0,0.0,1.0,37,450,300,150,0.6666666666666666,6,3,3,384.3382614426829,0.7498748748748749,0.04765453538537345,0.23195254160044648,132465.01498752163,2782.2747124565926,135247.28969997822,2195,41,899.0,31,6,22,32.752023779408034,0.6565860215053764,42.643229166666664,1029.4270833333328,33.207325268817186,0
2206,4,0,0,37,0.0,0.0,1.0,37,1100,900,200,0.8181818181818182,13,9,4,385.2867612854983,0.7505005005005005,0.05522698130274439,0.23331730599894673,132592.9931416439,2817.264979338866,135410.25812098276,2196,42,900.0,32,5,22,32.598535000612976,0.6552734375,42.518939393939405,1029.9242424242439,32.18513257575762,0
2207,4,0,0,37,0.0,0.0,1.0,37,1350,1000,350,0.7407407407407407,17,10,7,387.7324826989619,0.7490615615615616,0.0631359300476948,0.23540900735294126,132690.54178145094,2889.6866391184676,135580.22842056942,2197,43,901.0,32,5,19,32.43719362745098,0.65625,42.42424242424243,1030.303030303031,32.19696969696972,0
2208,4,0,0,37,0.0,0.0,1.0,37,850,500,350,0.5882352941176471,12,5,7,387.8724459013725,0.7483108108108109,0.06205519328911069,0.23569821526441576,132723.06596584545,2895.924044740349,135618.9900105858,2198,44,902.0,32,5,19,32.40079851325409,0.6565755208333333,42.392676767676775,1030.429292929294,32.20091540404044,0
2209,4,0,0,37,0.0,0.0,1.0,37,700,500,200,0.7142857142857143,9,5,4,390.40951851883347,0.7465590590590591,0.06688717383314957,0.2376519686554243,132788.1262913224,2968.349690082657,135756.47598140506,2199,45,903.0,32,5,19,32.269845644983455,0.6572265625,42.32954545454546,1030.681818181819,32.20880681818184,0
2210,4,0,0,37,0.0,0.0,1.0,37,950,600,350,0.631578947368421,13,6,7,390.19130365479236,0.7466841841841841,0.06318444853476679,0.23772550768938258,132820.66243240502,2965.093485358654,135785.7559177637,2200,46,904.0,32,5,20,32.24267107626981,0.6575520833333333,42.29797979797981,1030.808080808082,32.21275252525256,0
2211,4,0,0,37,0.0,0.0,1.0,37,800,500,300,0.625,11,5,6,399.8143024322861,0.7456831831831832,0.07217779388776857,0.2317036252333118,130920.20083922053,3068.7537545655528,133988.9545937861,2201,47,905.0,33,4,18,33.91896679040435,0.6360479797979798,44.14828431372549,1023.4068627450984,31.01232917409389,6
2212,4,0,0,37,0.0,0.0,1.0,37,950,700,250,0.7368421052631579,12,7,5,405.00219295830914,0.743993993993994,0.08085793104340433,0.23586085899321194,131108.39468293454,3219.837472366407,134328.23215530094,2202,48,906.0,33,4,18,33.59496529855212,0.6379419191919191,43.96446078431373,1024.1421568627457,31.034610814022596,0
2213,4,0,0,37,0.0,0.0,1.0,37,1000,700,300,0.7,13,7,6,404.8559268189747,0.7444944944944945,0.07941673587972753,0.23693562743086677,131296.72369100826,3231.2513516436,134527.97504265184,2203,49,907.0,33,4,20,33.407444497588585,0.6398358585858586,43.78063725490196,1024.8774509803923,31.05689245395128,0
2214,4,0,0,37,0.0,0.0,1.0,37,900,900,0,1.0,9,9,0,406.2024203828436,0.7450575575575575,0.07420201879012378,0.2385227661553921,131425.20732897156,3277.0512178346085,134702.25854680617,2204,50,908.0,32,5,20,33.24251939416328,0.6435546875,43.65530303030303,1025.378787878788,32.043087121212125,0
2215,4,1,1,37,0.02631578947368421,0.02631578947368421,0.9736842105263158,38,1000,700,300,0.7,13,7,6,397.7594601029549,0.752963489805595,0.06431910722364664,0.2352848331795445,131705.23356401385,2877.4005190311427,134582.63408304498,2205,0,885.078947368421,33,5,16,33.17514326647565,0.6439393939393939,43.38235294117647,1026.4705882352941,31.10516934046346,0
2216,4,1,0,38,0.02631578947368421,0.0,1.0,38,1050,900,150,0.8571428571428571,12,9,3,394.67446254813865,0.7564307728781413,0.08310216275245708,0.23540114103333507,132019.90370290278,2820.976907920035,134840.88061082282,2206,0,886.0526315789474,33,5,18,32.93584545671357,0.6470959595959596,43.075980392156865,1027.6960784313728,31.142305407011296,0
2217,4,1,0,39,0.02564102564102564,0.0,1.0,39,1400,1200,200,0.8571428571428571,16,12,4,379.21313432893976,0.7639451192082771,0.09386798360978421,0.22000502894468446,130962.30867346934,2140.470170911496,133102.77884438084,2207,0,864.3076923076923,34,5,18,34.4033496161898,0.6341911764705883,44.107142857142854,1023.5714285714282,30.105042016806713,3
2218,4,1,0,40,0.025,0.0,1.0,40,950,500,450,0.5263157894736842,14,5,9,374.7769185008924,0.7699786324786325,0.11504065040650424,0.21951219512195105,131328.12499999988,1844.2602040816184,133172.3852040815,2208,0,843.675,34,6,19,34.14634146341463,0.6378676470588236,43.74999999999999,1024.999999999999,30.147058823529385,0
2219,4,0,0,40,0.0,0.0,1.0,40,1000,600,400,0.6,14,6,8,347.05231482223206,0.7685363247863248,-0.030547150781643717,0.2143940000911172,133337.70751953125,1255.0320095486113,134592.73952907987,2209,1,844.675,39,1,16,32.835875777441586,0.6482371794871795,41.796875,1032.8125,26.482371794871796,8
2220,4,0,0,40,0.0,0.0,1.0,40,950,700,250,0.7368421052631579,12,7,5,345.6365346482635,0.7673076923076924,-0.027560742010283468,0.21413921219088872,133445.31385633687,1224.715169270839,134670.0290256077,2210,2,845.675,39,1,17,32.76466461672883,0.6493055555555556,41.692708333333336,1033.2291666666672,26.493055555555568,0
2221,4,0,1,39,0.0,0.025,0.975,40,1350,800,550,0.5925925925925926,19,8,11,340.81426906078116,0.7672809829059829,-0.025619962802231666,0.21225228416796926,133637.87187705465,1109.1414371969636,134747.0133142516,2211,3,846.675,38,2,18,32.69657987187436,0.6529605263157894,41.50641025641026,1033.9743589743598,27.209851551956838,0
2222,4,0,0,39,0.0,0.0,1.0,39,1000,900,100,0.9,11,9,2,347.8032596350406,0.7606275303643725,-0.01314269090750897,0.21679659891725508,133670.57802641203,1498.2125509772327,135168.79057738927,2212,5,869.3076923076923,37,2,19,32.483189304775046,0.6551238738738738,41.47478070175439,1034.100877192983,27.94867235656711,0
2223,4,0,0,39,0.0,0.0,1.0,39,1350,1100,250,0.8148148148148148,16,11,5,344.99528241447206,0.7606275303643725,-0.006946267611796397,0.20629309744375554,132116.0357032932,1315.881809787611,133431.9175130808,2213,6,870.3076923076923,37,2,17,34.11547212741752,0.6396396396396395,42.98245614035087,1028.0701754385955,27.785680417259336,2
2224,4,0,0,39,0.0,0.0,1.0,39,750,600,150,0.8,9,6,3,345.0007259084261,0.7613585245164193,-0.004653057430539009,0.20675794302205275,132200.59447378034,1321.860211795928,133522.45468557626,2214,7,871.3076923076923,37,2,17,34.03025820094538,0.6404842342342343,42.90021929824561,1028.399122807017,27.794570886676134,0
2225,4,0,0,39,0.0,0.0,1.0,39,800,700,100,0.875,9,7,2,345.6412727710822,0.7613022941970311,-0.00146520146520146,0.20729636436015025,132228.78674207442,1340.7452293013157,133569.53197137572,2215,8,872.3076923076923,37,2,17,33.985429992892676,0.6407657657657657,42.872807017543856,1028.508771929824,27.797534376481728,0
2226,4,0,0,39,0.0,0.0,1.0,39,650,600,50,0.9230769230769231,7,6,1,346.2387393395312,0.760233918128655,-0.0011150648541391472,0.207964907329288,132285.18029586007,1360.4508117882242,133645.6311076483,2216,9,873.3076923076923,37,2,18,33.91334470262205,0.6413288288288289,42.81798245614034,1028.728070175437,27.803461356092896,0
2227,4,0,0,39,0.0,0.0,1.0,39,950,600,350,0.631578947368421,13,6,7,349.095956259371,0.7601214574898786,-0.0015957330535332215,0.20999464445755994,132341.58587257605,1439.9824946137126,133781.56836718976,2217,10,874.3076923076923,37,2,19,33.78312375674908,0.6418918918918919,42.763157894736835,1028.9473684210516,27.809388335704096,0
2228,4,1,0,40,0.025,0.0,1.0,40,450,300,150,0.6666666666666666,6,3,3,341.89108693837056,0.766426282051282,0.0017275368333677932,0.20672185043362687,132535.4812714587,1062.5399499598043,133598.02122141852,2218,0,853.425,38,2,20,33.773647713910215,0.6419956140350878,42.57478632478632,1029.7008547008536,27.09739091318036,0
2229,4,0,0,40,0.0,0.0,1.0,40,950,500,450,0.5263157894736842,14,5,9,341.89108693837056,0.766426282051282,0.0017275368333677932,0.20672185043362687,132535.4812714587,1062.5399499598043,133598.02122141852,2219,1,854.425,38,2,20,33.773647713910215,0.6419956140350878,42.57478632478632,1029.7008547008536,27.09739091318036,0
2230,4,0,1,39,0.0,0.025,0.975,40,1000,700,300,0.7,13,7,6,337.99477081816633,0.7650641025641025,3.888024883380581e-05,0.2054164816976188,132728.0700402694,972.2787228796644,133700.34876314906,2220,2,855.425,38,2,13,33.680663556246756,0.6439144736842106,42.387820512820504,1030.4487179487166,27.117071524966228,0
2231,4,0,0,39,0.0,0.0,1.0,39,1150,600,550,0.5217391304347826,17,6,11,346.62997455702816,0.75787224471435,-0.0008133076786618343,0.21023812853216764,132652.03145438962,1396.2340575946232,134048.26551198424,2221,3,878.025641025641,37,2,13,33.53457069363137,0.6449887387387389,42.461622807017534,1030.1535087719283,27.84198672356563,0
2232,4,0,1,38,0.0,0.02564102564102564,0.9743589743589743,39,650,500,150,0.7692307692307693,8,5,3,345.81801699626374,0.7588843904633379,0.0005021231074870958,0.2099034940372667,132680.27181440426,1376.6456986764965,134056.91751308076,2222,4,879.025641025641,37,2,13,33.52712147012911,0.6452702702702704,42.43421052631578,1030.2631578947355,27.84495021337123,0
2233,4,1,1,38,0.02564102564102564,0.02564102564102564,0.9743589743589743,39,800,500,300,0.625,11,5,6,346.2014498839465,0.7576473234367972,0.0018977194647125106,0.21140769056549572,132906.3029008927,1402.470952600813,134308.77385349353,2223,0,879.8974358974359,37,2,14,33.29035516801362,0.6475225225225224,42.21491228070176,1031.140350877194,27.86865813181605,0
2234,4,0,0,38,0.0,0.0,1.0,38,950,400,550,0.42105263157894735,15,4,11,353.81289378601906,0.7510668563300142,0.0006729939603105084,0.21496600120465326,132716.91243608494,1791.3909686713966,134508.30340475633,2224,18,904.0526315789474,36,2,14,33.284380692167574,0.6475694444444443,42.39864864864866,1030.405405405407,28.622372372372418,0
2235,4,0,0,38,0.0,0.0,1.0,38,550,500,50,0.9090909090909091,6,5,1,352.26591634823234,0.7508594120436226,0.00320068557362152,0.2141917209636333,132745.92318247329,1752.3728542732247,134498.2960367465,2225,19,905.0526315789474,36,2,14,33.295086147233455,0.6478587962962962,42.37049549549551,1030.5180180180203,28.625500500500564,0
2236,4,1,1,38,0.02564102564102564,0.02564102564102564,0.9743589743589743,39,900,600,300,0.6666666666666666,12,6,6,346.235388492537,0.7640013495276653,-0.004583718262111347,0.2122298873176732,133047.6700162551,1413.1623432210006,134460.8323594761,2226,0,882.8205128205128,37,2,14,33.14767332695645,0.6489301801801801,42.077850877192986,1031.688596491229,27.883475580844028,0
2237,4,0,0,38,0.0,0.0,1.0,38,600,400,200,0.6666666666666666,8,4,4,354.5629086305579,0.7503556187766715,-0.007589821994103074,0.21659323244363052,132920.05423920558,1825.7042092768622,134745.75844848243,2227,21,907.0526315789474,36,2,15,33.06100069163846,0.6495949074074073,42.201576576576585,1031.193693693695,28.644269269269305,0
2238,4,0,0,38,0.0,0.0,1.0,38,600,300,300,0.5,9,3,6,354.5629086305579,0.7503556187766715,-0.007589821994103074,0.21659323244363052,132920.05423920558,1825.7042092768622,134745.75844848243,2228,22,908.0526315789474,36,2,15,33.06100069163846,0.6495949074074073,42.201576576576585,1031.193693693695,28.644269269269305,0
2239,4,0,0,38,0.0,0.0,1.0,38,800,600,200,0.75,10,6,4,353.95515913121403,0.7489331436699858,-0.004901172144335053,0.21672655465520885,133007.16256797352,1815.7142784676744,134822.87684644118,2229,23,909.0526315789474,36,2,16,32.98921943231439,0.6504629629629629,42.117117117117125,1031.5315315315327,28.653653653653684,0
2240,4,0,0,38,0.0,0.0,1.0,38,950,600,350,0.631578947368421,13,6,7,359.1052209116919,0.7486960644855382,-0.006914930276367581,0.22056570002913842,133123.35139193246,1961.0581020209372,135084.4094939534,2230,24,910.0526315789474,36,2,16,32.73975156409137,0.6516203703703705,42.0045045045045,1031.9819819819818,28.66616616616616,0
2241,4,0,0,38,0.0,0.0,1.0,38,1000,700,300,0.7,13,7,6,361.4184280273805,0.7480144618302513,-0.008739402219148262,0.2228544429443881,133268.65875588416,2033.1498305738044,135301.80858645795,2231,25,911.0526315789474,36,2,17,32.53421856254771,0.6530671296296298,41.86373873873873,1032.5450450450442,28.681806806806783,0
2242,4,1,0,39,0.02564102564102564,0.0,1.0,39,900,600,300,0.6666666666666666,12,6,6,355.2447462183905,0.7542735042735043,-0.004803677606204815,0.22111878068007046,133617.71981018162,1693.5539424559406,135311.27375263756,2232,0,888.6666666666666,36,3,18,32.34374432705223,0.656539351851852,41.525900900900886,1033.8963963963947,28.719344344344297,0
2243,4,0,0,39,0.0,0.0,1.0,39,1200,800,400,0.6666666666666666,16,8,8,353.01651334239835,0.7530364372469636,-0.0025183150183152314,0.22025160723753948,133705.05640775888,1640.0185658631312,135345.07497362202,2233,1,889.6666666666666,36,3,14,32.31389735772356,0.6574074074074076,41.44144144144143,1034.2342342342324,28.72872872872868,0
2244,4,0,1,38,0.0,0.02564102564102564,0.9743589743589743,39,1100,800,300,0.7272727272727273,14,8,6,348.91289877423384,0.7521367521367521,-0.0021541921639864903,0.21855218996840026,133850.68081172367,1540.4458089846344,135391.1266207083,2234,2,890.6666666666666,36,3,14,32.2743225595821,0.6588541666666667,41.30067567567566,1034.7972972972957,28.744369369369323,0
2245,4,0,0,38,0.0,0.0,1.0,38,850,400,450,0.47058823529411764,13,4,9,356.72751783497375,0.7431839734471314,-0.010342552890731493,0.2226059426936676,133711.52692043866,1939.716220850447,135651.2431412891,2235,29,915.0526315789474,35,3,14,32.211466726350345,0.6595238095238096,41.43518518518517,1034.2592592592569,29.550264550264483,0
2246,4,0,0,38,0.0,0.0,1.0,38,1150,1000,150,0.8695652173913043,13,10,3,360.0738705463718,0.7431247036510195,-0.008512892970681918,0.2254243979470983,133831.2596450617,2037.8279320987622,135869.08757716048,2236,30,916.0526315789474,35,3,14,32.00503355704698,0.6607142857142857,41.31944444444444,1034.7222222222222,29.563492063492063,0
2247,4,0,0,38,0.0,0.0,1.0,38,1150,900,250,0.782608695652174,14,9,5,364.42603412125703,0.7420874822190612,0.00215008853305676,0.22945247904876054,134040.92084887257,2169.6002389831906,136210.52108785577,2237,31,917.0526315789474,35,3,15,31.682523937260154,0.662797619047619,41.116898148148145,1035.5324074074072,29.586640211640205,0
2248,4,0,0,38,0.0,0.0,1.0,38,650,300,350,0.46153846153846156,10,3,7,367.4427140226584,0.740990990990991,0.0012408115260216235,0.23191906138947774,134130.8258852024,2257.078939471885,136387.90482467428,2238,32,918.0526315789474,35,3,16,31.514432029795152,0.663690476190476,41.030092592592595,1035.87962962963,29.59656084656086,0
2249,4,0,0,38,0.0,0.0,1.0,38,750,600,150,0.8,9,6,3,366.8151271974454,0.7414355144618302,0.0024484589111561927,0.23209157836033417,134220.76106234995,2246.841108324762,136467.6021706747,2239,33,919.0526315789474,35,3,17,31.440694925350922,0.6645833333333333,40.94328703703704,1036.2268518518517,29.606481481481477,0
2250,4,0,0,38,0.0,0.0,1.0,38,1100,900,200,0.8181818181818182,13,9,4,369.6778312186045,0.7401019440493125,0.00911270137836162,0.23486340511037326,134370.72000385824,2334.775270061749,136705.49527391998,2240,34,920.0526315789474,35,3,18,31.216510381781635,0.6660714285714284,40.79861111111112,1036.8055555555572,29.62301587301592,0
2251,4,0,0,38,0.0,0.0,1.0,38,1000,700,300,0.7,13,7,6,369.7968509675169,0.7390647226173542,0.011373848078515492,0.23551880465671085,134460.7355565202,2344.63131751545,136805.36687403565,2241,35,921.0526315789474,35,3,18,31.12340977569469,0.6669642857142856,40.711805555555564,1037.1527777777787,29.632936507936535,0
2252,4,0,0,38,0.0,0.0,1.0,38,1000,800,200,0.8,12,8,4,367.89729197916137,0.739153627311522,0.010885647854575797,0.2348882710328494,134550.78125000015,2300.173611111126,136850.95486111127,2242,36,922.0526315789474,35,3,19,31.082663989290484,0.6678571428571427,40.62500000000001,1037.5000000000011,29.642857142857174,0
2253,4,0,0,38,0.0,0.0,1.0,38,1350,1000,350,0.7407407407407407,17,10,7,366.313847789464,0.739805595068753,0.012488849241748534,0.234650184783994,134670.88906035677,2266.3623113854746,136937.25137174226,2243,37,923.0526315789474,35,3,21,31.003754088611377,0.6690476190476189,40.50925925925927,1037.9629629629637,29.656084656084676,0
2254,4,0,0,38,0.0,0.0,1.0,38,1150,800,350,0.6956521739130435,15,8,7,371.6968357429356,0.7387980085348507,0.012168083196959056,0.23908499692626276,134821.0991753474,2422.5151909722413,137243.61436631964,2244,38,924.0526315789474,35,3,15,30.714017051153448,0.6705357142857142,40.36458333333334,1038.541666666668,29.67261904761909,0
2255,4,0,0,38,0.0,0.0,1.0,38,900,700,200,0.7777777777777778,11,7,4,368.1556971445905,0.737968231389284,0.011847674432237776,0.23779149992547743,134971.39301483217,2338.0974579904205,137309.4904728226,2245,39,925.0526315789474,35,3,15,30.655955298136202,0.6720238095238094,40.21990740740742,1039.1203703703718,29.68915343915348,0
2256,4,0,0,38,0.0,0.0,1.0,38,1000,700,300,0.7,13,7,6,368.4128550949644,0.7372866287339972,0.007795100222717233,0.23835356186979728,135031.53399348448,2349.4705932784946,137381.00458676298,2246,40,926.0526315789474,35,3,15,30.589272457312553,0.6726190476190474,40.16203703703705,1039.351851851854,29.695767195767257,0
2257,4,0,0,38,0.0,0.0,1.0,38,1100,900,200,0.8181818181818182,13,9,4,350.002716161159,0.7371088193456614,0.0001455767077267467,0.21308455517583505,132793.26331178815,1695.6005694059622,134488.86388119412,2247,41,927.0526315789474,37,1,16,33.3058510638298,0.6463963963963963,42.32456140350877,1030.7017543859643,27.856804172593627,6
2258,4,0,0,38,0.0,0.0,1.0,38,750,600,150,0.8,9,6,3,351.6556525158128,0.7359530583214794,-0.006120666976384914,0.21457612593161518,132878.03849501783,1745.4626663973647,134623.5011614152,2248,42,928.0526315789474,37,1,16,33.178130206671625,0.6472409909909909,42.242324561403514,1031.0307017543869,27.865694642010457,0
2259,4,0,0,38,0.0,0.0,1.0,38,1400,1200,200,0.8571428571428571,16,12,4,338.07036286547094,0.7366642958748222,-0.041073040543192274,0.2038192996928821,132426.21678064394,1355.2013600338485,133781.4181406778,2249,43,929.0526315789474,37,1,21,33.98172561343703,0.6427364864864864,42.680921052631575,1029.2763157894728,27.818278805120887,3
2260,4,0,0,38,0.0,0.0,1.0,38,1000,700,300,0.7,13,7,6,361.0303635286285,0.7371088193456614,-0.04102909979023417,0.2116244824469266,131357.78523930462,1918.6442824495507,133276.42952175418,2250,44,930.0526315789474,35,3,19,34.4686171013511,0.6360119047619048,43.72106481481481,1025.11574074074,29.289021164021143,3
2261,4,0,0,38,0.0,0.0,1.0,38,750,600,150,0.8,9,6,3,356.6774300718354,0.7364272166903746,-0.03634387968603714,0.20954223730542781,131443.5782911289,1776.591540865184,133220.1698319941,2251,45,931.0526315789474,36,2,19,34.49351160407057,0.634837962962963,43.637387387387385,1025.45045045045,28.484734734734722,0
2262,4,1,0,39,0.02564102564102564,0.0,1.0,39,1050,800,250,0.7619047619047619,13,8,5,348.8708409490829,0.7409469185784976,-0.030497219888795724,0.20744546293911117,131903.67408366187,1403.4691403681595,133307.14322403003,2252,0,908.1538461538462,38,1,16,34.22971918876756,0.6356907894736843,43.189102564102555,1027.2435897435882,27.0327260458839,0
2263,4,0,0,39,0.0,0.0,1.0,39,1150,800,350,0.6956521739130435,15,8,7,348.4660336011693,0.7410031488978858,-0.03624393624393585,0.20795553618134258,132040.8950617281,1402.3533950617016,133443.24845678982,2253,1,909.1538461538462,38,1,17,34.10191441441441,0.637061403508772,43.05555555555554,1027.7777777777756,27.046783625730935,0
2264,4,1,1,39,0.025,0.025,0.975,40,1050,900,150,0.8571428571428571,12,9,3,343.2429472775336,0.7516292735042736,-0.04408474233066739,0.20634270178090083,132317.6120334202,1083.4174262152817,133401.0294596355,2254,0,887.4,39,1,18,33.95778492119739,0.6380876068376069,42.786458333333336,1028.8541666666672,26.380876068376082,0
2265,4,0,0,39,0.0,0.0,1.0,39,700,600,100,0.8571428571428571,8,6,2,349.6024267262308,0.74055330634278,-0.04555090388077543,0.20984863868579465,132260.59701219946,1447.72513514499,133708.32214734444,2255,3,911.1538461538462,38,1,19,33.851570073397035,0.6392543859649124,42.841880341880334,1028.6324786324776,27.069275753486252,0
2266,4,0,0,39,0.0,0.0,1.0,39,1700,1600,100,0.9411764705882353,18,16,2,349.45389857579573,0.7406657669815565,-0.034905443938251235,0.21084017993763296,132454.43309479833,1457.4149449388005,133911.84803973712,2256,4,912.1538461538462,37,2,19,33.66043530748474,0.6430180180180181,42.65350877192982,1029.38596491228,27.82124229492649,0
2267,4,0,0,39,0.0,0.0,1.0,39,950,600,350,0.631578947368421,13,6,7,350.9792305750078,0.7414529914529915,-0.030183899008430548,0.2123967096366288,132567.32840874133,1505.6757848568964,134073.00419359823,2257,5,913.1538461538462,37,2,19,33.507683844406586,0.6441441441441441,42.543859649122815,1029.8245614035102,27.833096254148924,0
2268,4,0,0,39,0.0,0.0,1.0,39,1150,900,250,0.782608695652174,14,9,5,350.88452613527943,0.7415654520917679,-0.03221977554211253,0.2131391009756445,132708.5151801516,1513.0728926208042,134221.5880727724,2258,6,914.1538461538462,37,2,16,33.36825139228833,0.6455518018018017,42.406798245614034,1030.372807017544,27.84791370317686,0
2269,4,0,0,39,0.0,0.0,1.0,39,800,300,500,0.375,13,3,10,350.5692303605875,0.7391475483580747,-0.02161024113800125,0.21375174473736988,132849.77709487543,1514.608821945222,134364.38591682067,2259,7,915.1538461538462,37,2,17,33.23450684251578,0.6469594594594594,42.26973684210527,1030.9210526315796,27.862731152204855,0
2270,4,0,0,39,0.0,0.0,1.0,39,500,200,300,0.4,8,2,6,350.20916233037434,0.7374606387764283,-0.021341621341621098,0.21401671031300668,132934.57031250012,1510.9809027777922,134445.5512152779,2260,8,916.1538461538462,37,2,18,33.15867003367004,0.647804054054054,42.18750000000001,1031.250000000001,27.871621621621646,0
2271,4,0,0,39,0.0,0.0,1.0,39,850,700,150,0.8235294117647058,10,7,3,346.88782799444624,0.7359986504723347,-0.01808415837536881,0.21262980935503228,133047.67001625506,1430.5234543321103,134478.19347058717,2261,9,917.1538461538462,37,2,18,33.130845467105964,0.6489301801801801,42.077850877192986,1031.6885964912285,27.883475580844014,0
2272,4,0,0,39,0.0,0.0,1.0,39,950,600,350,0.631578947368421,13,6,7,343.43737119485684,0.7353801169590644,-0.0155981090560533,0.21163653711850594,133245.71021852875,1352.3112880886354,134598.0215066174,2262,10,918.1538461538462,37,2,18,33.021364344378355,0.6509009009009008,41.8859649122807,1032.456140350877,27.90422000948316,0
2273,4,0,0,39,0.0,0.0,1.0,39,900,500,400,0.5555555555555556,13,5,8,342.4207094568798,0.7356612685560054,-0.013972153704581158,0.2113314706202422,133302.32018505695,1329.0950100030752,134631.41519506002,2263,11,919.1538461538462,37,2,18,32.99090394280454,0.651463963963964,41.83114035087719,1032.6754385964914,27.91014698909436,0
2274,4,0,0,39,0.0,0.0,1.0,39,1000,600,400,0.6,14,6,8,343.2717849304247,0.7346491228070176,-0.009776304437168593,0.21234166026457843,133387.25767784307,1357.6164060095302,134744.8740838526,2264,12,920.1538461538462,37,2,18,32.88387202349361,0.6523085585585586,41.748903508771924,1033.0043859649115,27.919037458511124,0
2275,4,0,0,39,0.0,0.0,1.0,39,1250,1000,250,0.8,15,10,5,334.8176972091301,0.7350989653621233,-0.03527446443803106,0.2052312516638897,133047.6700162552,1109.3428987765694,134157.01291503178,2265,13,921.1538461538462,37,2,18,33.44216087434018,0.6489301801801801,42.07785087719299,1031.6885964912296,27.883475580844046,2
2276,4,0,0,39,0.0,0.0,1.0,39,1200,800,400,0.6666666666666666,16,8,8,338.55704772753603,0.7349302744039586,-0.03741982924139042,0.20847054312326724,133217.40974386365,1220.3385897584074,134437.74833362206,2266,14,922.1538461538462,37,2,19,33.17567268543106,0.6506193693693693,41.913377192982466,1032.3464912280715,27.90125651967761,0
2277,4,0,0,39,0.0,0.0,1.0,39,1050,600,450,0.5714285714285714,15,6,9,336.25718679011857,0.7345366621682411,-0.036202939038237125,0.20736960890651915,133274.0136989267,1162.8689837257716,134436.88268265247,2267,15,923.1538461538462,37,2,19,33.178360942975466,0.6511824324324323,41.85855263157895,1032.565789473685,27.907183499288784,0
2278,4,1,1,39,0.025,0.025,0.975,40,1100,800,300,0.7272727272727273,14,8,6,328.0476722890436,0.7418803418803419,-0.03088691337605942,0.20369275877562332,133527.4273595589,760.6723464095419,134288.09970596846,2268,0,901.05,38,2,19,33.13693060436911,0.6518640350877192,41.61324786324787,1033.5470085470097,27.198605488079203,0
2279,4,0,0,39,0.0,0.0,1.0,39,1300,1100,200,0.8461538461538461,15,11,4,335.5037747398492,0.7339181286549707,-0.03175406379650392,0.20817136780270426,133500.54974848023,1157.987674092025,134658.53742257226,2269,17,925.1538461538462,37,2,19,32.97115384615387,0.6534346846846846,41.63925438596491,1033.4429824561398,27.93089141773351,0
2280,4,0,0,39,0.0,0.0,1.0,39,1050,600,450,0.5714285714285714,15,6,9,336.0542170582088,0.7327372919478183,-0.03655933277314127,0.20915215925028702,133613.88991083787,1180.3022324176582,134794.19214325552,2270,18,926.1538461538462,37,2,19,32.84359864955632,0.6545608108108107,41.52960526315789,1033.8815789473679,27.942745376955887,0
2281,4,0,0,39,0.0,0.0,1.0,39,1250,1100,150,0.88,14,11,3,338.7237981458502,0.7322312190733243,-0.03911241558300371,0.2117865497353276,133783.99032635032,1263.1642668898012,135047.15459324012,2271,19,927.1538461538462,37,2,18,32.60455308249426,0.65625,41.36513157894736,1034.5394736842097,27.96052631578945,0
2282,4,0,0,39,0.0,0.0,1.0,39,1050,700,350,0.6666666666666666,14,7,7,354.7445614536259,0.7327935222672065,-0.031846795918651916,0.22150433697835153,133734.1749477516,1700.9934685928051,135435.16841634442,2272,20,928.1538461538462,36,3,16,32.24006532389767,0.6576967592592593,41.41328828828828,1034.3468468468452,28.731856856856812,2
2283,4,0,2,37,0.0,0.05128205128205128,0.9487179487179487,39,1000,600,400,0.6,14,6,8,357.5225540360802,0.7340305892937472,-0.034669948896573266,0.22359153872903087,133792.4215389373,1766.7616518545274,135559.18319079184,2273,21,929.1538461538462,36,3,16,32.10991074344182,0.6582754629629631,41.35698198198197,1034.57207207207,28.73811311311305,0
2284,4,0,0,37,0.0,0.0,1.0,37,1100,700,400,0.6363636363636364,15,7,8,359.87012644874414,0.7271646646646647,-0.019537822541740413,0.22523751510974496,133821.54959013048,2231.675594513413,136053.2251846439,2274,22,958.8108108108108,36,1,17,32.02002612102743,0.6585648148148149,41.32882882882882,1034.6846846846831,28.741241241241198,0
2285,4,0,0,37,0.0,0.0,1.0,37,750,400,350,0.5333333333333333,11,4,7,360.6448794107232,0.7262887887887888,-0.020286445313649093,0.22607956628816828,133879.81520371727,2256.613961934905,136136.42916565217,2275,23,959.8108108108108,36,1,18,31.94164853101196,0.6591435185185186,41.27252252252252,1034.9099099099103,28.74749749749751,0
2286,4,0,0,37,0.0,0.0,1.0,37,1050,900,150,0.8571428571428571,12,9,3,365.6629811019589,0.7262887887887888,0.009646587867446543,0.21844055572635385,132079.4781267757,2259.3151428455794,134338.7932696213,2276,24,960.8108108108108,36,1,18,33.62113825591586,0.6412037037037035,43.01801801801803,1027.92792792793,28.553553553553613,3
2287,4,0,0,37,0.0,0.0,1.0,37,750,500,250,0.6666666666666666,10,5,5,363.27046711190013,0.7267892892892893,0.008010420058612633,0.2173433397596104,132137.36329234665,2200.320337229142,134337.6836295758,2277,25,961.8108108108108,36,1,18,33.62426980649871,0.6417824074074073,42.96171171171172,1028.153153153155,28.559809809809863,0
2288,4,0,0,37,0.0,0.0,1.0,37,1200,900,300,0.75,15,9,6,363.1418227892882,0.7279779779779779,0.008784079743344053,0.2175991552304321,132195.26113951812,2201.125618862131,134396.38675838025,2278,26,962.8108108108108,36,1,18,33.56922543437,0.6423611111111109,42.90540540540542,1028.3783783783801,28.566066066066114,0
2289,4,1,0,38,0.02631578947368421,0.0,1.0,38,650,500,150,0.7692307692307693,8,5,3,357.1985029156015,0.7400130393551446,0.01215748593669952,0.21552155215521576,132455.95838659626,1862.769357195057,134318.72774379133,2279,0,938.4473684210526,36,2,19,33.45959595959597,0.6449652777777777,42.65202702702704,1029.3918918918935,28.594219219219262,0
2290,4,0,1,37,0.0,0.02631578947368421,0.9736842105263158,38,1100,800,300,0.7272727272727273,14,8,6,354.4763661167848,0.7410798956851589,0.012512011415879876,0.21487046526641695,132629.89921932074,1802.8329427400472,134432.7321620608,2280,1,939.4473684210526,36,2,18,33.354742902955444,0.6467013888888888,42.48310810810811,1030.0675675675682,28.612987987988006,0
2291,4,0,1,36,0.0,0.02702702702702703,0.972972972972973,37,550,400,150,0.7272727272727273,7,4,3,354.5913777785084,0.7411786786786787,0.021614531015493155,0.2151062283765118,132658.9004545087,2007.9404573492607,134666.84091185796,2281,2,954.2702702702703,36,1,19,33.3226297186999,0.6469907407407407,42.454954954954964,1030.1801801801814,28.61611611611615,0
2292,4,0,0,36,0.0,0.0,1.0,36,1000,700,300,0.7,13,7,6,360.648353324954,0.7408399470899472,0.03369272237196741,0.21934514603861952,132755.59413580244,2375.617283950609,135131.21141975306,2282,3,969.3333333333334,35,1,19,33.06940700808625,0.65,42.36111111111111,1030.5555555555552,29.444444444444436,0
2293,4,1,0,37,0.02702702702702703,0.0,1.0,37,900,500,400,0.5555555555555556,13,5,8,354.8667751002584,0.7465590590590591,0.02761098068823986,0.2179624079771294,133123.35139193258,2048.2108797987285,135171.5622717313,2283,0,944.1081081081081,36,1,20,32.849101556816535,0.6516203703703705,42.00450450450451,1031.9819819819827,28.666166166166185,0
2294,4,0,1,36,0.0,0.02702702702702703,0.972972972972973,37,1050,900,150,0.8571428571428571,12,9,3,353.09219117539584,0.7461211211211212,0.027083044646042165,0.21738053166587332,133210.52629910313,2007.119323715604,135217.64562281873,2284,1,945.1081081081081,36,1,20,32.807443365695796,0.6524884259259259,41.92004504504504,1032.3198198198197,28.675550550550547,0
2295,4,0,0,36,0.0,0.0,1.0,36,1100,600,500,0.5454545454545454,16,6,10,360.02992071486244,0.741005291005291,0.03631406761177791,0.22217189589201153,133297.7297398751,2398.234213943684,135695.96395381878,2285,2,950.5833333333334,36,0,21,32.54089422028354,0.6533564814814814,41.83558558558559,1032.6576576576583,28.684934934934954,0
2296,4,1,0,37,0.02702702702702703,0.0,1.0,37,1150,900,250,0.782608695652174,14,9,5,357.37671807637935,0.7490615615615616,0.046432287255921745,0.2230110581515731,133711.52692043898,2157.305600770938,135868.8325212099,2286,0,925.8648648648649,35,2,17,32.194680692330635,0.6595238095238095,41.43518518518518,1034.2592592592594,29.550264550264554,0
2297,4,0,0,37,0.0,0.0,1.0,37,1000,800,200,0.8,12,8,4,358.4407929940337,0.7476851851851852,0.04823080155891457,0.22421989143272686,133801.3214404363,2191.970352151913,135993.29179258822,2287,1,926.8648648648649,35,2,18,32.07725043815491,0.6604166666666667,41.348379629629626,1034.6064814814808,29.560185185185166,0
2298,4,0,0,37,0.0,0.0,1.0,37,1100,700,400,0.6363636363636364,15,7,8,358.1303428691795,0.7472472472472472,0.052476142398969916,0.22438986654473259,133861.20119866685,2187.9515764317566,136049.1527750986,2288,2,927.8648648648649,35,2,18,32.02533739701003,0.6610119047619047,41.29050925925926,1034.837962962963,29.566798941798943,0
2299,4,0,0,37,0.0,0.0,1.0,37,750,600,150,0.8,9,6,3,356.810847544906,0.7466841841841841,0.046275057345168236,0.2239269761118664,133921.0943528164,2156.899836033959,136077.99418885037,2289,3,928.8648648648649,35,2,19,31.999538745387447,0.6616071428571428,41.23263888888889,1035.069444444445,29.573412698412714,0
2300,4,0,0,37,0.0,0.0,1.0,37,950,600,350,0.631578947368421,13,6,7,359.8927999041183,0.7457457457457457,0.04845350547820648,0.22659823228305068,134040.9208488728,2248.0724612054414,136288.99331007825,2290,4,929.8648648648649,35,2,19,31.79988171081555,0.6627976190476189,41.11689814814816,1035.532407407409,29.58664021164026,0
2301,4,1,1,37,0.02631578947368421,0.02631578947368421,0.9736842105263158,38,1200,800,400,0.6666666666666666,16,8,8,353.0328807628486,0.7537932669511617,0.0561652068424392,0.22469616327422767,134437.044330948,1892.1394082794777,136329.18373922748,2291,0,906.3684210526316,37,1,20,31.581729752590405,0.6627252252252251,40.73464912280702,1037.0614035087722,28.028686581318166,0
2302,4,1,0,38,0.02631578947368421,0.0,1.0,38,950,600,350,0.631578947368421,13,6,7,382.4457808484859,0.7664177335229967,0.07640780663530466,0.23442556039110116,133047.6700162549,2582.0061220760176,135629.67613833092,2292,0,847.5,37,1,15,32.21372710525385,0.6489301801801801,42.07785087719298,1031.6885964912274,27.88347558084398,5
2303,4,0,0,38,0.0,0.0,1.0,38,1600,1400,200,0.875,18,14,4,388.6554219201623,0.7641358463726885,0.08243453185948524,0.23986610508807885,133302.32018505677,2761.7338988919496,136064.05408394872,2293,1,848.5,37,1,17,31.797267643519493,0.6514639639639641,41.831140350877185,1032.67543859649,27.910146989094326,0
2304,4,0,1,37,0.0,0.02631578947368421,0.9736842105263158,38,950,600,350,0.631578947368421,13,6,7,387.91026005111763,0.7645507349454718,0.08233322158900425,0.2397713024725413,133358.94217451525,2746.260387811636,136105.2025623269,2294,2,849.5,37,1,17,31.75955414012738,0.652027027027027,41.776315789473685,1032.8947368421054,27.916073968705554,0
2305,4,0,0,37,0.0,0.0,1.0,37,1150,700,450,0.6086956521739131,16,7,9,394.11648278891937,0.7568193193193193,0.09288974941575501,0.24339678543146004,133326.80389426593,3109.258202459222,136436.06209672516,2295,3,873.3783783783783,36,1,17,31.631637771235418,0.6536458333333334,41.807432432432435,1032.7702702702707,28.688063063063073,0
2306,4,0,0,37,0.0,0.0,1.0,37,800,400,400,0.5,12,4,8,391.66601578451065,0.7568193193193193,0.08614478238456447,0.24264251821896615,133443.13221583085,3053.0279857560413,136496.1602015869,2296,4,874.3783783783783,36,1,17,31.57788374205269,0.6548032407407407,41.69481981981983,1033.2207207207218,28.700575575575606,0
2307,4,0,0,37,0.0,0.0,1.0,37,750,500,250,0.6666666666666666,10,5,5,392.78883394867773,0.7561936936936937,0.09053877783867126,0.2437371770926561,133503.88259623686,3087.776385719785,136591.65898195663,2297,5,875.3783783783783,33,4,17,31.487781137594364,0.6619318181818183,41.636029411764696,1033.4558823529399,31.316844919786057,0
2308,4,0,0,37,0.0,0.0,1.0,37,1000,800,200,0.8,12,8,4,393.57092691857844,0.7555680680680681,0.08756943471969403,0.24502964159769555,133626.03635204077,3118.264597505661,136744.30094954642,2298,6,876.3783783783783,34,3,17,31.344751487238533,0.6608455882352942,41.51785714285714,1033.9285714285709,30.409663865546204,0
2309,4,0,0,37,0.0,0.0,1.0,37,1000,600,400,0.6,14,6,8,393.54423566033216,0.7550675675675675,0.08336781584162734,0.2454213047509911,133687.5868055556,3122.3958333333385,136809.98263888893,2299,7,877.3783783783783,34,3,18,31.28357507386517,0.6614583333333333,41.458333333333336,1034.166666666667,30.416666666666675,0
2310,4,0,0,37,0.0,0.0,1.0,37,1200,900,300,0.75,15,9,6,387.64019638755025,0.7541291291291291,0.07458733901686943,0.24268230782245787,133831.25964506168,2975.6751543209853,136806.93479938267,2300,8,878.3783783783783,35,2,15,31.291946308724846,0.6607142857142857,41.31944444444444,1034.722222222222,29.563492063492056,0
2311,4,0,0,37,0.0,0.0,1.0,37,700,600,100,0.8571428571428571,8,6,2,389.86824865656496,0.7550675675675675,0.07405459803983772,0.24467310510425674,133921.0943528163,3042.3165027006116,136963.4108555169,2301,9,879.3783783783783,35,2,15,31.144121100301916,0.6616071428571428,41.232638888888886,1035.0694444444441,29.57341269841269,0
2312,4,0,1,36,0.0,0.02702702702702703,0.972972972972973,37,1150,600,550,0.5217391304347826,17,6,11,390.65403209184524,0.7560685685685685,0.07131486018263722,0.245966335336083,134040.92084887257,3072.725238983191,137113.64608785577,2302,10,880.3783783783783,35,2,15,31.003525390261167,0.662797619047619,41.116898148148145,1035.5324074074072,29.586640211640205,0
2313,4,0,1,35,0.0,0.027777777777777776,0.9722222222222222,36,1250,1000,250,0.8,15,10,5,399.7563303539612,0.743452380952381,0.07325845855054669,0.2511763763553504,133964.7392290251,3510.6505102040956,137475.38973922917,2303,17,905.5555555555555,34,2,15,30.84440164060105,0.6642156862745097,41.1904761904762,1035.2380952380963,30.448179271708714,0
2314,4,0,0,35,0.0,0.0,1.0,35,750,500,250,0.6666666666666666,10,5,5,407.82992607525387,0.7432072829131652,0.07509856009204574,0.25524893001136917,133820.6928374905,3915.2166534506077,137735.9094909411,2304,18,918.6571428571428,33,2,15,30.78030617079238,0.6650883838383839,41.329656862745104,1034.6813725490204,31.35398098633395,0
2315,4,0,0,35,0.0,0.0,1.0,35,600,400,200,0.6666666666666666,8,4,4,406.8863376404493,0.7427170868347338,0.07551382897741732,0.2550968909705712,133884.09994052764,3895.1222186178347,137779.22215914546,2305,19,919.6571428571428,33,2,15,30.740946319321093,0.665719696969697,41.268382352941174,1034.926470588235,31.36140819964348,0
2316,4,1,1,35,0.027777777777777776,0.027777777777777776,0.9722222222222222,36,600,400,200,0.6666666666666666,8,4,4,398.4305501309053,0.7554563492063493,0.07831590639243213,0.2518185241677028,134180.50063775506,3492.322137188203,137672.82277494326,2306,0,895.0833333333334,34,2,16,30.662080125627174,0.666360294117647,40.982142857142854,1036.0714285714282,30.472689075630242,0
2317,4,0,0,35,0.0,0.0,1.0,35,750,500,250,0.6666666666666666,10,5,5,408.3575273895113,0.7416666666666666,0.08388525449228346,0.25734746189177937,134074.41135921286,3950.059021770476,138024.47038098334,2307,21,921.6571428571428,33,2,16,30.511551887350606,0.6676136363636364,41.08455882352941,1035.6617647058827,31.383689839572202,0
2318,4,0,0,35,0.0,0.0,1.0,35,700,400,300,0.5714285714285714,10,4,6,406.44480589309745,0.7425070028011204,0.07758722649319938,0.2570299800917082,134201.36072964725,3909.0892024702016,138110.44993211745,2308,22,922.6571428571428,33,2,17,30.433545239503257,0.6688762626262627,40.96200980392157,1036.1519607843136,31.398544266191323,0
2319,4,0,0,35,0.0,0.0,1.0,35,750,400,350,0.5333333333333333,11,4,7,401.206022766854,0.7425070028011204,0.06539601583069787,0.23821089872055362,131847.23816609953,3579.5812074829682,135426.8193735825,2309,23,923.6571428571428,34,1,15,32.94284417139986,0.643075980392157,43.244047619047606,1027.0238095238076,30.206582633053163,5
2320,4,1,1,35,0.027777777777777776,0.027777777777777776,0.9722222222222222,36,850,500,350,0.5882352941176471,12,5,7,389.84409365084855,0.7482142857142857,0.06376227099355991,0.23356471827968903,132189.63162562152,3106.6694262259875,135296.30105184752,2310,0,898.9722222222222,35,1,15,32.88841211780153,0.6443452380952381,42.910879629629626,1028.356481481481,29.381613756613746,0
2321,4,0,0,35,0.0,0.0,1.0,35,1150,700,450,0.6086956521739131,16,7,9,400.4085123732241,0.7428571428571428,0.06756555546364473,0.2392752598161101,132091.88102324263,3578.1427154195,135670.02373866213,2311,25,925.6571428571428,34,1,16,32.71569195136074,0.6455269607843137,43.00595238095238,1027.9761904761906,30.234593837535016,0
2322,4,0,0,35,0.0,0.0,1.0,35,1000,700,300,0.7,13,7,6,397.42342892661173,0.7419467787114845,0.06385582010581992,0.23845405735596695,132244.89795918367,3511.4441609977275,135756.3421201814,2312,26,926.6571428571428,34,1,16,32.63768325617283,0.6470588235294117,42.857142857142854,1028.5714285714284,30.25210084033613,0
2323,4,2,2,35,0.05405405405405406,0.05405405405405406,0.9459459459459459,37,900,600,300,0.6666666666666666,12,6,6,384.5147884714584,0.766016016016016,0.05084869235812639,0.2338606336441166,132755.59413580253,2809.3864166036847,135564.98055240622,2313,0,877.5135135135135,35,2,15,32.454514824797855,0.6499999999999999,42.361111111111114,1030.5555555555559,29.444444444444454,0
2324,4,0,0,35,0.0,0.0,1.0,35,850,800,50,0.9411764705882353,9,8,1,398.6954580160128,0.7415266106442576,0.06540717941741603,0.24079371263785224,132492.61289227704,3564.840596164938,136057.45348844197,2314,28,928.6571428571428,33,2,16,32.354655199777795,0.651830808080808,42.61642156862745,1029.5343137254904,31.198009506833042,0
2325,4,0,0,35,0.0,0.0,1.0,35,1200,900,300,0.75,15,9,6,402.1090113476932,0.7408963585434173,0.06464948663901549,0.24346715643847397,132587.25610342197,3662.9060938101,136250.16219723207,2315,29,929.6571428571428,33,2,16,32.171188323020786,0.6527777777777777,42.52450980392158,1029.9019607843154,31.209150326797438,0
2326,4,0,0,35,0.0,0.0,1.0,35,800,400,400,0.5,12,4,8,398.0521796045257,0.7400560224089635,0.0665794792533585,0.24243424204588476,132808.221672554,3572.9204212322365,136381.14209378624,2316,30,930.6571428571428,33,2,16,32.05264435461499,0.6549873737373737,42.31004901960785,1030.75980392157,31.23514557338091,0
2327,4,0,0,35,0.0,0.0,1.0,35,1250,1000,250,0.8,15,10,5,395.5653453859386,0.7394957983193277,0.07547528517110247,0.2419388042709347,132966.16685890054,3519.361543637076,136485.52840253763,2317,31,931.6571428571428,33,2,16,31.957481780735105,0.6565656565656566,42.156862745098046,1031.3725490196089,31.253713606654813,0
2328,4,0,0,35,0.0,0.0,1.0,35,600,300,300,0.5,9,3,6,395.80809792183527,0.7393557422969187,0.0809693513898786,0.2424972757136835,133029.37121539802,3530.820477700895,136560.19169309892,2318,32,932.6571428571428,33,2,16,31.8875227686703,0.6571969696969696,42.09558823529412,1031.6176470588243,31.261140819964375,0
2329,4,1,0,36,0.027777777777777776,0.0,1.0,36,950,800,150,0.8421052631578947,11,8,3,386.61894044465095,0.7444775132275133,0.07865834133845673,0.2387131180325516,133318.49666950124,3108.6911848072687,136427.18785430852,2319,0,907.7222222222222,34,2,17,31.833573487031693,0.657781862745098,41.8154761904762,1032.738095238096,30.374649859944004,0
2330,4,2,2,36,0.05263157894736842,0.05263157894736842,0.9473684210526316,38,700,500,200,0.7142857142857143,9,5,4,367.494974911651,0.7604907539118065,0.06585536342489107,0.2296468598325461,133763.29665814465,2231.467869896928,135994.7645280416,2320,0,860.8947368421053,36,2,15,31.88116880760578,0.6579861111111112,41.38513513513514,1034.4594594594598,28.734984984984994,0
2331,4,0,0,36,0.0,0.0,1.0,36,800,600,200,0.75,10,6,4,385.05682097372875,0.7424933862433863,0.07960872403332964,0.238933399776479,133502.97796201822,3081.2464569161093,136584.22441893432,2321,2,909.7222222222222,34,2,18,31.68845755097338,0.6596200980392157,41.636904761904766,1033.4523809523816,30.395658263305343,0
2332,4,0,0,36,0.0,0.0,1.0,36,900,600,300,0.6666666666666666,12,6,6,388.3718231255308,0.7427910052910054,0.08456164593889137,0.24159175587550916,133595.26643990926,3176.9274376417156,136772.19387755098,2322,3,910.7222222222222,34,2,18,31.510056809458,0.6605392156862746,41.547619047619044,1033.8095238095234,30.406162464985982,0
2333,4,0,0,36,0.0,0.0,1.0,36,450,200,250,0.4444444444444444,7,2,5,385.7524376964589,0.7425595238095238,0.08413913510609738,0.24056219858357042,133687.58680555547,3114.06249999999,136801.64930555547,2323,4,911.7222222222222,34,2,18,31.485025517056147,0.6614583333333334,41.45833333333333,1034.166666666666,30.41666666666665,0
2334,4,1,1,36,0.02702702702702703,0.02702702702702703,0.972972972972973,37,1250,900,350,0.72,16,9,7,378.0833896740607,0.7508758758758759,0.07634999184295,0.23785752489621279,134010.9592013888,2733.463541666657,136744.42274305545,2324,0,888.0540540540541,35,2,15,31.358987256874578,0.6625,41.14583333333333,1035.4166666666658,29.58333333333331,0
2335,4,0,0,36,0.0,0.0,1.0,36,1250,900,350,0.72,16,9,7,371.4335353346765,0.7403439153439154,0.07255322955806065,0.23299012670993344,133903.125,2748.3072916666674,136651.43229166666,2325,6,913.7222222222222,34,2,17,31.639157273215247,0.6636029411764706,41.25,1035.0,30.441176470588236,1
2336,4,0,0,36,0.0,0.0,1.0,36,1200,800,400,0.6666666666666666,16,8,8,371.0859469725023,0.739649470899471,0.07435653890565064,0.2340273530272673,134100.85419077933,2752.58849344136,136853.44268422067,2326,7,914.7222222222222,35,1,17,31.45009218907141,0.6633928571428571,41.05902777777778,1035.763888888889,29.59325396825397,0
2337,4,0,0,36,0.0,0.0,1.0,36,650,600,50,0.9230769230769231,7,6,1,358.2987256822393,0.739649470899471,0.06690974583742637,0.20445739702255594,130321.66950660152,2138.8176225994544,132460.48712920098,2327,8,915.7222222222222,35,1,19,35.587640746618305,0.6255952380952381,44.7337962962963,1021.064814814815,29.173280423280428,7
2338,4,1,1,36,0.02702702702702703,0.02702702702702703,0.972972972972973,37,450,300,150,0.6666666666666666,6,3,3,348.71655700506193,0.7494369369369369,0.05578140123594699,0.20016462712339886,130550.14209733374,1704.9992137407576,132255.1413110745,2328,0,891.9459459459459,36,1,17,35.600780532598705,0.6258680555555556,44.51013513513513,1021.9594594594588,28.387762762762744,0
2339,4,1,1,36,0.02702702702702703,0.02702702702702703,0.972972972972973,37,1000,800,200,0.8,12,8,4,352.00510594194253,0.7458708708708709,0.07570662492485858,0.2031073934030953,130751.61944038619,1805.0475306387311,132556.6669710249,2329,0,892.918918918919,36,1,18,35.312752330617336,0.6278935185185186,44.313063063063055,1022.7477477477466,28.409659659659628,0
2340,4,1,1,36,0.02702702702702703,0.02702702702702703,0.972972972972973,37,850,600,250,0.7058823529411765,11,6,5,353.8346513761566,0.7518768768768769,0.07787781178339093,0.20492641663831307,130895.62694028478,1863.0817050158148,132758.7086453006,2330,0,893.6216216216217,36,1,18,35.12022669747993,0.6293402777777779,44.17229729729729,1023.31081081081,28.42530030030028,0
2341,4,0,0,36,0.0,0.0,1.0,36,800,600,200,0.75,10,6,4,358.3345823209306,0.7413359788359789,0.11069422987321897,0.20371568287279018,130176.38204082473,2129.3398973297717,132305.7219381545,2331,2,919.4444444444445,36,0,21,35.73415544765688,0.6221064814814814,44.87612612612613,1020.4954954954965,28.347097097097123,2
2342,4,0,0,36,0.0,0.0,1.0,36,1300,900,400,0.6923076923076923,17,9,8,362.31226771836646,0.7418981481481483,0.11626403221075665,0.20709948142420223,130387.71896626311,2248.2996290618876,132636.018595325,2332,3,920.4444444444445,33,3,21,35.41816654667627,0.6306818181818181,44.66911764705883,1021.3235294117659,30.949197860962602,0
2343,4,0,0,36,0.0,0.0,1.0,36,1350,1100,250,0.8148148148148148,16,11,5,360.03012605432514,0.7431878306878308,0.10314409236823052,0.20658413115309665,130536.16780045342,2199.3905895691496,132735.55839002258,2333,4,921.4444444444445,34,2,15,35.325897017707355,0.6299019607843137,44.52380952380952,1021.9047619047611,30.056022408963564,0
2344,4,1,0,37,0.02702702702702703,0.0,1.0,37,400,300,100,0.75,5,3,2,350.19017080974186,0.7526901901901902,0.10828545481786844,0.2024415251659455,130824.41332572438,1762.684729723931,132587.09805544832,2334,0,897.5135135135135,35,2,16,35.28550081080062,0.6306547619047619,44.241898148148145,1023.0324074074068,29.229497354497337,0
2345,4,0,0,37,0.0,0.0,1.0,37,1150,800,350,0.6956521739130435,15,8,7,349.18677786370495,0.7518143143143143,0.1054500044599056,0.20268887680594372,130982.06948502557,1747.4413602791988,132729.51084530476,2335,1,898.5135135135135,36,1,17,35.1517235056839,0.6302083333333334,44.08783783783784,1023.6486486486486,28.434684684684683,0
2346,4,0,0,37,0.0,0.0,1.0,37,900,700,200,0.7777777777777778,11,7,4,349.4977590098701,0.7516266266266266,0.10297680806975706,0.2030213499781934,131010.89000740602,1757.6024926953942,132768.49250010142,2336,2,899.5135135135135,36,1,17,35.11462802038646,0.6304976851851851,44.05968468468468,1023.761261261261,28.437812812812805,0
2347,4,0,0,37,0.0,0.0,1.0,37,850,500,350,0.5882352941176471,12,5,7,349.38147420903965,0.7503128128128128,0.09797965988861157,0.20341069951709365,131097.3705969481,1760.5985208180964,132857.96911776622,2337,3,900.5135135135135,36,1,18,35.03019390074042,0.6313657407407408,43.975225225225216,1024.0990990990977,28.447197197197156,0
2348,4,0,0,37,0.0,0.0,1.0,37,1000,500,500,0.5,15,5,10,350.9127017278416,0.7503753753753754,0.10029356533314315,0.20460909839207994,131155.04017531045,1804.7938986283586,132959.8340739388,2338,4,901.5135135135135,36,1,18,34.932708516564055,0.6319444444444444,43.91891891891892,1024.3243243243244,28.453453453453456,0
2349,4,0,0,37,0.0,0.0,1.0,37,750,500,250,0.6666666666666666,10,5,5,353.6341720601054,0.7493743743743744,0.10211398341962163,0.2066613571981309,131241.56832085463,1882.3006706030355,133123.86899145765,2339,5,902.5135135135135,36,1,18,34.77557057552113,0.6328125,43.83445945945946,1024.662162162162,28.462837837837835,0
2350,4,0,0,37,0.0,0.0,1.0,37,1100,700,400,0.6363636363636364,15,7,8,353.4940954105027,0.7503128128128128,0.10212255537972359,0.20720262398723815,131356.9835671821,1886.7836163866664,133243.76718356877,2340,6,903.5135135135135,36,1,19,34.66256545461205,0.6339699074074073,43.72184684684685,1025.112612612613,28.47535035035036,0
2351,4,1,0,38,0.02631578947368421,0.0,1.0,38,900,400,500,0.4444444444444444,14,4,10,345.09768202925125,0.7575865339023233,0.10414124316025686,0.20377092783039535,131637.38031173073,1485.5509627962672,133122.93127452699,2341,0,880.7105263157895,37,1,14,34.5949309042989,0.6348536036036034,43.44846491228071,1026.2061403508787,27.735301090564292,0
2352,4,0,0,38,0.0,0.0,1.0,38,650,200,450,0.3076923076923077,11,2,9,347.33789548036447,0.7583274063537222,0.0828315161398736,0.19762471206217502,130208.06081753586,1445.238763788432,131653.2995813243,2342,1,881.7105263157895,38,0,18,35.9825883666562,0.6186951754385965,44.845085470085465,1020.6196581196572,26.85841205578045,4
2353,4,0,0,38,0.0,0.0,1.0,38,1850,1700,150,0.918918918918919,20,17,3,346.85129219000413,0.757201280227596,0.08456306072179154,0.19848075172248628,130430.54112803933,1448.0117605346147,131878.55288857393,2343,2,882.7105263157895,37,1,20,35.76955417203378,0.6227477477477478,44.62719298245614,1021.4912280701749,27.607871028923647,0
2354,4,0,0,38,0.0,0.0,1.0,38,650,400,250,0.6153846153846154,9,4,5,345.4051689615046,0.7575272641062115,0.0839241228540919,0.19779594094740852,130458.54403518376,1412.2110889888995,131870.75512417266,2344,3,883.7105263157895,37,1,20,35.77812511180278,0.6230292792792793,44.599780701754376,1021.6008771929813,27.610834518729224,0
2355,4,0,0,38,0.0,0.0,1.0,38,850,600,250,0.7058823529411765,11,6,5,344.3635076969904,0.7582681365576103,0.08802606172156424,0.1979134783447188,130598.60365689419,1394.6786511233981,131993.2823080176,2345,4,884.7105263157895,37,1,12,35.662947865264975,0.624436936936937,44.4627192982456,1022.1491228070156,27.62565196775718,0
2356,4,2,2,38,0.05,0.05,0.95,40,1250,1000,250,0.8,15,10,5,333.35198855159376,0.7745192307692308,0.08614332214423759,0.19403098871821875,131088.00048828113,739.6891276041513,131827.6896158853,2346,0,841.425,39,1,13,35.45004323059709,0.6258012820512822,43.98437499999999,1024.062499999999,26.258012820512796,0
2357,4,0,0,38,0.0,0.0,1.0,38,800,400,400,0.5,12,4,8,346.49766768815573,0.7573198198198198,0.09010664776567157,0.20079256858952443,130917.7889751806,1472.541707758031,132390.33068293863,2347,6,886.7105263157895,38,0,15,35.28552040922852,0.6258223684210528,44.150641025641015,1023.3974358974343,26.931511470985114,0
2358,4,1,2,37,0.02564102564102564,0.05128205128205128,0.9487179487179487,39,600,200,400,0.3333333333333333,10,2,8,346.5113039194353,0.7620332883490778,0.10968530639161944,0.20253307763847192,131248.05908203113,1295.7872178819296,132543.84629991307,2348,0,864.9487179487179,39,0,16,34.95147995662633,0.6274038461538463,43.82812499999999,1024.687499999999,26.27403846153844,0
2359,4,1,0,38,0.02631578947368421,0.0,1.0,38,650,500,150,0.7692307692307693,8,5,3,351.24467776143,0.753615457562826,0.12848926334802857,0.20604803679541372,131387.4488275891,1629.901667256079,133017.3504948452,2349,0,886.6842105263158,35,3,18,34.68945209603372,0.6363095238095239,43.692129629629626,1025.231481481481,29.29232804232803,0
2360,4,0,0,38,0.0,0.0,1.0,38,800,600,200,0.75,10,6,4,351.24467776143,0.753615457562826,0.12848926334802857,0.20604803679541372,131387.4488275891,1629.828425068579,133017.2772526577,2350,1,887.6842105263158,35,3,18,34.68945209603372,0.6363095238095239,43.692129629629626,1025.231481481481,29.29232804232803,0
2361,4,0,0,38,0.0,0.0,1.0,38,950,700,250,0.7368421052631579,12,7,5,347.1977189029367,0.753615457562826,0.13144871323008966,0.19570665841132776,129843.17440221987,1416.2507935133817,131259.42519573326,2351,2,888.6842105263158,37,1,16,36.35635198135198,0.6168355855855856,45.20285087719298,1019.1885964912277,27.545637743006154,3
2362,4,0,0,38,0.0,0.0,1.0,38,1100,700,400,0.6363636363636364,15,7,8,347.50452154462636,0.7533191085822665,0.13743570300873076,0.19672182318238396,130010.85820877572,1435.8722154893721,131446.7304242651,2352,3,889.6842105263158,37,1,16,36.17834551840303,0.6185247747747749,45.03837719298245,1019.8464912280698,27.563418681839725,0
2363,4,0,0,38,0.0,0.0,1.0,38,700,200,500,0.2857142857142857,12,2,10,348.53674747831747,0.7532894736842105,0.1415011087477942,0.1977308474718453,130094.74068944271,1468.5595567866865,131563.3002462294,2353,4,890.6842105263158,37,1,17,36.06692462023502,0.6193693693693694,44.956140350877185,1020.1754385964897,27.57230915125648,0
2364,4,3,1,40,0.07317073170731707,0.024390243902439025,0.975609756097561,41,900,600,300,0.6666666666666666,12,6,6,326.77661637347717,0.7848577235772358,0.14097824170749051,0.1891530172443529,130874.74093967021,353.4692089753628,131228.21014864556,2354,0,826.439024390244,39,2,16,35.83352421188367,0.62366452991453,44.192708333333336,1023.2291666666673,26.236645299145316,0
2365,4,0,0,40,0.0,0.0,1.0,40,1100,1000,100,0.9090909090909091,12,10,2,334.62743552097083,0.7714476495726496,0.1490837422992588,0.19363909063349474,130863.12601587041,758.0784525896715,131621.20446846008,2355,1,848.1,38,2,16,35.6444258814521,0.6252741228070176,44.20405982905983,1023.1837606837606,26.925888439046332,0
2366,4,0,0,40,0.0,0.0,1.0,40,1000,800,200,0.8,12,8,4,334.46312289545244,0.772676282051282,0.14827001356852132,0.19409395399523505,130972.46334876552,761.0918209876673,131733.55516975318,2356,2,849.1,38,2,16,35.53821800090457,0.6263706140350876,44.09722222222223,1023.6111111111119,26.937134502923996,0
2367,4,1,1,40,0.024390243902439025,0.024390243902439025,0.975609756097561,41,1000,600,400,0.6,14,6,8,326.80222111620617,0.7804878048780488,0.14316842629753634,0.19127942020002114,131301.43364800356,381.92003038195435,131683.35367838552,2357,0,829.3658536585366,39,2,17,35.4025857980147,0.6279380341880341,43.77604166666667,1024.8958333333342,26.279380341880362,0
2368,4,0,0,40,0.0,0.0,1.0,40,850,500,350,0.5882352941176471,12,5,7,334.43634452028226,0.7714476495726496,0.14196903346887724,0.1954648982507024,131246.00643080208,778.6869247205767,132024.69335552267,2358,1,850.525,38,2,17,35.26287665519759,0.6291118421052632,43.830128205128204,1024.6794871794868,26.965249662618074,0
2369,4,1,0,41,0.024390243902439025,0.0,1.0,41,400,300,100,0.75,5,3,2,329.3026754040793,0.7791158536585366,0.14198208195141748,0.1938220827677211,131515.04041883696,461.6509331597416,131976.6913519967,2359,0,830.7560975609756,39,2,19,35.12332436275007,0.6300747863247862,43.56770833333334,1025.729166666668,26.3007478632479,0
2370,4,0,1,40,0.0,0.024390243902439025,0.975609756097561,41,1100,700,400,0.6363636363636364,15,7,8,328.1551122261109,0.7789634146341463,0.1447570383133796,0.1938239907465016,131648.63281250012,440.2343750000141,132088.86718750012,2360,1,831.7560975609756,39,2,14,35.01827040194885,0.6314102564102564,43.43750000000001,1026.250000000001,26.314102564102587,0
2371,4,0,0,40,0.0,0.0,1.0,40,1000,600,400,0.6,14,6,8,332.7304875145917,0.7695245726495726,0.14218213058419238,0.1961455415348449,131574.6348002958,755.7784763313505,132330.41327662717,2361,4,853.525,38,2,14,34.97539831302716,0.6324013157894737,43.50961538461538,1025.9615384615379,26.998987854251,0
2372,4,0,0,40,0.0,0.0,1.0,40,500,100,400,0.2,9,1,8,331.1211254989368,0.7688568376068377,0.14248906933166783,0.19561805237040505,131656.8560979619,718.873274161742,132375.72937212363,2362,5,854.525,38,2,14,34.93389548199042,0.6332236842105262,43.42948717948718,1026.2820512820515,27.00742240215925,0
2373,4,0,0,40,0.0,0.0,1.0,40,850,600,250,0.7058823529411765,11,6,5,332.40087028151993,0.7682959401709402,0.14624570714954732,0.19679851894855963,131739.10307774483,758.038502629842,132497.14158037468,2363,6,855.525,38,2,14,34.81826933083567,0.634046052631579,43.34935897435897,1026.6025641025635,27.015856950067462,0
2374,4,0,1,39,0.0,0.025,0.975,40,800,500,300,0.625,11,5,6,332.11206322360573,0.7679220085470085,0.1492898761835395,0.19691110670216386,131793.94866544308,754.0720423332584,132548.02070777633,2364,7,856.525,38,2,14,34.77048867616964,0.6345942982456141,43.29594017094017,1026.8162393162395,27.0214799820063,0
2375,4,0,0,39,0.0,0.0,1.0,39,1700,1300,400,0.7647058823529411,21,13,8,338.8018388463663,0.7568600989653621,0.14781232718452508,0.20109112944455398,131834.36850761747,1133.1452947060413,132967.51380232352,2365,11,879.3076923076923,37,2,15,34.55806463093459,0.6368243243243243,43.25657894736841,1026.9736842105244,27.75604551920336,0
2376,4,0,0,39,0.0,0.0,1.0,39,950,600,350,0.631578947368421,13,6,7,337.02044352524473,0.7577035537561854,0.14594144824717015,0.2003304260751581,131890.67790089254,1089.9709526007969,132980.64885349333,2366,12,880.3076923076923,37,2,15,34.54712852263024,0.6373873873873874,43.20175438596491,1027.19298245614,27.761972498814597,0
2377,4,0,0,39,0.0,0.0,1.0,39,700,400,300,0.5714285714285714,10,4,6,339.54645961076574,0.7577035537561854,0.14386445909228995,0.20228161939049494,131975.16453379884,1162.3399747999406,133137.5045085988,2367,13,881.3076923076923,37,2,15,34.39723170775086,0.6382319819819819,43.11951754385965,1027.5219298245613,27.770862968231388,0
2378,4,0,0,39,0.0,0.0,1.0,39,950,600,350,0.631578947368421,13,6,7,338.53115040280784,0.7582658569500675,0.13258651773152064,0.19715428965743131,131109.19922017684,1076.9096080794861,132186.10882825634,2368,14,882.3076923076923,38,1,19,35.29604805619305,0.6277412280701754,43.96367521367522,1024.1452991452998,26.951192082771048,4
2379,4,0,0,39,0.0,0.0,1.0,39,1100,900,200,0.8181818181818182,13,9,4,340.6244664403723,0.7584907782276203,0.13613170309040168,0.1986561669239835,131163.91354372117,1135.5276134122255,132299.4411571334,2369,15,883.3076923076923,38,1,19,35.1872131831456,0.6282894736842106,43.91025641025641,1024.358974358974,26.95681511470984,0
2380,4,0,0,39,0.0,0.0,1.0,39,700,500,200,0.7142857142857143,9,5,4,338.0888542787605,0.7583783175888439,0.1352943692393238,0.19774074940499198,131273.37643363274,1076.4130871502607,132349.789520783,2370,16,884.3076923076923,38,1,19,35.14169794273007,0.6293859649122808,43.8034188034188,1024.786324786324,26.968061178587476,0
2381,4,1,1,39,0.025,0.025,0.975,40,1150,900,250,0.782608695652174,14,9,5,333.33966986545784,0.7662393162393163,0.1296494228302698,0.1963933218678352,131553.00188519544,770.3896721926693,132323.3915573881,2371,0,863.175,37,3,20,34.98156263360412,0.634009009009009,43.530701754385966,1025.877192982456,27.726410621147462,0
2382,4,1,1,39,0.025,0.025,0.975,40,700,300,400,0.42857142857142855,11,3,8,333.33966986545784,0.771207264957265,0.1296494228302698,0.1963933218678352,131553.00188519544,770.3668436441995,132323.36872883965,2372,0,864.15,37,3,20,34.98156263360412,0.634009009009009,43.530701754385966,1025.877192982456,27.726410621147462,0
2383,4,0,0,39,0.0,0.0,1.0,39,1250,1000,250,0.8,15,10,5,341.1579913736782,0.7587719298245614,0.13154471269999468,0.2004248173837881,131443.57829112906,1168.6054297540882,132612.18372088316,2373,19,887.3076923076923,36,3,20,34.89137198916465,0.6348379629629629,43.63738738738739,1025.4504504504512,28.484734734734754,0
2384,4,0,0,39,0.0,0.0,1.0,39,1350,1200,150,0.8888888888888888,15,12,3,345.69914993007785,0.759727845254161,0.10845904684243912,0.19566571886042416,130004.05811216631,1191.9110411086872,131195.969153275,2374,20,888.3076923076923,36,3,19,36.23127392520613,0.6203703703703705,45.04504504504505,1019.8198198198205,28.328328328328347,8
2385,4,1,0,40,0.025,0.0,1.0,40,1450,1200,250,0.8275862068965517,17,12,5,337.8352290115284,0.7652510683760684,0.12106989306581362,0.19334406071694477,130435.08193582097,813.3699577956291,131248.4518936166,2375,0,867.075,36,4,20,35.99520449785028,0.6247106481481481,44.622747747747745,1021.5090090090091,28.375250250250254,0
2386,4,0,0,40,0.0,0.0,1.0,40,750,500,250,0.6666666666666666,10,5,5,340.27567228317764,0.7651175213675213,0.12675225920211575,0.19517455438037626,130521.37230135537,882.6495414333199,131404.0218427887,2376,1,868.075,36,4,17,35.845547718756876,0.6255787037037037,44.538288288288285,1021.8468468468466,28.384634634634626,0
2387,4,1,0,41,0.024390243902439025,0.0,1.0,41,950,600,350,0.631578947368421,13,6,7,336.5079328649231,0.771290650406504,0.15030765412099778,0.1952331605527689,130963.11034404793,614.0251086872626,131577.1354527352,2377,0,847.8780487804878,37,4,18,35.49533565434743,0.628096846846847,44.106359649122794,1023.5745614035069,27.664177335229915,0
2388,4,0,0,41,0.0,0.0,1.0,41,1100,700,400,0.6363636363636364,15,7,8,335.9986060736673,0.771290650406504,0.15137619470413122,0.19565006114264635,131103.4404816864,610.1146506617117,131713.55513234812,2378,1,848.8780487804878,37,4,18,35.366702355460376,0.6295045045045047,43.96929824561402,1024.1228070175418,27.67899478425789,0
2389,4,0,0,41,0.0,0.0,1.0,41,1050,600,450,0.5714285714285714,15,6,9,337.58260045367535,0.7709857723577236,0.14817624845964827,0.19731432208335145,131248.05908203125,661.4122178819443,131909.4712999132,2379,2,849.8780487804878,39,2,19,35.180208227440616,0.6274038461538461,43.828125,1024.6875,26.27403846153846,0
2390,4,0,0,41,0.0,0.0,1.0,41,1250,800,450,0.64,17,8,9,337.86143902575157,0.7694105691056911,0.1495601096530692,0.19832657352980543,131412.43128895413,679.8874563567399,132092.31874531088,2380,3,850.8780487804878,37,4,20,35.00728531707836,0.6326013513513514,43.667763157894726,1025.32894736842,27.711593172119457,0
2391,4,0,0,41,0.0,0.0,1.0,41,1050,800,250,0.7619047619047619,13,8,5,337.09906271451405,0.7688516260162601,0.15477310946278844,0.19846203471958956,131524.88175448208,667.3828726146353,132192.2646270967,2381,4,851.8780487804878,37,4,20,34.91348209513627,0.6337274774774775,43.55811403508771,1025.7675438596486,27.723447131341857,0
2392,4,0,0,41,0.0,0.0,1.0,41,950,800,150,0.8421052631578947,11,8,3,337.09906271451405,0.7685467479674797,0.15477310946278844,0.19846203471958956,131524.88175448208,667.3828726146353,132192.2646270967,2382,5,852.8780487804878,37,4,20,34.91348209513627,0.6337274774774775,43.55811403508771,1025.7675438596486,27.723447131341857,0
2393,4,0,0,41,0.0,0.0,1.0,41,1550,1200,350,0.7741935483870968,19,12,7,337.1845295174047,0.7670223577235772,0.14453284825614499,0.19909842345447257,131637.38031173052,677.2176294629047,132314.59794119344,2383,6,853.8780487804878,37,4,16,34.797944046728624,0.6348536036036037,43.4484649122807,1026.2061403508771,27.735301090564246,0
2394,4,1,0,42,0.023809523809523808,0.0,1.0,42,1100,900,200,0.8181818181818182,13,9,4,338.6578714781522,0.7730836236933798,0.16975442659333284,0.20257898130238558,132130.12695312497,549.3815104166661,132679.50846354163,2384,0,834.5238095238095,39,3,17,34.264184397163135,0.6362179487179487,42.96875,1028.1249999999998,26.362179487179482,0
2395,4,0,0,42,0.0,0.0,1.0,42,1500,1000,500,0.6666666666666666,20,10,10,338.0947107957675,0.7727448703058459,0.16786268892811296,0.20281574571065636,132237.24500868036,541.7426215277526,132778.9876302081,2385,1,835.5238095238095,39,3,17,34.170970900006736,0.637286324786325,42.86458333333332,1028.5416666666652,26.372863247863208,0
2396,4,0,0,42,0.0,0.0,1.0,42,1400,1100,300,0.7857142857142857,17,11,6,336.6825541279332,0.7731078203639179,0.16581813448270855,0.20239887931354786,132317.61203341995,509.80631510414105,132827.41834852408,2386,2,836.5238095238095,39,3,18,34.12652711687085,0.6380876068376069,42.78645833333332,1028.8541666666652,26.38087606837603,0
2397,4,0,0,42,0.0,0.0,1.0,42,1000,700,300,0.7,13,7,6,315.3810845439092,0.7722851335656213,0.11075686420331166,0.1898692971546124,132372.47973552853,-50.444755448467504,132322.03498008006,2387,3,837.5238095238095,41,1,14,34.61942462804075,0.6354166666666665,42.733134920634924,1029.067460317461,25.099206349206366,4
2398,4,0,0,42,0.0,0.0,1.0,42,400,300,100,0.75,5,3,2,314.8715763248043,0.771680216802168,0.11114324272219012,0.18969092524933365,132398.0034722224,-62.323928413939,132335.67954380845,2388,4,838.5238095238095,40,2,14,34.60695006747638,0.6372395833333333,42.70833333333334,1029.166666666668,25.729166666666703,0
2399,4,0,0,42,0.0,0.0,1.0,42,1250,1100,150,0.88,14,11,3,316.21989657562415,0.7725512969415408,0.10940819280732428,0.19116587065061008,132528.77338224612,-18.3529975543577,132510.42038469177,2389,5,839.5238095238095,40,2,14,34.441209369653905,0.6385416666666666,42.581300813008134,1029.6747967479682,25.741869918699205,0
2400,4,0,0,42,0.0,0.0,1.0,42,1350,1000,350,0.7407407407407407,17,10,7,319.54842094063207,0.7740998838559814,0.12559552468074386,0.19395151089821544,132678.92696719905,79.46832089318843,132758.39528809223,2390,6,840.5238095238095,41,1,12,34.20508345369926,0.6384654471544715,42.43551587301588,1030.2579365079375,25.128242353852134,0
2401,4,0,0,42,0.0,0.0,1.0,42,850,500,350,0.5882352941176471,12,5,7,310.2423720574555,0.7731804103755323,0.09428052371108198,0.18952923785507741,132922.07969022333,-152.387739618975,132769.69195060435,2391,7,841.5238095238095,42,0,11,34.20155202656144,0.6393849206349205,42.199612403100794,1031.2015503875998,24.552417866371425,1
2402,4,0,0,42,0.0,0.0,1.0,42,1600,1200,400,0.75,20,12,8,310.9065959343196,0.7723577235772358,0.09845801581338764,0.19069893050165,133072.00588906952,-125.4071269755089,132946.598762094,2392,8,842.5238095238095,42,0,11,34.03456048084147,0.6408730158730156,42.05426356589149,1031.782945736437,24.566260612772307,0
2403,4,0,0,42,0.0,0.0,1.0,42,1350,800,550,0.5925925925925926,19,8,11,311.3541992504138,0.7730110336817654,0.10158327857567495,0.19161503666173693,133197.00894064392,-105.7103877470989,133091.29855289683,2393,9,843.5238095238095,42,0,12,33.89811946556526,0.6421130952380951,41.933139534883736,1032.2674418604677,24.57779623477304,0
2404,4,0,0,42,0.0,0.0,1.0,42,1400,1000,400,0.7142857142857143,18,10,8,311.2816036739736,0.7725512969415408,0.10835589630860754,0.19221548852591067,133322.07067634191,-99.8584069466673,133222.21226939524,2394,10,844.5238095238095,42,0,13,33.77509851754551,0.6433531746031744,41.81201550387598,1032.7519379844987,24.58933185677378,0
2405,4,0,0,42,0.0,0.0,1.0,42,1400,900,500,0.6428571428571429,19,9,10,312.45046325662776,0.7725996902826171,0.10927548659681441,0.19345800460175197,133422.1623174691,-62.43671504114633,133359.72560242796,2395,11,845.5238095238095,42,0,13,33.644993121990865,0.6443452380952379,41.715116279069775,1033.1395348837225,24.598560354374346,0
2406,4,0,1,41,0.0,0.023809523809523808,0.9761904761904762,42,1500,1000,500,0.6666666666666666,20,10,10,310.35372808360034,0.7728658536585366,0.10368811055189076,0.19255239937146318,133497.8517593381,-113.67941360774773,133384.17234573036,2396,12,846.5238095238095,41,1,13,33.6236240440306,0.6465955284552845,41.64186507936508,1033.4325396825404,25.205671699574157,0
2407,4,0,0,41,0.0,0.0,1.0,41,1150,800,350,0.6956521739130435,15,8,7,318.24390089048586,0.7649390243902439,0.10848155084638056,0.19773113719958052,133550.99400365198,300.3578599048245,133851.3518635568,2397,13,867.1463414634146,40,1,18,33.36672074197883,0.6486979166666667,41.59044715447155,1033.6382113821144,25.84095528455286,0
2408,4,0,0,41,0.0,0.0,1.0,41,950,800,150,0.8421052631578947,11,8,3,318.8977796180322,0.764989837398374,0.10769608703281253,0.1989532826162767,133702.97663336166,327.51647534013284,134030.49310870178,2398,14,868.1463414634146,41,0,11,33.19814148681055,0.6486280487804879,41.44345238095238,1034.2261904761904,25.225029036004642,0
2409,4,0,0,41,0.0,0.0,1.0,41,1300,800,500,0.6153846153846154,18,8,10,317.48119454078653,0.7637195121951219,0.1113766573907351,0.1987592352377192,133831.25964506168,297.781635802466,134129.04128086416,2399,15,869.1463414634146,41,0,11,33.106823266219244,0.6498983739837398,41.31944444444444,1034.722222222222,25.237127371273704,0
2410,4,0,1,40,0.0,0.024390243902439025,0.975609756097561,41,1250,900,350,0.72,16,9,7,317.5038300385463,0.7635670731707317,0.10583598647947312,0.19932821676427173,133933.9303429707,304.9071712018286,134238.83751417254,2400,16,870.1463414634146,41,0,11,33.003881541115575,0.6509146341463413,41.2202380952381,1035.119047619049,25.246806039489,0
2411,4,0,0,40,0.0,0.0,1.0,40,1050,700,350,0.6666666666666666,14,7,7,323.7929429751849,0.7579326923076923,0.10335542464408443,0.2031935381517103,133918.9029037775,672.3991382444303,134591.3020420219,2401,24,892.5,40,0,12,32.85612011127475,0.65234375,41.234756097560975,1035.060975609756,25.8765243902439,0
2412,4,0,0,40,0.0,0.0,1.0,40,1550,1200,350,0.7741935483870968,19,12,7,323.61821625734444,0.7550747863247863,0.11341965862271941,0.20439678417146045,134155.68300118993,683.0445667261738,134838.7275679161,2402,25,893.5,40,0,14,32.62458308809104,0.6546874999999999,41.00609756097562,1035.9756097560987,25.899390243902467,0
2413,4,0,0,40,0.0,0.0,1.0,40,650,400,250,0.6153846153846154,9,4,5,321.90568753292763,0.7545673076923077,0.11167745415318198,0.20375371171776951,134234.65617563968,642.1798573931012,134876.8360330328,2403,26,894.5,40,0,14,32.590263476185804,0.6554687499999999,40.929878048780495,1036.2804878048794,25.907012195121986,0
2414,4,0,0,40,0.0,0.0,1.0,40,900,400,500,0.4444444444444444,14,4,10,320.9123708835214,0.7533920940170941,0.10198755024017236,0.2037104601980588,134339.9898890378,622.2729319518951,134962.26282098968,2404,27,895.5,40,0,15,32.51111002189328,0.6565104166666667,40.82825203252033,1036.6869918699201,25.917174796748004,0
2415,4,0,0,40,0.0,0.0,1.0,40,600,500,100,0.8333333333333334,7,5,2,320.2063676320991,0.7526976495726496,0.09794913260805638,0.20355548716201294,134392.67223750756,606.6778827087127,134999.3501202163,2405,28,896.5,40,0,15,32.476967558561206,0.65703125,40.77743902439025,1036.8902439024398,25.922256097560997,0
2416,4,1,0,41,0.024390243902439025,0.0,1.0,41,850,300,550,0.35294117647058826,14,3,11,316.80661802572735,0.7579776422764227,0.1148867163108005,0.20370587699590365,134808.22074200038,341.6272990677597,135149.84804106815,2406,0,875.609756097561,41,0,15,32.15195516494714,0.6595528455284554,40.37698412698412,1038.4920634920625,25.329074719318598,0
2417,4,0,0,41,0.0,0.0,1.0,41,1500,1200,300,0.8,18,12,6,321.1146294998777,0.7565040650406504,0.11933124200906842,0.20721093744622424,134937.03275581065,466.0510558390012,135403.08381164965,2407,1,876.609756097561,41,0,15,31.91211925904707,0.6608231707317074,40.25297619047619,1038.9880952380952,25.34117305458769,0
2418,4,0,0,41,0.0,0.0,1.0,41,500,200,300,0.4,8,2,6,321.1146294998777,0.7565040650406504,0.11933124200906842,0.20721093744622424,134937.03275581065,466.0510558390012,135403.08381164965,2408,2,877.609756097561,41,0,15,31.91211925904707,0.6608231707317074,40.25297619047619,1038.9880952380952,25.34117305458769,0
2419,4,0,0,41,0.0,0.0,1.0,41,1050,700,350,0.6666666666666666,14,7,7,321.7141746900403,0.7554878048780488,0.11889458209271475,0.20819020433771135,135040.12665540734,488.8645793965601,135528.9912348039,2409,3,878.609756097561,41,0,15,31.79414829308646,0.661839430894309,40.153769841269835,1039.3849206349191,25.350851722802904,0
2420,4,0,0,41,0.0,0.0,1.0,41,1550,1200,350,0.7741935483870968,19,12,7,324.11441857329385,0.7547256097560976,0.1184582554727367,0.21034323350258147,135143.2599226032,560.3758227828066,135703.635745386,2410,4,879.609756097561,41,0,15,31.629357090608394,0.6628556910569106,40.05456349206349,1039.7817460317453,25.36053039101818,0
2421,4,0,0,41,0.0,0.0,1.0,41,700,500,200,0.7142857142857143,9,5,4,324.781160906343,0.7525914634146341,0.11684985519383106,0.21137991757312236,135246.43255739775,585.0986748865985,135831.53123228435,2411,5,880.609756097561,41,0,15,31.50959704339531,0.6638719512195121,39.95535714285713,1040.1785714285697,25.370209059233407,0
2422,4,0,1,40,0.0,0.024390243902439025,0.975609756097561,41,850,600,250,0.7058823529411765,11,6,5,325.4389455880275,0.7530487804878049,0.10919796840989027,0.21226390928651934,135323.83786848068,607.9294217687047,135931.76729024938,2412,6,881.609756097561,41,0,15,31.415665522501914,0.6646341463414633,39.88095238095238,1040.4761904761901,25.377468060394882,0
2423,4,0,0,40,0.0,0.0,1.0,40,550,200,350,0.36363636363636365,9,2,7,331.75918965024107,0.7495726495726496,0.11515728800312619,0.21602335020737073,135263.42207019628,974.9766590653685,136238.39872926165,2413,7,902.575,40,0,15,31.31126253744952,0.665625,39.9390243902439,1040.2439024390242,26.006097560975604,0
2424,4,0,0,40,0.0,0.0,1.0,40,1250,900,350,0.72,16,9,7,332.5731350444084,0.7489049145299145,0.11982859654263134,0.2170309961580434,135342.72057183232,1002.2705772027316,136344.99114903505,2414,8,903.575,40,0,15,31.21134062571215,0.66640625,39.862804878048784,1040.5487804878055,26.013719512195138,0
2425,4,1,0,41,0.024390243902439025,0.0,1.0,41,600,400,200,0.6666666666666666,8,4,4,328.3200000000002,0.7529979674796748,0.1319024390243908,0.216,135633.68055555542,706.5624173772134,136340.24297293264,2415,0,882.5121951219512,40,1,17,31.033333333333346,0.6692708333333334,39.58333333333333,1041.6666666666656,26.04166666666664,0
2426,4,0,0,41,0.0,0.0,1.0,41,950,600,350,0.631578947368421,13,6,7,331.71221217091323,0.7539126016260163,0.13529045179275645,0.2188788303475255,135739.56164485432,805.2940544649405,136544.85569931925,2416,1,883.5121951219512,40,1,17,30.839997399388846,0.6703125,39.48170731707317,1042.073170731708,26.0518292682927,0
2427,4,0,0,41,0.0,0.0,1.0,41,950,600,350,0.631578947368421,13,6,7,338.90285497986014,0.7539126016260163,0.15870974125562753,0.20130012952418191,131862.52170138885,772.6690307108823,132635.19073209973,2417,2,884.5121951219512,37,4,17,34.52712981744422,0.6371058558558559,43.229166666666664,1027.083333333333,27.759009009009002,8
2428,4,0,0,41,0.0,0.0,1.0,41,1000,800,200,0.8,12,8,4,341.0521439381716,0.7534044715447155,0.16086262687795005,0.20287730390836384,131918.83710612878,798.2404441751316,132717.07755030392,2418,3,885.5121951219512,37,4,18,34.41524798093002,0.637668918918919,43.17434210526316,1027.3026315789473,27.7649359886202,0
2429,4,1,1,41,0.023809523809523808,0.023809523809523808,0.9761904761904762,42,1150,900,250,0.782608695652174,14,9,5,333.9131549431181,0.7567024777390631,0.1518143459915613,0.20044938632603582,132264.0313042534,432.9399956597181,132696.97129991313,2419,0,865.4047619047619,39,3,19,34.251582278480996,0.6375534188034189,42.838541666666664,1028.645833333333,26.37553418803418,0
2430,4,0,0,41,0.0,0.0,1.0,41,600,400,200,0.6666666666666666,8,4,4,343.1461929680145,0.7536585365853659,0.16631612609620827,0.21198096593631544,133337.70751953122,950.8653428819445,134288.57286241316,2420,5,887.5121951219512,39,2,19,32.936733064380576,0.6482371794871795,41.796875,1032.8124999999998,26.48237179487179,3
2431,4,0,0,41,0.0,0.0,1.0,41,850,600,250,0.7058823529411765,11,6,5,342.0176928937882,0.7536077235772358,0.16471652919795998,0.21174353796008677,133418.40820312494,926.291232638888,134344.69943576382,2421,6,888.5121951219512,39,2,19,32.88507427572763,0.6490384615384617,41.71875,1033.1249999999995,26.490384615384603,0
2432,4,0,0,41,0.0,0.0,1.0,41,800,400,400,0.5,12,4,8,339.5316364234459,0.7524898373983739,0.15648890615090383,0.21081557550647237,133526.0470920138,867.2634548611006,134393.31054687488,2422,7,889.5121951219512,39,2,19,32.8415809984546,0.6501068376068377,41.61458333333333,1033.5416666666658,26.501068376068353,0
2433,4,0,0,41,0.0,0.0,1.0,41,1150,900,250,0.782608695652174,14,9,5,338.1575384671325,0.7531504065040651,0.1615534285882747,0.21088115841091037,133687.5868055556,841.4930555555604,134529.07986111115,2423,8,890.5121951219512,39,2,19,32.71555197421434,0.6517094017094017,41.458333333333336,1034.166666666667,26.517094017094024,0
2434,4,0,0,41,0.0,0.0,1.0,41,900,600,300,0.6666666666666666,12,6,6,336.4931399683648,0.7526930894308943,0.15944916222251138,0.20999625309527947,133714.51958550356,798.8037109375095,134513.32329644106,2424,9,891.5121951219512,39,2,14,32.7316656595159,0.6519764957264957,41.43229166666667,1034.2708333333342,26.51976495726498,0
2435,4,0,0,41,0.0,0.0,1.0,41,1250,900,350,0.72,16,9,7,335.32482282744843,0.7532012195121951,0.15847767173323923,0.2103401161372176,133903.12499999997,780.2083333333335,134683.3333333333,2425,10,892.5121951219512,39,2,14,32.57347020933979,0.653846153846154,41.25,1034.9999999999998,26.538461538461533,0
2436,4,0,0,41,0.0,0.0,1.0,41,600,500,100,0.8333333333333334,7,5,2,334.24532489675397,0.7534552845528455,0.1577499220700167,0.20981653780789913,133930.0794813367,753.10058593749,134683.1800672742,2426,11,893.5121951219512,39,2,14,32.57449012109625,0.6541132478632479,41.22395833333333,1035.1041666666658,26.541132478632456,0
2437,4,0,0,41,0.0,0.0,1.0,41,1100,900,200,0.8181818181818182,13,9,4,335.1699735637161,0.7526422764227643,0.15811944839770287,0.21086009729261646,134010.95920138896,783.2899305555601,134794.24913194453,2427,12,894.5121951219512,39,2,14,32.46981891348087,0.65491452991453,41.145833333333336,1035.4166666666672,26.549145299145312,0
2438,4,0,0,41,0.0,0.0,1.0,41,1150,1000,150,0.8695652173913043,13,10,3,335.3562744921101,0.751219512195122,0.1572306220799764,0.2117535333221607,134145.8129882811,797.328016493041,134943.14100477414,2428,13,895.5121951219512,39,2,14,32.33042148483325,0.6562500000000002,41.01562499999999,1035.9374999999989,26.56249999999997,0
2439,4,1,0,42,0.023809523809523808,0.0,1.0,42,1100,800,300,0.7272727272727273,14,8,6,329.1233222987019,0.7598722415795587,0.15509563951046013,0.20907323375413162,134366.3297722915,444.6185719479031,134810.9483442394,2429,0,875.1666666666666,40,2,16,32.27206266745083,0.6567708333333334,40.80284552845528,1036.788617886178,25.91971544715445,0
2440,4,0,1,41,0.0,0.023809523809523808,0.9761904761904762,42,550,300,250,0.5454545454545454,8,3,5,328.6031961453976,0.7598480449090205,0.15161040403616166,0.20889335889541982,134392.6722375072,432.372327153127,134825.04456466035,2430,1,876.1666666666666,40,2,16,32.259302819432186,0.6570312500000002,40.77743902439023,1036.8902439024373,25.922256097560933,0
2441,4,0,0,41,0.0,0.0,1.0,41,950,600,350,0.631578947368421,13,6,7,338.84071775544584,0.7558434959349594,0.15867259044337612,0.21521899577664036,134361.7201063369,905.4443359375093,135267.1644422744,2431,2,898.170731707317,39,2,16,32.024787333802195,0.6583867521367521,40.80729166666667,1036.7708333333342,26.583867521367544,0
2442,4,0,0,41,0.0,0.0,1.0,41,1100,800,300,0.7272727272727273,14,8,6,341.4218196200969,0.7553353658536586,0.16469965884516746,0.2178231839587794,134523.76437717024,985.8696831597316,135509.63406032996,2432,3,899.170731707317,39,2,16,31.796302339592327,0.6599893162393162,40.65104166666667,1037.3958333333342,26.599893162393183,0
2443,4,0,0,41,0.0,0.0,1.0,41,1150,800,350,0.6956521739130435,15,8,7,342.53518112315214,0.7543191056910569,0.1582164869512821,0.21936251052151787,134661.64809564262,1025.2731168302448,135686.92121247287,2433,4,900.170731707317,38,3,18,31.62999656887973,0.6631030701754386,40.5181623931624,1037.9273504273515,27.313877642825037,0
2444,4,0,0,41,0.0,0.0,1.0,41,1100,700,400,0.6363636363636364,15,7,8,345.1988918984932,0.7525914634146341,0.16612764420000925,0.22208328445699882,134828.03397116298,1108.4975847395729,135936.53155590256,2434,5,901.170731707317,38,3,14,31.395089668415455,0.6647478070175439,40.35790598290598,1038.5683760683762,27.33074673864148,0
2445,4,0,0,41,0.0,0.0,1.0,41,600,300,300,0.5,9,3,6,344.75429911845544,0.7520833333333333,0.1683584126522195,0.22196697324699494,134855.7749379063,1098.4216341588099,135954.19657206512,2435,6,902.170731707317,38,3,14,31.37900294863882,0.6650219298245614,40.33119658119658,1038.6752136752134,27.333558254610878,0
2446,4,0,1,40,0.0,0.024390243902439025,0.975609756097561,41,1100,900,200,0.8181818181818182,13,9,4,345.4488261031196,0.7515752032520325,0.16323203338985204,0.2227549326940809,134911.26543209894,1120.9876543210048,136032.25308641995,2436,7,903.170731707317,38,3,14,31.305704099821742,0.6655701754385963,40.277777777777786,1038.8888888888903,27.339181286549746,0
2447,4,0,0,40,0.0,0.0,1.0,40,700,500,200,0.7142857142857143,9,5,4,356.99822535067705,0.7495993589743589,0.1710149899714979,0.2299010325456809,134863.8057503271,1629.2278633810486,136493.03361370813,2437,8,918.225,37,3,14,31.05305869312785,0.6669481981981982,40.323464912280706,1038.7061403508778,28.073138928402102,0
2448,4,1,0,41,0.024390243902439025,0.0,1.0,41,800,700,100,0.875,9,7,2,349.1869041748847,0.7542174796747968,0.1794090056285178,0.2269714877136753,135200.00000000015,1242.013888888903,136442.01388888905,2438,0,896.8048780487804,39,2,15,30.921140491453,0.6666666666666666,40.00000000000001,1040.0000000000011,26.666666666666696,0
2449,4,0,0,41,0.0,0.0,1.0,41,900,400,500,0.4444444444444444,14,4,10,349.57540527127014,0.7522357723577235,0.17527664011996036,0.22773708887437566,135281.2622070314,1258.2004123264032,136539.4626193578,2439,1,897.8048780487804,39,2,15,30.830183405093294,0.6674679487179487,39.92187500000001,1040.3125000000011,26.674679487179517,0
2450,4,0,1,40,0.0,0.024390243902439025,0.975609756097561,41,1300,1000,300,0.7692307692307693,16,10,6,346.50821685791016,0.7503048780487804,0.16839748475609762,0.22629108039700258,135369.15856963448,1181.3051507039431,136550.46372033842,2440,2,898.8048780487804,40,1,15,30.822550455729154,0.6666666666666667,39.83739837398374,1040.650406504065,26.016260162601622,0
2451,4,0,0,40,0.0,0.0,1.0,40,800,400,400,0.5,12,4,8,349.89623889648715,0.7431356837606837,0.16706969059777732,0.22794610162160575,135281.26220703125,1466.880967881945,136748.1431749132,2441,3,922.0,39,1,16,30.821839224324954,0.6674679487179487,39.921875,1040.3125,26.674679487179485,0
2452,4,0,0,40,0.0,0.0,1.0,40,800,600,200,0.75,10,6,4,337.0433557177569,0.7427884615384616,0.12430747922437657,0.22122300257110977,135550.22651627235,1137.7190845095915,136687.94560078194,2442,4,923.0,38,2,18,30.88899148455935,0.6718749999999998,39.66346153846155,1041.3461538461552,27.40384615384619,3
2453,4,0,0,40,0.0,0.0,1.0,40,950,600,350,0.631578947368421,13,6,7,338.5965264291265,0.7425747863247864,0.1250359011180633,0.2225878311636923,135605.8596888926,1183.1346108189146,136788.9942997115,2443,5,924.0,38,2,18,30.793329230348416,0.672423245614035,39.61004273504274,1041.5598290598296,27.40946918578499,0
2454,4,0,0,40,0.0,0.0,1.0,40,1150,800,350,0.6956521739130435,15,8,7,336.95247286952025,0.7419337606837607,0.131198042723351,0.2222109194780742,135719.3574585449,1146.1974759523657,136865.55493449725,2444,6,925.0,37,3,20,30.723521519520155,0.6753941441441441,39.50109649122807,1041.9956140350873,28.16204362256993,0
2455,4,0,0,40,0.0,0.0,1.0,40,1050,800,250,0.7619047619047619,13,8,5,334.9569540801634,0.7395566239316239,0.13319310054690803,0.2217806907656125,135862.21241151128,1101.5985687904035,136963.8109803017,2445,7,926.0,37,3,20,30.63385219464311,0.6768018018018017,39.3640350877193,1042.543859649123,28.17686107159792,0
2456,4,0,0,40,0.0,0.0,1.0,40,500,300,200,0.6,7,3,4,336.8457133506045,0.7380876068376069,0.13279179810725572,0.22338931199192802,135919.37543282547,1156.7717951677394,137076.1472279932,2446,8,927.0,37,3,18,30.527953031896256,0.6773648648648649,39.30921052631579,1042.7631578947367,28.182788051209098,0
2457,4,0,0,40,0.0,0.0,1.0,40,1200,800,400,0.6666666666666666,16,8,8,337.3243833622882,0.7388087606837607,0.13238911078410753,0.22442686596565078,136033.7375442443,1177.4993267159025,137211.23687096022,2447,9,928.0,37,3,18,30.4021266904912,0.678490990990991,39.19956140350877,1043.2017543859643,28.194642010431465,0
2458,4,1,1,40,0.024390243902439025,0.024390243902439025,0.975609756097561,41,1250,900,350,0.72,16,9,7,331.4262988860616,0.7467479674796748,0.12562160813424006,0.22235360820942038,136330.12963191263,836.6780581123658,137166.807690025,2448,0,906.3414634146342,38,3,19,30.262574595055426,0.6795504385964912,38.9155982905983,1044.3376068376078,27.48256860098968,0
2459,4,0,0,40,0.0,0.0,1.0,40,800,500,300,0.625,11,5,6,340.09568308211715,0.7398237179487179,0.12958937198067644,0.2277349574056199,136262.6060422436,1268.4648160972374,137531.07085834083,2449,11,930.0,37,3,19,30.10309458797172,0.6807432432432433,38.980263157894726,1044.0789473684197,28.218349928876208,0
2460,4,0,0,40,0.0,0.0,1.0,40,1300,800,500,0.6153846153846154,18,8,10,343.7263241536096,0.7401442307692307,0.1221673995296042,0.23133514961446303,136441.72699110597,1379.7226559646383,137821.4496470706,2450,12,931.0,38,2,19,29.830930224631015,0.6806469298245614,38.80876068376068,1044.764957264957,27.49381466486729,0
2461,4,0,0,40,0.0,0.0,1.0,40,700,500,200,0.7142857142857143,9,5,4,347.60477238391076,0.7384081196581197,0.12963606624412183,0.23450137127306298,136525.454972971,1491.3799400978846,138016.8349130689,2451,13,932.0,38,2,19,29.64671505486267,0.6814692982456141,38.72863247863248,1045.08547008547,27.502249212775524,0
2462,4,0,0,40,0.0,0.0,1.0,40,350,200,150,0.5714285714285714,5,2,3,346.65488572116135,0.7384882478632478,0.13059644280895455,0.2340458762601877,136553.37000739636,1467.3785749506822,138020.74858234703,2452,14,933.0,38,2,19,29.643897577430252,0.6817434210526316,38.70192307692307,1045.192307692307,27.50506072874492,0
2463,4,0,0,40,0.0,0.0,1.0,40,1300,700,600,0.5384615384615384,19,7,12,340.5493656227509,0.737099358974359,0.1456532029031241,0.22530291015835005,135833.63540945284,1257.3901501155924,137091.02555956843,2453,15,934.0,37,3,20,30.516439640966297,0.6765202702702702,39.39144736842105,1042.4342105263152,28.1738975817923,2
2464,4,0,0,40,0.0,0.0,1.0,40,750,300,450,0.4,12,3,9,335.58293166032365,0.7369123931623932,0.157482993197279,0.21279905901754648,134301.49778106515,1013.8580703484658,135315.35585141362,2454,16,935.0,38,2,17,32.16926922284065,0.6595394736842104,40.86538461538462,1036.5384615384621,27.277327935222687,3
2465,4,0,0,40,0.0,0.0,1.0,40,1200,800,400,0.6666666666666666,16,8,8,333.7624477121984,0.737099358974359,0.15648243535592865,0.2124480052421186,134439.96006145436,974.202028088234,135414.1620895426,2455,17,936.0,38,2,17,32.07843995741904,0.6609100877192983,40.7318376068376,1037.0726495726487,27.291385515069702,0
2466,4,0,0,40,0.0,0.0,1.0,40,900,700,200,0.7777777777777778,11,7,4,337.28062313794186,0.7357371794871795,0.158171987641607,0.21517705983373264,134523.07167251053,1074.4050880268587,135597.4767605374,2456,18,937.0,38,2,17,31.90439409543426,0.661732456140351,40.65170940170939,1037.3931623931605,27.299820062977908,0
2467,4,0,0,40,0.0,0.0,1.0,40,1150,700,450,0.6086956521739131,16,7,9,319.38046119105735,0.7351228632478632,0.08149350649350673,0.19989956654132154,133822.27783203122,548.0441623263894,134370.3219943576,2457,19,938.0,39,1,17,33.066650726534455,0.6530448717948718,41.328125,1034.6874999999998,26.530448717948712,5
2468,4,0,0,40,0.0,0.0,1.0,40,800,300,500,0.375,13,3,10,320.18639526322215,0.7353365384615385,0.08501509813789698,0.2006972767785558,133876.17323133672,573.0658637152728,134449.239095052,2458,20,939.0,39,1,17,32.99205250796846,0.6535790598290598,41.276041666666664,1034.8958333333328,26.535790598290586,0
2469,4,0,0,40,0.0,0.0,1.0,40,1200,600,600,0.5,18,6,12,323.1137905081949,0.7345619658119659,0.08737673576172322,0.20297755057335243,133957.03667534702,656.6731770833148,134613.70985243033,2459,21,940.0,39,1,17,32.83566445294158,0.654380341880342,41.19791666666666,1035.2083333333317,26.543803418803375,0
2470,4,0,0,40,0.0,0.0,1.0,40,700,400,300,0.5714285714285714,10,4,6,323.31632860843547,0.7341346153846153,0.08742579736392009,0.20325369955972408,133983.9965820311,663.8427734374859,134647.8393554686,2460,22,941.0,39,1,18,32.80353908843948,0.6546474358974359,41.17187499999999,1035.3124999999989,26.54647435897433,0
2471,4,0,0,40,0.0,0.0,1.0,40,1150,900,250,0.782608695652174,14,9,5,340.7245310199118,0.7323717948717948,0.08398800909654769,0.2115641279259707,133527.4273595586,1109.3078715831243,134636.73523114173,2461,23,942.0,38,2,19,32.80937736889256,0.6518640350877194,41.61324786324786,1033.5470085470074,27.198605488079142,6
2472,4,0,0,40,0.0,0.0,1.0,40,700,400,300,0.5714285714285714,10,4,6,339.05366264046654,0.7310897435897435,0.08555813953488389,0.21068363429971165,133555.03420857972,1056.4647024983392,134611.49891107806,2462,24,943.0,38,2,19,32.8249354005168,0.652138157894737,41.58653846153845,1033.6538461538448,27.201417004048547,0
2473,4,0,0,40,0.0,0.0,1.0,40,1000,700,300,0.7,13,7,6,338.1364402976629,0.732051282051282,0.07753125322863941,0.2107419578648472,133665.49014034987,1039.434605340049,134704.9247456899,2463,25,944.0,38,2,21,32.738187484933015,0.653234649122807,41.47970085470085,1034.0811965811963,27.21266306792622,0
2474,4,0,0,40,0.0,0.0,1.0,40,700,400,300,0.5714285714285714,10,4,6,336.4251075746194,0.7324519230769231,0.07426652892562013,0.2098321547243759,133693.1112572137,995.54386733873,134688.65512455243,2464,26,945.0,38,2,21,32.75482093663911,0.6535087719298246,41.45299145299145,1034.1880341880333,27.215474583895613,0
2475,4,0,0,40,0.0,0.0,1.0,40,850,600,250,0.7058823529411765,11,6,5,333.6279603389438,0.7319711538461539,0.0759966948977484,0.20839909109688087,133748.36205164727,924.4386459931295,134672.8006976404,2465,27,946.0,38,2,16,32.771939337602426,0.6540570175438596,41.39957264957265,1034.401709401709,27.22109761583445,0
2476,4,0,0,40,0.0,0.0,1.0,40,1100,800,300,0.7272727272727273,14,8,6,330.3859869345639,0.7296474358974359,0.07317280891917011,0.2071488061770304,133886.53897518068,846.847263313598,134733.38623849428,2466,28,947.0,38,2,17,32.717817693816464,0.6554276315789473,41.266025641025635,1034.9358974358965,27.23515519568149,0
2477,4,0,0,40,0.0,0.0,1.0,40,1850,1500,350,0.8108108108108109,22,15,7,334.88258301193076,0.7265224358974359,0.07351166532582498,0.2112990104994058,134118.83680555536,982.8124999999814,135101.64930555533,2467,29,948.0,39,1,18,32.36960311075357,0.6559829059829061,41.04166666666666,1035.8333333333317,26.559829059829017,0
2478,4,0,0,40,0.0,0.0,1.0,40,1100,800,300,0.7272727272727273,14,8,6,330.82481379949394,0.7260149572649572,0.06539802000202077,0.20202559110433033,132907.71620008702,793.8340928819702,133701.55029296898,2468,30,949.0,39,1,15,33.68532595885108,0.6439636752136751,42.21354166666668,1031.145833333335,26.439636752136796,2
2479,4,0,0,40,0.0,0.0,1.0,40,1000,600,400,0.6,14,6,8,334.38271088171814,0.7260149572649572,0.04146572339577492,0.18938289426686958,130029.26911891093,695.9079003900006,130725.17701930093,2469,31,950.0,40,0,17,36.494245715424476,0.6135416666666667,45.02032520325204,1019.9186991869938,25.497967479674845,5
2480,4,0,0,40,0.0,0.0,1.0,40,850,700,150,0.8235294117647058,10,7,3,338.5647454159777,0.7264690170940171,0.045026895109075094,0.192134057616224,130107.01844346961,809.929915229048,130916.94835869866,2470,32,951.0,40,0,17,36.30881229870175,0.6143229166666666,44.94410569105692,1020.2235772357733,25.505589430894332,0
2481,4,0,0,40,0.0,0.0,1.0,40,1400,1100,300,0.7857142857142857,17,11,6,341.24682143292716,0.7275106837606837,0.037350657108721874,0.19430176159140167,130236.65229030358,888.5687256263011,131125.22101592988,2471,33,952.0,40,0,18,36.109036904287805,0.6156249999999999,44.81707317073172,1020.7317073170747,25.518292682926866,0
2482,4,0,0,40,0.0,0.0,1.0,40,1050,700,350,0.6666666666666666,14,7,7,337.6789646791822,0.7269497863247864,0.030634613372397368,0.19266852927993725,130317.12420784961,801.0754804186164,131118.19968826824,2472,34,953.0,38,2,18,36.11859544487463,0.6197916666666665,44.73824786324788,1021.0470085470105,26.86965811965817,0
2483,4,1,1,40,0.024390243902439025,0.024390243902439025,0.975609756097561,41,950,700,250,0.7368421052631579,12,7,5,329.10773084331936,0.7378048780487805,0.020800811350959236,0.18906352781233343,130581.79253472244,395.0954861111354,130976.88802083358,2473,0,930.7317073170732,39,2,15,36.069778502513934,0.6207264957264957,44.47916666666668,1022.0833333333351,26.207264957265004,0
2484,4,1,1,40,0.024390243902439025,0.024390243902439025,0.975609756097561,41,950,600,350,0.631578947368421,13,6,7,329.05883172359694,0.739380081300813,0.024735728861416062,0.18916545493284487,130608.4106445315,395.57020399308465,131003.98084852459,2474,0,931.7073170731708,39,2,15,36.0441293861884,0.6209935897435896,44.453125000000014,1022.1875000000019,26.209935897435948,0
2485,4,0,0,40,0.0,0.0,1.0,40,850,600,250,0.7058823529411765,11,6,5,336.27686757648195,0.7279113247863248,0.021142185049659812,0.19295070416131088,130535.3879597671,779.2062741982708,131314.59423396538,2475,37,956.0,38,2,16,35.933525004356156,0.6219846491228069,44.524572649572654,1021.9017094017105,26.892150247413433,0
2486,4,0,1,39,0.0,0.025,0.975,40,1050,800,250,0.7619047619047619,13,8,5,337.30754578464905,0.7274305555555556,0.02167821479519083,0.19404081209440524,130635.03146701418,812.8363715278119,131447.867838542,2476,38,957.0,39,1,17,35.80641600434754,0.6212606837606836,44.42708333333335,1022.291666666669,26.2126068376069,0
2487,4,0,0,39,0.0,0.0,1.0,39,550,400,150,0.7272727272727273,7,4,3,339.2613432850627,0.7205353126405758,0.04434871366226534,0.19548888119092978,130699.205623585,1068.2376132296426,131767.44323681464,2477,39,979.9487179487179,38,1,17,35.69158569289173,0.623629385964912,44.36431623931626,1022.5427350427381,26.90901934322995,0
2488,4,1,1,39,0.025,0.025,0.975,40,1250,800,450,0.64,17,8,9,331.79179411015156,0.7301816239316239,0.05000254401139714,0.19258818433080144,130981.34901258719,691.7073567708724,131673.05636935806,2478,0,956.425,39,1,17,35.597609477290476,0.6247329059829059,44.088541666666686,1023.6458333333364,26.247329059829138,0
2489,4,0,0,39,0.0,0.0,1.0,39,700,600,100,0.8571428571428571,8,6,2,339.07597198127644,0.7201979307242465,0.049857847310342596,0.19635245826098358,130890.45606874143,1076.3617229162214,131966.81779165767,2479,41,981.9487179487179,38,1,17,35.50301907148327,0.625548245614035,44.17735042735043,1023.2905982905992,26.92869995501577,0
2490,4,1,0,40,0.025,0.0,1.0,40,800,500,300,0.625,11,5,6,341.67734430211124,0.7291666666666666,0.08383728021140358,0.1999859244847398,131301.43364800367,972.5450303819688,132273.97867838564,2480,0,958.375,39,1,19,35.02144950367585,0.6279380341880341,43.77604166666668,1024.895833333335,26.279380341880387,0
2491,4,0,0,40,0.0,0.0,1.0,40,900,600,300,0.6666666666666666,12,6,6,342.9867941890643,0.7281517094017094,0.08503438574554556,0.20132380818547074,131410.2692513148,1014.4001074796472,132424.66935879446,2481,1,959.375,38,2,19,34.878086902156916,0.6307565789473685,43.66987179487179,1025.3205128205118,26.98211875843452,0
2492,4,0,0,40,0.0,0.0,1.0,40,1200,900,300,0.75,15,9,6,342.9565171224511,0.7266559829059829,0.0904639175257731,0.20217381423737857,131574.6348002958,1024.8756985535738,132599.51049884938,2482,2,960.375,38,2,15,34.713110486306356,0.6324013157894737,43.50961538461538,1025.9615384615379,26.998987854251,0
2493,4,0,0,40,0.0,0.0,1.0,40,750,500,250,0.6666666666666666,10,5,5,342.9890983968876,0.7271100427350428,0.09216114928169938,0.20262935296436027,131656.85609796178,1031.373274161728,132688.22937212352,2483,3,961.375,38,2,16,34.62939829273371,0.6332236842105263,43.429487179487175,1026.2820512820506,27.007422402159225,0
2494,4,0,0,40,0.0,0.0,1.0,40,1150,900,250,0.782608695652174,14,9,5,341.0060466659107,0.7271901709401709,0.09726672214709264,0.2024762894749472,131848.8056674152,992.2479956534206,132841.05366306863,2484,4,962.375,38,2,17,34.48693609348451,0.6351425438596492,43.242521367521356,1027.0299145299127,27.027103013945073,0
2495,4,0,0,40,0.0,0.0,1.0,40,650,300,350,0.46153846153846156,10,3,7,343.86688878007124,0.7278846153846154,0.09925392534054289,0.2047658123466216,131958.55391418267,1075.2354764774368,133033.78939066012,2485,5,963.375,38,2,17,34.302970434300384,0.6362390350877194,43.13568376068375,1027.4572649572629,27.038349077822705,0
2496,4,1,1,40,0.024390243902439025,0.024390243902439025,0.975609756097561,41,1500,1300,200,0.8666666666666667,17,13,4,335.16620612747596,0.7388719512195122,0.09775858454167996,0.2010798560886892,132241.164784933,664.5538989688807,132905.71868390188,2486,0,940.8536585365854,40,1,17,34.24233442018245,0.6356770833333333,42.86077235772358,1028.5569105691065,25.713922764227664,0
2497,4,0,0,40,0.0,0.0,1.0,40,1250,900,350,0.72,16,9,7,342.4974191531669,0.727857905982906,0.09927066450567246,0.205165929725732,132183.68055555553,1054.513888888885,133238.1944444444,2487,7,965.375,39,1,17,34.111628849270666,0.6367521367521367,42.916666666666664,1028.3333333333333,26.367521367521366,0
2498,4,0,0,40,0.0,0.0,1.0,40,1400,900,500,0.6428571428571429,19,9,10,340.94680967517337,0.7285790598290598,0.09695504707907254,0.2049623639173274,132317.6120334202,1022.6535373263946,133340.26557074662,2488,8,966.375,39,1,18,34.0168446896831,0.6380876068376069,42.786458333333336,1028.8541666666672,26.380876068376082,0
2499,4,0,0,40,0.0,0.0,1.0,40,1100,800,300,0.7272727272727273,14,8,6,336.05034485775764,0.7275373931623932,0.09914133028950922,0.20304182905292845,132507.9800044743,905.8948894441813,133413.87489391846,2489,9,967.375,38,2,19,33.95161011379753,0.6417214912280702,42.60149572649572,1029.5940170940162,27.094579397210953,0
2500,4,0,0,40,0.0,0.0,1.0,40,1200,900,300,0.75,15,9,6,337.3309598756839,0.725133547008547,0.09819539514623532,0.2045625858566882,132645.51487508215,949.0877712031513,133594.60264628532,2490,10,968.375,38,2,14,33.78059531217589,0.6430921052631579,42.467948717948715,1030.1282051282049,27.108636977058023,0
2501,4,0,0,40,0.0,0.0,1.0,40,1200,900,300,0.75,15,9,6,337.1280548970131,0.7255074786324787,0.0972107009539609,0.20473948119816068,132700.5487983051,947.4155800277455,133647.96437833284,2491,11,969.375,38,2,15,33.730601064565185,0.6436403508771931,42.41452991452991,1030.3418803418795,27.114260008996826,0
2502,4,0,0,40,0.0,0.0,1.0,40,1350,900,450,0.6666666666666666,18,9,9,331.5760450026085,0.7231837606837607,0.09184799502642171,0.2024060980594669,132893.2574169953,812.8441403681632,133706.10155736346,2492,12,970.375,38,2,15,33.680447622008074,0.6455592105263158,42.227564102564095,1031.0897435897427,27.133940620782703,0
2503,4,0,0,40,0.0,0.0,1.0,40,900,400,500,0.4444444444444444,14,4,10,344.52630870774044,0.7231837606837607,0.07275389575497049,0.19559593059948283,130122.707527797,976.4120675330681,131099.11959533006,2493,13,971.375,37,3,16,36.14085169263837,0.6196509009009008,44.92872807017544,1020.2850877192982,27.575272641062114,5
2504,4,0,0,40,0.0,0.0,1.0,40,950,500,450,0.5263157894736842,14,5,9,343.74193267861085,0.7233974358974359,0.07520410355569918,0.19571214992692298,130234.60493853882,953.4189606417431,131188.02389918055,2494,14,972.375,37,3,17,36.047440648834474,0.620777027027027,44.819078947368425,1020.7236842105267,27.587126600284506,0
2505,4,1,0,41,0.024390243902439025,0.0,1.0,41,650,300,350,0.46153846153846156,10,3,7,339.6369919659736,0.7304878048780488,0.0941808059384941,0.19529127038043476,130617.28395061725,672.4922839506135,131289.77623456786,2495,0,949.6341463414634,38,3,13,35.76483242753624,0.6228070175438596,44.44444444444444,1022.222222222222,26.90058479532163,0
2506,4,0,1,40,0.0,0.024390243902439025,0.975609756097561,41,1100,800,300,0.7272727272727273,14,8,6,365.26005843159135,0.7294715447154472,0.03534926420144857,0.2048851171133488,129651.86767578128,1283.3860797646619,130935.25375554594,2496,1,950.6341463414634,39,2,14,36.0907614810269,0.6113782051282051,45.390625,1018.4375000000002,26.113782051282058,5
2507,4,0,0,40,0.0,0.0,1.0,40,1000,500,500,0.5,15,5,10,363.17268223161955,0.7274839743589744,0.03717666905224393,0.20426636025919917,129757.97661675356,1424.9104817708396,131182.8870985244,2497,2,958.35,39,1,14,36.03595832055344,0.6124465811965811,45.286458333333336,1018.8541666666673,26.124465811965827,0
2508,4,0,0,40,0.0,0.0,1.0,40,1050,700,350,0.6666666666666666,14,7,7,366.1394930607581,0.7254807692307692,0.032623135090946276,0.206634433627023,129890.67382812503,1511.621093750001,131402.29492187503,2498,3,959.35,39,1,14,35.82541385652973,0.6137820512820513,45.15625,1019.3750000000002,26.137820512820518,0
2509,4,1,0,41,0.024390243902439025,0.0,1.0,41,1050,800,250,0.7619047619047619,13,8,5,362.12711111413375,0.734959349593496,0.041601600920918136,0.20605340379145873,130210.72035701307,1230.566399795099,131441.28675680817,2499,0,936.9268292682926,40,1,16,35.60253410335556,0.6153645833333332,44.84247967479675,1020.6300813008133,25.515752032520332,0
2510,4,1,2,40,0.023809523809523808,0.047619047619047616,0.9523809523809523,42,1050,900,150,0.8571428571428571,12,9,3,357.1729318229926,0.7428377855207123,0.04090129984899038,0.20448306727309343,130448.74267578138,918.5726305207663,131367.31530630216,2500,0,915.5952380952381,39,3,17,35.48751317086436,0.6193910256410255,44.60937500000001,1021.562500000001,26.193910256410284,0
2511,4,0,0,40,0.0,0.0,1.0,40,950,800,150,0.8421052631578947,11,8,3,355.7499081351447,0.7300747863247863,0.006052739796442719,0.19299382913723126,128329.16802300353,1130.6179470486159,129459.78597005214,2501,2,962.25,39,1,16,37.681303759295446,0.5980235042735043,46.692708333333336,1013.2291666666671,25.980235042735053,6
2512,4,1,1,40,0.024390243902439025,0.024390243902439025,0.975609756097561,41,900,700,200,0.7777777777777778,11,7,4,331.65242532028304,0.7391768292682926,-0.016400293273477695,0.18232465818368856,128857.43408203125,350.1302083333333,129207.56429036458,2502,0,939.7560975609756,39,2,13,37.75360367292499,0.6033653846153846,46.171875,1015.3125,26.033653846153847,3
2513,4,1,0,41,0.024390243902439025,0.0,1.0,41,850,500,350,0.5882352941176471,12,5,7,332.6914897119117,0.7415142276422764,0.001330286011492543,0.1837527061523211,129042.58355034742,386.2738715277977,129428.85742187522,2503,0,940.7317073170732,39,2,15,37.538872941015654,0.6052350427350426,45.98958333333334,1016.0416666666683,26.05235042735047,0
2514,4,0,0,41,0.0,0.0,1.0,41,900,600,300,0.6666666666666666,12,6,6,331.44180508718523,0.7425813008130081,0.0025894670623203275,0.18367935602698698,129175.56023407046,362.83617142575474,129538.39640549621,2504,1,941.7317073170732,40,1,16,37.43543603585591,0.6049479166666666,45.85873983739838,1016.5650406504076,25.41412601626019,0
2515,4,1,1,41,0.023809523809523808,0.023809523809523808,0.9761904761904762,42,850,700,150,0.8235294117647058,10,7,3,322.004393492621,0.7521051103368177,0.008154709675621818,0.17959755650102335,129428.42306193334,-64.69582624714366,129363.7272356862,2505,0,920.2857142857143,41,1,11,37.41865311494589,0.6059451219512194,45.61011904761906,1017.5595238095257,24.81852497096404,0
2516,4,1,0,42,0.023809523809523808,0.0,1.0,42,1100,700,400,0.6363636363636364,15,7,8,322.04269955275447,0.7546699574138599,0.011985967647632378,0.18019641127646507,129554.63927469142,-55.57484567900531,129499.06442901242,2506,0,921.2619047619048,41,1,12,37.28967712596635,0.6072154471544715,45.486111111111114,1018.0555555555561,24.830623306233075,0
2517,4,2,2,42,0.045454545454545456,0.045454545454545456,0.9545454545454546,44,1050,700,350,0.6666666666666666,14,7,7,310.1193262691077,0.7743789640591966,0.018641850257449466,0.17560384563187667,130021.0243414258,-735.593506083543,129285.43083534225,2507,0,880.3409090909091,43,1,13,37.12124729186012,0.6090116279069766,45.0284090909091,1019.8863636363651,23.718287526427094,0
2518,4,2,1,43,0.045454545454545456,0.022727272727272728,0.9772727272727273,44,1100,1000,100,0.9090909090909091,12,10,2,307.1826519186231,0.7671555673009162,0.02198501999021607,0.17480541828822188,130214.25637769763,-800.0878816574605,129414.16849604018,2508,0,881.2045454545455,43,1,14,37.00091235232265,0.6109496124031006,44.83901515151516,1020.643939393941,23.735905567300954,0
2519,4,1,0,44,0.022727272727272728,0.0,1.0,44,1500,1100,400,0.7333333333333333,19,11,8,310.9507237015011,0.7708113107822411,0.036725604052015415,0.1779429950434002,130431.81392224815,-688.4266134354782,129743.38730881267,2509,0,882.1818181818181,43,1,15,36.685072309261166,0.6131298449612402,44.625946969696976,1021.4962121212129,23.75572586328402,0
2520,4,1,0,45,0.022222222222222223,0.0,1.0,45,1700,1400,300,0.8235294117647058,20,14,6,311.15998465782366,0.7775252525252526,0.06643736422882007,0.17979579029809847,130806.6529492458,-859.6407750342636,129947.01217421154,2510,0,863.5555555555555,44,1,13,36.30163076273234,0.615530303030303,44.259259259259274,1022.9629629629651,23.2491582491583,0
2521,4,0,1,44,0.0,0.022222222222222223,0.9777777777777777,45,1100,800,300,0.7272727272727273,14,8,6,313.3255559526652,0.7776515151515152,0.059531348955034646,0.1816039522781758,130925.07823216752,-795.5654149519728,130129.51281721555,2511,1,864.5555555555555,44,1,13,36.126881088090705,0.6167140151515151,44.143518518518526,1023.4259259259273,23.259680134680167,0
2522,4,1,0,45,0.022222222222222223,0.0,1.0,45,1450,1000,450,0.6896551724137931,19,10,9,318.78188910977514,0.7772727272727273,0.055267122992811224,0.18572822929849395,131124.83071932453,-630.4778701604293,130494.3528491641,2512,0,865.4666666666667,41,4,17,35.785951827457076,0.6229674796747968,43.94841269841269,1024.2063492063473,24.980642663569448,2
2523,4,0,1,44,0.0,0.022222222222222223,0.9777777777777777,45,1150,900,250,0.782608695652174,14,9,5,324.3541124376866,0.7759680134680135,0.06284281764091926,0.18935019328117522,131201.04762101604,-488.88012959813466,130712.1674914179,2513,1,866.4666666666667,41,4,17,35.56645605371032,0.6237296747967479,43.87400793650794,1024.5039682539687,24.98790166473094,0
2524,4,0,0,44,0.0,0.0,1.0,44,1050,900,150,0.8571428571428571,12,9,3,333.05205183925426,0.7660544397463003,0.05983044733044762,0.19428036357289838,131171.92147531238,-62.58448178993274,131109.33699352245,2514,2,887.0,40,4,18,35.373057208994716,0.625,43.90243902439025,1024.3902439024394,25.609756097560982,0
2525,4,0,0,44,0.0,0.0,1.0,44,1250,1000,250,0.8,15,10,5,331.830990667133,0.7662526427061311,0.05929332042594426,0.19410046056576902,131277.28666698147,-87.62558264047232,131189.661084341,2515,3,888.0,41,3,19,35.2980800258148,0.6244918699186992,43.79960317460317,1024.8015873015863,24.99516066589235,0
2526,4,0,0,44,0.0,0.0,1.0,44,1300,800,500,0.6153846153846154,18,8,10,332.0108443002428,0.7677942212825934,0.065261750633268,0.19498091401632406,131429.8311917357,-72.77415595870684,131357.057035777,2516,4,889.0,41,3,19,35.13972200722393,0.6260162601626017,43.65079365079364,1025.3968253968233,25.0096786682152,0
2527,4,0,0,44,0.0,0.0,1.0,44,1200,900,300,0.75,15,9,6,333.47868157113106,0.7667371388301621,0.0756454888308673,0.19649590006422016,131557.01929209175,-25.70773100908417,131531.31156108266,2517,5,890.0,41,3,14,34.973950778454686,0.6272865853658537,43.52678571428571,1025.8928571428564,25.021777003484303,0
2528,4,0,1,43,0.0,0.022727272727272728,0.9772727272727273,44,1300,900,400,0.6923076923076923,17,9,8,337.4317097066912,0.7686971458773785,0.07293460308535682,0.19975648352659262,131735.18597253712,90.3258062484199,131825.51177878553,2518,6,891.0,41,3,14,34.693096894730054,0.6290650406504066,43.3531746031746,1026.5873015873012,25.038714672861005,0
2529,4,0,0,43,0.0,0.0,1.0,43,1300,900,400,0.6923076923076923,17,9,8,345.31531567874066,0.7689645625692137,0.07202720925630124,0.2050385769829235,131849.47472569253,505.9285973957458,132355.40332308828,2519,7,904.2558139534884,40,3,15,34.375618444488424,0.6317708333333333,43.241869918699194,1027.0325203252046,25.675813008130113,0
2530,4,1,1,43,0.022727272727272728,0.022727272727272728,0.9772727272727273,44,800,500,300,0.625,11,5,6,342.93514601876507,0.7739825581395349,0.07444475632433978,0.20520668899182923,132142.8768266566,263.28735197783396,132406.16417863444,2520,0,884.6818181818181,41,3,16,34.141419014537504,0.6331300813008129,42.95634920634921,1028.1746031746034,25.077429345722035,0
2531,4,0,0,43,0.0,0.0,1.0,43,1350,900,450,0.6666666666666666,18,9,9,351.95262967024115,0.7681339977851606,0.08974992586735198,0.2105679925708945,132136.6572993091,701.1688024654468,132837.82610177455,2521,9,906.2558139534884,40,3,16,33.915892392342926,0.6346354166666668,42.96239837398373,1028.1504065040635,25.70376016260159,0
2532,4,1,1,43,0.022727272727272728,0.022727272727272728,0.9772727272727273,44,700,500,200,0.7142857142857143,9,5,4,345.8976010825677,0.775788407329105,0.09432114024245952,0.20795965338129307,132321.4396435656,353.9337089002118,132675.3733524658,2522,0,886.6363636363636,41,3,17,33.88565471024973,0.634908536585366,42.78273809523809,1028.8690476190463,25.09436701509869,0
2533,4,0,0,43,0.0,0.0,1.0,43,1150,700,450,0.6086956521739131,16,7,9,344.1045543648608,0.7746862310815799,0.10648442317015161,0.20759714323770181,132451.61132812503,515.4848267431976,132967.09615486822,2523,1,906.3023255813954,39,4,17,33.80093435876679,0.6394230769230769,42.65625,1029.3750000000002,26.394230769230774,0
2534,4,0,0,43,0.0,0.0,1.0,43,1000,500,500,0.5,15,5,10,346.41933064843573,0.7738095238095237,0.10944466010281029,0.20944067788744886,132532.04345703125,582.3323567708336,133114.3758138021,2524,2,907.3023255813954,39,4,17,33.66053363682348,0.640224358974359,42.578125,1029.6875,26.40224358974359,0
2535,4,0,0,43,0.0,0.0,1.0,43,1450,900,550,0.6206896551724138,20,9,11,351.6909227423567,0.7727482465854558,0.11467363882390713,0.21379771922107282,132738.13950029737,736.5597527926449,133474.69925309002,2525,3,908.3023255813954,40,3,14,33.317718606180144,0.640625,42.3780487804878,1030.4878048780483,25.76219512195121,0
2536,4,0,1,42,0.0,0.023255813953488372,0.9767441860465116,43,1150,800,350,0.6956521739130435,15,8,7,378.23281582521327,0.7723791066814323,0.12881787498248243,0.2141860902107961,130023.43885633687,1262.43597864357,131285.87483498044,2526,4,909.3023255813954,39,4,15,35.38208984441494,0.6151175213675213,45.02604166666667,1019.8958333333339,26.15117521367523,5
2537,4,0,0,42,0.0,0.0,1.0,42,1350,800,550,0.5925925925925926,19,8,11,389.93953016638795,0.7632113821138211,0.13717776115681857,0.2213984847258623,130126.2932372707,1748.277129446989,131874.5703667177,2527,15,931.8571428571429,38,4,16,34.97883944153576,0.6178728070175439,44.92521367521367,1020.2991452991446,26.849977507872225,0
2538,4,0,0,42,0.0,0.0,1.0,42,1000,700,300,0.7,13,7,6,394.0024989587669,0.766066589237321,0.14062196307094244,0.2244897959183674,130262.58680555565,1864.8996228723886,132127.48642842803,2528,16,932.8571428571429,36,6,16,34.736394557823125,0.622974537037037,44.79166666666667,1020.8333333333342,28.356481481481506,0
2539,4,0,0,42,0.0,0.0,1.0,42,1300,1100,200,0.8461538461538461,15,11,4,397.08104736185254,0.7657520325203252,0.13928925854165675,0.22691417886103632,130377.57087746558,1954.092479303662,132331.66335676925,2529,17,933.8571428571429,36,6,16,34.540743191090534,0.6241319444444443,44.67905405405407,1021.283783783786,28.368993993994057,0
2540,4,2,2,42,0.045454545454545456,0.045454545454545456,0.9545454545454546,44,1100,600,500,0.5454545454545454,16,6,10,381.51363880633716,0.7830778717406625,0.1404233171408742,0.2211428614319921,130928.0395507814,1190.1665581597379,132118.20610894114,2530,0,892.3636363636364,39,5,14,34.37924088210349,0.6241987179487178,44.14062500000001,1023.4375000000011,26.241987179487207,0
2541,4,0,0,42,0.0,0.0,1.0,42,1200,1000,200,0.8333333333333334,14,10,4,394.36710754068895,0.7647357723577236,0.14188923450963564,0.22681582625551172,130626.62459843422,1902.968822137589,132529.59342057182,2531,19,935.8571428571429,37,5,14,34.35667614144231,0.6247184684684683,44.43530701754386,1022.2587719298252,27.628615457562844,0
2542,4,0,0,42,0.0,0.0,1.0,42,1150,700,450,0.6086956521739131,16,7,9,397.50760779286134,0.7647599690282617,0.14582248762313088,0.2297859963263566,130822.85534972294,2000.6160549399754,132823.4714046629,2532,20,936.8571428571429,37,5,15,34.07690246516613,0.6266891891891893,44.243421052631575,1023.0263157894732,27.649359886201978,0
2543,4,0,0,42,0.0,0.0,1.0,42,1000,700,300,0.7,13,7,6,420.1591803400254,0.7642276422764228,0.14495254985168549,0.23198752295151223,129029.71172185703,2443.5774406537685,131473.2891625108,2533,21,937.8571428571429,36,6,12,35.33030370206162,0.6105324074074074,46.002252252252255,1015.9909909909913,28.221971971971982,7
2544,4,1,1,42,0.023255813953488372,0.023255813953488372,0.9767441860465116,43,1200,1100,100,0.9166666666666666,13,11,2,407.2033454087991,0.7743632336655593,0.12747043416144122,0.2268261981079432,129377.95380015431,1936.8553907229284,131314.80919087725,2534,0,917.0232558139535,35,8,14,35.302901023890776,0.6160714285714286,45.65972222222222,1017.3611111111111,29.067460317460316,0
2545,4,2,1,43,0.045454545454545456,0.022727272727272728,0.9772727272727273,44,950,700,250,0.7368421052631579,12,7,5,384.11438406936685,0.7834963002114165,0.12502037711242742,0.2178384286603562,130081.0994199881,1207.7924324191572,131288.89185240725,2535,0,897.1363636363636,40,4,14,35.17342432091386,0.6140625000000001,44.96951219512195,1020.1219512195121,25.503048780487802,6
2546,4,0,0,43,0.0,0.0,1.0,43,750,500,250,0.6666666666666666,10,5,5,393.46396019368126,0.7752399409376153,0.12586317165182104,0.22284448671014598,130029.26911891076,1632.3662337233188,131661.63535263407,2536,1,919.0,40,3,14,34.98779394180948,0.6135416666666667,45.020325203252035,1019.9186991869924,25.49796747967481,0
2547,4,0,0,43,0.0,0.0,1.0,43,850,400,450,0.47058823529411764,13,4,9,367.10131176102993,0.7759320782576596,0.07136194145873054,0.21517430493127684,131356.22409058546,1051.2907555302443,132407.5148461157,2537,2,920.0,37,6,16,34.314610297001465,0.6320382882882883,43.72258771929824,1025.109649122806,27.70566619250827,5
2548,4,0,0,43,0.0,0.0,1.0,43,1000,600,400,0.6,14,6,8,368.8062589229463,0.7763012181616833,0.06971770744225858,0.21665051089493656,131440.53939673724,1095.2187211449473,132535.7581178822,2538,3,921.0,37,6,16,34.18564656401483,0.632882882882883,43.64035087719297,1025.4385964912265,27.71455666192504,0
2549,4,0,0,43,0.0,0.0,1.0,43,1350,1000,350,0.7407407407407407,17,10,7,367.586589741793,0.776531930601698,0.06742545161627156,0.21625188430469983,131496.76462950124,1067.2894544475057,132564.05408394875,2539,4,922.0,37,6,16,34.16007412158791,0.633445945945946,43.585526315789465,1025.657894736841,27.72048364153624,0
2550,4,0,0,43,0.0,0.0,1.0,43,900,700,200,0.7777777777777778,11,7,4,361.6245135444514,0.776531930601698,0.07934850699519735,0.20940989061237922,130890.45606874117,866.6395006939712,131757.09556943516,2540,5,923.0,38,5,15,34.92617630681422,0.6255482456140352,44.17735042735042,1023.290598290597,26.928699955015713,1
2551,4,0,0,43,0.0,0.0,1.0,43,1050,500,550,0.47619047619047616,16,5,11,360.74017932025845,0.7769472129937246,0.07179158596787594,0.20949166049980067,130999.80481591038,851.378616042058,131851.18343195244,2541,6,924.0,38,5,16,34.838107910665826,0.6266447368421053,44.07051282051281,1023.7179487179471,26.939946018893345,0
2552,4,1,0,44,0.022727272727272728,0.0,1.0,44,1100,700,400,0.6363636363636364,15,7,8,354.56911772989633,0.7862491190979564,0.07594775891858951,0.20753156153149585,131301.43364800327,511.0866970485923,131812.52034505186,2542,0,903.9772727272727,39,5,17,34.691131381915504,0.6279380341880343,43.77604166666666,1024.8958333333317,26.279380341880298,0
2553,4,0,0,44,0.0,0.0,1.0,44,800,200,600,0.25,14,2,12,354.4648116903544,0.7853461945031713,0.07476421973748204,0.20792007461134335,131384.32618690358,514.2295135281911,131898.55570043178,2543,1,904.9772727272727,37,7,18,34.61007130124777,0.6323198198198199,43.695175438596486,1025.2192982456133,27.708629682313873,0
2554,4,0,1,43,0.0,0.022727272727272728,0.9772727272727273,44,1300,700,600,0.5384615384615384,19,7,12,353.9468783318124,0.7854563072586329,0.07598763511937134,0.20792155817582345,131440.5393967374,504.593721144961,131945.13311788236,2544,2,905.9772727272727,37,7,18,34.566581123467344,0.632882882882883,43.64035087719298,1025.4385964912278,27.714556661925076,0
2555,4,0,1,42,0.0,0.023255813953488372,0.9767441860465116,43,850,600,250,0.7058823529411765,11,6,5,353.9822857235475,0.7808693244739756,0.09501654028447826,0.20870902630845795,131581.125021641,715.4774786472506,132296.60250028825,2545,3,927.2558139534884,37,6,12,34.4237602864166,0.6342905405405406,43.5032894736842,1025.986842105261,27.729374110953003,0
2556,4,1,0,43,0.023255813953488372,0.0,1.0,43,1150,800,350,0.6956521739130435,15,8,7,350.7740449006672,0.7876061277224068,0.1113435268456302,0.20887888481793876,131958.55391418264,657.527143144102,132616.08105732675,2546,0,922.1395348837209,38,5,14,34.12555024089288,0.6362390350877194,43.13568376068375,1027.4572649572626,27.0383490778227,0
2557,4,1,2,42,0.022727272727272728,0.045454545454545456,0.9545454545454546,44,1000,700,300,0.7,13,7,6,320.1410614951272,0.7943974630021142,0.06955045533505322,0.19130920872044463,132091.88102324272,-342.39299886620074,131749.4880243765,2547,0,902.1590909090909,41,3,15,34.77851766068327,0.6326219512195121,43.00595238095239,1027.9761904761913,25.072590011614423,4
2558,4,0,0,42,0.0,0.0,1.0,42,1150,600,550,0.5217391304347826,17,6,11,329.3910261926784,0.7788182346109176,0.09141264209687927,0.19634093494808327,131996.2904188371,295.6787109375349,132291.96912977463,2548,1,945.9761904761905,39,3,15,34.636868558878206,0.6348824786324785,43.09895833333335,1027.6041666666692,26.34882478632485,0
2559,4,0,0,42,0.0,0.0,1.0,42,900,600,300,0.6666666666666666,12,6,6,327.7348746435424,0.7787698412698413,0.08758632671676181,0.19562976455582806,132049.8168945315,255.46603732641847,132305.28293185792,2549,2,946.9761904761905,39,3,15,34.62562497888585,0.6354166666666665,43.046875000000014,1027.812500000002,26.354166666666718,0
2560,4,0,0,42,0.0,0.0,1.0,42,1150,900,250,0.782608695652174,14,9,5,325.8552665750604,0.7775116144018583,0.09155079027458224,0.19533509695783705,132210.46142578154,216.2950303819744,132426.7564561635,2550,3,947.9761904761905,39,3,16,34.512580607042764,0.6370192307692306,42.890625000000014,1028.4375000000023,26.370192307692367,0
2561,4,0,0,42,0.0,0.0,1.0,42,800,400,400,0.5,12,4,8,325.7093414516903,0.7770276809910956,0.09254972875226031,0.19552460467084778,132264.03130425367,215.92610677085895,132479.95741102454,2551,4,948.9761904761905,39,3,17,34.46255274261604,0.6375534188034188,42.83854166666668,1028.645833333335,26.375534188034234,0
2562,4,0,1,41,0.0,0.023809523809523808,0.9761904761904762,42,1500,1300,200,0.8666666666666667,17,13,4,329.9331406582865,0.7762049941927991,0.09765018733256259,0.19890962935556503,132425.49332493232,338.37960002384216,132763.87292495617,2552,5,949.9761904761905,38,4,18,34.191837935091,0.6408991228070176,42.681623931623925,1029.2735042735032,27.086144849302716,0
2563,4,0,0,41,0.0,0.0,1.0,41,650,500,150,0.7692307692307693,8,5,3,329.9331406582865,0.775660569105691,0.10769277508012776,0.19890962935556503,132425.49332493232,538.3117831835643,132963.8051081159,2553,6,969.170731707317,38,3,18,34.191837935091,0.6408991228070176,42.681623931623925,1029.2735042735032,27.086144849302716,0
2564,4,0,0,41,0.0,0.0,1.0,41,1150,900,250,0.782608695652174,14,9,5,330.69533792698854,0.7760670731707318,0.10838590178618834,0.2000987044744661,132562.98539201193,567.592250164373,133130.5776421763,2554,7,970.170731707317,38,3,18,34.0342618528893,0.6422697368421052,42.54807692307693,1029.807692307693,27.100202429149817,0
2565,4,0,0,41,0.0,0.0,1.0,41,1050,600,450,0.5714285714285714,15,6,9,332.7626865707738,0.7764227642276422,0.11012403747676625,0.20223668002363698,132728.0700402698,633.3898339908216,133361.45987426065,2555,8,971.170731707317,38,3,13,33.81544841886988,0.6439144736842104,42.387820512820525,1030.44871794872,27.117071524966317,0
2566,4,1,1,41,0.023809523809523808,0.023809523809523808,0.9761904761904762,42,900,700,200,0.7777777777777778,11,7,4,326.69015064626296,0.7832946186604723,0.11459009535350018,0.20007498836425153,133015.1489257814,290.947808159737,133306.09673394114,2556,0,949.0238095238095,39,3,15,33.684342286849095,0.6450320512820513,42.10937500000001,1031.5625000000011,26.450320512820543,0
2567,4,0,0,41,0.0,0.0,1.0,41,850,600,250,0.7058823529411765,11,6,5,333.8329412140699,0.7760162601626016,0.10941625628832674,0.2040841913577847,132948.34270445263,676.5072549127243,133624.84995936535,2557,1,972.9512195121952,38,3,15,33.56706895956353,0.6461074561403508,42.17414529914531,1031.30341880342,27.13956365272158,0
2568,4,0,0,41,0.0,0.0,1.0,41,1050,700,350,0.6666666666666666,14,7,7,333.01901059075607,0.7757113821138212,0.10709279506588221,0.20418822763650357,133058.54752218933,662.2051692965175,133720.75269148583,2558,2,973.9512195121952,38,3,16,33.47765869317595,0.647203947368421,42.06730769230769,1031.730769230769,27.150809716599184,0
2569,4,0,0,41,0.0,0.0,1.0,41,800,400,400,0.5,12,4,8,323.87054026258687,0.7763719512195122,0.0783063398017414,0.19628644227269268,132623.79410010742,398.9089752923153,133022.70307539974,2559,3,974.9512195121952,37,4,22,34.149013554751235,0.6447072072072073,42.48903508771928,1030.0438596491203,27.83902323376001,2
2570,4,0,0,41,0.0,0.0,1.0,41,1100,600,500,0.5454545454545454,16,6,10,324.5495899319047,0.7760162601626016,0.08072293534171782,0.19729088267658693,132736.7615516309,415.9323060941404,133152.69385772504,2560,4,975.9512195121952,37,4,14,34.01831950060295,0.6458333333333335,42.37938596491226,1030.482456140348,27.850877192982377,0
2571,4,0,0,41,0.0,0.0,1.0,41,1150,900,250,0.782608695652174,14,9,5,323.00472146029716,0.7764735772357724,0.08519591844147367,0.19679633094285467,132821.51870046518,380.395530355457,133201.91423082064,2561,5,976.9512195121952,37,4,14,33.9732253660958,0.6466779279279281,42.297149122807,1030.8114035087692,27.859767662399168,0
2572,4,0,0,41,0.0,0.0,1.0,41,1100,800,300,0.7272727272727273,14,8,6,321.0558110696537,0.7763211382113822,0.08375263250718445,0.19605252255188427,132906.30290089233,334.0681748229929,133240.37107571532,2562,6,977.9512195121952,37,4,14,33.938572238763626,0.6475225225225227,42.21491228070174,1031.140350877191,27.86865813181597,0
2573,4,0,0,41,0.0,0.0,1.0,41,900,600,300,0.6666666666666666,12,6,6,323.2726514114347,0.7758130081300812,0.08743359252450844,0.19785464097770705,132991.11415291193,398.4780172744918,133389.59217018643,2563,7,978.9512195121952,37,4,15,33.79653006626272,0.6483671171171174,42.132675438596465,1031.4692982456102,27.877548601232707,0
2574,4,0,0,41,0.0,0.0,1.0,41,1400,1100,300,0.7857142857142857,17,11,6,325.154801431707,0.7742378048780488,0.09251293107916259,0.1997622056837611,133132.52635426255,457.7360341643292,133590.26238842687,2564,8,979.9512195121952,37,4,15,33.606477546394686,0.6497747747747749,41.995614035087705,1032.0175438596468,27.892366050260726,0
2575,4,0,0,41,0.0,0.0,1.0,41,1400,1000,400,0.7142857142857143,18,10,8,322.68656152365173,0.7730691056910569,0.09675823315881638,0.19858583168417318,133196.36774965274,396.1355833150367,133592.50333296778,2565,9,980.9512195121952,38,3,16,33.60630994273095,0.6485745614035089,41.93376068376067,1032.2649572649552,27.16486729644619,0
2576,4,0,1,40,0.0,0.024390243902439025,0.975609756097561,41,1000,800,200,0.8,12,8,4,323.87995795310195,0.7726626016260163,0.10217814188072594,0.20006054655160602,133334.25931633054,436.8588602162207,133771.11817654676,2566,10,981.9512195121952,38,3,18,33.43764008137649,0.6499451754385965,41.80021367521367,1032.7991452991446,27.17892487629328,0
2577,4,0,0,40,0.0,0.0,1.0,40,900,500,400,0.5555555555555556,13,5,8,334.7874942164049,0.7658386752136752,0.10894308943089381,0.19608981804103776,131328.12500000047,793.4027777778233,132121.52777777828,2567,32,1007.25,39,1,19,35.1710704607046,0.628205128205128,43.75000000000002,1025.0000000000036,26.282051282051377,5
2578,4,1,1,40,0.024390243902439025,0.024390243902439025,0.975609756097561,41,1050,800,250,0.7619047619047619,13,8,5,327.26957399259277,0.7727642276422764,0.10517895912951847,0.19320370363852835,131629.4461451714,415.662552962243,132045.10869813364,2568,0,983.6585365853658,38,3,15,35.06029845566547,0.6329495614035088,43.456196581196586,1026.1752136752143,27.00461088618985,0
2579,4,1,0,41,0.024390243902439025,0.0,1.0,41,850,700,150,0.8235294117647058,10,7,3,326.1411284242282,0.7726117886178862,0.11568422896217712,0.19309242778979735,131739.10307774498,393.10794707430193,132132.2110248193,2569,0,984.6341463414634,38,3,17,34.97892600686855,0.634046052631579,43.34935897435898,1026.6025641025649,27.015856950067498,0
2580,4,0,0,41,0.0,0.0,1.0,41,1300,1000,300,0.7692307692307693,16,10,6,325.23412424247107,0.7709349593495934,0.10879898699615631,0.19345349416642071,131916.02105034742,380.7183159722425,132296.73936631967,2570,1,985.6341463414634,39,2,18,34.824325694585276,0.6340811965811964,43.17708333333334,1027.2916666666683,26.34081196581201,0
2581,4,0,0,41,0.0,0.0,1.0,41,1050,700,350,0.6666666666666666,14,7,7,322.7608451544084,0.771290650406504,0.11685766467554215,0.19293317872979163,132103.35422092024,327.5580512152883,132430.91227213552,2571,2,986.6341463414634,39,2,18,34.69966984159152,0.6359508547008547,42.99479166666667,1028.0208333333342,26.35950854700857,0
2582,4,0,0,41,0.0,0.0,1.0,41,850,600,250,0.7058823529411765,11,6,5,321.04134213739974,0.7701219512195122,0.11286078213836515,0.19217702172457693,132156.90239800356,285.5658637152834,132442.46826171884,2572,3,987.6341463414634,39,2,19,34.690106541046156,0.6364850427350428,42.942708333333336,1028.2291666666672,26.36485042735044,0
2583,4,0,1,40,0.0,0.024390243902439025,0.975609756097561,41,1400,1100,300,0.7857142857142857,17,11,6,319.2589422344154,0.7702235772357724,0.11515567600120424,0.19206754546188096,132345.71358194528,250.51050548615095,132596.22408743144,2573,4,988.6341463414634,40,1,20,34.54650205761317,0.63671875,42.75914634146341,1028.9634146341464,25.72408536585366,0
2584,4,0,0,40,0.0,0.0,1.0,40,1600,1300,300,0.8125,19,13,6,322.3357614425357,0.7642895299145299,0.1362702366127022,0.194613245442373,132480.48159105846,540.6497098327083,133021.13130089117,2574,5,1012.5,38,2,20,34.33219178082191,0.6414473684210527,42.628205128205124,1029.487179487179,27.09176788124155,0
2585,4,0,0,40,0.0,0.0,1.0,40,1200,1000,200,0.8333333333333334,14,10,4,320.07389093796627,0.7647435897435897,0.12786795975521237,0.19395552372928526,132618.00219382325,489.51199411933504,133107.51418794258,2575,6,1013.5,38,2,21,34.252584448362896,0.6428179824561404,42.494658119658105,1030.0213675213654,27.105825461088564,0
2586,4,0,0,40,0.0,0.0,1.0,40,900,300,600,0.3333333333333333,15,3,12,319.3554706868323,0.7649038461538461,0.12839035769828944,0.19408843823405741,132728.07004026926,477.4870562129847,133205.55709648225,2576,7,1014.5,38,2,14,34.160834629341615,0.6439144736842106,42.3878205128205,1030.4487179487155,27.117071524966196,0
2587,4,1,1,40,0.024390243902439025,0.024390243902439025,0.975609756097561,41,700,600,100,0.8571428571428571,8,6,2,314.9000577895697,0.7686991869918699,0.13232464816315703,0.1925772373177594,132961.42713758658,173.91221788191945,133135.3393554685,2577,0,990.7317073170732,39,2,15,34.04212116621216,0.6444978632478634,42.16145833333332,1031.354166666665,26.444978632478588,0
2588,4,0,0,40,0.0,0.0,1.0,40,900,500,400,0.5555555555555556,13,5,8,318.5284404869865,0.7623397435897435,0.13067791473024926,0.19437697311591795,132880.8648003471,465.2669270833226,133346.13172743042,2578,1,1016.3,39,1,16,34.029180979322426,0.6436965811965812,42.23958333333333,1031.0416666666656,26.436965811965784,0
2589,4,0,0,40,0.0,0.0,1.0,40,700,600,100,0.8571428571428571,8,6,2,317.70000825296563,0.7617521367521367,0.13326095738234733,0.19442926339436728,132988.28667534704,450.07595486109074,133438.36263020814,2579,2,1017.3,39,1,16,33.943058641351904,0.6447649572649574,42.13541666666666,1031.458333333332,26.447649572649535,0
2590,4,0,0,40,0.0,0.0,1.0,40,900,600,300,0.6666666666666666,12,6,6,320.6096817405641,0.7611645299145299,0.13319539765845834,0.19705959842962203,133149.50086805545,537.8038194444399,133687.30468749988,2580,3,1018.3,39,1,18,33.706768940923176,0.6463675213675215,41.979166666666664,1032.0833333333326,26.463675213675195,0
2591,4,1,1,40,0.024390243902439025,0.024390243902439025,0.975609756097561,41,900,800,100,0.8888888888888888,10,8,2,312.5328295616183,0.7685467479674797,0.12719398222019573,0.19335947732768413,133393.4736784487,137.967954755766,133531.44163320446,2581,0,994.439024390244,40,1,20,33.67150352516805,0.6471354166666667,41.74288617886179,1033.028455284553,25.825711382113827,0
2592,4,0,0,40,0.0,0.0,1.0,40,1050,900,150,0.8571428571428571,12,9,3,317.756400915599,0.7585202991452992,0.1274710035300055,0.19629624393010373,133337.70751953125,473.7820095486114,133811.48952907987,2582,5,1020.3,39,1,20,33.59230542948394,0.6482371794871795,41.796875,1032.8125,26.482371794871796,0
2593,4,1,0,41,0.024390243902439025,0.0,1.0,41,850,600,250,0.7058823529411765,11,6,5,309.6447537894406,0.7660060975609756,0.1327517355778085,0.19267863206020067,133606.8047417536,74.19704861111583,133681.00179036474,2583,0,996.390243902439,39,2,21,33.53327036104112,0.6509081196581197,41.536458333333336,1033.8541666666677,26.50908119658122,0
2594,4,0,0,41,0.0,0.0,1.0,41,1300,1000,300,0.7692307692307693,16,10,6,312.2715660222497,0.7664634146341464,0.1250679769345573,0.19540484411017364,133813.73443593434,157.24488151893675,133970.97931745328,2584,1,997.390243902439,40,1,14,33.259052810791324,0.6513020833333334,41.33638211382114,1034.6544715447158,25.866361788617894,0
2595,4,0,0,41,0.0,0.0,1.0,41,900,700,200,0.7777777777777778,11,7,4,309.01578783726563,0.7646341463414634,0.12038553247723316,0.19433659546210263,133997.80636525876,81.48754048515733,134079.29390574392,2585,2,998.390243902439,40,1,14,33.15992671116346,0.6531250000000001,41.15853658536585,1035.3658536585363,25.884146341463406,0
2596,4,0,0,41,0.0,0.0,1.0,41,950,500,450,0.5263157894736842,14,5,9,308.08899463417356,0.7635670731707317,0.1264110404494272,0.19458855088604504,134155.6830011898,66.37790005949188,134222.0609012493,2586,3,999.390243902439,40,1,15,33.026780459093594,0.6546875,41.00609756097561,1035.9756097560978,25.899390243902445,0
2597,4,0,1,40,0.0,0.024390243902439025,0.975609756097561,41,1100,900,200,0.8181818181818182,13,9,4,310.11237355239757,0.7628556910569105,0.131862297246232,0.19643018543399693,134260.98573104636,127.19859210787536,134388.18432315424,2587,4,1000.390243902439,40,1,17,32.86959861410734,0.6557291666666667,40.90447154471545,1036.3821138211383,25.90955284552846,0
2598,4,0,0,40,0.0,0.0,1.0,40,700,400,300,0.5714285714285714,10,4,6,315.7084309256545,0.7610042735042735,0.13095094491355086,0.19978800705142571,134226.75781250012,475.30381944445844,134702.06163194458,2588,5,1020.45,39,1,17,32.75867846133227,0.6570512820512819,40.93750000000001,1036.250000000001,26.570512820512842,0
2599,4,0,1,39,0.0,0.025,0.975,40,1400,1100,300,0.7857142857142857,17,11,6,318.4898693304929,0.7594551282051282,0.13270621923038295,0.20229289530608813,134361.72010633702,558.5693359375248,134920.28944227454,2589,6,1021.45,39,1,17,32.55226648581667,0.6583867521367521,40.80729166666668,1036.770833333335,26.583867521367566,0
2600,4,0,0,39,0.0,0.0,1.0,39,900,600,300,0.6666666666666666,12,6,6,327.07067701137186,0.7544984255510572,0.13945545863071618,0.2070878307447984,134246.13284388944,981.5947110819093,135227.72755497135,2590,7,1048.3333333333333,38,1,17,32.445017182130584,0.6589912280701753,40.91880341880343,1036.3247863247877,27.271704903283887,0
2601,4,0,0,39,0.0,0.0,1.0,39,1450,1000,450,0.6896551724137931,19,10,9,323.3795363365683,0.7551169590643275,0.13611093495677196,0.20537140187238617,134356.87413251528,889.6527321206976,135246.526864636,2591,8,1049.3333333333333,38,1,17,32.43035517999452,0.6600877192982455,40.81196581196582,1036.7521367521376,27.282950967161515,0
2602,4,0,0,39,0.0,0.0,1.0,39,1600,1300,300,0.8125,19,13,6,323.10097140200344,0.7550044984255511,0.1357450528322912,0.20597421742232785,134495.3649485902,891.1166127913016,135386.4815613815,2592,9,1050.3333333333333,38,1,19,32.29971332440691,0.6614583333333333,40.67841880341881,1037.2863247863256,27.29700854700857,0
2603,4,0,0,39,0.0,0.0,1.0,39,750,600,150,0.8,9,6,3,324.02703182206704,0.7535425101214576,0.13325095252806052,0.20687879724024308,134550.78125000017,919.6180555555705,135470.39930555574,2593,10,1051.3333333333333,38,1,20,32.22054886211512,0.6620065789473684,40.62500000000001,1037.5000000000014,27.302631578947405,0
2604,4,0,0,39,0.0,0.0,1.0,39,1450,1200,250,0.8275862068965517,17,12,5,323.7735975055088,0.7542172739541161,0.13967972469413414,0.20750555892899242,134689.37194097455,921.7724998173793,135611.14444079192,2594,11,1052.3333333333333,38,1,21,32.08925140661453,0.6633771929824561,40.491452991452995,1038.0341880341884,27.316689158794432,0
2605,4,0,0,39,0.0,0.0,1.0,39,1100,800,300,0.7272727272727273,14,8,6,321.37739527826886,0.7526428250112461,0.13396321471622374,0.20675775377233957,134828.03397116298,866.1364736284612,135694.17044479144,2595,12,1053.3333333333333,38,1,13,32.01359599492507,0.6647478070175439,40.35790598290598,1038.5683760683762,27.33074673864148,0
2606,4,0,0,39,0.0,0.0,1.0,39,1100,900,200,0.8181818181818182,13,9,4,325.045321527733,0.7528115159694108,0.14294337991264117,0.21008078687709345,134994.52257515147,975.8675989845752,135970.39017413603,2596,13,1054.3333333333333,38,1,14,31.75289571981768,0.6663925438596492,40.19764957264957,1039.2094017094007,27.347615834457912,0
2607,4,0,0,39,0.0,0.0,1.0,39,1300,1000,300,0.7692307692307693,16,10,6,325.4001316667708,0.7528115159694108,0.1394922381358885,0.21111960542540062,135133.3415516106,994.4814266929466,136127.82297830353,2597,14,1055.3333333333333,38,1,15,31.605785039046456,0.667763157894737,40.064102564102555,1039.7435897435882,27.361673414304953,0
2608,4,0,0,39,0.0,0.0,1.0,39,1000,900,100,0.9,11,9,2,323.90428045373693,0.7525865946918578,0.13896682446975261,0.21031089804244285,135161.11390760812,955.8526691138643,136116.96657672198,2598,15,1056.3333333333333,38,1,15,31.617093051131892,0.6680372807017545,40.03739316239315,1039.850427350426,27.364484930274365,0
2609,4,0,1,38,0.0,0.02564102564102564,0.9743589743589743,39,650,400,250,0.6153846153846154,9,4,5,322.8998645591185,0.7523054430949168,0.13430988348819106,0.2101439225499716,135244.448097012,934.0827945795683,136178.53089159157,2599,16,1057.3333333333333,38,1,16,31.560488564776765,0.6688596491228072,39.95726495726495,1040.1709401709386,27.372919478182595,0
2610,4,0,0,38,0.0,0.0,1.0,38,1150,900,250,0.782608695652174,14,9,5,362.9493331146361,0.7431543385490754,0.15502315402565614,0.22997357307831345,134273.02295918387,2170.9078499085576,136443.93080909242,2600,65,1085.7368421052631,34,4,16,31.488580672333253,0.6672794117647057,40.89285714285715,1036.4285714285732,30.483193277310974,3
2611,4,0,0,38,0.0,0.0,1.0,38,650,400,250,0.6153846153846154,9,4,5,361.2452311287104,0.7425616405879564,0.15154848536131293,0.2292801364918959,134334.72222222236,2105.555555555575,136440.27777777793,2601,66,1086.7368421052631,34,4,17,31.471061093247588,0.667892156862745,40.83333333333334,1036.6666666666679,30.49019607843141,0
2612,4,0,0,38,0.0,0.0,1.0,38,900,700,200,0.7777777777777778,11,7,4,362.8181095631966,0.7428283546704599,0.1512032578288791,0.23086256774324368,134427.29768990932,2154.531604308393,136581.82929421772,2602,67,1087.7368421052631,34,4,17,31.337772165461306,0.6688112745098038,40.74404761904762,1037.0238095238096,30.50070028011205,0
2613,4,0,0,38,0.0,0.0,1.0,38,400,200,200,0.5,6,2,4,364.43938629321906,0.7411984352773826,0.15523438142331925,0.23229770838974606,134490.74743870023,2202.745091735247,136693.49253043547,2603,68,1088.7368421052631,35,3,17,31.232332812616217,0.6672619047619048,40.68287037037037,1037.2685185185182,29.63624338624338,0
2614,4,0,0,38,0.0,0.0,1.0,38,1000,800,200,0.8,12,8,4,366.6425268863515,0.7392128971076339,0.16281611555276387,0.23428564987840467,134581.66099773248,2268.6854480732627,136850.34644580574,2604,69,1089.7368421052631,34,4,17,31.084356356126662,0.6703431372549019,40.595238095238095,1037.619047619048,30.518207282913174,0
2615,4,0,0,38,0.0,0.0,1.0,38,1000,600,400,0.6,14,6,8,369.27039109647643,0.7382053105737316,0.16605900000603624,0.23656638794784574,134674.32149943322,2346.2478741496734,137020.5693735829,2605,70,1090.7368421052631,34,4,17,30.923605535803034,0.6712622549019608,40.50595238095239,1037.9761904761915,30.528711484593867,0
2616,4,0,0,38,0.0,0.0,1.0,38,1200,900,300,0.75,15,9,6,367.1898342972752,0.7378793266951161,0.16335849654225854,0.23618597728669868,134821.09917534704,2300.987413194421,137122.08658854145,2606,71,1091.7368421052631,35,3,16,30.831034770979596,0.6705357142857145,40.36458333333332,1038.5416666666652,29.672619047619005,0
2617,4,0,0,38,0.0,0.0,1.0,38,550,200,350,0.36363636363636365,9,2,7,387.36770901291464,0.7378793266951161,0.1487599754802269,0.24225644266178645,133792.42153893743,2767.814169215653,136560.23570815308,2607,72,1092.7368421052631,36,2,14,31.337986647799433,0.658275462962963,41.356981981981974,1034.5720720720708,28.738113113113076,8
2618,4,0,0,38,0.0,0.0,1.0,38,800,700,100,0.875,9,7,2,390.0331184757847,0.7378496917970602,0.15055106202598378,0.24411609622312705,133821.5495901305,2838.967261180079,136660.5168513106,2608,73,1093.7368421052631,36,2,14,31.23979647366128,0.6585648148148149,41.32882882882882,1034.6846846846834,28.741241241241205,0
2619,4,0,0,38,0.0,0.0,1.0,38,900,600,300,0.6666666666666666,12,6,6,390.22348680238855,0.7377311522048364,0.15008474188081178,0.24500917286117171,133938.0934989042,2853.1579721613393,136791.25147106554,2609,74,1094.7368421052631,36,2,15,31.117865172613868,0.6597222222222223,41.21621621621621,1035.1351351351343,28.75375375375373,0
2620,4,0,0,38,0.0,0.0,1.0,38,800,500,300,0.625,11,5,6,390.22348680238855,0.7377311522048364,0.15008474188081178,0.24500917286117171,133938.0934989042,2853.1579721613393,136791.25147106554,2610,75,1095.7368421052631,36,2,15,31.117865172613868,0.6597222222222223,41.21621621621621,1035.1351351351343,28.75375375375373,0
2621,4,0,0,38,0.0,0.0,1.0,38,1250,1000,250,0.8,15,10,5,390.26454579787867,0.7374940730203888,0.14900449950196326,0.24542354542173017,133996.38447569186,2858.8076251927537,136855.1921008846,2611,76,1096.7368421052631,36,2,15,31.058298890580815,0.6603009259259259,41.159909909909906,1035.36036036036,28.760010010009996,0
2622,4,0,0,38,0.0,0.0,1.0,38,1450,1100,350,0.7586206896551724,18,11,7,384.0255198487715,0.7367532005689901,0.14449656750572082,0.2426534878165312,134171.33349565763,2705.0432188945483,136876.37671455217,2612,77,1097.7368421052631,36,2,15,31.044384057971,0.6620370370370372,40.99099099099098,1036.0360360360346,28.77877877877874,0
2623,4,0,0,38,0.0,0.0,1.0,38,600,400,200,0.6666666666666666,8,4,4,384.2487961638232,0.7356270744428639,0.14574634804790731,0.24318139080464227,134229.67519884737,2715.5182209236095,136945.19341977098,2613,78,1098.7368421052631,36,2,15,30.98013113091357,0.6626157407407408,40.934684684684676,1036.2612612612602,28.785035035035005,0
2624,4,0,0,38,0.0,0.0,1.0,38,1000,800,200,0.8,12,8,4,388.46384223911303,0.7353307254623044,0.15078267034085346,0.246634353907122,134346.3966500282,2837.74348672995,137184.14013675816,2614,79,1099.7368421052631,36,2,15,30.753946701426614,0.6637731481481483,40.82207207207206,1036.71171171171,28.7975475475475,0
2625,4,0,0,38,0.0,0.0,1.0,38,850,400,450,0.47058823529411764,13,4,9,386.5822186023918,0.7363679468942627,0.14914375832100046,0.24642275540115077,134492.36979800742,2798.4717403214,137290.84153832882,2615,80,1100.7368421052631,36,2,16,30.656506712988097,0.6652199074074074,40.681306306306304,1037.2747747747744,28.813188188188178,0
2626,4,0,0,38,0.0,0.0,1.0,38,750,300,450,0.4,12,3,9,385.41393390482716,0.7348269321953532,0.15112278744826346,0.24627483374602824,134580.80317911954,2773.8760378676707,137354.67921698722,2616,81,1101.7368421052631,35,3,17,30.598275701803303,0.6681547619047619,40.59606481481482,1037.615740740741,29.646164021164033,0
2627,4,0,0,38,0.0,0.0,1.0,38,900,700,200,0.7777777777777778,11,7,4,382.1059475220054,0.7339675201517307,0.14613362129677432,0.24476615266981008,134670.88906035654,2691.709533607668,137362.5985939642,2617,82,1102.7368421052631,35,3,17,30.593963722866484,0.6690476190476191,40.50925925925925,1037.962962962962,29.656084656084627,0
2628,4,0,0,38,0.0,0.0,1.0,38,750,300,450,0.4,12,3,9,383.13395748821364,0.7335229966808914,0.14369670971944326,0.24562748139469515,134700.9243853951,2721.6996474193998,137422.6240328145,2618,83,1103.7368421052631,35,3,17,30.537244025718216,0.6693452380952382,40.48032407407407,1038.0787037037028,29.659391534391506,0
2629,4,0,0,38,0.0,0.0,1.0,38,900,900,0,1.0,9,9,0,383.28626803177843,0.7331081081081081,0.14493480441323947,0.24653961885656953,134821.09917534707,2735.0151909721985,137556.11436631926,2619,84,1104.7368421052631,35,3,15,30.41311434302907,0.6705357142857145,40.36458333333332,1038.5416666666654,29.672619047619012,0
2630,4,0,0,38,0.0,0.0,1.0,38,850,400,450,0.47058823529411764,13,4,9,387.12833891474327,0.7306187766714083,0.1458477447796367,0.25004591559543615,134971.39301483182,2850.250235768154,137821.64325059997,2620,85,1105.7368421052631,35,3,15,30.16308383455853,0.6720238095238096,40.2199074074074,1039.1203703703693,29.689153439153408,0
2631,4,1,1,38,0.02564102564102564,0.02564102564102564,0.9743589743589743,39,650,500,150,0.7692307692307693,8,5,3,380.95207504256325,0.7403846153846154,0.14832705911094846,0.2477798144431771,135223.42443795147,2502.7288267997747,137726.15326475125,2621,0,1078.3589743589744,36,3,16,30.07186552620182,0.6724537037037037,39.97747747747748,1040.0900900900901,28.891391391391394,0
2632,4,1,1,38,0.02564102564102564,0.02564102564102564,0.9743589743589743,39,650,300,350,0.46153846153846156,10,3,7,379.249774585718,0.7365609536662169,0.14850034139923762,0.24707400688454614,135281.9944099505,2461.133177096021,137743.12758704653,2622,0,1079.3333333333333,36,3,16,30.057687450386094,0.6730324074074073,39.921171171171174,1040.3153153153155,28.897647647647652,0
2633,4,1,0,39,0.02564102564102564,0.0,1.0,39,900,500,400,0.5555555555555556,13,5,8,376.2868161242848,0.7395973909131804,0.14739359237898708,0.24614430583416594,135428.47482195037,2391.989920663919,137820.46474261428,2623,0,1080.3076923076924,36,3,18,29.9886851310902,0.6744791666666666,39.78040540540541,1040.8783783783788,28.9132882882883,0
2634,4,0,0,39,0.0,0.0,1.0,39,1000,700,300,0.7,13,7,6,375.49003731378286,0.7384727845254161,0.14035321226842767,0.24642699609940066,135545.71621875273,2379.2132081405935,137924.92942689333,2624,1,1081.3076923076924,36,3,18,29.892577772971418,0.6756365740740741,39.6677927927928,1041.3288288288304,28.925800800800843,0
2635,4,0,0,39,0.0,0.0,1.0,39,1250,900,350,0.72,16,9,7,375.6799999999995,0.7389788573999101,0.1417435897435888,0.2471578947368422,135633.68055555577,2390.972222222243,138024.652777778,2625,2,1082.3076923076924,36,3,18,29.79999999999999,0.6765046296296295,39.58333333333334,1041.6666666666683,28.935185185185233,0
2636,4,0,0,39,0.0,0.0,1.0,39,1350,1100,250,0.8148148148148148,16,11,5,374.056139390714,0.7390913180386864,0.13904685889121637,0.24649340467541936,135692.33929875834,2351.310516597688,138043.649815356,2626,3,1083.3076923076924,36,3,18,29.783875558437813,0.6770833333333334,39.52702702702703,1041.8918918918928,28.941441441441466,0
2637,4,0,1,38,0.0,0.02564102564102564,0.9743589743589743,39,700,500,200,0.7142857142857143,9,5,4,346.8554361459611,0.7392600089968512,0.07595984683845614,0.21361785082717807,133223.94035585146,1441.8895874424777,134665.82994329394,2627,4,1084.3076923076924,38,1,16,32.95495705267516,0.6488486842105262,41.907051282051285,1032.3717948717951,27.167678812415662,8
2638,4,0,0,38,0.0,0.0,1.0,38,700,400,300,0.5714285714285714,10,4,6,352.8392953843341,0.7273589378852536,0.07870129579607266,0.21660604102165498,133104.23790252782,1792.8811028393475,134897.11900536716,2628,93,1113.7368421052631,37,1,16,32.92058495377751,0.6494932432432432,42.02302631578948,1031.907894736843,27.889402560455217,0
2639,4,0,0,38,0.0,0.0,1.0,38,650,300,350,0.46153846153846156,10,3,7,354.62040697367763,0.7272403982930299,0.07796685877392706,0.21823836765475624,133196.36774965297,1846.8300277595106,135043.19777741248,2629,94,1114.7368421052631,38,0,17,32.782205202511555,0.6485745614035088,41.93376068376068,1032.264957264957,27.16486729644624,0
2640,4,0,0,38,0.0,0.0,1.0,38,500,300,200,0.6,7,3,4,357.3254650974737,0.7260550023707919,0.07710112408504699,0.22022916420293281,133251.51581561842,1922.831972751846,135174.34778837027,2630,95,1115.7368421052631,38,0,17,32.65706919150109,0.6491228070175439,41.88034188034188,1032.4786324786328,27.170490328385075,0
2641,4,0,0,38,0.0,0.0,1.0,38,950,600,350,0.631578947368421,13,6,7,360.99259001014894,0.7258771929824561,0.08448266477984023,0.22348260854021368,133417.02849915982,2032.511733873902,135449.5402330337,2631,96,1116.7368421052631,38,0,18,32.39637194071009,0.6507675438596492,41.720085470085465,1033.1196581196573,27.187359424201507,0
2642,4,0,0,38,0.0,0.0,1.0,38,900,600,300,0.6666666666666666,12,6,6,360.5415151862613,0.7246917970602181,0.08889533974945851,0.22422067316464853,133585.55036164974,2032.6387611501991,135618.18912279993,2632,97,1117.7368421052631,37,1,18,32.23907509546033,0.6542792792792793,41.55701754385965,1033.7719298245615,27.93978188715031,0
2643,4,0,0,38,0.0,0.0,1.0,38,700,400,300,0.5714285714285714,10,4,6,359.3094847449928,0.7245139876718825,0.08400401852988781,0.2237971229290146,133642.23246575863,2003.7843374884505,135646.01680324707,2633,98,1118.7368421052631,37,1,18,32.21412159773772,0.6548423423423424,41.50219298245614,1033.9912280701749,27.945708866761482,0
2644,4,0,0,38,0.0,0.0,1.0,38,700,500,200,0.7142857142857143,9,5,4,357.3922782960553,0.725343764817449,0.08249556475458308,0.22328733466523087,133755.63274276705,1960.6460641735925,135716.27880694065,2634,99,1119.7368421052631,37,1,13,32.15011306621439,0.6559684684684685,41.39254385964912,1034.4298245614036,27.95756282598388,0
2645,4,0,0,38,0.0,0.0,1.0,38,550,200,350,0.36363636363636365,9,2,7,355.9182861904269,0.7248399715504978,0.07899199509106625,0.22253737774729465,133783.99032635032,1923.2337113342446,135707.22403768456,2635,100,1120.7368421052631,37,1,13,32.15984366719661,0.65625,41.36513157894736,1034.5394736842097,27.96052631578945,0
2646,4,0,0,38,0.0,0.0,1.0,38,1000,600,400,0.6,14,6,8,355.77562446152115,0.7243065433854907,0.0772745774808885,0.22313396141477054,133897.45071800938,1927.4898286011044,135824.94054661048,2636,101,1121.7368421052631,37,1,14,32.04998322562417,0.6573761261261262,41.25548245614035,1034.9780701754385,27.97238027501185,0
2647,4,0,0,38,0.0,0.0,1.0,38,900,600,300,0.6666666666666666,12,6,6,354.90789284688344,0.7243361782835467,0.07716324710080258,0.2227613369996393,133925.8233302553,1906.2663511849637,135832.08968144027,2637,102,1122.7368421052631,37,1,14,32.04405014124295,0.6576576576576577,41.22807017543859,1035.0877192982443,27.975343764817413,0
2648,4,0,0,38,0.0,0.0,1.0,38,850,700,150,0.8235294117647058,10,7,3,369.58203125,0.7243361782835467,0.09942434210526341,0.2174011948529412,131492.4391847469,2119.448553583172,133611.8877383301,2638,103,1123.7368421052631,38,0,15,34.11328125,0.631578947368421,43.58974358974359,1025.6410256410259,26.990553306342786,5
2649,4,0,0,38,0.0,0.0,1.0,38,1000,700,300,0.7,13,7,6,367.4971905628928,0.7232396870554766,0.10247130058357734,0.2169520906795688,131629.44614517127,2074.6903307400066,133704.13647591128,2639,104,1124.7368421052631,38,0,15,34.028283879923656,0.6329495614035088,43.45619658119658,1026.1752136752134,27.004610886189827,0
2650,4,0,0,38,0.0,0.0,1.0,38,1000,800,200,0.8,12,8,4,368.5813217217432,0.7229433380749171,0.108218787835624,0.21790527740189441,131684.26890432087,2107.2723765431974,133791.54128086407,2640,105,1125.7368421052631,38,0,15,33.94508344609832,0.6334978070175439,43.40277777777777,1026.388888888888,27.01023391812863,0
2651,4,0,0,38,0.0,0.0,1.0,38,1300,1000,300,0.7692307692307693,16,10,6,374.5830162176904,0.7224691797060219,0.10580244953379991,0.22241300400868763,131848.80566741523,2277.6646623200877,134126.4703297353,2641,106,1126.7368421052631,38,0,15,33.62482228926106,0.6351425438596492,43.242521367521356,1027.029914529913,27.027103013945077,0
2652,4,0,0,38,0.0,0.0,1.0,38,700,600,100,0.8571428571428571,8,6,2,371.16660106623607,0.7221135609293504,0.1017031244014166,0.22102224163801767,131958.55391418267,2195.7215875885477,134154.27550177122,2642,107,1127.7368421052631,38,0,15,33.601738241308794,0.6362390350877194,43.13568376068375,1027.4572649572629,27.038349077822705,0
2653,4,0,0,38,0.0,0.0,1.0,38,1050,700,350,0.6666666666666666,14,7,7,372.3675768583641,0.7220542911332385,0.1057364536197547,0.2220585072412028,132013.44515897785,2231.5053373146116,134244.95049629247,2643,108,1128.7368421052631,38,0,15,33.515481512284715,0.6367872807017545,43.08226495726495,1027.6709401709388,27.043972109761548,0
2654,4,0,0,38,0.0,0.0,1.0,38,950,700,250,0.7368421052631579,12,7,5,368.1530276553006,0.724158368895211,0.09235135844599007,0.22034233446235146,132150.7232084154,2130.3377712031424,134281.06097961855,2644,109,1129.7368421052631,38,0,16,33.48529717373231,0.6381578947368423,42.94871794871794,1028.2051282051275,27.058029689608617,0
2655,4,0,0,38,0.0,0.0,1.0,38,1300,900,400,0.6923076923076923,17,9,8,369.3170679632385,0.7238027501185396,0.09847515986227307,0.22200520377565422,132315.5510355027,2173.2782708743994,134488.8293063771,2645,110,1130.7368421052631,38,0,16,33.28920041536863,0.6398026315789475,42.788461538461526,1028.8461538461518,27.074898785425045,0
2656,4,1,0,39,0.02564102564102564,0.0,1.0,39,1100,900,200,0.8181818181818182,13,9,4,360.4886930919424,0.7330746738641476,0.09793699455848004,0.21810227784008202,132558.85959201376,1757.194010416658,134316.05360243042,2646,0,1102.7179487179487,39,0,17,33.27137703149236,0.6404914529914532,42.55208333333333,1029.7916666666656,26.404914529914503,0
2657,4,1,1,39,0.025,0.025,0.975,40,800,700,100,0.875,9,7,2,358.82417123285825,0.7459134615384615,0.0882952691680261,0.2055693616502265,130475.34722222241,1378.3962673611302,131853.74348958355,2647,0,1076.125,39,1,18,35.41836595976075,0.6196581196581196,44.58333333333334,1021.6666666666681,26.196581196581235,6
2658,4,0,0,39,0.0,0.0,1.0,39,1200,800,400,0.6666666666666666,16,8,8,364.6260522127366,0.7362798020692758,0.08930926873210487,0.20906975799536026,130508.09500328716,1717.3302925706616,132225.42529585783,2648,1,1104.6923076923076,38,1,13,35.236956294437476,0.6217105263157896,44.551282051282044,1021.7948717948706,26.889338731443964,0
2659,4,1,1,39,0.025,0.025,0.975,40,1150,1000,150,0.8695652173913043,13,10,3,357.68061356971333,0.744684829059829,0.0899694501018331,0.20661315442674014,130794.81336805546,1356.5538194444343,132151.36718749988,2649,0,1078.05,39,1,14,35.123896809232846,0.6228632478632479,44.27083333333333,1022.9166666666658,26.228632478632456,0
2660,4,0,0,39,0.0,0.0,1.0,39,1100,800,300,0.7272727272727273,14,8,6,363.86318815620695,0.7366734143049933,0.09488224091796682,0.20996156119465745,130753.83434007232,1715.3014053254478,132469.13574539777,2650,3,1106.6923076923076,38,1,15,35.00731223232008,0.6241776315789473,44.31089743589744,1022.7564102564103,26.914642375168693,0
2661,4,0,0,39,0.0,0.0,1.0,39,700,400,300,0.5714285714285714,10,4,6,361.6831081463056,0.7365047233468286,0.09771222929117696,0.20914718862373333,130835.7988165681,1664.219674556218,132500.01849112433,2651,4,1107.6923076923076,38,1,15,34.98002819548872,0.625,44.23076923076923,1023.0769230769234,26.923076923076934,0
2662,4,0,0,39,0.0,0.0,1.0,39,800,700,100,0.875,9,7,2,360.1656752882494,0.7370670265407108,0.09635799444716642,0.20841732158523044,130863.12601587042,1626.4812303674496,132489.60724623787,2652,5,1108.6923076923076,38,1,15,34.9911680762939,0.6252741228070176,44.20405982905983,1023.1837606837607,26.925888439046336,0
2663,4,0,0,39,0.0,0.0,1.0,39,450,400,50,0.8888888888888888,5,4,1,363.7370700803876,0.7368983355825461,0.10095802516723307,0.2107826614821557,130917.78897518083,1723.9305966469492,132641.71957182777,2653,6,1109.6923076923076,38,1,15,34.84445140411318,0.6258223684210527,44.15064102564103,1023.397435897436,26.931511470985157,0
2664,4,1,0,40,0.025,0.0,1.0,40,1050,700,350,0.6666666666666666,14,7,7,355.1740265899767,0.740892094017094,0.10873653181540943,0.20774090806136716,131274.7450086807,1325.0759548611304,132599.82096354183,2654,0,1082.925,39,1,16,34.702598766687004,0.6276709401709402,43.80208333333334,1024.791666666668,26.27670940170944,0
2665,4,1,1,40,0.024390243902439025,0.024390243902439025,0.975609756097561,41,1100,900,200,0.8181818181818182,13,9,4,351.0648617722117,0.7515243902439024,0.10405975708822934,0.20677552384765174,131541.7534722221,1035.9483506944382,132577.70182291654,2655,0,1057.4878048780488,39,2,16,34.53831573246684,0.6303418803418804,43.541666666666664,1025.8333333333326,26.303418803418783,0
2666,4,1,0,41,0.024390243902439025,0.0,1.0,41,1450,1000,450,0.6896551724137931,19,10,9,347.9718333614437,0.7498983739837398,0.10540069686411146,0.20610639360639374,131755.55555555568,969.4444444444637,132725.00000000015,2656,0,1058.4634146341464,39,2,12,34.40205627705629,0.6324786324786325,43.33333333333334,1026.6666666666679,26.324786324786356,0
2667,4,0,1,40,0.0,0.024390243902439025,0.975609756097561,41,650,300,350,0.46153846153846156,10,3,7,348.6071587344738,0.7491869918699187,0.10631694284486892,0.2069931813261217,131849.47472569236,992.7341529512856,132842.20887864364,2657,1,1059.4634146341464,40,1,13,34.291097697737314,0.6317708333333333,43.24186991869919,1027.0325203252032,25.67581300813008,0
2668,4,0,0,40,0.0,0.0,1.0,40,550,200,350,0.36363636363636365,9,2,7,354.7268092638411,0.7435096153846154,0.10734219606251205,0.2098126037506538,131702.08875868068,1343.6523437500089,133045.74110243068,2658,2,1086.875,39,1,13,34.2826094310263,0.6319444444444444,43.38541666666667,1026.4583333333344,26.31944444444447,0
2669,4,0,0,40,0.0,0.0,1.0,40,1100,1000,100,0.9090909090909091,12,10,2,355.23489992750075,0.7434294871794872,0.11019119586164905,0.21085255137779835,131835.7760959202,1366.5337456597267,133202.30984157993,2659,3,1087.875,39,1,14,34.13473729587178,0.6332799145299146,43.255208333333336,1026.9791666666672,26.33279914529916,0
2670,4,1,0,41,0.024390243902439025,0.0,1.0,41,800,700,100,0.875,9,7,2,349.48003710536256,0.7520833333333333,0.1154269015999767,0.20894444771618498,132110.53688280794,1033.9990663626236,133144.53594917056,2660,0,1062.3170731707316,40,1,16,34.00574172927376,0.634375,42.987804878048784,1028.0487804878055,25.701219512195138,0
2671,4,0,0,41,0.0,0.0,1.0,41,900,600,300,0.6666666666666666,12,6,6,348.66177574324774,0.7531504065040651,0.10702879634785067,0.20888741910869885,132188.90587819752,1017.84373140988,133206.7496096074,2661,1,1063.3170731707316,40,1,16,33.947895048917886,0.63515625,42.91158536585366,1028.3536585365855,25.708841463414636,0
2672,4,2,0,43,0.046511627906976744,0.0,1.0,43,850,600,250,0.7058823529411765,11,6,5,341.17522892535936,0.7702565522332964,0.13229811100970856,0.20769502831698644,132790.50684942826,461.2968058034252,133251.8036552317,2662,0,1014.8139534883721,40,3,13,33.536079340038135,0.6411458333333333,42.327235772357724,1030.6910569105692,25.76727642276423,0
2673,4,0,0,43,0.0,0.0,1.0,43,750,600,150,0.8,9,6,3,342.72388489038605,0.7699796973052787,0.12765020908223934,0.20892975290433147,132842.8845264062,505.68589298697395,133348.5704193932,2663,1,1015.8139534883721,40,3,13,33.44362020241851,0.6416666666666667,42.27642276422764,1030.894308943089,25.772357723577226,0
2674,4,0,0,43,0.0,0.0,1.0,43,850,600,250,0.7058823529411765,11,6,5,341.62590266477673,0.7700719822812846,0.12338004666749192,0.20855213047152948,132895.27253123128,480.09348767266863,133375.36601890397,2664,2,1016.8139534883721,40,3,13,33.41936888100402,0.6421875000000001,42.225609756097555,1031.0975609756088,25.77743902439022,0
2675,4,0,1,42,0.0,0.023255813953488372,0.9767441860465116,43,1400,1100,300,0.7857142857142857,17,11,6,341.93582014735284,0.7699335548172758,0.12516405965472477,0.2097688448311826,133078.71187991602,500.8756981624685,133579.5875780785,2665,3,1017.8139534883721,40,3,13,33.22745329787583,0.6440104166666667,42.047764227642276,1031.8089430894306,25.795223577235767,0
2676,4,0,1,41,0.0,0.023809523809523808,0.9761904761904762,42,1250,900,350,0.72,16,9,7,374.8352241337502,0.7617111885404568,0.05962513716302409,0.22598013449965865,132425.49332493232,1536.225867888435,133961.71919282075,2666,4,1042.9285714285713,38,4,15,33.0364248148917,0.6408991228070176,42.681623931623925,1029.2735042735032,27.086144849302716,5
2677,4,0,0,41,0.0,0.0,1.0,41,1100,700,400,0.6363636363636364,15,7,8,372.8771555459913,0.7549288617886178,0.06623140709437636,0.22365659666300677,132233.12428090078,1665.4628031631264,133898.5870840639,2667,5,1069.121951219512,38,3,16,33.280746857795776,0.6389802631578947,42.868589743589745,1028.5256410256413,27.06646423751688,4
2678,4,1,0,42,0.023809523809523808,0.0,1.0,42,1300,900,400,0.6923076923076923,17,9,8,370.15962957707694,0.763187185443283,0.07849056795080456,0.22417210835702667,132595.55975155818,1416.510113176612,134012.06986473477,2668,0,1044.642857142857,37,5,19,32.98544572199155,0.6444256756756757,42.516447368421055,1029.9342105263158,27.836059743954483,0
2679,4,0,0,42,0.0,0.0,1.0,42,900,500,400,0.5555555555555556,13,5,8,368.87246590340374,0.7635259388308169,0.0834840906672345,0.22406558255295977,132708.51518015168,1390.5034481763757,134099.01862832805,2669,1,1045.642857142857,37,5,16,32.904894292504714,0.6455518018018017,42.40679824561404,1030.3728070175446,27.84791370317688,0
2680,4,0,1,41,0.0,0.023809523809523808,0.9761904761904762,42,1600,1400,200,0.875,18,14,4,365.36441828881846,0.762824235385211,0.08303951367781215,0.22243688678205284,132793.26331178838,1303.586680517101,134096.84999230548,2670,2,1046.642857142857,37,5,16,32.91001773049646,0.6463963963963963,42.32456140350878,1030.701754385966,27.856804172593677,0
2681,4,0,0,41,0.0,0.0,1.0,41,400,200,200,0.5,6,2,4,372.8022154905847,0.7537093495934959,0.08597247664834784,0.22597891750115193,132629.89921932085,1688.9440538511726,134318.84327317204,2671,3,1072.9756097560976,36,5,16,32.88282132575345,0.6467013888888888,42.48310810810812,1030.067567567569,28.61298798798803,0
2682,4,0,0,41,0.0,0.0,1.0,41,1250,1000,250,0.8,15,10,5,374.24660130079684,0.751219512195122,0.09030146682585682,0.2277330382383576,132774.93709926165,1738.113789465168,134513.0508887268,2672,4,1073.9756097560976,36,5,17,32.69959207459208,0.6481481481481481,42.342342342342356,1030.6306306306324,28.628628628628675,0
2683,4,0,0,41,0.0,0.0,1.0,41,1050,600,450,0.5714285714285714,15,6,9,375.17345903518884,0.7495426829268292,0.08664593292747802,0.22892641371238684,132878.03849501777,1770.4626663973636,134648.50116141513,2673,5,1074.9756097560976,37,4,17,32.571940692686745,0.6472409909909909,42.242324561403514,1031.0307017543864,27.865694642010443,0
2684,4,0,0,41,0.0,0.0,1.0,41,850,600,250,0.7058823529411765,11,6,5,378.4836107061871,0.7483231707317073,0.09106935457109655,0.2318212115575398,133019.39058171763,1869.1318482610232,134888.52242997865,2674,6,1075.9756097560976,37,4,17,32.34437003968254,0.6486486486486486,42.10526315789475,1031.5789473684224,27.880512091038444,0
2685,4,0,0,41,0.0,0.0,1.0,41,1150,600,550,0.5217391304347826,17,6,11,377.6551297258719,0.7481707317073171,0.0972604053035111,0.2321925366498783,133160.8178117307,1857.7731850184841,135018.59099674918,2675,7,1076.9756097560976,37,4,18,32.223498530401216,0.6500563063063062,41.96820175438597,1032.1271929824575,27.895329540066417,0
2686,4,0,0,41,0.0,0.0,1.0,41,1250,900,350,0.72,16,9,7,374.3954983079449,0.748729674796748,0.09654547103091815,0.23053849683252495,133217.40974386368,1775.1997008695191,134992.6094447332,2676,8,1077.9756097560976,37,4,18,32.25073021773767,0.6506193693693693,41.913377192982466,1032.3464912280717,27.901256519677613,0
2687,4,0,0,41,0.0,0.0,1.0,41,1250,900,350,0.72,16,9,7,375.15992999219003,0.749339430894309,0.09696034546588939,0.2320670847312166,133387.2576778435,1808.3108504540185,135195.56852829753,2677,9,1078.9756097560976,37,4,18,32.06035718076639,0.6523085585585584,41.748903508771946,1033.0043859649147,27.91903745851121,0
2688,4,0,0,41,0.0,0.0,1.0,41,900,700,200,0.7777777777777778,11,7,4,372.5666683083674,0.7480691056910569,0.08884518341204584,0.2311679294803401,133500.54974848044,1747.5710074253734,135248.1207559058,2678,10,1079.9756097560976,37,4,19,32.013594164456215,0.6534346846846846,41.63925438596492,1033.4429824561414,27.93089141773355,0
2689,4,0,0,41,0.0,0.0,1.0,41,1500,1100,400,0.7333333333333333,19,11,8,376.46192053963597,0.7458841463414634,0.08590912383455618,0.2341215690532776,133585.55036164974,1857.9745690981865,135443.52493074792,2679,11,1080.9756097560976,37,4,19,31.827623391316656,0.6542792792792793,41.55701754385965,1033.7719298245615,27.93978188715031,0
2690,4,0,0,41,0.0,0.0,1.0,41,950,400,550,0.42105263157894735,15,4,11,377.44423189673535,0.7458841463414634,0.08642321928552499,0.20272373407998773,127928.27641034761,1476.2143497751404,129404.49076012275,2680,12,1081.9756097560976,38,3,17,37.54268314147924,0.5956688596491229,47.08867521367521,1011.6452991452982,26.62224471434995,8
2691,4,2,2,41,0.046511627906976744,0.046511627906976744,0.9534883720930233,43,800,600,200,0.75,10,6,4,363.2168547329866,0.7670727205610927,0.09349386250441172,0.197603298033634,128442.17985243622,730.838172985605,129173.01802542183,2681,0,1032.6046511627908,38,5,16,37.376598510399106,0.6008771929824561,46.58119658119658,1013.6752136752134,26.675663517768772,0
2692,4,3,2,42,0.06818181818181818,0.045454545454545456,0.9545454545454546,44,1250,1000,250,0.8,15,10,5,360.42603550295865,0.7811839323467231,0.11871794871794861,0.19853976531942633,128936.76757812501,494.43359375000057,129431.20117187501,2682,0,1006.1136363636364,39,5,18,36.942307692307686,0.6041666666666667,46.09375,1015.6250000000001,26.041666666666668,0
2693,4,3,1,44,0.06666666666666667,0.022222222222222223,0.9777777777777777,45,1250,800,450,0.64,17,8,9,352.10416020832037,0.7835858585858586,0.1426561679790026,0.19647288377177807,129445.8954840565,116.23019908776678,129562.12568314426,2683,0,984.6888888888889,38,7,17,36.635170603674545,0.6110197368421053,45.592948717948715,1017.6282051282049,26.77968960863697,0
2694,4,0,0,44,0.0,0.0,1.0,44,1200,600,600,0.5,18,6,12,357.53725286687063,0.7768454897815363,0.14983200335993274,0.19936679135269747,129418.71667031912,454.40248557234287,129873.11915589146,2684,1,1008.0681818181819,38,6,20,36.52461325773484,0.6107456140350878,45.61965811965811,1017.5213675213665,26.77687809266754,0
2695,4,1,0,45,0.022222222222222223,0.0,1.0,45,1300,800,500,0.6153846153846154,18,8,10,348.09966781050224,0.7828703703703704,0.15269652962432634,0.1953914208869743,129678.39084201399,28.200954861115463,129706.5917968751,2685,0,986.6444444444444,39,6,19,36.50073293788776,0.6116452991452992,45.364583333333336,1018.5416666666675,26.116452991453013,0
2696,4,1,1,45,0.021739130434782608,0.021739130434782608,0.9782608695652174,46,950,600,350,0.631578947368421,13,6,7,342.38133774844283,0.7903985507246377,0.1545433005568062,0.1933137706979668,129908.3719135802,-304.35956790124067,129604.01234567896,2686,0,966.1739130434783,41,5,19,36.412920072661215,0.6107723577235773,45.138888888888886,1019.444444444444,24.86449864498644,0
2697,4,0,0,45,0.0,0.0,1.0,45,1250,800,450,0.64,17,8,9,349.6957621173679,0.7805555555555556,0.15888401365066707,0.1970083765456721,129822.05119307282,79.64422632030386,129901.69541939313,2687,2,988.6444444444444,40,5,20,36.31415370296503,0.6114583333333334,45.22357723577235,1019.1056910569099,25.47764227642275,0
2698,4,4,5,44,0.08163265306122448,0.10204081632653061,0.8979591836734694,49,1250,800,450,0.64,17,8,9,322.8067734337741,0.8072916666666667,0.1660511393864581,0.18557431351241885,130609.02970261716,-1366.2117341587875,129242.81796845837,2688,0,908.8571428571429,42,7,13,36.20327361203273,0.6163194444444444,44.452519379844965,1022.1899224806212,24.33785529715765,0
2699,4,0,0,44,0.0,0.0,1.0,44,1050,700,350,0.6666666666666666,14,7,7,351.59349624489107,0.7717582804792107,0.1570934175686347,0.19829062598018796,129864.12896050354,331.87662760417663,130196.00558810771,2689,4,1012.9772727272727,39,5,20,36.2230667688639,0.6135149572649572,45.18229166666667,1019.2708333333339,26.13514957264959,0
2700,4,3,1,46,0.06382978723404255,0.02127659574468085,0.9787234042553191,47,1500,1000,500,0.6666666666666666,20,10,10,336.01896535694385,0.7920135676842429,0.16987440443084378,0.19351384146858727,130677.89019639461,-616.7294051108133,130061.1607912838,2690,0,949.2553191489362,40,7,20,35.79601928237748,0.6200520833333333,44.38516260162603,1022.4593495934981,25.561483739837453,0
2701,4,0,0,46,0.0,0.0,1.0,46,850,700,150,0.8235294117647058,10,7,3,345.61365963680083,0.7871376811594203,0.1710112439195115,0.1988190185038433,130635.03146701405,-170.14973958331495,130464.88172743074,2691,1,970.8913043478261,39,7,21,35.59413423001156,0.6212606837606837,44.42708333333334,1022.291666666668,26.21260683760687,0
2702,4,0,0,46,0.0,0.0,1.0,46,1350,1100,250,0.8148148148148148,16,11,5,343.41155047473654,0.7875402576489533,0.16315416629770652,0.19837067209775996,130794.81336805584,-216.71006944440998,130578.10329861143,2692,2,971.8913043478261,39,7,22,35.48879837067211,0.6228632478632476,44.27083333333335,1022.9166666666689,26.228632478632537,0
2703,4,0,1,45,0.0,0.021739130434782608,0.9782608695652174,46,1200,700,500,0.5833333333333334,17,7,10,342.41737825292427,0.7857085346215781,0.161664004144898,0.19839718061029651,130911.78882444341,-234.7056976667039,130677.0831267767,2693,3,972.8913043478261,40,6,22,35.39597815292949,0.6223958333333333,44.156504065040664,1023.3739837398398,25.584349593495993,0
2704,4,0,0,45,0.0,0.0,1.0,45,950,500,450,0.5263157894736842,14,5,9,345.8657386285261,0.7807659932659933,0.158559536735432,0.2003410976584107,130901.38888888914,54.86111111113544,130956.25000000028,2694,4,994.8222222222222,39,6,22,35.318268186753514,0.6239316239316238,44.16666666666668,1023.3333333333353,26.239316239316288,0
2705,4,0,0,45,0.0,0.0,1.0,45,1150,800,350,0.6956521739130435,15,8,7,344.8860156546832,0.7796717171717172,0.1575050320012663,0.20005017649485962,130954.69292534741,32.88845486113078,130987.58138020853,2695,5,995.8222222222222,39,6,22,35.28945315150282,0.6244658119658119,44.11458333333334,1023.5416666666681,26.24465811965816,0
2706,4,0,0,45,0.0,0.0,1.0,45,1550,1300,250,0.8387096774193549,18,13,5,342.49648040426985,0.7776094276094276,0.15318098135837976,0.19965425251559538,131145.89659139764,-16.59839959676873,131129.2981918009,2696,6,996.8222222222222,40,5,23,35.157464364851016,0.6247395833333332,43.9278455284553,1024.2886178861816,25.607215447154537,0
2707,4,2,3,44,0.0425531914893617,0.06382978723404255,0.9361702127659575,47,1150,500,650,0.43478260869565216,18,5,13,329.2509554297395,0.7898936170212766,0.14739156160595002,0.1938159670803758,131519.83486969463,-738.8876777264286,130780.94719196821,2697,0,955.3617021276596,38,9,23,35.119822587924865,0.6318530701754386,43.56303418803419,1025.747863247863,26.993364822312184,0
2708,4,1,0,45,0.022222222222222223,0.0,1.0,45,950,800,150,0.8421052631578947,11,8,3,338.0084382799385,0.7854377104377105,0.1773890103787008,0.1992569080909913,131574.6348002958,-105.33263477976112,131469.30216551604,2698,0,994.6222222222223,38,7,17,34.84002395084868,0.6324013157894737,43.50961538461538,1025.9615384615379,26.998987854251,0
2709,4,0,0,45,0.0,0.0,1.0,45,1150,800,350,0.6956521739130435,15,8,7,335.95119030398035,0.7839225589225589,0.18246880168395752,0.1986143437077131,131684.26890432098,-152.1026234567883,131532.16628086418,2699,1,995.6222222222223,38,7,18,34.782363554352735,0.6334978070175439,43.40277777777778,1026.388888888889,27.010233918128655,0
2710,4,0,0,45,0.0,0.0,1.0,45,1000,500,500,0.5,15,5,10,332.28400516832085,0.7827020202020203,0.1842141767235399,0.1971551763998705,131821.3757396451,-239.57306048651253,131581.80267915857,2700,2,996.6222222222223,38,7,18,34.73847794423636,0.6348684210526315,43.269230769230774,1026.9230769230778,27.02429149797573,0
2711,4,1,0,46,0.021739130434782608,0.0,1.0,46,900,500,400,0.5555555555555556,13,5,8,328.30287142850307,0.79170692431562,0.18566038222363512,0.1964186960521685,132136.6572993094,-523.8311975345248,131612.82610177487,2701,0,975.9347826086956,40,6,19,34.52378010609206,0.6346354166666666,42.962398373983746,1028.150406504066,25.70376016260165,0
2712,4,1,0,47,0.02127659574468085,0.0,1.0,47,1550,1100,450,0.7096774193548387,20,11,9,353.7509217723374,0.7968701819303113,0.2507351842762324,0.19188774157074068,128324.66310562535,-320.4900356929993,128004.17306993235,2702,0,956.1489361702128,40,7,21,37.73654296222,0.5963541666666665,46.697154471544735,1013.2113821138244,25.330284552845608,8
2713,4,1,1,47,0.020833333333333332,0.020833333333333332,0.9791666666666666,48,1700,1500,200,0.8823529411764706,19,15,4,358.2277583091354,0.8040226063829787,0.2605213008477594,0.17888449104892715,124946.58690371852,-607.4204794334994,124339.16642428502,2703,0,937.2083333333334,38,10,18,41.099638455510444,0.5652412280701753,50.053418803418815,999.7863247863265,26.310166441745434,7
2714,4,6,3,50,0.11320754716981132,0.05660377358490566,0.9433962264150944,53,1600,1300,300,0.8125,19,13,6,317.9795493522098,0.8447024673439767,0.24871853063396454,0.1634645401893774,126148.45920138928,-2558.2751490703813,123590.1840523189,2704,0,805.0188679245283,39,14,19,40.86824277616479,0.5758547008547007,48.854166666666686,1004.5833333333366,25.75854700854709,0
2715,4,2,1,51,0.038461538461538464,0.019230769230769232,0.9807692307692307,52,1500,1000,500,0.6666666666666666,20,10,10,325.26112988273974,0.8384709653092005,0.2543466124337046,0.16731432521168163,126174.62158203148,-2192.060004340248,123982.56157769123,2705,0,821.4615384615385,39,13,20,40.65848021427339,0.5761217948717947,48.828125000000014,1004.6875000000018,25.761217948717995,0
2716,4,5,6,50,0.08928571428571429,0.10714285714285714,0.8928571428571429,56,1200,900,300,0.75,15,9,6,306.67304145891654,0.854396645021645,0.2771546635183,0.16133668702838663,127092.01388888898,-3404.861111111102,123687.15277777787,2706,0,763.6964285714286,43,13,17,40.185950413223146,0.5794573643410852,47.91666666666667,1008.3333333333342,23.449612403100794,0
2717,4,5,2,53,0.09090909090909091,0.03636363636363636,0.9636363636363636,55,1150,800,350,0.6956521739130435,15,8,7,317.5118528448973,0.8600448933782268,0.2911068985411689,0.16756726013776174,127220.1372880727,-2921.2196980963577,124298.91758997634,2707,0,778.3636363636364,40,15,21,39.781656089453,0.5851562499999999,47.78963414634147,1008.8414634146352,25.22103658536588,0
2718,4,1,1,53,0.018518518518518517,0.018518518518518517,0.9814814814814815,54,1400,1100,300,0.7857142857142857,17,11,6,325.54067740832676,0.8546907756813418,0.29834116882620476,0.17237645705391733,127354.736328125,-2508.170572916668,124846.56575520833,2708,0,793.3148148148148,39,15,16,39.44143446852425,0.5881410256410255,47.65625,1009.375,25.881410256410255,0
2719,4,0,2,51,0.0,0.03773584905660377,0.9622641509433962,53,2200,1800,400,0.8181818181818182,26,18,8,333.02487773602905,0.8506591678761489,0.30155257800868984,0.1767593581829694,127450.92207019645,-2111.1344520457233,125339.78761815073,2709,2,809.2830188679245,40,13,16,39.15412808641977,0.5874999999999999,47.560975609756106,1009.7560975609767,25.243902439024417,0
2720,4,2,3,50,0.03773584905660377,0.05660377358490566,0.9433962264150944,53,1300,900,400,0.6923076923076923,17,9,8,336.0369240367011,0.8469097726173197,0.30083161582461293,0.1790396087230913,127604.89477989299,-2024.0087332275637,125580.88604666543,2710,0,810.1698113207547,40,13,17,38.920530744987616,0.5890624999999999,47.40853658536586,1010.3658536585372,25.259146341463428,0
2721,4,3,4,49,0.05660377358490566,0.07547169811320754,0.9245283018867925,53,1300,900,400,0.6923076923076923,17,9,8,339.0756178206287,0.8450350749879051,0.3067991290559975,0.18135076591825888,127758.96044021418,-1936.0103113226232,125822.95012889156,2711,0,811.0377358490566,40,13,18,38.686168073984724,0.590625,47.25609756097561,1010.9756097560977,25.27439024390244,0
2722,4,0,0,49,0.0,0.0,1.0,49,1050,500,550,0.47619047619047616,16,5,11,350.5984693024708,0.8284084467120182,0.3115956383644092,0.1811063304244708,126346.81013629203,-932.503320803381,125414.30681548864,2712,5,872.0204081632653,37,12,17,39.84474406514707,0.5813626126126126,48.65679824561404,1005.3728070175446,27.172238027501205,6
2723,4,1,0,50,0.02,0.0,1.0,50,1000,800,200,0.8,12,8,4,348.25208085612365,0.836156462585034,0.32013793103448296,0.18164227238898537,126742.1392746913,-1172.3572530864258,125569.78202160489,2713,0,855.56,38,12,18,39.497126436781606,0.5836074561403508,48.263888888888886,1006.944444444444,26.498538011695896,0
2724,4,5,3,52,0.09090909090909091,0.05454545454545454,0.9454545454545454,55,1200,900,300,0.75,15,9,6,325.1600139809749,0.8592312008978675,0.3358251007525237,0.17449113171315908,127893.53820231807,-2681.8625598387343,125211.67564247934,2714,0,778.6909090909091,41,14,17,38.900467503596204,0.5904471544715446,47.12301587301588,1011.5079365079374,24.670925280681402,0
2725,4,1,0,53,0.018867924528301886,0.0,1.0,53,1250,800,450,0.64,17,8,9,338.6736761806802,0.8519895984518626,0.3484014945044689,0.1812109537491558,127775.65646701407,-1945.149739583316,125830.50672743075,2715,0,809.0566037735849,39,14,20,38.67925338278729,0.5924145299145298,47.23958333333334,1011.0416666666681,25.924145299145337,0
2726,4,3,2,54,0.05357142857142857,0.03571428571428571,0.9642857142857143,56,1000,500,500,0.5,15,5,10,322.2114923401922,0.8625135281385281,0.35230475114118454,0.1754943735280967,128487.53390842001,-2918.3729383680643,125569.16097005195,2716,0,766.6607142857143,39,17,18,38.369571731908636,0.5996260683760685,46.53645833333333,1013.8541666666656,25.996260683760656,0
2727,4,2,2,54,0.03571428571428571,0.03571428571428571,0.9642857142857143,56,1650,1400,250,0.8484848484848485,19,14,5,324.7018228795996,0.8609172077922078,0.3506268431168307,0.17732033928091193,128593.16541883671,-2849.11295572917,125744.05246310754,2717,0,767.625,39,17,18,38.198901954743086,0.6006944444444444,46.432291666666664,1014.2708333333326,26.006944444444425,0
2728,4,1,1,54,0.01818181818181818,0.01818181818181818,0.9818181818181818,55,2150,1600,550,0.7441860465116279,27,16,11,328.8189629732125,0.8602413019079685,0.3516019961494625,0.17925449612744154,128523.41666894936,-2547.812682628405,125975.60398632096,2718,0,782.5636363636364,38,17,18,38.16554279492852,0.6016995614035088,46.50106837606837,1013.9957264957252,26.684098065676977,0
2729,4,0,1,53,0.0,0.018518518518518517,0.9814814814814815,54,1550,1000,550,0.6451612903225806,21,10,11,334.86324591574646,0.8544141625902633,0.3551369108426976,0.18221369679170543,128450.01737313399,-2197.362048899667,126252.65532423432,2719,3,798.0555555555555,37,17,18,38.087141698215255,0.6027590090090091,46.5734649122807,1013.7061403508768,27.3974632527264,0
2730,4,2,2,53,0.03636363636363636,0.03636363636363636,0.9636363636363636,55,1150,700,450,0.6086956521739131,16,7,9,284.3734533755905,0.862317620650954,0.24944056552302185,0.16034534543693774,129855.65776526574,-3614.4996321865215,126241.15813307923,2720,0,783.8909090909091,46,9,14,37.944500014496505,0.6034873188405798,45.19060283687943,1019.2375886524816,22.1573388837496,8
2731,4,0,0,53,0.0,0.0,1.0,53,1600,1200,400,0.75,20,12,8,299.24236247164504,0.8494496855345912,0.2681114073362878,0.1684481943222738,129790.4074502743,-2832.242369684507,126958.1650805898,2721,1,814.377358490566,44,9,14,37.63156898379523,0.6053503787878789,45.254629629629626,1018.9814814814811,23.158670033670024,0
2732,4,1,1,53,0.018518518518518517,0.018518518518518517,0.9814814814814815,54,1250,1000,250,0.8,15,10,5,290.35042975367753,0.8537299091544375,0.17873627650011614,0.16304977425830552,129696.07445987653,-3233.547668038412,126462.52679183811,2722,0,800.2777777777778,44,10,12,37.95336787564768,0.6044034090909092,45.34722222222222,1018.6111111111111,23.150252525252526,5
2733,4,0,2,51,0.0,0.03773584905660377,0.9622641509433962,53,1350,1000,350,0.7407407407407407,17,10,7,294.78246212248865,0.8483309143686502,0.1955839833921591,0.16599445708530128,129803.80980436497,-2947.222670597996,126856.58713376697,2723,1,816.0188679245283,43,10,12,37.731642815103925,0.6068313953488371,45.24147727272729,1019.0340909090933,23.69846723044403,0
2734,4,0,1,50,0.0,0.0196078431372549,0.9803921568627451,51,1750,1400,350,0.8,21,14,7,305.7911454776924,0.841732026143791,0.1949553637936765,0.17154381964338775,129655.65653344693,-2270.4896541949884,127385.16687925195,2724,2,848.0588235294117,41,10,13,37.601061757256964,0.6082317073170731,45.38690476190477,1018.4523809523827,24.84030197444836,0
2735,4,0,1,49,0.0,0.02,0.98,50,1300,900,400,0.6923076923076923,17,9,8,317.2631067767454,0.8357653061224489,0.20635002993414497,0.17802972318681665,129666.74619109009,-1772.305051556598,127894.44113953349,2725,3,865.94,40,10,14,37.29773664604537,0.6098958333333333,45.37601626016261,1018.4959349593506,25.462398373983767,0
2736,4,3,1,51,0.057692307692307696,0.019230769230769232,0.9807692307692307,52,1150,1000,150,0.8695652173913043,13,10,3,310.7038733860893,0.8452425842131723,0.22927786499215075,0.17702895111532974,130262.58680555537,-2302.650228865114,127959.93657669026,2726,0,833.4038461538462,40,12,16,36.86224489795917,0.6158854166666667,44.79166666666666,1020.8333333333319,25.520833333333297,0
2737,4,0,1,50,0.0,0.0196078431372549,0.9803921568627451,51,1050,700,350,0.6666666666666666,14,7,7,316.8699631670102,0.8373202614379086,0.23276333567735574,0.18042473995713143,130237.26974875582,-1946.3442263479626,128290.92552240785,2727,1,850.7450980392157,41,10,16,36.73046862344898,0.6140752032520326,44.816468253968246,1020.7341269841257,24.895954316685994,0
2738,4,1,0,51,0.0196078431372549,0.0,1.0,51,1500,700,800,0.4666666666666667,23,7,16,316.41523358114654,0.8402941176470589,0.23492728766300042,0.18076501888896773,130366.35068618225,-1950.0176788270612,128416.33300735519,2728,0,851.0,40,11,17,36.611644608087055,0.6169270833333333,44.69004065040651,1021.2398373983747,25.530995934959368,0
2739,4,1,2,50,0.019230769230769232,0.038461538461538464,0.9615384615384616,52,1400,700,700,0.5,21,7,14,309.1060352542677,0.840827677224736,0.23547850936023784,0.17803967707440135,130683.32732407906,-2320.9989634036447,128362.32836067541,2729,0,835.6153846153846,42,10,14,36.4784716957291,0.6170634920634921,44.37984496124031,1022.4806201550385,24.344776670358062,0
2740,4,0,1,49,0.0,0.02,0.98,50,1450,800,650,0.5517241379310345,21,8,13,315.96824134515305,0.8313095238095238,0.23589206461920775,0.17960132224997472,130170.13642748402,-1774.0741834698304,128396.06224401419,2730,2,869.6,45,5,16,36.82133558198713,0.6078703703703703,44.88224637681161,1020.471014492756,22.677133655394577,1
2741,4,1,1,49,0.02,0.02,0.98,50,950,700,250,0.7368421052631579,12,7,5,284.43873941719147,0.8332823129251701,0.12265833106822566,0.16325274919123983,130546.30594135808,-2554.545431340281,127991.76051001779,2731,0,870.5,44,6,13,37.24687415058442,0.6129261363636364,44.51388888888889,1021.9444444444448,23.226010101010107,4
2742,4,0,1,48,0.0,0.02040816326530612,0.9795918367346939,49,1300,900,400,0.6923076923076923,17,9,8,286.7163847765806,0.8288336167800454,0.1254263128923827,0.16427950479843487,130480.18470392848,-2317.838631341827,128162.34607258665,2732,4,889.265306122449,43,6,15,37.25524840114932,0.6136143410852714,44.578598484848484,1021.685606060606,23.760130373502466,0
2743,4,0,1,47,0.0,0.020833333333333332,0.9791666666666666,48,650,300,350,0.46153846153846156,10,3,7,293.99760094510964,0.8231567671394799,0.13048204009359354,0.16825856184382976,130435.75074364513,-1930.4404407788115,128505.31030286632,2733,5,908.1458333333334,42,6,15,37.11404382470116,0.6145833333333334,44.62209302325581,1021.5116279069761,24.321705426356573,0
2744,4,0,1,46,0.0,0.02127659574468085,0.9787234042553191,47,850,600,250,0.7058823529411765,11,6,5,300.01983285120735,0.8176842429848905,0.13356376776839718,0.17116430818761777,130313.22830057937,-1580.6894053917965,128732.53889518758,2734,6,928.2340425531914,41,6,16,37.08381914755799,0.6148373983739838,44.74206349206349,1021.0317460317451,24.90321331784744,0
2745,4,0,1,45,0.0,0.021739130434782608,0.9782608695652174,46,1350,1000,350,0.7407407407407407,17,10,7,308.9008765474174,0.8097624798711756,0.1475886024752029,0.17670817929300459,130418.24811826616,-1142.7377676978092,129275.51035056835,2735,7,948.9565217391304,40,6,16,36.751111000563796,0.6174479166666667,44.63922764227642,1021.4430894308936,25.53607723577234,0
2746,4,0,0,45,0.0,0.0,1.0,45,1350,900,450,0.6666666666666666,18,9,9,314.58156473791104,0.8018097643097644,0.16407467826717426,0.18022289643396186,130475.347222222,-790.9722222222451,129684.37499999975,2736,8,970.4,39,6,17,36.548395867319186,0.6196581196581198,44.58333333333332,1021.6666666666648,26.19658119658115,0
2747,4,0,1,44,0.0,0.022222222222222223,0.9777777777777777,45,1450,1200,250,0.8275862068965517,17,12,5,316.42296571966597,0.8008417508417509,0.1645562071364679,0.18222847499173184,130677.89019639415,-730.1028860136349,129947.78731038052,2737,9,971.4,40,5,14,36.29692210847167,0.6200520833333334,44.38516260162601,1022.4593495934944,25.56148373983736,0
2748,4,0,0,44,0.0,0.0,1.0,44,650,400,250,0.6153846153846154,9,4,5,322.8622107504356,0.7932963354474982,0.16807988138263363,0.18522095248314466,130528.564453125,-371.4518229166667,130157.11263020833,2738,10,994.2272727272727,39,5,14,36.28312945973497,0.6201923076923077,44.53125,1021.875,26.201923076923077,0
2749,4,1,1,44,0.022222222222222223,0.022222222222222223,0.9777777777777777,45,1050,800,250,0.7619047619047619,13,8,5,319.52988677273237,0.80239898989899,0.17071770757445348,0.1846376486942777,130807.80805902542,-640.599180382078,130167.20887864335,2739,0,973.1111111111111,40,5,14,36.086413007483934,0.6213541666666668,44.2581300813008,1022.9674796747945,25.574186991869862,0
2750,4,0,0,44,0.0,0.0,1.0,44,1750,1600,150,0.9142857142857143,19,16,3,327.81513267325073,0.7948158914728682,0.17149601925569313,0.1893614472265484,130794.81336805563,-224.69618055555065,130570.11718750009,2740,12,996.2272727272727,39,5,14,35.887644263408,0.6228632478632479,44.270833333333336,1022.9166666666673,26.228632478632495,0
2751,4,1,1,44,0.022222222222222223,0.022222222222222223,0.9777777777777777,45,1000,600,400,0.6,14,6,8,320.4681735207817,0.8015572390572391,0.16891623660182642,0.18643402519603894,131067.837431423,-599.3859062066318,130468.45152521637,2741,0,975.0666666666667,40,5,16,35.80021007013366,0.6239583333333334,44.0040650406504,1023.9837398373976,25.59959349593494,0
2752,4,0,0,44,0.0,0.0,1.0,44,1100,700,400,0.6363636363636364,15,7,8,327.60141472535014,0.7945736434108528,0.18031385603579664,0.19071285131065033,131093.85456945284,-210.6935562495758,130883.16101320327,2742,14,998.2272727272727,40,4,18,35.5913631702557,0.6242187499999999,43.97865853658537,1024.0853658536596,25.60213414634149,0
2753,4,1,0,45,0.022222222222222223,0.0,1.0,45,800,500,300,0.625,11,5,6,320.9068676052612,0.8006313131313132,0.1828364950316168,0.18795973674022473,131328.12500000026,-570.971416650113,130757.15358335015,2743,0,977.0222222222222,40,5,19,35.526761517615185,0.6265624999999999,43.750000000000014,1025.000000000002,25.62500000000005,0
2754,4,1,1,45,0.021739130434782608,0.021739130434782608,0.9782608695652174,46,1150,900,250,0.782608695652174,14,9,5,315.8773229358242,0.8087761674718197,0.1819303572582205,0.18615187244816994,131562.604569453,-888.4713340273306,130674.13323542566,2744,0,956.7608695652174,40,6,14,35.419762258543834,0.6289062499999998,43.52134146341465,1025.9146341463438,25.647865853658594,0
2755,4,0,0,45,0.0,0.0,1.0,45,1050,600,450,0.5714285714285714,15,6,9,319.0565544513264,0.8003787878787879,0.18250319284801986,0.18764095265284336,131484.42147531256,-609.806704012139,130874.61477130042,2745,2,979.0222222222222,40,5,19,35.416873100805894,0.6281249999999998,43.59756097560977,1025.609756097563,25.640243902439074,0
2756,4,0,0,45,0.0,0.0,1.0,45,1100,900,200,0.8181818181818182,13,9,4,322.84238155809214,0.7999579124579125,0.18213550779659538,0.19051662925727983,131614.73954202203,-501.83680762111373,131112.9027344009,2746,3,980.0222222222222,40,5,14,35.18866990195109,0.6294270833333333,43.47052845528456,1026.1178861788626,25.652947154471565,0
2757,4,0,0,45,0.0,0.0,1.0,45,1550,1100,450,0.7096774193548387,20,11,9,323.49534359376497,0.7996632996632997,0.18693069306930687,0.19129408491200414,131692.96136558952,-479.58804283162465,131213.3733227579,2747,4,981.0222222222222,40,5,15,35.09323432343234,0.6302083333333333,43.39430894308944,1026.4227642276442,25.660569105691103,0
2758,4,0,2,43,0.0,0.044444444444444446,0.9555555555555556,45,1100,700,400,0.6363636363636364,15,7,8,289.18273661438616,0.7998737373737375,0.1150594315245479,0.16174372625414443,129538.57197687122,-1507.936251721737,128030.63572514948,2748,5,982.0222222222222,43,2,13,38.14224806201552,0.6041666666666665,45.50189393939395,1017.9924242424261,23.67424242424247,8
2759,4,0,0,43,0.0,0.0,1.0,43,900,400,500,0.4444444444444444,14,4,10,301.75723226080567,0.7909745293466224,0.12078143889820159,0.16787395020998586,129327.49438027525,-794.8986481166509,128532.5957321586,2749,21,1027.2325581395348,41,2,19,38.035920381026706,0.6049288617886179,45.7093253968254,1017.1626984126983,24.80884630274874,0
2760,4,1,0,44,0.022727272727272728,0.0,1.0,44,1200,800,400,0.6666666666666666,16,8,8,309.7815015441391,0.7971943269908387,0.1597697898080861,0.16687301617475647,128046.4395638031,-863.3479467287093,127183.09161707439,2750,0,1004.8636363636364,42,2,13,39.13355672570607,0.5905257936507937,46.971899224806194,1012.1124031007738,24.097914359542234,4
2761,4,3,1,46,0.06382978723404255,0.02127659574468085,0.9787234042553191,47,1150,700,450,0.6086956521739131,16,7,9,294.4101760649198,0.8162195497995682,0.18777507820565642,0.1617190967122129,128825.12002743436,-1814.477188388684,127010.64283904567,2751,0,941.6595744680851,44,3,11,38.73168247598199,0.5956439393939397,46.20370370370368,1015.1851851851814,23.072390572390486,0
2762,4,0,0,46,0.0,0.0,1.0,46,1400,1200,200,0.8571428571428571,16,12,4,299.3274703147385,0.8108091787439614,0.18381511800546835,0.164185866265781,128768.51343692577,-1491.209323347142,127277.30411357863,2752,1,963.1304347826087,43,3,12,38.664318591777054,0.5964147286821707,46.25946969696968,1014.9621212121187,23.60377026074695,0
2763,4,2,0,48,0.041666666666666664,0.0,1.0,48,1250,1000,250,0.8,15,10,5,295.09941921277493,0.8211066784869976,0.2073188373542254,0.16450877300332953,129408.67304826934,-1962.3151484719974,127446.35789979734,2753,0,923.9583333333334,45,3,15,38.123071159381595,0.6002314814814816,45.62952898550723,1017.4818840579674,22.610708534621498,0
2764,4,0,0,48,0.0,0.0,1.0,48,1000,400,600,0.4,16,4,12,295.9097170375296,0.8213837174940898,0.20402426723626532,0.16525057557821451,129477.80468914066,-1937.251890359189,127540.55279878147,2754,1,924.9583333333334,45,3,12,38.032514536608545,0.6009259259259261,45.56159420289854,1017.7536231884035,22.61674718196452,0
2765,4,1,0,49,0.02040816326530612,0.0,1.0,49,1450,900,550,0.6206896551724138,20,9,11,292.6974887998095,0.8258928571428572,0.21325332220752657,0.16484848769004423,129810.48272376857,-2200.9595373723955,127609.52318639617,2755,0,907.0612244897959,46,3,15,37.77801942873711,0.6030344202898552,45.23492907801417,1019.0602836879405,22.153484427998706,0
2766,4,0,0,49,0.0,0.0,1.0,49,1450,1300,150,0.896551724137931,16,13,3,286.3181967897107,0.8272392290249433,0.14677774433036062,0.16159603744590822,129892.98220568182,-2353.0350543792965,127539.94715130252,2756,1,908.0612244897959,45,4,14,37.85728037438543,0.6050925925925925,45.15398550724639,1019.3840579710164,22.65297906602259,4
2767,4,1,0,50,0.02,0.0,1.0,50,1150,800,350,0.6956521739130435,15,8,7,282.71553519366904,0.8295748299319727,0.1649795918367345,0.1610821072615094,130262.58680555582,-2634.5486111110868,127628.03819444474,2757,0,890.88,46,4,16,37.576530612244895,0.6075634057971013,44.79166666666668,1020.8333333333355,22.192028985507296,0
2768,4,0,1,49,0.0,0.02,0.98,50,1150,800,350,0.6956521739130435,15,8,7,283.5236725983796,0.829234693877551,0.1653958333333332,0.16201352719907408,130375.73562698049,-2607.0785234646196,127768.65710351587,2758,1,891.88,46,4,17,37.441948784722214,0.608695652173913,44.680851063829785,1021.2765957446804,22.201665124884357,0
2769,4,1,2,48,0.02,0.04,0.96,50,1050,800,250,0.7619047619047619,13,8,5,282.1246031838512,0.8274319727891156,0.17098386257157716,0.16177951125856055,130511.57905160697,-2635.894509833518,127875.68454177344,2759,0,892.8,46,4,16,37.34093932558274,0.6100543478260869,44.54787234042553,1021.8085106382971,22.213228492136892,0
2770,4,1,1,48,0.02040816326530612,0.02040816326530612,0.9795918367346939,49,900,500,400,0.5555555555555556,13,5,8,282.75614908706814,0.8211451247165533,0.16948907222463472,0.162067548866978,130493.85633270313,-2420.4119407687517,128073.44439193438,2760,0,911.8367346938776,45,4,16,37.342641843971634,0.6111111111111112,44.565217391304344,1021.7391304347819,22.70531400966182,0
2771,4,0,0,48,0.0,0.0,1.0,48,1000,800,200,0.8,12,8,4,286.29434393768327,0.8161015070921985,0.17140288856659414,0.16381738601247514,130428.05212620023,-2131.8372770919145,128296.21484910832,2761,4,931.8333333333334,44,4,19,37.318520364998776,0.6117424242424243,44.629629629629626,1021.4814814814811,23.215488215488207,0
2772,4,0,0,48,0.0,0.0,1.0,48,1500,900,600,0.6,21,9,12,291.50003971923115,0.8144762115839244,0.1839437649561284,0.16737887776855398,130563.27718868144,-1988.1599027252735,128575.11728595618,2762,5,932.8333333333334,45,3,17,37.04937738190198,0.6118055555555555,44.49728260869565,1022.0108695652171,22.711352657004827,0
2773,4,0,0,48,0.0,0.0,1.0,48,1450,900,550,0.6206896551724138,20,9,11,295.5166696924068,0.8140144799054373,0.18778796739323034,0.16998986412581552,130632.71650519842,-1879.1709331022967,128753.54557209612,2763,6,933.8333333333334,45,3,17,36.876809025931834,0.6125,44.42934782608695,1022.2826086956516,22.717391304347814,0
2774,4,1,2,47,0.02040816326530612,0.04081632653061224,0.9591836734693877,49,1100,800,300,0.7272727272727273,14,8,6,292.7617657645051,0.819515306122449,0.1933691594651894,0.16936158088662429,130851.49707163882,-2138.336932875608,128713.16013876321,2764,0,915.7551020408164,46,3,17,36.72703116425496,0.6134510869565217,44.215425531914896,1023.1382978723409,22.24213691026828,0
2775,4,0,0,47,0.0,0.0,1.0,47,1100,800,300,0.7272727272727273,14,8,6,303.48800986231436,0.808973172987974,0.19972602264648276,0.1748261915967416,130688.28124999997,-1467.5347222222222,129220.74652777775,2765,8,954.9574468085107,44,3,17,36.6170877478946,0.6143465909090909,44.375,1022.4999999999998,23.23863636363636,0
2776,4,0,0,47,0.0,0.0,1.0,47,1300,900,400,0.6923076923076923,17,9,8,301.10358100775994,0.8084335491828554,0.18956387792432872,0.17419866859349445,130854.01663237295,-1519.8774005487144,129334.13923182423,2766,9,955.9574468085107,44,3,18,36.511123680241326,0.616003787878788,44.212962962962955,1023.1481481481469,23.253367003366975,0
2777,4,0,0,47,0.0,0.0,1.0,47,950,500,450,0.5263157894736842,14,5,9,299.6450890725634,0.8079710144927535,0.18975673989881559,0.17356800442505077,130901.38888888879,-1555.2083333333396,129346.18055555545,2767,10,956.9574468085107,44,3,18,36.500746471226954,0.6164772727272728,44.166666666666664,1023.3333333333325,23.257575757575736,0
2778,4,1,1,47,0.020833333333333332,0.020833333333333332,0.9791666666666666,48,950,600,350,0.631578947368421,13,6,7,293.3532213693197,0.8142915189125295,0.17898246389625694,0.17119839699107328,131188.89561672948,-1903.0629725898098,129285.83264413968,2768,0,938.0,45,3,18,36.37267904509284,0.6180555555555556,43.885869565217384,1024.456521739129,22.765700483091752,0
2779,4,0,0,47,0.0,0.0,1.0,47,900,600,300,0.6666666666666666,12,6,6,296.19826262661064,0.8086648165279062,0.17859183214168284,0.17252495960573638,131114.6701388886,-1632.8125000000232,129481.85763888858,2769,12,958.9574468085107,44,3,18,36.374423650664504,0.6186079545454547,43.95833333333332,1024.1666666666645,23.276515151515103,0
2780,4,0,1,46,0.0,0.02127659574468085,0.9787234042553191,47,1500,900,600,0.6,21,9,12,297.81152254641063,0.8073928461301264,0.17072022112743457,0.1743244708125974,131304.3992198215,-1579.2073902606535,129725.19182956085,2770,13,959.9574468085107,44,3,18,36.14241726142076,0.620501893939394,43.77314814814814,1024.907407407406,23.293350168350138,0
2781,4,1,0,47,0.02127659574468085,0.0,1.0,47,1450,1100,350,0.7586206896551724,18,11,7,292.7983006767338,0.812018193031144,0.18206799089267456,0.17324964952706282,131716.66953627174,-1686.7144544491025,130029.95508182264,2771,0,958.3191489361702,43,4,15,35.857164821648205,0.625968992248062,43.37121212121212,1026.515151515151,23.87244538407328,0
2782,4,1,0,48,0.020833333333333332,0.0,1.0,48,1200,800,400,0.6666666666666666,16,8,8,286.47464916964185,0.8190750591016548,0.18564105452906676,0.1704255352566851,131921.9660922497,-2041.5402091906726,129880.42588305903,2772,0,939.3333333333334,44,4,16,35.81380501727504,0.626657196969697,43.1712962962963,1027.3148148148152,23.348063973063983,0
2783,4,0,0,48,0.0,0.0,1.0,48,1500,1200,300,0.8,18,12,6,290.8451551553493,0.8175790484633569,0.18673641703377375,0.1739247898320978,132118.48630145984,-1914.7956705524011,130203.69063090744,2773,1,940.3333333333334,45,3,18,35.504772393538914,0.6273148148148149,42.98007246376812,1028.079710144928,22.8462157809984,0
2784,4,1,1,48,0.02040816326530612,0.02040816326530612,0.9795918367346939,49,1400,1000,400,0.7142857142857143,18,10,8,289.5772099930581,0.8200821995464853,0.18136387336510706,0.17456292116501276,132421.82784636487,-2130.140572773644,130291.68727359123,2774,0,922.1224489795918,44,5,19,35.233934568789735,0.6316287878787878,42.68518518518518,1029.2592592592591,23.39225589225589,0
2785,4,0,1,47,0.0,0.020833333333333332,0.9791666666666666,48,1300,900,400,0.6923076923076923,17,9,8,295.53016768017807,0.8139775413711584,0.18193319838056654,0.17803890589513188,132398.00347222234,-1774.4791666666615,130623.52430555568,2775,3,942.3333333333334,44,4,19,35.10458839406206,0.6313920454545454,42.708333333333336,1029.1666666666674,23.390151515151533,0
2786,4,0,0,47,0.0,0.0,1.0,47,650,500,150,0.7692307692307693,8,5,3,299.90926859760515,0.8107847671908726,0.17620973300859388,0.1803350537151834,132326.54320987655,-1462.8086419753074,130863.73456790124,2776,4,962.8723404255319,44,3,20,35.06344492440604,0.6306818181818181,42.77777777777778,1028.888888888889,23.383838383838384,0
2787,4,2,2,47,0.04081632653061224,0.04081632653061224,0.9591836734693877,49,700,200,500,0.2857142857142857,12,2,10,287.92727448375814,0.8155824829931974,0.18324467369365305,0.17486239974654277,132701.14705583113,-2158.3247913457844,130542.82226448534,2777,0,924.530612244898,45,4,15,34.99734432234432,0.6331018518518519,42.41394927536231,1030.3442028985498,22.896537842189996,0
2788,4,0,0,47,0.0,0.0,1.0,47,1350,1200,150,0.8888888888888888,15,12,3,298.3739669967265,0.8102065988282454,0.18440098950232153,0.18043593730128304,132540.98186728393,-1490.6442901234602,131050.33757716048,2778,6,964.8723404255319,44,3,20,34.88838683571621,0.6328125,42.56944444444444,1029.7222222222222,23.402777777777775,0
2789,4,0,0,47,0.0,0.0,1.0,47,750,400,350,0.5333333333333333,11,4,7,319.53549431561686,0.8110160345359235,0.19838123394562124,0.17667012846921384,129083.74592764051,-1147.3722565157832,127936.37367112473,2779,7,965.8723404255319,44,3,16,37.831245254365975,0.5982481060606061,45.94907407407407,1016.203703703703,23.095538720538705,7
2790,4,1,0,48,0.020833333333333332,0.0,1.0,48,1700,1100,600,0.6470588235294118,23,11,12,316.71103994428313,0.8172281323877069,0.2116345832954094,0.1763661528569613,129366.17905521295,-1405.6069958847415,127960.57205932822,2780,0,946.7291666666666,44,4,18,37.61642547252816,0.6010890151515151,45.67129629629631,1017.3148148148175,23.120791245791306,0
2791,4,0,0,48,0.0,0.0,1.0,48,1000,900,100,0.9,11,9,2,316.98121160677687,0.817043439716312,0.20871811785400185,0.1769395884596286,129460.39201817568,-1392.6976165980677,128067.69440157761,2781,1,947.7291666666666,44,4,15,37.514026627847045,0.6020359848484848,45.57870370370371,1017.6851851851859,23.129208754208772,0
2792,4,1,1,48,0.02040816326530612,0.02040816326530612,0.9795918367346939,49,1550,900,650,0.5806451612903226,22,9,13,316.04944025299136,0.8221017573696145,0.2154603423201693,0.17779521374584595,129765.31554153471,-1597.5489317690249,128167.76660976569,2782,0,929.3673469387755,46,3,17,37.2288204414281,0.6025815217391305,45.27925531914894,1018.8829787234049,22.149629972247933,0
2793,4,0,0,48,0.0,0.0,1.0,48,1600,1200,400,0.75,20,12,8,319.8612543209876,0.8160276300236406,0.20682592592592575,0.18010205761316872,129800.663102552,-1296.3594176643567,128504.30368488765,2783,3,949.7291666666666,45,3,18,37.095925925925926,0.6041666666666667,45.244565217391305,1019.021739130435,22.64492753623189,0
2794,4,1,1,48,0.02040816326530612,0.02040816326530612,0.9795918367346939,49,1450,1000,450,0.6896551724137931,19,10,9,313.2360266464374,0.8199759070294785,0.20689422797273216,0.17774754411475352,130104.26097781803,-1649.3316483074286,128454.9293295106,2784,0,931.3265306122449,46,3,18,36.95762368207623,0.6059782608695652,44.9468085106383,1020.212765957447,22.178538390379284,0
2795,4,3,1,50,0.058823529411764705,0.0196078431372549,0.9803921568627451,51,1450,1000,450,0.6896551724137931,19,10,9,318.55653521556366,0.8253921568627451,0.22839175653247312,0.18098753366162187,130151.8428472827,-1902.1265756852554,128249.71627159746,2785,0,895.7450980392157,47,4,18,36.77380192825749,0.6052748226950353,44.90017361111112,1020.3993055555571,21.71062352245866,2
2796,4,0,1,49,0.0,0.02,0.98,50,1200,800,400,0.6666666666666666,16,8,8,331.92397833911366,0.8208333333333333,0.24970423661071117,0.1878899985982947,130008.42723594049,-1369.3700278191177,128639.05720812136,2786,1,914.66,45,5,18,36.57805237291648,0.60625,45.04076086956522,1019.8369565217394,22.663043478260875,2
2797,4,0,0,49,0.0,0.0,1.0,49,1150,900,250,0.782608695652174,14,9,5,348.81004648416405,0.8165036848072562,0.2646159124045855,0.19217241480500225,128943.21852898429,-768.828033328127,128174.39049565616,2787,2,934.3061224489796,40,9,16,37.230671736375164,0.6026041666666666,46.08739837398375,1015.6504065040668,25.39126016260167,6
2798,4,1,0,50,0.02,0.0,1.0,50,1450,1000,450,0.6896551724137931,19,10,9,340.1169128384707,0.8212755102040816,0.26892291105121235,0.18901044736829356,129285.00987082577,-1204.563528570603,128080.44634225516,2788,0,916.6,37,13,17,37.10366127583109,0.611204954954955,45.751096491228076,1016.9956140350888,27.48636794689429,0
2799,4,0,1,49,0.0,0.02,0.98,50,1400,1100,300,0.7857142857142857,17,11,6,341.0452788809316,0.8214115646258503,0.2693833548943505,0.18966043206831693,129312.88954293645,-1179.6899045860134,128133.19963835043,2789,1,917.6,37,13,17,37.05171050740259,0.6114864864864864,45.72368421052632,1017.105263157896,27.489331436699892,0
2800,4,1,1,49,0.02,0.02,0.98,50,1700,1300,400,0.7647058823529411,21,13,8,341.9168144614795,0.8234353741496598,0.2657265970052787,0.19109053513822463,129508.13140822173,-1143.798452408434,128364.3329558133,2790,0,918.5,37,13,16,36.83110255305398,0.6134572072072071,45.531798245614034,1017.8728070175436,27.510075865339015,0
2801,4,0,0,49,0.0,0.0,1.0,49,1100,700,400,0.6363636363636364,15,7,8,352.1153211255489,0.8177791950113379,0.26629552920069033,0.19665068656361934,129480.23069598367,-681.6053978146855,128798.62529816899,2791,3,938.2448979591836,37,12,16,36.599960497019296,0.6131756756756754,45.5592105263158,1017.7631578947393,27.507112375533495,0
2802,4,0,1,48,0.0,0.02040816326530612,0.9795918367346939,49,1200,800,400,0.6666666666666666,16,8,8,355.00493120240424,0.8172831632653061,0.2717703559614473,0.19868720833118306,129563.94184989626,-600.8323474530446,128963.10950244321,2792,4,939.2448979591836,37,12,16,36.441280739544084,0.6140202702702702,45.476973684210535,1018.0921052631589,27.516002844950243,0
2803,4,2,2,48,0.04,0.04,0.96,50,1450,1000,450,0.6896551724137931,19,10,9,348.3354870518125,0.8341496598639455,0.2600628535512255,0.19722482558698734,130017.30974687726,-942.0714168310119,129075.23833004625,2793,0,885.72,38,12,18,36.150612822124444,0.6167763157894736,45.03205128205129,1019.8717948717965,26.838731443994646,0
2804,4,0,0,48,0.0,0.0,1.0,48,1250,700,550,0.56,18,7,11,362.4623066425013,0.8189457742316785,0.27174943836776766,0.2044016409608275,129860.54202428795,-186.08967920621046,129674.45234508174,2794,6,923.625,36,12,19,35.94975693293561,0.618923611111111,45.18581081081082,1019.256756756758,28.312687687687724,0
2805,4,0,0,48,0.0,0.0,1.0,48,1050,600,450,0.5714285714285714,15,6,9,362.1934655954034,0.8182808806146572,0.27349881733146963,0.2050372138467955,130010.85820877597,-182.1833400661534,129828.67486870982,2795,7,924.625,37,11,19,35.80383381715228,0.6185247747747746,45.038377192982466,1019.8464912280717,27.563418681839778,0
2806,4,0,0,48,0.0,0.0,1.0,48,1850,1500,350,0.8108108108108109,22,15,7,364.1183476274573,0.8173758865248226,0.272597049133362,0.20716464423694214,130206.62607725458,-117.87569252077111,130088.75038473381,2796,8,925.625,37,11,21,35.55588382753187,0.6204954954954953,44.84649122807018,1020.6140350877197,27.58416311047891,0
2807,4,1,1,48,0.02040816326530612,0.02040816326530612,0.9795918367346939,49,1650,1200,450,0.7272727272727273,21,12,9,362.80562061865726,0.82203089569161,0.26247512200889367,0.20836174921666684,130570.58572108716,-325.63949965375025,130244.9462214334,2797,0,907.7142857142857,37,12,18,35.22008994027821,0.6241554054054055,44.49013157894736,1022.0394736842098,27.622688477951616,0
2808,4,2,1,49,0.04,0.02,0.98,50,1350,1100,250,0.8148148148148148,16,11,5,343.3958122000335,0.828078231292517,0.22732295719844386,0.19438925932909376,130009.52695893166,-1066.6722212058653,128942.8547377258,2798,0,890.52,41,9,20,36.28445201037614,0.6117886178861789,45.03968253968254,1019.8412698412693,24.87417731320169,6
2809,4,0,0,49,0.0,0.0,1.0,49,750,500,250,0.6666666666666666,10,5,5,349.6048516834335,0.825219671201814,0.228789571467235,0.19708752431327464,129847.94439693642,-720.9057315420625,129127.03866539436,2799,1,909.6938775510204,40,9,20,36.29017515870642,0.6117187499999999,45.19817073170732,1019.2073170731712,25.48018292682928,0
2810,4,0,0,49,0.0,0.0,1.0,49,1350,900,450,0.6666666666666666,18,9,9,351.2865687853096,0.8251133786848073,0.2249536178107603,0.198429440205756,129925.6395002975,-671.7735805406779,129253.86591975682,2800,2,910.6938775510204,40,9,20,36.168427698032964,0.6125,45.1219512195122,1019.5121951219517,25.48780487804879,0
2811,4,0,0,49,0.0,0.0,1.0,49,1350,900,450,0.6666666666666666,18,9,9,352.7261472040128,0.8254322562358277,0.21884706073664528,0.20030376232626051,130132.94004891261,-619.7418864432618,129513.19816246936,2801,3,911.6938775510204,40,9,20,35.92131474103584,0.6145833333333334,44.918699186991866,1020.3252032520319,25.5081300813008,0
2812,4,0,0,49,0.0,0.0,1.0,49,1300,1100,200,0.8461538461538461,15,11,4,350.4606583208682,0.8237315759637188,0.21601806111272537,0.1994150930037665,130210.72035701305,-673.2530446493452,129537.4673123637,2802,4,912.6938775510204,40,9,20,35.90021241992764,0.6153645833333334,44.84247967479675,1020.6300813008132,25.515752032520332,0
2813,4,1,0,50,0.02,0.0,1.0,50,1250,900,350,0.72,16,9,7,341.3616444806454,0.829421768707483,0.21886634844868658,0.19593223155806933,130548.03688280811,-1087.1711613457373,129460.86572146238,2803,0,895.42,40,10,16,35.790821400159096,0.6187499999999999,44.51219512195123,1021.9512195121972,25.54878048780493,0
2814,4,0,0,50,0.0,0.0,1.0,50,1650,1200,450,0.7272727272727273,21,12,9,339.8515478783163,0.8290306122448979,0.22214202561117546,0.1959278386761569,130718.71456916103,-1115.0085034013614,129603.70606575967,2804,1,896.42,41,9,17,35.65677143965852,0.6189024390243902,44.345238095238095,1022.6190476190479,24.941927990708486,0
2815,4,0,0,50,0.0,0.0,1.0,50,1100,700,400,0.6363636363636364,15,7,8,339.85480182245647,0.828843537414966,0.22299515033947648,0.19618717843166428,130769.44464128237,-1111.475261400862,129657.96937988151,2805,2,897.42,41,9,17,35.60539928871646,0.619410569105691,44.29563492063492,1022.8174603174598,24.946767324816093,0
2816,4,1,1,50,0.0196078431372549,0.0196078431372549,0.9803921568627451,51,1200,800,400,0.6666666666666666,16,8,8,337.4688116508997,0.8325816993464054,0.22154803058727057,0.19625937989626072,131055.13232565642,-1354.596046661867,129700.53627899455,2806,0,880.8039215686274,42,9,17,35.3778271978802,0.6207837301587302,44.01647286821705,1023.9341085271311,24.379383536360265,0
2817,4,0,1,49,0.0,0.02,0.98,50,950,500,450,0.5263157894736842,14,5,9,341.93163092289075,0.827687074829932,0.22036056993312014,0.19829728140705247,130947.07739866781,-1045.0104520975044,129902.06694657031,2807,4,899.42,41,9,18,35.372746437917996,0.6211890243902438,44.12202380952381,1023.5119047619048,24.9637049941928,0
2818,4,0,0,49,0.0,0.0,1.0,49,1400,1200,200,0.8571428571428571,16,12,4,359.3813487275118,0.8207908163265306,0.23790911999598485,0.19915971506143018,129174.91455078112,-514.8353905364369,128660.07916024468,2808,5,918.5918367346939,39,10,20,36.72603494210471,0.606570512820513,45.85937499999999,1016.562499999999,26.065705128205103,4
2819,4,1,0,50,0.02,0.0,1.0,50,1800,1500,300,0.8333333333333334,21,15,6,351.801613394756,0.8256462585034013,0.2392980661004811,0.19680350129976792,129545.80213758662,-885.1128472222421,128660.68929036437,2809,0,901.2,39,11,16,36.54125737576315,0.6103098290598292,45.49479166666666,1018.0208333333319,26.103098290598254,0
2820,4,1,2,49,0.0196078431372549,0.0392156862745098,0.9607843137254902,51,1300,800,500,0.6153846153846154,18,8,10,348.69278664335036,0.8305555555555556,0.2435885403223914,0.19644332946401752,129822.05119307268,-1146.3974403463799,128675.6537527263,2810,0,884.5098039215686,40,11,16,36.339707153304076,0.6114583333333334,45.223577235772346,1019.1056910569088,25.47764227642272,0
2821,4,1,0,50,0.02,0.0,1.0,50,1650,1200,450,0.7272727272727273,21,12,9,353.9445570231087,0.8271938775510204,0.24862981506079507,0.19988778878160202,129917.22140842005,-803.3013237847315,129113.92008463532,2811,0,900.94,39,11,17,36.1092307823303,0.6140491452991453,45.13020833333333,1019.479166666666,26.140491452991434,0
2822,4,0,0,50,0.0,0.0,1.0,50,950,700,250,0.7368421052631579,12,7,5,353.3229740698021,0.8269727891156462,0.25398692810457524,0.2002163519728879,130050.00000000001,-810.0694444444446,129239.93055555558,2812,1,901.94,39,11,17,35.99026416122005,0.6153846153846154,45.0,1020.0000000000001,26.153846153846157,0
2823,4,1,0,51,0.0196078431372549,0.0,1.0,51,1200,700,500,0.5833333333333334,17,7,10,347.85679927276755,0.8295424836601308,0.2611899863442879,0.19914954059941817,130448.7426757814,-1124.3299696180402,129324.41270616336,2813,0,885.2352941176471,39,12,18,35.72543846232284,0.6193910256410255,44.60937500000001,1021.5625000000011,26.193910256410284,0
2824,4,0,1,50,0.0,0.0196078431372549,0.9803921568627451,51,1400,700,700,0.5,21,7,14,347.10030378350154,0.8289542483660132,0.2672230649471077,0.19926278996020708,130555.17713758702,-1136.8516710069234,129418.32546658009,2814,1,886.2352941176471,39,12,14,35.63697635307309,0.6204594017094016,44.50520833333334,1021.9791666666683,26.20459401709406,0
2825,4,0,0,50,0.0,0.0,1.0,50,1100,600,500,0.5454545454545454,16,6,10,354.39241764622494,0.8245068027210884,0.267708877967165,0.20305899879873313,130480.80490037652,-751.7184189860118,129729.0864813905,2815,4,904.94,38,12,19,35.526029140088546,0.6214364035087717,44.57799145299147,1021.6880341880366,26.886527215474647,0
2826,4,0,0,50,0.0,0.0,1.0,50,1200,700,500,0.5833333333333334,17,7,10,353.98388561874856,0.8255442176870748,0.26759096612296007,0.20296773873247714,130508.09500328763,-760.4474852070714,129747.64751808056,2816,5,905.94,38,12,16,35.50880907570053,0.6217105263157894,44.551282051282065,1021.7948717948743,26.88933873144406,0
2827,4,0,0,50,0.0,0.0,1.0,50,1350,800,550,0.5925925925925926,19,8,11,356.6951345076228,0.8257142857142857,0.26903104421448676,0.20495509620627222,130589.98243343212,-683.8377301117512,129906.14470332036,2817,6,906.94,38,12,16,35.35656423121144,0.622532894736842,44.471153846153854,1022.115384615386,26.897773279352265,0
2828,4,0,0,50,0.0,0.0,1.0,50,1400,900,500,0.6428571428571429,19,9,10,356.6670925010564,0.8244727891156463,0.2737304075235112,0.20537328972533767,130671.89554569375,-678.7269888231251,129993.16855687063,2818,7,907.94,38,12,16,35.274294670846416,0.6233552631578946,44.39102564102565,1022.4358974358985,26.906207827260488,0
2829,4,0,0,50,0.0,0.0,1.0,50,1150,800,350,0.6956521739130435,15,8,7,347.7214369991076,0.8241326530612245,0.25566008153026054,0.19979885812435205,130589.98243343194,-918.2127301117678,129671.76970332017,2819,8,908.94,38,12,14,35.58586808821992,0.6225328947368421,44.47115384615385,1022.1153846153845,26.897773279352226,2
2830,4,2,2,50,0.038461538461538464,0.038461538461538464,0.9615384615384616,52,1050,600,450,0.5714285714285714,15,6,9,338.96375526868405,0.8351401458019104,0.2606280697308698,0.1970954883452443,131048.63596190783,-1515.852446302606,129532.78351560522,2820,0,874.9423076923077,41,11,15,35.34611875464262,0.6222052845528455,44.022817460317455,1023.9087301587296,24.97338366240804,0
2831,4,0,1,49,0.0,0.02,0.98,50,1300,800,500,0.6153846153846154,18,8,10,404.63397092311635,0.8237925170068027,0.34152388395037625,0.2228207617181251,128924.17332963285,455.6258267195859,129379.79915635243,2821,10,910.94,41,9,17,35.832743153918805,0.6008638211382114,46.1061507936508,1015.5753968253973,24.77013162988774,6
2832,4,1,0,50,0.02,0.0,1.0,50,1300,1000,300,0.7692307692307693,16,10,6,407.4845471647401,0.8279591836734693,0.3513114754098354,0.2259687034277198,129201.3888888891,529.5138888889072,129730.902777778,2822,0,909.14,41,9,18,35.47643442622952,0.6036585365853657,45.83333333333334,1016.6666666666683,24.796747967479714,0
2833,4,3,2,51,0.05660377358490566,0.03773584905660377,0.9622641509433962,53,1250,800,450,0.64,17,8,9,388.56780121417285,0.8420718432510885,0.3464683091502003,0.21876301756173538,129796.16057117113,-513.0782561636723,129283.08231500746,2823,0,858.622641509434,40,13,14,35.35017951530866,0.6111979166666668,45.24898373983739,1019.0040650406494,25.475101626016233,0
2834,4,1,2,50,0.019230769230769232,0.038461538461538464,0.9615384615384616,52,900,700,200,0.7777777777777778,11,7,4,397.2043063950757,0.8394136500754147,0.36434681426504856,0.2238621505627546,129837.58680555547,-85.59027777778948,129751.99652777768,2824,0,876.1153846153846,39,13,15,35.08789860997546,0.6132478632478633,45.20833333333333,1019.166666666666,26.132478632478612,0
2835,4,1,0,51,0.0196078431372549,0.0,1.0,51,1250,900,350,0.72,16,9,7,392.72207364270895,0.8439542483660132,0.3482793801151296,0.2233341727648495,130188.40889970561,25.572381467466187,130213.98128117308,2825,0,825.4509803921569,42,9,18,34.84460058235219,0.6121031746031745,44.86434108527132,1020.5426356589153,24.298634182355126,0
2836,4,0,0,51,0.0,0.0,1.0,51,1450,900,550,0.6206896551724138,20,9,11,394.9106578750485,0.8425816993464053,0.34825328455158,0.22550691722990798,130348.82010388761,95.3544177993881,130444.174521687,2826,1,826.4509803921569,36,15,18,34.62542273195118,0.6238425925925927,44.707207207207205,1021.1711711711707,28.365865865865853,0
2837,4,0,0,51,0.0,0.0,1.0,51,1350,1000,350,0.7407407407407407,17,10,7,394.3519753422675,0.8427450980392158,0.34727039719227304,0.22602371903224205,130492.6056757771,92.0033631604561,130584.60903893756,2827,2,827.4509803921569,36,15,13,34.49336860281421,0.6252893518518519,44.56644144144144,1021.734234234234,28.3815065065065,0
2838,4,1,2,50,0.019230769230769232,0.038461538461538464,0.9615384615384616,52,1050,700,350,0.6666666666666666,14,7,7,382.30451123875906,0.8448026646556057,0.3380754350516111,0.22114222081196047,130848.09570312485,-395.2365451389045,130452.85915798595,2828,0,812.5192307692307,39,13,14,34.440117423471115,0.6233974358974359,44.21874999999999,1023.1249999999989,26.23397435897433,0
2839,4,0,1,49,0.0,0.02,0.98,50,1050,700,350,0.6666666666666666,14,7,7,391.08248765698664,0.8419557823129251,0.33909746161078025,0.2256680322085794,130753.83434007232,227.10696088100073,130980.94130095333,2829,1,825.78,38,12,16,34.31134440614228,0.6241776315789473,44.31089743589744,1022.7564102564103,26.914642375168693,0
2840,4,0,0,49,0.0,0.0,1.0,49,1100,500,600,0.45454545454545453,17,5,12,394.70234749526287,0.8378330498866213,0.33495494856775787,0.22290547460681703,129917.22140842021,455.72645399306066,130372.94786241328,2830,2,843.5510204081633,39,10,19,35.07043782568713,0.6140491452991453,45.130208333333336,1019.4791666666673,26.14049145299147,1
2841,4,0,0,49,0.0,0.0,1.0,49,1450,1100,350,0.7586206896551724,18,11,7,393.27398124900304,0.8348568594104309,0.3381140084283538,0.22318131700162477,130107.0184434695,433.54102634014345,130540.55946980964,2831,3,844.5510204081633,40,9,20,34.91342099146662,0.6143229166666667,44.94410569105691,1020.2235772357724,25.50558943089431,0
2842,4,1,1,49,0.02,0.02,0.98,50,1300,900,400,0.6923076923076923,17,9,8,386.20866397843616,0.8398809523809524,0.3299624972424444,0.22021180802694976,130291.32806793273,64.39270134161984,130355.72076927435,2832,0,828.64,36,14,20,34.90605926906388,0.623263888888889,44.76351351351351,1020.9459459459454,28.359609609609592,0
2843,4,0,0,49,0.0,0.0,1.0,49,1700,1100,600,0.6470588235294118,23,11,12,401.48478270339933,0.8343962585034014,0.3419431235776267,0.22944959343101015,130380.76560356659,669.1786694101609,131049.94427297675,2833,5,846.5510204081633,35,14,20,34.4250528860683,0.6261904761904762,44.67592592592593,1021.2962962962968,29.179894179894195,0
2844,4,0,0,49,0.0,0.0,1.0,49,1150,800,350,0.6956521739130435,15,8,7,402.48219560902027,0.8342191043083901,0.3468555523704726,0.23072161187249546,130498.99798525372,704.7046467764017,131203.70263203012,2834,6,847.5510204081633,35,14,18,34.279187433922374,0.6273809523809524,44.56018518518518,1021.7592592592589,29.193121693121682,0
2845,4,3,3,49,0.057692307692307696,0.057692307692307696,0.9423076923076923,52,950,700,250,0.7368421052631579,12,7,5,378.9255343034737,0.8514643036701859,0.32989579829303217,0.22086394658008668,131141.34250217036,-461.43934461803275,130679.90315755233,2835,0,799.5961538461538,39,13,18,34.22923234685923,0.62633547008547,43.93229166666668,1024.270833333335,26.263354700854745,0
2846,4,0,0,49,0.0,0.0,1.0,49,1700,1300,400,0.7647058823529411,21,13,8,400.9709787607129,0.8331916099773243,0.3489165820702207,0.23145156496781757,130766.77439212069,686.7363034779944,131453.51069559867,2836,8,849.5510204081633,37,12,18,34.045347341337894,0.6261261261261261,44.29824561403509,1022.80701754386,27.64343290659081,0
2847,4,1,0,50,0.02,0.0,1.0,50,1300,1100,200,0.8461538461538461,15,11,4,390.6413023627911,0.837517006802721,0.3468663257852449,0.2270173196205354,131027.14913662433,236.92323672292085,131264.07237334724,2837,0,833.54,38,12,19,34.045097220772895,0.6269188596491228,44.04380341880342,1023.8247863247865,26.942757534862803,0
2848,4,0,0,50,0.0,0.0,1.0,50,1100,800,300,0.7272727272727273,14,8,6,392.2072335337189,0.8364455782312925,0.35158652341712693,0.22857694516035043,131136.55495516476,286.541086821536,131423.09604198628,2838,1,834.54,38,12,20,33.89398838705192,0.628015350877193,43.93696581196581,1024.252136752137,26.954003598740446,0
2849,4,0,0,50,0.0,0.0,1.0,50,1350,1000,350,0.7407407407407407,17,10,7,391.9813720914221,0.8352380952380952,0.34430775646372047,0.22926130006712914,131273.37643363274,291.3436427058152,131564.72007633856,2839,2,835.54,38,12,20,33.76099006116209,0.6293859649122808,43.8034188034188,1024.786324786324,26.968061178587476,0
2850,4,0,0,50,0.0,0.0,1.0,50,1100,600,500,0.5454545454545454,16,6,10,391.9813720914221,0.8351360544217686,0.34430775646372047,0.22926130006712914,131273.37643363274,291.3436427058152,131564.72007633856,2840,3,836.54,38,12,20,33.76099006116209,0.6293859649122808,43.8034188034188,1024.786324786324,26.968061178587476,0
2851,4,1,1,50,0.0196078431372549,0.0196078431372549,0.9803921568627451,51,950,700,250,0.7368421052631579,12,7,5,383.1997732484735,0.8412745098039216,0.34219169901463165,0.22601902793397977,131595.1877170138,-114.5051241530706,131480.6825928607,2841,0,821.1176470588235,35,16,16,33.66010998307953,0.6383928571428572,43.48958333333333,1026.0416666666658,29.315476190476165,0
2852,4,0,0,50,0.0,0.0,1.0,50,1300,800,500,0.6153846153846154,18,8,10,390.822786260174,0.8345408163265305,0.3427072208033439,0.2296417108352755,131450.177154195,274.7448979591967,131724.9220521542,2842,5,838.54,34,16,20,33.61146583081806,0.6390931372549019,43.63095238095239,1025.4761904761906,30.161064425770313,0
2853,4,0,0,50,0.0,0.0,1.0,50,1700,1400,300,0.8235294117647058,20,14,6,352.85575767720144,0.8347619047619047,0.2620733496332517,0.1928353886824902,128622.09590143956,-907.5569058641674,127714.53899557539,2843,6,839.54,41,9,17,37.45548084759578,0.5978150406504064,46.403769841269856,1014.3849206349229,24.74109562524202,7
2854,4,2,0,52,0.038461538461538464,0.0,1.0,52,1150,1000,150,0.8695652173913043,13,10,3,343.9466344284045,0.8433415032679737,0.2804545734988655,0.19040084780074654,129132.33109017294,-1517.0738651281038,127615.25722504484,2844,0,808.2115384615385,45,7,20,37.16162775153732,0.5974537037037035,45.90126811594204,1016.3949275362334,22.58655394524963,0
2855,4,0,0,52,0.0,0.0,1.0,52,1350,1000,350,0.7407407407407407,17,10,7,347.29109084459526,0.8442370537958772,0.2884688651666458,0.19343284683169265,129373.84627013099,-1413.8677788007903,127959.9784913302,2845,1,809.2115384615385,42,10,20,36.830888656062484,0.6039186507936507,45.66375968992248,1017.34496124031,24.22249907715024,0
2856,4,0,1,51,0.0,0.019230769230769232,0.9807692307692307,52,1200,800,400,0.6666666666666666,16,8,8,355.3215277871732,0.8442370537958772,0.31235504014273063,0.19544427509785084,128879.27710171146,-1241.2836720227172,127637.99342968874,2846,2,810.2115384615385,45,7,17,37.1305382099316,0.5949074074074076,46.150362318840564,1015.3985507246347,22.564412238325215,1
2857,4,2,0,53,0.03773584905660377,0.0,1.0,53,1200,800,400,0.6666666666666666,16,8,8,357.67789435450237,0.8528664731494919,0.3441868682778877,0.1988564952777849,129302.26836104793,-1348.2772359188912,127953.99112512903,2847,0,795.2264150943396,41,12,19,36.63959877747431,0.6046747967479675,45.73412698412697,1017.0634920634906,24.80642663569489,0
2858,4,2,2,53,0.03636363636363636,0.03636363636363636,0.9636363636363636,55,1700,1300,400,0.7647058823529411,21,13,8,344.9050039658564,0.8609147025813693,0.3523411816970228,0.19477701051860094,129916.06710939152,-2038.2596716813625,127877.80743771016,2848,0,767.2727272727273,45,10,19,36.340792980897376,0.6053240740740741,45.13134057971015,1019.4746376811603,22.65499194847023,0
2859,4,0,0,53,0.0,0.0,1.0,53,1150,800,350,0.6956521739130435,15,8,7,352.6980377906975,0.8574020319303338,0.35010558358929345,0.19889856557377045,129861.17969821673,-1439.643347050761,128421.53635116597,2849,1,767.4905660377359,44,9,19,36.19791666666666,0.6060606060606061,45.18518518518518,1019.2592592592592,23.164983164983166,0
2860,4,0,0,53,0.0,0.0,1.0,53,1700,1400,300,0.8235294117647058,20,14,6,352.8079163454464,0.8548923560716013,0.355830868589025,0.20004553856807927,130073.6121827845,-1421.799982853232,128651.81219993127,2850,2,768.4905660377359,44,9,19,35.97943330005144,0.608191287878788,44.97685185185185,1020.0925925925916,23.183922558922536,0
2861,4,3,3,53,0.05357142857142857,0.05357142857142857,0.9464285714285714,56,800,600,200,0.75,10,6,4,343.1434209979894,0.863379329004329,0.38392857142857184,0.1983461298952502,130820.18455530347,-2221.1598219534885,128599.02473334997,2851,0,728.2678571428571,41,15,17,35.47000258598396,0.6199186991869919,44.24603174603174,1023.015873015872,24.95160665892371,0
2862,4,0,0,53,0.0,0.0,1.0,53,1500,800,700,0.5333333333333333,22,8,14,354.3685018903597,0.8536828737300435,0.384280147662019,0.2037618885869565,130617.28395061707,-1342.669753086437,129274.61419753064,2852,1,763.9622641509434,41,12,17,35.3883605072464,0.6178861788617886,44.444444444444436,1022.2222222222205,24.93224932249318,0
2863,4,0,0,53,0.0,0.0,1.0,53,900,300,600,0.3333333333333333,15,3,12,356.442581902189,0.8535316884373488,0.3888912279802521,0.2053579481087679,130693.35322381252,-1283.0647478899095,129410.28847592261,2853,2,764.9622641509434,41,12,17,35.25829937582873,0.6186483739837398,44.37003968253968,1022.51984126984,24.939508323654632,0
2864,4,0,0,53,0.0,0.0,1.0,53,1700,1200,500,0.7058823529411765,22,12,10,357.0479048918286,0.8519593613933236,0.3907286827945684,0.20651907140490308,130845.5582030264,-1256.373515841539,129589.18468718487,2854,3,765.9622641509434,41,12,18,35.08870276996671,0.6201727642276423,44.22123015873015,1023.1150793650779,24.95402632597751,0
2865,4,0,1,52,0.0,0.018867924528301886,0.9811320754716981,53,1550,1500,50,0.967741935483871,16,15,1,390.14816160944235,0.8523524431543299,0.46250740447464334,0.2158975110422643,129117.79495854516,-504.0103843873888,128613.78457415776,2855,4,766.9622641509434,37,16,18,36.00251285647501,0.6095157657657657,45.91557017543861,1016.3377192982474,27.46858700806074,6
2866,4,4,3,53,0.07142857142857142,0.05357142857142857,0.9464285714285714,56,1450,1100,350,0.7586206896551724,18,11,7,361.0924848501909,0.868262987012987,0.4367434048092891,0.20459050165369586,130044.5513391228,-1808.2968083671817,128236.25453075561,2856,0,702.9107142857143,38,18,18,35.79767640794666,0.6170504385964912,45.00534188034189,1019.9786324786337,26.841542959964045,0
2867,4,2,0,55,0.03636363636363636,0.0,1.0,55,1450,700,750,0.4827586206896552,22,7,15,376.1185049702409,0.8640572390572391,0.46708598663906,0.21399211761998777,130206.62607725445,-1205.375692520785,129001.25038473366,2857,0,716.6545454545454,37,18,20,35.249695602349234,0.6204954954954955,44.84649122807017,1020.6140350877185,27.58416311047888,0
2868,4,1,0,56,0.017857142857142856,0.0,1.0,56,950,700,250,0.7368421052631579,12,7,5,365.36445539613743,0.8659361471861472,0.46247623044900954,0.20968851985880155,130544.21864487203,-1660.69641528976,128883.52222958228,2858,0,704.8392857142857,33,23,20,35.18145161290323,0.632260101010101,44.51593137254901,1021.9362745098028,30.96776589423645,0
2869,4,2,1,57,0.034482758620689655,0.017241379310344827,0.9827586206896551,58,1750,1400,350,0.8,21,14,7,345.54321397891965,0.8711685823754789,0.4500744845780913,0.20162967399398518,131183.87972009153,-2534.0601158591217,128649.81960423241,2859,0,681.5,36,22,23,35.041084973068045,0.6322337962962964,43.89076576576576,1024.4369369369356,28.456581581581545,0
2870,4,0,0,57,0.0,0.0,1.0,57,1700,1500,200,0.8823529411764706,19,15,4,352.8106727512642,0.8663063909774436,0.45591263385611813,0.20494580357710784,131010.89000740589,-2155.591951749063,128855.29805565682,2860,1,694.421052631579,36,21,23,35.02983720162799,0.6304976851851853,44.059684684684676,1023.76126126126,28.437812812812776,0
2871,4,0,0,57,0.0,0.0,1.0,57,1550,1000,550,0.6451612903225806,21,10,11,353.86676858267,0.8666196741854636,0.4578160252328001,0.2059041589902525,131075.36844269375,-2123.356585680227,128952.01185701352,2861,2,695.421052631579,37,20,23,34.93760484705712,0.629222972972973,43.99671052631578,1024.0131578947355,27.67603129445231,0
2872,4,0,1,56,0.0,0.017543859649122806,0.9824561403508771,57,1250,700,550,0.56,18,7,11,352.6365277987427,0.8656537176274018,0.4574572377566104,0.20624936430765467,131273.37643363266,-2141.642468405309,129131.73396522735,2862,3,696.421052631579,38,19,24,34.768991520711715,0.6293859649122808,43.80341880341879,1024.7863247863233,26.968061178587458,0
2873,4,0,0,56,0.0,0.0,1.0,56,1400,700,700,0.5,21,7,14,350.0734136045345,0.865625,0.4493975714599483,0.20566248414728344,131443.578291129,-1996.9967416974418,129446.58154943156,2863,4,706.3928571428571,36,20,24,34.66281389559998,0.6348379629629629,43.63738738738739,1025.4504504504507,28.484734734734744,0
2874,4,1,0,57,0.017543859649122806,0.0,1.0,57,1700,1400,300,0.8235294117647058,20,14,6,346.47334488107356,0.8665413533834586,0.4543610547667345,0.20579681810405925,131862.52170138882,-2262.6302083333376,129599.89149305547,2864,0,694.9824561403509,37,20,21,34.33274171737661,0.6371058558558559,43.229166666666664,1027.0833333333328,27.759009009008995,0
2875,4,0,0,57,0.0,0.0,1.0,57,1200,800,400,0.6666666666666666,16,8,8,347.7047595074541,0.8660192147034251,0.4560504783837924,0.20698815734338277,131946.99931709745,-2224.2800669436883,129722.71925015376,2865,1,695.9824561403509,37,20,21,34.2160263251512,0.6379504504504505,43.1469298245614,1027.4122807017536,27.76789947842577,0
2876,4,0,0,57,0.0,0.0,1.0,57,2250,1700,550,0.7555555555555555,28,17,11,344.4216649350119,0.8658625730994152,0.45220077952444293,0.20539318009980623,132013.44515897782,-2306.3418849076133,129707.1032740702,2866,2,696.9824561403509,38,19,21,34.23346155178986,0.6367872807017545,43.08226495726495,1027.6709401709386,27.04397210976154,0
2877,4,0,1,56,0.0,0.017543859649122806,0.9824561403508771,57,1450,1000,450,0.6896551724137931,19,10,9,344.6400471632929,0.8656537176274018,0.4507498986623426,0.20586610081158463,132076.58420138908,-2296.223958333315,129780.36024305577,2867,3,697.9824561403509,39,18,21,34.16430212133494,0.6356837606837606,43.02083333333334,1027.9166666666683,26.35683760683765,0
2878,4,0,2,54,0.0,0.03571428571428571,0.9642857142857143,56,1700,800,900,0.47058823529411764,26,8,18,354.0540540540542,0.861715367965368,0.45699806949806954,0.21129032258064517,132040.89506172828,-1850.0771604938382,130190.81790123445,2868,4,711.25,38,18,21,33.95833333333333,0.637061403508772,43.05555555555555,1027.777777777777,27.04678362573097,0
2879,4,0,0,54,0.0,0.0,1.0,54,1700,1200,500,0.7058823529411765,22,12,10,372.82672586339766,0.8547926857675285,0.47344690599790384,0.2210295244748024,131790.2425229284,-973.0150758866895,130817.2274470417,2869,5,738.2592592592592,36,18,21,33.72907070263947,0.6383101851851851,43.29954954954955,1026.8018018018024,28.52227227227229,0
2880,4,1,0,55,0.01818181818181818,0.0,1.0,55,1650,1300,350,0.7878787878787878,20,13,7,366.36499003015024,0.855976430976431,0.4862215761603159,0.22039108176017347,132343.03232750745,-1302.8292561545768,131040.20307135287,2870,0,725.8181818181819,38,17,23,33.33744332537293,0.6400767543859649,42.761752136752136,1028.9529914529912,27.077710301394507,0
2881,4,0,0,55,0.0,0.0,1.0,55,1000,700,300,0.7,13,7,6,362.5918725969479,0.8559203142536476,0.4814999005370999,0.21860750102480914,132426.9793442092,-1396.587886896691,131030.3914573125,2871,1,726.8181818181819,36,19,23,33.34997264770241,0.6446759259259258,42.68018018018019,1029.2792792792802,28.591091091091116,0
2882,4,0,0,55,0.0,0.0,1.0,55,1350,1200,150,0.8888888888888888,15,12,3,364.45107470561464,0.8545173961840629,0.48310139934581087,0.2208808642441642,132623.79410010777,-1333.0231417359098,131290.77095837187,2872,2,727.8181818181819,37,18,23,33.10402029664324,0.6447072072072071,42.4890350877193,1030.043859649123,27.839023233760084,0
2883,4,0,0,55,0.0,0.0,1.0,55,1850,1400,450,0.7567567567567568,23,14,9,361.7691263014937,0.8534231200897867,0.48160928433268846,0.2202480432146402,132793.2633117884,-1391.8994305940105,131401.3638811944,2873,3,728.8181818181819,37,18,20,33.00265957446809,0.6463963963963963,42.32456140350878,1030.7017543859663,27.856804172593684,0
2884,4,0,0,55,0.0,0.0,1.0,55,1350,900,450,0.6666666666666666,18,9,9,360.99024354334574,0.8523849607182941,0.4783408953140209,0.22028862087497167,132880.8648003474,-1406.2608506944252,131474.60394965296,2874,4,729.8181818181819,39,16,20,32.93468377449991,0.6436965811965811,42.23958333333334,1031.041666666668,26.436965811965848,0
2885,4,0,0,55,0.0,0.0,1.0,55,1300,800,500,0.6153846153846154,18,8,10,360.99024354334574,0.8523288439955107,0.4783408953140209,0.22028862087497167,132880.8648003474,-1406.2608506944252,131474.60394965296,2875,5,730.8181818181819,39,16,20,32.93468377449991,0.6436965811965811,42.23958333333334,1031.041666666668,26.436965811965848,0
2886,4,0,0,55,0.0,0.0,1.0,55,1800,1200,600,0.6666666666666666,24,12,12,355.24231328344956,0.8523288439955107,0.47017183139961727,0.21771781378460953,133042.01388888908,-1547.5694444444246,131494.44444444464,2876,6,731.8181818181819,39,16,20,32.921042003231015,0.6452991452991452,42.08333333333334,1031.6666666666683,26.452991452991494,0
2887,4,0,0,55,0.0,0.0,1.0,55,1950,1400,550,0.717948717948718,25,14,11,367.1487304906276,0.8524971941638608,0.4751164073919909,0.22201505009900085,132539.10007165666,-1265.6042003308703,131273.49587132578,2877,7,732.8181818181819,37,18,20,33.11980885954638,0.6438626126126126,42.57127192982456,1029.7149122807016,27.830132764343286,1
2888,4,0,1,54,0.0,0.01818181818181818,0.9818181818181818,55,1600,900,700,0.5625,23,9,14,365.8536585365854,0.8524971941638608,0.466666666666667,0.21428571428571414,131328.12499999988,-1368.9266168436584,129959.19838315622,2878,8,733.8181818181819,34,21,20,34.375,0.6378676470588236,43.74999999999999,1024.999999999999,30.147058823529385,3
2889,4,0,0,54,0.0,0.0,1.0,54,1600,1100,500,0.6875,21,11,10,373.2489124272009,0.8491148381085488,0.47696776596840795,0.21829689208664677,131271.9358360263,-1000.5785433979876,130271.35729262831,2879,9,748.0370370370371,37,17,20,34.242367501248296,0.6311936936936938,43.8048245614035,1024.7807017543846,27.696775723091477,0
2890,4,0,0,54,0.0,0.0,1.0,54,1650,1400,250,0.8484848484848485,19,14,5,373.28798972184865,0.8474988353133007,0.4783445351772302,0.2191635620636866,131419.65880102038,-988.4878824567718,130431.17091856361,2880,10,749.0370370370371,34,20,20,34.091876620612254,0.6387867647058822,43.660714285714285,1025.3571428571427,30.157563025210077,0
2891,4,0,0,54,0.0,0.0,1.0,54,1650,1300,350,0.7878787878787878,20,13,7,373.6958179733695,0.8465962031213604,0.4796893667861406,0.22028116000646378,131572.2859977325,-966.3973922902418,130605.88860544228,2881,11,750.0370370370371,34,20,18,33.92705190686161,0.6403186274509803,43.511904761904766,1025.9523809523816,30.175070028011223,0
2892,4,1,0,55,0.01818181818181818,0.0,1.0,55,1350,900,450,0.6666666666666666,18,9,9,364.7869232295181,0.8492424242424242,0.47653777208706805,0.21684420252257006,131892.24222232925,-1377.4869523748475,130514.7552699544,2882,0,737.3818181818182,35,20,19,33.83251173708921,0.6413690476190477,43.200231481481474,1027.199074074073,29.348544973544943,0
2893,4,0,0,55,0.0,0.0,1.0,55,1550,1200,350,0.7741935483870968,19,12,7,365.0144403387928,0.8491301907968575,0.4778149866355339,0.21731946256790483,131951.69331114963,-1367.1453028549483,130584.54800829469,2883,1,738.3818181818182,35,20,19,33.76668638053397,0.6419642857142858,43.14236111111111,1027.430555555555,29.355158730158713,0
2894,4,0,1,54,0.0,0.01818181818181818,0.9818181818181818,55,1250,1000,250,0.8,15,10,5,363.4769905040176,0.847334455667789,0.4756756756756755,0.21691368788142976,132040.8950617283,-1401.234567901245,130639.66049382706,2884,2,739.3818181818182,35,20,19,33.71621621621621,0.6428571428571428,43.05555555555555,1027.7777777777771,29.365079365079346,0
2895,4,3,3,54,0.05263157894736842,0.05263157894736842,0.9473684210526316,57,1100,600,500,0.5454545454545454,16,6,10,343.8780061273901,0.8572472848788638,0.4434073374996641,0.20828531417490806,132600.90115453303,-2279.8110469703824,130321.09010756265,2885,0,712.0350877192982,36,21,19,33.656789853487865,0.646412037037037,42.51126126126127,1029.9549549549558,28.609859859859885,0
2896,4,0,0,54,0.0,0.0,1.0,54,1050,900,150,0.8571428571428571,12,9,3,366.00547555555556,0.8476007453994876,0.4675377777777776,0.21869352028893135,132087.85545792934,-1131.02432960142,130956.83112832792,2886,4,752.5925925925926,37,17,19,33.603888888888896,0.6393581081081081,43.00986842105263,1027.9605263157891,27.78271692745376,0
2897,4,0,0,54,0.0,0.0,1.0,54,1900,1200,700,0.631578947368421,26,12,14,365.54972894407916,0.8480957372466806,0.4635550503076875,0.21972793764780896,132313.3815813521,-1126.5758454524344,131186.80573589966,2887,5,753.5925925925926,37,17,20,33.388286440015634,0.6416103603603602,42.7905701754386,1028.8377192982466,27.806424845898558,0
2898,4,0,0,54,0.0,0.0,1.0,54,1650,800,850,0.48484848484848486,25,8,17,365.71602978087645,0.8477608898206382,0.4636475587476345,0.22100077067326898,132513.92598257068,-1107.4795682026465,131406.44641436802,2888,6,754.5925925925926,36,18,21,33.18203361405811,0.6455439814814813,42.595720720720735,1029.6171171171193,28.600475475475534,0
2899,4,2,2,54,0.03571428571428571,0.03571428571428571,0.9642857142857143,56,1450,1200,250,0.8275862068965517,17,12,5,331.2118323069389,0.8560064935064935,0.35973531544597503,0.19535548192954197,131595.18771701396,-2472.465653470186,129122.72206354377,2889,0,728.6071428571429,39,17,17,34.99365482233502,0.6308760683760684,43.489583333333336,1026.0416666666672,26.3087606837607,6
2900,4,0,1,53,0.0,0.018518518518518517,0.9814814814814815,54,1500,1100,400,0.7333333333333333,19,11,8,348.43036979787144,0.8483286745865363,0.366070968840726,0.204530595604513,131412.4312889541,-1642.383593990482,129770.04769496362,2890,8,756.5925925925926,37,17,19,34.7363695504937,0.6326013513513514,43.667763157894726,1025.3289473684197,27.71159317211945,0
2901,4,0,0,53,0.0,0.0,1.0,53,1150,900,250,0.782608695652174,14,9,5,352.8773835327392,0.8466981132075472,0.37883775905326766,0.20746638681940957,131472.44953991147,-1321.2691999431959,130151.18033996827,2891,9,771.0754716981132,36,17,20,34.56178397569633,0.6351273148148149,43.60923423423423,1025.5630630630626,28.48786286286285,0
2902,4,0,0,53,0.0,0.0,1.0,53,1200,700,500,0.5833333333333334,17,7,10,356.72210229204126,0.8470609579100145,0.3826830793181548,0.2108408067632727,131674.6370525931,-1205.7493304114942,130468.88772218162,2892,10,772.0754716981132,36,17,18,34.25910686855388,0.6371527777777779,43.41216216216216,1026.3513513513512,28.509759759759756,0
2903,4,0,0,53,0.0,0.0,1.0,53,1650,1400,250,0.8484848484848485,19,14,5,355.36044172162843,0.8472726173197871,0.3850893643078577,0.21107553948043686,131862.52170138873,-1228.2552083333526,130634.26649305537,2893,11,773.0754716981132,37,16,18,34.10454699121027,0.6371058558558559,43.22916666666666,1027.083333333332,27.75900900900897,0
2904,4,0,0,53,0.0,0.0,1.0,53,1250,600,650,0.48,19,6,13,355.19962647656763,0.8473028543783261,0.386432977482948,0.21129303494977517,131918.83710612866,-1228.495666935995,130690.34143919266,2894,12,774.0754716981132,37,16,18,34.051904329882234,0.637668918918919,43.17434210526315,1027.3026315789461,27.764935988620167,0
2905,4,0,0,53,0.0,0.0,1.0,53,1450,1100,350,0.7586206896551724,18,11,7,354.17622755555556,0.8468492985002418,0.389083773584906,0.21162537497344364,132087.85545792922,-1243.5243296014357,130844.33112832779,2895,13,775.0754716981132,37,16,19,33.90788888888889,0.6393581081081081,43.00986842105262,1027.9605263157882,27.782716927453738,0
2906,4,0,0,53,0.0,0.0,1.0,53,1100,700,400,0.6363636363636364,15,7,8,352.23187792384414,0.8462747943880019,0.3852259945551242,0.2107771741730621,132144.21895438968,-1290.9187201831485,130853.30023420653,2896,14,776.0754716981132,37,16,19,33.90110109843234,0.6399211711711712,42.955043859649116,1028.1798245614025,27.78864390706493,0
2907,4,0,0,53,0.0,0.0,1.0,53,1550,800,750,0.5161290322580645,23,8,15,353.49241602810156,0.8461236090953071,0.3902025973817007,0.21216329844911203,132256.9820161012,-1249.6319781086368,131007.35003799255,2897,15,777.0754716981132,37,16,19,33.75517446611947,0.6410472972972973,42.84539473684211,1028.6184210526321,27.800497866287355,0
2908,4,1,2,52,0.018518518518518517,0.037037037037037035,0.962962962962963,54,1600,1300,300,0.8125,19,13,6,342.0409683274203,0.8513277428371768,0.38368175762949974,0.2073325869642755,132629.89921932085,-1726.8778817443974,130903.02133757646,2898,0,763.6666666666666,36,18,15,33.674975401771086,0.6467013888888888,42.48310810810812,1030.067567567569,28.61298798798803,0
2909,4,0,0,52,0.0,0.0,1.0,52,800,400,400,0.5,12,4,8,357.21813330662155,0.843891402714932,0.40097688570971,0.21537712556269495,132428.63520408145,-938.8180272109081,131489.81717687054,2899,17,793.1346153846154,34,18,19,33.486583391163535,0.6488970588235295,42.678571428571416,1029.2857142857129,30.273109243697437,0
2910,4,0,0,52,0.0,0.0,1.0,52,1750,1300,450,0.7428571428571429,22,13,9,357.03438380410773,0.8434200603318249,0.39824495892457046,0.2163208325401356,132612.49999999977,-930.5555555555862,131681.94444444418,2900,18,794.1346153846154,34,18,20,33.30636461704422,0.6507352941176472,42.499999999999986,1029.9999999999982,30.29411764705877,0
2911,4,0,0,52,0.0,0.0,1.0,52,1000,600,400,0.6,14,6,8,356.50502039968455,0.8419117647058822,0.4064004833235606,0.21706191748385825,132796.4923469385,-931.4767573696465,131865.01558956885,2901,19,795.1346153846154,34,18,18,33.135058135058124,0.6525735294117648,42.321428571428555,1030.7142857142835,30.315126050420105,0
2912,4,0,0,52,0.0,0.0,1.0,52,1200,900,300,0.75,15,9,6,357.3409640032218,0.841566113624937,0.40719932492449895,0.21792765832872532,132857.8514739228,-904.8894557823189,131952.9620181405,2902,20,796.1346153846154,34,18,19,33.05186682063126,0.6531862745098039,42.26190476190476,1030.9523809523803,30.322128851540597,0
2913,4,0,1,51,0.0,0.019230769230769232,0.9807692307692307,52,950,700,250,0.7368421052631579,12,7,5,357.4846431260444,0.841299019607843,0.408774843258797,0.21837320019448456,132919.22477324237,-896.6836734694091,132022.54109977296,2903,21,797.1346153846154,34,18,19,32.98651196798278,0.6537990196078433,42.20238095238094,1031.1904761904743,30.329131652661008,0
2914,4,0,0,51,0.0,0.0,1.0,51,2150,1400,750,0.6511627906976745,29,14,15,359.94007740871365,0.8373202614379086,0.4204124299154237,0.22059693853068651,133042.01388888867,-622.5694444444689,132419.4444444442,2904,22,811.8039215686274,34,17,20,32.79987883683361,0.6550245098039217,42.08333333333332,1031.666666666665,30.343137254901908,0
2915,4,0,0,51,0.0,0.0,1.0,51,1300,800,500,0.6153846153846154,18,8,10,359.44728238242425,0.8365359477124183,0.4197403560663109,0.22120421472945345,133195.58000283435,-624.6421485260885,132570.93785430826,2905,23,812.8039215686274,34,17,20,32.65843040018453,0.6565563725490196,41.9345238095238,1032.261904761904,30.360644257703058,0
2916,4,0,0,51,0.0,0.0,1.0,51,1450,1100,350,0.7586206896551724,18,11,7,352.7732250311674,0.83640522875817,0.39577074515966437,0.21541169717633107,132904.73257726768,-822.9537733624838,132081.7788039052,2906,24,813.8039215686274,35,16,20,33.12252123320986,0.6514880952380953,42.21643518518518,1031.1342592592594,29.46097883597884,1
2917,4,1,0,52,0.019230769230769232,0.0,1.0,52,1300,700,600,0.5384615384615384,19,7,12,343.7445701331203,0.8403720462543991,0.3881342062193125,0.21129570659088212,133152.40652392275,-1245.9166514487251,131906.48987247402,2907,0,799.1346153846154,36,16,21,33.106928532460444,0.6519097222222221,41.97635135135136,1032.094594594596,28.669294294294332,0
2918,4,1,0,53,0.018867924528301886,0.0,1.0,53,1250,1000,250,0.8,15,10,5,336.38060405106523,0.8442186744073537,0.38175606669256634,0.20823771690993015,133415.5761869037,-1624.3175784856785,131791.25860841802,2908,0,785.0377358490566,37,16,22,33.03350314865917,0.6525900900900901,41.72149122807018,1033.1140350877197,27.922000948316747,0
2919,4,0,0,53,0.0,0.0,1.0,53,750,300,450,0.4,12,3,9,338.26533642110167,0.8437953555878084,0.3841223501708986,0.20956438297804358,133443.89770169675,-1572.1110101184906,131871.78669157825,2909,1,786.0377358490566,37,16,22,32.95648501892533,0.6528716216216215,41.694078947368425,1033.223684210527,27.92496443812235,0
2920,4,0,0,53,0.0,0.0,1.0,53,1350,800,550,0.5925925925925926,19,8,11,337.08021197463984,0.8437046444121915,0.3821520410617345,0.209482685559595,133559.51126379755,-1595.943320661434,131963.56794313612,2910,2,787.0377358490566,36,17,22,32.8714547699459,0.6559606481481481,41.582207207207205,1033.671171171171,28.71308808808808,0
2921,4,0,1,52,0.0,0.018867924528301886,0.9811320754716981,53,950,700,250,0.7368421052631579,12,7,5,336.57569477165555,0.8432208514755685,0.3792232737749852,0.2096373052639836,133642.23246575866,-1603.8545514004395,132038.37791435822,2911,3,788.0377358490566,37,16,22,32.80178508306821,0.6548423423423424,41.50219298245614,1033.991228070175,27.94570886676149,0
2922,4,0,1,51,0.0,0.019230769230769232,0.9807692307692307,52,1200,700,500,0.5833333333333334,17,7,10,342.44275858198074,0.8429330065359476,0.3892585949679006,0.21264814873243698,133530.41174620562,-1254.695489408328,132275.71625679728,2912,4,765.8269230769231,36,16,22,32.761994261640176,0.6556712962962963,41.61036036036036,1033.5585585585582,28.70995995995995,0
2923,4,0,0,51,0.0,0.0,1.0,51,1350,900,450,0.6666666666666666,18,9,9,348.59521331945894,0.8431372549019609,0.38946869070208723,0.2161290322580644,133472.22222222207,-894.4444444444641,132577.7777777776,2913,5,777.9607843137255,35,16,22,32.66129032258065,0.6571428571428573,41.66666666666666,1033.3333333333321,29.52380952380949,0
2924,4,1,0,52,0.019230769230769232,0.0,1.0,52,1700,1100,600,0.6470588235294118,23,11,12,345.4028437891399,0.8454154097536449,0.3887288418753616,0.21662840149672363,133897.45071800938,-1150.2879491766728,132747.1627688327,2914,0,763.9807692307693,37,15,16,32.31837323869053,0.6573761261261262,41.25548245614035,1034.9780701754385,27.97238027501185,0
2925,4,0,0,52,0.0,0.0,1.0,52,1600,1200,400,0.75,20,12,8,347.39624871968203,0.8442527652086474,0.39115462002785906,0.21855181723250897,134010.95920138896,-1089.0190972222172,132921.94010416674,2915,1,764.9807692307693,37,15,16,32.153336686787384,0.6585022522522522,41.145833333333336,1035.4166666666672,27.984234234234247,0
2926,4,0,0,52,0.0,0.0,1.0,52,1450,1200,250,0.8275862068965517,17,12,5,348.55446533644636,0.8445984162895926,0.39169611882929734,0.21978941786168704,134096.12212411506,-1052.0395698676548,133044.0825542474,2916,2,765.9807692307693,37,15,16,32.03825252311385,0.6593468468468469,41.06359649122807,1035.7456140350873,27.99312470365101,0
2927,4,0,1,51,0.0,0.019230769230769232,0.9807692307692307,52,1000,800,200,0.8,12,8,4,354.5016096973772,0.8435300402212166,0.3928815628815636,0.22423294589291917,134209.71476800542,-884.4880155432534,133325.22675246216,2917,3,766.9807692307693,37,15,16,31.770723104056444,0.660472972972973,40.95394736842105,1036.1842105263147,28.00497866287337,0
2928,4,1,1,51,0.019230769230769232,0.019230769230769232,0.9807692307692307,52,1600,1300,300,0.8125,19,13,6,351.91504436884634,0.84309012066365,0.39481361228425693,0.22311555428696872,134294.9408111149,-947.9179891889836,133347.02282192593,2918,0,767.7884615384615,37,15,17,31.75259617758032,0.6613175675675675,40.87171052631579,1036.5131578947364,28.013869132290175,0
2929,4,0,0,51,0.0,0.0,1.0,51,1150,800,350,0.6956521739130435,15,8,7,359.36123976563954,0.8381372549019609,0.4018543484945247,0.227412570813523,134226.75781249997,-552.8211805555557,133673.9366319444,2919,1,783.6274509803922,39,12,18,31.627797882321417,0.6570512820512822,40.9375,1036.2499999999998,26.570512820512814,0
2930,4,0,0,51,0.0,0.0,1.0,51,1100,600,500,0.5454545454545454,16,6,10,356.0323641049411,0.837843137254902,0.3968450952814322,0.22630562913796826,134388.72070312497,-630.6532118055543,133758.0674913194,2920,2,784.6274509803922,39,12,19,31.552223561717238,0.6586538461538463,40.78125,1036.8749999999998,26.586538461538456,0
2931,4,0,0,51,0.0,0.0,1.0,51,1200,900,300,0.75,15,9,6,354.2974487626097,0.837091503267974,0.3929838655687219,0.22587029415992754,134496.75021701393,-669.6289062499932,133827.12131076393,2921,3,785.6274509803922,39,12,19,31.48933855526545,0.6597222222222222,40.677083333333336,1037.291666666667,26.59722222222223,0
2932,4,0,0,51,0.0,0.0,1.0,51,1200,900,300,0.75,15,9,6,354.1936471472121,0.8369281045751635,0.3933698506535235,0.2263204067138983,134579.99173159653,-666.4918270254974,133913.49990457104,2922,4,786.6274509803922,36,15,20,31.408951957166632,0.6660879629629629,40.59684684684685,1037.6126126126132,28.82257257257259,0
2933,4,0,0,51,0.0,0.0,1.0,51,1600,1300,300,0.8125,19,13,6,367.01507890990996,0.8369281045751635,0.42808331511043085,0.21462403527557783,131267.12018140592,-539.4847662403154,130727.6354151656,2923,5,787.6274509803922,34,17,19,34.4069470260223,0.6372549019607843,43.80952380952381,1024.7619047619048,30.140056022408967,7
2934,4,1,1,51,0.019230769230769232,0.019230769230769232,0.9807692307692307,52,1250,1000,250,0.8,15,10,5,359.98565499326975,0.8420060331825037,0.4156324043777506,0.2119968677877308,131535.81700370795,-929.7985521690692,130606.01845153888,2924,0,773.4615384615385,35,17,20,34.31552991838732,0.6377976190476191,43.5474537037037,1025.8101851851848,29.308862433862423,0
2935,4,0,0,51,0.0,0.0,1.0,51,1650,1200,450,0.7272727272727273,21,12,9,370.40018846994235,0.8362418300653596,0.43251939280992735,0.21816393875909038,131541.75347222213,-455.38194444444775,131086.3715277777,2925,7,789.6274509803922,34,17,20,34.04244516653128,0.6400122549019608,43.541666666666664,1025.8333333333328,30.171568627450966,0
2936,4,0,0,51,0.0,0.0,1.0,51,1200,700,500,0.5833333333333334,17,7,10,371.70339569175337,0.8361111111111111,0.43644115030859765,0.2192821059183588,131602.82206632654,-416.5568310657634,131186.26523526077,2926,8,790.6274509803922,34,17,15,33.94728700158562,0.640625,43.482142857142854,1026.0714285714284,30.178571428571423,0
2937,4,0,0,51,0.0,0.0,1.0,51,1350,900,450,0.6666666666666666,18,9,9,370.61707840542766,0.8347058823529413,0.4291074815451581,0.2191673834027159,131694.45153061222,-438.35742630386267,131256.09410430834,2927,9,791.6274509803922,34,17,16,33.88255818448929,0.6415441176470589,43.39285714285714,1026.428571428571,30.18907563025209,0
2938,4,0,0,51,0.0,0.0,1.0,51,1550,1000,550,0.6451612903225806,21,10,11,369.69392863733947,0.8343464052287582,0.4281947418429466,0.219324609932991,131816.67375283438,-453.635204081642,131363.03854875272,2928,10,792.6274509803922,34,17,16,33.78279812968544,0.6427696078431373,43.27380952380952,1026.9047619047612,30.203081232492977,0
2939,4,0,0,51,0.0,0.0,1.0,51,1150,700,450,0.6086956521739131,16,7,9,369.0649315611984,0.8337581699346406,0.4282176194421432,0.2193872248898616,131892.24222232925,-464.63973015262326,131427.60249217664,2929,11,793.6274509803922,35,16,16,33.72265258215963,0.6413690476190477,43.200231481481474,1027.199074074073,29.348544973544943,0
2940,4,0,0,51,0.0,0.0,1.0,51,1400,800,600,0.5714285714285714,20,8,12,369.0649315611984,0.8336274509803923,0.4282176194421432,0.2193872248898616,131892.24222232925,-464.63973015262326,131427.60249217664,2930,12,794.6274509803922,35,16,16,33.72265258215963,0.6413690476190477,43.200231481481474,1027.199074074073,29.348544973544943,0
2941,4,0,0,51,0.0,0.0,1.0,51,1800,1400,400,0.7777777777777778,22,14,8,367.8344185161314,0.8316339869281046,0.42387302933336857,0.21934196118231902,132011.15779588904,-488.35050690157743,131522.80728898747,2931,13,795.6274509803922,35,16,16,33.6342540451252,0.6425595238095239,43.08449074074074,1027.662037037037,29.361772486772484,0
2942,4,0,0,51,0.0,0.0,1.0,51,1550,1000,550,0.6451612903225806,21,10,11,366.08386311178356,0.8317647058823531,0.4201478971426553,0.2198482010363197,132278.91375171463,-514.9648491083751,131763.94890260627,2932,14,796.6274509803922,35,16,17,33.40927842784278,0.6452380952380953,42.82407407407407,1028.7037037037032,29.39153439153438,0
2943,4,0,0,51,0.0,0.0,1.0,51,1400,1000,400,0.7142857142857143,18,10,8,365.22395270904985,0.8310784313725491,0.4207074349253821,0.2198514667255355,132368.22601862554,-531.1906560785471,131837.035362547,2933,15,797.6274509803922,35,16,18,33.34141735087916,0.6461309523809524,42.73726851851851,1029.050925925925,29.401455026455,0
2944,4,1,1,51,0.019230769230769232,0.019230769230769232,0.9807692307692307,52,1350,1000,350,0.7407407407407407,17,10,7,355.6015654589067,0.8342760180995474,0.4132152117545378,0.2155895049444324,132636.34366426605,-966.8583622685277,131669.4853019975,2934,0,783.2692307692307,35,17,15,33.3192883895131,0.648809523809524,42.47685185185185,1030.0925925925922,29.43121693121692,0
2945,4,0,0,51,0.0,0.0,1.0,51,1200,800,400,0.6666666666666666,16,8,8,365.19372496572794,0.8308496732026145,0.42443079671456974,0.2207240060956381,132520.55165816328,-520.8652210884336,131999.68643707485,2935,17,799.6274509803922,34,17,18,33.18880795467684,0.6498161764705883,42.589285714285715,1029.6428571428573,30.28361344537816,0
2946,4,0,0,51,0.0,0.0,1.0,51,1550,1200,350,0.7741935483870968,19,12,7,363.8752248646566,0.8302614379084968,0.4245254376305645,0.2208258201948623,132673.8166099772,-544.6570294784705,132129.15958049873,2936,18,800.6274509803922,34,17,15,33.06852322625375,0.6513480392156863,42.44047619047618,1030.2380952380943,30.301120448179244,0
2947,4,1,1,51,0.019230769230769232,0.019230769230769232,0.9807692307692307,52,950,500,450,0.5263157894736842,14,5,9,354.8664805449654,0.8354229512317747,0.41150998109934567,0.21738315746373013,133024.1036120754,-958.8409047068078,132065.26270736862,2937,0,786.2115384615385,35,17,15,32.94871255469539,0.6526785714285714,42.100694444444436,1031.5972222222208,29.47420634920631,0
2948,4,0,0,51,0.0,0.0,1.0,51,1400,1100,300,0.7857142857142857,17,11,6,364.3418779232546,0.829607843137255,0.42366251510994624,0.22256201315735047,132919.22477324257,-514.3920068027281,132404.83276643985,2938,20,802.6274509803922,34,17,15,32.809734087585625,0.6537990196078431,42.20238095238095,1031.1904761904757,30.32913165266105,0
2949,4,0,0,51,0.0,0.0,1.0,51,750,400,350,0.5333333333333333,11,4,7,366.4021595393938,0.8293790849673204,0.42487281154382384,0.22418843998935786,132980.6122448979,-455.123299319739,132525.48894557817,2939,21,803.6274509803922,34,17,16,32.69491574330563,0.6544117647058822,42.14285714285714,1031.4285714285709,30.336134453781497,0
2950,4,0,0,51,0.0,0.0,1.0,51,1750,1500,250,0.8571428571428571,20,15,5,365.992393534828,0.8273856209150328,0.4245492820411889,0.22449087577964297,133072.72002551024,-459.2793367346886,132613.44068877556,2940,22,804.6274509803922,34,17,16,32.61292834890965,0.6553308823529411,42.05357142857143,1031.7857142857147,30.346638655462197,0
2951,4,0,0,51,0.0,0.0,1.0,51,1000,300,700,0.3,17,3,14,365.6715793302019,0.8259150326797386,0.42417539169318674,0.22466384983795323,133134.14292800456,-463.32553854875107,132670.8173894558,2941,23,805.6274509803922,34,17,16,32.55950321067405,0.6559436274509804,41.99404761904762,1032.0238095238096,30.353641456582636,0
2952,4,0,0,51,0.0,0.0,1.0,51,1250,1000,250,0.8,15,10,5,364.9607967550196,0.8237581699346406,0.4190302886453845,0.22518535467830467,133292.8843557099,-470.66454475308524,132822.2198109568,2942,24,806.6274509803922,35,16,17,32.41845998655011,0.6553571428571429,41.84027777777778,1032.638888888889,29.503968253968253,0
2953,4,0,0,51,0.0,0.0,1.0,51,1400,1000,400,0.7142857142857143,18,10,8,362.3586876660145,0.8231045751633987,0.4171346709907633,0.22393967650495217,133352.65024862808,-535.701731824437,132816.94851680365,2943,25,807.6274509803922,35,16,17,32.425668608994464,0.6559523809523811,41.7824074074074,1032.8703703703688,29.510582010581967,0
2954,4,0,0,51,0.0,0.0,1.0,51,1400,1100,300,0.7857142857142857,17,11,6,360.385997215813,0.8218954248366014,0.41961507016997057,0.22381053131814668,133533.73724489802,-575.2086045323422,132958.52864036566,2944,26,808.6274509803922,34,17,17,32.295026107655694,0.6599264705882353,41.60714285714286,1033.5714285714291,30.39915966386556,0
2955,4,2,2,51,0.03773584905660377,0.03773584905660377,0.9622641509433962,53,1150,700,450,0.6086956521739131,16,7,9,343.6214962525095,0.8286465892597967,0.39898046716275193,0.21609138416864393,133996.38447569197,-1391.192374807229,132605.19210088474,2945,0,779.0754716981132,36,17,16,32.2656080052208,0.6603009259259258,41.15990990990991,1035.3603603603608,28.76001001001002,0
2956,4,0,0,51,0.0,0.0,1.0,51,1000,600,400,0.6,14,6,8,358.1564865744074,0.8220588235294118,0.4189221216286676,0.22335286424062306,133687.58680555568,-623.7847222222046,133063.80208333346,2946,28,810.6274509803922,34,17,17,32.19849583669083,0.6614583333333333,41.45833333333334,1034.1666666666679,30.416666666666703,0
2957,4,0,0,51,0.0,0.0,1.0,51,1550,1400,150,0.9032258064516129,17,14,3,362.93585076559805,0.8218300653594772,0.4220763103860643,0.22690018296065112,133779.93905895707,-489.2928004534994,133290.64625850358,2947,29,811.6274509803922,34,17,16,31.98240314537782,0.6623774509803921,41.36904761904763,1034.5238095238108,30.427170868347375,0
2958,4,0,0,51,0.0,0.0,1.0,51,1200,900,300,0.75,15,9,6,362.93585076559805,0.8216339869281046,0.4220763103860643,0.22690018296065112,133779.93905895707,-489.2928004534994,133290.64625850358,2948,30,812.6274509803922,34,17,16,31.98240314537782,0.6623774509803921,41.36904761904763,1034.5238095238108,30.427170868347375,0
2959,4,0,0,51,0.0,0.0,1.0,51,1850,1200,650,0.6486486486486487,25,12,13,363.46983333178184,0.8206535947712419,0.42111766509731785,0.22837671030731013,133964.73922902482,-461.57171201815936,133503.16751700666,2949,31,813.6274509803922,34,17,16,31.78353074210364,0.6642156862745099,41.19047619047618,1035.2380952380943,30.448179271708653,0
2960,4,0,0,51,0.0,0.0,1.0,51,1300,800,500,0.6153846153846154,18,8,10,363.45462678901333,0.8199346405228759,0.4215149343519684,0.22884085474182267,134040.92084887254,-456.4414276834765,133584.47942118905,2950,32,814.6274509803922,35,16,17,31.707672031593468,0.662797619047619,41.116898148148145,1035.532407407407,29.586640211640198,0
2961,4,0,0,51,0.0,0.0,1.0,51,1250,800,450,0.64,17,8,9,363.4683505890091,0.8199346405228759,0.42106369975093183,0.22959810911236547,134160.800928605,-447.3589945559175,133713.44193404907,2951,33,815.6274509803922,35,16,18,31.58736919524819,0.6639880952380952,41.0011574074074,1035.9953703703693,29.599867724867693,0
2962,4,0,0,51,0.0,0.0,1.0,51,1500,1100,400,0.7333333333333333,19,11,8,367.35189049342256,0.8191176470588236,0.41783689325270656,0.21675151268836337,131609.2511638194,-506.42217689431607,131102.82898692507,2952,34,816.6274509803922,37,14,15,34.052415045949985,0.6345720720720722,43.475877192982445,1026.0964912280683,27.732337600758605,6
2963,4,2,1,52,0.03773584905660377,0.018867924528301886,0.9811320754716981,53,1350,900,450,0.6666666666666666,18,9,9,351.72887063907194,0.8287675374939526,0.40708594113023966,0.20995213349036437,132049.81689453125,-1310.853407118057,130738.96348741319,2953,0,786.7735849056604,39,14,16,34.00909175365697,0.6354166666666667,43.046875,1027.8125,26.354166666666668,0
2964,4,0,0,52,0.0,0.0,1.0,52,1550,1100,450,0.7096774193548387,20,11,9,351.40018576242085,0.8250219959778783,0.4045244053605257,0.2097559366556447,132049.81689453125,-1119.5339626736115,130930.28293185764,2954,1,802.9038461538462,39,13,16,34.017537414276546,0.6354166666666666,43.046875,1027.8125,26.354166666666668,0
2965,4,1,0,53,0.018867924528301886,0.0,1.0,53,1200,900,300,0.75,15,9,6,346.67016341851195,0.8283139816158683,0.4057749598961118,0.20884763503505482,132398.0034722223,-1420.312499999998,130977.6909722223,2955,0,788.7358490566038,40,13,17,33.78879892037787,0.6372395833333333,42.708333333333336,1029.1666666666672,25.72916666666668,0
2966,4,0,0,53,0.0,0.0,1.0,53,1250,900,350,0.72,16,9,7,343.2916020655466,0.8289187227866472,0.4020413865037529,0.207243380746364,132476.45767235116,-1504.3889219379994,130972.06875041316,2956,1,789.7358490566038,40,13,17,33.79689042448173,0.6380208333333333,42.63211382113821,1029.4715447154474,25.736788617886184,0
2967,4,0,0,53,0.0,0.0,1.0,53,1300,700,600,0.5384615384615384,19,7,12,342.8251288662452,0.8281627963231737,0.40342802670628664,0.20753822317386694,132581.09941998826,-1509.5735012228006,131071.52591876546,2957,2,790.7358490566038,40,13,19,33.703785935135855,0.6390624999999999,42.53048780487806,1029.878048780489,25.746951219512226,0
2968,4,1,0,54,0.018518518518518517,0.0,1.0,54,1500,1200,300,0.8,18,12,6,336.35877835264813,0.8287619380386676,0.3998139952536721,0.2054120530080741,132908.99490583257,-1858.9785682791728,131050.0163375534,2958,0,777.074074074074,41,13,15,33.54138605605798,0.6407520325203253,42.21230158730158,1031.1507936507926,25.150019357336404,0
2969,4,0,0,54,0.0,0.0,1.0,54,1300,700,600,0.5384615384615384,19,7,12,335.5554527053505,0.8282523876077336,0.4010066038340703,0.2054832507202731,133011.31129535157,-1873.4658446711974,131137.84545068038,2959,1,778.074074074074,41,13,15,33.45955953067898,0.6417682926829268,42.11309523809524,1031.5476190476197,25.1596980255517,0
2970,4,0,0,54,0.0,0.0,1.0,54,1450,1100,350,0.7586206896551724,18,11,7,334.707172301303,0.8281504775215467,0.4021995748272065,0.20538579935727758,133088.07442247745,-1890.8933886054294,131197.181033872,2960,2,779.074074074074,41,13,16,33.404540428804914,0.6425304878048781,42.03869047619048,1031.8452380952392,25.166957026713153,0
2971,4,1,2,53,0.01818181818181818,0.03636363636363636,0.9636363636363636,55,1250,800,450,0.64,17,8,9,327.8845686252188,0.8309483726150393,0.39885702587898164,0.20246777128665017,133322.0706763416,-2257.1500736133617,131064.92060272823,2961,0,765.8909090909091,42,13,16,33.346429911803334,0.6433531746031745,41.81201550387597,1032.7519379844962,24.58933185677372,0
2972,4,0,0,53,0.0,0.0,1.0,53,1550,1100,450,0.7096774193548387,20,11,9,338.2127311162598,0.8215106434446057,0.4108281063511008,0.20767938778461226,133113.66705246904,-1595.8526234567946,131517.81442901224,2962,4,795.6415094339623,41,12,17,33.288470165993715,0.6427845528455285,42.013888888888886,1031.944444444444,25.169376693766925,0
2973,4,0,0,53,0.0,0.0,1.0,53,1250,800,450,0.64,17,8,9,364.221782883068,0.821329221093372,0.4184613494530047,0.21170525747827773,131034.66932508687,-1038.9494719328638,129995.719853154,2963,5,796.6415094339623,39,14,16,34.713708583443555,0.625267094017094,44.036458333333336,1023.8541666666672,26.252670940170955,8
2974,4,0,1,52,0.0,0.018867924528301886,0.9811320754716981,53,1450,1100,350,0.7586206896551724,18,11,7,364.1439627849192,0.8212385099177552,0.41948169344948494,0.21195377727285625,131088.00048828125,-1053.0192057291674,130034.98128255208,2964,6,797.6415094339623,39,14,16,34.66172057776421,0.6258012820512822,43.984375,1024.0625,26.25801282051282,0
2975,4,0,1,51,0.0,0.019230769230769232,0.9807692307692307,52,1200,800,400,0.6666666666666666,16,8,8,391.4640208900062,0.8196801156359979,0.4509813795715125,0.2217986354561953,130044.55133912269,-218.00795446503525,129826.54338465765,2965,10,813.8653846153846,38,14,17,35.02321846304248,0.6170504385964912,45.00534188034188,1019.9786324786328,26.84154295996402,2
2976,4,0,0,51,0.0,0.0,1.0,51,1300,1000,300,0.7692307692307693,16,10,6,397.8673104974598,0.8176143790849674,0.45283034769893327,0.22604109838152392,130150.67737188366,156.53999307479376,130307.21736495846,2966,11,822.3921568627451,37,14,17,34.75177304964539,0.6199324324324323,44.901315789473685,1020.3947368421054,27.578236130867715,0
2977,4,0,0,51,0.0,0.0,1.0,51,1800,1400,400,0.7777777777777778,22,14,8,396.8047003085374,0.817483660130719,0.4523696793080685,0.22625819401561786,130292.12648158864,140.201823658821,130432.32830524746,2967,12,823.3921568627451,35,16,17,34.63479669727544,0.6252976190476189,44.76273148148148,1020.9490740740739,29.16997354497354,0
2978,4,0,0,51,0.0,0.0,1.0,51,1400,1000,400,0.7142857142857143,18,10,8,397.58836039130415,0.8185947712418301,0.44960506582236315,0.2273958056029331,130410.31867551866,169.92495606138385,130580.24363158004,2968,13,824.3921568627451,35,16,17,34.49445231350331,0.6264880952380951,44.64699074074074,1021.4120370370368,29.183201058201053,0
2979,4,1,2,50,0.019230769230769232,0.038461538461538464,0.9615384615384616,52,1150,900,250,0.782608695652174,14,9,5,389.4860866772518,0.8230580693815988,0.4428500605927066,0.22389899992206574,130607.69120049113,-226.0242928739435,130381.66690761718,2969,0,809.5192307692307,36,16,15,34.500661011347354,0.6264467592592593,44.45382882882883,1022.1846846846854,28.39401901901904,0
2980,4,0,0,50,0.0,0.0,1.0,50,900,800,100,0.8888888888888888,10,8,2,385.4741368481237,0.8183673469387754,0.3983609378360933,0.21774839151967498,129927.00277970132,30.86836813415914,129957.87114783548,2970,15,803.02,37,13,18,35.29567290456729,0.6176801801801803,45.12061403508771,1019.5175438596482,27.554528212422923,3
2981,4,0,0,50,0.0,0.0,1.0,50,1200,900,300,0.75,15,9,6,384.80304060941904,0.8187414965986395,0.39720213769254986,0.21741713537807453,129935.60209155135,-0.07704635111053904,129935.52504520024,2971,16,804.02,38,12,18,35.30401865241538,0.6159539473684212,45.112179487179475,1019.5512820512799,26.830296896086313,0
2982,4,1,0,51,0.0196078431372549,0.0,1.0,51,1350,1100,250,0.8148148148148148,16,11,5,381.7327305534287,0.8230065359477124,0.40717109693248266,0.21799533214711314,130351.21588059395,-246.4912306984868,130104.72464989546,2972,0,789.2352941176471,35,16,20,34.95941006460388,0.6258928571428573,44.7048611111111,1021.1805555555541,29.176587301587258,0
2983,4,0,0,51,0.0,0.0,1.0,51,1450,800,650,0.5517241379310345,21,8,13,376.9165702403505,0.8220261437908497,0.4028901684130446,0.21587039931947336,130463.84222059889,-365.2032099667354,130098.63901063215,2973,1,790.2352941176471,36,15,20,34.967941651969426,0.625,44.59459459459459,1021.6216216216209,28.378378378378358,0
2984,4,1,1,51,0.019230769230769232,0.019230769230769232,0.9807692307692307,52,1650,1300,350,0.7878787878787878,20,13,7,367.0797605100302,0.8282742584213172,0.38885749639100853,0.21142796582804393,130682.6754987111,-805.8069550246285,129876.86854368648,2974,0,776.0192307692307,37,15,15,34.9972073279714,0.6252815315315315,44.38048245614035,1022.4780701754383,27.63454243717401,0
2985,4,2,0,53,0.03773584905660377,0.0,1.0,53,1600,1300,300,0.8125,19,13,6,363.03936680218567,0.8301584421867441,0.38515664426104634,0.21160439204302844,131141.34250217007,-1078.106011284728,130063.23649088533,2975,0,762.3396226415094,39,14,17,34.63602579748466,0.6263354700854702,43.932291666666664,1024.2708333333328,26.263354700854688,0
2986,4,1,1,53,0.018518518518518517,0.018518518518518517,0.9814814814814815,54,1100,700,400,0.6363636363636364,15,7,8,353.7148351839313,0.8338720009317494,0.37171108655441865,0.20763260664186683,131412.43128895407,-1503.0959420807612,129909.33534687331,2976,0,749.2037037037037,37,17,17,34.600911667201366,0.6326013513513514,43.667763157894726,1025.3289473684194,27.711593172119443,0
2987,4,0,0,53,0.0,0.0,1.0,53,1350,700,650,0.5185185185185185,20,7,13,356.7675735747076,0.8289489598451862,0.3791629238108529,0.20971291725313046,131465.0463533677,-1219.5068805245007,130245.53947284321,2977,2,764.3396226415094,38,15,20,34.469519394381365,0.6313048245614035,43.616452991452995,1025.5341880341884,26.98774179037338,0
2988,4,2,1,54,0.03636363636363636,0.01818181818181818,0.9818181818181818,55,1150,800,350,0.6956521739130435,15,8,7,345.7316731453448,0.8367845117845117,0.37066880097842536,0.20570932806511436,131927.7662622283,-1877.678527166359,130050.08773506196,2978,0,737.5090909090909,40,15,14,34.28607346588848,0.6325520833333333,43.16565040650407,1027.3373983739848,25.68343495934962,0
2989,4,1,2,53,0.01818181818181818,0.03636363636363636,0.9636363636363636,55,600,200,400,0.3333333333333333,10,2,8,347.26672942628574,0.8353535353535354,0.3826505937452249,0.2071922380346918,132032.1911250743,-1829.922561801842,130202.26856327248,2979,0,738.4909090909091,40,15,15,34.14149279804873,0.63359375,43.0640243902439,1027.743902439024,25.693597560975597,0
2990,4,0,0,53,0.0,0.0,1.0,53,1650,1100,550,0.6666666666666666,22,11,11,360.43384071556136,0.8266811804547654,0.3947560087399855,0.21370324757046655,131793.94866544305,-1099.4001798889637,130694.54848555409,2980,1,767.2075471698113,38,15,15,34.043457149793625,0.6345942982456141,43.29594017094017,1026.8162393162393,27.021479982006298,0
2991,4,0,0,53,0.0,0.0,1.0,53,1450,1100,350,0.7586206896551724,18,11,7,352.1887702211623,0.8271044992743105,0.34694090911592057,0.2002745096332277,130186.64301658137,-1429.9452593537662,128756.6977572276,2981,2,768.2075471698113,41,12,18,35.88054097404492,0.6135670731707318,44.866071428571416,1020.5357142857122,24.891114982578344,4
2992,4,0,0,53,0.0,0.0,1.0,53,1350,900,450,0.6666666666666666,18,9,9,349.6876301541022,0.8264392839864537,0.34624566807855195,0.19924062648315136,130262.58680555566,-1489.7126558956825,128772.87414965998,2982,3,769.2075471698113,39,14,19,35.867346938775505,0.6175213675213675,44.79166666666667,1020.8333333333343,26.1752136752137,0
2993,4,0,2,51,0.0,0.03773584905660377,0.9622641509433962,53,1550,1000,550,0.6451612903225806,21,10,11,371.7890339667563,0.8264997581035316,0.331081853230764,0.19214204276008462,126365.89055309004,-1142.9456360946763,125222.94491699536,2983,4,770.2075471698113,38,15,15,39.29245032408883,0.5797697368421053,48.63782051282051,1005.4487179487176,26.459176788124147,7
2994,4,0,0,51,0.0,0.0,1.0,51,1400,700,700,0.5,21,7,14,386.2380334299879,0.8222875816993465,0.321524993864027,0.1915207903697664,124653.01890432098,-537.3117786178695,124115.70712570312,2984,5,763.8627450980392,38,13,19,40.70468242929996,0.5622258771929824,50.34722222222222,998.6111111111111,26.279239766081872,5
2995,4,4,2,53,0.07272727272727272,0.03636363636363636,0.9636363636363636,55,850,600,250,0.7058823529411765,11,6,5,370.2588909791276,0.8430695847362514,0.34525186289120713,0.188844417639856,125823.72100069241,-1680.1184552511982,124143.60254544122,2985,0,709.2363636363636,37,18,19,39.89071038251365,0.5760135135135136,49.17763157894736,1003.2894736842097,27.11593172119486,0
2996,4,5,3,55,0.08620689655172414,0.05172413793103448,0.9482758620689655,58,1300,1200,100,0.9230769230769231,14,12,2,353.9991170532761,0.85453216374269,0.35925606200824545,0.1848836385851095,126795.93474915961,-2622.485476806325,124173.44927235329,2986,0,673.4655172413793,38,20,18,39.2971429581698,0.5841557017543861,48.21047008547007,1007.1581196581172,26.504161043634664,0
2997,4,2,1,56,0.03508771929824561,0.017543859649122806,0.9824561403508771,57,950,500,450,0.5263157894736842,14,5,9,364.61054646363385,0.8534617794486216,0.36753706691678767,0.19042568540236426,126795.93474915979,-2153.7729883483253,124642.16176081146,2987,0,686.2280701754386,38,19,19,39.02995827587425,0.584155701754386,48.21047008547008,1007.1581196581187,26.504161043634703,0
2998,4,4,4,56,0.06666666666666667,0.06666666666666667,0.9333333333333333,60,1350,700,650,0.5185185185185185,20,7,13,344.2847999011676,0.8661252354048964,0.36276229790161674,0.1823016235542245,127354.73632812474,-3230.0494537699333,124124.68687435481,2988,0,652.85,39,21,15,38.96843825249397,0.5881410256410258,47.656249999999986,1009.374999999998,25.881410256410202,0
2999,4,5,4,57,0.08196721311475409,0.06557377049180328,0.9344262295081968,61,1850,1300,550,0.7027027027027027,24,13,11,327.2778268583157,0.8688069216757741,0.3630982164816434,0.17051968714747268,126698.43885633671,-3862.1229383680566,122836.31591796865,2989,0,641.9180327868852,39,22,14,40.06994740472497,0.5814636752136753,48.307291666666664,1006.7708333333326,25.81463675213673,3
3000,4,4,4,57,0.06557377049180328,0.06557377049180328,0.9344262295081968,61,1500,1100,400,0.7333333333333333,19,11,8,332.0109635328143,0.8783242258652094,0.34055155833522055,0.17147218259296296,126339.0370461686,-3794.3992403514976,122544.6378058171,2990,0,639.5573770491803,38,23,12,40.319916755224945,0.5794956140350876,48.66452991452992,1005.3418803418814,26.456365272154773,2
3001,4,3,3,57,0.05,0.05,0.95,60,1150,700,450,0.6086956521739131,16,7,9,338.05439394401867,0.8732933145009416,0.3506906077348064,0.1748224151539069,126392.74691358031,-3454.4753086419687,122938.27160493835,2991,0,651.1,38,22,13,40.112799263351754,0.5800438596491228,48.611111111111114,1005.5555555555561,26.46198830409358,0
3002,4,2,0,59,0.03389830508474576,0.0,1.0,59,1700,1200,500,0.7058823529411765,22,12,10,340.2953949549967,0.8685223066432884,0.3599919331503678,0.17730215591590526,126698.43885633674,-3177.02094184028,123521.41791449646,2992,0,641.6779661016949,39,20,16,39.74230470770823,0.5814636752136753,48.307291666666664,1006.7708333333328,25.81463675213674,0
3003,4,6,2,63,0.09230769230769231,0.03076923076923077,0.9692307692307692,65,1650,1000,650,0.6060606060606061,23,10,13,301.98539341110927,0.8877604166666667,0.3622903855359585,0.16267341073641206,128046.43956380295,-5264.53805999915,122781.9015038038,2993,0,583.3538461538461,42,23,15,39.33082016913992,0.5905257936507938,46.97189922480619,1012.1124031007727,24.097914359542205,0
3004,4,1,2,62,0.015625,0.03125,0.96875,64,2000,1500,500,0.75,25,15,10,308.38794899151554,0.8866877480158729,0.3560313786008227,0.16652949245541826,128144.53124999988,-4896.316608827609,123248.21464117228,2994,0,593.453125,40,24,15,39.068930041152235,0.5945312500000001,46.87499999999999,1012.4999999999991,25.31249999999998,0
3005,4,1,1,62,0.015873015873015872,0.015873015873015872,0.9841269841269842,63,2050,1300,750,0.6341463414634146,28,13,15,314.6913148803479,0.8866274108209593,0.362151510040857,0.16972535707563183,128095.4807121715,-4537.892948891321,123557.58776328017,2995,0,603.7936507936508,42,21,17,38.95935037171757,0.5910218253968255,46.92344961240309,1012.3062015503856,24.102528608342514,0
3006,4,2,0,64,0.03125,0.0,1.0,64,2050,1600,450,0.7804878048780488,25,16,9,310.5133520146935,0.8900359623015872,0.36975803492809023,0.16926703845024935,128521.48216057222,-4818.4539747653,123703.02818580692,2996,0,595.265625,41,23,12,38.631555131591824,0.596798780487805,46.502976190476176,1013.9880952380926,24.73141695702665,0
3007,4,2,4,62,0.030303030303030304,0.06060606060606061,0.9393939393939394,66,2100,1700,400,0.8095238095238095,25,17,8,304.6222838904325,0.8946775446775447,0.36534027938291613,0.1665811483991213,128647.25548784353,-5356.854784737937,123290.4007031056,2997,0,578.1969696969697,41,25,16,38.65310646065585,0.5980691056910568,46.37896825396827,1014.4841269841289,24.74351529229583,1
3008,4,1,1,62,0.015873015873015872,0.015873015873015872,0.9841269841269842,63,1100,500,600,0.45454545454545453,17,5,12,320.76845730780565,0.8881635091312511,0.34480270046882366,0.17255181849732784,127990.76880937757,-4388.919707875179,123601.84910150239,2998,0,606.2857142857143,47,16,16,38.91233093134312,0.583554964539007,47.02690972222223,1011.8923611111123,21.529624704491752,2
3009,4,3,5,60,0.046153846153846156,0.07692307692307693,0.9230769230769231,65,1450,1100,350,0.7586206896551724,18,11,7,311.07483363715824,0.8937099358974359,0.3195792930388184,0.16469057823476838,127348.32523630113,-4976.732727261902,122371.59250903923,2999,0,588.4153846153846,40,25,12,39.813020204054254,0.5864583333333333,47.66260162601626,1009.3495934959348,25.233739837398367,7
3010,4,2,3,59,0.03225806451612903,0.04838709677419355,0.9516129032258065,62,2000,1400,600,0.7,26,14,12,331.4289427239951,0.8877467830072272,0.36082118444241185,0.17567451212779625,127396.24361582406,-3955.4395342797884,123440.80408154427,3000,0,617.758064516129,37,25,14,39.25036656891494,0.5920608108108109,47.61513157894736,1009.5394736842102,27.28485064011379,0
3011,4,4,3,60,0.06349206349206349,0.047619047619047616,0.9523809523809523,63,1850,1600,250,0.8648648648648649,21,16,5,324.6574389538262,0.895673323092678,0.358305402059365,0.17355416312887573,127739.20323800117,-4305.703484549662,123433.4997534515,3001,0,608.6507936507936,38,25,15,39.070756711054734,0.5937500000000002,47.275641025641015,1010.8974358974347,26.60256410256407,0
3012,4,2,1,61,0.03225806451612903,0.016129032258064516,0.9838709677419355,62,1550,1100,450,0.7096774193548387,20,11,9,332.7647627098176,0.8878128855984488,0.3679989365473235,0.1781270200387846,127793.20987654309,-3894.9845679012465,123898.22530864183,3002,0,619.4354838709677,38,24,16,38.810668498168496,0.5942982456140352,47.222222222222214,1011.1111111111102,26.6081871345029,0
3013,4,3,2,62,0.046875,0.03125,0.96875,64,2100,1600,500,0.7619047619047619,26,16,10,324.64411674301687,0.8941695601851851,0.3874454008221988,0.17646856178265685,128408.33875868065,-4462.115403163573,123946.22335551708,3003,0,601.03125,39,25,12,38.38857485440219,0.5988247863247864,46.614583333333336,1013.5416666666674,25.98824786324788,0
3014,4,1,0,63,0.015873015873015872,0.0,1.0,63,1200,700,500,0.5833333333333334,17,7,10,331.3045679594529,0.8925797917733402,0.3966128640878239,0.17987543372040146,128360.96871804015,-4094.684943202564,124266.28377483759,3004,0,611.5555555555555,38,25,20,38.26809875241609,0.6000548245614035,46.66132478632479,1013.3547008547018,26.667228969860574,0
3015,4,1,1,63,0.015625,0.015625,0.984375,64,2050,1600,450,0.7804878048780488,25,16,9,328.59034365467613,0.8961433531746031,0.40559609030836974,0.1803274918913686,128788.44024720753,-4336.272432084059,124452.16781512347,3005,0,602.984375,40,24,15,37.90152349486052,0.6010416666666666,46.23983739837399,1015.0406504065055,25.376016260162636,0
3016,4,1,1,63,0.015625,0.015625,0.984375,64,2250,1600,650,0.7111111111111111,29,16,13,328.0951216874577,0.9021164021164021,0.3955314585319356,0.18171688629891392,129152.13647767557,-4325.1628132323785,124826.97366444318,3006,0,588.203125,42,22,15,37.54428821099461,0.6016865079365079,45.88178294573643,1016.4728682170538,24.2017349575489,0
3017,4,1,2,62,0.015625,0.03125,0.96875,64,1250,1000,250,0.8,15,10,5,328.8749851136216,0.8990988756613756,0.3992327844311374,0.18275312220061662,129282.865405161,-4296.382355047197,124986.4830501138,3007,0,589.1875,38,26,17,37.39166404034037,0.609375,45.753205128205124,1016.987179487179,26.7628205128205,0
3018,4,0,0,62,0.0,0.0,1.0,62,2200,1800,400,0.8181818181818182,26,18,8,344.2810403491195,0.8928587167283624,0.4007454093300342,0.19054536162321792,129123.91067031882,-3509.0171400951594,125614.89353022365,3008,1,608.9516129032259,40,22,17,37.161700496617,0.6044270833333333,45.90955284552847,1016.361788617888,25.4090447154472,0
3019,4,1,1,62,0.015873015873015872,0.015873015873015872,0.9841269841269842,63,1600,1000,600,0.625,22,10,12,337.5547566807388,0.8962920293565455,0.3990943995145235,0.1878351162102463,129337.19735051868,-3868.25305074692,125468.94429977176,3009,0,600.2698412698413,38,25,17,37.11576164968666,0.6099232456140351,45.699786324786324,1017.2008547008547,26.768443544759336,0
3020,4,0,1,61,0.0,0.016129032258064516,0.9838709677419355,62,1450,800,650,0.5517241379310345,21,8,13,342.6552170364488,0.8920875198307774,0.40212421236022466,0.19014867058518262,129228.54487407762,-3543.8329817737044,125684.71189230391,3010,3,610.9516129032259,38,24,18,37.09655528703022,0.6088267543859649,45.806623931623925,1016.7735042735035,26.757197480881672,0
3021,4,2,2,61,0.031746031746031744,0.031746031746031744,0.9682539682539683,63,1850,1500,350,0.8108108108108109,22,15,7,324.8906591171762,0.8979561358593617,0.38183644765923286,0.1827287551551697,129756.71315980091,-4168.6511873267855,125588.06197247413,3007,0,554.4444444444445,41,22,15,37.01233365790328,0.6092479674796749,45.28769841269841,1018.8492063492059,24.84998064266356,0
3022,4,1,2,60,0.016129032258064516,0.03225806451612903,0.967741935483871,62,1600,1000,600,0.625,22,10,12,326.5992158970217,0.8945994182971972,0.37559580706311,0.18338957652301657,129692.62390318252,-3928.4981451186613,125764.12575806386,3008,0,564.3709677419355,40,22,15,37.03378063786624,0.6101562500000001,45.350609756097555,1018.5975609756089,25.464939024390222,0
3023,4,2,0,62,0.03225806451612903,0.0,1.0,62,1450,1100,350,0.7586206896551724,18,11,7,335.66964221916294,0.8945333157059757,0.3988762926615639,0.18162025215898317,128223.64501953153,-3735.9899928969935,124487.65502663453,3009,0,565.016129032258,39,23,20,38.2976147622476,0.5969551282051281,46.796875000000014,1012.8125000000022,25.969551282051338,4
3024,4,1,2,61,0.015873015873015872,0.031746031746031744,0.9682539682539683,63,1500,1200,300,0.8,18,12,6,329.9737061953124,0.8967827274278888,0.400690615427457,0.17956834256946258,128453.40617563979,-4122.750698162441,124330.65547747734,3010,0,557.031746031746,40,23,16,38.207602339181285,0.5976562499999998,46.57012195121953,1013.7195121951243,25.342987804878106,0
3025,4,3,3,61,0.046875,0.046875,0.953125,64,2500,1700,800,0.68,33,17,16,326.26726717234135,0.89823082010582,0.40211019929660097,0.17955224445032722,128898.9866780046,-4388.8959750566755,124510.09070294793,3011,0,549.125,41,23,17,37.84803634232124,0.600609756097561,46.13095238095239,1015.4761904761909,24.767711962833925,0
3026,4,0,0,61,0.0,0.0,1.0,61,1950,1400,550,0.717948717948718,25,14,11,340.12554166449144,0.8900728597449908,0.40013141036170685,0.18569217209035138,128582.21379469882,-3453.18097693173,125129.03281776709,3012,1,577.0983606557377,40,21,18,37.8189712758851,0.5989583333333334,46.443089430894304,1014.227642276422,25.35569105691055,0
3027,4,3,2,62,0.046875,0.03125,0.96875,64,1400,1100,300,0.7857142857142857,17,11,6,322.50116075217665,0.8994708994708994,0.40984255416621784,0.17947470115764474,129340.77222077921,-4448.566905278874,124892.20531550034,3013,0,551.0,37,27,21,37.49494718120081,0.6117680180180182,45.69627192982455,1017.2149122806997,27.492294926505394,0
3028,4,1,2,61,0.015873015873015872,0.031746031746031744,0.9682539682539683,63,1950,1500,450,0.7692307692307693,24,15,9,320.0381162647132,0.8997909199522103,0.390505168597709,0.17932294451022782,129609.02829141983,-4304.034146942835,125304.994144477,3014,0,556.2857142857143,38,25,17,37.28556814604972,0.6126644736842106,45.43269230769229,1018.2692307692284,26.79655870445338,0
3029,4,1,1,61,0.016129032258064516,0.016129032258064516,0.9838709677419355,62,1950,1500,450,0.7692307692307693,24,15,9,326.19568971441953,0.8957782478406486,0.3932096513627603,0.18256341042787128,129563.941849896,-3947.360125230855,125616.58172466514,3015,0,566.2258064516129,37,25,18,37.17454227248249,0.6140202702702704,45.47697368421052,1018.0921052631569,27.516002844950187,0
3030,4,1,1,61,0.016129032258064516,0.016129032258064516,0.9838709677419355,62,1950,1200,750,0.6153846153846154,27,12,15,327.01384940818093,0.8962189317821259,0.3980331092181921,0.18355576461040135,129678.3908420138,-3918.674045138902,125759.7167968749,3016,0,567.2096774193549,39,23,18,37.03765255335105,0.6116452991452992,45.36458333333333,1018.541666666666,26.116452991452974,0
3031,4,2,1,62,0.031746031746031744,0.015873015873015872,0.9841269841269842,63,1300,900,400,0.6923076923076923,17,9,8,318.1114594230638,0.8998122546509644,0.3997516897604456,0.17995969683047153,129984.23450688118,-4330.10509180527,125654.12941507592,3017,0,559.1746031746031,41,22,19,36.954693225670454,0.6115345528455285,45.06448412698411,1019.7420634920612,24.871757646147834,0
3032,4,1,0,63,0.015873015873015872,0.0,1.0,63,1850,1300,550,0.7027027027027027,24,13,11,321.4770025572408,0.8992148830858508,0.40778472627299944,0.18270233750298426,130163.68762581855,-4231.073572050977,125932.61405376757,3018,0,560.1587301587301,42,21,20,36.68731997594406,0.6118551587301588,44.88856589147286,1020.4457364341068,24.296327057954926,0
3033,4,0,2,61,0.0,0.031746031746031744,0.9682539682539683,63,1650,1300,350,0.7878787878787878,20,13,7,321.0339404424602,0.8987241850145077,0.4032669576830321,0.18304297940740705,130289.8540799178,-4234.356717653905,126055.4973622639,3019,1,561.1587301587301,38,25,20,36.57104611413424,0.6195175438596492,44.764957264957246,1020.9401709401678,26.86684660368863,0
3034,4,2,1,62,0.031746031746031744,0.015873015873015872,0.9841269841269842,63,1800,1600,200,0.8888888888888888,20,16,4,323.1640641910521,0.9019030551288616,0.4096697422556148,0.18552151163127034,130555.17713758674,-4161.8516710069525,126393.32546657979,3020,0,561.3809523809524,39,24,16,36.24853480786871,0.6204594017094018,44.50520833333333,1021.9791666666661,26.204594017094003,0
3035,4,2,1,63,0.03125,0.015625,0.984375,64,1850,1300,550,0.7027027027027027,24,13,11,320.43457591503403,0.9018477182539683,0.4203142066329053,0.18578564271964976,130937.79047070231,-4408.6009278537595,126529.18954284856,3021,0,553.578125,40,24,18,35.9321732366862,0.6226562499999999,44.131097560975626,1023.4756097561004,25.58689024390251,0
3036,4,0,0,63,0.0,0.0,1.0,63,2000,1500,500,0.75,25,15,10,329.62726084419177,0.8983828298344427,0.4337332273840202,0.19146434512864788,131008.00781250028,-3963.237847222197,127044.76996527807,3022,1,563.3650793650794,39,24,20,35.62610229276896,0.6249999999999998,44.062500000000014,1023.7500000000022,26.250000000000057,0
3037,4,0,1,62,0.0,0.015873015873015872,0.9841269841269842,63,1650,1000,650,0.6060606060606061,23,10,13,327.06896242936756,0.8978707970643455,0.43134444476726297,0.19077082897570627,131168.0175781253,-4019.8025173610804,127148.21506076421,3023,2,564.3650793650794,39,24,20,35.53021829028541,0.6266025641025641,43.906250000000014,1024.3750000000023,26.2660256410257,0
3038,4,0,0,62,0.0,0.0,1.0,62,1400,900,500,0.6428571428571429,19,9,10,331.5792481811899,0.8936188965274106,0.42618603743362304,0.19310563019835278,131109.19922017682,-3705.3820585871795,127403.81716158964,3024,3,574.3709677419355,38,24,20,35.474042005702756,0.6277412280701754,43.96367521367522,1024.1452991452995,26.95119208277104,0
3039,4,2,1,63,0.03125,0.015625,0.984375,64,1550,1000,550,0.6451612903225806,21,10,11,317.5268333692721,0.8969494047619048,0.42791140416047546,0.18712395696805634,131562.6045694529,-4445.06855624957,127117.53601320334,3025,0,557.390625,40,24,15,35.377455836222545,0.62890625,43.52134146341464,1025.914634146343,25.647865853658573,0
3040,4,2,3,62,0.03076923076923077,0.046153846153846156,0.9538461538461538,65,1750,1300,450,0.7428571428571429,22,13,9,310.1196313893963,0.8979366987179487,0.42001738962419033,0.18395692289464993,131811.58002842346,-4824.528277746283,126987.05175067717,3026,0,549.7846153846153,41,24,16,35.31734051460406,0.6298272357723577,43.27876984126984,1026.884920634921,25.045973674022463,0
3041,4,0,0,62,0.0,0.0,1.0,62,2250,1900,350,0.8444444444444444,26,19,7,330.0915121319183,0.8929688877137317,0.42448932289304775,0.19458985825677166,131574.6348002958,-3713.6659681130946,127860.96883218271,3027,2,576.7903225806451,38,24,17,35.04308549411642,0.6324013157894738,43.50961538461538,1025.9615384615379,26.998987854251,0
3042,4,0,0,62,0.0,0.0,1.0,62,1300,1000,300,0.7692307692307693,16,10,6,330.55518195009574,0.8923739643927375,0.42752679218930467,0.19556491306505647,131711.68456424854,-3692.404028782251,128019.28053546629,3028,3,577.7903225806451,38,24,17,34.89323133499859,0.6337719298245614,43.37606837606837,1026.4957264957254,27.013045434098036,0
3043,4,0,0,62,0.0,0.0,1.0,62,1900,1400,500,0.7368421052631579,24,14,10,331.9434520310055,0.8917570068746695,0.4228712160357544,0.19723759875315736,131876.23844875436,-3644.909233691294,128231.32921506307,3029,4,578.7903225806451,38,24,17,34.692028985507235,0.6354166666666667,43.21581196581196,1027.1367521367513,27.029914529914507,0
3044,4,0,1,61,0.0,0.016129032258064516,0.9838709677419355,62,1050,900,150,0.8571428571428571,12,9,3,331.48817582752855,0.8920434514366297,0.4223431871692185,0.19753737763997337,131985.99810979617,-3649.6404503616036,128336.35765943456,3030,5,579.7903225806451,38,24,17,34.59334061135371,0.6365131578947368,43.10897435897436,1027.5641025641025,27.04116059379217,0
3045,4,1,2,60,0.016129032258064516,0.03225806451612903,0.967741935483871,62,1500,1200,300,0.8,18,12,6,355.6123897283608,0.8903137669663318,0.43297784142297324,0.20026592474176091,129807.25623582755,-3167.7862811791492,126639.4699546484,3031,0,580.6290322580645,41,21,18,36.17844626168224,0.6097560975609757,45.238095238095234,1019.0476190476181,24.854819976771175,7
3046,4,0,1,59,0.0,0.016666666666666666,0.9833333333333333,60,1600,900,700,0.5625,23,9,14,362.10436516240554,0.8921374764595104,0.4284955028618147,0.20408001778507934,129837.58680555562,-2597.0486111111068,127240.53819444451,3032,1,592.9666666666667,39,21,19,35.98221586263286,0.6132478632478633,45.208333333333336,1019.1666666666672,26.132478632478644,0
3047,4,0,0,59,0.0,0.0,1.0,59,2200,1600,600,0.7272727272727273,28,16,12,371.4417209774988,0.8907802454704851,0.43316513834792336,0.2098678711242319,129935.60209155177,-2147.2992685732925,127788.30282297848,3033,2,603.2033898305085,38,21,19,35.644582416430914,0.615953947368421,45.112179487179496,1019.5512820512834,26.830296896086406,0
3048,4,0,2,57,0.0,0.03389830508474576,0.9661016949152542,59,1800,1100,700,0.6111111111111112,25,11,14,371.1658896666392,0.889586986167933,0.4316708441913466,0.21044488803664352,130071.79578493707,-2144.3572393892655,127927.4385455478,3034,3,604.2033898305085,38,21,19,35.51310920262533,0.6173245614035086,44.97863247863249,1020.0854700854723,26.844354475933482,0
3049,4,1,0,58,0.017241379310344827,0.0,1.0,58,2200,1400,800,0.6363636363636364,30,14,16,372.6013948622073,0.8895820729985884,0.4311903928935399,0.21276759751955293,130348.82010388788,-1886.0899124109205,128462.73019147695,3035,0,610.3965517241379,36,22,20,35.19496213792089,0.6238425925925926,44.70720720720722,1021.1711711711728,28.36586586586591,0
3050,4,2,3,57,0.03333333333333333,0.05,0.95,60,1300,900,400,0.6923076923076923,17,9,8,361.8652250680009,0.895668549905838,0.42871540469973923,0.20910437718926436,130808.47447083435,-2532.9923889619295,128275.48208187243,3036,0,591.0166666666667,38,22,17,35.003046127067016,0.6247258771929824,44.25747863247864,1022.9700854700862,26.920265407107532,0
3051,4,0,1,56,0.0,0.017543859649122806,0.9824561403508771,57,1450,1100,350,0.7586206896551724,18,11,7,385.69839466023615,0.8854166666666666,0.44151848008873285,0.22076355585416624,130439.87509645055,-1337.9099151234673,129101.96518132708,3037,6,623.1052631578947,35,22,19,34.768014955812376,0.6267857142857143,44.61805555555555,1021.5277777777771,29.18650793650792,0
3052,4,0,0,56,0.0,0.0,1.0,56,1650,1000,650,0.6060606060606061,23,10,13,391.76828655922196,0.8863501082251082,0.4480146142517276,0.22440873883570756,130469.43486636235,-977.2426108110355,129492.19225555132,3038,7,629.1785714285714,35,21,19,34.58293210226199,0.6270833333333332,44.589120370370374,1021.6435185185189,29.189814814814827,0
3053,4,2,2,56,0.034482758620689655,0.034482758620689655,0.9655172413793104,58,1650,1200,450,0.7272727272727273,21,12,9,376.89141154890416,0.8925060496067756,0.4403811057830844,0.21850338108058825,130935.05333371808,-1730.3405855647893,129204.7127481533,3039,0,608.448275862069,37,21,19,34.49039354331833,0.6278153153153152,44.13377192982456,1023.4649122807018,27.661213845424374,0
3054,4,1,1,56,0.017543859649122806,0.017543859649122806,0.9824561403508771,57,1950,1500,450,0.7692307692307693,24,15,9,375.94598944426775,0.8884711779448621,0.4406919816949979,0.21811409642400478,130963.11034404808,-1552.9887802016124,129410.12156384646,3040,0,620.1052631578947,37,20,19,34.48614086770219,0.6280968468468469,44.1063596491228,1023.574561403508,27.664177335229947,0
3055,4,0,1,55,0.0,0.017857142857142856,0.9821428571428571,56,1550,1300,250,0.8387096774193549,18,13,5,386.98172825997466,0.8864989177489178,0.4436072646684377,0.22445928067357462,130953.25213304537,-1064.6968336579605,129888.55529938742,3041,10,632.1785714285714,36,20,19,34.213747386951255,0.6299189814814814,44.115990990991,1023.5360360360374,28.431556556556597,0
3056,4,0,1,54,0.0,0.01818181818181818,0.9818181818181818,55,1900,1500,400,0.7894736842105263,23,15,8,393.48044456941994,0.8846801346801347,0.44561280907652145,0.2286943503719507,131031.70680084024,-688.3171510630941,130343.38964977715,3042,11,643.6545454545454,35,20,19,33.967800889290835,0.6327380952380952,44.039351851851855,1023.842592592593,29.252645502645514,0
3057,4,1,0,55,0.01818181818181818,0.0,1.0,55,1400,800,600,0.5714285714285714,20,8,12,389.80103585731825,0.8890291806958474,0.4402858258657636,0.22885864497880565,131419.65880102027,-753.8263775160437,130665.83242350422,3043,0,639.3090909090909,34,21,20,33.66858237547892,0.6387867647058825,43.66071428571428,1025.3571428571418,30.157563025210052,0
3058,4,0,0,55,0.0,0.0,1.0,55,750,600,150,0.8,9,6,3,388.8633822757151,0.8893097643097643,0.43570938637682755,0.22867290363858578,131480.69905045335,-774.3941326530794,130706.30491780027,3044,1,640.3090909090909,34,21,20,33.63077964790096,0.6393995098039216,43.60119047619047,1025.5952380952367,30.16456582633049,0
3059,4,0,0,55,0.0,0.0,1.0,55,1100,400,700,0.36363636363636365,18,4,14,390.20135521751024,0.8880751964085297,0.4425520571680497,0.2305073562101037,131654.57182623856,-725.6415305641598,130928.9302956744,3045,2,641.3090909090909,35,20,18,33.42038363219427,0.6389880952380953,43.43171296296295,1026.2731481481458,29.32208994708988,0
3060,4,0,1,54,0.0,0.01818181818181818,0.9818181818181818,55,1650,1100,550,0.6666666666666666,22,11,11,388.9208785229735,0.8883838383838384,0.44257526214905885,0.23010935767980312,131713.9693313827,-754.7374667781423,130959.23186460455,3046,3,642.3090909090909,35,20,18,33.39311553350622,0.6395833333333334,43.37384259259258,1026.5046296296282,29.328703703703663,0
3061,4,0,1,53,0.0,0.018518518518518517,0.9814814814814815,54,1200,600,600,0.5,18,6,12,402.39518758629674,0.8841864663405544,0.4514538906509198,0.23719847651290726,131572.2859977324,-211.18905895692126,131361.09693877547,3047,16,655.1481481481482,34,20,18,33.19094724220623,0.6403186274509804,43.51190476190476,1025.9523809523807,30.1750700280112,0
3062,4,0,0,53,0.0,0.0,1.0,53,1300,900,400,0.6923076923076923,17,9,8,401.0557086708434,0.8856736816642476,0.4483600295091803,0.23659816242532472,131602.82206632636,-43.98738662133496,131558.83467970503,3048,17,664.6603773584906,34,19,18,33.1943477588274,0.640625,43.48214285714285,1026.071428571427,30.178571428571384,0
3063,4,0,0,53,0.0,0.0,1.0,53,1200,1000,200,0.8333333333333334,14,10,4,401.5379821614979,0.884978229317852,0.4496268207667522,0.23764324091822875,131725.00177154184,-21.48171768708289,131703.52005385477,3049,18,665.6603773584906,34,19,19,33.058148749468465,0.6418504901960784,43.363095238095234,1026.5476190476181,30.1925770308123,0
3064,4,0,0,53,0.0,0.0,1.0,53,1100,800,300,0.7272727272727273,14,8,6,403.9376154212491,0.8847363328495403,0.4560499411607726,0.23964001861235856,131816.6737528344,49.14257369613517,131865.81632653053,3050,19,666.6603773584906,34,19,19,32.903673004096134,0.6427696078431373,43.27380952380952,1026.9047619047615,30.203081232492984,0
3065,4,0,0,53,0.0,0.0,1.0,53,1550,1000,550,0.6451612903225806,21,10,11,405.25967617813274,0.8841315916787614,0.45420335551245583,0.24100522024404586,131908.37762188198,91.4292800453365,131999.8069019273,3051,20,667.6603773584906,34,19,19,32.776828137675274,0.6436887254901962,43.1845238095238,1027.261904761904,30.213585434173645,0
3066,4,0,0,53,0.0,0.0,1.0,53,2300,2000,300,0.8695652173913043,26,20,6,400.7478247738938,0.8836780358006773,0.4409320094678386,0.23909163588617982,132030.69905045335,-17.796910430855405,132012.9021400225,3052,21,668.6603773584906,34,19,19,32.76888103787792,0.6449142156862746,43.06547619047618,1027.738095238094,30.22759103641453,0
3067,4,0,0,53,0.0,0.0,1.0,53,1400,800,600,0.5714285714285714,20,8,12,400.58296388337965,0.8837385099177552,0.43975769336672443,0.23918625934779372,132061.288265306,-19.69954648527687,132041.58871882074,3053,22,669.6603773584906,34,19,20,32.74216276735387,0.6452205882352942,43.03571428571428,1027.857142857142,30.231092436974762,0
3068,4,0,0,53,0.0,0.0,1.0,53,1200,700,500,0.5833333333333334,17,7,10,401.6730044567424,0.8826197387518142,0.43822431356100733,0.24041924736610387,132153.07716836716,16.46471088433543,132169.5418792515,3054,23,670.6603773584906,34,19,20,32.621280537223576,0.646139705882353,42.94642857142856,1028.2142857142842,30.241596638655416,0
3069,4,0,0,53,0.0,0.0,1.0,53,1350,1100,250,0.8148148148148148,16,11,5,400.9642436788612,0.8825895016932752,0.4317988818522569,0.24116450647991616,132336.75063775506,12.46102607709065,132349.21166383216,3055,24,671.6603773584906,34,19,20,32.453767981796446,0.6479779411764706,42.76785714285714,1028.9285714285709,30.26260504201679,0
3070,4,0,0,53,0.0,0.0,1.0,53,1750,1400,350,0.8,21,14,7,400.989817125258,0.8819847605224963,0.4335595385783324,0.24178025068085082,132430.49178655236,20.68408133072228,132451.17586788308,3056,25,672.6603773584906,32,21,20,32.358368089630346,0.6536458333333334,42.676767676767675,1029.292929292929,32.165404040404034,0
3071,4,0,1,52,0.0,0.018867924528301886,0.9811320754716981,53,1600,1100,500,0.6875,21,11,10,403.6177114961109,0.8805938558297048,0.43391368913376915,0.24441794154964946,132592.9931416438,103.3760904499639,132696.36923209374,3057,26,673.6603773584906,32,21,20,32.12654775039843,0.6552734375,42.5189393939394,1029.924242424243,32.18513257575759,0
3072,4,0,0,52,0.0,0.0,1.0,52,1100,700,400,0.6363636363636364,15,7,8,411.86125182377873,0.882525766716943,0.4431444472552495,0.24856298144418296,132465.01498752178,511.44137912327346,132976.45636664506,3058,27,674.4615384615385,31,21,20,32.043700986592455,0.6565860215053763,42.64322916666667,1029.427083333334,33.20732526881722,0
3073,4,0,0,52,0.0,0.0,1.0,52,1500,1000,500,0.6666666666666666,20,10,10,407.5457722555277,0.882588612368024,0.4304396412708289,0.24679664916765717,132592.99314164382,407.54275711663087,133000.53589876046,3059,28,675.4615384615385,32,20,21,32.02540762535246,0.6552734375,42.5189393939394,1029.9242424242432,32.1851325757576,0
3074,4,0,1,51,0.0,0.019230769230769232,0.9807692307692307,52,1150,900,250,0.782608695652174,14,9,5,409.83032398982954,0.8826671694318752,0.4351471239876683,0.24861008278312413,132658.02158261914,473.4559930109235,133131.47757563007,3060,29,676.4615384615385,32,20,18,31.90086611921395,0.6559244791666666,42.45580808080808,1030.176767676768,32.193023989899,0
3075,4,0,0,51,0.0,0.0,1.0,51,1350,1200,150,0.8888888888888888,15,12,3,410.62932525951555,0.8804575163398694,0.4348760092272206,0.24931066176470595,132690.54178145094,697.3255280073561,133387.8673094583,3061,30,686.4117647058823,32,19,18,31.847426470588243,0.65625,42.42424242424243,1030.303030303031,32.19696969696972,0
3076,4,0,0,51,0.0,0.0,1.0,51,1450,1100,350,0.7586206896551724,18,11,7,408.5991819298025,0.8801960784313726,0.43147825167802956,0.24850868278025723,132755.59413580265,648.7654320987889,133404.35956790144,3062,31,687.4117647058823,32,19,19,31.83400718778078,0.6569010416666665,42.36111111111112,1030.555555555557,32.20486111111116,0
3077,4,0,0,51,0.0,0.0,1.0,51,1050,700,350,0.6666666666666666,14,7,7,409.6482197200159,0.8789869281045752,0.43166068778723843,0.2500140031564763,132885.74667125815,687.2819100091971,133573.02858126734,3063,32,688.4117647058823,32,19,20,31.675544942444283,0.658203125,42.23484848484849,1031.060606060607,32.220643939393966,0
3078,4,0,0,51,0.0,0.0,1.0,51,1200,800,400,0.6666666666666666,16,8,8,410.89030143694043,0.8784640522875817,0.43228443011031303,0.2518668156820139,133048.52701573842,733.6698742475519,133782.19688998596,3064,33,689.4117647058823,32,19,20,31.4792151103496,0.6598307291666665,42.077020202020215,1031.691919191921,32.24037247474753,0
3079,4,0,0,51,0.0,0.0,1.0,51,800,500,300,0.625,11,5,6,413.8581901244271,0.8773529411764707,0.43554218457234795,0.25412945063012365,133113.6670524693,818.0362654321216,133931.7033179014,3065,34,690.4117647058823,32,19,20,31.336922386720502,0.6604817708333333,42.0138888888889,1031.944444444446,32.248263888888935,0
3080,4,0,1,50,0.0,0.0196078431372549,0.9803921568627451,51,1300,1000,300,0.7692307692307693,16,10,6,417.1911701256501,0.8769607843137256,0.4417524873450862,0.25712038100282414,133250.7047319542,918.2034854383107,134168.9082173925,3066,35,691.4117647058823,33,18,21,31.112636003956474,0.6594065656565655,41.8811274509804,1032.4754901960796,31.287136066547866,0
3081,4,0,0,50,0.0,0.0,1.0,50,1450,1200,250,0.8275862068965517,17,12,5,415.9432387229904,0.8760204081632653,0.4313444879553814,0.2567878148511828,133313.9766706317,1090.2094446847655,134404.18611531646,3067,36,659.18,33,17,21,31.081024287013985,0.6600378787878787,41.819852941176485,1032.7205882352957,31.294563279857446,0
3082,4,0,1,49,0.0,0.02,0.98,50,1200,700,500,0.5833333333333334,17,7,10,413.8746648571571,0.8739115646258503,0.43433246383685087,0.25704115783543935,133535.54672481754,1053.3959294502324,134588.94265426777,3068,37,660.18,33,17,21,30.911093984665246,0.6622474747474746,41.605392156862756,1033.5784313725503,31.32055852644092,0
3083,4,1,1,49,0.02,0.02,0.98,50,1150,700,450,0.6086956521739131,16,7,9,406.46364197878165,0.875765306122449,0.427648382893022,0.2539570393740119,133757.3007527155,873.4959210400132,134630.7966737555,3069,0,658.82,33,17,18,30.879412984243576,0.6644570707070705,41.39093137254903,1034.4362745098056,31.34655377302441,0
3084,4,0,0,49,0.0,0.0,1.0,49,750,500,250,0.6666666666666666,10,5,5,406.886337640449,0.875,0.4177619893428064,0.25509689097057137,133884.09994052784,1095.1222186178643,134979.22215914572,3070,1,668.1836734693877,33,16,20,30.7409463193211,0.6657196969696968,41.26838235294119,1034.9264705882367,31.361408199643538,0
3085,4,0,0,49,0.0,0.0,1.0,49,1150,700,450,0.6086956521739131,16,7,9,403.9601855084008,0.8749645691609977,0.4114007388204479,0.2536990101850904,133947.52206182736,1021.893172097292,134969.41523392466,3071,2,669.1836734693877,33,16,20,30.752905370743076,0.66635101010101,41.207107843137265,1035.1715686274522,31.368835412953096,0
3086,4,0,0,49,0.0,0.0,1.0,49,1100,600,500,0.5454545454545454,16,6,10,407.81105288333987,0.8736890589569162,0.41217314226621315,0.25774724714914365,134180.50063775518,1144.0582482993282,135324.5588860545,3072,3,670.1836734693877,34,15,20,30.419108353441338,0.666360294117647,40.98214285714286,1036.0714285714294,30.472689075630274,0
3087,4,0,0,49,0.0,0.0,1.0,49,1950,1400,550,0.717948717948718,25,14,11,407.6353835686155,0.871421485260771,0.41450194010840846,0.25876613257435105,134340.72151759703,1152.4063089420606,135493.1278265391,3073,4,671.1836734693877,35,14,20,30.262760038703426,0.6657738095238095,40.827546296296305,1036.6898148148161,29.619708994709033,0
3088,4,0,0,49,0.0,0.0,1.0,49,1250,900,350,0.72,16,9,7,444.0134558359386,0.871421485260771,0.42228673078426704,0.25752780438484457,130951.55709342573,1862.1361923321124,132813.69328575785,3074,5,672.1836734693877,33,16,18,32.75612627713922,0.6363636363636362,44.117647058823536,1023.5294117647069,31.016042780748695,7
3089,4,1,0,50,0.02,0.0,1.0,50,1450,900,550,0.6206896551724138,20,9,11,429.3764007915337,0.8745918367346939,0.4137799921332108,0.2517182020627998,131362.56946251006,1282.9600846658575,132645.52954717592,3075,0,659.72,30,20,19,32.71218478213365,0.648263888888889,43.71639784946236,1025.13440860215,34.171146953405,0
3090,4,0,0,50,0.0,0.0,1.0,50,950,900,50,0.9473684210526315,10,9,1,430.731514184871,0.8738945578231292,0.411073876618431,0.25361007987656303,131528.3966064453,1330.685085720487,132859.0816921658,3076,1,660.72,31,19,19,32.50877972412626,0.6471774193548387,43.5546875,1025.78125,33.08971774193548,0
3091,4,0,1,49,0.0,0.02,0.98,50,1450,1100,350,0.7586206896551724,18,11,7,428.01869915275176,0.8724489795918368,0.41209742895805124,0.25304465493910694,131684.26890432098,1272.6658950617302,132956.93479938273,3077,2,661.72,32,18,16,32.419936851601264,0.6461588541666666,43.40277777777778,1026.388888888889,32.07465277777778,0
3092,4,0,0,49,0.0,0.0,1.0,49,2000,1500,500,0.75,25,15,10,412.1962043490744,0.8691184807256236,0.35849738125338626,0.24514826890234442,131911.15702479347,1086.7119745434243,132997.8689993369,3078,3,639.0612244897959,32,17,15,32.59587020648968,0.6484375,43.18181818181819,1027.272727272728,32.10227272727275,2
3093,4,0,1,48,0.0,0.02040816326530612,0.9795918367346939,49,1250,1000,250,0.8,15,10,5,412.68481968576174,0.8675949546485261,0.36012724706637367,0.24649061753938287,132073.33953486904,1100.9324622487732,133174.27199711782,3079,4,640.0612244897959,32,17,15,32.41898005977973,0.6500651041666665,43.02398989898991,1027.9040404040416,32.1220012626263,0
3094,4,0,0,48,0.0,0.0,1.0,48,1550,1100,450,0.7096774193548387,20,11,9,421.22910444600484,0.8647495567375886,0.3764816975801497,0.25159399407886474,132073.33953486898,1526.6269066932032,133599.9664415622,3080,5,654.1875,32,16,16,32.1994124390943,0.6500651041666666,43.0239898989899,1027.904040404041,32.122001262626284,0
3095,4,0,0,48,0.0,0.0,1.0,48,850,700,150,0.8235294117647058,10,7,3,422.3897723941993,0.8643062943262411,0.3772662734818697,0.2534036711725888,132240.39619677534,1571.3981701749435,133811.7943669503,3081,6,655.1875,33,15,17,32.00025318717979,0.6493055555555556,42.86151960784314,1028.553921568628,31.16830065359479,0
3096,4,0,0,48,0.0,0.0,1.0,48,1050,600,450,0.5714285714285714,15,6,9,405.9987582986687,0.8645833333333333,0.346388410962271,0.24166875612847613,131943.58555568312,1113.8802443550999,133057.46580003822,3082,7,656.1875,32,16,18,32.7221846708451,0.6487630208333334,43.150252525252526,1027.3989898989903,32.10621843434345,1
3097,4,0,0,48,0.0,0.0,1.0,48,1450,1000,450,0.6896551724137931,19,10,9,399.46022760220876,0.8635859929078014,0.34280122397075274,0.23865187956747336,132082.882785467,952.3716839676939,133035.2544694347,3083,8,657.1875,33,15,18,32.74916547448738,0.6477272727272728,43.014705882352935,1027.9411764705872,31.149732620320822,0
3098,4,0,0,48,0.0,0.0,1.0,48,1000,300,700,0.3,17,3,14,399.46022760220876,0.8641216016548463,0.34280122397075274,0.23865187956747336,132082.882785467,952.3716839676939,133035.2544694347,3084,9,658.1875,33,15,18,32.74916547448738,0.6477272727272728,43.014705882352935,1027.9411764705872,31.149732620320822,0
3099,4,1,1,48,0.02040816326530612,0.02040816326530612,0.9795918367346939,49,1350,1100,250,0.8148148148148148,16,11,5,393.16780045351464,0.866390306122449,0.34064139941690974,0.23725643130815544,132461.0726643599,616.2611735870853,133077.333837947,3085,0,645.734693877551,33,16,19,32.52876984126983,0.6515151515151515,42.64705882352941,1029.4117647058827,31.19429590017826,0
3100,4,0,0,48,0.0,0.0,1.0,48,1500,1000,500,0.6666666666666666,20,10,10,395.09200764143446,0.8650820035460993,0.33574128079990473,0.2386173944065917,132492.61289227704,869.354485053827,133361.96737733088,3086,1,654.3541666666666,33,15,19,32.447402094988696,0.6518308080808082,42.61642156862745,1029.5343137254904,31.198009506833042,0
3101,4,1,3,46,0.02040816326530612,0.061224489795918366,0.9387755102040817,49,950,500,450,0.5263157894736842,14,5,9,386.08498775681585,0.8705711451247166,0.3305627276907299,0.23449582940598168,132704.4802295917,447.04152494329355,133151.52175453497,3087,0,641.9795918367347,34,15,15,32.46557866358559,0.651654411764706,42.41071428571428,1030.3571428571418,30.304621848739462,0
3102,4,0,0,46,0.0,0.0,1.0,46,650,300,350,0.46153846153846156,10,3,7,401.08972911627757,0.8612520128824477,0.32296765524522475,0.2422581963862317,132495.48037190078,1428.5152662993492,133923.9956382001,3088,3,612.7173913043479,32,14,20,32.29013367672307,0.654296875,42.61363636363636,1029.5454545454543,32.173295454545446,0
3103,4,0,0,46,0.0,0.0,1.0,46,1400,1000,400,0.7142857142857143,18,10,8,403.61771149611127,0.8616545893719807,0.3267105873322993,0.24441794154964938,132592.99314164364,1503.3760904499472,134096.3692320936,3089,4,613.7173913043479,32,14,20,32.12654775039844,0.6552734375,42.51893939393939,1029.9242424242418,32.18513257575756,0
3104,4,0,1,45,0.0,0.021739130434782608,0.9782608695652174,46,1150,800,350,0.6956521739130435,15,8,7,398.85380622837397,0.862037037037037,0.3207800511508949,0.24216123949579824,132690.5417814507,1384.8255280073267,134075.36730945803,3090,5,614.7173913043479,32,14,15,32.15073529411764,0.65625,42.424242424242415,1030.3030303030291,32.19696969696966,0
3105,4,0,0,45,0.0,0.0,1.0,45,1100,700,400,0.6363636363636364,15,7,8,398.6640265225985,0.8613636363636364,0.3138994404280524,0.24225592855181857,132723.06596584522,1582.3823780736525,134305.44834391886,3091,6,622.2,32,13,16,32.12279949352612,0.6565755208333335,42.39267676767676,1030.4292929292922,32.20091540404038,0
3106,4,0,0,45,0.0,0.0,1.0,45,850,600,250,0.7058823529411765,11,6,5,399.2346675191973,0.8617003367003367,0.3123361509249052,0.24302405599994079,132788.12629132217,1602.7246900826278,134390.8509814048,3092,7,623.2,32,13,16,32.042447629547965,0.6572265625,42.329545454545446,1030.681818181817,32.208806818181785,0
3107,4,0,1,44,0.0,0.022222222222222223,0.9777777777777777,45,1450,1100,350,0.7586206896551724,18,11,7,402.871223762892,0.8598905723905724,0.3216875899304319,0.2466157883936189,132997.7671598663,1716.1946426854884,134713.96180255178,3093,8,624.2,33,12,16,31.737233178884,0.6568813131313131,42.12622549019607,1031.4950980392148,31.25742721330954,0
3108,4,0,0,44,0.0,0.0,1.0,44,1150,700,450,0.6086956521739131,16,7,9,413.89424403221665,0.8557522903453136,0.33270990581791415,0.2526054108196625,132885.74667125815,2200.129132231419,135085.87580348956,3094,19,639.2045454545455,32,12,16,31.566097232427133,0.658203125,42.23484848484849,1031.060606060607,32.220643939393966,0
3109,4,0,0,44,0.0,0.0,1.0,44,1300,800,500,0.6153846153846154,18,8,10,412.4479802296212,0.8553558844256519,0.3325793743531533,0.2523810899247774,132983.40292125818,2169.7471877869757,135153.15010904515,3095,20,640.2045454545455,32,12,16,31.504774146162323,0.6591796875,42.14015151515152,1031.439393939395,32.23248106060609,0
3110,4,0,0,44,0.0,0.0,1.0,44,800,600,200,0.75,10,6,4,408.81293241131107,0.8537482381959126,0.3280624197083055,0.25110238540012025,133124.20590938572,2084.579398548629,135208.78530793436,3096,21,641.2045454545455,33,11,16,31.456453113248642,0.6581439393939394,42.00367647058823,1031.9852941176464,31.27228163992868,0
3111,4,0,0,44,0.0,0.0,1.0,44,1050,800,250,0.7619047619047619,13,8,5,404.3264342029066,0.8526250880902044,0.3225291657495051,0.2492340557101499,133257.03124999997,1975.8680555555552,135232.89930555553,3097,22,642.2045454545455,34,10,17,31.438323917137488,0.6571691176470589,41.875,1032.4999999999998,30.367647058823522,0
3112,4,0,0,44,0.0,0.0,1.0,44,1300,1100,200,0.8461538461538461,15,11,4,402.147010655646,0.8531095842142354,0.32104695258647853,0.24891809974819504,133410.721371882,1930.1445578231255,135340.86592970515,3098,23,643.2045454545455,34,10,17,31.339786433125916,0.6587009803921569,41.726190476190474,1033.0952380952376,30.385154061624636,0
3113,4,0,0,44,0.0,0.0,1.0,44,1250,1000,250,0.8,15,10,5,399.8459575631358,0.8506650810429881,0.3176079107614378,0.24854094709248709,133567.21460796322,1881.2763371279798,135448.4909450912,3099,24,644.2045454545455,33,11,17,31.24172594348942,0.6625631313131313,41.57475490196078,1033.7009803921565,31.32427213309565,0
3114,4,0,0,44,0.0,0.0,1.0,44,950,400,550,0.42105263157894735,15,4,11,399.64937219160674,0.8493217054263567,0.31609514167860353,0.24969950782156555,133757.3007527152,1891.2042543733032,135648.5050070885,3100,25,645.2045454545455,33,11,15,31.05563618054733,0.6644570707070707,41.39093137254901,1034.436274509803,31.346553773024336,0
3115,4,0,0,44,0.0,0.0,1.0,44,1550,1100,450,0.7096774193548387,20,11,9,399.5939379812264,0.8487270965468641,0.31440918778119853,0.25074074295612486,133915.8091238947,1902.3891051518726,135818.19822904657,3101,26,646.2045454545455,33,11,15,30.897762254321577,0.6660353535353535,41.23774509803922,1035.0490196078435,31.36512180629829,0
3116,4,1,1,44,0.022222222222222223,0.022222222222222223,0.9777777777777777,45,1850,1400,450,0.7567567567567568,23,14,9,384.24634318548516,0.8514309764309764,0.3013440532748608,0.24357360858761767,134288.91383851145,1341.9014408573316,135630.81527936878,3102,0,632.8222222222222,32,13,16,30.920838916636217,0.6722005208333333,40.87752525252526,1036.4898989898998,32.39030934343437,4
3117,4,1,1,44,0.022222222222222223,0.022222222222222223,0.9777777777777777,45,950,600,350,0.631578947368421,13,6,7,383.52492114381596,0.8521464646464647,0.30485933503836304,0.243551672661398,134354.35677800755,1305.6488177227072,135660.00559573027,3103,0,633.8,32,13,18,30.873980026793333,0.6728515624999998,40.81439393939395,1036.7424242424258,32.39820075757581,0
3118,4,0,1,43,0.0,0.022727272727272728,0.9772727272727273,44,1150,800,350,0.6956521739130435,15,8,7,395.6372337365823,0.8491014799154334,0.3155290180356143,0.25050729859263826,134246.9978332522,1822.6221720377898,136069.62000528997,3104,29,649.2045454545455,31,13,19,30.66771893453952,0.6743951612903225,40.917968750000014,1036.3281250000018,33.42993951612909,0
3119,4,0,0,43,0.0,0.0,1.0,43,1400,800,600,0.5714285714285714,20,8,12,398.074770307208,0.8486526393503138,0.322012563922093,0.25298239393106936,134381.97029961486,2098.814392089854,136480.7846917047,3105,30,662.8372093023256,31,12,21,30.46917514337143,0.675739247311828,40.78776041666667,1036.848958333334,33.44674059139787,0
3120,4,0,1,42,0.0,0.023255813953488372,0.9767441860465116,43,1050,600,450,0.5714285714285714,15,6,9,398.54195900066134,0.8457918050941307,0.3242738395442233,0.2544537122850376,134550.78125,2124.9323527018223,136675.7136027018,3106,31,663.8372093023256,30,13,21,30.287817938420353,0.6802083333333333,40.625,1037.5,34.583333333333336,0
3121,4,0,0,42,0.0,0.0,1.0,42,950,400,550,0.42105263157894735,15,4,11,400.19664957448555,0.8446815718157181,0.3187453737971879,0.25575481247640935,134585.64573939162,2372.1449011446166,136957.79064053623,3107,32,671.0238095238095,30,12,21,30.209952504317794,0.6805555555555556,40.59139784946235,1037.6344086021488,34.58781362007163,0
3122,4,0,0,42,0.0,0.0,1.0,42,1700,1200,500,0.7058823529411765,22,12,10,395.2795167187771,0.8433991482771971,0.31200807385909,0.2537809071107508,134753.49426269517,2253.059217664915,137006.55348036007,3108,33,672.0238095238095,31,11,21,30.169404732045823,0.6794354838709677,40.42968749999999,1038.2812499999989,33.49294354838706,0
3123,4,0,0,42,0.0,0.0,1.0,42,1000,800,200,0.8,12,8,4,396.730263541781,0.8431813782423538,0.31420393154127724,0.2554251260914273,134854.9079895018,2300.2046373155235,137155.11262681734,3109,34,673.0238095238095,31,11,17,30.03021708244537,0.6804435483870968,40.33203124999999,1038.6718749999989,33.505544354838676,0
3124,4,0,0,42,0.0,0.0,1.0,42,950,500,450,0.5263157894736842,14,5,9,412.6846228714153,0.8435201316298877,0.3248636765041901,0.2614799611307711,134272.02792591637,2699.706251285778,136971.73417720213,3110,35,674.0238095238095,30,12,19,30.200903471231573,0.6774305555555555,40.89381720430108,1036.4247311827962,34.54749103942654,3
3125,4,0,0,42,0.0,0.0,1.0,42,1000,800,200,0.8,12,8,4,412.79610760699256,0.8429152148664344,0.3177637873036452,0.2625492143600945,134411.36845661342,2696.8979434038592,137108.26640001728,3111,36,675.0238095238095,30,12,20,30.058057895873844,0.6788194444444444,40.759408602150536,1036.9623655913974,34.565412186379916,0
3126,4,0,0,42,0.0,0.0,1.0,42,1250,900,350,0.72,16,9,7,412.79610760699256,0.842140921409214,0.3177637873036452,0.2625492143600945,134411.36845661342,2696.8979434038592,137108.26640001728,3112,37,676.0238095238095,30,12,20,30.058057895873844,0.6788194444444444,40.759408602150536,1036.9623655913974,34.565412186379916,0
3127,4,0,0,42,0.0,0.0,1.0,42,750,400,350,0.5333333333333333,11,4,7,410.04388611791614,0.8413182346109176,0.31373837600350507,0.26129716508438966,134481.0658204706,2628.6277676610075,137109.6935881316,3113,38,677.0238095238095,30,12,20,30.05944667616949,0.6795138888888889,40.69220430107527,1037.2311827956992,34.57437275985664,0
3128,4,0,0,42,0.0,0.0,1.0,42,1450,1000,450,0.6896551724137931,19,10,9,409.37522356915736,0.8404471544715447,0.315028659888708,0.26112829513014213,134517.01058281783,2613.58625623914,137130.59683905696,3114,39,678.0238095238095,31,11,21,30.040714823647544,0.6770833333333334,40.65755208333333,1037.3697916666658,33.46354166666664,0
3129,4,0,0,42,0.0,0.0,1.0,42,1350,1000,350,0.7407407407407407,17,10,7,411.5359464538769,0.8394066976384049,0.32059771985966434,0.26375868169819855,134690.26630607588,2685.9814830316514,137376.24778910753,3115,40,679.0238095238095,30,12,21,29.810846389572273,0.6815972222222222,40.490591397849464,1038.0376344086023,34.60125448028675,0
3130,4,1,1,42,0.023255813953488372,0.023255813953488372,0.9767441860465116,43,1200,900,300,0.75,15,9,6,398.73031365166986,0.8412236987818383,0.30316186990614313,0.2576734115995125,134990.1856316461,2164.935811360687,137155.1214430068,3116,0,664.2093023255813,31,12,18,29.842882053209703,0.6817876344086021,40.20182291666667,1039.192708333334,33.52234543010755,0
3131,4,0,0,42,0.0,0.0,1.0,42,1250,900,350,0.72,16,9,7,408.2359234113238,0.8378339140534262,0.3135110650964146,0.2626510391506495,134829.82362484108,2608.4755101745923,137438.29913501567,3117,42,681.0238095238095,30,12,19,29.756589448255028,0.6829861111111111,40.35618279569893,1038.575268817205,34.61917562724016,0
3132,4,0,0,42,0.0,0.0,1.0,42,1150,900,250,0.782608695652174,14,9,5,409.03018932972304,0.8358981804103756,0.3092034744039922,0.26392348610340227,134934.53903630478,2638.4600098277306,137572.99904613252,3118,43,682.0238095238095,30,12,19,29.63103708495042,0.6840277777777777,40.255376344086024,1038.978494623656,34.632616487455195,0
3133,4,0,0,42,0.0,0.0,1.0,42,950,600,350,0.631578947368421,13,6,7,412.0644707587177,0.8350029036004646,0.3068027210884354,0.26716837228153245,135109.1550504394,2734.736494103376,137843.8915445428,3119,44,683.0238095238095,30,12,19,29.37728937728939,0.6857638888888888,40.087365591397855,1039.6505376344091,34.65501792114697,0
3134,4,0,0,42,0.0,0.0,1.0,42,750,400,350,0.5333333333333333,11,4,7,412.0644707587177,0.8350271002710027,0.3068027210884354,0.26716837228153245,135109.1550504394,2734.736494103376,137843.8915445428,3120,45,684.0238095238095,30,12,19,29.37728937728939,0.6857638888888888,40.087365591397855,1039.6505376344091,34.65501792114697,0
3135,4,0,1,41,0.0,0.023809523809523808,0.9761904761904762,42,1150,800,350,0.6956521739130435,15,8,7,409.21970635087325,0.8339382500967867,0.3035537337592398,0.26583819211055465,135179.03307101974,2663.584843623532,137842.61791464328,3121,46,685.0238095238095,30,12,19,29.381273964930415,0.6864583333333333,40.02016129032258,1039.9193548387093,34.66397849462364,0
3136,4,0,1,40,0.0,0.024390243902439025,0.975609756097561,41,1450,900,550,0.6206896551724138,20,9,11,410.2207588147058,0.8297764227642277,0.29562999499945253,0.2681562026098034,135403.61195605047,2909.0744885726053,138312.68644462308,3122,47,676.7073170731708,32,9,19,29.13052488980549,0.6832682291666666,39.804292929292934,1040.7828282828289,32.5244633838384,0
3137,4,0,0,40,0.0,0.0,1.0,40,1250,1000,250,0.8,15,10,5,407.1317418674801,0.8262553418803419,0.28510186757215616,0.26686870774556803,135502.18887103378,3033.4484363840697,138535.63730741784,3123,48,688.075,32,8,19,29.112347400759976,0.6842447916666666,39.70959595959597,1041.1616161616178,32.536300505050555,0
3138,4,0,0,40,0.0,0.0,1.0,40,1000,700,300,0.7,13,7,6,404.2772476813148,0.8259882478632479,0.2844253848951388,0.2657277303683799,135600.8016560811,2964.063775380078,138564.8654314612,3124,49,689.075,32,8,21,29.08812179254051,0.6852213541666666,39.614898989899,1041.5404040404048,32.54813762626265,0
3139,4,0,0,40,0.0,0.0,1.0,40,1150,700,450,0.6086956521739131,16,7,9,407.39773553469604,0.8244925213675214,0.2872952933591233,0.26934095814761866,135808.7482114984,3065.6432685586233,138874.39148005703,3125,50,690.075,30,10,21,28.79916183107673,0.6927083333333333,39.41532258064516,1042.338709677419,34.74462365591397,0
3140,4,0,0,40,0.0,0.0,1.0,40,1200,900,300,0.75,15,9,6,395.3577331759152,0.8243856837606838,0.26444805194805254,0.2479034646135624,133889.21407099089,2616.174919065793,136505.38899005667,3126,51,691.075,30,10,20,31.034090909090907,0.673611111111111,41.263440860215056,1034.9462365591398,34.49820788530466,4
3141,4,0,1,39,0.0,0.025,0.975,40,1050,700,350,0.6666666666666666,14,7,7,388.11103933774666,0.8242521367521367,0.21384381338742386,0.2305286052933845,131862.52170138896,2237.090496372423,134099.6121977614,3127,52,692.075,33,7,17,33.263607167004736,0.6455176767676767,43.22916666666667,1027.083333333334,31.12373737373739,8
3142,4,1,0,40,0.025,0.0,1.0,40,800,500,300,0.625,11,5,6,378.8717093005123,0.8227029914529914,0.20085108846688304,0.22658837129634507,132122.477324263,2011.4937641723322,134133.97108843533,3128,0,671.075,34,6,19,33.238285471668995,0.6458333333333333,42.976190476190474,1028.0952380952376,30.238095238095223,0
3143,4,0,1,39,0.0,0.025,0.975,40,850,500,350,0.5882352941176471,12,5,7,378.8717093005123,0.8227297008547009,0.20085108846688304,0.22658837129634507,132122.477324263,2011.4937641723322,134133.97108843533,3129,1,672.075,34,6,19,33.238285471668995,0.6458333333333333,42.976190476190474,1028.0952380952376,30.238095238095223,0
3144,4,0,0,39,0.0,0.0,1.0,39,1200,900,300,0.75,15,9,6,376.4389162043642,0.8173639226270806,0.19358321764615183,0.2265973531803985,132367.37528344663,2165.6462585033933,134533.02154195003,3130,2,642.6666666666666,34,5,20,33.053755977171065,0.6482843137254901,42.738095238095234,1029.0476190476184,30.266106442577012,0
3145,4,0,0,39,0.0,0.0,1.0,39,1050,700,350,0.6666666666666666,14,7,7,376.1292517006799,0.8162955465587045,0.19902319902319876,0.22697454844006568,132461.07266435993,2164.5003712269263,134625.57303558686,3131,3,643.6666666666666,33,6,22,32.96726190476189,0.6515151515151515,42.64705882352941,1029.411764705883,31.19429590017827,0
3146,4,0,1,38,0.0,0.02564102564102564,0.9743589743589743,39,1100,800,300,0.7272727272727273,14,8,6,351.7315054845553,0.8157894736842105,0.1312825466411558,0.1929165780412638,128765.68657487488,1274.5446462898663,130040.23122116475,3132,4,644.6666666666666,33,6,18,37.33749899380182,0.6142676767676769,46.26225490196077,1014.9509803921555,30.756090314913806,8
3147,4,0,0,38,0.0,0.0,1.0,38,900,400,500,0.4444444444444444,14,4,10,365.3987525061263,0.8140706495969654,0.15296543597800483,0.2006698067041838,128816.57483930186,1813.883149678573,130630.45798898043,3133,58,662.5263157894736,32,6,19,36.93874378109452,0.6171875000000002,46.2121212121212,1015.1515151515131,31.723484848484784,0
3148,4,0,0,38,0.0,0.0,1.0,38,750,500,250,0.6666666666666666,10,5,5,367.4856510860637,0.8144559032716927,0.15469076247390023,0.2019789555969265,128848.62075617263,1870.0038580246646,130718.6246141973,3134,59,663.5263157894736,32,6,19,36.85305517555861,0.6175130208333335,46.18055555555554,1015.2777777777761,31.727430555555504,0
3149,4,1,0,39,0.02564102564102564,0.0,1.0,39,850,700,150,0.8235294117647058,10,7,3,359.8058370527918,0.820906432748538,0.15445179870342596,0.19984396491727321,129263.69214965375,1501.9661908880937,130765.65834054185,3135,0,647.4871794871794,33,6,20,36.62478910580863,0.6193181818181819,45.7720588235294,1016.9117647058805,30.81550802139032,0
3150,4,0,0,39,0.0,0.0,1.0,39,1350,1100,250,0.8148148148148148,16,11,5,357.4161204091318,0.8214125056230319,0.14926839213069765,0.198988009088947,129357.17520004313,1446.8679414167473,130804.04314145987,3136,1,648.4871794871794,33,6,20,36.59034554069791,0.6202651515151516,45.68014705882352,1017.279411764705,30.826648841354697,0
3151,4,0,0,39,0.0,0.0,1.0,39,950,400,550,0.42105263157894735,15,4,11,359.6866652183501,0.8211313540260909,0.14840480888897134,0.20056940102806975,129419.51600646375,1510.0948253075555,130929.61083177131,3137,2,649.4871794871794,33,6,20,36.469122606286874,0.6208964646464648,45.6188725490196,1017.5245098039206,30.834076054664262,0
3152,4,0,0,39,0.0,0.0,1.0,39,1450,1100,350,0.7586206896551724,18,11,7,357.3985016922163,0.8196693657219973,0.14730857201063086,0.19992655579510024,129544.24267409153,1459.7836469146246,131004.02632100615,3138,3,650.4871794871794,33,6,16,36.40040026483687,0.622159090909091,45.496323529411754,1018.0147058823516,30.848930481283382,0
3153,4,0,0,39,0.0,0.0,1.0,39,850,500,350,0.5882352941176471,12,5,7,360.30794269708883,0.8200067476383266,0.15460511092805662,0.20219576716782595,129669.02941476814,1544.1562439926677,131213.1856587608,3139,4,651.4871794871794,33,6,17,36.19938936349416,0.6234217171717172,45.37377450980391,1018.5049019607826,30.863784907902502,0
3154,4,2,2,39,0.04878048780487805,0.04878048780487805,0.9512195121951219,41,1400,1100,300,0.7857142857142857,17,11,6,344.0233236151606,0.8350609756097561,0.1477351916376306,0.1960132890365448,130262.58680555537,762.6736111110918,131025.26041666647,3140,0,620.6585365853658,35,6,18,36.01190476190475,0.625,44.79166666666666,1020.8333333333319,29.166666666666625,0
3155,4,0,0,39,0.0,0.0,1.0,39,750,400,350,0.5333333333333333,11,4,7,360.36708403067246,0.8201754385964912,0.1550436331522147,0.20373228215991468,129958.94451530601,1566.58517573695,131525.52969104296,3141,6,653.4871794871794,34,5,18,35.90314263475385,0.6240808823529412,45.08928571428571,1019.6428571428563,29.989495798319304,0
3156,4,0,0,39,0.0,0.0,1.0,39,1000,700,300,0.7,13,7,6,361.71069616270745,0.8194444444444444,0.15467820767225504,0.20481001546767438,130019.64462868468,1605.8992346938635,131625.54386337855,3142,7,654.4871794871794,34,5,18,35.80721567254192,0.6246936274509804,45.0297619047619,1019.8809523809514,29.996498599439747,0
3157,4,1,0,40,0.025,0.0,1.0,40,900,800,100,0.8888888888888888,10,8,2,352.1693061105243,0.8252136752136752,0.15781450390579366,0.20096847228941894,130323.35778061223,1179.404053287976,131502.7618339002,3143,0,639.1,34,6,19,35.7423924449108,0.6277573529411764,44.732142857142854,1021.0714285714286,30.031512605042018,0
3158,4,2,1,41,0.047619047619047616,0.023809523809523808,0.9761904761904762,42,1050,600,450,0.5714285714285714,15,6,9,341.57506106179346,0.8310830429732868,0.16369047619047672,0.19797411702357004,130924.43795146493,544.104577550521,131468.54252901545,3144,0,609.6190476190476,36,6,17,35.404746185446015,0.6296296296296295,44.14414414414414,1023.4234234234231,28.42842842842842,0
3159,4,1,0,42,0.023809523809523808,0.0,1.0,42,1150,700,450,0.6086956521739131,16,7,9,364.04139688046104,0.8289779326364692,0.13354177775623333,0.21077210149444378,130883.62328800155,1137.6576208457916,132021.28090884734,3145,0,610.5952380952381,35,7,15,34.871267390566686,0.63125,44.18402777777778,1023.2638888888889,29.23611111111111,4
3160,4,0,0,42,0.0,0.0,1.0,42,1500,1200,300,0.8,18,12,6,363.4354414539363,0.8281310491676346,0.13769710304363802,0.21095965279797452,130982.06948502558,1120.705249168088,132102.77473419366,3146,1,611.5952380952381,36,6,15,34.78708287495415,0.6302083333333334,44.08783783783784,1023.6486486486488,28.434684684684687,0
3161,4,1,1,42,0.023255813953488372,0.023255813953488372,0.9767441860465116,43,1350,1100,250,0.8148148148148148,16,11,5,360.6848746909423,0.8356866002214839,0.13836039793171118,0.21094873835178626,131271.93583602642,869.5603454909168,132141.49618151734,3147,0,598.3488372093024,37,6,16,34.5642520864541,0.6311936936936937,43.80482456140351,1024.7807017543855,27.696775723091502,0
3162,4,1,0,43,0.023255813953488372,0.0,1.0,43,1150,900,250,0.782608695652174,14,9,5,361.0937209635539,0.835640457733481,0.14536991382856157,0.21165718879145076,131356.983567182,886.4484170945628,132243.43198427657,3148,0,599.3255813953489,36,7,17,34.46780365447288,0.6339699074074074,43.721846846846844,1025.1126126126123,28.475350350350343,0
3163,4,0,0,43,0.0,0.0,1.0,43,1100,700,400,0.6363636363636364,15,7,8,366.835397586035,0.8345330380214101,0.14613126388073394,0.21616238499409962,131559.0823086601,1052.1056529502525,132611.18796161033,3149,1,600.3255813953489,36,7,16,34.11635565312842,0.6359953703703705,43.52477477477478,1025.9009009009014,28.497247247247262,0
3164,4,0,0,43,0.0,0.0,1.0,43,850,700,150,0.8235294117647058,10,7,3,371.8846865411272,0.8348560354374307,0.14678159335752294,0.21980266103345233,131674.63705259314,1193.556225144063,132868.1932777372,3150,2,601.3255813953489,36,7,16,33.870053397703174,0.6371527777777779,43.41216216216216,1026.3513513513515,28.509759759759763,0
3165,4,0,0,43,0.0,0.0,1.0,43,1450,1000,450,0.6896551724137931,19,10,9,372.49739360824077,0.8348560354374307,0.13931553737304703,0.2208342805539622,131790.24252292825,1218.3043685577413,133008.54689148598,3151,3,602.3255813953489,36,7,16,33.73752467646413,0.6383101851851853,43.299549549549546,1026.8018018018013,28.522272272272257,0
3166,4,0,0,43,0.0,0.0,1.0,43,1600,1200,400,0.75,20,12,8,375.9346081826711,0.8320874861572536,0.13635865395155067,0.22372155449775016,131934.82069485023,1319.7730247139011,133254.59371956415,3152,4,603.3255813953489,36,7,16,33.50323358544339,0.6397569444444444,43.15878378378378,1027.3648648648648,28.537912912912912,0
3167,4,0,0,43,0.0,0.0,1.0,43,1150,700,450,0.6086956521739131,16,7,9,376.4986194217592,0.8315799187892211,0.1364685101294525,0.22479605467895336,132059.6782182978,1344.0573060941638,133403.73552439196,3153,5,604.3255813953489,37,6,17,33.36266979588934,0.6390765765765766,43.037280701754376,1027.8508771929812,27.77975343764814,0
3168,4,0,0,43,0.0,0.0,1.0,43,600,300,300,0.5,9,3,6,378.8363334786763,0.8312107788851975,0.14105269945512466,0.2266974026183497,132144.2189543895,1412.2062798168392,133556.42523420634,3154,6,605.3255813953489,37,6,17,33.21724698730939,0.6399211711711712,42.95504385964911,1028.1798245614011,27.788643907064895,0
3169,4,0,1,42,0.0,0.023255813953488372,0.9767441860465116,43,800,600,200,0.75,10,6,4,380.4023585016457,0.8313492063492063,0.1335951192787006,0.2283144289893751,132256.9820161009,1462.173577446888,133719.1555935478,3155,7,606.3255813953489,37,6,17,33.063172902675646,0.6410472972972974,42.845394736842096,1028.6184210526299,27.800497866287294,0
3170,4,0,0,42,0.0,0.0,1.0,42,1100,700,400,0.6363636363636364,15,7,8,385.5415643515218,0.8265340689121177,0.12865904219534752,0.23084459174385227,132166.31063073207,1791.1212310283277,133957.4318617604,3156,8,621.2857142857143,36,6,17,33.02257876099734,0.6420717592592593,42.93355855855856,1028.2657657657658,28.56293793793794,0
3171,4,1,0,43,0.023255813953488372,0.0,1.0,43,1200,900,300,0.75,15,9,6,374.8869736553919,0.8315337763012182,0.13033735301374283,0.22654273629420013,132513.92598257042,1335.7518413683952,133849.6778239388,3157,0,607.8139534883721,36,7,18,32.945969594225105,0.6455439814814815,42.59572072072072,1029.617117117117,28.600475475475474,0
3172,4,0,0,43,0.0,0.0,1.0,43,1000,700,300,0.7,13,7,6,378.24875719200736,0.8304263565891472,0.13875197950214413,0.229634895789627,132687.90486009672,1437.8070215485884,134125.71188164531,3158,1,608.8139534883721,36,7,16,32.68412759135789,0.6472800925925926,42.42680180180181,1030.2927927927938,28.61924424424427,0
3173,4,1,0,44,0.022727272727272728,0.0,1.0,44,1100,800,300,0.7272727272727273,14,8,6,373.5318572264374,0.834830866807611,0.13356349720227723,0.22861510611119681,132991.11415291234,1135.2835728300909,134126.39772574243,3159,0,595.9545454545455,37,7,17,32.50050937245312,0.6483671171171171,42.132675438596486,1031.4692982456133,27.877548601232792,0
3174,4,0,0,44,0.0,0.0,1.0,44,1200,700,500,0.5833333333333334,17,7,10,376.2867865036066,0.8350731148696265,0.13351850062795845,0.23082520606251208,133075.95245652506,1214.9445021545052,134290.89695867957,3160,1,596.9545454545455,37,7,17,32.34413744243712,0.6492117117117117,42.050438596491226,1031.7982456140348,27.88643907064959,0
3175,4,0,0,44,0.0,0.0,1.0,44,1250,800,450,0.64,17,8,9,378.7337188441054,0.8351612050739958,0.13585555409194394,0.23307803767335952,133196.36774965294,1289.1911388706224,134485.55888852358,3161,2,597.9545454545455,38,6,18,32.159922031325465,0.6485745614035088,41.93376068376068,1032.2649572649568,27.164867296446232,0
3176,4,0,0,44,0.0,0.0,1.0,44,1500,1200,300,0.8,18,12,6,385.78029403974676,0.8351612050739958,0.11252922335396587,0.220978757656641,130469.43486636202,1352.56245621354,131821.99732257557,3162,3,598.9545454545455,35,9,19,34.73587194592346,0.6270833333333334,44.58912037037035,1021.6435185185162,29.18981481481475,7
3177,4,2,0,46,0.043478260869565216,0.0,1.0,46,1050,800,250,0.7619047619047619,13,8,5,372.67262603633645,0.8409420289855073,0.12074810923587043,0.21637261422109658,130991.17036011061,563.3646891350952,131554.53504924572,3163,0,573.8695652173913,37,9,21,34.54147029420164,0.6283783783783785,44.07894736842104,1023.6842105263142,27.66714082503552,0
3178,4,1,0,47,0.02127659574468085,0.0,1.0,47,1200,900,300,0.75,15,9,6,361.2328803332777,0.8469781066913351,0.12106720139123062,0.21127718220468278,131273.37643363277,84.05197603915093,131357.42840967193,3164,0,562.6382978723404,38,9,22,34.54875590770087,0.6293859649122808,43.8034188034188,1024.7863247863243,26.96806117858748,0
3179,4,0,0,47,0.0,0.0,1.0,47,1500,1200,300,0.8,18,12,6,360.2792089042819,0.8446268886833178,0.1233077072720854,0.2115118298000685,131417.11576485337,69.40514367146744,131486.52090852484,3165,1,563.6382978723404,35,12,22,34.4279122925838,0.6366071428571429,43.66319444444444,1025.3472222222222,29.29563492063492,0
3180,4,1,0,48,0.020833333333333332,0.0,1.0,48,1100,700,400,0.6363636363636364,15,7,8,354.6525541018324,0.8483488475177304,0.13834731819677493,0.2100953434533078,131761.33639974435,-254.10110279198238,131507.23529695236,3166,0,552.875,36,12,21,34.22475412233554,0.6380208333333335,43.3277027027027,1026.6891891891894,28.51914414414415,0
3181,4,1,2,47,0.02040816326530612,0.04081632653061224,0.9591836734693877,49,1350,800,550,0.5925925925925926,19,8,11,346.6483310991247,0.8502338435374149,0.14264615231862088,0.20677342410060232,132023.05230034713,-646.8858506944485,131376.1664496527,3167,0,542.5714285714286,39,10,21,34.16658220150012,0.6351495726495726,43.072916666666664,1027.7083333333328,26.351495726495713,0
3182,4,2,3,46,0.04081632653061224,0.061224489795918366,0.9387755102040817,49,1200,900,300,0.75,15,9,6,345.1551731060502,0.8511550453514739,0.13808138031740502,0.2060281967959708,132049.81689453125,-684.4645182291654,131365.3523763021,3168,0,543.469387755102,39,10,21,34.17800496604844,0.6354166666666667,43.046875,1027.8125,26.354166666666668,0
3183,4,0,0,46,0.0,0.0,1.0,46,1250,700,550,0.56,18,7,11,366.84545788891575,0.8382850241545894,0.1398312969050426,0.21665992597159348,131645.74361100953,458.728618821514,132104.47222983104,3169,3,579.804347826087,36,10,21,34.028539814916414,0.636863425925926,43.44031531531531,1026.2387387387378,28.506631631631606,0
3184,4,1,0,47,0.02127659574468085,0.0,1.0,47,1200,600,600,0.5,18,6,12,354.1432645243509,0.8402328091273512,0.13980056923352535,0.21149673171873198,132068.34781804704,-45.77683267590072,132022.57098537113,3170,0,568.4468085106383,38,9,22,33.92838582267956,0.6373355263157896,43.02884615384614,1027.884615384613,27.04959514170034,0
3185,4,0,0,47,0.0,0.0,1.0,47,1600,1400,200,0.875,18,14,4,353.5116304340758,0.8391150169596052,0.13381248218109976,0.21204090132017706,132233.1242809005,-50.81052761343864,132182.31375328705,3171,1,569.4468085106383,38,9,22,33.77869533603406,0.6389802631578949,42.86858974358973,1028.525641025639,27.06646423751682,0
3186,4,0,0,47,0.0,0.0,1.0,47,1750,1000,750,0.5714285714285714,25,10,15,354.88040453471865,0.8383055812519272,0.13006291086449484,0.21363800352990023,132370.51647308035,-4.8595131127370905,132365.6569599676,3172,2,570.4468085106383,38,9,22,33.605213524363236,0.6403508771929826,42.735042735042725,1029.0598290598273,27.080521817363877,0
3187,4,0,0,47,0.0,0.0,1.0,47,1300,900,400,0.6923076923076923,17,9,8,354.4578950448701,0.8385368485969781,0.12461779418797847,0.2136991818102885,132426.21678064385,-12.0935366669205,132414.12324397694,3173,3,571.4468085106383,37,10,22,33.56004314477468,0.6427364864864865,42.68092105263157,1029.2763157894722,27.81827880512087,0
3188,4,0,0,47,0.0,0.0,1.0,47,1500,1000,500,0.6666666666666666,20,10,10,357.721011280613,0.8377274128893,0.12600601171990888,0.21663916563241772,132595.55975155823,86.44354512927447,132682.0032966875,3174,4,572.4468085106383,37,10,22,33.30571968487171,0.6444256756756757,42.516447368421055,1029.9342105263163,27.836059743954493,0
3189,4,0,0,47,0.0,0.0,1.0,47,1100,800,300,0.7272727272727273,14,8,6,359.3879158438472,0.8378045020043169,0.12245646528203857,0.2183043468121934,132708.5151801516,138.76733706524834,132847.28251721684,3175,5,573.4468085106383,37,10,20,33.1492098542088,0.6455518018018017,42.406798245614034,1030.372807017544,27.84791370317686,0
3190,4,0,1,46,0.0,0.02127659574468085,0.9787234042553191,47,1600,1200,400,0.75,20,12,8,360.3836228805278,0.8379586802343508,0.1358399262616179,0.21239630539980026,131565.50068587094,87.19271468617839,131652.69340055712,3176,6,574.4468085106383,35,12,20,34.2753459687124,0.6380952380952382,43.51851851851851,1025.925925925925,29.312169312169285,2
3191,4,0,0,46,0.0,0.0,1.0,46,1350,1000,350,0.7407407407407407,17,10,7,366.7563766503337,0.836352657004831,0.1360971967897009,0.21636366942842072,131602.82206632657,453.2348356009023,132056.05690192746,3177,7,558.1086956521739,34,12,20,34.07418687396061,0.640625,43.482142857142854,1026.0714285714287,30.17857142857143,0
3192,4,0,0,46,0.0,0.0,1.0,46,900,700,200,0.7777777777777778,11,7,4,364.02564235427576,0.8354066022544284,0.13986465361612832,0.2152694847996273,131694.45153061222,388.0314625850271,132082.48299319725,3178,8,559.1086956521739,34,12,21,34.05169914173045,0.6415441176470589,43.39285714285714,1026.428571428571,30.18907563025209,0
3193,4,0,0,46,0.0,0.0,1.0,46,1200,900,300,0.75,15,9,6,358.33610663648506,0.8357085346215781,0.13418751251704686,0.21243879195783308,131790.2425229284,245.0404796688669,132035.28300259725,3179,9,560.1086956521739,36,10,21,34.10104555092491,0.6383101851851851,43.29954954954955,1026.8018018018024,28.52227227227229,0
3194,4,0,0,46,0.0,0.0,1.0,46,1100,800,300,0.7272727272727273,14,8,6,360.10697148080686,0.835487117552335,0.13668648079205648,0.21397626624602215,131876.97991488117,297.9639690366126,132174.9438839178,3180,10,561.1086956521739,36,10,21,33.96808646712715,0.6391782407407407,43.215090090090094,1027.13963963964,28.53165665665667,0
3195,4,0,0,46,0.0,0.0,1.0,46,1200,700,500,0.5833333333333334,17,7,10,364.99550777771026,0.8342391304347826,0.14342631329950528,0.217927891076959,132059.67821829792,440.23786164973484,132499.91607994767,3181,11,562.1086956521739,37,9,21,33.65825688073394,0.6390765765765766,43.03728070175438,1027.8508771929824,27.77975343764817,0
3196,4,0,0,46,0.0,0.0,1.0,46,1350,800,550,0.5925925925925926,19,8,11,365.36735059311474,0.8325080515297907,0.14399566051906865,0.21880044788392278,132172.40521121887,458.2963027085299,132630.7015139274,3182,12,563.1086956521739,37,9,21,33.53504656287767,0.6402027027027026,42.92763157894737,1028.2894736842109,27.791607396870564,0
3197,4,0,1,45,0.0,0.021739130434782608,0.9782608695652174,46,1350,1000,350,0.7407407407407407,17,10,7,369.429490911232,0.8327093397745572,0.15567663738463278,0.22222604760967937,132341.58587257602,578.1769390581578,132919.76281163417,3183,13,564.1086956521739,37,9,21,33.260070332480815,0.6418918918918919,42.763157894736835,1028.9473684210514,27.809388335704092,0
3198,4,0,0,45,0.0,0.0,1.0,45,1450,1200,250,0.8275862068965517,17,12,5,370.7006051000601,0.831523569023569,0.1608830294385981,0.2236879366573775,132459.27047902485,820.5703893976694,133279.84086842253,3184,14,573.6444444444444,34,11,21,33.108785320535056,0.649203431372549,42.64880952380952,1029.4047619047612,30.276610644257683,0
3199,4,0,0,45,0.0,0.0,1.0,45,1050,500,550,0.47619047619047616,16,5,11,366.9322221863519,0.8316919191919192,0.1508353937214355,0.22210632061320817,132576.73852237655,729.3354552469133,133306.07397762345,3185,15,574.6444444444444,35,10,21,33.08749157113957,0.6482142857142856,42.53472222222222,1029.861111111111,29.424603174603174,0
3200,4,1,1,45,0.021739130434782608,0.021739130434782608,0.9782608695652174,46,1300,900,400,0.6923076923076923,17,9,8,359.0107160132143,0.8336553945249597,0.14807021876870086,0.2188005389071217,132832.97444403885,337.6922530638927,133170.66669710274,3186,0,563.1304347826087,36,10,18,33.03382856310536,0.6487268518518519,42.286036036036045,1030.8558558558575,28.63488488488493,0
3201,4,0,2,43,0.0,0.044444444444444446,0.9555555555555556,45,1250,700,550,0.56,18,7,11,367.7753987354751,0.8324915824915825,0.15290675795428288,0.22396861108621474,132803.95418645008,768.405440913896,133572.35962736397,3187,17,576.6444444444444,36,9,18,32.83713900724715,0.6484375,42.31418918918919,1030.743243243244,28.63175675675678,0
3202,4,0,0,43,0.0,0.0,1.0,43,1400,1100,300,0.7857142857142857,17,11,6,375.6874768419298,0.8291805094130675,0.15012850247602372,0.22849189165304223,132755.59413580227,1374.9228395061505,134130.51697530842,3188,18,595.7209302325581,35,8,18,32.681940700808624,0.6500000000000001,42.3611111111111,1030.5555555555538,29.444444444444397,0
3203,4,0,0,43,0.0,0.0,1.0,43,1150,800,350,0.6956521739130435,15,8,7,370.08146663862783,0.8292266519010705,0.14577889617763096,0.22598051996460128,132904.7325772675,1237.1156710819441,134141.84824834944,3189,19,596.7209302325581,35,8,19,32.676343210985145,0.6514880952380953,42.216435185185176,1031.134259259258,29.4609788359788,0
3204,4,0,0,43,0.0,0.0,1.0,43,900,600,300,0.6666666666666666,12,6,6,370.6498158997492,0.8288113695090439,0.14794883773125989,0.2266891221333329,132964.41139671192,1256.646921081937,134221.05831779385,3190,20,597.7209302325581,35,8,19,32.60167676654323,0.6520833333333333,42.1585648148148,1031.365740740739,29.467592592592545,0
3205,4,0,0,43,0.0,0.0,1.0,43,1150,700,450,0.6086956521739131,16,7,9,370.824282337421,0.8294573643410852,0.1396183407184084,0.22788698315663553,133143.5282305598,1274.5706607938932,134418.0988913537,3191,21,598.7209302325581,35,8,21,32.41712926619566,0.6538690476190476,41.9849537037037,1032.060185185185,29.487433862433857,0
3206,4,0,0,43,0.0,0.0,1.0,43,1150,700,450,0.6086956521739131,16,7,9,370.2647744941612,0.8297803617571059,0.1408490366789481,0.2279083177165922,133203.26063368045,1264.0950520833235,134467.35568576376,3192,22,599.7209302325581,35,8,21,32.37155230406997,0.6544642857142857,41.92708333333333,1032.2916666666658,29.494047619047596,0
3207,4,0,0,43,0.0,0.0,1.0,43,1050,600,450,0.5714285714285714,15,6,9,371.47195069837227,0.8301956441491325,0.14232850009902775,0.2295717235479412,133352.6502486281,1307.3538237311186,134660.00407235924,3193,23,600.7209302325581,35,8,21,32.19034812490661,0.6559523809523811,41.7824074074074,1032.870370370369,29.510582010581974,0
3208,4,1,0,44,0.022727272727272728,0.0,1.0,44,1450,1000,450,0.6896551724137931,19,10,9,361.01562585666977,0.8319238900634249,0.14272564535486887,0.2256473890843997,133771.3865847908,858.7657536008267,134630.15233839164,3194,0,588.0454545454545,35,9,18,32.04063175952861,0.6601190476190476,41.37731481481482,1034.4907407407409,29.55687830687831,0
3209,4,0,0,44,0.0,0.0,1.0,44,1100,900,200,0.8181818181818182,13,9,4,356.4273441730269,0.8308668076109937,0.14091417246811333,0.22405077959435882,133981.00090288496,750.8984642918393,134731.8993671768,3195,1,589.0454545454545,35,9,19,31.94952953232719,0.6622023809523809,41.17476851851852,1035.300925925926,29.58002645502646,0
3210,4,0,0,44,0.0,0.0,1.0,44,1150,1000,150,0.8695652173913043,13,10,3,356.1976914887795,0.8305364693446089,0.1358836436778108,0.22463799444207808,134100.85419077933,753.2829378858046,134854.13712866514,3196,2,590.0454545454545,35,9,19,31.835610124036204,0.6633928571428571,41.05902777777778,1035.763888888889,29.59325396825397,0
3211,4,0,1,43,0.0,0.022727272727272728,0.9772727272727273,44,1250,1100,150,0.88,14,11,3,357.64511463191496,0.8310870331219169,0.1398599445465718,0.22591964862881247,134160.8009286052,796.3910054441111,134957.1919340493,3197,3,591.0454545454545,35,9,19,31.73819033255129,0.6639880952380952,41.00115740740741,1035.995370370371,29.59986772486774,0
3212,4,0,0,43,0.0,0.0,1.0,43,950,600,350,0.631578947368421,13,6,7,361.45550281988216,0.8296880767811,0.12938533818018594,0.22922017939204045,134303.8708191611,1108.9746315192801,135412.84545068038,3198,4,576.2790697674419,34,9,19,31.49644921710501,0.6675857843137254,40.86309523809524,1036.5476190476197,30.486694677871167,0
3213,4,0,0,43,0.0,0.0,1.0,43,1500,1000,500,0.6666666666666666,20,10,10,361.8494942925564,0.8289036544850498,0.13446244123308393,0.23024623409660036,134427.29768990935,1128.4899376417266,135555.78762755106,3199,5,577.2790697674419,34,9,19,31.362884092909347,0.6688112745098038,40.74404761904762,1037.0238095238099,30.500700280112056,0
3214,4,0,1,42,0.0,0.023255813953488372,0.9767441860465116,43,1100,900,200,0.8181818181818182,13,9,4,350.66668389774213,0.8288575119970468,0.11048186732634524,0.2168734722865795,133379.97626133793,754.3827947845921,134134.3590561225,3200,6,578.2790697674419,34,9,21,32.70019399946219,0.6583946078431373,41.75595238095239,1032.976190476191,30.381652661064443,2
3215,4,0,0,42,0.0,0.0,1.0,42,1250,900,350,0.72,16,9,7,357.69303803242224,0.8280100658149439,0.09833435035143623,0.22101443728279013,133345.61827181865,1139.3598615917092,134484.97813341036,3201,7,546.5238095238095,33,9,22,32.553195696883414,0.6603535353535352,41.78921568627452,1032.843137254903,31.298276886512213,0
3216,4,0,1,41,0.0,0.023809523809523808,0.9761904761904762,42,1100,600,500,0.5454545454545454,16,6,10,357.7132817516999,0.8267518389469609,0.09433157677731252,0.22159299621223977,133440.56560277307,1146.6925281141973,134587.25813088726,3202,8,547.5238095238095,33,9,23,32.45747341161586,0.661300505050505,41.69730392156863,1033.2107843137262,31.30941770647655,0
3217,4,0,0,41,0.0,0.0,1.0,41,1300,900,400,0.6923076923076923,17,9,8,367.624981918026,0.8242886178861789,0.09664283883122393,0.22752705007967394,133406.99450311202,1608.7487883889528,135015.74329150096,3203,9,561.0,32,9,23,32.23514014503382,0.6634114583333333,41.729797979797986,1033.0808080808088,32.283775252525274,0
3218,4,0,0,41,0.0,0.0,1.0,41,1250,900,350,0.72,16,9,7,363.99586716106813,0.8232723577235772,0.09277588744614551,0.22607512659943135,133537.46588358344,1521.4171385573104,135058.88302214074,3204,10,562.0,32,9,23,32.19801083150094,0.6647135416666665,41.603535353535364,1033.5858585858596,32.29955808080811,0
3219,4,0,0,41,0.0,0.0,1.0,41,650,400,250,0.6153846153846154,9,4,5,366.7055776945884,0.8228150406504064,0.09697132136156505,0.2285630655493671,133668.00103305807,1603.3603076216982,135271.36134067978,3205,11,563.0,32,9,23,31.997100122100125,0.6660156249999998,41.47727272727274,1034.0909090909108,32.31534090909096,0
3220,4,0,0,41,0.0,0.0,1.0,41,1000,600,400,0.6,14,6,8,366.7055776945884,0.8221544715447154,0.09697132136156505,0.2285630655493671,133668.00103305807,1603.3603076216982,135271.36134067978,3206,12,564.0,32,9,23,31.997100122100125,0.6660156249999998,41.47727272727274,1034.0909090909108,32.31534090909096,0
3221,4,0,0,41,0.0,0.0,1.0,41,1050,700,350,0.6666666666666666,14,7,7,369.76354456428135,0.8224085365853658,0.09264898947048761,0.23108106183182014,133765.94424357233,1692.3539370982844,135458.29818067062,3207,13,565.0,32,9,17,31.81984621017943,0.6669921874999998,41.38257575757577,1034.4696969696988,32.32717803030309,0
3222,4,0,0,41,0.0,0.0,1.0,41,1000,800,200,0.8,12,8,4,367.10058105490725,0.8211890243902439,0.08963823866426601,0.22982347301336664,133831.25964506192,1625.9066358024954,135457.16628086442,3208,14,566.0,32,9,17,31.823266219239372,0.6676432291666665,41.31944444444446,1034.7222222222238,32.33506944444449,0
3223,4,0,0,41,0.0,0.0,1.0,41,1100,800,300,0.7272727272727273,14,8,6,367.10058105490725,0.8211382113821138,0.08963823866426601,0.22982347301336664,133831.25964506192,1625.9066358024954,135457.16628086442,3209,15,567.0,32,9,17,31.823266219239372,0.6676432291666665,41.31944444444446,1034.7222222222238,32.33506944444449,0
3224,4,0,0,41,0.0,0.0,1.0,41,600,300,300,0.5,9,3,6,382.7042604653293,0.8210365853658537,0.09390853587643,0.22255844112659198,131053.71492346929,1830.9630102040733,132884.67793367337,3210,16,568.0,34,7,18,34.22131147540984,0.635110294117647,44.01785714285714,1023.9285714285706,30.11554621848737,4
3225,4,0,1,40,0.0,0.024390243902439025,0.975609756097561,41,1250,1000,250,0.8,15,10,5,386.00176746260456,0.8201727642276423,0.09391065790741537,0.225368467488682,131206.12953514734,1929.159580498855,133135.28911564618,3211,17,569.0,34,7,18,33.98234758695483,0.6366421568627452,43.86904761904761,1024.523809523809,30.1330532212885,0
3226,4,1,0,41,0.024390243902439025,0.0,1.0,41,800,500,300,0.625,11,5,6,392.2523808686795,0.8263719512195122,0.10881801125703539,0.23126316426990023,131579.47063629367,2122.5288154477394,133701.9994517414,3212,0,565.5853658536586,33,8,17,33.443820672081536,0.6426767676767677,43.50490196078431,1025.9803921568623,31.090314913844313,0
3227,4,1,1,41,0.023809523809523808,0.023809523809523808,0.9761904761904762,42,1450,1100,350,0.7586206896551724,18,11,7,383.32678867458094,0.8287843592721641,0.11230876216968078,0.2277784802124163,131877.80612244896,1710.4591836734728,133588.26530612243,3213,0,553.0952380952381,34,8,18,33.37100139082059,0.6433823529411764,43.214285714285715,1027.142857142857,30.210084033613445,0
3228,4,1,0,42,0.023809523809523808,0.0,1.0,42,950,700,250,0.7368421052631579,12,7,5,384.13384771709633,0.8286633759194735,0.12774173617547135,0.22899470811422484,132000.11337868482,1741.1422902494328,133741.25566893426,3214,0,554.0714285714286,34,8,19,33.22665662650602,0.6446078431372548,43.095238095238095,1027.6190476190477,30.224089635854344,0
3229,4,0,0,42,0.0,0.0,1.0,42,1650,1300,350,0.7878787878787878,20,13,7,381.96732130152594,0.8290505226480837,0.12911504766315463,0.22862451518234767,132153.07716836722,1695.6313775510018,133848.70854591823,3215,1,555.0714285714286,34,8,19,33.12782216047238,0.646139705882353,42.94642857142856,1028.2142857142846,30.24159663865543,0
3230,4,0,0,42,0.0,0.0,1.0,42,1000,700,300,0.7,13,7,6,356.09917355371914,0.8286633759194735,0.0909307359307363,0.1998515769944342,129672.49657064475,841.804934422336,130514.3015050671,3216,2,556.0714285714286,35,7,16,36.303030303030305,0.619047619047619,45.370370370370374,1018.5185185185188,29.10052910052911,6
3231,4,0,0,42,0.0,0.0,1.0,42,1200,1000,200,0.8333333333333334,14,10,4,358.1032197088503,0.8268970189701897,0.0887622942837667,0.20127870625014688,129731.44531250001,891.4496527777785,130622.8949652778,3217,3,557.0714285714286,35,7,16,36.19205862304021,0.6196428571428572,45.3125,1018.7500000000001,29.10714285714286,0
3232,4,2,1,43,0.045454545454545456,0.022727272727272728,0.9772727272727273,44,1500,1200,300,0.8,18,12,6,342.02415660141594,0.8368569415081043,0.08896103896103913,0.1948742287612721,130262.58680555575,110.5902777778033,130373.17708333356,3218,0,532.7045454545455,38,6,19,36.062925170068034,0.6192434210526314,44.79166666666668,1020.833333333335,26.86403508771934,0
3233,4,0,1,42,0.0,0.023255813953488372,0.9767441860465116,43,1200,1000,200,0.8333333333333334,14,10,4,345.4514362053501,0.8325027685492802,0.08785640759136948,0.19654413008553803,130206.62607725468,396.01319636813434,130602.63927362282,3219,1,546.0930232558139,37,6,19,36.03217662226043,0.6204954954954953,44.846491228070185,1020.6140350877205,27.584163110478933,0
3234,4,0,0,42,0.0,0.0,1.0,42,800,500,300,0.625,11,5,6,352.84737577012936,0.8282762291908633,0.08986010049839832,0.2004638387617113,130150.67737188394,784.6649930748238,130935.34236495876,3220,2,559.9761904761905,37,5,19,35.90022566086396,0.6199324324324322,44.9013157894737,1020.3947368421076,27.578236130867772,0
3235,4,0,0,42,0.0,0.0,1.0,42,1400,1000,400,0.7142857142857143,18,10,8,349.88644667267795,0.8260743321718932,0.08915080084617699,0.1999610107150072,130380.7656035666,723.7887417401096,131104.5543453067,3221,3,560.9761904761905,35,7,20,35.742482623148994,0.6261904761904762,44.67592592592593,1021.2962962962969,29.179894179894195,0
3236,4,0,0,42,0.0,0.0,1.0,42,1000,900,100,0.9,11,9,2,349.85233892289205,0.8247435152922957,0.08956556452874564,0.20039887058224315,130469.43486636225,729.0073891889506,131198.4422555512,3222,4,561.9761904761905,35,7,20,35.65351100789244,0.6270833333333334,44.58912037037037,1021.6435185185181,29.189814814814802,0
3237,4,1,1,42,0.023255813953488372,0.023255813953488372,0.9767441860465116,43,1150,700,450,0.6086956521739131,16,7,9,340.23147998317074,0.8309339239571797,0.08654114643583699,0.19639104240612754,130766.77439212082,298.194636811344,131064.96902893216,3223,0,549.8837209302326,37,6,17,35.59846698113208,0.626126126126126,44.298245614035096,1022.807017543861,27.64343290659084,0
3238,4,0,0,42,0.0,0.0,1.0,42,1100,700,400,0.6363636363636364,15,7,8,349.7393449069866,0.8212591947348045,0.08642344039577865,0.20173276870423407,130738.7384219183,744.8961459295175,131483.63456784782,3224,6,563.9761904761905,37,5,17,35.38372020299488,0.6258445945945945,44.32565789473684,1022.6973684210528,27.640469416785212,0
3239,4,0,0,42,0.0,0.0,1.0,42,1200,900,300,0.75,15,9,6,350.39661615482805,0.8218399148277197,0.08231000867656801,0.20255269075121088,130822.85534972294,767.9771660510852,131590.83251577403,3225,7,564.9761904761905,37,5,17,35.281797070382275,0.6266891891891893,44.243421052631575,1023.0263157894732,27.649359886201978,0
3240,4,0,1,41,0.0,0.023809523809523808,0.9761904761904762,42,650,500,150,0.7692307692307693,8,5,3,350.70423434048104,0.8220092915214866,0.07889742569408331,0.20332132443068615,130935.05333371794,783.8955255463077,131718.94885926423,3226,8,565.9761904761905,37,5,17,35.160434968930794,0.6278153153153154,44.133771929824555,1023.4649122807007,27.661213845424342,0
3241,4,0,1,40,0.0,0.024390243902439025,0.975609756097561,41,1050,800,250,0.7619047619047619,13,8,5,355.16697649585893,0.8161585365853659,0.07764728615595984,0.20585188025474271,130924.43795146496,1100.0073553282982,132024.44530679326,3227,15,580.5853658536586,36,5,17,35.05698906983567,0.6296296296296295,44.14414414414414,1023.4234234234233,28.428428428428425,0
3242,4,0,0,40,0.0,0.0,1.0,40,1300,1200,100,0.9230769230769231,14,12,2,362.3833293282558,0.812767094017094,0.07841024770953542,0.20981211621421808,130883.62328800155,1486.008632330249,132369.6319203318,3228,16,595.275,35,5,17,34.91368340685443,0.63125,44.18402777777778,1023.2638888888889,29.23611111111111,0
3243,4,0,0,40,0.0,0.0,1.0,40,700,300,400,0.42857142857142855,11,3,8,364.0936280601694,0.8123130341880341,0.07515262860373095,0.21145161787210762,131002.08340031294,1539.404765732169,132541.4881660451,3229,17,596.275,35,5,17,34.74997644620313,0.632440476190476,44.06828703703704,1023.726851851852,29.249338624338627,0
3244,4,0,0,40,0.0,0.0,1.0,40,950,700,250,0.7368421052631579,12,7,5,373.80430900079546,0.8133814102564103,0.08240908575960137,0.21411879529850827,130469.43486636187,1754.4126157406904,132223.84748210257,3230,18,597.275,35,5,20,35.04175163324647,0.6270833333333335,44.589120370370345,1021.6435185185151,29.189814814814717,1
3245,4,0,0,40,0.0,0.0,1.0,40,900,600,300,0.6666666666666666,12,6,6,372.4343048205053,0.8125267094017093,0.08708131335390057,0.21393757914879136,130578.91506371222,1726.4134911938804,132305.3285549061,3231,19,598.275,36,4,15,34.96561444101659,0.6261574074074074,44.481981981981974,1022.0720720720709,28.39089089089086,0
3246,4,0,0,40,0.0,0.0,1.0,40,1150,900,250,0.782608695652174,14,9,5,374.5205167587082,0.8129807692307692,0.07963605329809531,0.21593782937687792,130722.8274516069,1791.6761778670452,132514.50362947394,3232,20,599.275,36,4,15,34.76627023455566,0.6276041666666667,44.34121621621621,1022.6351351351342,28.406531531531506,0
3247,4,0,0,40,0.0,0.0,1.0,40,1000,800,200,0.8,12,8,4,374.7243866860111,0.8136752136752137,0.08142126114229153,0.2170248885797183,130895.62694028477,1809.956705015815,132705.5836453006,3233,21,600.275,36,4,15,34.58580939804117,0.6293402777777779,44.17229729729729,1023.3108108108099,28.425300300300275,0
3248,4,0,0,40,0.0,0.0,1.0,40,850,700,150,0.8235294117647058,10,7,3,376.3757382118791,0.8129807692307692,0.08133733083947625,0.2183075357120463,130953.25213304514,1857.5253885642321,132810.7775216094,3234,22,601.275,36,4,15,34.48513771225291,0.6299189814814815,44.11599099099099,1023.5360360360355,28.431556556556544,0
3249,4,0,0,40,0.0,0.0,1.0,40,900,600,300,0.6666666666666666,12,6,6,389.55744930429984,0.8127938034188035,0.12684959574703747,0.21618403256106475,129230.01284646134,2076.428835930526,131306.44168239186,3235,23,602.275,36,4,19,35.902831616642665,0.6125578703703705,45.80518018018018,1016.7792792792793,28.24386886886887,7
3250,4,0,1,39,0.0,0.025,0.975,40,1150,1000,150,0.8695652173913043,13,10,3,389.29723276846573,0.8111378205128205,0.12012451577199812,0.2169833743407211,129401.82317029867,2075.1543350783213,131476.977505377,3236,24,603.275,36,4,19,35.73395130049806,0.6142939814814815,45.63626126126126,1017.4549549549549,28.26263763763764,0
3251,4,0,0,39,0.0,0.0,1.0,39,1100,700,400,0.6363636363636364,15,7,8,396.89341126003774,0.8084795321637427,0.11904949409215182,0.2212485718698152,129407.39300679417,2472.1883305469564,131879.58133734114,3237,25,600.2564102564103,35,4,20,35.53504057179692,0.6163690476190478,45.630787037037024,1017.4768518518498,29.070767195767136,0
3252,4,1,1,39,0.025,0.025,0.975,40,1150,600,550,0.5217391304347826,17,6,11,387.3950270338126,0.8161591880341881,0.11580256466946737,0.21766306922657552,129717.10519641252,2050.3522948624177,131767.45749127495,3238,0,586.225,36,4,17,35.460654801385516,0.6174768518518519,45.32657657657657,1018.6936936936928,28.297047047047023,0
3253,4,4,3,40,0.09302325581395349,0.06976744186046512,0.9302325581395349,43,700,400,300,0.5714285714285714,10,4,6,374.40359393725794,0.8319952011812477,0.14965477182860365,0.21543403429859406,130644.58832137109,1183.9051936418457,131828.49351501293,3239,0,546.2325581395348,38,5,15,34.84864318807259,0.6230811403508772,44.41773504273504,1022.3290598290592,26.903396311291033,0
3254,4,0,0,40,0.0,0.0,1.0,40,800,600,200,0.75,10,6,4,387.9251053608527,0.8236912393162393,0.14643329658213888,0.22184619833688102,130406.32482144305,2117.5774592159714,132523.902280659,3240,1,578.875,36,4,19,34.74526828371921,0.6244212962962963,44.6509009009009,1021.3963963963962,28.372122122122118,0
3255,4,0,1,39,0.0,0.025,0.975,40,1250,1000,250,0.8,15,10,5,403.3304498269896,0.8235042735042735,0.15742187500000004,0.2109728506787331,126858.71056241433,2242.9356283210227,129101.64619073535,3241,2,579.875,35,5,17,37.990196078431374,0.5904761904761904,48.14814814814815,1007.407407407408,28.7830687830688,6
3256,4,3,2,40,0.07142857142857142,0.047619047619047616,0.9523809523809523,42,650,200,450,0.3076923076923077,11,2,9,384.2786192590091,0.8405681378242353,0.15324294556567297,0.20396667462571846,127451.59718615342,1395.3847578100876,128846.9819439635,3242,0,543.4761904761905,37,5,15,37.859589350997204,0.5926238738738739,47.560307017543856,1009.7587719298244,27.290777619724985,0
3257,4,2,2,40,0.047619047619047616,0.047619047619047616,0.9523809523809523,42,1000,900,100,0.9,11,9,2,374.8949842278205,0.8355110336817654,0.1286045260849782,0.19884982803973292,127423.91889812227,1186.6576735149051,128610.57657163717,3243,0,544.4285714285714,37,5,11,38.12490949898639,0.5923423423423424,47.5877192982456,1009.6491228070156,27.28781412991934,5
3258,4,4,3,41,0.09090909090909091,0.06818181818181818,0.9318181818181819,44,900,500,400,0.5555555555555556,13,5,8,364.12095025363044,0.8504448555320648,0.1251310468773399,0.195594174162791,127933.68055555565,516.6666666666729,128450.34722222232,3244,0,520.5909090909091,39,5,13,37.87410763316857,0.594017094017094,47.083333333333336,1011.6666666666674,25.940170940170958,0
3259,4,2,2,41,0.046511627906976744,0.046511627906976744,0.9534883720930233,43,950,700,250,0.7368421052631579,12,7,5,373.0336658597065,0.8490679217423404,0.134956909572731,0.20035483732419498,127928.27641034761,944.3107832931461,128872.58719364075,3245,0,533.6511627906976,38,5,14,37.65423135142748,0.5956688596491229,47.08867521367521,1011.6452991452982,26.62224471434995,0
3260,4,2,2,41,0.046511627906976744,0.046511627906976744,0.9534883720930233,43,750,600,150,0.8,9,6,3,373.5841983770091,0.8478220745662606,0.14423907919547485,0.20105622312653568,128009.35057345303,964.4541237489881,128973.80469720202,3246,0,534.5348837209302,38,5,16,37.557186092342356,0.5964912280701755,47.008547008547005,1011.9658119658111,26.630679262258187,0
3261,4,2,0,43,0.046511627906976744,0.0,1.0,43,900,500,400,0.5555555555555556,13,5,8,372.4017964055652,0.8481450719822813,0.15099791832902465,0.2017959059818778,128283.34349270926,954.6608523333845,129238.00434504265,3247,0,530.0697674418604,37,6,19,37.3064139336869,0.6010698198198199,46.737938596491226,1013.0482456140348,27.379682313892832,0
3262,4,0,1,42,0.0,0.023255813953488372,0.9767441860465116,43,1600,1300,300,0.8125,19,13,6,377.2826098051421,0.8477759320782576,0.1652128687123855,0.19232810564985278,125802.56615713362,899.1705814465595,126701.73673858018,3248,1,531.0697674418604,38,5,16,39.736421725239616,0.5740131578947367,49.198717948717956,1003.2051282051295,26.400134952766567,7
3263,4,2,2,42,0.045454545454545456,0.045454545454545456,0.9545454545454546,44,1150,600,550,0.5217391304347826,17,6,11,368.5885659108916,0.8559064482029599,0.18046280816026727,0.1899897336725348,126258.49364681508,507.7185605230618,126766.21220733815,3249,0,519.8636363636364,38,6,18,39.483673505545525,0.578673245614035,48.744658119658126,1005.0213675213686,26.447930724246543,0
3264,4,1,0,43,0.023255813953488372,0.0,1.0,43,1500,1100,400,0.7333333333333333,19,11,8,377.4959232284164,0.8540051679586563,0.18840634872302386,0.19447724206792769,126236.59593576861,930.7600655970969,127167.35600136571,3250,0,532.8372093023256,37,6,20,39.282483178759776,0.5802364864864864,48.76644736842105,1004.934210526315,27.160384068278784,0
3265,4,5,3,45,0.10416666666666667,0.0625,0.9375,48,1050,800,250,0.7619047619047619,13,8,5,344.46558717395925,0.8766807033096926,0.19750317561130526,0.18230624101021792,127334.51727892821,-815.9741117430915,126518.54316718511,3251,0,478.2291666666667,38,10,15,38.98459828516989,0.589638157894737,47.676282051282044,1009.2948717948707,26.560391363022912,0
3266,4,1,1,45,0.021739130434782608,0.021739130434782608,0.9782608695652174,46,1050,800,250,0.7619047619047619,13,8,5,357.0763214465775,0.8707125603864735,0.18887449959116553,0.1882375404577115,127174.94956380807,-117.76736592028215,127057.18219788779,3252,0,500.0,37,9,20,38.83019440518898,0.5898085585585585,47.834429824561404,1008.6622807017542,27.26114272166903,0
3267,4,4,4,45,0.08163265306122448,0.08163265306122448,0.9183673469387755,49,950,500,450,0.5263157894736842,14,5,9,337.18203520334146,0.8811649659863946,0.19247816843040932,0.18071680688027664,127843.36911848062,-1178.7025226757435,126664.66659580488,3253,0,470.3061224489796,41,8,16,38.647733961153634,0.5899390243902438,47.172619047619044,1011.309523809523,24.66608594657373,0
3268,4,3,2,46,0.0625,0.041666666666666664,0.9583333333333334,48,1150,800,350,0.6956521739130435,15,8,7,343.3016337971261,0.8780843676122931,0.19969849246231153,0.18384560044571624,127810.33631601572,-824.5005453103206,126985.8357707054,3254,0,481.0416666666667,40,8,17,38.52680067001675,0.5911458333333333,47.205284552845534,1011.1788617886189,25.27947154471547,0
3269,4,0,0,46,0.0,0.0,1.0,46,1150,700,450,0.6086956521739131,16,7,9,359.87428208309206,0.8673107890499195,0.20259596462208096,0.1916760385460686,127591.41845703125,-16.62597656250071,127574.79248046875,3255,1,502.95652173913044,39,7,17,38.33223785957314,0.5905448717948718,47.421875,1010.3125,25.90544871794872,0
3270,4,4,3,47,0.08,0.06,0.94,50,1450,1100,350,0.7586206896551724,18,11,7,336.0764310688872,0.8820068027210884,0.21062149157979126,0.18300755875235952,128479.16253552813,-1360.6474504805217,127118.5150850476,3256,0,463.64,40,10,15,38.02668070034749,0.5979166666666664,46.54471544715449,1013.8211382113848,25.34552845528462,0
3271,4,4,1,50,0.0784313725490196,0.0196078431372549,0.9803921568627451,51,1550,1100,450,0.7096774193548387,20,11,9,333.62406153640785,0.8848366013071897,0.22642882080584603,0.18399924463244519,128984.86036680773,-1593.509401543801,127391.35096526392,3257,0,455.3529411764706,43,8,20,37.57389841832139,0.5985949612403099,46.04640151515154,1015.8143939393975,23.623590556730175,0
3272,4,2,3,49,0.038461538461538464,0.057692307692307696,0.9423076923076923,52,1200,900,300,0.75,15,9,6,312.40478751944704,0.8890931372549019,0.20531767083491248,0.17140046450391275,128778.12499999997,-2353.8194444444457,126424.30555555552,3258,0,447.5576923076923,44,8,15,38.32272851669405,0.5951704545454546,46.25,1014.9999999999998,23.068181818181813,2
3273,4,1,0,50,0.02,0.0,1.0,50,1000,500,500,0.5,15,5,10,329.09262682659073,0.8842687074829931,0.22090127935841175,0.18046681536029877,128758.455208521,-1525.3083498587926,127233.1468586622,3259,0,466.34,42,8,17,37.9192922156451,0.597718253968254,46.269379844961236,1014.922480620154,24.164820967146525,0
3274,4,2,2,50,0.038461538461538464,0.038461538461538464,0.9615384615384616,52,1600,1000,600,0.625,22,10,12,316.7496211724303,0.8927224736048265,0.2249050628573004,0.17544739628810482,129155.34830524013,-2218.0184703844034,126937.32983485573,3260,0,449.36538461538464,45,7,18,37.829338204716926,0.5976851851851852,45.87862318840578,1016.4855072463739,22.5885668276972,0
3275,4,3,3,50,0.05660377358490566,0.05660377358490566,0.9433962264150944,53,950,500,450,0.5263157894736842,14,5,9,307.79967077947526,0.8928701015965167,0.2303408577131325,0.17267056941104314,129655.65653344651,-2618.365297442249,127037.29123600427,3261,0,438.33962264150944,41,12,15,37.54992207286187,0.6082317073170733,45.38690476190475,1018.4523809523794,24.840301974448277,0
3276,4,2,1,51,0.038461538461538464,0.019230769230769232,0.9807692307692307,52,1600,1100,500,0.6875,21,11,10,311.14545614608187,0.8922825540472599,0.2411529680365294,0.1747201407589533,129694.42942130854,-2329.2335196202475,127365.19590168829,3262,0,447.65384615384613,42,10,16,37.425481988838136,0.6071428571428573,45.34883720930231,1018.6046511627884,24.252491694352106,0
3277,4,2,0,53,0.03773584905660377,0.0,1.0,53,1450,900,550,0.6206896551724138,20,9,11,322.5633547688388,0.8924770198355103,0.28169169855559706,0.17751389781794785,128898.9866780044,-2272.9152084260977,126626.0714695783,3263,0,440.1698113207547,41,12,15,37.94206721375535,0.6006097560975611,46.13095238095237,1015.4761904761893,24.767711962833886,3
3278,4,1,4,50,0.018518518518518517,0.07407407407407407,0.9259259259259259,54,850,500,350,0.5882352941176471,12,5,7,319.2500898660081,0.8928924994176567,0.2778942797530155,0.17692829861512363,129176.76150959972,-2552.0614558920784,126624.70005370764,3264,0,433.0,42,12,15,37.74405839926286,0.6019345238095237,45.85755813953488,1016.56976744186,24.204042081949048,0
3279,4,0,2,48,0.0,0.04,0.96,50,1350,900,450,0.6666666666666666,18,9,9,333.18760430740633,0.8901020408163265,0.260816408204102,0.18368505819374106,128969.02394614647,-1405.823976303786,127563.19996984268,3265,2,450.76,40,10,16,37.60109221277306,0.6028645833333333,46.0619918699187,1015.7520325203252,25.39380081300813,0
3280,4,0,1,47,0.0,0.020833333333333332,0.9791666666666666,48,1600,1100,500,0.6875,21,11,10,345.09283812645765,0.8868388002364066,0.26166196340003434,0.18946082859393396,128804.55864800341,-710.0938585069543,128094.46478949646,3266,3,470.1458333333333,39,9,16,37.4663288866085,0.6028311965811967,46.22395833333333,1015.1041666666661,26.02831196581195,0
3281,4,0,1,46,0.0,0.02127659574468085,0.9787234042553191,47,650,400,250,0.6153846153846154,9,4,5,353.6741213809654,0.8836725254394079,0.2657748967976479,0.19385750023068601,128740.17373666805,-293.58643345022347,128446.58730321782,3267,4,480.5744680851064,38,9,16,37.31423483173667,0.6038925438596492,46.28739316239316,1014.8504273504267,26.70659019343228,0
3282,4,0,0,46,0.0,0.0,1.0,46,1350,900,450,0.6666666666666666,18,9,9,343.19430049297534,0.8836956521739131,0.20609633833390095,0.1824836286198306,127523.29082657603,-446.1220003287332,127077.1688262473,3268,5,491.89130434782606,38,8,15,38.823293491291174,0.5915570175438596,47.48931623931624,1010.0427350427346,26.580071974808806,6
3283,4,3,2,47,0.061224489795918366,0.04081632653061224,0.9591836734693877,49,1300,1000,300,0.7692307692307693,16,10,6,322.68663153902077,0.8957624716553289,0.20561418683304966,0.17436557783161882,128170.8997938369,-1525.1737413051724,126645.72605253173,3269,0,462.7142857142857,39,10,17,38.68011264273221,0.5964209401709402,46.848958333333336,1012.6041666666674,25.96420940170942,0
3284,4,5,5,47,0.09615384615384616,0.09615384615384616,0.9038461538461539,52,1250,800,450,0.64,17,8,9,308.8342372359582,0.9051187782805429,0.24568494607099156,0.17115583638892948,129176.76150959972,-2421.1586781143014,126755.60283148542,3270,0,436.5,42,10,17,38.00876942140883,0.6019345238095237,45.85755813953488,1016.56976744186,24.204042081949048,0
3285,4,0,0,47,0.0,0.0,1.0,47,1850,1300,550,0.7027027027027027,24,13,11,344.01629217983833,0.8875269811902559,0.2492900519900394,0.18824262279952925,128672.41753472203,-546.9184027777972,128125.49913194423,3271,1,483.72340425531917,39,8,17,37.628336755646814,0.6014957264957267,46.35416666666666,1014.5833333333318,26.014957264957225,0
3286,4,2,1,48,0.04081632653061224,0.02040816326530612,0.9795918367346939,49,1700,1400,300,0.8235294117647058,20,14,6,327.61716415869745,0.8942743764172336,0.24655193885334503,0.18122620346500082,129102.89345592195,-1340.7352322576871,127762.15822366426,3272,0,464.9387755102041,42,7,18,37.60647088736336,0.6011904761904763,45.93023255813953,1016.2790697674404,24.19712070874858,0
3287,4,2,0,50,0.04,0.0,1.0,50,1500,1100,400,0.7333333333333333,19,11,8,326.50185765065436,0.899251700680272,0.273780687397708,0.18302076607756873,129625.34722222232,-1535.2664353103671,128090.08078691196,3273,0,456.6,39,11,18,37.10447354064375,0.611111111111111,45.41666666666667,1018.3333333333342,26.111111111111132,0
3288,4,0,1,49,0.0,0.02,0.98,50,1500,900,600,0.6,21,9,12,324.58944177508465,0.8989965986394558,0.2758904109589042,0.1826889481843427,129784.51063368049,-1574.663628472229,128209.84700520826,3274,1,457.6,39,11,18,36.991838751448235,0.6127136752136753,45.260416666666664,1018.9583333333328,26.12713675213674,0
3289,4,1,0,50,0.02,0.0,1.0,50,1350,1000,350,0.7407407407407407,17,10,7,323.7013550739057,0.8994217687074829,0.2766919091271416,0.18333334083079691,130029.26911891082,-1581.869877387791,128447.39924152303,3275,0,458.54,40,10,19,36.766598578450896,0.6135416666666667,45.020325203252035,1019.9186991869929,25.49796747967482,0
3290,4,0,1,49,0.0,0.02,0.98,50,1200,700,500,0.5833333333333334,17,7,10,325.72399418968234,0.8993877551020408,0.27532177724646334,0.18472414992519945,130081.0994199881,-1525.8929456672636,128555.20647432083,3276,1,459.54,40,10,19,36.66255728232715,0.6140625,44.96951219512195,1020.1219512195121,25.503048780487802,0
3291,4,0,0,49,0.0,0.0,1.0,49,1450,1100,350,0.7586206896551724,18,11,7,333.83644010081315,0.8973922902494331,0.2765638581037555,0.18904526229190682,130023.43885633718,-1118.687608506904,128904.75124783027,3277,2,469.7959183673469,39,10,19,36.51408180982534,0.6151175213675213,45.026041666666686,1019.8958333333363,26.15117521367529,0
3292,4,0,0,49,0.0,0.0,1.0,49,1200,1000,200,0.8333333333333334,14,10,4,335.3040547142922,0.8975340136054422,0.2761508891458575,0.19039438932907224,130129.69970703151,-1073.3968098958053,129056.30289713571,3278,3,470.7959183673469,39,10,19,36.369002041858096,0.6161858974358974,44.921875000000014,1020.312500000002,26.161858974359028,0
3293,4,2,1,50,0.0392156862745098,0.0196078431372549,0.9803921568627451,51,1250,800,450,0.64,17,8,9,322.4694915839354,0.9000653594771243,0.28355773398286677,0.1858886082724308,130714.91021050364,-1769.5502387152585,128945.35997178839,3279,0,453.29411764705884,39,12,18,36.10499219041799,0.6220619658119657,44.34895833333334,1022.604166666668,26.22061965811969,0
3294,4,0,0,50,0.0,0.0,1.0,50,1400,900,500,0.6428571428571429,19,9,10,328.889419703507,0.8975,0.2817201379454488,0.18924491023107987,130644.58832137122,-1406.4754319161311,129238.1128894551,3280,1,463.36,38,12,18,36.01190476190476,0.6230811403508771,44.417735042735046,1022.3290598290603,26.90339631129106,0
3295,4,1,0,51,0.0196078431372549,0.0,1.0,51,1050,600,450,0.5714285714285714,15,6,9,339.19775181028746,0.899248366013072,0.3084156990691871,0.19432544099037996,130475.34722222241,-1348.61111111109,129126.73611111131,3281,0,455.2549019607843,39,12,19,35.919657422512245,0.6196581196581196,44.58333333333334,1021.6666666666681,26.196581196581235,1
3296,4,0,3,48,0.0,0.058823529411764705,0.9411764705882353,51,1100,800,300,0.7272727272727273,14,8,6,342.62345865002624,0.8992156862745099,0.3168263025609672,0.19709886419644554,130635.03146701407,-1248.274739583313,129386.75672743075,3282,1,456.2549019607843,39,12,15,35.67055566877251,0.6212606837606838,44.42708333333334,1022.2916666666681,26.212606837606874,0
3297,4,1,1,48,0.02040816326530612,0.02040816326530612,0.9795918367346939,49,1450,1000,450,0.6896551724137931,19,10,9,358.49808295759726,0.8909793083900227,0.32249104021170494,0.20514546319612864,130430.54112803935,-448.1802092951742,129982.36091874418,3283,0,475.51020408163265,37,12,18,35.47212680692715,0.6227477477477478,44.62719298245614,1021.491228070175,27.607871028923647,0
3298,4,1,1,48,0.02040816326530612,0.02040816326530612,0.9795918367346939,49,1600,1200,400,0.75,20,12,8,358.6380298034592,0.8918296485260772,0.32701235000437934,0.2058193619315419,130542.57079101265,-436.4939212065239,130106.07686980613,3284,0,476.48979591836735,37,12,16,35.3549713876967,0.6238738738738738,44.51754385964912,1021.9298245614037,27.619724988146046,0
3299,4,0,1,47,0.0,0.020833333333333332,0.9791666666666666,48,1500,1200,300,0.8,18,12,6,363.88557744956825,0.8849918735224586,0.3248429579016967,0.2087166706559663,130521.37230135564,-101.03101412220684,130420.34128723344,3285,1,486.875,36,12,16,35.24240504004114,0.6255787037037036,44.5382882882883,1021.8468468468487,28.384634634634686,0
3300,4,1,1,47,0.020833333333333332,0.020833333333333332,0.9791666666666666,48,1050,700,350,0.6666666666666666,14,7,7,357.18527431155275,0.8856198286052009,0.3111554698972103,0.20578948545361037,130694.03863322789,-263.60279198116183,130430.43584124673,3286,0,485.2291666666667,36,12,16,35.238619676945675,0.6273148148148149,44.36936936936937,1022.522522522523,28.403403403403416,0
3301,4,0,0,47,0.0,0.0,1.0,47,1050,700,350,0.6666666666666666,14,7,7,370.45744944729586,0.883441258094357,0.32603076952723287,0.21317593817380853,130646.86381440744,279.8207893947057,130926.68460380215,3287,3,496.5531914893617,35,12,17,34.947191403449196,0.6288690476190477,44.41550925925925,1022.3379629629618,29.20965608465605,0
3302,4,0,0,47,0.0,0.0,1.0,47,1250,800,450,0.64,17,8,9,368.16105107502864,0.8835568917668825,0.32221941263591414,0.21217892278198808,130706.03358892743,224.17414158950032,130930.20773051692,3288,4,497.5531914893617,35,12,17,34.94588285229201,0.6294642857142857,44.357638888888886,1022.5694444444441,29.21626984126983,0
3303,4,0,0,47,0.0,0.0,1.0,47,1100,500,600,0.45454545454545453,17,5,12,369.95348381736534,0.8813983965464076,0.3189419934837119,0.21435967915551385,130913.23329260964,286.3613468792779,131199.59463948893,3289,5,498.5531914893617,35,12,17,34.690021111362434,0.631547619047619,44.15509259259259,1023.3796296296289,29.23941798941797,0
3304,4,0,0,47,0.0,0.0,1.0,47,1050,600,450,0.5714285714285714,15,6,9,371.05121460898897,0.8810129509713228,0.3168709332114552,0.21549231734842447,131002.08340031284,321.6964323988219,131323.77983271168,3290,6,499.5531914893617,35,12,18,34.57190974185038,0.6324404761904763,44.06828703703703,1023.7268518518512,29.249338624338606,0
3305,4,0,0,47,0.0,0.0,1.0,47,1150,700,450,0.6086956521739131,16,7,9,373.262809262487,0.8812056737588652,0.31947833990137164,0.21744585906278777,131120.59709630048,388.4884848679574,131509.08558116845,3291,7,500.5531914893617,35,12,18,34.395247108901195,0.6336309523809525,43.95254629629629,1024.189814814814,29.262566137566118,0
3306,4,0,0,47,0.0,0.0,1.0,47,1300,800,500,0.6153846153846154,18,8,10,371.6634579479827,0.8813213074313906,0.3158484315992667,0.21684860028329556,131179.87403817294,350.9531196416271,131530.82715781458,3292,8,501.5531914893617,35,12,18,34.376176891500016,0.6342261904761906,43.894675925925924,1024.4212962962958,29.26917989417988,0
3307,4,1,1,47,0.020833333333333332,0.020833333333333332,0.9791666666666666,48,900,500,400,0.5555555555555556,13,5,8,363.0265631926787,0.8846409574468085,0.30877539503385987,0.21329014256545972,131446.7860510974,-56.18127893518496,131390.60477216222,3293,0,492.0833333333333,35,13,19,34.32750188111361,0.6369047619047619,43.63425925925926,1025.462962962963,29.2989417989418,0
3308,4,0,0,47,0.0,0.0,1.0,47,1350,800,550,0.5925925925925926,19,8,11,370.31564141746424,0.8813598519888991,0.30926531146633884,0.2174184471389652,131419.65880102038,333.351048752833,131753.00984977323,3294,10,503.5531914893617,34,13,19,34.16806958473625,0.6387867647058822,43.660714285714285,1025.3571428571427,30.157563025210077,0
3309,4,3,2,48,0.06,0.04,0.96,50,1300,1100,200,0.8461538461538461,15,11,4,349.93272744379675,0.8877551020408163,0.30662898581635933,0.20940135196174106,132144.2189543898,-751.6826090720207,131392.53634531779,3295,0,474.28,37,13,18,33.960199601862726,0.6399211711711712,42.95504385964912,1028.1798245614034,27.788643907064955,0
3310,4,0,0,48,0.0,0.0,1.0,48,1250,800,450,0.64,17,8,9,366.7267542462841,0.8829417848699763,0.32684860441326924,0.218408283664693,131963.74584043506,78.92723804886722,132042.67307848393,3296,1,495.0416666666667,36,12,18,33.71054362121877,0.6400462962962963,43.130630630630634,1027.4774774774778,28.54104104104105,0
3311,4,0,0,48,0.0,0.0,1.0,48,1300,900,400,0.6923076923076923,17,9,8,366.93506917157407,0.8822584219858156,0.3190770255960853,0.21936805805286866,132108.41912436104,95.04238190895916,132203.46150627,3297,2,496.0416666666667,36,12,18,33.55926169350423,0.6414930555555554,42.98986486486488,1028.0405405405422,28.556681681681727,0
3312,4,2,3,47,0.04,0.06,0.94,50,1400,1000,400,0.7142857142857143,18,10,8,351.6467958570413,0.8847108843537415,0.3194053344993433,0.213319952818317,132658.9004545089,-669.5504626247543,131989.34999188414,3298,0,477.16,36,14,18,33.39846596706018,0.6469907407407407,42.45495495495497,1030.1801801801828,28.61611611611619,0
3313,4,0,0,47,0.0,0.0,1.0,47,1150,700,450,0.6086956521739131,16,7,9,370.34936616974005,0.8752312673450509,0.3312905758660971,0.22240980854842254,132278.91375171483,397.882373113874,132676.79612482872,3299,1,507.21276595744683,35,12,20,33.29957995799582,0.6452380952380952,42.82407407407408,1028.7037037037048,29.391534391534424,0
3314,4,0,0,47,0.0,0.0,1.0,47,1400,1200,200,0.8571428571428571,16,12,4,371.25669983117234,0.873959296947271,0.3319838056680162,0.2236595240446332,132398.00347222228,430.8363340192093,132828.83980624148,3300,2,508.21276595744683,33,14,20,33.15620782726046,0.6508838383838383,42.708333333333336,1029.166666666667,31.186868686868696,0
3315,4,1,1,47,0.020833333333333332,0.020833333333333332,0.9791666666666666,48,1300,700,600,0.5384615384615384,19,7,12,363.2528984824206,0.8755910165484634,0.3268271305285868,0.22008852084523137,132612.5,34.37500000000034,132646.875,3301,0,498.6041666666667,34,14,20,33.14623786407766,0.650735294117647,42.5,1030.0,30.294117647058822,0
3316,4,0,0,47,0.0,0.0,1.0,47,1200,1000,200,0.8333333333333334,14,10,4,373.55303580168334,0.8717622571692877,0.3335755059678256,0.2263672145575448,132618.81134960108,508.03191681083797,133126.84326641192,3302,4,510.21276595744683,33,14,20,32.874652984334716,0.6530934343434343,42.493872549019606,1030.0245098039213,31.212863933452162,0
3317,4,0,1,46,0.0,0.02127659574468085,0.9787234042553191,47,1250,800,450,0.64,17,8,9,377.7900889874481,0.8702590194264569,0.3384271356911033,0.23009358714507083,132808.221672554,634.7259767877943,133442.9476493418,3303,5,511.21276595744683,33,14,18,32.574778068402495,0.6549873737373737,42.31004901960785,1030.75980392157,31.23514557338091,0
3318,4,0,0,46,0.0,0.0,1.0,46,1400,1000,400,0.7142857142857143,18,10,8,377.487287147611,0.8686392914653784,0.3342937172801925,0.2302973565462547,132871.3884833958,831.4519956266847,133702.84047902247,3304,6,516.9782608695652,33,13,18,32.51899342287731,0.6556186868686869,42.24877450980392,1031.0049019607843,31.242572786690435,0
3319,4,0,1,45,0.0,0.021739130434782608,0.9782608695652174,46,1250,700,550,0.56,18,7,11,374.1531142336291,0.8674315619967794,0.3271923798110452,0.2290361281821422,132997.76715986637,752.3057537966163,133750.072913663,3305,7,517.9782608695652,33,13,18,32.47779790899371,0.6568813131313131,42.12622549019608,1031.4950980392155,31.25742721330956,0
3320,4,0,1,44,0.0,0.022222222222222223,0.9777777777777777,45,1200,1100,100,0.9166666666666666,13,11,2,374.2943566803513,0.8662457912457913,0.32184527014898645,0.2293942641437003,133042.0138888888,959.3749999999907,134001.3888888888,3306,8,527.0,34,11,18,32.42965805061929,0.6550245098039216,42.08333333333333,1031.6666666666658,30.343137254901936,0
3321,4,0,0,44,0.0,0.0,1.0,44,1300,1000,300,0.7692307692307693,16,10,6,373.19732282775044,0.8637464763918252,0.3151316392991468,0.22971338318155307,133203.2606336804,1142.2200520833107,134345.4806857637,3307,9,533.4318181818181,35,9,18,32.295871173898405,0.6544642857142857,41.92708333333332,1032.2916666666654,29.49404761904758,0
3322,4,1,2,43,0.022222222222222223,0.044444444444444446,0.9555555555555556,45,900,600,300,0.6666666666666666,12,6,6,362.5540703235549,0.8661616161616162,0.3014506502233292,0.2249756052272657,133503.8825962371,681.2890099360925,134185.1716061732,3308,0,522.5555555555555,33,12,18,32.26893849559272,0.6619318181818181,41.63602941176471,1033.4558823529417,31.31684491978611,0
3323,4,0,0,43,0.0,0.0,1.0,43,1750,1500,250,0.8571428571428571,20,15,5,374.49030370669334,0.8647563676633444,0.3075748773644631,0.23199687308741496,133442.324205354,1394.5713037980045,134836.895509152,3309,11,540.4418604651163,35,8,18,32.02235260072439,0.6568452380952381,41.69560185185185,1033.217592592592,29.520502645502628,0
3324,4,0,0,43,0.0,0.0,1.0,43,1700,1500,200,0.8823529411764706,19,15,4,375.76735432528494,0.863095238095238,0.3106020154281359,0.23379810769114268,133602.72548719536,1440.7185843334628,135043.44407152882,3310,12,541.4418604651163,32,11,19,31.828336183032086,0.6653645833333333,41.54040404040405,1033.8383838383852,32.30744949494954,0
3325,4,0,0,43,0.0,0.0,1.0,43,1000,500,500,0.5,15,5,10,373.0025026459327,0.8623108157991879,0.30602424249105664,0.23245163348053038,133662.24078479433,1371.2700643983117,135033.51084919262,3311,13,542.4418604651163,33,10,19,31.840088488583394,0.663510101010101,41.4828431372549,1034.0686274509806,31.33541295306002,0
3326,4,0,1,42,0.0,0.023255813953488372,0.9767441860465116,43,1050,800,250,0.7619047619047619,13,8,5,369.03343303114184,0.8614802510151347,0.30111898976876406,0.23076890678880732,133788.99491782006,1274.522419261822,135063.5173370819,3312,14,543.4418604651163,33,10,17,31.81562425965411,0.6647727272727273,41.36029411764706,1034.5588235294117,31.350267379679142,0
3327,4,0,0,42,0.0,0.0,1.0,42,1750,1400,350,0.8,21,14,7,378.5241824577812,0.8603368176538908,0.3009450576275914,0.23655595933459952,133765.944243572,1726.7289370982405,135492.67318067024,3313,15,553.3809523809524,32,10,17,31.593280849505675,0.6669921875,41.38257575757575,1034.4696969696963,32.32717803030301,0
3328,4,0,0,42,0.0,0.0,1.0,42,1050,800,250,0.7619047619047619,13,8,5,380.12855038812916,0.8585946573751452,0.3000278779642116,0.23882559269212805,133961.93827479333,1784.551480716243,135746.48975550957,3314,16,554.3809523809524,32,10,17,31.355195755579942,0.6689453125,41.19318181818181,1035.2272727272723,32.35085227272726,0
3329,4,0,0,42,0.0,0.0,1.0,42,650,200,450,0.3076923076923077,11,2,9,381.8176680547295,0.8574090205187767,0.30252613240418147,0.24010006733502923,133994.617896133,1832.3025073972003,135826.92040353018,3315,17,555.3809523809524,32,10,17,31.278709349593495,0.6692708333333334,41.16161616161616,1035.3535353535349,32.354797979797965,0
3330,4,0,0,42,0.0,0.0,1.0,42,900,500,400,0.5555555555555556,13,5,8,381.36419693257886,0.856392760356175,0.30715591538260645,0.2408847756606475,134158.07578627186,1832.6173668503284,135990.69315312218,3316,18,556.3809523809524,32,10,17,31.12659963436929,0.6708984375,41.00378787878788,1035.984848484849,32.37452651515153,0
3331,4,0,0,42,0.0,0.0,1.0,42,1000,600,400,0.6,14,6,8,383.56746844776507,0.8550861401471157,0.30488950756916666,0.24336081267049076,134321.63331547793,1904.2817697173655,136225.9150851953,3317,19,557.3809523809524,32,10,18,30.905653674380837,0.6725260416666667,40.84595959595959,1036.616161616161,32.39425505050503,0
3332,4,0,0,42,0.0,0.0,1.0,42,1200,700,500,0.5833333333333334,17,7,10,385.69751860623364,0.854239256678281,0.30295741125234277,0.24561009029078634,134455.4396896624,1971.8258902825578,136427.26557994494,3318,20,558.3809523809524,33,9,18,30.716427389814495,0.6714015151515154,40.71691176470587,1037.1323529411745,31.42825311942953,0
3333,4,0,0,42,0.0,0.0,1.0,42,1000,500,500,0.5,15,5,10,382.7643725300912,0.8542150600077429,0.30045003234607526,0.24416732580762746,134518.99697532176,1897.8158941272304,136416.812869449,3319,21,559.3809523809524,33,9,18,30.72885902736759,0.6720328282828284,40.65563725490195,1037.3774509803902,31.435680332739096,0
3334,4,0,0,42,0.0,0.0,1.0,42,1100,400,700,0.36363636363636365,18,4,14,383.92823616152543,0.8530294231513744,0.3034497381041974,0.24626386379049403,134719.69816419802,1944.5467276098273,136664.24489180784,3320,22,560.3809523809524,31,11,19,30.497852125925,0.6790994623655915,40.46223958333333,1038.1510416666658,33.48874327956987,0
3335,4,0,0,42,0.0,0.0,1.0,42,600,400,200,0.6666666666666666,8,4,4,386.70676020036063,0.8515050329074719,0.3050819124038786,0.24873976769016726,134821.09917534713,2027.24609374999,136848.34526909713,3321,23,561.3809523809524,31,11,17,30.324306252089613,0.6801075268817205,40.36458333333333,1038.5416666666658,33.501344086021476,0
3336,4,0,0,42,0.0,0.0,1.0,42,1050,500,550,0.47619047619047616,16,5,11,392.4951708850094,0.8514324428958575,0.3187084086977592,0.24735098353088839,134074.41135921283,2124.7117995482527,136199.12315876107,3322,24,562.3809523809524,33,9,18,30.92225279059677,0.6676136363636364,41.08455882352941,1035.6617647058824,31.383689839572195,2
3337,4,0,0,42,0.0,0.0,1.0,42,900,500,400,0.5555555555555556,13,5,8,393.2487884591566,0.8513598528842431,0.31726500349311526,0.24804020597438742,134106.14306997307,2147.4156574394483,136253.5587274125,3323,25,563.3809523809524,33,9,18,30.87089840668875,0.6679292929292928,41.05392156862745,1035.7843137254902,31.387403446226976,0
3338,4,0,0,42,0.0,0.0,1.0,42,1500,1300,200,0.8666666666666667,17,13,4,392.537946571423,0.8502226093689508,0.3125538565514909,0.24823547780563834,134201.3607296474,2135.825313581329,136337.18604322872,3324,26,564.3809523809524,33,9,18,30.793785728365858,0.6688762626262625,40.962009803921575,1036.1519607843147,31.398544266191355,0
3339,4,0,0,42,0.0,0.0,1.0,42,1200,900,300,0.75,15,9,6,397.9168043527436,0.8496660859465738,0.3176976902594588,0.25251149647560855,134328.3701731307,2290.3031586409306,136618.67333177163,3325,27,565.3809523809524,33,9,18,30.527027426409738,0.6701388888888888,40.83946078431374,1036.6421568627466,31.413398692810503,0
3340,4,0,0,42,0.0,0.0,1.0,42,1550,1200,350,0.7741935483870968,19,12,7,397.9514259883289,0.8487224157955865,0.31469979296066275,0.2536341016238869,134487.21645520956,2303.875913110345,136791.09236831992,3326,28,566.3809523809524,33,9,19,30.36684782608696,0.6717171717171717,40.68627450980392,1037.2549019607845,31.43196672608438,0
3341,4,0,0,42,0.0,0.0,1.0,42,650,300,350,0.46153846153846156,10,3,7,400.79998709698197,0.8481900890437476,0.31870338496844464,0.25589537637730414,134550.78125000015,2385.590277777793,136936.37152777793,3327,29,567.3809523809524,33,9,19,30.229250334672027,0.6723484848484848,40.62500000000001,1037.5000000000011,31.439393939393973,0
3342,4,0,0,42,0.0,0.0,1.0,42,800,500,300,0.625,11,5,6,400.22769208915776,0.8476093689508324,0.31743667548615107,0.2560197191897586,134620.51474520168,2375.7715848652974,136996.28633006697,3328,30,568.3809523809524,30,12,19,30.174200233130428,0.6809027777777779,40.55779569892473,1037.7688172043006,34.59229390681002,0
3343,4,0,0,42,0.0,0.0,1.0,42,1250,800,450,0.64,17,8,9,400.9019807936425,0.8459639953542393,0.3140680589210958,0.25694323632110366,134690.26630607576,2399.518911145787,137089.78521722154,3329,31,569.3809523809524,30,12,19,30.086807803530576,0.6815972222222222,40.49059139784946,1038.0376344086014,34.60125448028671,0
3344,4,0,0,42,0.0,0.0,1.0,42,1750,1400,350,0.8,21,14,7,405.0168449751952,0.8439556716995741,0.32051803509031407,0.2605799468046072,134829.82362484097,2521.669954619023,137351.49357946,3330,32,570.3809523809524,30,12,17,29.840170829558673,0.6829861111111113,40.35618279569892,1038.575268817204,34.61917562724013,0
3345,4,1,0,43,0.023255813953488372,0.0,1.0,43,1100,900,200,0.8181818181818182,13,9,4,397.2062389364338,0.8457918050941307,0.32559833330510357,0.25846642941219117,135239.39680899904,2143.586432506885,137382.98324150592,3331,0,558.0930232558139,32,11,18,29.633254430687067,0.681640625,39.96212121212121,1040.1515151515148,32.50473484848484,0
3346,4,0,0,43,0.0,0.0,1.0,43,1550,900,650,0.5806451612903226,22,9,13,400.7074126345177,0.8441768180140273,0.33456385763892715,0.26175441139171685,135378.49024413666,2249.4329104190388,137627.9231545557,3332,1,559.0930232558139,33,10,18,29.403163761972046,0.6805555555555557,39.828431372549005,1040.6862745098022,31.53594771241825,0
3347,4,1,0,44,0.022727272727272728,0.0,1.0,44,1200,700,500,0.5833333333333334,17,7,10,388.94298141814306,0.8449392177589853,0.32272299616178235,0.2565696020945284,135729.43887266918,1758.4428164648234,137487.881689134,3333,0,547.3636363636364,33,11,20,29.35912325061743,0.6840277777777778,39.49142156862745,1042.0343137254904,31.57679738562092,0
3348,4,0,0,44,0.0,0.0,1.0,44,950,700,250,0.7368421052631579,12,7,5,386.6549358690619,0.8431994362226921,0.3144816568173803,0.2559745945088023,135857.16919273837,1705.9690083141072,137563.13820105247,3334,1,548.3636363636364,33,11,21,29.29144136201559,0.6852904040404041,39.368872549019606,1042.5245098039215,31.59165181224005,0
3349,4,0,0,44,0.0,0.0,1.0,44,800,500,300,0.625,11,5,6,384.0419993896726,0.8417679704016914,0.3048552505074249,0.2549295955386981,135953.00635572837,1642.3328767781418,137595.33923250652,3335,2,549.3636363636364,33,11,15,29.264101057579317,0.6862373737373739,39.276960784313715,1042.8921568627436,31.602792632204352,0
3350,4,0,2,42,0.0,0.045454545454545456,0.9545454545454546,44,1050,600,450,0.5714285714285714,15,6,9,384.38105072361384,0.8406888653981678,0.30273838004101195,0.25561339873120287,136016.9165705496,1656.4650615147793,137673.38163206438,3336,3,550.3636363636364,33,11,15,29.191631422305765,0.686868686868687,39.21568627450979,1043.1372549019593,31.610219845513917,0
3351,4,0,0,42,0.0,0.0,1.0,42,1400,1100,300,0.7857142857142857,17,11,6,408.7091362173628,0.8380274874177314,0.2726784755770262,0.25637209453634574,133903.125,2547.303320838139,136450.42832083814,3337,6,519.2380952380952,34,8,16,30.674651100375737,0.6636029411764706,41.25,1035.0,30.441176470588236,7
3352,4,0,0,42,0.0,0.0,1.0,42,500,400,100,0.8,6,4,2,407.0087461317649,0.8374467673248162,0.2722548769060398,0.25563807762658036,133951.04595336074,2503.849451303152,136454.8954046639,3338,7,520.2380952380952,35,7,16,30.67046809779367,0.6619047619047618,41.2037037037037,1035.185185185185,29.576719576719572,0
3353,4,0,1,41,0.0,0.023809523809523808,0.9761904761904762,42,1100,700,400,0.6363636363636364,15,7,8,410.00813521685643,0.8361401471157569,0.2756987461949467,0.25836287281129783,134070.88584533596,2594.030778463633,136664.9166237996,3339,8,521.2380952380952,35,7,16,30.472358813887638,0.6630952380952382,41.087962962962955,1035.6481481481471,29.58994708994706,0
3354,4,0,0,41,0.0,0.0,1.0,41,950,600,350,0.631578947368421,13,6,7,413.7661171331979,0.8308434959349593,0.29217257681889297,0.26041517270799985,134026.3676303856,2891.113945578244,136917.48157596384,3340,9,533.8780487804878,34,7,16,30.41982831302215,0.664828431372549,41.13095238095239,1035.4761904761913,30.455182072829157,0
3355,4,0,0,41,0.0,0.0,1.0,41,1200,800,400,0.6666666666666666,16,8,8,411.24097852982004,0.8282012195121952,0.28846719818431965,0.2596434977004677,134142.16739966316,2832.9512367096795,136975.11863637285,3341,10,534.8780487804878,36,5,17,30.36879008587889,0.6617476851851851,41.01914414414414,1035.9234234234234,28.77565065065065,0
3356,4,0,0,41,0.0,0.0,1.0,41,650,300,350,0.46153846153846156,10,3,7,409.25756143667314,0.8282012195121952,0.28589607635206793,0.2585968107978977,134171.33349565775,2782.126552227896,136953.46004788563,3342,11,535.8780487804878,36,5,17,30.39085144927536,0.6620370370370371,40.99099099099099,1036.0360360360355,28.778778778778765,0
3357,4,0,0,41,0.0,0.0,1.0,41,850,600,250,0.7058823529411765,11,6,5,405.0351682259453,0.8274390243902439,0.28304871424596945,0.25695029107648704,134317.21153163293,2680.6388736709655,136997.8504053039,3343,12,536.8780487804878,36,5,18,30.35374796306355,0.6634837962962963,40.85022522522522,1036.5990990990988,28.794419419419413,0
3358,4,0,0,41,0.0,0.0,1.0,41,1150,700,450,0.6086956521739131,16,7,9,405.24749751139916,0.8264735772357723,0.27865635155428525,0.25790768518192625,134433.9710276154,2695.806067892207,137129.7770955076,3344,13,537.8780487804878,36,5,18,30.23106924385565,0.6646412037037037,40.73761261261261,1037.049549549549,28.806931931931917,0
3359,4,0,0,41,0.0,0.0,1.0,41,1300,900,400,0.6923076923076923,17,9,8,407.2514959436139,0.8259146341463415,0.28171221471250885,0.26001441664092273,134550.78125,2759.302841693045,137310.08409169305,3345,14,538.8780487804878,34,7,18,30.061914323962515,0.6700367647058822,40.625,1037.5,30.514705882352942,0
3360,4,0,0,41,0.0,0.0,1.0,41,1150,700,450,0.6086956521739131,16,7,9,411.79851233061197,0.8250508130081301,0.27998433654061317,0.2640355167296276,134705.2154195011,2894.2814625850306,137599.49688208612,3346,15,539.8780487804878,34,7,18,29.7890386085627,0.6715686274509804,40.476190476190474,1038.0952380952378,30.532212885154053,0
3361,4,0,0,41,0.0,0.0,1.0,41,1350,1000,350,0.7407407407407407,17,10,7,407.73064260556146,0.8238821138211382,0.2751275421063668,0.2625424248511827,134859.73816609982,2797.2895408163336,137657.02770691615,3347,16,540.8780487804878,34,7,15,29.73973256924546,0.6731004901960784,40.327380952380956,1038.6904761904766,30.549719887955195,0
3362,4,0,0,41,0.0,0.0,1.0,41,1250,700,550,0.56,18,7,11,413.0796754880075,0.8229674796747968,0.27125415584052703,0.2671248568155785,135014.3494897961,2954.3367346938962,137968.68622449,3348,17,541.8780487804878,34,7,15,29.4458762886598,0.6746323529411763,40.17857142857144,1039.2857142857156,30.56722689075634,0
3363,4,0,0,41,0.0,0.0,1.0,41,1450,1100,350,0.7586206896551724,18,11,7,411.4153425682289,0.821849593495935,0.2703398658857763,0.26673275327753126,135107.15880102056,2917.031604308407,138024.19040532896,3349,18,542.8780487804878,34,7,15,29.396160158784692,0.6755514705882353,40.08928571428572,1039.6428571428582,30.577731092437006,0
3364,4,0,0,41,0.0,0.0,1.0,41,850,800,50,0.9411764705882353,9,8,1,415.29038741366764,0.8212906504065041,0.27207617239309223,0.2697071772534116,135169.04939058956,3026.8813775510203,138195.93076814056,3350,19,543.8780487804878,34,7,15,29.233447815302426,0.6761642156862745,40.029761904761905,1039.8809523809523,30.58473389355742,0
3365,4,0,0,41,0.0,0.0,1.0,41,1200,900,300,0.75,15,9,6,419.2471974249514,0.8205792682926829,0.27588902126920445,0.2728294397724866,135242.1329116298,3139.9770393947183,138382.10995102453,3351,20,544.8780487804878,35,6,15,29.05736526835058,0.6747023809523809,39.95949074074074,1040.1620370370372,29.71891534391535,0
3366,4,0,0,41,0.0,0.0,1.0,41,1200,1000,200,0.8333333333333334,14,10,4,420.7799792378384,0.8207825203252033,0.27664342494370486,0.27451465989464185,135332.43982553147,3189.036243998625,138521.4760695301,3352,21,545.8780487804878,35,6,15,28.92704857248796,0.6755952380952381,39.87268518518518,1040.5092592592587,29.728835978835964,0
3367,4,0,0,41,0.0,0.0,1.0,41,1200,800,400,0.6666666666666666,16,8,8,419.30267602809454,0.8198678861788617,0.2694396616006187,0.2746997502456451,135483.01832829634,3161.6784282835943,138644.69675657994,3353,22,546.8780487804878,35,6,15,28.81473503798406,0.6770833333333334,39.72800925925925,1041.087962962962,29.745370370370342,0
3368,4,0,0,41,0.0,0.0,1.0,41,700,500,200,0.7142857142857143,9,5,4,419.30267602809454,0.8198678861788617,0.2694396616006187,0.2746997502456451,135483.01832829634,3161.6784282835943,138644.69675657994,3354,23,547.8780487804878,35,6,15,28.81473503798406,0.6770833333333334,39.72800925925925,1041.087962962962,29.745370370370342,0
3369,4,0,0,41,0.0,0.0,1.0,41,700,600,100,0.8571428571428571,8,6,2,418.718072573442,0.819359756097561,0.2632205039472253,0.27479673648592073,135545.71621875273,3151.088208140593,138696.80442689333,3355,24,548.8780487804878,36,5,15,28.767212789733605,0.6756365740740741,39.6677927927928,1041.3288288288304,28.925800800800843,0
3370,4,0,1,40,0.0,0.024390243902439025,0.975609756097561,41,850,600,250,0.7058823529411765,11,6,5,417.286988452006,0.8184451219512195,0.2635454468731535,0.2740816810514314,135575.0344939535,3114.739570651748,138689.77406460527,3356,25,549.8780487804878,36,5,15,28.775140570934262,0.6759259259259258,39.63963963963965,1041.4414414414423,28.928928928928954,0
3371,4,0,0,40,0.0,0.0,1.0,40,1050,700,350,0.6666666666666666,14,7,7,419.75092712268264,0.818616452991453,0.2531586842982554,0.27591954661629076,135603.5414121442,3383.9424457733207,138987.4838579175,3357,26,559.8,35,5,15,28.682469348446123,0.6782738095238094,39.61226851851852,1041.5509259259259,29.758597883597883,0
3372,4,0,0,40,0.0,0.0,1.0,40,1300,1000,300,0.7692307692307693,16,10,6,398.9457280639401,0.8177617521367522,0.27316481174520524,0.2503339984567636,133915.80912389458,2729.4019759508983,136645.21109984547,3358,27,560.8,33,7,18,30.91453548030626,0.6660353535353536,41.23774509803921,1035.0490196078426,31.365121806298262,5
3373,4,1,1,40,0.024390243902439025,0.024390243902439025,0.975609756097561,41,1000,700,300,0.7,13,7,6,403.42277086674596,0.8221544715447154,0.26057106595513657,0.24792011356435376,133143.5282305598,2542.6262163494494,135686.15444690926,3359,0,548.0975609756098,35,6,16,31.57603921348735,0.6538690476190476,41.9849537037037,1032.060185185185,29.487433862433857,4
3374,4,0,1,39,0.0,0.025,0.975,40,950,600,350,0.631578947368421,13,6,7,410.184046087972,0.8190438034188035,0.26713774803876333,0.2518042005304915,133103.42970521533,2919.38066893423,136022.81037414956,3360,1,560.225,34,6,16,31.44203776342101,0.6556372549019608,42.02380952380952,1031.9047619047612,30.35014005602239,0
3375,4,0,0,39,0.0,0.0,1.0,39,650,400,250,0.6153846153846154,9,4,5,418.6103458830732,0.8184322986954566,0.27143227143227144,0.25581743359521125,132934.5703124999,3329.557291666653,136264.12760416657,3361,2,511.5897435897436,33,6,16,31.395202020202007,0.65625,42.18749999999999,1031.2499999999993,31.24999999999998,0
3376,4,0,0,39,0.0,0.0,1.0,39,1300,1000,300,0.7692307692307693,16,10,6,422.75207203750824,0.817757534862798,0.26935866983372914,0.25944405587141545,133092.59059015766,3453.033688965791,136545.62427912344,3362,3,512.5897435897435,33,6,16,31.128760886777528,0.6578282828282829,42.0343137254902,1031.8627450980396,31.268568033273926,0
3377,4,0,0,39,0.0,0.0,1.0,39,1150,700,450,0.6086956521739131,16,7,9,422.90264311543734,0.816183085919928,0.26964786974285904,0.25997708469476016,133155.82498317957,3462.3900663206523,136618.21504950023,3363,4,513.5897435897435,33,6,16,31.061010844613314,0.6584595959595959,41.97303921568628,1032.1078431372553,31.27599524658349,0
3378,4,0,0,39,0.0,0.0,1.0,39,650,600,50,0.9230769230769231,7,6,1,422.2091849155699,0.8164642375168691,0.26930470529086437,0.25961373285233996,133164.8596938777,3444.685374149676,136609.54506802736,3364,5,514.5897435897435,34,5,16,31.069780853517887,0.65625,41.96428571428572,1032.1428571428582,30.35714285714289,0
3379,4,0,0,39,0.0,0.0,1.0,39,800,500,300,0.625,11,5,6,419.5246864830272,0.8155083220872695,0.26324628630901725,0.25838906826568275,133226.30385487527,3378.3446712018144,136604.64852607707,3365,6,515.5897435897435,34,5,16,31.077029520295216,0.6568627450980392,41.904761904761905,1032.3809523809523,30.364145658263304,0
3380,4,0,0,39,0.0,0.0,1.0,39,900,600,300,0.6666666666666666,12,6,6,417.6804304025544,0.8147210976158344,0.2589764284679541,0.2574656981436643,133257.03125000012,3331.770833333348,136588.80208333346,3366,7,516.5897435897435,34,5,16,31.093623890234053,0.6571691176470588,41.87500000000001,1032.500000000001,30.367647058823557,0
3381,4,0,1,38,0.0,0.02564102564102564,0.9743589743589743,39,1700,1300,400,0.7647058823529411,21,13,8,409.5058091397485,0.8147210976158344,0.25670326182170045,0.24732266733163374,132492.61289227701,3051.6461517204934,135544.2590439975,3367,8,517.5897435897435,33,6,18,32.07641451414514,0.6518308080808082,42.61642156862745,1029.5343137254902,31.198009506833035,1
3382,4,1,2,37,0.02564102564102564,0.05128205128205128,0.9487179487179487,39,1100,700,400,0.6363636363636364,15,7,8,415.8578188895339,0.8203441295546559,0.2601081292180769,0.25179172261870636,132587.25610342188,3227.4894271434187,135814.7455305653,3368,0,517.6410256410256,33,6,18,31.817190226876086,0.6527777777777777,42.524509803921575,1029.9019607843145,31.20915032679741,0
3383,4,0,0,37,0.0,0.0,1.0,37,900,600,300,0.6666666666666666,12,6,6,428.2974643085443,0.8118743743743744,0.26042236568552335,0.258023106546855,132398.00347222236,3941.1458333333517,136339.1493055557,3369,10,530.4054054054054,33,4,18,31.688596491228072,0.6508838383838382,42.70833333333334,1029.1666666666679,31.186868686868724,0
3384,4,0,0,37,0.0,0.0,1.0,37,750,500,250,0.6666666666666666,10,5,5,430.00305387104976,0.8119369369369369,0.26224453870843156,0.259742868369625,132498.52710300026,3994.954257541238,136493.4813605415,3370,11,531.4054054054054,31,6,18,31.542857594536482,0.6569220430107526,42.610677083333336,1029.557291666667,33.211525537634415,0
3385,4,0,1,36,0.0,0.02702702702702703,0.972972972972973,37,1200,1000,200,0.8333333333333334,14,10,4,428.29260380622844,0.8103728728728729,0.26293720190779046,0.26003479516806727,132690.54178145083,3966.0755280073417,136656.61730945818,3371,12,532.4054054054054,32,5,17,31.392463235294112,0.65625,42.42424242424242,1030.30303030303,32.19696969696969,0
3386,4,1,0,37,0.02702702702702703,0.0,1.0,37,950,700,250,0.7368421052631579,12,7,5,418.08711814921895,0.811498998998999,0.24903758383934593,0.25650209681046693,133081.09504132243,3727.8983011937735,136808.99334251622,3372,0,524.027027027027,32,5,18,31.26070729319629,0.66015625,42.045454545454554,1031.818181818183,32.244318181818215,0
3387,4,0,0,37,0.0,0.0,1.0,37,900,600,300,0.6666666666666666,12,6,6,416.1407062167372,0.8118743743743744,0.2451609916743267,0.2557544460613242,133146.24304917877,3681.514322518124,136827.7573716969,3373,1,525.027027027027,32,5,18,31.245157409672963,0.6608072916666666,41.98232323232324,1032.0707070707078,32.25220959595962,0
3388,4,0,0,37,0.0,0.0,1.0,37,900,600,300,0.6666666666666666,12,6,6,416.1306287349547,0.8124374374374375,0.2470419042896106,0.2559720007455424,133178.82303145103,3683.9574724518097,136862.78050390285,3374,2,526.027027027027,32,5,18,31.212538226299692,0.6611328125,41.950757575757585,1032.1969696969709,32.25615530303034,0
3389,4,0,0,37,0.0,0.0,1.0,37,1050,800,250,0.7619047619047619,13,8,5,379.2756879760864,0.8119369369369369,0.21798188244687622,0.21557874769807991,130168.77710796327,2473.970498125718,132642.747606089,3375,3,527.027027027027,33,4,20,35.2076328009287,0.6284722222222222,44.88357843137255,1020.4656862745096,30.92320261437908,8
3390,4,0,0,37,0.0,0.0,1.0,37,1050,500,550,0.47619047619047616,16,5,11,382.6627137503025,0.8119369369369369,0.21731949262265005,0.2178535709382277,130231.31315179267,2566.9335411860925,132798.24669297875,3376,4,528.027027027027,33,4,20,35.057604954576384,0.6291035353535352,44.82230392156863,1020.7107843137261,30.93062982768867,0
3391,4,0,0,37,0.0,0.0,1.0,37,900,700,200,0.7777777777777778,11,7,4,380.0220121435586,0.8108733733733734,0.21315577245186978,0.21689465933259028,130329.05578613294,2505.5895132543815,132834.64529938734,3377,5,529.027027027027,31,6,20,35.02560996344469,0.6350806451612903,44.72656250000001,1021.093750000001,32.938508064516164,0
3392,4,1,1,37,0.02631578947368421,0.02631578947368421,0.9736842105263158,38,600,300,300,0.5,9,3,6,369.99375206409934,0.8202939781887151,0.20586399282119294,0.21239215809977458,130552.7576905419,2060.740932047765,132613.49862258966,3378,0,516.078947368421,32,6,16,35.054515690635036,0.634765625,44.507575757575765,1021.9696969696978,31.936553030303056,0
3393,4,1,1,37,0.02631578947368421,0.02631578947368421,0.9736842105263158,38,700,300,400,0.42857142857142855,11,3,8,371.9884756629983,0.817952821242295,0.20564940891888717,0.2135372143273979,130552.7576905419,2112.824265381098,132665.581955923,3379,0,517.0526315789474,32,6,16,35.003552013837414,0.634765625,44.507575757575765,1021.9696969696978,31.936553030303056,0
3394,4,0,0,37,0.0,0.0,1.0,37,1050,700,350,0.6666666666666666,14,7,7,384.79323247720964,0.8097472472472472,0.22470176598616964,0.22074980178955728,130528.5644531251,2645.3016493055707,133173.86610243068,3380,8,532.027027027027,31,6,16,34.700985389058786,0.6370967741935483,44.53125000000001,1021.8750000000008,32.96370967741938,0
3395,4,1,1,37,0.02631578947368421,0.02631578947368421,0.9736842105263158,38,900,600,300,0.6666666666666666,12,6,6,371.30350833815817,0.8165303461356093,0.2121113765133702,0.21518081874614575,130920.20083922053,2122.225976787775,133042.42681600832,3381,0,519.0,33,5,16,34.64842034886042,0.6360479797979798,44.14828431372549,1023.4068627450984,31.01232917409389,0
3396,4,0,1,36,0.0,0.02702702702702703,0.972972972972973,37,900,600,300,0.6666666666666666,12,6,6,380.99549187747584,0.8088088088088088,0.22328153875919843,0.2201730010835457,130810.95838434855,2567.677086521784,133378.63547087033,3382,10,534.027027027027,32,5,17,34.51128322224964,0.6373697916666666,44.255050505050505,1022.9797979797981,31.968118686868692,0
3397,4,0,0,36,0.0,0.0,1.0,36,700,400,300,0.5714285714285714,10,4,6,391.52513104931364,0.8026455026455027,0.22912378913860754,0.22550288131133311,130681.82615294364,3033.0438220589817,133714.86997500263,3383,11,549.2222222222222,32,4,17,34.37319914382152,0.6360677083333333,44.381313131313135,1022.474747474748,31.952335858585876,0
3398,4,1,0,37,0.02702702702702703,0.0,1.0,37,700,500,200,0.7142857142857143,9,5,4,390.2531993315171,0.8112487487487487,0.25155825682141475,0.22782938173264544,131202.5422914263,2840.4423779315566,134042.98466935786,3384,0,535.3513513513514,33,4,18,33.877093301435394,0.638888888888889,43.87254901960784,1024.5098039215682,31.045751633986914,0
3399,4,1,1,37,0.02631578947368421,0.02631578947368421,0.9736842105263158,38,900,700,200,0.7777777777777778,11,7,4,378.6023564394718,0.8133297771455666,0.2358233078214711,0.22266501201981304,131485.18786344194,2356.1804654459775,133841.3683288879,3385,0,522.2368421052631,33,5,18,33.88932867327836,0.641729797979798,43.59681372549019,1025.612745098039,31.079174093879974,0
3400,4,0,0,37,0.0,0.0,1.0,37,900,600,300,0.6666666666666666,12,6,6,388.9020811730475,0.8112487487487487,0.24525720448863741,0.2279780503280846,131360.48179076106,2817.272950464231,134177.75474122528,3386,2,537.3513513513514,32,5,18,33.75159091842182,0.6429036458333335,43.71843434343434,1025.126262626262,32.035195707070685,0
3401,4,1,0,38,0.02631578947368421,0.0,1.0,38,750,600,150,0.8,9,6,3,379.53121701373175,0.8162339971550497,0.24271240556610074,0.22413218697270704,131642.3445910225,2392.475850634347,134034.82044165683,3387,0,524.1842105263158,33,5,18,33.70651222036462,0.6433080808080809,43.44362745098038,1026.2254901960769,31.097742127153843,0
3402,4,0,0,38,0.0,0.0,1.0,38,650,500,150,0.7692307692307693,8,5,3,382.80104623742454,0.8166192508297772,0.2412024151341705,0.2266236299880499,131736.68368235775,2485.788068291043,134222.47175064878,3388,1,525.1842105263158,33,5,18,33.5271925112411,0.6442550505050505,43.35171568627451,1026.593137254902,31.108882947118246,0
3403,4,0,0,38,0.0,0.0,1.0,38,850,600,250,0.7058823529411765,11,6,5,382.844611580381,0.8169155998103367,0.24089890039500372,0.22740047410738287,131862.52170138885,2496.571180555551,134359.0928819444,3389,2,526.1842105263158,33,5,18,33.39883367139959,0.6455176767676768,43.229166666666664,1027.083333333333,31.123737373737363,0
3404,4,0,2,36,0.0,0.05263157894736842,0.9473684210526316,38,850,700,150,0.8235294117647058,10,7,3,383.13552693203684,0.8165599810336652,0.23861260571206144,0.22795068291492285,131925.4632382977,2509.066374711643,134434.52961300933,3390,3,527.1842105263158,33,5,18,33.32774165970814,0.6461489898989898,43.16789215686274,1027.3284313725485,31.131164587046925,0
3405,4,1,0,37,0.02702702702702703,0.0,1.0,37,900,500,400,0.5555555555555556,13,5,8,379.3526178184135,0.816504004004004,0.20110529977069524,0.2273947977665804,132208.88600538252,2630.757400999613,134839.64340638212,3391,0,428.13513513513516,33,4,19,33.13870352716873,0.648989898989899,42.8921568627451,1028.4313725490194,31.16458704693998,0
3406,4,0,1,36,0.0,0.02702702702702703,0.972972972972973,37,900,600,300,0.6666666666666666,12,6,6,366.1601056114792,0.8168793793793794,0.17053324338092524,0.21078366196930587,130661.65500217001,2168.8874077127593,132830.54240988276,3392,1,429.13513513513516,31,6,18,35.042027508914934,0.6384408602150538,44.40104166666666,1022.3958333333322,32.98051075268814,5
3407,4,0,0,36,0.0,0.0,1.0,36,750,500,250,0.6666666666666666,10,5,5,375.10552790044505,0.8135582010582011,0.18352626501797764,0.21504918726238187,130502.8128251821,2590.4652994565818,133093.2781246387,3393,6,442.02777777777777,30,6,18,34.97462290625275,0.6395833333333334,44.556451612903224,1021.7741935483871,34.05913978494623,0
3408,4,1,1,36,0.02702702702702703,0.02702702702702703,0.972972972972973,37,1050,700,350,0.6666666666666666,14,7,7,368.6282278796564,0.8140640640640641,0.1719013835059131,0.21348925887297143,130894.72664727113,2250.298224555127,133145.02487182626,3394,0,431.05405405405406,31,6,18,34.74267824574796,0.6407930107526882,44.173177083333336,1023.3072916666673,33.00991263440862,0
3409,4,1,1,36,0.02702702702702703,0.02702702702702703,0.972972972972973,37,1050,800,250,0.7619047619047619,13,8,5,368.99587726611924,0.8186936936936937,0.1821205821205818,0.21481514246469494,131094.66764662007,2274.678378634988,133369.34602525507,3395,0,432.02702702702703,31,6,18,34.53075333757151,0.6428091397849462,43.977864583333336,1024.0885416666672,33.035114247311846,0
3410,4,0,0,36,0.0,0.0,1.0,36,1400,1200,200,0.8571428571428571,16,12,4,382.1491549691765,0.8106481481481482,0.19753792694296157,0.22266557429537334,131128.0059814452,2822.0913357204727,133950.09731716567,3396,9,445.02777777777777,31,5,19,34.16020425459786,0.6431451612903226,43.94531249999999,1024.218749999999,33.039314516129004,0
3411,4,0,0,36,0.0,0.0,1.0,36,650,400,250,0.6153846153846154,9,4,5,381.68329380385524,0.8101851851851852,0.19886347592827902,0.22316846376198649,131261.4017062716,2820.0568305121337,134081.45853678373,3397,10,446.02777777777777,31,5,21,34.03695468022024,0.644489247311828,43.81510416666666,1024.7395833333323,33.05611559139782,0
3412,4,0,0,36,0.0,0.0,1.0,36,1050,700,350,0.6666666666666666,14,7,7,395.3352769679298,0.8098875661375662,0.21848072562358234,0.22524916943521592,130262.58680555565,3099.496120876746,133362.0829264324,3398,11,447.02777777777777,31,5,20,34.70238095238095,0.6344086021505376,44.79166666666667,1020.8333333333342,32.93010752688175,4
3413,4,1,1,36,0.02702702702702703,0.02702702702702703,0.972972972972973,37,850,500,350,0.5882352941176471,12,5,7,383.46317026562804,0.8142517517517518,0.2071245557484087,0.21998676609975498,130528.564453125,2610.579427083333,133139.14388020834,3399,0,435.9189189189189,31,6,19,34.7349643221203,0.6370967741935484,44.53125,1021.875,32.96370967741935,0
3414,4,1,1,36,0.02702702702702703,0.02702702702702703,0.972972972972973,37,1000,700,300,0.7,13,7,6,384.6328857154447,0.8143768768768769,0.2087657083835428,0.22103720006341457,130595.10125054258,2646.2341308593795,133241.33538140196,3400,0,436.8918918918919,31,6,19,34.63747346072188,0.637768817204301,44.466145833333336,1022.135416666667,32.972110215053775,0
3415,4,2,2,36,0.05263157894736842,0.05263157894736842,0.9473684210526316,38,1250,900,350,0.72,16,9,7,378.49516015393175,0.8278212422949265,0.20029095443445755,0.21909462699196186,130875.54841342737,2307.1523313947814,133182.70074482216,3401,0,426.3421052631579,32,6,19,34.50970714050677,0.6380208333333333,44.191919191919204,1023.2323232323246,31.976010101010143,0
3416,4,0,0,36,0.0,0.0,1.0,36,1100,800,300,0.7272727272727273,14,8,6,401.72174295404426,0.810681216931217,0.22866339310506056,0.23051248390034715,130537.14889365825,3287.9221947624,133825.07108842063,3402,15,451.02777777777777,30,6,19,34.259776842474444,0.6399305555555554,44.52284946236559,1021.9086021505378,34.063620071684596,0
3417,4,0,0,36,0.0,0.0,1.0,36,1000,900,100,0.9,11,9,2,402.2683245595701,0.8103835978835979,0.2289329945087042,0.23185283433706147,130708.89698231017,3316.00979882068,134024.90678113085,3403,16,452.02777777777777,30,6,19,34.0710436382755,0.6416666666666666,44.35483870967742,1022.5806451612909,34.086021505376365,0
3418,4,0,0,36,0.0,0.0,1.0,36,600,400,200,0.6666666666666666,8,4,4,402.72827393485045,0.8108134920634921,0.231583672754347,0.23273841252225835,130812.00003251804,3336.338196612303,134148.33822913034,3404,17,453.02777777777777,30,6,19,33.954419042613765,0.6427083333333334,44.254032258064505,1022.9838709677406,34.09946236559135,0
3419,4,0,0,36,0.0,0.0,1.0,36,800,700,100,0.875,9,7,2,402.20544030947775,0.8104828042328043,0.22422537472452064,0.23285095186890142,130880.75798141405,3328.190578390566,134208.94855980462,3405,18,454.02777777777777,30,6,19,33.89788300713692,0.6434027777777778,44.18682795698925,1023.2526881720431,34.108422939068106,0
3420,4,1,0,37,0.02702702702702703,0.0,1.0,37,1000,600,400,0.6,14,6,8,391.3777087464318,0.8176301301301301,0.21746151720280094,0.22904202320798764,131295.77219480166,2877.247697938995,134173.01989274065,3406,0,442.72972972972974,32,5,21,33.75374727937251,0.6422526041666666,43.78156565656566,1024.873737373738,32.027304292929315,0
3421,4,0,0,37,0.0,0.0,1.0,37,950,400,550,0.42105263157894735,15,4,11,392.78683741768833,0.8164414414414415,0.22340465703859613,0.23026141258298274,131361.49300469283,2919.4170647185083,134280.91006941133,3407,1,443.72972972972974,31,6,21,33.651006604852036,0.645497311827957,43.717447916666664,1025.1302083333328,33.06871639784944,0
3422,4,0,0,37,0.0,0.0,1.0,37,1000,700,300,0.7,13,7,6,392.8824664473025,0.8163788788788788,0.21399256036127556,0.23092106759245934,131461.62245008684,2929.793294270843,134391.41574435768,3408,2,444.72972972972974,31,6,21,33.54706280683935,0.646505376344086,43.61979166666667,1025.5208333333337,33.08131720430109,0
3423,4,0,0,37,0.0,0.0,1.0,37,900,600,300,0.6666666666666666,12,6,6,396.08264015517915,0.8155655655655656,0.21011267547679657,0.23402723910818007,131661.99578179244,3029.8061794704813,134691.8019612629,3409,3,445.72972972972974,31,6,18,33.26196819758099,0.648521505376344,43.424479166666664,1026.3020833333328,33.10651881720428,0
3424,4,0,0,37,0.0,0.0,1.0,37,700,400,300,0.5714285714285714,10,4,6,395.888583871916,0.8147522522522522,0.21168486177997914,0.2345290371021831,131762.23966810433,3032.633293999562,134794.8729621039,3410,4,446.72972972972974,31,6,19,33.16542485732403,0.6495295698924731,43.326822916666664,1026.692708333333,33.119119623655905,0
3425,4,0,0,37,0.0,0.0,1.0,37,600,300,300,0.5,9,3,6,395.9124858680786,0.8138763763763763,0.21250111384526793,0.23474931304929836,131795.66277398012,3035.9096950954913,134831.57246907562,3411,5,447.72972972972974,31,6,19,33.13097049623804,0.6498655913978495,43.294270833333336,1026.8229166666672,33.123319892473134,0
3426,4,0,0,37,0.0,0.0,1.0,37,1300,800,500,0.6153846153846154,18,8,10,394.91487034172326,0.8130005005005005,0.2164217449388557,0.2349832825788988,131929.3975830078,3020.176188151041,134949.57377115884,3412,6,448.72972972972974,31,6,19,33.02122940430927,0.6512096774193548,43.1640625,1027.34375,33.140120967741936,0
3427,4,0,0,37,0.0,0.0,1.0,37,800,600,200,0.75,10,6,4,395.54373144639374,0.8132507507507507,0.2141680395387151,0.23556494979950893,131962.841881646,3039.4149780273397,135002.25685967333,3413,7,449.72972972972974,31,6,19,32.97123833058758,0.6515456989247312,43.131510416666664,1027.473958333333,33.14432123655913,0
3428,4,0,1,36,0.0,0.02702702702702703,0.972972972972973,37,1250,800,450,0.64,17,8,9,401.6372496767888,0.8140015015015015,0.20850594704154402,0.23982787057099617,132063.2002088758,3208.3001030815935,135271.50031195738,3414,8,450.72972972972974,31,6,19,32.71313655941222,0.6525537634408602,43.033854166666664,1027.8645833333328,33.15692204301074,0
3429,4,0,0,36,0.0,0.0,1.0,36,850,600,250,0.7058823529411765,11,6,5,411.8203565585151,0.8159391534391535,0.20049699189118542,0.24561454338895503,132017.87236963797,3673.529454272156,135691.40182391013,3415,9,452.05555555555554,30,6,19,32.497384253204295,0.6548611111111111,43.077956989247305,1027.6881720430097,34.256272401433655,0
3430,4,0,0,36,0.0,0.0,1.0,36,550,400,150,0.7272727272727273,7,4,3,410.53066079025245,0.8147156084656085,0.19788034635053497,0.24529206982217577,132086.9464677997,3645.148283038497,135732.09475083818,3416,10,453.05555555555554,30,6,19,32.46055613668062,0.6555555555555556,43.01075268817204,1027.9569892473114,34.26523297491038,0
3431,4,0,0,36,0.0,0.0,1.0,36,1400,1000,400,0.7142857142857143,18,10,8,414.82326550232324,0.8135251322751323,0.19326300984528832,0.24902004540033099,132264.03130425353,3773.239474826398,136037.27077907993,3417,11,454.05555555555554,31,5,20,32.17088607594936,0.6545698924731183,42.83854166666667,1028.645833333334,33.182123655914,0
3432,4,0,0,36,0.0,0.0,1.0,36,1100,900,200,0.8181818181818182,13,9,4,413.2177219754458,0.8133928571428573,0.19579397210976124,0.2489384812876469,132398.00347222234,3741.908094618062,136139.9115668404,3418,12,455.05555555555554,30,6,21,32.076585695006735,0.6586805555555555,42.708333333333336,1029.1666666666674,34.30555555555558,0
3433,4,1,1,36,0.02702702702702703,0.02702702702702703,0.972972972972973,37,900,500,400,0.5555555555555556,13,5,8,404.107763751706,0.8181306306306306,0.1823906028580693,0.24585034205186446,132766.7766147191,3330.4170396592986,136097.1936543784,3419,0,443.72972972972974,31,6,18,31.93843440724361,0.6596102150537634,42.35026041666667,1030.5989583333344,33.245127688172076,0
3434,4,1,1,36,0.02702702702702703,0.02702702702702703,0.972972972972973,37,900,700,200,0.7777777777777778,11,7,4,403.5191222789333,0.8188813813813813,0.1854549674706274,0.24615288214211067,132867.44011773015,3322.910563151051,136190.3506808812,3420,0,444.7027027027027,31,6,18,31.85200387303191,0.6606182795698924,42.25260416666667,1030.9895833333344,33.25772849462369,0
3435,4,1,1,36,0.02702702702702703,0.02702702702702703,0.972972972972973,37,950,700,250,0.7368421052631579,12,7,5,404.4994909230679,0.8156281281281281,0.18516533960403136,0.24697235687122415,132901.00309583885,3351.677619086391,136252.68071492526,3421,0,445.6756756756757,31,6,18,31.792866313086677,0.6609543010752688,42.22005208333334,1031.1197916666677,33.26192876344089,0
3436,4,1,1,36,0.02702702702702703,0.02702702702702703,0.972972972972973,37,900,800,100,0.8888888888888888,10,8,2,403.78479368490576,0.814502002002002,0.19019221190390057,0.2472011696732477,133001.71746148012,3340.8142089843805,136342.5316704645,3422,0,446.64864864864865,31,6,19,31.70969031389378,0.6619623655913978,42.122395833333336,1031.5104166666672,33.27452956989249,0
3437,4,0,0,36,0.0,0.0,1.0,36,950,500,450,0.5263157894736842,14,5,9,409.05855765047886,0.8063822751322752,0.2003872602243939,0.2505606089359479,133021.21497066144,3682.6932665626205,136703.90823722407,3423,17,460.05555555555554,30,6,19,31.554017372421274,0.6649305555555556,42.10349462365592,1031.5860215053772,34.386200716845906,0
3438,4,0,0,36,0.0,0.0,1.0,36,1050,900,150,0.8571428571428571,12,9,3,408.45384177219466,0.806878306878307,0.20226723401791835,0.2506554870731525,133090.55102107173,3672.269373627001,136762.82039469873,3424,18,461.05555555555554,30,6,19,31.499663497025747,0.6656249999999999,42.03629032258064,1031.8548387096769,34.39516129032256,0
3439,4,0,0,36,0.0,0.0,1.0,36,950,800,150,0.8421052631578947,11,8,3,387.59008343548487,0.8078042328042329,0.18989439388832685,0.23516968866116253,132666.15125868074,3091.9838885817967,135758.13514726254,3425,19,462.05555555555554,31,5,18,32.46545331985171,0.6586021505376343,42.44791666666668,1030.2083333333348,33.23252688172048,3
3440,4,0,0,36,0.0,0.0,1.0,36,800,400,400,0.5,12,4,8,390.37754665110845,0.807175925925926,0.18821857233101702,0.2374971776897406,132766.77661471907,3165.833706325965,135932.61032104504,3426,20,463.05555555555554,31,5,18,32.292193093282776,0.6596102150537634,42.35026041666667,1030.5989583333342,33.24512768817207,0
3441,4,0,0,36,0.0,0.0,1.0,36,650,300,350,0.46153846153846156,10,3,7,390.37754665110845,0.807175925925926,0.18821857233101702,0.2374971776897406,132766.77661471907,3165.833706325965,135932.61032104504,3427,21,464.05555555555554,31,5,18,32.292193093282776,0.6596102150537634,42.35026041666667,1030.5989583333342,33.24512768817207,0
3442,4,0,0,36,0.0,0.0,1.0,36,850,500,350,0.5882352941176471,12,5,7,392.3986272315706,0.8071428571428572,0.18029065442858538,0.2391547291603038,132833.88137817394,3224.7665405273588,136058.64791870132,3428,22,465.05555555555554,31,5,19,32.172461159530116,0.660282258064516,42.28515625000001,1030.859375000001,33.253528225806484,0
3443,4,1,0,37,0.02702702702702703,0.0,1.0,37,1650,1400,250,0.8484848484848485,19,14,5,383.8666778890663,0.8121246246246246,0.17852715100421523,0.23612566529293624,133178.82303145112,2824.582472451824,136003.40550390293,3429,0,453.4594594594595,32,5,21,32.045107033639155,0.6611328124999998,41.95075757575759,1032.1969696969718,32.25615530303037,0
3444,4,0,0,37,0.0,0.0,1.0,37,850,500,350,0.5882352941176471,12,5,7,383.43061288185953,0.8127502502502503,0.17532044821444526,0.23668520624609285,133309.18281616678,2822.964333996543,136132.14715016334,3430,1,454.4594594594595,32,5,22,31.925255736235076,0.6624348958333333,41.824494949494955,1032.7020202020208,32.27193813131315,0
3445,4,0,0,37,0.0,0.0,1.0,37,1000,600,400,0.6,14,6,8,385.15718362868586,0.8106856856856857,0.18507230930060703,0.23901427415644091,133505.8614942763,2884.2479612788184,136390.10945555512,3431,2,455.4594594594595,31,6,22,31.682966906051828,0.667002688172043,41.634114583333336,1033.463541666667,33.33753360215055,0
3446,4,0,0,37,0.0,0.0,1.0,37,800,500,300,0.625,11,5,6,385.61321900054213,0.8101851851851852,0.18727571108523478,0.2395146895482241,133539.5050048828,2898.919677734375,136438.4246826172,3432,3,456.4594594594595,31,6,22,31.63737717309146,0.6673387096774194,41.6015625,1033.59375,33.341733870967744,0
3447,4,0,0,37,0.0,0.0,1.0,37,1100,900,200,0.8181818181818182,13,9,4,410.7929576246066,0.8096846846846847,0.2188565770655324,0.23838929903097256,130972.46334876552,3364.3278145495888,134336.79116331512,3433,4,457.4594594594595,32,5,18,33.58491632745364,0.6389973958333333,44.09722222222223,1023.6111111111119,31.987847222222246,4
3448,4,0,0,37,0.0,0.0,1.0,37,850,500,350,0.5882352941176471,12,5,7,413.1458599117542,0.809496996996997,0.22337542870284266,0.24015769018096192,131037.09323347126,3427.486512855854,134464.5797463271,3434,5,458.4594594594595,32,5,18,33.45896534714514,0.6396484374999998,44.03409090909092,1023.8636363636379,31.995738636363683,0
3449,4,0,0,37,0.0,0.0,1.0,37,600,300,300,0.5,9,3,6,413.11797556107956,0.8087462462462462,0.2222333280025588,0.2407480616200777,131134.06795224996,3434.768135904524,134568.8360881545,3435,6,459.4594594594595,32,5,18,33.361070019723876,0.6406249999999998,43.93939393939395,1024.2424242424256,32.0075757575758,0
3450,4,0,0,37,0.0,0.0,1.0,37,1050,800,250,0.7619047619047619,13,8,5,405.9229007986848,0.8092467467467468,0.20744583440160613,0.23755415903265498,131295.77219480154,3259.4791028976592,134555.2512976992,3436,7,460.4594594594595,32,5,20,33.38107264588723,0.6422526041666667,43.781565656565654,1024.8737373737372,32.02730429292929,1
3451,4,1,2,36,0.02631578947368421,0.05263157894736842,0.9473684210526316,38,950,600,350,0.631578947368421,13,6,7,396.5668319908819,0.8135668563300142,0.197918318657905,0.23374475896420072,131569.3310823505,2835.2185195855245,134404.549601936,3437,0,449.3157894736842,30,8,16,33.34343202759945,0.6503472222222222,43.51478494623655,1025.9408602150531,34.198028673835104,0
3452,4,1,0,37,0.02702702702702703,0.0,1.0,37,800,600,200,0.75,10,6,4,405.70869168674864,0.8076201201201201,0.21199964861936693,0.23851536460310122,131470.524691358,3267.7469135802394,134738.27160493826,3438,0,462.2162162162162,29,8,21,33.209191043698084,0.6522988505747127,43.61111111111111,1025.5555555555552,35.36398467432949,0
3453,4,1,1,37,0.02631578947368421,0.02631578947368421,0.9736842105263158,38,800,600,200,0.75,10,6,4,394.15044236926474,0.816737790422001,0.20021774782596724,0.23337372704003437,131741.75663371483,2785.2143311365426,134526.97096485138,3439,0,451.0263157894737,30,8,18,33.23077594483722,0.6520833333333333,43.346774193548384,1026.6129032258061,34.22043010752687,0
3454,4,0,0,37,0.0,0.0,1.0,37,750,600,150,0.8,9,6,3,406.381937785824,0.8088713713713713,0.21525044264621962,0.23980429363911082,131613.00154320986,3297.0293209876527,134910.0308641975,3440,2,464.2162162162162,29,8,18,33.047396679299766,0.6537356321839081,43.47222222222222,1026.111111111111,35.383141762452105,0
3455,4,0,0,37,0.0,0.0,1.0,37,800,500,300,0.625,11,5,6,405.9446433278292,0.8088713713713713,0.21277062689973802,0.23977018141881135,131648.6328125,3288.411458333334,134937.04427083334,3441,3,465.2162162162162,29,8,19,33.02248274462038,0.6540948275862069,43.4375,1026.25,35.38793103448276,0
3456,4,0,0,37,0.0,0.0,1.0,37,1000,800,200,0.8,12,8,4,407.3775447797568,0.8081206206206206,0.21360600421874554,0.24151902073430176,131791.20611496922,3337.755594135809,135128.96170910503,3442,4,466.2162162162162,29,8,20,32.84117295640019,0.6555316091954022,43.298611111111114,1026.805555555556,35.40708812260538,0
3457,4,1,0,38,0.02631578947368421,0.0,1.0,38,1150,900,250,0.782608695652174,14,9,5,397.9765103486229,0.8122036510194405,0.216235177593749,0.2386611486824187,132225.14886114,2924.5006648167396,135149.64952595675,3443,0,454.92105263157896,30,8,21,32.643426555148984,0.6569444444444444,42.876344086021504,1028.494623655914,34.2831541218638,0
3458,4,1,0,39,0.02564102564102564,0.0,1.0,39,750,300,450,0.4,12,3,9,387.55621595607664,0.8159581646423752,0.22302507234014102,0.23520335671443598,132674.80570369403,2483.9020406983427,135158.70774439236,3444,0,444.2307692307692,30,9,17,32.45759947814742,0.6614583333333333,42.439516129032256,1030.2419354838707,34.34139784946236,0
3459,4,0,0,39,0.0,0.0,1.0,39,800,600,200,0.75,10,6,4,388.19072210523785,0.8166329284750338,0.2253373203021003,0.23580586970354628,132709.4263065094,2503.313605619148,135212.73991212857,3445,1,445.2307692307692,30,9,17,32.406350552221944,0.6618055555555555,42.405913978494624,1030.3763440860214,34.34587813620071,0
3460,4,0,0,39,0.0,0.0,1.0,39,1000,800,200,0.8,12,8,4,388.1600647426498,0.8168578497525866,0.22640487202897552,0.23600501319444073,132744.051425743,2505.1879191236185,135249.23934486663,3446,2,446.2307692307692,30,9,17,32.37223381592104,0.6621527777777777,42.372311827957,1030.5107526881732,34.3503584229391,0
3461,4,0,0,39,0.0,0.0,1.0,39,1300,1100,200,0.8461538461538461,15,11,4,387.6761251697719,0.8165766981556456,0.22587503760906658,0.23636533227759565,132847.9538819518,2500.395999537537,135348.34988148935,3447,3,447.2307692307692,30,9,19,32.27998696219036,0.6631944444444444,42.271505376344095,1030.9139784946246,34.36379928315416,0
3462,4,0,0,39,0.0,0.0,1.0,39,1050,600,450,0.5714285714285714,15,6,9,387.1907636099761,0.8159581646423752,0.22769645221975,0.23640429121259843,132901.00309583882,2491.6081746419327,135392.61127048076,3448,4,448.2307692307692,31,8,19,32.23905059561392,0.6609543010752688,42.220052083333336,1031.1197916666672,33.26192876344088,0
3463,4,0,0,39,0.0,0.0,1.0,39,850,600,250,0.7058823529411765,11,6,5,387.18498112437493,0.8151709401709402,0.22698782698782716,0.23661304402045147,132934.57031250012,2494.0538194444594,135428.62413194458,3449,5,449.2307692307692,31,8,19,32.20538720538721,0.661290322580645,42.18750000000001,1031.250000000001,33.26612903225809,0
3464,4,0,0,39,0.0,0.0,1.0,39,1150,500,650,0.43478260869565216,18,5,13,385.79949328964256,0.8154520917678812,0.22444878105612687,0.23640289136379258,133035.29739379883,2464.9900648329,135500.28745863173,3450,6,450.2307692307692,31,8,19,32.13968299044976,0.6622983870967742,42.08984375,1031.640625,33.27872983870968,0
3465,4,2,2,39,0.04878048780487805,0.04878048780487805,0.9512195121951219,41,1200,800,400,0.6666666666666666,16,8,8,366.9210761832354,0.8220020325203252,0.21205746873007492,0.22789195217268332,133537.46588358344,1600.2584539327454,135137.72433751618,3451,0,429.219512195122,32,9,20,32.12242446453295,0.6647135416666665,41.603535353535364,1033.5858585858596,32.29955808080811,0
3466,4,0,0,39,0.0,0.0,1.0,39,600,500,100,0.8333333333333334,7,5,2,387.63737464994887,0.813540260908682,0.22889684410683286,0.23881715179482876,133236.86599731457,2529.517788357219,135766.3837856718,3452,1,451.8974358974359,31,8,21,31.889398621095555,0.6643145161290323,41.89453125000001,1032.421875000001,33.30393145161293,0
3467,4,0,0,39,0.0,0.0,1.0,39,650,200,450,0.3076923076923077,11,2,9,387.2836723835941,0.8139901034637878,0.2259482164127644,0.23927344713729615,133341.7827262525,2528.219059279682,135870.0017855322,3453,2,452.8974358974359,32,7,22,31.792991035044846,0.6627604166666665,41.7929292929293,1032.8282828282836,32.27588383838386,0
3468,4,0,0,39,0.0,0.0,1.0,39,1000,900,100,0.9,11,9,2,387.1454476654634,0.8142150247413406,0.2228782380334562,0.23960847600596277,133406.9945031122,2529.5821217223006,135936.5766248345,3454,3,453.8974358974359,32,7,22,31.730984681821884,0.6634114583333333,41.72979797979799,1033.0808080808101,32.28377525252532,0
3469,4,0,1,38,0.0,0.02564102564102564,0.9743589743589743,39,1250,1000,250,0.8,15,10,5,389.3439033010292,0.8152834008097166,0.2209062718815642,0.24184609179199634,133541.67569950287,2598.7593385425153,136140.4350380454,3455,4,454.8974358974359,30,9,22,31.538794971824885,0.6701388888888888,41.5994623655914,1033.6021505376348,34.453405017921156,0
3470,4,0,0,38,0.0,0.0,1.0,38,950,700,250,0.7368421052631579,12,7,5,395.0962539021853,0.8154338549075392,0.2190152801358234,0.24495967741935498,133472.22222222225,2946.87500000001,136419.09722222225,3456,5,462.7105263157895,31,7,22,31.460013440860212,0.6666666666666666,41.66666666666667,1033.3333333333337,33.33333333333334,0
3471,4,0,0,38,0.0,0.0,1.0,38,1550,1200,350,0.7741935483870968,19,12,7,391.87597871016635,0.8143669985775249,0.2134223117602616,0.24429191702638486,133674.12143283428,2876.7354329427176,136550.856865777,3457,6,463.7105263157895,31,7,23,31.340237555611516,0.6686827956989246,41.47135416666667,1034.114583333334,33.35853494623658,0
3472,4,0,0,38,0.0,0.0,1.0,38,1300,900,400,0.6923076923076923,17,9,8,390.7770579752794,0.814337363679469,0.21168891391474287,0.24427409328195077,133775.1282585992,2855.2502102322146,136630.37846883142,3458,7,464.7105263157895,31,7,19,31.267175372351595,0.6696908602150538,41.37369791666667,1034.5052083333337,33.37113575268818,0
3473,4,0,0,38,0.0,0.0,1.0,38,650,600,50,0.9230769230769231,7,6,1,388.9121096067284,0.8141891891891891,0.20558900081460707,0.24355276083882357,133842.48733520508,2810.592820909289,136653.08015611436,3459,8,465.7105263157895,31,7,19,31.247771695818145,0.6703629032258065,41.30859375,1034.765625,33.379536290322584,0
3474,4,1,0,39,0.02564102564102564,0.0,1.0,39,700,400,300,0.5714285714285714,10,4,6,376.8349214094493,0.8200629779577149,0.19714058032156712,0.23802390532444448,134158.0757862719,2311.0895890725515,136469.16537534446,3460,0,454.7435897435897,32,7,20,31.24390615478367,0.6708984375,41.00378787878788,1035.9848484848492,32.37452651515154,0
3475,4,0,0,39,0.0,0.0,1.0,39,850,700,150,0.8235294117647058,10,7,3,374.9038172441009,0.8188259109311741,0.18995041756099385,0.23722711088067341,134223.48684126622,2264.179516120808,136487.66635738703,3461,1,455.7435897435897,32,7,21,31.228422891027993,0.6715494791666666,40.94065656565657,1036.237373737374,32.382417929292934,0
3476,4,0,1,38,0.0,0.02564102564102564,0.9743589743589743,39,1550,1100,450,0.7096774193548387,20,11,9,377.27470661991697,0.8175888439046334,0.18550328278807537,0.24001217393256216,134419.81565975407,2342.639303387403,136762.45496314147,3462,2,456.7435897435897,32,7,21,30.970463492836558,0.6735026041666667,40.75126262626262,1036.9949494949492,32.40609217171716,0
3477,4,0,0,38,0.0,0.0,1.0,38,1200,1000,200,0.8333333333333334,14,10,4,383.89939647988683,0.8151967757230916,0.18971171647712182,0.2432992990429856,134280.73459201388,2710.0585937499964,136990.79318576388,3463,3,469.4736842105263,31,7,21,30.93802345058626,0.674731182795699,40.885416666666664,1036.4583333333333,33.43413978494623,0
3478,4,0,0,38,0.0,0.0,1.0,38,600,300,300,0.5,9,3,6,383.8953298899887,0.8146040777619725,0.1922721115406214,0.24442256615297847,134449.48196411133,2722.905646430123,137172.38761054145,3464,4,470.4736842105263,31,7,21,30.769120108809375,0.6764112903225806,40.72265625,1037.109375,33.455141129032256,0
3479,4,0,0,38,0.0,0.0,1.0,38,750,500,250,0.6666666666666666,10,5,5,385.3163658650667,0.8139224751066857,0.19097442401183673,0.24600967974461954,134550.78125,2768.923611111111,137319.70486111112,3465,5,471.4736842105263,31,7,21,30.630856760374822,0.6774193548387097,40.625,1037.5,33.46774193548387,0
3480,4,0,0,38,0.0,0.0,1.0,38,1250,900,350,0.72,16,9,7,384.3284504587238,0.8125,0.19471836098900397,0.24675000514958642,134753.4942626953,2757.920328776043,137511.41459147134,3466,6,472.4736842105263,31,7,21,30.453661901178833,0.6794354838709677,40.4296875,1038.28125,33.492943548387096,0
3481,4,0,0,38,0.0,0.0,1.0,38,1300,1000,300,0.7692307692307693,16,10,6,383.48747345345953,0.8115516832622096,0.1926569181227893,0.2466690393761931,134821.0991753473,2740.4405381944507,137561.53971354174,3467,7,473.4736842105263,31,7,20,30.407890337679703,0.6801075268817204,40.364583333333336,1038.5416666666672,33.501344086021525,0
3482,4,0,0,38,0.0,0.0,1.0,38,1100,700,400,0.6363636363636364,15,7,8,381.9889033503019,0.8103366524419157,0.1913608749282656,0.24639365075441066,134922.5383334691,2707.782491048198,137630.3208245173,3468,8,474.4736842105263,31,7,20,30.345411914609194,0.6811155913978494,40.26692708333334,1038.9322916666679,33.513944892473155,0
3483,4,0,0,38,0.0,0.0,1.0,38,750,400,350,0.5333333333333333,11,4,7,382.6483501988054,0.8098921289710763,0.19423558897243098,0.24704966299243253,134956.35986328125,2728.165690104167,137684.5255533854,3469,9,475.4736842105263,31,7,20,30.294486215538853,0.6814516129032258,40.234375,1039.0625,33.51814516129032,0
3484,4,0,0,38,0.0,0.0,1.0,38,900,700,200,0.7777777777777778,11,7,4,381.3237697840569,0.8091512565196776,0.1930703512287728,0.24711761184707076,135091.68836805565,2702.7343750000105,137794.42274305565,3470,10,476.4736842105263,31,7,20,30.193720774883094,0.6827956989247311,40.10416666666667,1039.5833333333342,33.534946236559165,0
3485,4,0,0,38,0.0,0.0,1.0,38,1200,900,300,0.75,15,9,6,382.2405781448442,0.8079065908013277,0.18273371473957245,0.24749347968126487,135059.84026576325,2725.070285467139,137784.9105512304,3471,11,477.4736842105263,33,5,19,30.201701642694335,0.6773989898989898,40.13480392156863,1039.4607843137262,31.49881164587049,4
3486,4,0,1,37,0.0,0.02631578947368421,0.9736842105263158,38,1200,700,500,0.5833333333333334,17,7,10,378.2857747532806,0.807047178757705,0.17261384284323356,0.24601619696023727,135219.1183228808,2630.2937872453103,137849.4121101261,3472,12,478.4736842105263,33,5,19,30.145492125211103,0.6789772727272727,39.98161764705883,1040.073529411766,31.517379679144426,0
3487,4,0,1,36,0.0,0.02702702702702703,0.972972972972973,37,700,400,300,0.5714285714285714,10,4,6,384.559958065164,0.8028653653653653,0.18168030605043883,0.24910812713835398,135076.21882086172,2988.9810090702977,138065.199829932,3473,13,491.6216216216216,34,3,19,30.125066804092235,0.6752450980392157,40.11904761904762,1039.5238095238096,30.574229691876752,0
3488,4,0,0,36,0.0,0.0,1.0,36,600,400,200,0.6666666666666666,8,4,4,387.8892484321787,0.7990410052910053,0.16892334499338424,0.2509297266173384,135027.99591803632,3275.1815707900787,138303.1774888264,3474,14,475.0833333333333,33,3,19,30.08673800259402,0.6770833333333334,40.16544117647059,1039.3382352941176,31.495098039215684,0
3489,4,0,0,36,0.0,0.0,1.0,36,750,400,350,0.5333333333333333,11,4,7,387.94604859556455,0.7970899470899472,0.16289486091466276,0.25163106087804066,135123.5402249136,3284.128700499817,138407.66892541343,3475,15,476.0833333333333,33,3,21,29.989784692754995,0.678030303030303,40.07352941176471,1039.705882352942,31.50623885918006,0
3490,4,0,0,36,0.0,0.0,1.0,36,750,600,150,0.8,9,6,3,388.7015939817538,0.7931878306878307,0.16813588827371406,0.25323774607145894,135282.8558276866,3316.9323397251237,138599.78816741172,3476,16,477.0833333333333,33,3,21,29.81100541877725,0.6796085858585857,39.92034313725491,1040.3186274509815,31.524806892453984,0
3491,4,0,0,36,0.0,0.0,1.0,36,950,800,150,0.8421052631578947,11,8,3,383.45458897852507,0.7923280423280424,0.1663233274475182,0.251152408124331,135474.15845167736,3189.6375492599113,138663.79600093726,3477,17,478.0833333333333,33,3,22,29.756597017853636,0.6815025252525251,39.73651960784314,1041.0539215686283,31.547088532382677,0
3492,4,0,0,36,0.0,0.0,1.0,36,1050,800,250,0.7619047619047619,13,8,5,388.8896868376683,0.7920304232804233,0.1646823061734204,0.2551656887304763,135537.95602953198,3341.8626549884757,138879.81868452046,3478,18,479.0833333333333,33,3,22,29.551483857047586,0.6821338383838383,39.67524509803922,1041.2990196078438,31.554515745692235,0
3493,4,0,0,36,0.0,0.0,1.0,36,600,200,400,0.3333333333333333,10,2,8,389.18963170545953,0.7919642857142858,0.16830757563871246,0.25558991423748045,135569.86045030778,3352.476811803177,138922.33726211096,3479,19,480.0833333333333,33,3,22,29.511845924531265,0.6824494949494948,39.644607843137265,1041.4215686274524,31.55822935234704,0
3494,4,1,1,36,0.02702702702702703,0.02702702702702703,0.972972972972973,37,1100,800,300,0.7272727272727273,14,8,6,380.51393223210874,0.7943568568568569,0.1587475069311941,0.2512080665731435,135757.71683673482,2931.5405328798374,138689.25736961467,3480,0,468.0810810810811,34,3,22,29.550538801309884,0.681985294117647,39.46428571428572,1042.1428571428582,30.651260504201712,0
3495,4,0,0,36,0.0,0.0,1.0,36,600,200,400,0.3333333333333333,10,2,8,378.7365807911975,0.7916005291005291,0.17269312703217876,0.2331229512820352,133203.26063368047,2889.7894965277687,136093.05013020826,3481,21,482.0833333333333,35,1,17,32.152917928018844,0.6544642857142857,41.92708333333333,1032.291666666666,29.494047619047603,6
3496,4,0,0,36,0.0,0.0,1.0,36,350,200,150,0.5714285714285714,5,2,3,377.1594680409152,0.7912698412698413,0.17157705289641179,0.2325251979539048,133263.00643272026,2852.2809231395586,136115.28735585982,3482,22,483.0833333333333,35,1,17,32.13356593057578,0.6550595238095238,41.869212962962955,1032.5231481481474,29.500661375661352,0
3497,4,0,0,36,0.0,0.0,1.0,36,850,500,350,0.5882352941176471,12,5,7,377.65595061318663,0.7916997354497355,0.1653095273669012,0.23339346975568379,133352.6502486281,2872.2843792866756,136224.93462791477,3483,23,484.0833333333333,35,1,17,32.030666367847004,0.6559523809523811,41.7824074074074,1032.870370370369,29.510582010581974,0
3498,4,0,0,36,0.0,0.0,1.0,36,650,500,150,0.7692307692307693,8,5,3,377.7428533034003,0.7910714285714286,0.1637510424056856,0.23401182869114875,133442.32420535403,2881.376859353559,136323.7010647076,3484,24,485.0833333333333,35,1,17,31.93833781412194,0.6568452380952381,41.69560185185185,1033.2175925925922,29.52050264550263,0
3499,4,0,0,36,0.0,0.0,1.0,36,850,700,150,0.8235294117647058,10,7,3,377.53642039542154,0.791170634920635,0.16330645161290347,0.23407258064516123,133472.22222222207,2878.1283489797484,136350.35057120182,3485,25,486.0833333333333,34,2,18,31.91364247311828,0.6593137254901962,41.66666666666666,1033.3333333333321,30.39215686274506,0
3500,4,1,0,37,0.02702702702702703,0.0,1.0,37,750,600,150,0.8,9,6,3,374.0074770979921,0.7956706706706707,0.17536436011050216,0.23452839131909137,133891.14610125162,2615.2579518175485,136506.4040530692,3486,0,473.9189189189189,35,2,18,31.584563483187956,0.6613095238095239,41.26157407407407,1034.953703703703,29.570105820105802,0
3501,4,0,0,37,0.0,0.0,1.0,37,1100,800,300,0.7272727272727273,14,8,6,335.42235295931,0.7959209209209209,0.049489621562188724,0.19543025625656152,131126.20380092927,1398.1528689130735,132524.35666984235,3487,1,474.9189189189189,36,1,18,35.358484515301456,0.6316550925925927,43.94707207207207,1024.2117117117114,28.450325325325316,8
3502,4,0,0,37,0.0,0.0,1.0,37,800,400,400,0.5,12,4,8,335.42235295931,0.7959209209209209,0.049489621562188724,0.19543025625656152,131126.20380092927,1396.5319627059405,132522.73576363522,3488,2,475.9189189189189,36,1,18,35.358484515301456,0.6316550925925927,43.94707207207207,1024.2117117117114,28.450325325325316,0
3503,4,0,0,37,0.0,0.0,1.0,37,1000,700,300,0.7,13,7,6,333.22047932091954,0.7959834834834835,0.04274773784556141,0.1945853607741801,131212.72243527308,1344.553252576892,132557.27568784996,3489,3,476.9189189189189,36,1,19,35.32759031288926,0.6325231481481481,43.86261261261261,1024.5495495495493,28.459709709709703,0
3504,4,0,0,37,0.0,0.0,1.0,37,700,400,300,0.5714285714285714,10,4,6,334.3533389687235,0.7947322322322322,0.047193347193347,0.19554083448684983,131270.4173768363,1378.1404715526292,132648.5578483889,3490,4,477.9189189189189,36,1,20,35.24038461538461,0.6331018518518519,43.806306306306304,1024.7747747747746,28.465965965965964,0
3505,4,0,0,37,0.0,0.0,1.0,37,900,600,300,0.6666666666666666,12,6,6,335.2578776382858,0.7927302302302303,0.038882056946865085,0.19651747334495656,131357.7852393046,1407.7591397195074,132765.5443790241,3491,5,478.9189189189189,35,2,20,35.12911162545634,0.6360119047619048,43.72106481481481,1025.1157407407397,29.289021164021136,0
3506,4,2,1,38,0.05128205128205128,0.02564102564102564,0.9743589743589743,39,1200,1000,200,0.8333333333333334,14,10,4,321.0605385839365,0.8049932523616734,0.04123361519306057,0.19112688986858212,131946.99931709742,672.5949330563114,132619.59425015372,3492,0,455.3076923076923,37,2,15,34.90039131981501,0.6379504504504505,43.1469298245614,1027.4122807017534,27.767899478425768,0
3507,4,0,0,38,0.0,0.0,1.0,38,1150,900,250,0.782608695652174,14,9,5,327.76585249047275,0.7981863442389758,0.03749545483403671,0.19446303245677432,131819.15181651246,1041.1633339420534,132860.31515045452,3493,1,468.2894736842105,36,2,15,34.85670943451402,0.6385995370370371,43.2713963963964,1026.9144144144145,28.525400400400404,0
3508,4,1,1,38,0.02564102564102564,0.02564102564102564,0.9743589743589743,39,850,500,350,0.5882352941176471,12,5,7,321.94100419569975,0.8019568151147098,0.036576892988243515,0.1922213358809228,132059.67821829786,703.0850838719557,132762.76330216983,3494,0,457.2564102564103,37,2,15,34.764597112580915,0.6390765765765766,43.03728070175438,1027.850877192982,27.77975343764816,0
3509,4,0,0,38,0.0,0.0,1.0,38,800,500,300,0.625,11,5,6,329.49921616264095,0.798067804646752,0.03767765538173884,0.19578907821625077,131876.9799148812,1090.6723023699446,132967.65221725113,3495,3,470.2894736842105,36,2,15,34.75404743631912,0.6391782407407407,43.215090090090094,1027.1396396396403,28.531656656656676,0
3510,4,0,0,38,0.0,0.0,1.0,38,1150,800,350,0.6956521739130435,15,8,7,331.8579937369869,0.7983345187292555,0.03727925995132453,0.19794353273488527,132021.60564280508,1162.4850357113987,133184.09067851648,3496,4,471.2894736842105,36,2,16,34.54804039739937,0.640625,43.07432432432433,1027.7027027027036,28.547297297297323,0
3511,4,0,0,38,0.0,0.0,1.0,38,1100,1000,100,0.9090909090909091,12,10,2,328.49476325036926,0.7981863442389758,-0.016476703152795924,0.18968327619854455,130780.41459956583,1000.0622666585568,131780.4768662244,3497,5,472.2894736842105,36,2,17,35.88480311204081,0.6281828703703705,44.28490990990991,1022.8603603603608,28.4127877877878,3
3512,4,1,1,38,0.02564102564102564,0.02564102564102564,0.9743589743589743,39,1050,600,450,0.5714285714285714,15,6,9,320.7699608875277,0.8042060278902384,-0.015955636084115765,0.1867825083971014,131103.4404816865,610.8090951061693,131714.24957679267,3498,0,461.15384615384613,37,2,18,35.75660242683797,0.6295045045045045,43.96929824561403,1024.1228070175425,27.678994784257906,0
3513,4,1,0,39,0.02564102564102564,0.0,1.0,39,950,600,350,0.631578947368421,13,6,7,320.90686760526137,0.8117408906882592,-0.001250781738586948,0.18795973674022434,131328.1249999999,628.8194444444301,131956.94444444435,3499,0,449.87179487179486,37,2,19,35.52676151761517,0.6317567567567568,43.74999999999999,1024.9999999999993,27.702702702702684,0
3514,4,0,0,39,0.0,0.0,1.0,39,900,500,400,0.5555555555555556,13,5,8,322.78203249507703,0.8091542959964013,-0.0009866149241948285,0.19017309168916513,131553.00188519547,692.5890658664218,132245.5909510619,3500,1,450.87179487179486,37,2,21,35.25233361835542,0.634009009009009,43.530701754385966,1025.8771929824563,27.72641062114747,0
3515,4,0,0,39,0.0,0.0,1.0,39,1700,1200,500,0.7058823529411765,22,12,10,326.71591110017937,0.8066239316239316,0.0069770753239362104,0.1936308728824099,131778.07113727284,810.7985149276585,132588.8696522005,3501,2,451.87179487179486,37,2,15,34.92497864160616,0.6362612612612613,43.311403508771924,1026.754385964911,27.75011853959219,0
3516,4,0,0,39,0.0,0.0,1.0,39,800,500,300,0.625,11,5,6,333.95342840459966,0.8066239316239316,-0.02430086476779092,0.1843043035809249,129011.3768924866,816.758323288764,129828.13521577537,3502,3,452.87179487179486,38,1,18,37.53855996073895,0.6066337719298246,46.02029914529914,1015.9188034188029,26.73470535312639,8
3517,4,0,0,39,0.0,0.0,1.0,39,850,600,250,0.7058823529411765,11,6,5,357.44975958333237,0.8057804768331085,0.04640029786969979,0.18341759691925336,126072.89422850219,1239.7401551567605,127312.63438365895,3503,4,453.87179487179486,35,4,19,39.95488552110943,0.5824404761904762,48.929398148148145,1004.2824074074072,28.693783068783063,8
3518,4,5,2,42,0.11363636363636363,0.045454545454545456,0.9545454545454546,44,950,800,150,0.8421052631578947,11,8,3,325.7782780188213,0.8416138125440451,0.08078331064908228,0.1719434671723318,127223.34120008702,-506.5772957925896,126716.76390429442,3504,0,403.1818181818182,39,5,17,39.56988900361384,0.5868055555555556,47.78645833333334,1008.8541666666683,25.8680555555556,0
3519,4,5,4,43,0.10638297872340426,0.0851063829787234,0.9148936170212766,47,1100,800,300,0.7272727272727273,14,8,6,305.32233085245355,0.8590810977489978,0.09854080052172476,0.16396939990224368,127923.87777176857,-1588.3966934078458,126335.48107836072,3505,0,378.3404255319149,42,5,16,39.37120849297572,0.5892857142857143,47.093023255813954,1011.6279069767446,24.086378737541537,0
3520,4,4,2,45,0.0851063829787234,0.0425531914893617,0.9574468085106383,47,1000,600,400,0.6,14,6,8,301.29935257700777,0.8590425531914893,0.12042220144235083,0.16301570834866785,128221.71512492574,-1672.9957761886562,126548.71934873708,3506,0,378.29787234042556,40,7,18,39.169844136731555,0.5953124999999999,46.79878048780488,1012.8048780487813,25.320121951219534,0
3521,4,1,0,46,0.021739130434782608,0.0,1.0,46,1150,700,450,0.6086956521739131,16,7,9,309.5255982144508,0.8529991948470209,0.12463520923395,0.1675742334276716,128247.44824715791,-1260.826372364319,126986.62187479359,3507,0,387.5,40,6,20,38.935361693588845,0.5955729166666666,46.773373983739845,1012.9065040650418,25.322662601626043,0
3522,4,2,3,45,0.041666666666666664,0.0625,0.9375,48,1250,700,550,0.56,18,7,11,303.8111155808892,0.8602061170212766,0.15084176691490048,0.16660301699446248,128758.45520852119,-1776.3500165254438,126982.10519199575,3508,0,372.3125,42,6,15,38.560761568327926,0.597718253968254,46.26937984496124,1014.9224806201555,24.16482096714656,0
3523,4,1,1,45,0.021739130434782608,0.021739130434782608,0.9782608695652174,46,1550,1100,450,0.7096774193548387,20,11,9,316.1686138746865,0.856219806763285,0.14040136460480057,0.17250118085595947,128556.44710696355,-1070.897262707369,127485.54984425618,3509,0,389.4130434782609,40,6,15,38.45262551357854,0.5986979166666666,46.46849593495936,1014.1260162601634,25.353150406504085,0
3524,4,0,0,45,0.0,0.0,1.0,45,1000,700,300,0.7,13,7,6,323.25415911743875,0.8473905723905725,0.14431859944539127,0.17613909041587567,128504.9214773778,-692.0499330755572,127812.87154430224,3510,2,399.06666666666666,40,5,16,38.325440179078555,0.5981770833333333,46.51930894308943,1013.9227642276414,25.348069105691035,0
3525,4,0,2,43,0.0,0.044444444444444446,0.9555555555555556,45,1450,1200,250,0.8275862068965517,17,12,5,325.14563365487334,0.8476010101010102,0.1503472222222224,0.1779744521058255,128685.3063652588,-631.7069039592809,128053.59946129953,3511,3,400.06666666666666,40,5,16,38.09386685363248,0.6,46.34146341463415,1014.6341463414636,25.36585365853659,0
3526,4,2,0,45,0.044444444444444446,0.0,1.0,45,1100,700,400,0.6363636363636364,15,7,8,325.92098785386935,0.8476010101010102,0.16243523892113076,0.179561981952126,128943.2185289839,-594.9397679952574,128348.27876098864,3512,0,400.75555555555553,40,5,18,37.811853778934044,0.6026041666666667,46.08739837398373,1015.6504065040635,25.39126016260159,0
3527,4,1,1,45,0.021739130434782608,0.021739130434782608,0.9782608695652174,46,1550,1000,550,0.6451612903225806,21,10,11,320.93428179905254,0.8530193236714976,0.15843599404968667,0.17821163020036127,129254.34570312501,-903.0534861131755,128351.29221701184,3513,0,393.0217391304348,39,7,18,37.622498804889716,0.6073717948717949,45.78125,1016.8750000000001,26.073717948717952,0
3528,4,2,1,46,0.0425531914893617,0.02127659574468085,0.9787234042553191,47,1050,800,250,0.7619047619047619,13,8,5,316.6369855100179,0.8552266419981498,0.1707351254936933,0.17744421671198984,129614.99851278993,-1191.819518804954,128423.17899398497,3514,0,385.6170212765957,40,7,17,37.36610113107119,0.609375,45.42682926829268,1018.2926829268287,25.457317073170717,0
3529,4,1,1,46,0.02127659574468085,0.02127659574468085,0.9787234042553191,47,1200,700,500,0.5833333333333334,17,7,10,316.55945192165984,0.8564986123959296,0.17038683368677576,0.1777521224992042,129692.62390318251,-1188.9148117853247,128503.70909139719,3515,0,386.59574468085106,40,7,17,37.28944261531811,0.6101562500000001,45.350609756097555,1018.5975609756088,25.46493902439022,0
3530,4,0,0,46,0.0,0.0,1.0,46,850,300,550,0.35294117647058826,14,3,11,320.655296194039,0.8499194847020934,0.171070901674911,0.17969608880672663,129614.99851279006,-887.6528521382731,128727.34566065179,3516,2,396.0,40,6,17,37.263805721889554,0.609375,45.426829268292686,1018.2926829268297,25.457317073170742,0
3531,4,1,1,46,0.02127659574468085,0.02127659574468085,0.9787234042553191,47,1250,700,550,0.56,18,7,11,314.0369758644574,0.8541088498304039,0.17443702438266806,0.17719549297129597,129883.08930342968,-1242.381483843541,128640.70781958614,3517,0,388.5531914893617,41,6,18,37.16088807785888,0.6105182926829269,45.163690476190474,1019.3452380952378,24.86207897793263,0
3532,4,0,0,46,0.0,0.0,1.0,46,1000,800,200,0.8,12,8,4,314.5401223262592,0.8554347826086957,0.1643523334026762,0.1776726636924006,129925.63950029752,-1026.6346916517891,128899.00480864572,3518,1,386.5652173913044,40,6,18,37.105013955342905,0.6125,45.1219512195122,1019.5121951219518,25.487804878048795,0
3533,4,0,0,46,0.0,0.0,1.0,46,700,400,300,0.5714285714285714,10,4,6,313.75490086343115,0.8553341384863125,0.16040761140410553,0.17734664340072145,129951.5430320081,-1045.4132997884753,128906.12973221963,3519,2,387.5652173913044,40,6,18,37.09882388119209,0.6127604166666667,45.09654471544716,1019.6138211382117,25.490345528455293,0
3534,4,1,0,47,0.02127659574468085,0.0,1.0,47,700,600,100,0.8571428571428571,8,6,2,309.20499989793507,0.8601988899167436,0.1625284594371601,0.17606033447425837,130237.26974875579,-1345.9970041257411,128891.27274463004,3520,0,380.29787234042556,41,6,19,36.92606586321963,0.6140752032520326,44.816468253968246,1020.7341269841254,24.895954316685984,0
3535,4,0,0,47,0.0,0.0,1.0,47,1350,1100,250,0.8148148148148148,16,11,5,308.26223846897625,0.8591581868640148,0.16966532922978295,0.17637912998215943,130426.23325525981,-1358.8960949065556,129067.33716035326,3521,1,381.29787234042556,38,9,19,36.75936094550779,0.6208881578947367,44.63141025641026,1021.4743589743599,26.880904183535787,0
3536,4,1,0,48,0.020833333333333332,0.0,1.0,48,1400,800,600,0.5714285714285714,20,8,12,303.35906648006676,0.8631242612293144,0.1736026267562616,0.175476604886173,130848.09570312499,-1661.2087673611136,129186.88693576388,3522,0,374.3333333333333,39,9,18,36.45939387768953,0.6233974358974359,44.21875,1023.1249999999999,26.233974358974358,0
3537,4,0,0,48,0.0,0.0,1.0,48,1100,700,400,0.6363636363636364,15,7,8,302.20337796067554,0.8625517139479906,0.17207203852646247,0.1752153263927438,130937.79047070183,-1686.031483409358,129251.75898729247,3523,1,375.3333333333333,40,8,18,36.39865289775924,0.6226562500000001,44.131097560975604,1023.4756097560966,25.586890243902413,0
3538,4,0,0,48,0.0,0.0,1.0,48,1750,1200,550,0.6857142857142857,23,12,11,297.7894541109678,0.8617205969267139,0.1094244685662602,0.17281167533841144,130972.46334876496,-1799.5563271605401,129172.90702160442,3524,2,376.3333333333333,41,7,16,36.476707372229754,0.6214430894308944,44.0972222222222,1023.6111111111073,24.96612466124652,2
3539,4,0,1,47,0.0,0.020833333333333332,0.9791666666666666,48,1300,1100,200,0.8461538461538461,15,11,4,297.3738989150865,0.8609633569739953,0.1098457328296043,0.1731410467287328,131099.43000637725,-1802.8902706916404,129296.53973568561,3525,3,377.3333333333333,41,7,16,36.35964593625884,0.6227134146341464,43.97321428571427,1024.1071428571404,24.97822299651562,0
3540,4,0,1,46,0.0,0.02127659574468085,0.9787234042553191,47,1550,1200,350,0.7741935483870968,19,12,7,303.10136805188944,0.8553422756706752,0.1120014188619971,0.17645017249329215,131093.8545694526,-1453.0546673607032,129640.79990209191,3526,4,386.25531914893617,40,7,18,36.218616651781296,0.62421875,43.978658536585364,1024.0853658536578,25.602134146341445,0
3541,4,0,0,46,0.0,0.0,1.0,46,1650,1300,350,0.7878787878787878,20,13,7,306.7301811362854,0.8510466988727858,0.101397673492857,0.17841169707512922,131061.33355034715,-1159.9066840277835,129901.42686631937,3527,5,395.3478260869565,39,7,18,36.15844354018312,0.625534188034188,44.010416666666664,1023.9583333333327,26.255341880341863,0
3542,4,0,2,44,0.0,0.043478260869565216,0.9565217391304348,46,1700,1100,600,0.6470588235294118,23,11,12,305.99672545965063,0.850925925925926,0.10091272508578886,0.1782322159193887,131114.6701388888,-1175.8680555555668,129938.80208333323,3528,6,396.3478260869565,39,7,18,36.1235421752102,0.6260683760683762,43.95833333333333,1024.1666666666658,26.26068376068374,0
3543,4,0,0,44,0.0,0.0,1.0,44,750,700,50,0.9333333333333333,8,7,1,317.8169482541904,0.8482426004228331,0.10259051459630064,0.1841207683461426,130906.99932912037,-479.1073936211312,130427.89193549924,3529,7,399.34090909090907,37,7,18,36.03019304260866,0.6275337837837839,44.16118421052631,1023.3552631578937,27.658250355618748,0
3544,4,0,1,43,0.0,0.022727272727272728,0.9772727272727273,44,1200,900,300,0.75,15,9,6,319.6059086166322,0.847758104298802,0.10909821298144817,0.1854270451793822,130963.11034404808,-428.68322464605683,130534.42711940203,3530,8,400.34090909090907,37,7,18,35.92784770576683,0.6280968468468469,44.1063596491228,1023.574561403508,27.664177335229947,0
3545,4,1,1,43,0.022727272727272728,0.022727272727272728,0.9772727272727273,44,1200,1000,200,0.8333333333333334,14,10,4,320.3637081527667,0.8484628259337562,0.11227326277663607,0.1861378931563399,131019.23338190594,-405.23851088797437,130613.99487101797,3531,0,400.90909090909093,37,7,18,35.851875156188626,0.6286599099099099,44.051535087719294,1023.7938596491225,27.670104314841147,0
3546,4,1,0,44,0.022727272727272728,0.0,1.0,44,700,500,200,0.7142857142857143,9,5,4,325.39618996085204,0.8434416842847076,0.13510114524242778,0.18989235495341883,131187.67463305994,-262.4061009156916,130925.26853214426,3532,0,401.8863636363636,37,7,19,35.55324396161119,0.6303490990990992,43.88706140350876,1024.451754385963,27.68788525367468,0
3547,4,1,0,45,0.022222222222222223,0.0,1.0,45,900,500,400,0.5555555555555556,13,5,8,318.470532940125,0.8505471380471381,0.1392922873910476,0.1872013867539656,131465.0463533676,-626.4513249689602,130838.59502839863,3533,0,393.93333333333334,38,7,20,35.45139250616385,0.6313048245614036,43.61645299145299,1025.5341880341875,26.987741790373356,0
3548,4,1,1,45,0.021739130434782608,0.021739130434782608,0.9782608695652174,46,900,400,500,0.4444444444444444,14,4,10,313.85787741621834,0.8525563607085347,0.14452618486861235,0.1861619106840603,131809.033203125,-926.139322916667,130882.89388020833,3534,0,386.3478260869565,39,7,17,35.22392980320553,0.6330128205128206,43.28125,1026.875,26.330128205128204,0
3549,4,0,0,45,0.0,0.0,1.0,45,1200,800,400,0.6666666666666666,16,8,8,321.98743622612585,0.8470117845117846,0.13748265334443555,0.19049601522540732,131711.6845642485,-518.0984732266952,131193.58609102183,3535,1,395.9111111111111,38,7,17,35.11310019428254,0.6337719298245614,43.37606837606837,1026.4957264957252,27.013045434098032,0
3550,4,1,2,44,0.021739130434782608,0.043478260869565216,0.9565217391304348,46,1100,700,400,0.6363636363636364,15,7,8,317.3804454284678,0.8506642512077295,0.14092527945273092,0.18904835227695688,131969.53125000003,-823.0902777777762,131146.44097222225,3536,0,388.2826086956522,39,7,18,34.972289808056225,0.6346153846153847,43.125,1027.5000000000002,26.34615384615385,0
3551,4,1,0,45,0.022222222222222223,0.0,1.0,45,1350,1000,350,0.7407407407407407,17,10,7,329.18626919504123,0.8448232323232324,0.15135509807998915,0.19616564666158,131985.99810979588,-310.40433925052344,131675.59377054535,3537,0,397.5777777777778,38,7,19,34.65247452692868,0.636513157894737,43.10897435897434,1027.5641025641003,27.041160593792114,0
3552,4,0,0,45,0.0,0.0,1.0,45,1650,1200,450,0.7272727272727273,21,12,9,330.7709765559118,0.8432239057239058,0.15800519480519526,0.19811267264160842,132178.1873790085,-255.85837625102295,131922.3290027575,3538,1,398.5777777777778,38,7,19,34.41861471861472,0.6384320175438598,42.92200854700854,1028.3119658119645,27.06084120557801,0
3553,4,0,0,45,0.0,0.0,1.0,45,1000,700,300,0.7,13,7,6,334.1788568827693,0.8420454545454545,0.16789918293865091,0.20059065050294905,132260.59701219958,-160.260975966106,132100.33603623346,3539,2,399.5777777777778,38,7,19,34.24819969533304,0.6392543859649124,42.84188034188034,1028.6324786324788,27.069275753486284,0
3554,4,0,0,45,0.0,0.0,1.0,45,1400,1200,200,0.8571428571428571,16,12,4,336.5209347118191,0.8419612794612795,0.17562731457446423,0.2024380463591212,132343.0323275075,-92.75981171013154,132250.27251579738,3540,3,400.5777777777778,38,7,19,34.10514657529505,0.6400767543859649,42.761752136752136,1028.9529914529917,27.077710301394518,0
3555,4,0,0,45,0.0,0.0,1.0,45,1400,1000,400,0.7142857142857143,18,10,8,333.53841743368866,0.841919191919192,0.17417479759186194,0.20108317356421482,132425.49332493235,-166.20210570532356,132259.29121922702,3541,4,401.5777777777778,38,7,19,34.09906753857862,0.6408991228070176,42.681623931623925,1029.2735042735035,27.086144849302723,0
3556,4,0,0,45,0.0,0.0,1.0,45,1250,600,650,0.48,19,6,13,333.24078687118975,0.8399410774410775,0.18606981944023082,0.20204893570626592,132639.32427300359,-159.8334418402718,132479.4908311633,3542,5,402.5777777777778,39,6,14,33.89214025685104,0.6412927350427351,42.473958333333336,1030.1041666666674,26.41292735042737,0
3557,4,0,0,45,0.0,0.0,1.0,45,1250,700,550,0.56,18,7,11,334.3356038388684,0.8382154882154883,0.19154733425429926,0.20329330846821905,132746.64849175338,-123.61382378472655,132623.03466796866,3543,6,403.5777777777778,39,6,16,33.75629653964082,0.6423611111111112,42.369791666666664,1030.5208333333328,26.423611111111097,0
3558,4,0,1,44,0.0,0.022222222222222223,0.9777777777777777,45,1300,800,500,0.6153846153846154,18,8,10,334.8320579832561,0.8381313131313132,0.1951827522317673,0.2038869669996502,132800.32687717,-106.83865017361984,132693.4882269964,3544,7,404.5777777777778,39,6,16,33.68967913087419,0.6428952991452992,42.31770833333333,1030.7291666666656,26.428952991452963,0
3559,4,0,0,44,0.0,0.0,1.0,44,1250,1100,150,0.88,14,11,3,333.3344257206202,0.8379580690627203,0.193504459569934,0.20326622374349834,132854.01611328125,56.96343315972274,132910.97954644097,3545,8,408.3863636363636,39,5,16,33.674451012091204,0.6434294871794872,42.265625,1030.9375,26.434294871794872,0
3560,4,0,0,44,0.0,0.0,1.0,44,1300,1100,200,0.8461538461538461,15,11,4,331.6804407713499,0.8382443622269204,0.192791551882461,0.20269360269360273,132934.5703125,18.359375000000796,132952.9296875,3546,9,409.3863636363636,39,5,17,33.636363636363626,0.6442307692307693,42.1875,1031.25,26.442307692307693,0
3561,4,0,0,44,0.0,0.0,1.0,44,650,400,250,0.6153846153846154,9,4,5,333.0391829017484,0.8383324524312896,0.19231652007858857,0.20381668659413552,132988.28667534716,58.06206597221757,133046.34874131938,3547,10,410.3863636363636,39,5,17,33.54751565340336,0.6447649572649572,42.135416666666664,1031.458333333333,26.447649572649564,0
3562,4,0,0,44,0.0,0.0,1.0,44,750,500,250,0.6666666666666666,10,5,5,336.64699695428254,0.8376277307963355,0.19863416066970152,0.20632127833138733,133042.01388888908,157.6388888889088,133199.65277777798,3548,11,411.3863636363636,39,5,17,33.40064620355411,0.6452991452991452,42.08333333333334,1031.6666666666683,26.452991452991494,0
3563,4,0,0,44,0.0,0.0,1.0,44,1050,700,350,0.6666666666666666,14,7,7,338.7806097460389,0.8371872797744891,0.20307769929364228,0.20852893432194097,133203.26063368074,225.3363715277984,133428.59700520855,3549,12,412.3863636363636,39,5,18,33.184073326606125,0.6469017094017093,41.92708333333334,1032.2916666666683,26.469017094017136,0
3564,4,0,1,43,0.0,0.022727272727272728,0.9772727272727273,44,1350,1100,250,0.8148148148148148,16,11,5,340.0159409211202,0.8367468287526427,0.21222739648170652,0.21035172090547438,133391.50526258704,271.04763454863564,133662.55289713567,3550,13,413.3863636363636,39,5,18,32.96370290074283,0.6487713675213674,41.74479166666668,1033.0208333333353,26.487713675213726,0
3565,4,0,0,43,0.0,0.0,1.0,43,1400,800,600,0.5714285714285714,20,8,12,343.33142560286063,0.8301033591731266,0.15997501344436427,0.210266611487021,133015.14892578122,533.6561414930555,133548.80506727428,3551,14,422.93023255813955,39,4,18,33.25517940691375,0.6450320512820513,42.109375,1031.5624999999998,26.450320512820507,2
3566,4,0,0,43,0.0,0.0,1.0,43,1250,700,550,0.56,18,7,11,342.24848075301384,0.8294112218530822,0.16232835078282193,0.21051149570339,133176.37939453122,515.8827039930563,133692.26209852428,3552,15,423.93023255813955,39,4,18,33.12150990681873,0.6466346153846154,41.953125,1032.1874999999998,26.46634615384615,0
3567,4,0,0,43,0.0,0.0,1.0,43,900,500,400,0.5555555555555556,13,5,8,338.86329786527347,0.8288575119970468,0.1557878645020434,0.20920588292265543,133314.74837233132,435.0950575054559,133749.84342983676,3553,16,424.93023255813955,40,3,18,33.07030276192351,0.6463541666666668,41.81910569105691,1032.7235772357726,25.818089430894315,0
3568,4,0,0,43,0.0,0.0,1.0,43,1750,1300,450,0.7428571428571429,22,13,9,341.0323103338212,0.8269656699889257,0.1594671314627123,0.21129040214283756,133445.97012566944,501.8774993390391,133947.84762500846,3554,17,425.93023255813955,40,3,19,32.88293826431921,0.6476562499999999,41.69207317073172,1033.2317073170746,25.830792682926862,0
3569,4,0,0,43,0.0,0.0,1.0,43,1000,700,300,0.7,13,7,6,341.76638917793946,0.8266426725729051,0.16204051012753173,0.21189516129032263,133472.2222222223,523.2638888888997,133995.4861111112,3555,18,426.93023255813955,40,3,19,32.837701612903224,0.6479166666666667,41.66666666666667,1033.3333333333342,25.833333333333353,0
3570,4,0,0,43,0.0,0.0,1.0,43,1300,700,600,0.5384615384615384,19,7,12,342.89845906075357,0.8257198228128461,0.1616466539123418,0.21323171528739365,133582.64391116935,561.0565508802473,134143.7004620496,3556,19,427.93023255813955,38,5,20,32.69795542235084,0.6524122807017545,41.55982905982905,1033.760683760682,27.20422852001795,0
3571,4,0,0,43,0.0,0.0,1.0,43,750,400,350,0.5333333333333333,11,4,7,339.73906852663384,0.8263658176448874,0.1537052608403382,0.212021949176678,133714.5195855034,485.6092664930521,134200.12885199647,3557,20,428.93023255813955,39,4,16,32.64773642864337,0.6519764957264957,41.432291666666664,1034.270833333333,26.51976495726495,0
3572,4,0,0,43,0.0,0.0,1.0,43,1400,1100,300,0.7857142857142857,17,11,6,339.88836533048186,0.8259043927648578,0.14787063660800448,0.21258005317772954,133795.33420138882,495.09548611110654,134290.4296874999,3558,21,429.93023255813955,39,4,17,32.563095717545984,0.6527777777777778,41.354166666666664,1034.5833333333328,26.527777777777764,0
3573,4,0,0,43,0.0,0.0,1.0,43,1250,800,450,0.64,17,8,9,337.6940249510744,0.8270118124769287,0.14744438776226576,0.2121367395678746,133957.03667534713,447.29817708332934,134404.33485243047,3559,22,430.93023255813955,39,4,17,32.45832494801101,0.654380341880342,41.197916666666664,1035.2083333333328,26.543803418803407,0
3574,4,0,0,43,0.0,0.0,1.0,43,1050,900,150,0.8571428571428571,12,9,3,340.70835549465903,0.8256275378368402,0.15071601334250273,0.21465921865195822,134064.89257812503,535.4058159722222,134600.29839409725,3560,23,431.93023255813955,39,4,18,32.27259773352108,0.655448717948718,41.09375,1035.6250000000002,26.554487179487186,0
3575,4,0,0,43,0.0,0.0,1.0,43,1100,900,200,0.8181818181818182,13,9,4,340.15923279477516,0.8257198228128461,0.1490504324080415,0.2151025994030281,134199.77349175356,529.8583984375108,134729.63189019106,3561,24,432.93023255813955,39,4,18,32.1521773734124,0.656784188034188,40.96354166666667,1036.1458333333342,26.567841880341902,0
3576,4,0,0,43,0.0,0.0,1.0,43,1500,1000,500,0.6666666666666666,20,10,10,340.4805843906191,0.823827980804725,0.1450341997264022,0.215976490098527,134313.65258774534,546.238184942822,134859.89077268817,3562,25,433.93023255813955,40,3,19,32.030228758169926,0.65625,40.853658536585364,1036.5853658536582,25.914634146341456,0
3577,4,0,0,43,0.0,0.0,1.0,43,1200,1000,200,0.8333333333333334,14,10,4,342.2824324970139,0.8242432631967516,0.14333640250517332,0.21774625568575623,134419.01728468502,601.8536420120262,135020.87092669704,3563,26,434.93023255813955,40,3,19,31.878430027440217,0.6572916666666667,40.7520325203252,1036.991869918699,25.924796747967473,0
3578,4,0,0,43,0.0,0.0,1.0,43,1000,600,400,0.6,14,6,8,342.0165418234882,0.8239664082687338,0.14985966319166,0.21820655368338565,134524.42329301353,601.915609095126,135126.33890210866,3564,27,435.93023255813955,40,3,19,31.780221394984324,0.6583333333333332,40.650406504065046,1037.3983739837406,25.934959349593516,0
3579,4,0,0,43,0.0,0.0,1.0,43,850,500,350,0.5882352941176471,12,5,7,340.1724986179519,0.8239202657807309,0.14809027137925534,0.21769659901412508,134636.1154994804,559.9085086200498,135196.02400810044,3565,28,436.93023255813955,37,6,19,31.71674150378587,0.664695945945946,40.542763157894726,1037.8289473684194,28.04943100995728,0
3580,4,0,0,43,0.0,0.0,1.0,43,1100,700,400,0.6363636363636364,15,7,8,339.603005616046,0.823827980804725,0.1466342079340479,0.21767242072898485,134693.02002779694,548.4308873884227,135241.45091518536,3566,29,437.93023255813955,37,6,19,31.674830991866493,0.665259009009009,40.487938596491226,1038.0482456140346,28.055357989568503,0
3581,4,0,0,43,0.0,0.0,1.0,43,950,700,250,0.7368421052631579,12,7,5,337.2352418407935,0.8240125507567367,0.14230495321824144,0.21666334736989892,134778.3993632655,490.40522083716786,135268.80458410265,3567,30,438.93023255813955,37,6,19,31.651267159450896,0.6661036036036037,40.40570175438596,1038.3771929824552,28.064248458985276,0
3582,4,0,0,43,0.0,0.0,1.0,43,1050,700,350,0.6666666666666666,14,7,7,335.74261401755894,0.8238741232927279,0.13676963779105655,0.21616488036282835,134855.7749379063,455.3660786032545,135311.14101650956,3568,31,439.93023255813955,38,5,18,31.613008297332506,0.6650219298245614,40.33119658119658,1038.6752136752134,27.333558254610878,0
3583,4,0,0,43,0.0,0.0,1.0,43,1000,700,300,0.7,13,7,6,336.1191340901945,0.8230897009966777,0.13294366372341782,0.216738889913332,134911.26543209862,469.25154320986417,135380.51697530848,3569,32,440.93023255813955,38,5,18,31.548016934046352,0.6655701754385965,40.27777777777777,1038.8888888888878,27.339181286549678,0
3584,4,0,0,43,0.0,0.0,1.0,43,1350,1000,350,0.7407407407407407,17,10,7,337.5538138122206,0.8220745662606127,0.13643697695931856,0.21850040283294037,135050.04160502952,517.3313198553526,135567.37292488487,3570,33,441.93023255813955,38,5,18,31.37270017473533,0.6669407894736842,40.14423076923077,1039.4230769230765,27.353238866396747,0
3585,4,0,0,43,0.0,0.0,1.0,43,1150,600,550,0.5217391304347826,17,6,11,334.9216548731282,0.8209210040605389,0.14179022462621993,0.21763200190487528,135188.8891171744,455.5372927167818,135644.4264098912,3571,34,442.93023255813955,38,5,18,31.303078556263273,0.6683114035087719,40.01068376068376,1039.9572649572654,27.367296446243824,0
3586,4,0,0,43,0.0,0.0,1.0,43,1100,600,500,0.5454545454545454,16,6,10,330.90220093923625,0.8200904392764857,0.11529465975019715,0.21654916136121746,135443.8598632814,364.46478004409744,135808.3246433255,3572,35,443.93023255813955,39,4,18,31.154412255245337,0.6690705128205128,39.76562500000001,1040.9375000000011,26.690705128205156,2
3587,4,0,0,43,0.0,0.0,1.0,43,1100,800,300,0.7272727272727273,14,8,6,334.0372015191193,0.817921742340347,0.12312229887838,0.219428642627343,135579.43250868077,457.71484375002495,136037.1473524308,3573,36,444.93023255813955,39,4,18,30.93827098753085,0.6704059829059827,39.63541666666668,1041.458333333335,26.704059829059872,0
3588,4,0,0,43,0.0,0.0,1.0,43,850,700,150,0.8235294117647058,10,7,3,337.7099797222231,0.8171834625322997,0.12618151380615106,0.22253260938422778,135690.79548514934,564.8488597453149,136255.64434489465,3574,37,445.93023255813955,37,6,18,30.732126569844937,0.6751126126126126,39.52850877192983,1041.8859649122812,28.15908013276436,0
3589,4,0,0,43,0.0,0.0,1.0,43,1200,800,400,0.6666666666666666,16,8,8,335.3743339180501,0.8167220376522701,0.12436794488217129,0.221501464276952,135772.8276923991,506.94433030171393,136279.7720227008,3575,38,446.93023255813955,38,5,18,30.711600888433292,0.6740679824561402,39.44978632478633,1042.2008547008554,27.42633828160146,0
3590,4,0,0,43,0.0,0.0,1.0,43,1150,800,350,0.6956521739130435,15,8,7,334.45137861982454,0.81593761535622,0.12222767723084704,0.2214095354526627,135856.35021732777,487.46872488859526,136343.81894221637,3576,39,447.93023255813955,38,5,18,30.652840404454462,0.674890350877193,39.36965811965812,1042.5213675213674,27.43477282950967,0
3591,4,0,0,43,0.0,0.0,1.0,43,950,400,550,0.42105263157894735,15,4,11,335.96437186500685,0.8151531930601698,0.12831002176675388,0.2228853099231668,135932.2387695314,533.6778428819589,136465.91661241336,3577,40,448.93023255813955,39,4,16,30.538178836613056,0.6738782051282051,39.29687500000001,1042.8125000000011,26.73878205128208,0
3592,4,0,0,43,0.0,0.0,1.0,43,1350,900,450,0.6666666666666666,18,9,9,359.14841634648536,0.8151531930601698,0.11401971882588913,0.21979527927459191,132988.28667534716,952.5065104166632,133940.79318576382,3578,41,449.93023255813955,39,4,19,32.874250993065374,0.6447649572649572,42.135416666666664,1031.458333333333,26.447649572649564,5
3593,4,0,0,43,0.0,0.0,1.0,43,1250,800,450,0.64,17,8,9,357.44432142688925,0.8151531930601698,0.10344471463041383,0.21969964867851222,133149.5008680555,918.7065972222185,134068.20746527772,3579,42,450.93023255813955,39,4,19,32.75635849818328,0.6463675213675215,41.979166666666664,1032.083333333333,26.463675213675206,0
3594,4,0,0,43,0.0,0.0,1.0,43,1200,900,300,0.75,15,9,6,352.51356135226155,0.8157991878922111,0.10245319046122225,0.21761017728806464,133310.81271701382,798.7738715277738,134109.5865885416,3580,43,451.93023255813955,39,4,19,32.72182435612938,0.6479700854700855,41.822916666666664,1032.7083333333328,26.47970085470084,0
3595,4,0,0,43,0.0,0.0,1.0,43,1300,900,400,0.6923076923076923,17,9,8,352.4277173244072,0.8145533407161314,0.10460661142297067,0.21818839578173987,133418.40820312515,804.0690104166814,134222.47721354183,3581,44,452.93023255813955,39,4,19,32.616202863480545,0.6490384615384615,41.71875000000001,1033.1250000000011,26.490384615384645,0
3596,4,0,0,43,0.0,0.0,1.0,43,1000,700,300,0.7,13,7,6,370.15004296384427,0.8145533407161314,0.0960484023444883,0.21680216802168017,131328.125,1190.4188368055559,132518.54383680556,3582,45,453.93023255813955,35,8,18,34.264905149051486,0.6357142857142857,43.75,1025.0,29.285714285714285,7
3597,4,1,1,43,0.022727272727272728,0.022727272727272728,0.9772727272727273,44,800,400,400,0.5,12,4,8,367.5048453721297,0.8189746300211417,0.0924079486846956,0.21704936201401295,131645.74361100973,876.089729932638,132521.83334094236,3583,0,444.59090909090907,36,8,15,34.011622590438556,0.6368634259259259,43.44031531531532,1026.2387387387394,28.50663163163165,0
3598,4,1,1,43,0.022727272727272728,0.022727272727272728,0.9772727272727273,44,950,600,350,0.631578947368421,13,6,7,368.34427166254073,0.8184460887949261,0.09195880915573729,0.21787527814432558,131703.5336645767,902.4484366122806,132605.982101189,3584,0,445.5681818181818,36,8,16,33.93170597915523,0.6374421296296298,43.384009009009006,1026.4639639639636,28.512887887887878,0
3599,4,1,1,43,0.022727272727272728,0.022727272727272728,0.9772727272727273,44,1150,900,250,0.782608695652174,14,9,5,367.3168667282241,0.8197013742071882,0.09996511164274291,0.21809438961988306,131848.0642804967,886.0035711387031,132734.06785163542,3585,0,446.54545454545456,36,8,16,33.81213450292399,0.6388888888888888,43.24324324324324,1027.0270270270269,28.528528528528525,0
3600,4,0,0,43,0.0,0.0,1.0,43,950,600,350,0.631578947368421,13,6,7,368.5019973472612,0.8140457733480989,0.04135818598844465,0.2186445184260414,131821.37573964478,1116.4325650714486,132937.80830471622,3586,49,457.93023255813955,38,5,16,33.80865064502704,0.6348684210526316,43.26923076923076,1026.9230769230755,27.02429149797567,3
3601,4,0,0,43,0.0,0.0,1.0,43,650,200,450,0.3076923076923077,11,2,9,370.17986447757954,0.8132152085640457,0.0482817491312626,0.220434659856401,131958.55391418267,1169.6799209218807,133128.23383510456,3587,50,458.93023255813955,38,5,16,33.627083983224146,0.6362390350877194,43.13568376068375,1027.4572649572629,27.038349077822705,0
3602,4,0,0,43,0.0,0.0,1.0,43,900,700,200,0.7777777777777778,11,7,4,369.3442496788441,0.812984496124031,0.048246854901073055,0.22000070524348525,131969.53125,1148.4374999999995,133117.96875,3588,51,459.93023255813955,39,4,16,33.6374695863747,0.6346153846153847,43.125,1027.5,26.346153846153847,0
3603,4,1,1,43,0.022727272727272728,0.022727272727272728,0.9772727272727273,44,1050,900,150,0.8571428571428571,12,9,3,364.422049417447,0.8157593375616632,0.047554555336944526,0.21832958662256613,132188.9058781973,834.510398076517,133023.41627627384,3589,0,450.45454545454544,40,4,17,33.542716671607856,0.6351562500000001,42.91158536585365,1028.3536585365837,25.708841463414593,0
3604,4,0,0,43,0.0,0.0,1.0,43,1400,800,600,0.5714285714285714,20,8,12,370.6325426386574,0.8123846437799925,0.03690868011299253,0.2218625729767241,132156.90239800324,1196.329752604142,133353.23215060736,3590,53,461.93023255813955,39,4,17,33.41532857191098,0.6364850427350428,42.94270833333332,1028.2291666666647,26.364850427350376,0
3605,4,0,1,42,0.0,0.023255813953488372,0.9767441860465116,43,850,700,150,0.8235294117647058,10,7,3,373.45666445166313,0.8121539313399778,0.035421951811258845,0.22386992399096944,132210.4614257811,1274.975585937485,133485.43701171858,3591,54,462.93023255813955,39,4,17,33.28870404132483,0.6370192307692308,42.89062499999999,1028.4374999999989,26.370192307692278,0
3606,4,0,0,42,0.0,0.0,1.0,42,900,600,300,0.6666666666666666,12,6,6,376.69230912743086,0.8114595431668602,0.03945493409333789,0.2254531581494026,132150.72320841538,1556.0322156475856,133706.75542406295,3592,55,472.73809523809524,38,4,17,33.26579384871155,0.6381578947368423,42.94871794871794,1028.2051282051273,27.058029689608613,0
3607,4,0,2,40,0.0,0.047619047619047616,0.9523809523809523,42,1050,700,350,0.6666666666666666,14,7,7,379.0814483714614,0.8109030197444832,0.043349856044641255,0.22721282827046604,132205.65440317037,1623.3421908101304,133828.9965939805,3593,56,473.73809523809524,38,4,17,33.14893690698801,0.6387061403508772,42.89529914529914,1028.4188034188028,27.06365272154744,0
3608,4,0,0,40,0.0,0.0,1.0,40,950,600,350,0.631578947368421,13,6,7,384.701833506849,0.8090010683760683,0.03247334754797482,0.23072271088837873,132228.78674207442,2173.731340412428,134402.51808248684,3594,57,478.625,37,3,18,32.981076759061835,0.6407657657657657,42.872807017543856,1028.508771929824,27.797534376481728,0
3609,4,0,0,40,0.0,0.0,1.0,40,1000,800,200,0.8,12,8,4,389.3653624377647,0.809241452991453,0.026582312200319702,0.23439345262850692,132369.793169533,2308.0424986534344,134677.83566818642,3595,58,479.625,37,3,18,32.71876664890784,0.6421734234234234,42.73574561403509,1029.05701754386,27.81235182550973,0
3610,4,0,0,40,0.0,0.0,1.0,40,950,600,350,0.631578947368421,13,6,7,386.89036691242313,0.8077457264957265,0.02140206881043394,0.2334466026675096,132457.56842635458,2249.3174612250086,134706.88588757958,3596,59,480.625,35,5,18,32.693857282062815,0.6470238095238094,42.65046296296296,1029.398148148148,29.411375661375658,0
3611,4,0,0,40,0.0,0.0,1.0,40,800,500,300,0.625,11,5,6,384.458620154236,0.8076923076923077,0.020436151079136655,0.23234673131060374,132517.1467764061,2189.4718792866993,134706.6186556928,3597,60,481.625,35,5,18,32.69634292565947,0.6476190476190475,42.592592592592595,1029.6296296296302,29.417989417989435,0
3612,4,0,0,40,0.0,0.0,1.0,40,650,300,350,0.46153846153846156,10,3,7,386.90231252009164,0.8073717948717949,0.02088671611598114,0.23419433855808003,132576.73852237655,2258.849344135801,134835.58786651236,3598,61,482.625,35,5,18,32.57333108563722,0.6482142857142856,42.53472222222222,1029.861111111111,29.424603174603174,0
3613,4,1,1,40,0.024390243902439025,0.024390243902439025,0.975609756097561,41,1050,700,350,0.6666666666666666,14,7,7,380.9847312378361,0.8105691056910569,0.026095110230263563,0.23255307994757543,132891.02447041657,1925.8902483564866,134816.91471877304,3599,0,471.8292682926829,36,5,16,32.4090760157274,0.6493055555555556,42.22972972972974,1031.0810810810826,28.641141141141183,0
3614,4,0,0,40,0.0,0.0,1.0,40,950,600,350,0.631578947368421,13,6,7,389.74575334800284,0.8055555555555556,0.02652706040871311,0.23741967710788742,132815.23946544927,2352.8351123113853,135168.07457776065,3600,63,484.625,35,5,16,32.25961898345684,0.6505952380952381,42.30324074074074,1030.7870370370372,29.451058201058206,0
3615,4,0,0,40,0.0,0.0,1.0,40,1000,800,200,0.8,12,8,4,396.3751696218195,0.8040064102564103,0.031104129263914038,0.24261644997731183,132994.25582990417,2543.1241426611996,135537.37997256537,3601,64,485.625,35,5,16,31.908288450029936,0.6523809523809522,42.12962962962964,1031.481481481483,29.47089947089951,0
3616,4,0,0,40,0.0,0.0,1.0,40,1200,700,500,0.5833333333333334,17,7,10,395.6210617486557,0.8020833333333334,0.03130728939327798,0.24299406232337062,133123.35139193284,2533.2803242432024,135656.63171617605,3602,65,486.625,36,4,17,31.79765931907465,0.6516203703703702,42.004504504504524,1031.981981981985,28.66616616616625,0
3617,4,0,1,39,0.0,0.025,0.975,40,1200,1000,200,0.8333333333333334,14,10,4,390.56159830946245,0.802590811965812,0.03053616232137024,0.24044850045015786,133210.52629910348,2405.3832126045354,135615.909511708,3603,66,487.625,36,4,17,31.840433075160913,0.6524884259259258,41.920045045045065,1032.3198198198224,28.675550550550625,0
3618,4,0,0,39,0.0,0.0,1.0,39,850,600,250,0.7058823529411765,11,6,5,377.58138171707066,0.8010008996851102,0.039320407136499425,0.2216842836216177,131419.6588010205,2137.740404324636,133557.39920534514,3604,67,483.35897435897436,34,5,18,33.98182011687759,0.6387867647058822,43.66071428571429,1025.3571428571436,30.157563025210106,3
3619,4,1,1,39,0.025,0.025,0.975,40,1350,1000,350,0.7407407407407407,17,10,7,368.67382073818175,0.8090544871794871,0.031116291826659648,0.21807020610178618,131703.53366457668,1711.128992167837,133414.6626567445,3605,0,472.25,36,4,16,33.92324922289266,0.6374421296296298,43.384009009009006,1026.4639639639634,28.51288788788787,0
3620,4,0,0,39,0.0,0.0,1.0,39,800,500,300,0.625,11,5,6,375.61390399134245,0.8002136752136753,0.030456852791878264,0.2215447278032767,131595.1877170138,2085.7964409722117,133680.984157986,3606,69,485.35897435897436,35,4,16,33.85469543147209,0.6383928571428572,43.48958333333333,1026.0416666666658,29.315476190476165,0
3621,4,0,0,39,0.0,0.0,1.0,39,950,600,350,0.631578947368421,13,6,7,381.6751638780587,0.8001012145748988,0.030748419656096315,0.22617504200148686,131773.38023244598,2258.9252989969114,134032.3055314429,3607,70,486.35897435897436,35,4,17,33.51898038552587,0.6401785714285715,43.31597222222222,1026.736111111111,29.33531746031746,0
3622,4,0,0,39,0.0,0.0,1.0,39,800,500,300,0.625,11,5,6,380.8135676361956,0.7994264507422403,0.03520017993702185,0.22610805578399118,131848.06428049674,2241.906348916482,134089.9706294132,3608,71,487.35897435897436,36,3,18,33.46559758771931,0.638888888888889,43.24324324324324,1027.027027027027,28.52852852852853,0
3623,4,0,0,39,0.0,0.0,1.0,39,1000,900,100,0.9,11,9,2,386.7600974767313,0.7990328385065227,0.03823957472872652,0.23069102284788562,132021.60564280493,2412.1378134891625,134433.7434562941,3609,72,488.35897435897436,36,3,18,33.137464387464384,0.640625,43.07432432432432,1027.7027027027025,28.54729729729729,0
3624,4,0,0,39,0.0,0.0,1.0,39,1350,1300,50,0.9629629629629629,14,13,1,392.4378628786094,0.7976833108412056,0.03907230651289351,0.23497377875046466,132166.31063073222,2573.4128976950083,134739.72352842722,3610,73,489.35897435897436,36,3,18,32.84529806884971,0.6420717592592592,42.933558558558566,1028.265765765767,28.56293793793797,0
3625,4,0,0,39,0.0,0.0,1.0,39,1050,400,650,0.38095238095238093,17,4,13,388.3622956928727,0.7963337831758884,0.0409425658987832,0.2334261798322427,132311.0948786626,2476.928110542996,134788.0229892056,3611,74,490.35897435897436,36,3,18,32.80383464681845,0.6435185185185185,42.7927927927928,1028.8288288288302,28.578578578578615,0
3626,4,1,1,39,0.025,0.025,0.975,40,1300,900,400,0.6923076923076923,17,9,8,382.50111245909824,0.7996260683760684,0.03724177505738324,0.23221650151879863,132687.90486009684,2150.6827773719947,134838.58763746882,3612,0,479.075,36,4,17,32.57459831675593,0.6472800925925926,42.426801801801815,1030.292792792795,28.619244244244303,0
3627,4,0,0,39,0.0,0.0,1.0,39,850,500,350,0.5882352941176471,12,5,7,391.21870094253325,0.7944781826360774,0.03781467811134087,0.2369949094409534,132606.53941883158,2575.6316175840357,135182.17103641562,3613,76,492.35897435897436,35,4,18,32.43213188747801,0.6485119047619047,42.505787037037045,1029.976851851853,29.42791005291009,0
3628,4,0,0,39,0.0,0.0,1.0,39,850,600,250,0.7058823529411765,11,6,5,392.4027591149329,0.7947593342330185,0.04413619167717542,0.23841203492042767,132716.91243608494,2615.696524226952,135332.6089603119,3614,77,493.35897435897436,36,3,17,32.29030054644809,0.6475694444444443,42.39864864864866,1030.405405405407,28.622372372372418,0
3629,4,0,0,39,0.0,0.0,1.0,39,650,400,250,0.6153846153846154,9,4,5,391.24487291554556,0.7942532613585246,0.042103729603729656,0.2380766673486089,132774.93709926168,2589.5026783540575,135364.43977761574,3615,78,494.35897435897436,36,3,17,32.2616185897436,0.6481481481481481,42.342342342342356,1030.6306306306326,28.628628628628682,0
3630,4,0,0,39,0.0,0.0,1.0,39,1200,900,300,0.75,15,9,6,404.289696501187,0.7941970310391363,0.050262353636970625,0.227067876126799,129701.9692670822,2691.0862590685647,132393.05552615077,3616,79,495.35897435897436,35,4,17,35.04585179714425,0.6193452380952382,45.34143518518517,1018.634259259257,29.103835978835914,6
3631,4,0,0,39,0.0,0.0,1.0,39,1300,900,400,0.6923076923076923,17,9,8,399.36375022144904,0.7925101214574899,0.0555385721730679,0.22531688329277982,129878.87577428378,2573.782980752705,132452.65875503648,3617,80,496.35897435897436,35,4,17,34.99075072858711,0.6211309523809525,45.167824074074055,1019.3287037037009,29.12367724867717,0
3632,4,0,0,39,0.0,0.0,1.0,39,950,800,150,0.8421052631578947,11,8,3,402.90661292353246,0.7928475033738192,0.061571051130743015,0.22817564737031876,130026.3899605621,2677.6984739368654,132704.08843449896,3618,81,497.35897435897436,35,4,19,34.749962172794675,0.6226190476190478,45.02314814814813,1019.9074074074048,29.140211640211565,0
3633,4,1,0,40,0.025,0.0,1.0,40,700,500,200,0.7142857142857143,9,5,4,396.96386847433575,0.7998130341880342,0.07815612624504986,0.22672377765569848,130356.43029423783,2350.001574136378,132706.4318683742,3619,0,485.9,33,7,20,34.565257610304414,0.6303661616161615,44.69975490196079,1021.2009803921571,30.945484254307793,0
3634,4,0,0,40,0.0,0.0,1.0,40,850,500,350,0.5882352941176471,12,5,7,396.93124046116617,0.7995459401709402,0.07954763618910499,0.22688785720187662,130387.71896626311,2350.9918060361606,132738.71077229927,3620,1,486.9,33,7,20,34.53423726101913,0.6306818181818181,44.66911764705883,1021.3235294117659,30.949197860962602,0
3635,4,0,0,40,0.0,0.0,1.0,40,900,600,300,0.6666666666666666,12,6,6,395.2245663644716,0.7989850427350428,0.07604379124175176,0.22609449283787722,130419.01139285375,2308.959444684741,132727.97083753848,3621,2,487.9,33,7,20,34.545965806838645,0.6309974747474747,44.638480392156865,1021.4460784313728,30.95291146761736,0
3636,4,0,0,40,0.0,0.0,1.0,40,950,500,450,0.5263157894736842,14,5,9,397.770860634203,0.7988247863247864,0.08045759865659097,0.22791860241287656,130481.60750973197,2380.356263216086,132861.96377294805,3622,3,488.9,33,7,20,34.417231418176,0.6316287878787878,44.57720588235295,1021.6911764705893,30.96033868092695,0
3637,4,1,1,40,0.024390243902439025,0.024390243902439025,0.975609756097561,41,900,300,600,0.3333333333333333,15,3,12,389.0810876251367,0.8099085365853659,0.07829723798086885,0.2242355778974613,130706.03358892741,1971.0491415895,132677.0827305169,3623,0,477.9512195121951,35,6,18,34.411078098471975,0.6294642857142857,44.357638888888886,1022.569444444444,29.216269841269828,0
3638,4,1,1,40,0.024390243902439025,0.024390243902439025,0.975609756097561,41,1300,1100,200,0.8461538461538461,15,11,4,389.96466296100243,0.8063008130081301,0.09354647402783889,0.22618945894400436,130953.25213304508,2013.4281663420093,132966.68029938708,3624,0,478.9268292682927,36,5,20,34.137418857960185,0.6299189814814815,44.11599099099099,1023.5360360360351,28.43155655655653,0
3639,4,0,1,39,0.0,0.025,0.975,40,900,600,300,0.6666666666666666,12,6,6,392.2343462738507,0.8070512820512821,0.0787069629303705,0.2278468014041904,131010.89000740618,2277.394159362076,133288.28416676825,3625,1,475.85,36,4,20,34.02082645840207,0.6304976851851851,44.05968468468469,1023.7612612612623,28.437812812812844,0
3640,4,0,0,39,0.0,0.0,1.0,39,1050,800,250,0.7619047619047619,13,8,5,397.8659749454477,0.8049932523616734,0.08326590274333734,0.23035580121104812,130883.62328800156,2614.828076774693,133498.45136477627,3626,2,486.79487179487177,35,4,20,34.00598065829657,0.6312499999999999,44.18402777777778,1023.263888888889,29.236111111111114,0
3641,4,1,0,40,0.025,0.0,1.0,40,800,500,300,0.625,11,5,6,387.3664978009113,0.810042735042735,0.08750686888669068,0.22637429437960785,131241.56832085477,2167.7173372697175,133409.28565812449,3627,0,475.6,36,4,21,33.9114646298128,0.6328125,43.83445945945947,1024.6621621621632,28.462837837837867,0
3642,4,1,1,40,0.024390243902439025,0.024390243902439025,0.975609756097561,41,1200,700,500,0.5833333333333334,17,7,10,375.31526507317744,0.8186991869918699,0.0918220946915349,0.22149434555354913,131616.8533398265,1679.5913734680857,133296.4447132946,3628,0,464.9756097560976,36,5,18,33.84044849282997,0.636574074074074,43.46846846846848,1026.1261261261277,28.50350350350355,0
3643,4,0,0,40,0.0,0.0,1.0,40,1450,900,550,0.6206896551724138,20,9,11,383.2437328285914,0.810176282051282,0.09099368373561934,0.22622096772691686,131624.87809713642,2088.8819230109684,133713.7600201474,3629,2,477.6,35,5,19,33.62893826603505,0.6386904761904761,43.460648148148145,1026.157407407407,29.318783068783056,0
3644,4,0,0,40,0.0,0.0,1.0,40,1050,800,250,0.7619047619047619,13,8,5,382.9894651431639,0.8098824786324786,0.0889249069793665,0.22659997107102864,131713.96933138277,2089.0125332218704,133802.98186460463,3630,3,478.6,35,5,19,33.545331115871775,0.6395833333333334,43.37384259259259,1026.5046296296289,29.32870370370368,0
3645,4,0,1,39,0.0,0.025,0.975,40,1150,800,350,0.6956521739130435,15,8,7,383.94589700215045,0.8098824786324786,0.08528964273639161,0.22787638422074089,131832.80452942796,2123.3328778720625,133956.13740730003,3631,4,479.6,35,5,20,33.4006020135993,0.6407738095238096,43.25810185185184,1026.967592592591,29.341931216931172,0
3646,4,0,0,39,0.0,0.0,1.0,39,700,500,200,0.7142857142857143,9,5,4,392.41585099015794,0.8028002699055331,0.08905505042844086,0.2318723133232453,131663.90483276627,2533.400651927416,134197.3054846937,3632,8,492.79487179487177,34,5,21,33.3541159184936,0.6412377450980393,43.42261904761904,1026.3095238095225,30.185574229691838,0
3647,4,1,0,40,0.025,0.0,1.0,40,1050,900,150,0.8571428571428571,12,9,3,382.4476931034839,0.809241452991453,0.09605441027374173,0.22769873720185246,131951.69331114946,2092.924141589484,134044.61745273895,3633,0,481.45,35,5,22,33.318899966204825,0.6419642857142858,43.1423611111111,1027.4305555555536,29.355158730158674,0
3648,4,0,0,40,0.0,0.0,1.0,40,750,600,150,0.8,9,6,3,375.8724196741615,0.8089476495726495,0.09464868821078753,0.22448708534809836,132070.63567654727,1928.3418799296776,133998.97755647695,3634,1,482.45,35,5,22,33.367699771046816,0.643154761904762,43.02662037037036,1027.8935185185169,29.368386243386198,0
3649,4,0,0,40,0.0,0.0,1.0,40,900,700,200,0.7777777777777778,11,7,4,379.6656394516439,0.8087873931623931,0.09405458638154207,0.22746656820821684,132189.63162562152,2037.5722040037654,134227.20382962527,3635,2,483.45,35,5,22,33.15008910148189,0.6443452380952381,42.910879629629626,1028.356481481481,29.381613756613746,0
3650,4,0,0,40,0.0,0.0,1.0,40,850,600,250,0.7058823529411765,11,6,5,377.07285612415683,0.8080395299145299,0.09375773601890458,0.2262691743670073,132249.14969403707,1973.5129190243345,134222.6626130614,3636,3,484.45,35,5,22,33.15669423502496,0.6449404761904762,42.85300925925925,1028.587962962962,29.388227513227484,0
3651,4,0,0,40,0.0,0.0,1.0,40,950,700,250,0.7368421052631579,12,7,5,389.2053953302312,0.8072916666666666,0.003336815227483525,0.22905694577631658,131511.22448979603,2237.0593480769453,133748.28383787296,3637,4,485.45,34,6,19,33.59109021974621,0.6397058823529411,43.57142857142858,1025.7142857142865,30.168067226890777,5
3652,4,0,1,39,0.0,0.025,0.975,40,750,600,150,0.8,9,6,3,387.5338566242962,0.8081997863247863,0.0009426847662143967,0.22862110268616084,131602.82206632657,2200.1098356009147,133802.93190192748,3638,5,486.45,34,6,17,33.541207409985695,0.640625,43.48214285714286,1026.071428571429,30.178571428571438,0
3653,4,0,0,39,0.0,0.0,1.0,39,750,300,450,0.4,12,3,9,395.68662747621073,0.8026315789473685,0.006552638508692921,0.23367276576063403,131642.34459102273,2617.8230728565954,134260.1676638793,3639,15,499.79487179487177,33,6,17,33.292034869835206,0.6433080808080808,43.443627450980394,1026.2254901960787,31.0977421271539,0
3654,4,1,0,40,0.025,0.0,1.0,40,1050,700,350,0.6666666666666666,14,7,7,386.75580811369247,0.8069711538461538,0.01030569708198259,0.2313035428580226,132122.47732426302,2219.8270975056657,134342.3044217687,3640,0,488.275,34,6,18,33.03564536050641,0.6458333333333333,42.976190476190474,1028.0952380952378,30.23809523809523,0
3655,4,0,0,40,0.0,0.0,1.0,40,1250,1000,250,0.8,15,10,5,380.3570280349795,0.8060363247863248,0.0014467592592595224,0.2282142168209877,132244.8979591837,2060.0552721088507,134304.95323129254,3641,1,489.275,34,6,18,33.07653356481481,0.6470588235294117,42.85714285714286,1028.571428571429,30.252100840336144,0
3656,4,0,0,40,0.0,0.0,1.0,40,1000,700,300,0.7,13,7,6,394.6063850882411,0.8056623931623932,-0.04573170731707288,0.23112659698025553,131328.125,2481.947987528344,133810.07298752834,3642,2,490.275,33,7,20,33.638211382113816,0.6401515151515151,43.75,1025.0,31.060606060606062,7
3657,4,0,0,40,0.0,0.0,1.0,40,1450,1200,250,0.8275862068965517,17,12,5,394.3133196118639,0.8068108974358974,-0.04850973599331021,0.23228689644411735,131548.03929077744,2374.2288122356567,133922.2681030131,3643,3,491.275,33,7,20,33.42280392625334,0.6423611111111112,43.53553921568626,1025.8578431372537,31.086601307189504,0
3658,4,2,2,40,0.047619047619047616,0.047619047619047616,0.9523809523809523,42,1200,1100,100,0.9166666666666666,13,11,2,380.73464729594525,0.8174361207897793,-0.055476887758933335,0.2268565234022415,131981.42387902932,1649.9801740397643,133631.40405306907,3644,0,468.8333333333333,35,7,16,33.33286400841029,0.6422619047619048,43.11342592592592,1027.546296296295,29.35846560846557,0
3659,4,0,0,40,0.0,0.0,1.0,40,1100,900,200,0.8181818181818182,13,9,4,398.1752825096984,0.8057959401709401,-0.05166396103896109,0.23584228271728272,131755.55555555536,2492.3611111110877,134247.91666666645,3645,5,493.275,34,6,16,33.11350108225108,0.6421568627450982,43.33333333333332,1026.6666666666652,30.196078431372506,0
3660,4,0,0,40,0.0,0.0,1.0,40,950,600,350,0.631578947368421,13,6,7,376.40193590329557,0.8055555555555556,-0.046668306548594995,0.2281609349044034,132629.89921932074,1984.4301649622687,134614.32938428302,3646,6,494.275,36,4,17,32.79012244451733,0.6467013888888888,42.48310810810811,1030.0675675675682,28.612987987988006,2
3661,4,0,0,40,0.0,0.0,1.0,40,1250,1000,250,0.8,15,10,5,378.4228192419604,0.8030715811965812,-0.048390886241940434,0.23009616072313516,132745.92318247317,2046.817298717655,134792.74048119082,3647,7,495.275,36,4,17,32.62120715404511,0.6478587962962963,42.370495495495504,1030.5180180180193,28.625500500500536,0
3662,4,0,0,40,0.0,0.0,1.0,40,600,400,200,0.6666666666666666,8,4,4,375.3480667197828,0.8031517094017094,-0.05316801398295834,0.22875740364533256,132832.97444403882,1971.7200308416705,134804.6944748805,3648,8,496.275,36,4,17,32.612792221979454,0.6487268518518519,42.286036036036045,1030.8558558558573,28.634884884884926,0
3663,4,0,0,40,0.0,0.0,1.0,40,1050,500,550,0.47619047619047616,16,5,11,373.3904703601672,0.8028311965811966,-0.04752525252525208,0.2281830652201024,132934.57031250012,1927.3003472222374,134861.87065972236,3649,9,497.275,37,3,17,32.56102693602695,0.647804054054054,42.18750000000001,1031.250000000001,27.871621621621646,0
3664,4,0,0,40,0.0,0.0,1.0,40,1250,900,350,0.72,16,9,7,371.43821611820516,0.8018696581196582,-0.0508695652173915,0.22825020150775208,133141.23109796192,1890.7482741617378,135031.97937212366,3650,10,498.275,38,2,17,32.403597308488614,0.6480263157894737,41.98717948717949,1032.0512820512824,27.159244264507432,0
3665,4,0,0,40,0.0,0.0,1.0,40,1150,1000,150,0.8695652173913043,13,10,3,371.0391225559605,0.8001068376068377,-0.053297982410760225,0.22885086914507743,133279.09412895414,1890.3516281321026,135169.44575708624,3651,11,499.275,38,2,18,32.2753923090188,0.6493969298245613,41.85363247863249,1032.585470085472,27.173301844354526,0
3666,4,0,1,39,0.0,0.025,0.975,40,800,500,300,0.625,11,5,6,372.06415596051113,0.7997061965811966,-0.0521721141911462,0.22999464576894071,133361.84619037228,1923.8325480313085,135285.6787384036,3652,12,500.275,38,2,19,32.16582195559233,0.6502192982456139,41.773504273504294,1032.9059829059863,27.1817363922628,0
3667,4,0,0,39,0.0,0.0,1.0,39,850,500,350,0.5882352941176471,12,5,7,378.236331787591,0.7979644624381467,-0.04761204676260955,0.23343576492631307,133302.32018505718,2283.9561211142154,135586.2763061714,3653,13,506.9230769230769,37,2,19,32.066256105330226,0.6514639639639639,41.831140350877206,1032.6754385964932,27.91014698909441,0
3668,4,0,0,39,0.0,0.0,1.0,39,800,600,200,0.75,10,6,4,376.94379589609906,0.7977395411605939,-0.041305679530935224,0.23318423304666636,133389.43591798207,2256.064061472767,135645.49997945485,3654,14,507.9230769230769,38,1,19,32.0121005274589,0.6504934210526314,41.7467948717949,1033.0128205128244,27.184547908232222,0
3669,4,0,0,39,0.0,0.0,1.0,39,800,600,200,0.75,10,6,4,376.91385642546123,0.7968398560503824,-0.04361440097144731,0.23351274218389778,133444.62393390716,2259.425565234903,135704.04949914207,3655,15,508.9230769230769,38,1,19,31.957441491745104,0.6510416666666665,41.69337606837609,1033.2264957264988,27.190170940171022,0
3670,4,0,0,39,0.0,0.0,1.0,39,1100,600,500,0.5454545454545454,16,6,10,380.58903596533014,0.7950404858299596,-0.04841168011435548,0.23691999012392287,133621.7625412594,2371.0041186189137,135992.7666598783,3656,16,509.9230769230769,35,4,19,31.684601104518833,0.6586309523809524,41.52199074074074,1033.912037037037,29.540343915343914,0
3671,4,0,0,39,0.0,0.0,1.0,39,1050,600,450,0.5714285714285714,15,6,9,381.3536111861798,0.7958277103013945,-0.05036373810856154,0.2377804965770075,133681.60211173273,2395.992342892668,136077.5944546254,3657,17,510.9230769230769,35,4,19,31.6047612385749,0.6592261904761905,41.464120370370374,1034.143518518519,29.546957671957685,0
3672,4,0,1,38,0.0,0.02564102564102564,0.9743589743589743,39,550,200,350,0.36363636363636365,9,2,7,383.07855698296214,0.7954903283850653,-0.04657727593507377,0.2394374924694907,133771.38658479083,2448.9899477023373,136220.37653249316,3658,18,511.9230769230769,35,4,19,31.47003431043484,0.6601190476190476,41.37731481481482,1034.490740740741,29.556878306878318,0
3673,4,0,0,38,0.0,0.0,1.0,38,1100,800,300,0.7272727272727273,14,8,6,384.3067125951641,0.795726647700332,-0.04438424987137213,0.24126692173393158,133933.9303429705,2694.341695011335,136628.27203798183,3659,19,520.7631578947369,34,4,19,31.275158136860263,0.6639093137254901,41.220238095238095,1035.1190476190475,30.444677871148457,0
3674,4,0,0,38,0.0,0.0,1.0,38,950,800,150,0.8421052631578947,11,8,3,383.195365519417,0.7949561403508772,-0.0360628263381757,0.24137700830220196,134057.18714569157,2674.018565759632,136731.2057114512,3660,20,521.7631578947369,34,4,19,31.18030808138866,0.6651348039215685,41.101190476190474,1035.5952380952378,30.45868347338935,0
3675,4,0,1,37,0.0,0.02631578947368421,0.9736842105263158,38,850,700,150,0.8235294117647058,10,7,3,382.0848196591359,0.7951635846372689,-0.03747731397459164,0.24087956021989004,134088.01020408171,2646.5986394557935,136734.6088435375,3661,21,522.7631578947369,34,4,19,31.178160919540232,0.6654411764705882,41.07142857142858,1035.7142857142862,30.462184873949596,0
3676,4,0,0,37,0.0,0.0,1.0,37,900,600,300,0.6666666666666666,12,6,6,383.4211415305222,0.7926676676676676,-0.046735743786682216,0.2424001454082793,134190.7793209876,2890.3163580246896,137081.0956790123,3662,22,525.7567567567568,35,2,19,31.04054959785523,0.6642857142857144,40.97222222222222,1036.1111111111109,29.603174603174597,0
3677,4,0,0,37,0.0,0.0,1.0,37,1000,800,200,0.8,12,8,4,386.5254451316331,0.7906031031031031,-0.05067200591858423,0.24540367226771148,134346.3966500285,2985.660153396646,137332.05680342513,3663,23,526.7567567567568,36,1,19,30.80418567600839,0.6637731481481481,40.822072072072075,1036.7117117117123,28.797547547547563,0
3678,4,0,0,37,0.0,0.0,1.0,37,1050,700,350,0.6666666666666666,14,7,7,384.1356406964528,0.7894769769769769,-0.04227484813804039,0.24466730641869514,134463.16882761152,2930.419101533981,137393.5879291455,3664,24,527.7567567567568,36,1,20,30.74918566775245,0.6649305555555556,40.70945945945947,1037.1621621621632,28.81006006006009,0
3679,4,0,0,37,0.0,0.0,1.0,37,800,600,200,0.75,10,6,4,390.6347849907175,0.7895395395395395,-0.03234029837738239,0.24279755462236197,133564.50007086148,3045.133233930269,136609.63330479176,3665,25,528.7567567567568,34,3,18,31.482494529540478,0.660232843137255,41.57738095238094,1033.6904761904748,30.40266106442573,2
3680,4,0,0,37,0.0,0.0,1.0,37,1150,700,450,0.6086956521739131,16,7,9,388.6176428187023,0.7873498498498498,-0.028042416804259673,0.24227262824196436,133675.9410381662,2989.7658215647693,136665.70685973097,3666,26,529.7567567567568,36,1,19,31.422646920033387,0.6571180555555557,41.469594594594575,1034.121621621619,28.725600600600526,0
3681,4,0,0,37,0.0,0.0,1.0,37,700,400,300,0.5714285714285714,10,4,6,390.2081893759232,0.7865990990990991,-0.029845652314627102,0.24384030119777067,133763.29665814442,3039.106758785787,136802.4034169302,3667,27,530.7567567567568,36,1,16,31.293771318673336,0.6579861111111112,41.38513513513512,1034.4594594594578,28.734984984984937,0
3682,4,0,0,37,0.0,0.0,1.0,37,950,400,550,0.42105263157894735,15,4,11,396.8020001742137,0.7865990990990991,-0.009485446985447066,0.2414582384038833,132774.93709926156,3137.072122798488,135912.00922206003,3668,28,531.7567567567568,36,1,16,32.11843495046621,0.6481481481481481,42.34234234234235,1030.6306306306317,28.628628628628658,3
3683,4,0,0,37,0.0,0.0,1.0,37,1450,1100,350,0.7586206896551724,18,11,7,394.04890256189435,0.7867867867867868,-0.009794197867592391,0.24052745012378035,132891.02447041645,3073.1124705786965,135964.13694099514,3669,29,532.7567567567568,36,1,16,32.072320518421435,0.6493055555555556,42.22972972972973,1031.0810810810817,28.64114114114116,0
3684,4,0,0,37,0.0,0.0,1.0,37,650,500,150,0.7692307692307693,8,5,3,392.45649916457745,0.7870995995995996,-0.013770267319077156,0.2399276781942057,132949.08717839475,3035.3466642318126,135984.43384262657,3670,30,533.7567567567568,36,1,16,32.05485185994031,0.6498842592592593,42.17342342342343,1031.3063063063073,28.647397397397427,0
3685,4,1,1,37,0.02631578947368421,0.02631578947368421,0.9736842105263158,38,600,500,100,0.8333333333333334,7,5,2,383.4458768538766,0.7926446183025131,-0.014077187021493076,0.23665093500719603,133302.32018505692,2622.845010003077,135925.16519506,3671,0,520.6842105263158,37,1,18,31.931761874424854,0.6514639639639639,41.83114035087719,1032.6754385964912,27.910146989094358,0
3686,4,0,0,37,0.0,0.0,1.0,37,750,400,350,0.5333333333333333,11,4,7,388.2069795083587,0.7852852852852853,-0.017917786896844534,0.23918559060031142,133239.59094229375,2944.907830127431,136184.49877242118,3672,32,535.7567567567568,36,1,19,31.87195498836532,0.6527777777777778,41.891891891891895,1032.4324324324332,28.6786786786787,0
3687,4,0,0,37,0.0,0.0,1.0,37,950,600,350,0.631578947368421,13,6,7,389.77417381138156,0.7837212212212212,-0.009064013861222575,0.24090355270875985,133355.88121905702,2995.735685009348,136351.61690406635,3673,33,536.7567567567568,36,1,19,31.71450247128943,0.6539351851851851,41.77927927927929,1032.882882882884,28.69119119119122,0
3688,4,0,0,37,0.0,0.0,1.0,37,1250,800,450,0.64,17,8,9,385.11050854128075,0.7832207207207207,-0.005030021383815919,0.23936396175117688,133564.50007086172,2887.5199618744605,136452.02003273618,3674,34,537.7567567567568,34,3,20,31.62525432838112,0.6602328431372548,41.577380952380956,1033.6904761904766,30.402661064425782,0
3689,4,0,1,36,0.0,0.02702702702702703,0.972972972972973,37,800,600,200,0.75,10,6,4,380.24830172589867,0.7820945945945946,-0.006136000149355336,0.23693233492045612,133656.80980725633,2764.5549886621375,136421.36479591846,3675,35,538.7567567567568,34,3,20,31.65822396193108,0.6611519607843137,41.48809523809524,1034.0476190476197,30.41316526610646,0
3690,4,0,0,36,0.0,0.0,1.0,36,550,200,350,0.36363636363636365,9,2,7,385.87307170246737,0.78125,-0.007083580320094596,0.2398555165667146,133567.21460796348,3107.9982759035206,136675.212883867,3676,36,543.2777777777778,33,3,20,31.60282058881644,0.6625631313131313,41.574754901960794,1033.7009803921583,31.324272133095704,0
3691,4,0,0,36,0.0,0.0,1.0,36,700,500,200,0.7142857142857143,9,5,4,382.52143277610537,0.7804232804232805,-0.0058203494768083175,0.2383487205949249,133656.80980725633,3025.318877551026,136682.12868480737,3677,37,544.2777777777778,34,2,21,31.599460818174848,0.6611519607843137,41.48809523809524,1034.0476190476197,30.41316526610646,0
3692,4,0,0,36,0.0,0.0,1.0,36,1250,1000,250,0.8,15,10,5,377.9088105710727,0.7793981481481482,-0.007552597894841195,0.23678224774463635,133861.20119866682,2917.4654653206458,136778.66666398747,3678,38,545.2777777777778,35,1,16,31.513649666331144,0.6610119047619047,41.29050925925926,1034.8379629629628,29.566798941798936,0
3693,4,0,0,36,0.0,0.0,1.0,36,1100,900,200,0.8181818181818182,13,9,4,376.73052699634775,0.777744708994709,-0.007454391912869562,0.23719972026997363,134040.9208488728,2899.4613500943296,136940.38219896713,3679,39,546.2777777777778,35,1,16,31.363981409038416,0.6627976190476189,41.11689814814816,1035.532407407409,29.58664021164026,0
3694,4,0,0,36,0.0,0.0,1.0,36,850,400,450,0.47058823529411764,13,4,9,375.01167980794787,0.7761243386243387,0.0012660113196307776,0.2370836552006181,134190.77932098776,2864.6219135802608,137055.401234568,3680,40,547.2777777777778,35,1,17,31.2583780160858,0.6642857142857143,40.97222222222223,1036.111111111112,29.60317460317463,0
3695,4,0,2,34,0.0,0.05555555555555555,0.9444444444444444,36,1300,800,500,0.6153846153846154,18,8,10,382.21363114249993,0.7757936507936508,-0.003915072096889904,0.2420325921676057,134250.74615269207,3062.49303412209,137313.23918681417,3681,41,548.2777777777778,35,1,17,31.011745216290674,0.6648809523809524,40.914351851851855,1036.3425925925928,29.609788359788368,0
3696,4,0,0,34,0.0,0.0,1.0,34,800,800,0,1.0,8,8,0,385.5763238346415,0.7670083184789067,-0.003074282779962134,0.24431058772229897,134273.0229591836,3554.499716553282,137827.5226757369,3682,42,563.8529411764706,34,0,17,30.902299180641702,0.6672794117647058,40.89285714285714,1036.4285714285709,30.483193277310907,0
3697,4,0,0,34,0.0,0.0,1.0,34,650,400,250,0.6153846153846154,9,4,5,383.215640863928,0.7672311348781937,-0.001891431813883182,0.2432246210381258,134334.7222222223,3495.833333333339,137830.55555555565,3683,43,564.8529411764706,34,0,17,30.90166130760986,0.6678921568627452,40.833333333333336,1036.6666666666672,30.49019607843139,0
3698,4,0,0,34,0.0,0.0,1.0,34,1050,800,250,0.7619047619047619,13,8,5,382.4338521118683,0.7661913250148544,0.0016546228135343455,0.2431386023280566,134396.43565759642,3479.5493197278965,137875.98497732432,3684,44,565.8529411764706,34,0,17,30.860122464600078,0.6685049019607843,40.773809523809526,1036.9047619047622,30.497198879551828,0
3699,4,0,0,34,0.0,0.0,1.0,34,850,600,250,0.7058823529411765,11,6,5,379.6780097493845,0.7661170528817588,0.0023632042348620264,0.24179494305092403,134458.16326530627,3410.161564625869,137868.32482993213,3685,45,566.8529411764706,34,0,17,30.86977731864095,0.6691176470588235,40.71428571428572,1037.1428571428582,30.504201680672303,0
3700,4,0,0,34,0.0,0.0,1.0,34,1150,700,450,0.6086956521739131,16,7,9,376.34138532909606,0.764965834818776,-0.00460560500442031,0.24068729683886503,134612.54428854876,3332.0542800453527,137944.5985685941,3686,46,567.8529411764706,34,0,18,30.80188138120913,0.6706495098039216,40.56547619047619,1037.7380952380954,30.521708683473395,0
3701,4,0,0,34,0.0,0.0,1.0,34,950,700,250,0.7368421052631579,12,7,5,376.6828204131752,0.7633318478906714,-0.0017709802122476415,0.24131502653802178,134674.32149943308,3345.900651927437,138020.2221513605,3687,47,568.8529411764706,34,0,18,30.73125740719501,0.6712622549019608,40.50595238095238,1037.9761904761904,30.528711484593835,0
3702,4,0,0,34,0.0,0.0,1.0,34,900,700,200,0.7777777777777778,11,7,4,375.35200925465506,0.763888888888889,0.002596544235671905,0.24107659975840215,134767.01388888885,3317.013888888885,138084.02777777772,3688,48,569.8529411764706,34,0,20,30.6731540930979,0.6721813725490196,40.416666666666664,1038.333333333333,30.539215686274503,0
3703,4,0,0,34,0.0,0.0,1.0,34,1100,800,300,0.7272727272727273,14,8,6,373.70925963923935,0.7631833036244802,0.0008260784538514088,0.24022593012771445,134797.91843820867,3275.0460600907127,138072.96449829938,3689,49,570.8529411764706,34,0,15,30.68492300049678,0.6724877450980392,40.386904761904766,1038.4523809523814,30.54271708683475,0
3704,4,0,0,34,0.0,0.0,1.0,34,850,600,250,0.7058823529411765,11,6,5,369.69402181755834,0.76232917409388,-0.000943765083388115,0.23825332602511187,134890.65334467124,3173.653628117921,138064.30697278917,3690,50,571.8529411764706,34,0,15,30.69657727863091,0.673406862745098,40.29761904761905,1038.809523809524,30.553221288515413,0
3705,4,0,0,34,0.0,0.0,1.0,34,700,500,200,0.7142857142857143,9,5,4,367.8499609970102,0.7621434937611409,0.00011793009104188457,0.23767300588770568,134983.42013888896,3130.729166666674,138114.14930555565,3691,51,572.8529411764706,34,0,15,30.651897888265164,0.6743259803921569,40.208333333333336,1039.1666666666672,30.563725490196095,0
3706,4,0,0,34,0.0,0.0,1.0,34,850,500,350,0.5882352941176471,12,5,7,371.2594598572884,0.7596182412358884,-0.0036541583311444636,0.24069850504333334,135107.15880102044,3231.9621598639483,138339.12096088438,3692,52,573.8529411764706,34,0,16,30.439854574602084,0.6755514705882353,40.089285714285715,1039.6428571428573,30.57773109243698,0
3707,4,0,0,34,0.0,0.0,1.0,34,900,600,300,0.6666666666666666,12,6,6,371.78716715976327,0.7577985739750446,-0.001414027149321262,0.24166165865384603,135200.0,3253.1250000000005,138453.125,3693,53,574.8529411764706,34,0,16,30.33353365384617,0.6764705882352942,40.0,1040.0,30.58823529411765,0
3708,4,0,0,34,0.0,0.0,1.0,34,900,500,400,0.5555555555555556,13,5,8,373.759043590308,0.7544191919191919,-0.0062417141665038756,0.243990126962127,135354.8061933105,3318.0165816326353,138672.82277494314,3694,54,575.8529411764706,34,0,17,30.12789345231285,0.6780024509803921,39.85119047619047,1040.595238095237,30.605742296918734,0
3709,4,0,0,34,0.0,0.0,1.0,34,650,500,150,0.7692307692307693,8,5,3,373.9677089950584,0.7544191919191919,-0.0005887062591252157,0.24454747043708253,135416.75347222207,3328.298611111093,138745.05208333317,3695,55,576.8529411764706,34,0,17,30.06071523885775,0.6786151960784315,39.79166666666666,1040.8333333333321,30.61274509803918,0
3710,4,0,0,34,0.0,0.0,1.0,34,1000,800,200,0.8,12,8,4,373.9677089950584,0.7544191919191919,-0.0005887062591252157,0.24454747043708253,135416.75347222207,3328.298611111093,138745.05208333317,3696,56,577.8529411764706,34,0,17,30.06071523885775,0.6786151960784315,39.79166666666666,1040.8333333333321,30.61274509803918,0
3711,4,0,0,34,0.0,0.0,1.0,34,450,300,150,0.6666666666666666,6,3,3,368.2884789874323,0.7529337492572787,-0.010505406152829133,0.23633876565484915,134736.11288265316,3124.3516156462692,137860.46449829944,3697,57,578.8529411764706,34,0,20,30.887369567710124,0.671875,40.44642857142858,1038.2142857142865,30.535714285714306,2
3712,4,0,0,34,0.0,0.0,1.0,34,800,500,300,0.625,11,5,6,369.48251131389617,0.7518568033273916,-0.009439814440219019,0.23771131480106414,134828.82653061222,3163.378684807251,137992.20521541947,3698,58,579.8529411764706,34,0,18,30.76379336695705,0.6727941176470589,40.357142857142854,1038.5714285714282,30.54621848739495,0
3713,4,0,0,34,0.0,0.0,1.0,34,1150,900,250,0.782608695652174,14,9,5,369.45766873375,0.7504084967320261,-0.0036558328223030845,0.23871176834766142,134983.42013888896,3174.1319444444516,138157.5520833334,3699,59,580.8529411764706,34,0,19,30.610130981021115,0.6743259803921569,40.208333333333336,1039.1666666666672,30.563725490196095,0
3714,4,0,0,34,0.0,0.0,1.0,34,1150,1000,150,0.8695652173913043,13,10,3,371.9019539806634,0.7498885918003566,-0.003418406180748068,0.24111505301508032,135107.15880102044,3249.3232709750596,138356.4820719955,3700,60,581.8529411764706,34,0,19,30.423155463949005,0.6755514705882353,40.089285714285715,1039.6428571428573,30.57773109243698,0
3715,4,0,0,34,0.0,0.0,1.0,34,1050,700,350,0.6666666666666666,14,7,7,371.3021189486069,0.7484031491384433,-0.0034168411555988154,0.24155373144110037,135230.95415249432,3242.307964852607,138473.26211734692,3701,61,582.8529411764706,34,0,19,30.315277936744128,0.6767769607843137,39.970238095238095,1040.1190476190475,30.591736694677866,0
3716,4,0,0,34,0.0,0.0,1.0,34,900,600,300,0.6666666666666666,12,6,6,371.51442847105955,0.7458778966131908,0.008126005235637557,0.2425248408712122,135354.80619331062,3257.2526927437607,138612.05888605438,3702,62,583.8529411764706,34,0,19,30.18628684742402,0.6780024509803921,39.851190476190474,1040.5952380952378,30.60574229691876,0
3717,4,0,0,34,0.0,0.0,1.0,34,1000,600,400,0.6,14,6,8,370.10856971667573,0.7435011883541296,0.01000342974734214,0.2428611897458188,135540.69054705222,3232.9542233560173,138773.64477040822,3703,63,584.8529411764706,34,0,20,30.03767958538166,0.6798406862745099,39.67261904761905,1041.3095238095243,30.626750700280127,0
3718,4,0,0,34,0.0,0.0,1.0,34,1500,1000,500,0.6666666666666666,20,10,10,400.66424913812904,0.7447638146167559,0.020039359912906285,0.24777688598571448,133377.2636275711,3887.932124442914,137265.19575201403,3704,64,585.8529411764706,33,1,20,31.41176790445683,0.6606691919191918,41.75857843137255,1032.9656862745096,31.301990493166958,6
3719,4,0,0,34,0.0,0.0,1.0,34,750,600,150,0.8,9,6,3,400.9727614936273,0.7439096850861557,0.02454875913121768,0.24839098840211388,133440.56560277293,3901.206417003072,137341.772019776,3705,65,586.8529411764706,33,1,21,31.340069386786855,0.661300505050505,41.697303921568626,1033.210784313725,31.309417706476516,0
3720,4,0,0,34,0.0,0.0,1.0,34,800,400,400,0.5,12,4,8,399.2639859896816,0.7432783719548426,0.024535740222014546,0.24799354622739378,133539.5050048828,3863.5105201988126,137403.01552508163,3706,66,587.8529411764706,31,3,21,31.284643487024436,0.6673387096774194,41.6015625,1033.59375,33.341733870967744,0
3721,4,0,0,34,0.0,0.0,1.0,34,1000,700,300,0.7,13,7,6,398.12034787899023,0.7422014260249555,0.026456887677644536,0.24841083450139992,133707.7861362034,3846.358066134989,137554.1442023384,3707,67,588.8529411764706,31,3,16,31.144954677074153,0.669018817204301,41.438802083333336,1034.244791666667,33.362735215053775,0
3722,4,0,0,34,0.0,0.0,1.0,34,800,500,300,0.625,11,5,6,396.370607343615,0.7404188948306596,0.023823270342489877,0.24822357892511493,133842.48733520508,3810.245598687067,137652.73293389214,3708,68,589.8529411764706,31,3,18,31.054826769011385,0.6703629032258064,41.30859375,1034.765625,33.379536290322584,0
3723,4,1,0,35,0.02857142857142857,0.0,1.0,35,750,500,250,0.6666666666666666,10,5,5,384.4525632448683,0.7481092436974789,0.025411844217284818,0.24312239508117922,134201.36072964745,3318.811424692454,137520.1721543399,3709,0,573.9714285714285,33,2,19,31.003227873053433,0.6688762626262625,40.96200980392158,1036.1519607843154,31.398544266191376,0
3724,4,0,0,35,0.0,0.0,1.0,35,850,400,450,0.47058823529411764,13,4,9,385.5994157155933,0.7458683473389355,0.03213187852582533,0.24448274798519404,134296.61218041144,3356.939037870058,137653.5512182815,3710,1,574.9714285714285,33,2,20,30.87806416016396,0.6698232323232323,40.87009803921569,1036.5196078431377,31.409685086155687,0
3725,4,0,0,35,0.0,0.0,1.0,35,900,700,200,0.7777777777777778,11,7,4,382.14667264077775,0.7455882352941176,0.018757279586772313,0.2433489308170734,134455.43968966277,3276.3397791714906,137731.77946883425,3711,2,575.9714285714285,33,2,20,30.80849482059159,0.6714015151515151,40.71691176470589,1037.1323529411777,31.428253119429627,0
3726,4,0,0,35,0.0,0.0,1.0,35,600,300,300,0.5,9,3,6,380.80030967242425,0.7464985994397758,0.022030981067125754,0.24312635156008652,134550.78125000015,3247.3958333333476,137798.1770833335,3712,3,576.9714285714285,33,2,21,30.747991967871474,0.6723484848484848,40.62500000000001,1037.5000000000011,31.439393939393973,0
3727,4,0,0,35,0.0,0.0,1.0,35,850,700,150,0.8235294117647058,10,7,3,382.68954126485147,0.7466386554621848,0.02502606882168945,0.24499283716488177,134649.04729109287,3305.756427915536,137954.8037190084,3713,4,577.9714285714285,32,3,21,30.600669099756704,0.67578125,40.53030303030304,1037.878787878789,32.43371212121215,0
3728,4,0,0,35,0.0,0.0,1.0,35,750,500,250,0.6666666666666666,10,5,5,383.51909156842544,0.7443277310924369,0.024808464064210112,0.24618871896699193,134747.34920224996,3335.6361914600725,138082.98539371003,3714,5,578.9714285714285,32,3,21,30.480816003891523,0.6767578125,40.43560606060607,1038.2575757575771,32.445549242424285,0
3729,4,0,0,35,0.0,0.0,1.0,35,550,300,250,0.5454545454545454,8,3,5,382.64753748189156,0.7450980392156862,0.020923205168282166,0.2462956684918655,134845.68698347107,3319.674012855836,138165.3609963269,3715,6,579.9714285714285,32,3,15,30.40511791879408,0.677734375,40.34090909090909,1038.6363636363637,32.45738636363637,0
3730,4,0,0,35,0.0,0.0,1.0,35,750,500,250,0.6666666666666666,10,5,5,383.4098248630033,0.7448879551820727,0.024060150375940337,0.2470096029089999,134878.47421500363,3342.7464353127343,138221.22065031636,3716,7,580.9714285714285,32,3,15,30.352548519103774,0.6780598958333333,40.30934343434344,1038.7626262626268,32.46133207070709,0
3731,4,0,0,35,0.0,0.0,1.0,35,1150,1000,150,0.8695652173913043,13,10,3,382.2779458882162,0.7453781512605041,0.02059299191374664,0.24708208697653003,134996.15532487506,3321.210592079968,138317.36591695502,3717,8,581.9714285714285,33,2,15,30.26434748427673,0.6767676767676767,40.19607843137255,1039.2156862745098,31.491384432560903,0
3732,4,0,0,35,0.0,0.0,1.0,35,850,700,150,0.8235294117647058,10,7,3,384.0915512040191,0.7457282913165265,0.023519903010709164,0.24913094192774443,135123.54022491348,3379.962033833134,138503.50225874662,3718,9,582.9714285714285,33,2,15,30.089973283042593,0.678030303030303,40.0735294117647,1039.705882352941,31.50623885918003,0
3733,4,0,0,35,0.0,0.0,1.0,35,600,400,200,0.6666666666666666,8,4,4,384.52008449171456,0.7449579831932772,0.023220809832477762,0.24962914436971684,135155.39583633703,3393.992845299892,138549.38868163692,3719,10,583.9714285714285,33,2,15,30.047019249656262,0.6783459595959596,40.04289215686275,1039.8284313725494,31.50995246583483,0
3734,4,0,0,35,0.0,0.0,1.0,35,850,600,250,0.7058823529411765,11,6,5,384.4624911501163,0.7460784313725489,0.0204927965531172,0.25025441908605717,135250.98519800068,3399.7861399461644,138650.77133794685,3720,11,584.9714285714285,33,2,16,29.953071002199177,0.6792929292929293,39.95098039215686,1040.196078431372,31.52109328579915,0
3735,4,0,1,34,0.0,0.02857142857142857,0.9714285714285714,35,1250,1000,250,0.8,15,10,5,384.20997614022286,0.7463585434173668,0.016532319135687867,0.250311472559812,135282.85582768638,3395.404561947316,138678.26038963368,3721,12,585.9714285714285,33,2,17,29.92782326147562,0.6796085858585859,39.920343137254896,1040.3186274509799,31.524806892453935,0
3736,4,0,0,34,0.0,0.0,1.0,34,1100,700,400,0.6363636363636364,15,7,8,391.4459987730805,0.7357397504456329,0.018939000131689365,0.25457488058138966,135219.11832288065,3786.196565023073,139005.31488790372,3722,82,603.8529411764706,33,1,17,29.803302109108053,0.6789772727272727,39.981617647058826,1040.0735294117649,31.51737967914439,0
3737,4,1,0,35,0.02857142857142857,0.0,1.0,35,850,700,150,0.8235294117647058,10,7,3,378.43427779494834,0.7462184873949579,0.022335821261167066,0.24832442819748032,135540.6905470521,3258.6486678004467,138799.33921485255,3723,0,587.5714285714286,34,1,19,29.82093860752258,0.6798406862745099,39.672619047619044,1041.3095238095234,30.6267507002801,0
3738,4,0,0,35,0.0,0.0,1.0,35,500,400,100,0.8,6,4,2,379.1676741894616,0.7458683473389355,0.022683408716098086,0.24923651250815915,135602.68034297042,3283.230583900219,138885.91092687062,3724,1,588.5714285714286,34,1,20,29.740065531298818,0.680453431372549,39.613095238095234,1041.5476190476184,30.63375350140054,0
3739,4,0,0,35,0.0,0.0,1.0,35,1350,1000,350,0.7407407407407407,17,10,7,381.4281157765399,0.7426470588235293,0.026637114648398574,0.25274068606127714,135889.11115916938,3366.3890678820358,139255.5002270514,3725,2,589.5714285714286,33,2,16,29.395862717442412,0.6856060606060607,39.33823529411764,1042.647058823528,31.595365418894787,0
3740,4,0,0,35,0.0,0.0,1.0,35,850,500,350,0.5882352941176471,12,5,7,376.5314020861189,0.7403361344537814,0.01872157284687237,0.2505349033014925,136037.00573979577,3244.4409013605255,139281.4466411563,3726,3,590.5714285714286,34,1,17,29.37635512952185,0.6847426470588236,39.19642857142856,1043.2142857142844,30.68277310924366,0
3741,4,0,0,35,0.0,0.0,1.0,35,1000,700,300,0.7,13,7,6,379.6235510227983,0.7396358543417366,0.018167896648909387,0.25392211433401357,136223.35778061222,3342.718962585025,139566.07674319725,3727,4,591.5714285714286,34,1,18,29.11036036036035,0.6865808823529411,39.01785714285714,1043.928571428571,30.703781512605033,0
3742,4,0,1,34,0.0,0.02857142857142857,0.9714285714285714,35,950,700,250,0.7368421052631579,12,7,5,379.4480177674311,0.7397058823529411,0.0202853234316982,0.25447385411742385,136316.58163265296,3345.011337868471,139661.59297052142,3728,5,592.5714285714286,34,1,18,29.022267821857422,0.6875,38.92857142857142,1044.2857142857135,30.714285714285694,0
3743,4,0,0,34,0.0,0.0,1.0,34,750,600,150,0.8,9,6,3,387.60801749793814,0.7273841354723708,0.0227192673476575,0.2589221556886227,136176.75781250003,3756.6406249999986,139933.39843750003,3729,89,610.8529411764706,33,1,18,28.94835329341317,0.6884469696969697,39.0625,1043.7500000000002,31.628787878787886,0
3744,4,0,0,34,0.0,0.0,1.0,34,950,800,150,0.8421052631578947,11,8,3,382.40754647484204,0.7261215092097445,-0.05322211636753038,0.2426695750660683,134328.37017313062,3474.721561418693,137803.09173454932,3730,90,611.8529411764706,33,1,20,30.928966189856954,0.6701388888888888,40.83946078431373,1036.6421568627457,31.413398692810475,7
3745,4,0,0,34,0.0,0.0,1.0,34,1100,800,300,0.7272727272727273,14,8,6,379.8605075832561,0.7274584076054664,-0.05174594350439521,0.24231493569647794,134518.9969753219,3419.690894127245,137938.68786944915,3731,91,612.8529411764706,33,1,20,30.80416912778106,0.6720328282828283,40.655637254901954,1037.3774509803914,31.435680332739132,0
3746,4,0,0,34,0.0,0.0,1.0,34,500,400,100,0.8,6,4,2,382.5108490356637,0.7274584076054664,-0.013159588377559928,0.23774815334120716,133564.5000708615,3417.9740646258297,136982.47413548734,3732,92,613.8529411764706,34,0,17,31.692435410188473,0.660232843137255,41.57738095238094,1033.690476190475,30.402661064425736,3
3747,4,0,0,34,0.0,0.0,1.0,34,1050,900,150,0.8571428571428571,12,9,3,384.77846295097487,0.7272355912061795,-0.0036735080817178467,0.23995481031264287,133687.58680555536,3488.020833333309,137175.60763888867,3733,93,614.8529411764706,34,0,17,31.510206822455007,0.6614583333333335,41.45833333333332,1034.1666666666652,30.41666666666662,0
3748,4,0,0,34,0.0,0.0,1.0,34,700,500,200,0.7142857142857143,9,5,4,385.0421519061234,0.7279783125371361,0.0005923649238726014,0.2405198603819051,133749.15143140557,3499.8122165532477,137248.96364795882,3734,94,615.8529411764706,34,0,16,31.44157363716575,0.6620710784313728,41.398809523809504,1034.4047619047594,30.423669467787043,0
3749,4,0,0,34,0.0,0.0,1.0,34,800,600,200,0.75,10,6,4,385.5278213628376,0.7283125371360666,-0.002842370266099792,0.2414270766056037,133841.52494331042,3519.926303854847,137361.45124716527,3735,95,616.8529411764706,34,0,16,31.336286240220897,0.6629901960784315,41.309523809523796,1034.7619047619028,30.43417366946773,0
3750,4,0,0,34,0.0,0.0,1.0,34,1200,500,700,0.4166666666666667,19,5,14,387.008962673681,0.7263443256090315,-0.0010652760586813415,0.24337071210216926,133995.55165816314,3571.4958900226593,137567.0475481858,3736,96,617.8529411764706,34,0,16,31.143401939366058,0.6645220588235294,41.16071428571428,1035.3571428571418,30.451680672268875,0
3751,4,0,0,34,0.0,0.0,1.0,34,500,300,200,0.6,7,3,4,386.56375838997144,0.7256387403446227,0.0007101023900017989,0.24329461436150304,134026.36763038547,3561.947278911563,137588.31490929704,3737,97,618.8529411764706,34,0,16,31.12401318310723,0.664828431372549,41.13095238095238,1035.4761904761904,30.45518207282913,0
3752,4,0,0,34,0.0,0.0,1.0,34,1350,1200,150,0.8888888888888888,15,12,3,386.14309319639705,0.7234477124183007,0.00035492877762521857,0.24364257098635603,134118.8368055555,3557.812499999995,137676.6493055555,3738,98,619.8529411764706,34,0,17,31.042169482434964,0.6657475490196079,41.041666666666664,1035.833333333333,30.465686274509796,0
3753,4,0,0,34,0.0,0.0,1.0,34,850,700,150,0.8235294117647058,10,7,3,385.49192564478835,0.724041889483066,0.0008279768301671098,0.24364097522778427,134180.5006377549,3545.0999149659638,137725.6005527209,3739,99,620.8529411764706,34,0,17,30.997213604504182,0.6663602941176471,40.98214285714285,1036.071428571427,30.472689075630207,0
3754,4,0,0,34,0.0,0.0,1.0,34,600,400,200,0.6666666666666666,8,4,4,387.0665284101613,0.724041889483066,0.001300807514275304,0.24504830034985112,134242.1786422902,3592.130810657589,137834.3094529478,3740,100,621.8529411764706,34,0,17,30.894600804135557,0.6669730392156863,40.922619047619044,1036.3095238095234,30.47969187675069,0
3755,4,0,0,34,0.0,0.0,1.0,34,750,400,350,0.5333333333333333,11,4,7,386.5460520083564,0.7243018419489008,-0.00023648329076619845,0.24492503120704107,134273.02295918346,3580.541383219932,137853.5643424034,3741,101,622.8529411764706,34,0,17,30.87717283099778,0.667279411764706,40.89285714285713,1036.4285714285697,30.483193277310875,0
3756,4,0,0,34,0.0,0.0,1.0,34,800,500,300,0.625,11,5,6,385.6931388126415,0.7239676173499703,0.0008275964572117545,0.24459068897608646,134303.87081916092,3560.0162981859335,137863.88711734687,3742,102,623.8529411764706,34,0,17,30.868362620114084,0.6675857843137255,40.863095238095234,1036.5476190476184,30.486694677871128,0
3757,4,0,0,34,0.0,0.0,1.0,34,1200,800,400,0.6666666666666666,16,8,8,393.00536783592145,0.7239676173499703,0.0048452400165601706,0.23382285298570132,131925.46323829785,3576.034203509844,135501.4974418077,3743,103,624.8529411764706,33,1,17,33.074252455366015,0.6461489898989898,43.16789215686275,1027.3284313725496,31.131164587046957,4
3758,4,0,0,34,0.0,0.0,1.0,34,700,400,300,0.5714285714285714,10,4,6,393.9091052291535,0.7239676173499703,0.008316671928163322,0.23474966932099883,131988.419793469,3598.288068291062,135586.70786176005,3744,104,625.8529411764706,33,1,17,32.98735340886505,0.646780303030303,43.10661764705883,1027.5735294117658,31.13859180035654,0
3759,4,0,0,34,0.0,0.0,1.0,34,800,700,100,0.875,9,7,2,370.64046661503903,0.7245246583481878,-0.0334408700613521,0.21479656743249084,130920.20083922052,2904.8648656766636,133825.0657048972,3745,105,626.8529411764706,33,1,15,34.66538438510359,0.6360479797979798,44.14828431372549,1023.4068627450982,31.012329174093885,5
3760,4,1,1,34,0.02857142857142857,0.02857142857142857,0.9714285714285714,35,900,700,200,0.7777777777777778,11,7,4,359.44486249542274,0.7328431372549019,-0.028581110519436237,0.21004391865821617,131239.1643759644,2434.648678626532,133673.81305459095,3746,0,609.9142857142857,35,0,15,34.62915113520841,0.6348214285714285,43.83680555555555,1024.652777777777,29.275793650793627,0
3761,4,1,1,34,0.02857142857142857,0.02857142857142857,0.9714285714285714,35,900,700,200,0.7777777777777778,11,7,4,361.5153117725652,0.7280812324929972,-0.030118321979203833,0.2122665693755124,131422.35145436844,2502.2987536177275,133924.65020798618,3747,0,610.8857142857142,33,2,16,34.390935620094815,0.6410984848484849,43.658088235294116,1025.3676470588232,31.0717468805704,0
3762,4,0,0,34,0.0,0.0,1.0,34,1050,600,450,0.5714285714285714,15,6,9,369.8195518540551,0.7190285204991088,-0.027498804399808563,0.2166085946573752,131328.12500000012,2913.5416666666815,134241.6666666668,3748,108,629.8529411764706,34,0,17,34.27337398373984,0.6378676470588235,43.75000000000001,1025.000000000001,30.147058823529438,0
3763,4,0,0,34,0.0,0.0,1.0,34,1050,900,150,0.8571428571428571,12,9,3,372.074266839707,0.7179887106357695,-0.018844967191505857,0.21866766970130974,131457.57607642084,2982.3962478318617,134439.9723242527,3749,109,630.8529411764706,32,2,18,34.08463637856029,0.6438802083333333,43.62373737373738,1025.505050505051,32.047032828282845,0
3764,4,1,1,34,0.02857142857142857,0.02857142857142857,0.9714285714285714,35,700,500,200,0.7142857142857143,9,5,4,364.68040807460517,0.7294817927170868,-0.022510615801770273,0.21589595607356696,131736.68368235786,2608.357512735501,134345.04119509336,3750,0,613.8,33,2,13,33.99225558075684,0.6442550505050504,43.35171568627452,1026.593137254903,31.108882947118275,0
3765,4,0,0,34,0.0,0.0,1.0,34,650,400,250,0.6153846153846154,9,4,5,376.7872867776984,0.7178401663695781,-0.01459732515053247,0.22256737405008242,131651.87225793296,3120.9503494541473,134772.82260738712,3751,111,632.8529411764706,32,2,13,33.76727567257217,0.6458333333333333,43.43434343434344,1026.262626262627,32.070707070707094,0
3766,4,0,0,34,0.0,0.0,1.0,34,750,700,50,0.9333333333333333,8,7,1,374.84885744926265,0.7167632204396911,-0.017071307242600087,0.2218477486468769,131725.00177154213,3075.3932823129444,134800.39505385509,3752,112,633.8529411764706,34,0,13,33.74309018516371,0.6418504901960783,43.36309523809525,1026.5476190476204,30.192577030812366,0
3767,4,0,0,34,0.0,0.0,1.0,34,550,400,150,0.7272727272727273,7,4,3,377.01995379122036,0.7169860368389781,-0.015873827791986095,0.22349120972159975,131786.11288265308,3137.198837868484,134923.31172052157,3753,113,634.8529411764706,34,0,14,33.625603864734295,0.6424632352941175,43.30357142857143,1026.7857142857144,30.199579831932777,0
3768,4,1,0,35,0.02857142857142857,0.0,1.0,35,1000,700,300,0.7,13,7,6,368.09834843851513,0.7246498599439776,-0.008568533796496913,0.22018973933867556,132130.12695312512,2727.376302083347,134857.50325520846,3754,0,617.6857142857143,35,0,15,33.50747213779129,0.6437499999999999,42.96875000000001,1028.125000000001,29.375000000000025,0
3769,4,1,0,36,0.027777777777777776,0.0,1.0,36,900,600,300,0.6666666666666666,12,6,6,360.03752971994186,0.7353505291005291,-0.007536512105845494,0.21656767011528053,132340.06123944905,2329.477746327424,134669.53898577648,3755,0,601.5,36,0,16,33.50320126956332,0.6438078703703705,42.76463963963965,1028.9414414414425,28.581706706706736,0
3770,4,0,0,36,0.0,0.0,1.0,36,600,400,200,0.6666666666666666,8,4,4,362.2184678420723,0.7367063492063493,-0.005344845307842627,0.2187475775068606,132489.90929705222,2398.0837532237174,134887.99305027592,3756,1,602.5,34,2,18,33.29623419673141,0.6495098039215685,42.61904761904762,1029.5238095238099,30.280112044817937,0
3771,4,0,0,36,0.0,0.0,1.0,36,1050,700,350,0.6666666666666666,14,7,7,361.6176103942342,0.7370701058201059,-0.0006839286402338107,0.2189191005962575,132581.84700963713,2388.786139455782,134970.6331490929,3757,2,603.5,34,2,18,33.21918467999847,0.6504289215686274,42.529761904761905,1029.880952380952,30.29061624649859,0
3772,4,0,0,36,0.0,0.0,1.0,36,1050,900,150,0.8571428571428571,12,9,3,360.29680047290907,0.7379960317460318,-0.004170037366616697,0.2184756982825565,132643.15653344675,2358.180980725623,135001.33751417237,3758,3,604.5,34,2,13,33.191523171154515,0.6510416666666667,42.470238095238095,1030.1190476190477,30.29761904761905,0
3773,4,0,0,36,0.0,0.0,1.0,36,700,200,500,0.2857142857142857,12,2,10,365.83479564134456,0.7386243386243386,0.004298178085706983,0.22310769931366473,132857.85147392272,2520.804988662111,135378.65646258483,3759,4,605.5,34,2,13,32.83294842186297,0.653186274509804,42.26190476190475,1030.9523809523796,30.322128851540576,0
3774,4,0,1,35,0.0,0.027777777777777776,0.9722222222222222,36,700,500,200,0.7142857142857143,9,5,4,365.8667477956548,0.7389880952380953,-0.0009266741057114558,0.22367703854296078,132949.91673752817,2528.390731292495,135478.30746882065,3760,5,606.5,34,2,13,32.73957251144716,0.6541053921568629,42.17261904761904,1031.3095238095225,30.33263305322125,0
3775,4,0,0,35,0.0,0.0,1.0,35,1000,800,200,0.8,12,8,4,374.8488177688407,0.7287114845938375,0.005530173072677558,0.228302201756243,132808.2216725536,2956.60097678775,135764.82264934134,3761,7,624.6857142857143,33,2,13,32.65057167201681,0.6549873737373739,42.31004901960783,1030.7598039215668,31.235145573380812,0
3776,4,0,0,35,0.0,0.0,1.0,35,1000,700,300,0.7,13,7,6,373.40294136930436,0.7280112044817927,0.0008804754567468542,0.23250189050426728,133630.56163795176,2979.6089544886636,136610.1705924404,3762,8,625.6857142857143,33,2,19,31.86151771956857,0.6631944444444444,41.513480392156865,1033.9460784313726,31.33169934640523,1
3777,4,0,0,35,0.0,0.0,1.0,35,750,600,150,0.8,9,6,3,373.40294136930436,0.7280112044817927,0.0008804754567468542,0.23250189050426728,133630.56163795176,2979.6089544886636,136610.1705924404,3763,9,626.6857142857143,33,2,19,31.86151771956857,0.6631944444444444,41.513480392156865,1033.9460784313726,31.33169934640523,0
3778,4,0,0,35,0.0,0.0,1.0,35,650,300,350,0.46153846153846156,10,3,7,372.67778283334417,0.728501400560224,-0.00032506010225863413,0.23224927116305474,133662.24078479447,2962.5895088427715,136624.83029363723,3764,10,627.6857142857143,33,2,19,31.848483052856125,0.6635101010101009,41.48284313725491,1034.0686274509817,31.33541295306005,0
3779,4,0,0,35,0.0,0.0,1.0,35,650,500,150,0.7692307692307693,8,5,3,371.74331496793656,0.7277310924369748,-0.0020986003689478228,0.23226390241631045,133757.30075271547,2944.6764765955545,136701.977229311,3765,11,628.6857142857143,33,2,12,31.777312127315092,0.6644570707070706,41.390931372549026,1034.4362745098051,31.346553773024397,0
3780,4,0,0,35,0.0,0.0,1.0,35,500,400,100,0.8,6,4,2,372.80171107645407,0.728641456582633,-0.002896736095835628,0.23332578551656796,133820.69283749035,2977.716653450594,136798.40949094095,3766,12,629.6857142857143,33,2,12,31.686382210114893,0.6650883838383839,41.3296568627451,1034.6813725490192,31.353980986333916,0
3781,4,0,0,35,0.0,0.0,1.0,35,550,300,250,0.5454545454545454,8,3,5,373.7024849536226,0.7293417366946778,-0.009477800782148549,0.23441337692545416,133903.12500000012,3007.986111111127,136911.11111111124,3767,13,630.6857142857143,34,1,12,31.58044820182503,0.6636029411764706,41.25000000000001,1035.000000000001,30.44117647058826,0
3782,4,1,0,36,0.027777777777777776,0.0,1.0,36,650,500,150,0.7692307692307693,8,5,3,368.18262165096803,0.7375,0.005611390284756768,0.233338667861601,134280.73459201402,2687.9665798611218,136968.70117187515,3768,0,614.1388888888889,35,1,14,31.345268006700163,0.6651785714285714,40.88541666666667,1036.4583333333344,29.61309523809527,0
3783,4,0,0,36,0.0,0.0,1.0,36,750,400,350,0.5333333333333333,11,4,7,368.86558940649627,0.7378968253968254,0.008523396708462139,0.2345398733493826,134400.72183909902,2715.16029556757,137115.88213466658,3769,1,615.1388888888889,35,1,15,31.20756129776388,0.6663690476190476,40.76967592592593,1036.921296296297,29.62632275132277,0
3784,4,0,0,36,0.0,0.0,1.0,36,700,400,300,0.5714285714285714,10,4,6,369.01307397959147,0.7381283068783069,0.01103670634920606,0.2348265016233767,134430.72702331978,2721.3391632373255,137152.06618655712,3770,2,616.1388888888889,35,1,15,31.173735119047613,0.6666666666666665,40.74074074074075,1037.0370370370383,29.629629629629665,0
3785,4,1,1,36,0.02702702702702703,0.02702702702702703,0.972972972972973,37,550,400,150,0.7272727272727273,7,4,3,360.60935951458634,0.746996996996997,0.009559973196336946,0.23104094365268918,134677.95589436777,2313.3870341891547,136991.34292855693,3771,0,600.4594594594595,33,4,15,31.144726485635584,0.6736111111111109,40.50245098039217,1037.990196078433,31.454248366013122,0
3786,4,0,0,36,0.0,0.0,1.0,36,700,400,300,0.5714285714285714,10,4,6,369.07716201564966,0.7371031746031746,0.011879083144284763,0.23544758741254582,134520.7626698603,2729.7082636745654,137250.47093353487,3772,4,618.1388888888889,35,1,16,31.082064227007344,0.6675595238095238,40.65393518518519,1037.3842592592598,29.63955026455028,0
3787,4,0,0,36,0.0,0.0,1.0,36,1250,1000,250,0.8,15,10,5,369.3751659922961,0.7371693121693123,0.015136904527623285,0.23645036135969472,134646.15660142756,2746.995986934953,137393.1525883625,3773,5,619.1388888888889,33,3,17,30.949024875034436,0.6732954545454544,40.53308823529413,1037.8676470588255,31.450534759358348,0
3788,4,0,0,36,0.0,0.0,1.0,36,1100,700,400,0.6363636363636364,15,7,8,363.7615055884287,0.7377976190476191,-0.04473824786324787,0.23644497863247863,135200.0,2639.719248606305,137839.7192486063,3774,6,620.1388888888889,34,2,18,30.54220085470086,0.6764705882352942,40.0,1040.0,30.58823529411765,5
3789,4,0,0,36,0.0,0.0,1.0,36,550,300,250,0.5454545454545454,8,3,5,363.7485035881668,0.7372685185185186,-0.046794333816535416,0.236843101665678,135261.91184807252,2640.263605442175,137902.1754535147,3775,7,621.1388888888889,34,2,19,30.48084992751965,0.6770833333333333,39.94047619047619,1040.238095238095,30.595238095238088,0
3790,4,1,0,37,0.02702702702702703,0.0,1.0,37,750,500,250,0.6666666666666666,10,5,5,366.2262759476261,0.7454329329329329,-0.030705688981474077,0.23654528816243073,134971.3930148319,2509.8378208021836,137481.23083563408,3776,0,605.3243243243244,35,2,17,30.70607781985595,0.6720238095238095,40.219907407407405,1039.1203703703698,29.689153439153422,8
3791,4,0,0,37,0.0,0.0,1.0,37,1000,700,300,0.7,13,7,6,367.7700011408675,0.7451826826826827,-0.029109733341359134,0.23793765203494147,135031.53399348413,2532.109482167339,137563.64347565148,3777,1,606.3243243243244,35,2,18,30.605976243504067,0.6726190476190477,40.16203703703703,1039.351851851851,29.69576719576717,0
3792,4,0,0,37,0.0,0.0,1.0,37,1250,800,450,0.64,17,8,9,369.725444475549,0.7463713713713713,-0.03061030426159439,0.23393299677664953,134220.76106234998,2524.966108324763,136745.72717067474,3778,2,607.3243243243244,35,2,18,31.36530120257643,0.6645833333333333,40.94328703703704,1036.226851851852,29.606481481481485,3
3793,4,0,0,37,0.0,0.0,1.0,37,1000,900,100,0.9,11,9,2,371.7642272288054,0.7464964964964965,-0.014861222408392383,0.2261057841014537,132755.59413580244,2470.756172839499,135226.35030864194,3779,3,608.3243243243244,35,2,16,32.783018867924525,0.65,42.36111111111111,1030.5555555555552,29.444444444444436,6
3794,4,0,0,37,0.0,0.0,1.0,37,900,500,400,0.5555555555555556,13,5,8,368.75585397968064,0.7466841841841841,-0.01712627081358642,0.22456569071696736,132803.95418645008,2394.4471075805623,135198.40129403063,3780,4,609.3243243243244,36,1,16,32.81187406679047,0.6484375,42.31418918918919,1030.743243243244,28.63175675675678,0
3795,4,0,0,37,0.0,0.0,1.0,37,1150,800,350,0.6956521739130435,15,8,7,368.81312643715586,0.7468718718718719,-0.017130304873367974,0.22477465775004823,132832.97444403864,2398.1089197305446,135231.0833637692,3781,5,610.3243243243244,36,1,17,32.781206758429846,0.6487268518518519,42.28603603603604,1030.855855855856,28.634884884884887,0
3796,4,0,0,37,0.0,0.0,1.0,37,850,500,350,0.5882352941176471,12,5,7,370.8599984616911,0.747997997997998,-0.01080372640005689,0.22637294306101646,132891.0244704166,2456.793026134265,135347.81749655085,3782,6,611.3243243243244,36,1,17,32.670061526139506,0.6493055555555556,42.22972972972974,1031.0810810810829,28.64114114114119,0
3797,4,0,1,36,0.0,0.02702702702702703,0.972972972972973,37,1050,800,250,0.7619047619047619,13,8,5,370.57503490137793,0.7449324324324325,-0.010177171277367947,0.22725625634313443,133065.25063915286,2462.1319799529465,135527.3826191058,3783,7,612.3243243243244,36,1,18,32.50222840718911,0.6510416666666665,42.06081081081082,1031.7567567567583,28.659909909909953,0
3798,4,1,1,36,0.02702702702702703,0.02702702702702703,0.972972972972973,37,1000,700,300,0.7,13,7,6,364.5884296262646,0.7446821821821822,0.004833623154233857,0.22498491922428301,133297.72973987498,2319.761991721447,135617.4917315964,3784,0,612.8918918918919,36,1,18,32.42320974191204,0.6533564814814815,41.835585585585584,1032.6576576576574,28.68493493493493,0
3799,4,0,0,36,0.0,0.0,1.0,36,950,700,250,0.7368421052631579,12,7,5,373.43216141976706,0.7359126984126985,0.005529388309471361,0.229489633589253,133143.52823055978,2744.015105238337,135887.5433357981,3785,9,630.9166666666666,35,1,18,32.349842061979,0.6538690476190476,41.9849537037037,1032.0601851851848,29.48743386243385,0
3800,4,0,0,36,0.0,0.0,1.0,36,350,300,50,0.8571428571428571,4,3,1,373.43216141976706,0.7359126984126985,0.005529388309471361,0.229489633589253,133143.52823055978,2744.015105238337,135887.5433357981,3786,10,631.9166666666666,35,1,18,32.349842061979,0.6538690476190476,41.9849537037037,1032.0601851851848,29.48743386243385,0
3801,4,0,1,35,0.0,0.027777777777777776,0.9722222222222222,36,950,700,250,0.7368421052631579,12,7,5,364.9087740990509,0.7370701058201059,0.022418741031879907,0.2221129619516097,132785.41512613607,2490.9126103823833,135276.32773651846,3787,11,632.9166666666666,35,1,18,32.929650945161896,0.6502976190476188,42.33217592592593,1030.671296296297,29.447751322751344,2
3802,4,0,0,35,0.0,0.0,1.0,35,700,600,100,0.8571428571428571,8,6,2,370.71300821229454,0.7343837535014005,0.020269043492613603,0.2251593744615729,132704.48022959207,2839.0554138322263,135543.5356434243,3788,12,634.0,34,1,19,32.861544386674375,0.6516544117647057,42.4107142857143,1030.3571428571447,30.30462184873955,0
3803,4,0,0,35,0.0,0.0,1.0,35,800,600,200,0.75,10,6,4,370.61993071621043,0.7352941176470588,0.018171917028333873,0.2254713099234179,132765.81809807263,2841.131660997742,135606.94975907038,3789,13,635.0,34,1,19,32.802212082707634,0.652267156862745,42.35119047619048,1030.5952380952388,30.311624649859965,0
3804,4,0,0,35,0.0,0.0,1.0,35,600,300,300,0.5,9,3,6,371.86634899732604,0.7353641456582632,0.021628221628221977,0.22641482768065063,132796.49234693896,2876.509353741521,135673.00170068047,3790,14,636.0,34,1,19,32.73922961422962,0.6525735294117645,42.321428571428584,1030.7142857142871,30.31512605042021,0
3805,4,0,0,35,0.0,0.0,1.0,35,800,600,200,0.75,10,6,4,371.71514062158286,0.7345238095238095,0.02461233916199279,0.22669388153400774,132857.85147392302,2877.054988662141,135734.90646258515,3791,15,637.0,34,1,19,32.681389530408,0.6531862745098038,42.261904761904766,1030.9523809523819,30.322128851540644,0
3806,4,0,0,35,0.0,0.0,1.0,35,750,400,350,0.5333333333333333,11,4,7,370.6453452199254,0.7353641456582632,0.021831857093374207,0.22622687349892706,132888.53635204086,2850.9034863945662,135739.4398384354,3792,16,638.0,34,1,19,32.67809721741138,0.6534926470588235,42.23214285714286,1031.0714285714291,30.325630252100858,0
3807,4,0,1,34,0.0,0.02857142857142857,0.9714285714285714,35,800,500,300,0.625,11,5,6,374.29435668035063,0.732703081232493,0.03240249249942284,0.22939426414370043,133042.01388888917,2959.3750000000337,136001.3888888892,3793,17,639.0,34,1,19,32.429658050619274,0.6550245098039214,42.08333333333335,1031.666666666669,30.34313725490203,0
3808,4,1,1,34,0.02857142857142857,0.02857142857142857,0.9714285714285714,35,900,500,400,0.5555555555555556,13,5,8,366.759959803669,0.7405462184873949,0.03738163853437615,0.22645143425600225,133318.49666950124,2779.177295918381,136097.6739654196,3794,0,631.7714285714286,34,1,19,32.346301633045144,0.657781862745098,41.8154761904762,1032.738095238096,30.374649859944004,0
3809,4,0,0,34,0.0,0.0,1.0,34,450,400,50,0.8888888888888888,5,4,1,373.4296941873269,0.7304664289958408,0.04170303999553027,0.22975882499195432,133187.4478115389,3147.229581170709,136334.67739270962,3795,19,651.3529411764706,33,1,19,32.305764968934255,0.6587752525252526,41.942401960784316,1032.2303921568632,31.27970885323828,0
3810,4,0,0,34,0.0,0.0,1.0,34,900,600,300,0.6666666666666666,12,6,6,374.52149794398105,0.7289067142008319,0.04880781986385063,0.23082250330490428,133250.7047319541,3181.0507076605186,136431.75543961462,3796,20,652.3529411764706,33,1,19,32.21402077151335,0.6594065656565655,41.881127450980394,1032.4754901960787,31.287136066547838,0
3811,4,1,0,35,0.02857142857142857,0.0,1.0,35,1150,800,350,0.6956521739130435,15,8,7,369.83017665363184,0.7394257703081232,0.04923212380839481,0.23027728416433144,133630.56163795167,2884.3068170895694,136514.86845504123,3797,0,634.6857142857143,33,2,20,31.953868871241745,0.6631944444444444,41.51348039215686,1033.946078431372,31.33169934640521,0
3812,4,0,0,35,0.0,0.0,1.0,35,750,500,250,0.6666666666666666,10,5,5,376.37404689628676,0.7394257703081232,-0.009233825393019757,0.2165318827040568,130638.16350682426,2848.664726307186,133486.82823313144,3798,1,635.6857142857143,33,2,16,34.80480300487493,0.6332070707070707,44.424019607843135,1022.3039215686272,30.978906714200825,7
3813,4,0,0,35,0.0,0.0,1.0,35,700,300,400,0.42857142857142855,11,3,8,375.84108675302406,0.7387254901960784,-0.012926637225702642,0.21692736583960842,130763.47588667813,2829.2573769703895,133592.73326364852,3799,2,636.6857142857143,33,2,17,34.691269270708524,0.634469696969697,44.30147058823529,1022.7941176470583,30.99376114081995,0
3814,4,0,0,35,0.0,0.0,1.0,35,850,700,150,0.8235294117647058,10,7,3,377.5052122925849,0.7392857142857142,-0.014306249572181073,0.2182419329791201,130826.15460399825,2877.5110534409578,133703.6656574392,3800,3,637.6857142857143,33,2,17,34.585130170899205,0.6351010101010102,44.24019607843136,1023.0392156862728,31.00118835412948,0
3815,4,0,0,35,0.0,0.0,1.0,35,900,500,400,0.5555555555555556,13,5,8,372.4157842239415,0.7407563025210083,0.003968163913698808,0.21106754381772316,130055.90284475725,2686.9742101765946,132742.87705493384,3801,4,638.6857142857143,35,0,19,35.4973949468588,0.6229166666666668,44.994212962962955,1020.0231481481471,29.14351851851849,2
3816,4,0,0,35,0.0,0.0,1.0,35,1350,900,450,0.6666666666666666,18,9,9,370.86002745800766,0.74187675070028,0.004198726774982786,0.21114361408341975,130233.05047850231,2659.6465352795003,132892.6970137818,3802,5,639.6857142857143,35,0,19,35.35701799145783,0.624702380952381,44.820601851851855,1020.7175925925932,29.163359788359806,0
3817,4,1,1,35,0.027777777777777776,0.027777777777777776,0.9722222222222222,36,850,600,250,0.7058823529411765,11,6,5,359.31422823659756,0.7468915343915344,0.005521576622494528,0.20613289935678478,130528.56445312485,2180.157428840865,132708.72188196573,3803,0,622.8888888888889,35,1,17,35.35189432551819,0.6276785714285715,44.53124999999999,1021.8749999999989,29.196428571428537,0
3818,4,0,1,34,0.0,0.02857142857142857,0.9714285714285714,35,700,400,300,0.5714285714285714,10,4,6,368.2942931194682,0.7392156862745097,0.011421911421911624,0.21066433566433565,130414.54081632645,2606.186224489789,133020.72704081624,3804,7,641.6857142857143,34,1,21,35.238199300699314,0.6286764705882353,44.64285714285714,1021.4285714285708,30.04201680672267,0
3819,4,1,1,34,0.02857142857142857,0.02857142857142857,0.9714285714285714,35,900,600,300,0.6666666666666666,12,6,6,367.0148604366821,0.7445378151260503,0.014400559245019373,0.21042675665517996,130505.75573979595,2579.5103458049944,133085.26608560095,3805,0,641.8571428571429,34,1,17,35.17830789545226,0.6295955882352942,44.55357142857143,1021.7857142857146,30.05252100840337,0
3820,4,0,0,34,0.0,0.0,1.0,34,850,500,350,0.5882352941176471,12,5,7,378.58482292743616,0.732397504456328,0.023998729665831497,0.2165754632189554,130419.01139285375,3074.931666906963,133493.9430597607,3806,9,661.7352941176471,33,1,22,34.97088082383524,0.6309974747474747,44.638480392156865,1021.4460784313728,30.95291146761736,0
3821,4,1,1,34,0.02857142857142857,0.02857142857142857,0.9714285714285714,35,950,800,150,0.8421052631578947,11,8,3,375.0218090762369,0.7407563025210083,0.017134210219997836,0.2163742351762224,130749.15143140586,2806.756660997731,133555.90809240358,3807,0,643.8,34,1,18,34.72674892329182,0.632046568627451,44.31547619047619,1022.738095238095,30.080532212885146,0
3822,4,0,0,34,0.0,0.0,1.0,34,1000,700,300,0.7,13,7,6,385.12248865320356,0.7337344028520499,0.02388978610266812,0.22138571177507732,130606.8447982748,3259.9266207708692,133866.77141904566,3808,11,663.7352941176471,33,1,18,34.613031011469445,0.6328914141414141,44.454656862745104,1022.1813725490205,30.975193107546076,0
3823,4,0,0,34,0.0,0.0,1.0,34,1000,700,300,0.7,13,7,6,383.3510152558097,0.7337715389185978,0.024391103840241346,0.22054580477682528,130638.16350682439,3216.054522299127,133854.21802912353,3809,12,664.7352941176471,33,1,18,34.62648845200991,0.6332070707070707,44.42401960784314,1022.3039215686282,30.978906714200853,0
3824,4,0,0,34,0.0,0.0,1.0,34,950,700,250,0.7368421052631579,12,7,5,381.10872924459176,0.7342914438502675,0.022517060515481413,0.2196112732608339,130700.8121876202,3162.2440888120027,133863.0562764322,3810,13,665.7352941176471,33,1,19,34.620186161713015,0.6338383838383839,44.36274509803922,1022.5490196078437,30.986333927510415,0
3825,4,1,1,34,0.02857142857142857,0.02857142857142857,0.9714285714285714,35,550,300,250,0.5454545454545454,8,3,5,371.28177393185524,0.745798319327731,0.018837209302325908,0.2157448145820239,131023.24263038553,2729.308390022684,133752.55102040822,3811,0,647.6857142857143,34,1,19,34.54457364341086,0.6348039215686274,44.04761904761905,1023.8095238095241,30.112044817927178,0
3826,4,0,0,34,0.0,0.0,1.0,34,850,700,150,0.8235294117647058,10,7,3,379.4591415970454,0.7341428995840761,0.018337442761535705,0.21972842110508511,130888.84833958096,3133.3940071126503,134022.24234669362,3812,15,667.7352941176471,33,1,19,34.471556886227546,0.6357323232323232,44.17892156862745,1023.2843137254905,31.008615567439108,0
3827,4,0,0,34,0.0,0.0,1.0,34,1050,900,150,0.8571428571428571,12,9,3,362.51195263320506,0.734402852049911,0.03517297394033725,0.20195744114754702,129383.0002834467,2580.5768140589585,131963.57709750565,3813,16,668.7352941176471,34,0,21,36.434443014275686,0.6182598039215685,45.654761904761905,1017.3809523809523,29.92296918767507,6
3828,4,0,0,34,0.0,0.0,1.0,34,600,300,300,0.5,9,3,6,361.8882408985433,0.734402852049911,0.03347876352225465,0.20192041013059714,129443.5657596372,2568.8208616780057,132012.3866213152,3814,17,669.7352941176471,34,0,16,36.388628919045395,0.6188725490196079,45.595238095238095,1017.6190476190478,29.929971988795526,0
3829,4,2,1,35,0.05555555555555555,0.027777777777777776,0.9722222222222222,36,600,500,100,0.8333333333333334,7,5,2,348.0982564723016,0.7636243386243386,0.03201870673147744,0.19644547491192463,129889.23890106313,1842.8435191948583,131732.082420258,3815,0,633.4722222222222,36,0,17,36.28664015318897,0.619212962962963,45.15765765765765,1019.3693693693685,28.315815815815792,0
3830,4,0,0,35,0.0,0.0,1.0,35,1250,900,350,0.72,16,9,7,367.93302446679644,0.7484593837535013,0.02793516133919116,0.19602307461705565,127602.69451530586,2397.775064950466,130000.46958025632,3816,1,652.5714285714286,34,1,16,38.11712030163779,0.6001838235294119,47.41071428571427,1010.3571428571407,29.716386554621785,6
3831,4,4,2,37,0.10256410256410256,0.05128205128205128,0.9487179487179487,39,750,400,350,0.5333333333333333,11,4,7,338.2746544672232,0.7884615384615384,0.03755244509643396,0.18440923294361927,128523.41666894936,895.2428729271487,129418.6595418765,3817,0,586.5384615384615,38,1,15,37.9258420257788,0.6016995614035088,46.50106837606837,1013.9957264957252,26.684098065676977,0
3832,4,4,2,39,0.0975609756097561,0.04878048780487805,0.9512195121951219,41,550,500,50,0.9090909090909091,6,5,1,328.0127919962873,0.8040650406504065,0.05198600695748956,0.18118629250712018,129046.45568940423,265.77764558131526,129312.23333498555,3818,0,558.829268292683,40,1,17,37.653780756151235,0.6036458333333334,45.98577235772357,1016.0569105691038,25.401422764227597,0
3833,4,2,2,39,0.04878048780487805,0.04878048780487805,0.9512195121951219,41,1000,700,300,0.7,13,7,6,324.58975111596357,0.8095528455284553,0.04364980662404094,0.17976449006987077,129149.73416121355,184.13601361622983,129333.87017482978,3819,0,559.780487804878,40,1,17,37.635806172098896,0.6046875,45.88414634146341,1016.4634146341461,25.411585365853654,0
3834,4,1,0,40,0.025,0.0,1.0,40,850,500,350,0.5882352941176471,12,5,7,328.97292913083623,0.7959935897435897,0.0495874756585013,0.1820640311701399,129121.97401258674,495.52680121526714,129617.500813802,3820,0,574.75,39,1,18,37.55263315226675,0.6060363247863249,45.91145833333333,1016.3541666666661,26.060363247863233,0
3835,4,1,1,40,0.024390243902439025,0.024390243902439025,0.975609756097561,41,1050,600,450,0.5714285714285714,15,6,9,324.10039503900526,0.8053353658536585,0.05275023781049537,0.1808187755074838,129439.78000217007,190.32118055554508,129630.10118272562,3821,0,561.7073170731708,39,2,17,37.35381052308321,0.6092414529914532,45.59895833333333,1017.6041666666661,26.092414529914514,0
3836,4,2,2,40,0.047619047619047616,0.047619047619047616,0.9523809523809523,42,1150,700,450,0.6086956521739131,16,7,9,320.9100163109832,0.806523422377081,0.05146021293881242,0.1801950192428563,129692.62390318263,-76.06758956308937,129616.55631361954,3822,0,549.2857142857143,40,2,17,37.17865575842231,0.61015625,45.35060975609756,1018.5975609756097,25.46493902439024,0
3837,4,1,3,38,0.024390243902439025,0.07317073170731707,0.926829268292683,41,950,600,350,0.631578947368421,13,6,7,330.3608047101366,0.8003048780487805,0.05272163991838319,0.1854344402098576,129678.39084201407,368.13151041668584,130046.52235243075,3823,0,563.6585365853658,39,2,18,36.95242721756323,0.6116452991452991,45.36458333333334,1018.5416666666681,26.116452991453027,0
3838,4,1,1,38,0.02564102564102564,0.02564102564102564,0.9743589743589743,39,850,700,150,0.8235294117647058,10,7,3,340.047841853994,0.7917228969860549,0.04980138011812252,0.18991119543253762,129480.2306959835,1005.8946021852987,130486.1252981688,3824,0,579.5128205128206,37,2,18,36.9070063923005,0.6131756756756757,45.559210526315795,1017.7631578947377,27.50711237553345,0
3839,4,0,0,38,0.0,0.0,1.0,38,1100,900,200,0.8181818181818182,13,9,4,342.5381061927464,0.7870732574679943,0.050288741902179135,0.19076041712222727,129368.6579043554,1262.739015851048,130631.39692020645,3825,7,595.7631578947369,37,1,19,36.957048932959694,0.6120495495495495,45.668859649122815,1017.3245614035104,27.495258416311092,0
3840,4,2,0,40,0.05,0.0,1.0,40,1000,500,500,0.5,15,5,10,331.68441609409166,0.7964476495726496,0.061467702371218236,0.1869355027110942,129837.58680555563,613.0208333333376,130450.60763888898,3826,0,566.925,39,1,20,36.75729081493594,0.6132478632478633,45.208333333333336,1019.1666666666673,26.132478632478648,0
3841,4,0,0,40,0.0,0.0,1.0,40,1250,1000,250,0.8,15,10,5,332.0596899466898,0.7968215811965812,0.0625561912545971,0.1876559033024366,129943.77170138899,629.8177083333417,130573.58940972234,3827,1,567.925,39,1,20,36.64010352812968,0.6143162393162394,45.10416666666667,1019.5833333333342,26.143162393162413,0
3842,4,1,0,41,0.024390243902439025,0.0,1.0,41,700,200,500,0.2857142857142857,12,2,10,325.0312369845896,0.8017784552845528,0.07028372324539545,0.18519221642145237,130262.58680555565,267.8819444444533,130530.4687500001,3828,0,555.0487804878048,40,1,21,36.49659863945578,0.6158854166666666,44.79166666666667,1020.8333333333342,25.520833333333353,0
3843,4,2,1,42,0.046511627906976744,0.023255813953488372,0.9767441860465116,43,1350,1200,150,0.8888888888888888,15,12,3,315.27437811499175,0.8162144702842377,0.08617641221787209,0.18223707326915933,130820.18455530392,-351.1495338875989,130469.03502141632,3829,0,530.1860465116279,41,2,20,36.1827644168606,0.6199186991869917,44.24603174603176,1023.0158730158755,24.951606658923794,0
3844,4,0,0,42,0.0,0.0,1.0,42,950,700,250,0.7368421052631579,12,7,5,320.5253039061994,0.806716995741386,0.08625452962826263,0.18521284208494895,130807.80805902604,-14.5575137153524,130793.25054531069,3830,1,543.8095238095239,40,2,20,36.06095602357771,0.6213541666666664,44.25813008130083,1022.9674796747994,25.574186991869986,0
3845,4,0,0,42,0.0,0.0,1.0,42,1100,700,400,0.6363636363636364,15,7,8,322.313772923907,0.8052893921796361,0.08009474639736736,0.18700140097290327,130963.79469892294,42.286957168388454,131006.08165609132,3831,2,544.8095238095239,40,2,20,35.85786503839026,0.6229166666666666,44.10569105691059,1023.5772357723605,25.58943089430901,0
3846,4,1,2,41,0.023255813953488372,0.046511627906976744,0.9534883720930233,43,1550,1000,550,0.6451612903225806,21,10,11,315.279288598118,0.8126153562200074,0.08197179039143987,0.1841744622534708,131226.45817586302,-325.40312421263627,130901.05505165039,3832,0,533.1162790697674,41,2,20,35.77330234959979,0.6239837398373983,43.849206349206355,1024.6031746031754,24.990321331784767,0
3847,4,0,2,39,0.0,0.04878048780487805,0.9512195121951219,41,1000,700,300,0.7,13,7,6,330.43619502196464,0.8007113821138211,0.08225038400551865,0.1920672596612,131034.66932508687,459.71950954861575,131494.3888346355,3833,4,559.9756097560976,39,2,20,35.578496456065395,0.625267094017094,44.036458333333336,1023.8541666666672,26.252670940170955,0
3848,4,0,0,39,0.0,0.0,1.0,39,800,300,500,0.375,13,3,10,330.24226180311695,0.7932411156095367,-0.004960525396492388,0.18645986166422127,129908.3719135802,780.5751470871853,130688.94706066739,3834,5,574.8461538461538,38,1,17,36.72229791099,0.6156798245614035,45.138888888888886,1019.444444444444,26.827485380116947,7
3849,4,0,0,39,0.0,0.0,1.0,39,1000,800,200,0.8,12,8,4,331.0237290909431,0.7936909581646424,-0.006787093237894615,0.18703134675635713,129935.60209155163,802.3535092044744,130737.9556007561,3835,6,575.8461538461538,38,1,17,36.67478780257781,0.615953947368421,45.11217948717949,1019.5512820512822,26.830296896086374,0
3850,4,0,0,39,0.0,0.0,1.0,39,700,400,300,0.5714285714285714,10,4,6,329.888172728722,0.7932973459289249,-0.003943533330646787,0.18664982861266474,129990.07100820009,776.4373995543972,130766.50840775449,3836,7,576.8461538461538,38,1,17,36.64855072463768,0.6165021929824561,45.05876068376069,1019.7649572649578,26.835919928025206,0
3851,4,0,0,39,0.0,0.0,1.0,39,1250,1100,150,0.88,14,11,3,328.18177071504505,0.7929037336932074,-0.0026583532709827384,0.18620366776933844,130099.04308431956,739.2268655489885,130838.26994986855,3837,8,577.8461538461538,38,1,18,36.58171012671485,0.6175986842105262,44.95192307692308,1020.1923076923081,26.847165991902845,0
3852,4,3,2,40,0.07142857142857142,0.047619047619047616,0.9523809523809523,42,1200,600,600,0.5,18,6,12,312.48604583716036,0.8097415795586528,0.030318137336361684,0.18110146341888464,130921.69390904512,-217.75951121188677,130703.93439783323,3838,0,537.5,41,1,17,36.15177071216234,0.6209349593495934,44.1468253968254,1023.4126984126985,24.961285327138988,0
3853,4,0,1,39,0.0,0.025,0.975,40,1000,500,500,0.5,15,5,10,325.6991650151307,0.7946314102564103,0.03223161540028485,0.18787981211037375,130741.54188368094,516.4822048611506,131258.0240885421,3839,1,565.375,39,1,17,35.995535411149575,0.6223290598290596,44.322916666666686,1022.7083333333364,26.223290598290678,0
3854,4,0,1,38,0.0,0.02564102564102564,0.9743589743589743,39,800,500,300,0.625,11,5,6,331.17446199535334,0.78621232568601,0.04227260797137533,0.1912342761847717,130781.15297866914,862.2755953685585,131643.4285740377,3840,2,580.3076923076923,38,1,19,35.81553338903976,0.6244517543859648,44.28418803418804,1022.863247863249,26.91745389113813,0
3855,4,0,0,38,0.0,0.0,1.0,38,1100,800,300,0.7272727272727273,14,8,6,333.1447037239984,0.7857396870554766,0.0420206464714834,0.19257993096312934,130822.85534972312,1116.5882771622107,131939.44362688533,3841,3,588.078947368421,37,1,19,35.72302608074311,0.6266891891891891,44.24342105263158,1023.0263157894747,27.649359886202017,0
3856,4,0,0,38,0.0,0.0,1.0,38,750,400,350,0.5333333333333333,11,4,7,330.48375573650867,0.7844950213371266,0.03923967836883868,0.1915984705617745,130935.05333371802,1054.3816366574335,131989.43497037547,3842,4,589.078947368421,37,1,19,35.677808727948026,0.6278153153153152,44.13377192982456,1023.4649122807014,27.66121384542436,0
3857,4,1,1,38,0.02564102564102564,0.02564102564102564,0.9743589743589743,39,800,500,300,0.625,11,5,6,322.3717394242221,0.7924538911381017,0.036759179765333494,0.18787707391246325,131136.5549551649,654.9438645993296,131791.49881976424,3843,0,574.9487179487179,38,1,19,35.68221723862173,0.6280153508771928,43.93696581196582,1024.252136752138,26.954003598740474,0
3858,4,0,1,37,0.0,0.02631578947368421,0.9736842105263158,38,1050,700,350,0.6666666666666666,14,7,7,326.989113699335,0.7833688952110005,0.036512911281094684,0.18998738983265032,131019.23338190599,968.3726002231525,131987.60598212914,3844,6,591.078947368421,37,1,19,35.6822989182821,0.6286599099099099,44.0515350877193,1023.7938596491229,27.670104314841158,0
3859,4,1,0,38,0.02631578947368421,0.0,1.0,38,1600,1200,400,0.75,20,12,8,320.64933701094327,0.7915777619724989,0.04891430024974541,0.18809223995796565,131385.84530476414,826.1205315554942,132211.96583631964,3845,0,586.1315789473684,36,2,20,35.47524897480959,0.6342592592592593,43.69369369369369,1025.2252252252247,28.478478478478465,0
3860,4,0,0,38,0.0,0.0,1.0,38,550,400,150,0.7272727272727273,7,4,3,320.02513867831595,0.7918148411569464,0.04690949865328786,0.18800960727772537,131443.5782911289,813.0498741985192,132256.62816532742,3846,1,587.1315789473684,36,2,20,35.433139322058715,0.634837962962963,43.637387387387385,1025.45045045045,28.484734734734722,0
3861,4,1,0,39,0.02564102564102564,0.0,1.0,39,550,400,150,0.7272727272727273,7,4,3,313.66566052730667,0.7925101214574899,0.06489520445740427,0.18603412988209173,131806.21831957914,468.6169061634421,132274.83522574257,3847,0,573.0512820512821,37,2,18,35.23169158213207,0.6365427927927928,43.28399122807018,1026.8640350877197,27.75308202939783,0
3862,4,0,1,38,0.0,0.02564102564102564,0.9743589743589743,39,1000,600,400,0.6,14,6,8,313.4152013050262,0.7922852001799371,0.06221828123845441,0.18643727117630418,131918.83710612878,469.0737775084645,132387.91088363723,3848,1,574.0512820512821,37,2,18,35.12503557832568,0.637668918918919,43.17434210526316,1027.3026315789473,27.7649359886202,0
3863,4,0,1,37,0.0,0.02631578947368421,0.9736842105263158,38,1250,900,350,0.72,16,9,7,320.3519592016928,0.7819760550023708,0.06476268487966919,0.190789247764768,131963.74584043503,854.96890471552,132818.71474515056,3849,2,590.078947368421,36,2,20,34.90177005699253,0.6400462962962964,43.13063063063063,1027.4774774774774,28.541041041041037,0
3864,4,0,0,37,0.0,0.0,1.0,37,950,500,450,0.5263157894736842,14,5,9,323.9571328446798,0.7762137137137137,0.021590811462564252,0.19278936222713738,131934.82069485038,1148.2452469361378,133083.0659417865,3850,3,606.1891891891892,36,1,16,34.83822938360918,0.6397569444444444,43.15878378378379,1027.364864864866,28.537912912912944,2
3865,4,0,0,37,0.0,0.0,1.0,37,1200,900,300,0.75,15,9,6,333.9035555244677,0.7759009009009009,0.032159512155004455,0.1981756687738195,131832.8045294282,1404.7000558608904,133237.50458528908,3851,4,607.1891891891892,35,2,16,34.68539858747511,0.6407738095238095,43.258101851851855,1026.9675925925928,29.341931216931226,4
3866,4,0,1,36,0.0,0.02702702702702703,0.972972972972973,37,850,500,350,0.5882352941176471,12,5,7,334.69491905010995,0.7755255255255256,0.034838623259439316,0.19942426116287762,131981.42387902955,1434.7023962620124,133416.12627529155,3852,5,608.1891891891892,35,2,16,34.5155628144477,0.6422619047619047,43.11342592592593,1027.5462962962968,29.35846560846562,0
3867,4,0,0,36,0.0,0.0,1.0,36,600,300,300,0.5,9,3,6,341.97180602307554,0.7699074074074075,0.04792712759109041,0.20353218523994096,131938.95266439923,1823.880385487543,133762.83304988677,3853,6,625.4166666666666,34,2,16,34.37137891077636,0.6439950980392156,43.15476190476191,1027.3809523809534,30.217086834733923,0
3868,4,0,0,36,0.0,0.0,1.0,36,650,400,250,0.6153846153846154,9,4,5,343.6903849804292,0.7681878306878307,0.05124343527957964,0.2048850416540791,132000.11337868482,1873.4339569160989,133873.54733560092,3854,7,626.4166666666666,34,2,16,34.26566844300277,0.6446078431372548,43.095238095238095,1027.6190476190477,30.224089635854344,0
3869,4,0,0,36,0.0,0.0,1.0,36,850,700,150,0.8235294117647058,10,7,3,343.06476052398466,0.768915343915344,0.04481241315423823,0.20517363378705894,132122.47732426302,1865.313208616776,133987.7905328798,3855,8,627.4166666666666,34,2,16,34.15860930986568,0.6458333333333333,42.976190476190474,1028.0952380952378,30.23809523809523,0
3870,4,0,0,36,0.0,0.0,1.0,36,800,600,200,0.75,10,6,4,344.2550261488341,0.7679563492063493,0.049864969135802406,0.20655301568930048,132244.8979591837,1905.1941609977403,134150.09212018145,3856,9,628.4166666666666,34,2,17,34.00487075617283,0.6470588235294117,42.85714285714286,1028.571428571429,30.252100840336144,0
3871,4,0,0,36,0.0,0.0,1.0,36,750,500,250,0.6666666666666666,10,5,5,345.20896642848265,0.7683201058201059,0.04943306722202956,0.2076298606013484,132336.75063775512,1936.766581632659,134273.51721938778,3857,10,629.4166666666666,34,2,18,33.88797292606734,0.6479779411764706,42.767857142857146,1028.9285714285716,30.262605042016812,0
3872,4,0,0,36,0.0,0.0,1.0,36,700,500,200,0.7142857142857143,9,5,4,347.3857935613184,0.7678240740740742,0.047202302927493944,0.20944892406772378,132428.63520408166,2000.7653061224526,134429.4005102041,3858,11,630.4166666666666,34,2,19,33.739590562109655,0.6488970588235293,42.67857142857143,1029.2857142857144,30.273109243697483,0
3873,4,0,0,36,0.0,0.0,1.0,36,750,600,150,0.8,9,6,3,344.8560344731683,0.7678902116402117,0.041968599033816334,0.20826221970139383,132489.9092970522,1937.9889455782345,134427.8982426304,3859,12,631.4166666666666,34,2,19,33.74311016034535,0.6495098039215685,42.61904761904762,1029.5238095238096,30.28011204481793,0
3874,4,0,0,36,0.0,0.0,1.0,36,1100,600,500,0.5454545454545454,16,6,10,342.62721192230026,0.767989417989418,0.03383861730677862,0.2077612659259751,132643.15653344675,1889.4309807256227,134532.58751417237,3860,13,632.4166666666666,34,2,16,33.64656766439386,0.6510416666666666,42.470238095238095,1030.1190476190477,30.29761904761905,0
3875,4,0,0,36,0.0,0.0,1.0,36,1050,800,250,0.7619047619047619,13,8,5,342.17856138817046,0.766468253968254,0.03372030341534793,0.20816864412771546,132765.81809807252,1885.9233276643956,134651.74142573692,3861,14,633.4166666666666,34,2,17,33.53500057756729,0.6522671568627452,42.351190476190474,1030.5952380952378,30.311624649859937,0
3876,4,0,0,36,0.0,0.0,1.0,36,1300,1100,200,0.8461538461538461,15,11,4,340.4028983270597,0.7648148148148148,0.03107404414688264,0.20810940777751014,132949.9167375284,1851.3073979591904,134801.2241354876,3862,15,634.4166666666666,34,2,19,33.39610027319251,0.6541053921568627,42.17261904761905,1031.3095238095243,30.332633053221304,0
3877,4,0,0,36,0.0,0.0,1.0,36,950,700,250,0.7368421052631579,12,7,5,340.692293839926,0.7636904761904763,0.030649793573864326,0.20880052464050927,133042.013888889,1865.2777777777828,134907.29166666677,3863,16,635.4166666666666,34,2,19,33.296311254711895,0.6550245098039216,42.083333333333336,1031.6666666666674,30.343137254901983,0
3878,4,1,2,35,0.02702702702702703,0.05405405405405406,0.9459459459459459,37,800,700,100,0.875,9,7,2,333.2254918237869,0.7709584584584585,0.02893827369900448,0.2057696237746473,133322.76562767936,1485.3088295181951,134808.07445719757,3864,0,619.2162162162163,35,2,20,33.20783835780193,0.6556547619047619,41.8113425925926,1032.754629629631,29.50727513227517,0
3879,4,0,0,35,0.0,0.0,1.0,35,800,700,100,0.875,9,7,2,350.77920074193196,0.7533613445378151,0.03460057339644118,0.21545672133098537,133124.20590938587,2339.440509659754,135463.64641904563,3865,1,652.8857142857142,33,2,20,32.95370205438784,0.6581439393939392,42.00367647058824,1031.9852941176475,31.272281639928714,0
3880,4,0,1,34,0.0,0.02857142857142857,0.9714285714285714,35,900,900,0,1.0,9,9,0,353.5511734412069,0.753641456582633,0.03247570427909974,0.21752823476225616,133187.4478115389,2417.71569228182,135605.16350382072,3866,2,653.8857142857142,33,2,20,32.81874530056592,0.6587752525252526,41.942401960784316,1032.2303921568632,31.27970885323828,0
3881,4,0,0,34,0.0,0.0,1.0,34,1000,800,200,0.8,12,8,4,367.2021051652216,0.7491458704694,0.07424702801853922,0.2219591429926755,132524.15687475962,2932.629877931551,135456.78675269117,3867,3,670.8235294117648,33,1,22,33.133480123780046,0.6521464646464648,42.58578431372548,1029.6568627450972,31.201723113487795,2
3882,4,0,0,34,0.0,0.0,1.0,34,750,400,350,0.5333333333333333,11,4,7,368.0643450536124,0.7491458704694,0.0807038665061457,0.2228539449445645,132587.25610342165,2960.1283160322796,135547.38441945394,3868,4,671.8235294117648,33,1,22,33.04775503728383,0.6527777777777779,42.52450980392156,1029.9019607843127,31.209150326797353,0
3883,4,0,0,34,0.0,0.0,1.0,34,750,400,350,0.5333333333333333,11,4,7,367.37813020267026,0.7491458704694,0.08409358034365,0.22318752303063966,132713.4996155325,2951.207468281424,135664.7070838139,3869,5,672.8235294117648,33,1,17,32.938372185220416,0.6540404040404041,42.40196078431372,1030.392156862745,31.224004753416516,0
3884,4,0,0,34,0.0,0.0,1.0,34,1000,800,200,0.8,12,8,4,367.51496684423137,0.7491458704694,0.08320046991692531,0.22402434065896198,132839.80320069208,2964.12317377932,135803.9263744714,3870,6,673.8235294117648,33,1,17,32.807794420668884,0.6553030303030303,42.279411764705884,1030.8823529411768,31.23885918003566,0
3885,4,0,0,34,0.0,0.0,1.0,34,700,300,400,0.42857142857142855,11,3,8,371.2160348499545,0.7478461081402258,0.08588710522821463,0.2272382083877866,132997.7671598664,3074.180753796614,136071.94791366303,3871,7,674.8235294117648,33,1,18,32.553537483664016,0.6568813131313131,42.12622549019608,1031.4950980392157,31.257427213309565,0
3886,4,1,1,34,0.02857142857142857,0.02857142857142857,0.9714285714285714,35,850,700,150,0.8235294117647058,10,7,3,363.7263033512356,0.7563025210084033,0.08148489739451192,0.22439274219549205,133287.76218820867,2696.053004535147,135983.81519274382,3872,0,656.5142857142857,34,1,19,32.45547037122434,0.6574754901960784,41.845238095238095,1032.619047619048,30.37114845938376,0
3887,4,0,0,34,0.0,0.0,1.0,34,500,400,100,0.8,6,4,2,373.031561614956,0.747140522875817,0.08999539022448255,0.22931911035920877,133155.82498317954,3134.2650663206527,136290.0900495002,3873,9,676.8235294117648,33,1,19,32.34781920367292,0.6584595959595959,41.97303921568628,1032.107843137255,31.275995246583484,0
3888,4,0,0,34,0.0,0.0,1.0,34,650,500,150,0.7692307692307693,8,5,3,374.6185618981092,0.7447638146167559,0.0910271085178258,0.2314725249030255,133345.61827181865,3190.7487504805986,136536.36702229924,3874,10,677.8235294117648,33,1,19,32.11616041765544,0.6603535353535352,41.78921568627452,1032.843137254903,31.298276886512213,0
3889,4,1,1,34,0.02857142857142857,0.02857142857142857,0.9714285714285714,35,950,700,250,0.7368421052631579,12,7,5,366.61188020956064,0.7522408963585434,0.09027058146229128,0.2282454609046618,133626.0363520408,2797.77848639455,136423.81483843536,3875,0,659.4285714285714,34,1,19,32.041594703511805,0.6608455882352942,41.51785714285714,1033.928571428571,30.409663865546207,0
3890,4,0,0,34,0.0,0.0,1.0,34,900,600,300,0.6666666666666666,12,6,6,374.17484167958276,0.7404188948306596,0.08922556574497054,0.23258399333583493,133567.2146079633,3195.4982759035056,136762.71288386683,3876,12,679.8235294117648,33,1,19,31.905132384904185,0.6625631313131313,41.57475490196079,1033.700980392157,31.324272133095665,0
3891,4,1,0,35,0.02857142857142857,0.0,1.0,35,1100,800,300,0.7272727272727273,14,8,6,366.6025016668583,0.7504901960784314,0.08076348166034264,0.23053810245818257,133995.55165816325,2824.6208900226743,136820.17254818592,3877,0,661.3714285714286,34,1,18,31.671601318462294,0.6645220588235294,41.160714285714285,1035.3571428571427,30.451680672268903,0
3892,4,0,0,35,0.0,0.0,1.0,35,1000,600,400,0.6,14,6,8,365.25300568106786,0.7502100840336134,0.076781609195403,0.2302681992337165,134088.01020408154,2795.2097505668908,136883.21995464843,3878,1,662.3714285714286,34,1,18,31.613984674329508,0.6654411764705883,41.07142857142857,1035.7142857142849,30.462184873949553,0
3893,4,0,0,35,0.0,0.0,1.0,35,1150,900,250,0.782608695652174,14,9,5,366.2339048814609,0.750140056022409,0.07545955882352962,0.2316642375064125,134211.33786848077,2830.5484693877643,137041.88633786852,3879,2,663.3714285714286,34,1,18,31.465178844975497,0.6666666666666666,40.952380952380956,1036.1904761904766,30.47619047619049,0
3894,4,0,0,35,0.0,0.0,1.0,35,1000,700,300,0.7,13,7,6,362.8607024327704,0.7489495798319327,0.07850252641249433,0.23030546623794218,134334.7222222224,2748.9583333333535,137083.68055555574,3880,3,664.3714285714286,34,1,18,31.429193461950696,0.667892156862745,40.83333333333334,1036.666666666668,30.490196078431413,0
3895,4,0,0,35,0.0,0.0,1.0,35,700,300,400,0.42857142857142855,11,3,8,363.05709815314486,0.7484593837535013,0.07761194029850804,0.2308195127674376,134396.4356575965,2758.7159863945776,137155.1516439911,3881,4,665.3714285714286,34,1,18,31.36241867585153,0.6685049019607842,40.77380952380953,1036.9047619047628,30.49719887955185,0
3896,4,0,0,35,0.0,0.0,1.0,35,600,300,300,0.5,9,3,6,362.8925324705436,0.7494397759103641,0.07052341597796152,0.23110524436282023,134458.1632653063,2758.7726757369796,137216.93594104328,3882,5,666.3714285714286,34,1,19,31.305000765228034,0.6691176470588235,40.71428571428572,1037.1428571428585,30.50420168067231,0
3897,4,1,0,36,0.027777777777777776,0.0,1.0,36,900,700,200,0.7777777777777778,11,7,4,369.57596371882084,0.7575066137566138,0.05092592592592604,0.22301997810618507,132461.07266436,2614.8830242881636,135075.95568864816,3883,0,648.8333333333334,33,3,16,33.1359126984127,0.6515151515151514,42.64705882352942,1029.4117647058833,31.194295900178282,8
3898,4,0,0,36,0.0,0.0,1.0,36,500,300,200,0.6,7,3,4,368.55750942862915,0.7578042328042328,0.05159108042693328,0.22259177834003702,132492.61289227716,2566.2294850538406,135058.842377331,3884,1,649.8333333333334,33,3,16,33.13035650517796,0.651830808080808,42.61642156862746,1029.5343137254913,31.19800950683307,0
3899,4,0,0,36,0.0,0.0,1.0,36,1100,800,300,0.7272727272727273,14,8,6,367.9893664043066,0.7556216931216931,0.045934959349593685,0.22299571915127606,132618.8113496012,2560.4624723664074,135179.2738219676,3885,2,650.8333333333334,33,3,16,33.01792088042831,0.6530934343434343,42.49387254901961,1030.0245098039222,31.212863933452187,0
3900,4,2,0,38,0.05263157894736842,0.0,1.0,38,750,400,350,0.5333333333333333,11,4,7,352.7325215051052,0.7700035561877667,0.0648823886866583,0.21746557182771584,133263.00643272058,1801.2392564729334,135064.2456891935,3886,0,617.5263157894736,35,3,17,32.76410062399581,0.6550595238095236,41.869212962962976,1032.52314814815,29.50066137566143,0
3901,4,0,1,37,0.0,0.02631578947368421,0.9736842105263158,38,1150,900,250,0.782608695652174,14,9,5,350.6125426233443,0.7693219535324799,0.056706015543002586,0.21702965017031697,133412.4295374657,1755.214227537724,135167.64376500342,3887,1,618.5263157894736,35,3,17,32.66907536037044,0.6565476190476189,41.72453703703704,1033.101851851852,29.51719576719577,0
3902,4,0,0,37,0.0,0.0,1.0,37,1000,700,300,0.7,13,7,6,359.0417363065332,0.7596346346346347,0.07068894620761856,0.221869380640704,133349.23469387766,2175.58815192745,135524.82284580512,3888,2,635.972972972973,34,3,17,32.51474373751344,0.6580882352941175,41.78571428571429,1032.8571428571436,30.37815126050422,0
3903,4,1,1,37,0.02631578947368421,0.02631578947368421,0.9736842105263158,38,1400,1100,300,0.7857142857142857,17,11,6,351.2093157830195,0.7658546704599336,0.0751543137162507,0.2191624613014708,133711.52692043898,1792.1467764060317,135503.673696845,3889,0,620.2105263157895,35,3,17,32.354148015517744,0.6595238095238095,41.43518518518518,1034.2592592592594,29.550264550264554,0
3904,4,1,1,37,0.02631578947368421,0.02631578947368421,0.9736842105263158,38,800,600,200,0.75,10,6,4,351.8585160244262,0.7672771455666193,0.07282193846298846,0.21956757675937638,133711.52692043877,1809.5078875171278,135521.0348079559,3890,0,621.1842105263158,35,3,17,32.33736198149806,0.6595238095238096,41.435185185185176,1034.2592592592578,29.550264550264508,0
3905,4,0,0,37,0.0,0.0,1.0,37,1100,900,200,0.8181818181818182,13,9,4,345.94278306834,0.7575075075075075,0.046719965087312465,0.21276674064851403,133173.39275763015,1814.074824245529,134987.46758187568,3891,5,638.972972972973,35,2,18,33.02917320774465,0.6541666666666668,41.95601851851851,1032.1759259259247,29.490740740740705,2
3906,4,0,0,37,0.0,0.0,1.0,37,1400,1000,400,0.7142857142857143,18,10,8,325.56435724357806,0.7570695695695696,0.044839891347445704,0.19538139547062036,132253.17166828993,1211.3837655222796,133464.5554338122,3892,6,639.972972972973,36,1,19,34.477182322458205,0.6429398148148149,42.8490990990991,1028.6036036036037,28.572322322322325,5
3907,4,1,2,36,0.02631578947368421,0.05263157894736842,0.9473684210526316,38,1200,1100,100,0.9166666666666666,13,11,2,320.965684883783,0.7653212422949265,0.0394017517004841,0.19440742741371386,132600.90115453294,912.1470710575421,133513.0482255905,3893,0,624.1052631578947,36,2,19,34.24675632334717,0.6464120370370371,42.51126126126126,1029.9549549549552,28.609859859859867,0
3908,4,0,0,36,0.0,0.0,1.0,36,1000,700,300,0.7,13,7,6,339.24439481294024,0.7473544973544974,0.04999486013132337,0.2047066491240402,132459.270479025,1787.213010204084,134246.48348922908,3894,8,659.5,34,2,19,33.91831463706101,0.649203431372549,42.648809523809526,1029.4047619047624,30.276610644257715,0
3909,4,0,0,36,0.0,0.0,1.0,36,750,500,250,0.6666666666666666,10,5,5,338.04726444956754,0.7453703703703705,0.04742226332215971,0.20464988696663444,132581.84700963704,1763.7861394557676,134345.6331490928,3895,9,660.5,34,2,21,33.826050938234495,0.6504289215686274,42.5297619047619,1029.8809523809514,30.29061624649857,0
3910,4,0,1,35,0.0,0.027777777777777776,0.9722222222222222,36,700,400,300,0.5714285714285714,10,4,6,354.0017286225254,0.746362433862434,0.05370203386434258,0.20994006258950834,131803.09070644717,2131.704389574761,133934.79509602193,3896,10,661.5,35,1,17,34.199353772167136,0.6404761904761904,43.28703703703704,1026.8518518518517,29.338624338624335,2
3911,4,0,0,35,0.0,0.0,1.0,35,950,600,350,0.631578947368421,13,6,7,356.2713715605966,0.7366246498599439,0.05919668737060069,0.2111917924199413,131786.11288265308,2390.3238378684846,134176.43672052157,3897,11,681.1142857142858,34,1,18,34.15821256038646,0.6424632352941178,43.30357142857143,1026.7857142857144,30.199579831932777,0
3912,4,0,1,34,0.0,0.02857142857142857,0.9714285714285714,35,800,400,400,0.5,12,4,8,354.0356794591638,0.7369047619047618,0.05589774157228922,0.21037326738110665,131877.8061224491,2337.889739229041,134215.69586167816,3898,12,682.1142857142858,34,1,18,34.12315523103074,0.6433823529411764,43.21428571428572,1027.1428571428582,30.210084033613477,0
3913,4,0,0,34,0.0,0.0,1.0,34,750,400,350,0.5333333333333333,11,4,7,363.2506989531883,0.7380421865715984,0.04200176849551518,0.21594094742025705,131893.99059256056,2782.116854094571,134676.10744665514,3899,13,676.7352941176471,33,1,19,33.870198043426385,0.6458333333333334,43.1985294117647,1027.2058823529412,31.127450980392158,0
3914,4,1,2,33,0.02857142857142857,0.05714285714285714,0.9428571428571428,35,850,400,450,0.47058823529411764,13,4,9,355.8483981673219,0.749859943977591,0.041655231702680595,0.21368214097038374,132275.51197562335,2414.005810657574,134689.51778628092,3900,0,658.3714285714286,34,1,20,33.67593449832195,0.6473651960784315,42.82738095238094,1028.6904761904743,30.255602240896305,0
3915,4,0,0,33,0.0,0.0,1.0,33,850,600,250,0.7058823529411765,11,6,5,369.31785783912574,0.7339804292929294,0.043366606373238525,0.22077723924567988,132105.78799357207,3157.805325987143,135263.5933195592,3901,15,683.7272727272727,32,1,20,33.50067550970278,0.650390625,42.99242424242424,1028.030303030303,32.12594696969697,0
3916,4,0,0,33,0.0,0.0,1.0,33,1000,600,400,0.6,14,6,8,371.93755283096823,0.7342171717171718,0.0434899089123062,0.2227249581070151,132170.69686766656,3231.849109784725,135402.5459774513,3902,16,684.7272727272727,32,1,20,33.367867960052415,0.6510416666666666,42.929292929292934,1028.2828282828284,32.13383838383839,0
3917,4,0,0,33,0.0,0.0,1.0,33,550,400,150,0.7272727272727273,7,4,3,374.09362724790213,0.7343750000000001,0.0437363323961264,0.22478723265604017,132300.5624426078,3298.5594582185367,135599.12190082634,3903,17,685.7272727272727,32,1,20,33.18145557191948,0.65234375,42.8030303030303,1028.787878787878,32.14962121212119,0
3918,4,1,1,33,0.029411764705882353,0.029411764705882353,0.9705882352941176,34,900,600,300,0.6666666666666666,12,6,6,361.2375648788927,0.744726678550208,0.031920415224913734,0.21932280724789915,132690.54178145083,2786.5975091827318,135477.13929063355,3904,0,666.5294117647059,32,2,16,33.119638480392155,0.65625,42.42424242424242,1030.30303030303,32.19696969696969,0
3919,4,1,1,33,0.029411764705882353,0.029411764705882353,0.9705882352941176,34,1000,800,200,0.8,12,8,4,357.513573410926,0.7485888294711824,0.03395826728535645,0.21781647860647768,132820.6624324049,2697.0379298030844,135517.70036220798,3905,0,667.5,32,2,16,33.08478278621592,0.6575520833333334,42.2979797979798,1030.808080808081,32.21275252525253,0
3920,4,0,0,33,0.0,0.0,1.0,33,800,600,200,0.75,10,6,4,383.32975911207615,0.7361111111111112,0.056056123363815935,0.22338872168945098,131134.06795224964,3453.518135904482,134587.58608815412,3906,20,688.7272727272727,32,1,19,34.123828895463504,0.640625,43.93939393939393,1024.242424242423,32.00757575757572,4
3921,4,0,0,33,0.0,0.0,1.0,33,850,500,350,0.5882352941176471,12,5,7,400.66820421282614,0.7365056818181819,0.09167225549825386,0.23264796318472986,130994.67807345936,3903.1425258892377,134897.8205993486,3907,21,689.7272727272727,31,2,18,33.82144068515221,0.6418010752688171,44.07552083333334,1023.697916666668,33.02251344086026,2
3922,4,1,1,33,0.029411764705882353,0.029411764705882353,0.9705882352941176,34,750,600,150,0.8,9,6,3,389.8455998168654,0.7501114081996435,0.08510383820811152,0.22776076619970229,131231.07854109284,3431.9717056933096,134663.05024678615,3908,0,670.4117647058823,32,2,18,33.85859519408503,0.6416015625,43.844696969696976,1024.621212121213,32.019412878787904,0
3923,4,1,0,34,0.029411764705882353,0.0,1.0,34,700,500,200,0.7142857142857143,9,5,4,389.13617171006337,0.744503862150921,0.09749348015068127,0.22830821635012397,131392.84256708506,3425.941549331712,134818.78411641676,3909,0,671.3823529411765,32,2,20,33.71279761904762,0.6432291666666666,43.68686868686869,1025.2525252525259,32.03914141414143,0
3924,4,0,0,34,0.0,0.0,1.0,34,1100,800,300,0.7272727272727273,14,8,6,392.0864377316813,0.7446895424836601,0.09344924723551862,0.2306240502313141,131489.9488094327,3511.085125242321,135001.03393467504,3910,1,672.3823529411765,32,2,20,33.538768517378635,0.6442057291666667,43.592171717171716,1025.6313131313132,32.050978535353536,0
3925,4,1,1,34,0.02857142857142857,0.02857142857142857,0.9714285714285714,35,950,600,350,0.631578947368421,13,6,7,382.1841841972727,0.7502801120448179,0.08862973760932902,0.22663278693481573,131799.5951827421,3074.3441524894106,134873.93933523152,3911,0,654.1428571428571,33,2,18,33.479407845009334,0.6448863636363638,43.29044117647058,1026.8382352941169,31.116310160427783,0
3926,4,0,0,34,0.0,0.0,1.0,34,700,400,300,0.5714285714285714,10,4,6,390.63377931443404,0.7435011883541296,0.09507439786938443,0.23074646499038645,131651.8722579328,3485.533682787468,135137.40594072026,3912,3,674.3823529411765,32,2,18,33.4120222276903,0.6458333333333334,43.43434343434343,1026.2626262626256,32.07070707070705,0
3927,4,1,0,35,0.02857142857142857,0.0,1.0,35,750,500,250,0.6666666666666666,10,5,5,381.16155875125975,0.7546218487394958,0.09774884545253193,0.2267762489007672,131925.4632382977,3056.9830413783097,134982.44627967602,3913,0,656.0857142857143,33,2,19,33.37843950057656,0.6461489898989898,43.16789215686274,1027.3284313725485,31.131164587046925,0
3928,4,0,0,35,0.0,0.0,1.0,35,1150,800,350,0.6956521739130435,15,8,7,378.6667634133571,0.7543417366946779,0.1031528385767091,0.2260411490923718,132051.391366902,3000.694594627055,135052.08596152905,3914,1,657.0857142857143,33,2,19,33.315324311434374,0.6474116161616161,43.045343137254896,1027.8186274509794,31.14601901366604,0
3929,4,0,0,35,0.0,0.0,1.0,35,1150,900,250,0.782608695652174,14,9,5,380.55349961146226,0.7542016806722689,0.10141324706283017,0.22773494020971233,132145.8768862936,3057.7151816608844,135203.5920679545,3915,2,658.0857142857143,33,2,19,33.17143424711959,0.6483585858585859,42.95343137254901,1028.1862745098028,31.157159833630388,0
3930,4,0,0,35,0.0,0.0,1.0,35,800,500,300,0.625,11,5,6,379.68090723290896,0.7530812324929972,0.09971401334604435,0.22759158382132644,132208.8860053825,3039.4379565551685,135248.32396193765,3916,3,659.0857142857143,33,2,19,33.130262948840176,0.648989898989899,42.8921568627451,1028.4313725490192,31.164587046939975,0
3931,4,0,0,35,0.0,0.0,1.0,35,950,700,250,0.7368421052631579,12,7,5,380.05052890764773,0.7522408963585434,0.1012952971013259,0.2280031514740448,132240.39619677523,3051.606503508262,135292.00270028348,3917,4,660.0857142857143,33,2,19,33.08895806028834,0.6493055555555556,42.861519607843135,1028.5539215686272,31.168300653594763,0
3932,4,0,0,35,0.0,0.0,1.0,35,750,700,50,0.9333333333333333,8,7,1,380.05052890764773,0.7522408963585434,0.1012952971013259,0.2280031514740448,132240.39619677523,3051.606503508262,135292.00270028348,3918,5,661.0857142857143,33,2,19,33.08895806028834,0.6493055555555556,42.861519607843135,1028.5539215686272,31.168300653594763,0
3933,4,0,0,35,0.0,0.0,1.0,35,600,400,200,0.6666666666666666,8,4,4,379.7867856491931,0.7505602240896359,0.10071462601238723,0.2284161785322796,132334.9492983467,3051.8130046136025,135386.7623029603,3919,6,662.0857142857143,33,2,19,33.00033746228363,0.6502525252525253,42.76960784313725,1028.9215686274504,31.179441473559102,0
3934,4,0,0,35,0.0,0.0,1.0,35,900,600,300,0.6666666666666666,12,6,6,376.15659090944865,0.7503501400560224,0.10082832990322022,0.22680109167612755,132429.53619100817,2962.848573865809,135392.38476487398,3920,7,663.0857142857143,33,2,19,32.99834801762113,0.651199494949495,42.67769607843137,1029.2892156862738,31.19058229352345,0
3935,4,0,0,35,0.0,0.0,1.0,35,850,700,150,0.8235294117647058,10,7,3,380.7530785512293,0.7490896358543417,0.09966856462989715,0.23073032625977516,132618.81134960108,3099.004139033061,135717.81548863414,3921,8,664.0857142857143,33,2,19,32.689247471743,0.6530934343434345,42.493872549019606,1030.0245098039213,31.212863933452162,0
3936,4,0,0,35,0.0,0.0,1.0,35,550,200,350,0.36363636363636365,9,2,7,381.5487693995031,0.7484593837535013,0.09820387772094685,0.23160148045787857,132681.9331056563,3124.9256596020564,135806.85876525834,3922,9,665.0857142857143,33,2,15,32.60514551365925,0.6537247474747476,42.43259803921568,1030.2696078431359,31.220291146761692,0
3937,4,0,0,35,0.0,0.0,1.0,35,1050,700,350,0.6666666666666666,14,7,7,381.56436619199206,0.7471288515406161,0.10124312207051145,0.23258836582659687,132839.80320069197,3137.387062668194,135977.19026336016,3923,10,666.0857142857143,33,2,15,32.44571247424314,0.6553030303030304,42.27941176470588,1030.882352941176,31.238859180035632,0
3938,4,0,0,35,0.0,0.0,1.0,35,700,300,400,0.42857142857142855,11,3,8,376.4375093098206,0.7467787114845937,0.10335545409799884,0.2304345102444187,132997.76715986626,3013.0696426854893,136010.83680255176,3924,11,667.0857142857143,33,2,15,32.41888935091681,0.6568813131313131,42.12622549019607,1031.4950980392146,31.257427213309533,0
3939,4,0,0,35,0.0,0.0,1.0,35,600,400,200,0.6666666666666666,8,4,4,376.86177677311355,0.7457282913165265,0.1064278080309431,0.23147724450812449,133124.20590938567,3033.88495410417,136158.09086348984,3925,12,668.0857142857143,33,2,15,32.28078118196572,0.6581439393939394,42.003676470588225,1031.985294117646,31.272281639928664,0
3940,4,0,0,35,0.0,0.0,1.0,35,1200,800,400,0.6666666666666666,16,8,8,373.2186071903427,0.7462184873949579,0.10603815175922038,0.2300195146729066,133250.70473195385,2946.3284854382678,136197.03321739213,3926,13,669.0857142857143,33,2,15,32.24765084075173,0.6594065656565657,41.88112745098038,1032.4754901960769,31.287136066547784,0
3941,4,0,0,35,0.0,0.0,1.0,35,1050,800,250,0.7619047619047619,13,8,5,372.93551111591637,0.7461484593837534,0.10807364958800991,0.2300406015126433,133282.3388240098,2941.1434304113536,136223.48225442116,3927,14,670.0857142857143,33,2,16,32.22317825777354,0.6597222222222223,41.85049019607842,1032.5980392156848,31.29084967320257,0
3942,4,0,0,35,0.0,0.0,1.0,35,750,300,450,0.4,12,3,9,374.27052222094517,0.745658263305322,0.11149197307972702,0.23106063668541407,133313.97667063138,2979.0983335736123,136293.075004205,3928,15,671.0857142857143,33,2,16,32.15693109449785,0.6600378787878789,41.819852941176464,1032.7205882352932,31.29456327985737,0
3943,4,0,0,35,0.0,0.0,1.0,35,750,400,350,0.5333333333333333,11,4,7,374.27052222094517,0.745658263305322,0.11149197307972702,0.23106063668541407,133313.97667063138,2979.0983335736123,136293.075004205,3929,16,672.0857142857143,33,2,16,32.15693109449785,0.6600378787878789,41.819852941176464,1032.7205882352932,31.29456327985737,0
3944,4,0,0,35,0.0,0.0,1.0,35,1150,900,250,0.782608695652174,14,9,5,373.30905306971914,0.7461484593837534,0.11129032258064542,0.23145161290322575,133472.22222222207,2965.277777777759,136437.49999999983,3930,17,673.0857142857143,33,2,17,32.0228494623656,0.6616161616161618,41.66666666666666,1033.3333333333321,31.313131313131276,0
3945,4,0,0,35,0.0,0.0,1.0,35,1250,900,350,0.72,16,9,7,369.430584707461,0.7465686274509803,0.1098974029052251,0.2302256479882979,133662.2407847942,2875.7839532871863,136538.02473808138,3931,18,674.0857142857143,33,2,17,31.932428695583468,0.663510101010101,41.482843137254896,1034.0686274509796,31.33541295305999,0
3946,4,0,0,35,0.0,0.0,1.0,35,950,700,250,0.7368421052631579,12,7,5,369.430584707461,0.7465686274509803,0.1098974029052251,0.2302256479882979,133662.2407847942,2875.7839532871863,136538.02473808138,3932,19,675.0857142857143,33,2,17,31.932428695583468,0.663510101010101,41.482843137254896,1034.0686274509796,31.33541295305999,0
3947,4,0,0,35,0.0,0.0,1.0,35,1050,800,250,0.7619047619047619,13,8,5,368.7090208640239,0.7457282913165265,0.10490405117270751,0.23056604104696965,133788.9949178201,2865.841863706266,136654.83678152636,3933,20,676.0857142857143,33,2,15,31.824014846402896,0.6647727272727273,41.36029411764706,1034.558823529412,31.35026737967915,0
3948,4,0,0,35,0.0,0.0,1.0,35,850,600,250,0.7058823529411765,11,6,5,367.1548795519892,0.7467787114845937,0.10597550247005483,0.22998930288850117,133852.39451172625,2828.9119569396353,136681.3064686659,3934,21,677.0857142857143,33,2,15,31.800686878256755,0.6654040404040404,41.299019607843135,1034.8039215686274,31.357694592988707,0
3949,4,0,0,35,0.0,0.0,1.0,35,1250,1100,150,0.88,14,11,3,362.132553874555,0.7478991596638654,0.09910893935038789,0.22782263199449862,134010.95920138896,2705.9461805555616,136716.90538194453,3935,22,678.0857142857143,33,2,15,31.771881287726348,0.6669823232323232,41.145833333333336,1035.4166666666672,31.376262626262644,0
3950,4,0,0,35,0.0,0.0,1.0,35,600,400,200,0.6666666666666666,8,4,4,360.6467560659639,0.7485994397759103,0.09884023668639053,0.22708383671813684,134042.6834030181,2668.4117887351067,136711.0951917532,3936,23,679.0857142857143,33,2,15,31.778599605522682,0.6672979797979798,41.115196078431374,1035.539215686275,31.37997623291742,0
3951,4,0,0,35,0.0,0.0,1.0,35,1000,700,300,0.7,13,7,6,359.5495825990798,0.7488095238095237,0.09267212976260875,0.22737410028984462,134201.3607296474,2650.4086469146614,136851.76937656206,3937,24,680.0857142857143,33,2,15,31.64830967869111,0.6688762626262625,40.962009803921575,1036.1519607843147,31.398544266191355,0
3952,4,0,0,35,0.0,0.0,1.0,35,900,600,300,0.6666666666666666,12,6,6,359.04285755891965,0.7479691876750699,0.09144749066707214,0.2274475989794594,134264.85794225777,2641.367653066124,136906.2255953239,3938,25,681.0857142857143,33,2,15,31.597961254976152,0.6695075757575758,40.900735294117645,1036.3970588235293,31.405971479500888,0
3953,4,0,0,35,0.0,0.0,1.0,35,1250,1000,250,0.8,15,10,5,357.8872066573891,0.7476190476190475,0.08857818304626797,0.2273067393634769,134360.13192041518,2617.154459823138,136977.2863802383,3939,26,682.0857142857143,33,2,15,31.532702915681632,0.6704545454545454,40.80882352941176,1036.7647058823527,31.417112299465234,0
3954,4,0,0,35,0.0,0.0,1.0,35,900,500,400,0.5555555555555556,13,5,8,355.66960523280875,0.7468487394957982,0.08827362663335259,0.226291443569927,134423.66667868133,2562.0824923106547,136985.74917099197,3940,27,683.0857142857143,33,2,15,31.52672733002443,0.6710858585858586,40.747549019607845,1037.009803921569,31.42453951277482,0
3955,4,0,0,35,0.0,0.0,1.0,35,900,600,300,0.6666666666666666,12,6,6,356.6295880085784,0.7467086834733893,0.0833414901696059,0.22749581480728084,134518.996975322,2594.69089412726,137113.68786944926,3941,28,684.0857142857143,33,2,17,31.406649931088793,0.6720328282828283,40.65563725490196,1037.3774509803923,31.43568033273916,0
3956,4,0,0,35,0.0,0.0,1.0,35,900,500,400,0.5555555555555556,13,5,8,354.22485938834285,0.7450280112044817,0.08112949749506604,0.2267521038669598,134646.1566014274,2539.0031778642947,137185.15977929172,3942,29,685.0857142857143,33,2,18,31.34212520171606,0.6732954545454545,40.53308823529412,1037.8676470588243,31.450534759358312,0
3957,4,0,0,35,0.0,0.0,1.0,35,700,400,300,0.5714285714285714,10,4,6,354.80848442102035,0.7441176470588234,0.08499241018721526,0.22732434667519252,134677.95589436768,2556.9762831603334,137234.932177528,3943,30,686.0857142857143,33,2,18,31.295257772530498,0.673611111111111,40.50245098039216,1037.9901960784323,31.4542483660131,0
3958,4,0,0,35,0.0,0.0,1.0,35,800,600,200,0.75,10,6,4,354.0932899583753,0.7441176470588234,0.08541410189385634,0.22706466761827412,134709.7589418735,2539.9643466455445,137249.72328851905,3944,31,687.0857142857143,33,2,18,31.28209479400308,0.6739267676767676,40.47181372549021,1038.1127450980407,31.4579619726679,0
3959,4,0,0,35,0.0,0.0,1.0,35,1200,900,300,0.75,15,9,6,355.32290878081443,0.7431372549019607,0.08824610198061533,0.22865312467102553,134837.00867755205,2582.1356269223566,137419.1443044744,3945,32,688.0857142857143,33,2,14,31.123279252704034,0.6751893939393938,40.34926470588236,1038.6029411764719,31.472816399287026,0
3960,4,0,0,35,0.0,0.0,1.0,35,1000,800,200,0.8,12,8,4,357.3590252829878,0.740126050420168,0.09061715498795375,0.23077282371473395,134964.3184862794,2646.1434604479186,137610.46194672733,3946,33,689.0857142857143,33,2,14,30.94348291858317,0.6764520202020201,40.22671568627452,1039.0931372549028,31.487670825906147,0
3961,4,0,0,35,0.0,0.0,1.0,35,1100,900,200,0.8181818181818182,13,9,4,361.3522034066231,0.7397759103641456,0.08569407484757652,0.23396865567137234,135059.84026576325,2760.8341743560277,137820.67444011927,3947,34,690.0857142857143,33,2,14,30.744517802405092,0.6773989898989898,40.13480392156863,1039.4607843137262,31.49881164587049,0
3962,4,0,0,35,0.0,0.0,1.0,35,1100,1000,100,0.9090909090909091,12,10,2,361.8226001606728,0.7389355742296918,0.08600383825460445,0.23510157618403268,135187.255202326,2782.760837178,137970.016039504,3948,35,691.0857142857143,33,2,16,30.60531070783251,0.6786616161616161,40.01225490196078,1039.9509803921565,31.51366607248959,0
3963,4,0,0,35,0.0,0.0,1.0,35,600,300,300,0.5,9,3,6,361.27377784963755,0.7392857142857142,0.086424615798953,0.2349525327670401,135219.11832288056,2770.224342800836,137989.34266568138,3949,36,692.0857142857143,33,2,16,30.587835316758962,0.6789772727272728,39.98161764705882,1040.0735294117642,31.51737967914437,0
3964,4,0,0,35,0.0,0.0,1.0,35,1000,800,200,0.8,12,8,4,361.4950589691191,0.7404761904761904,0.08150765606596,0.2357214324614302,135314.73021193774,2783.1212754709736,138097.8514874087,3950,37,693.0857142857143,33,2,16,30.486847271299574,0.6799242424242424,39.88970588235294,1040.4411764705883,31.528520499108737,0
3965,4,0,0,35,0.0,0.0,1.0,35,750,500,250,0.6666666666666666,10,5,5,362.6149989723907,0.7394957983193277,0.08479262672811072,0.23729212644618525,135442.2652945981,2822.679378123781,138264.94467272187,3951,38,694.0857142857143,33,2,17,30.330723648065298,0.6811868686868687,39.76715686274509,1040.9313725490185,31.543374925727836,0
3966,4,0,0,35,0.0,0.0,1.0,35,400,100,300,0.25,7,1,6,366.6668016145161,0.7394957983193277,0.04966944524288586,0.23067519038280318,134010.95920138893,2827.473958333339,136838.43315972228,3952,39,695.0857142857143,33,2,17,31.654510395707582,0.6669823232323232,41.145833333333336,1035.416666666667,31.376262626262637,5
3967,4,0,0,35,0.0,0.0,1.0,35,850,600,250,0.7058823529411765,11,6,5,367.4465179790621,0.7391456582633052,0.04871682163989832,0.2313653559555199,134042.6834030181,2850.7034554017723,136893.38685841986,3953,40,696.0857142857143,33,2,17,31.602564102564102,0.6672979797979798,41.115196078431374,1035.539215686275,31.37997623291742,0
3968,4,0,0,35,0.0,0.0,1.0,35,1200,900,300,0.75,15,9,6,368.6778864872559,0.7389355742296918,0.04553318015948116,0.2333488179742691,134233.10745866972,2897.7556708958073,137130.86312956552,3954,41,697.0857142857143,33,2,17,31.38008514664144,0.6691919191919191,40.931372549019606,1036.2745098039213,31.4022578728461,0
3969,4,0,0,35,0.0,0.0,1.0,35,950,700,250,0.7368421052631579,12,7,5,368.79374647493864,0.7387955182072828,0.045238658244096897,0.23382739937668906,134296.61218041147,2905.5501489811704,137202.16232939262,3955,42,698.0857142857143,33,2,17,31.313549302435565,0.6698232323232323,40.87009803921569,1036.519607843138,31.409685086155694,0
3970,4,0,0,35,0.0,0.0,1.0,35,950,800,150,0.8421052631578947,11,8,3,372.78227057708057,0.7387955182072828,0.04970118513016164,0.23717921606189907,134423.66667868133,3022.1519367550986,137445.81861543644,3956,43,699.0857142857143,33,2,18,31.083077286693456,0.6710858585858586,40.747549019607845,1037.009803921569,31.42453951277482,0
3971,4,0,2,33,0.0,0.05714285714285714,0.9428571428571428,35,750,700,50,0.9333333333333333,8,7,1,372.78535145912275,0.7387254901960784,0.05334143582991513,0.23738769220455672,134455.43968966271,3024.603668060366,137480.04335772307,3957,44,700.0857142857143,33,2,18,31.051218047185785,0.6714015151515151,40.716911764705884,1037.132352941177,31.428253119429606,0
3972,4,0,0,33,0.0,0.0,1.0,33,750,500,250,0.6666666666666666,10,5,5,387.07597764274277,0.733191287878788,0.05996625803085487,0.24463570723616385,134179.53703138555,3787.535095214825,137967.07212660037,3958,45,726.3030303030303,31,2,18,30.957149888986624,0.67372311827957,40.98307291666666,1036.0677083333326,33.4215389784946,0
3973,4,0,0,33,0.0,0.0,1.0,33,850,500,350,0.5882352941176471,12,5,7,387.2312936378411,0.7324810606060607,0.059174481338069906,0.24518487399073777,134246.99783325172,3796.927727593287,138043.925560845,3959,46,727.3030303030303,31,2,18,30.885501738074296,0.6743951612903227,40.917968749999986,1036.3281249999982,33.429939516128975,0
3974,4,0,0,33,0.0,0.0,1.0,33,500,200,300,0.4,8,2,6,387.1316380899471,0.7317708333333334,0.06036241815136245,0.24534775789776886,134280.73459201382,3796.8641493055366,138077.59874131935,3960,47,728.3030303030303,31,2,18,30.85427135678391,0.674731182795699,40.88541666666666,1036.4583333333326,33.43413978494621,0
3975,4,0,0,33,0.0,0.0,1.0,33,500,300,200,0.6,7,3,4,387.92093299808994,0.7314551767676768,0.0636500616410216,0.24675737303488704,134415.7240125867,3828.5346137152683,138244.25862630198,3961,48,729.3030303030303,31,2,18,30.698560187510473,0.6760752688172043,40.75520833333333,1036.9791666666658,33.45094086021503,0
3976,4,0,0,33,0.0,0.0,1.0,33,1050,700,350,0.6666666666666666,14,7,7,388.89798338898123,0.7310606060606061,0.06383189159990565,0.24783690685412998,134483.24415418835,3860.0524902343705,138343.29664442272,3962,49,730.3030303030303,31,2,18,30.605594610427644,0.676747311827957,40.690104166666664,1037.2395833333333,33.45934139784946,0
3977,4,0,0,33,0.0,0.0,1.0,33,700,600,100,0.8571428571428571,8,6,2,390.4775729423718,0.7312973484848485,0.06425702811244927,0.24930491195551435,134550.78125000003,3907.82945421007,138458.6107042101,3963,50,731.3030303030303,30,3,18,30.496987951807228,0.6802083333333333,40.625,1037.5000000000002,34.58333333333334,0
3978,4,0,0,33,0.0,0.0,1.0,33,850,600,250,0.7058823529411765,11,6,5,388.64427753316625,0.7324021464646465,0.059397392730726306,0.24884835083840057,134655.38826742978,3866.60921782865,138521.99748525844,3964,51,732.3030303030303,30,3,19,30.439814814814802,0.68125,40.524193548387096,1037.9032258064517,34.59677419354839,0
3979,4,0,0,33,0.0,0.0,1.0,33,700,400,300,0.5714285714285714,10,4,6,405.4385074954402,0.7325599747474748,0.021414650922847445,0.2500099039221493,133270.47559950082,4206.596544053816,137477.07214355463,3965,52,733.3030303030303,31,2,19,31.396069777217317,0.6646505376344086,41.861979166666664,1032.552083333333,33.3081317204301,6
3980,4,0,0,33,0.0,0.0,1.0,33,950,500,450,0.5263157894736842,14,5,9,403.54867101578753,0.7324810606060607,0.02405293479423576,0.24929502013218274,133337.70751953125,4161.650933159723,137499.35845269097,3966,53,734.3030303030303,31,2,19,31.377122205412682,0.6653225806451613,41.796875,1032.8125,33.31653225806452,0
3981,4,0,0,33,0.0,0.0,1.0,33,750,300,450,0.4,12,3,9,402.5754422476589,0.7325599747474748,0.030791788856304958,0.24959677419354837,133472.22222222216,4146.527777777774,137618.74999999994,3967,54,735.3030303030303,31,2,19,31.266801075268823,0.6666666666666667,41.666666666666664,1033.333333333333,33.33333333333332,0
3982,4,0,0,33,0.0,0.0,1.0,33,650,500,150,0.7692307692307693,8,5,3,400.56405903626626,0.7323232323232324,0.024630278598532396,0.2488010563873147,133539.5050048828,4098.225233289932,137637.73023817275,3968,55,736.3030303030303,31,2,20,31.25104980263711,0.6673387096774194,41.6015625,1033.59375,33.341733870967744,0
3983,4,0,0,33,0.0,0.0,1.0,33,450,300,150,0.6666666666666666,6,3,3,402.3053602080899,0.7330334595959597,0.024359987327615462,0.25010980851151354,133573.15275404195,4147.439066569022,137720.59182061098,3969,56,737.3030303030303,31,2,20,31.172193181341054,0.6676747311827957,41.56901041666667,1033.723958333334,33.345934139784966,0
3984,4,0,1,32,0.0,0.030303030303030304,0.9696969696969697,33,1050,800,250,0.7619047619047619,13,8,5,400.55753075417783,0.7316130050505051,0.021133129557761032,0.2494766550367786,133640.4609680176,4106.138610839846,137746.59957885745,3970,57,738.3030303030303,31,2,20,31.149650547789953,0.6683467741935484,41.50390625,1033.9843750000002,33.35433467741936,0
3985,4,0,0,32,0.0,0.0,1.0,32,850,700,150,0.8235294117647058,10,7,3,407.9220325622463,0.7285366263440861,0.022265726540161124,0.25433971787146853,133680.636851081,4506.255419701693,138186.8922707827,3971,58,744.75,30,2,20,30.91884368772203,0.6715277777777778,41.46505376344086,1034.1397849462362,34.47132616487454,0
3986,4,0,0,32,0.0,0.0,1.0,32,950,500,450,0.5263157894736842,14,5,9,409.79421157744946,0.7265625000000001,0.018785728205794383,0.25622957323408835,133784.9051371545,4564.855944328816,138349.76108148333,3972,59,745.75,30,2,20,30.765503875969,0.6725694444444446,41.36424731182795,1034.5430107526877,34.48476702508959,0
3987,4,1,1,32,0.030303030303030304,0.030303030303030304,0.9696969696969697,33,900,600,300,0.6666666666666666,12,6,6,398.5294402320408,0.7354008838383839,0.015267698988629341,0.25141171269198115,134112.0931837293,4089.523484971779,138201.61666870108,3973,0,724.1212121212121,31,2,20,30.728184579928765,0.6730510752688172,41.04817708333333,1035.807291666666,33.413138440860195,0
3988,4,0,0,32,0.0,0.0,1.0,32,900,700,200,0.7777777777777778,11,7,4,407.40772636822834,0.7249243951612904,0.02441013241594181,0.25618462989505814,133993.56365258983,4518.002623135613,138511.56627572543,3974,61,747.75,30,2,20,30.617400147128823,0.6746527777777778,41.162634408602145,1035.3494623655909,34.51164874551969,0
3989,4,0,0,32,0.0,0.0,1.0,32,500,300,200,0.6,7,3,4,405.5562831386616,0.7234122983870969,0.024355126541206973,0.25550377445489675,134063.15262241298,4474.030776679384,138537.18339909235,3975,62,748.75,30,2,20,30.595392602206363,0.6753472222222222,41.09543010752688,1035.6182795698924,34.520609318996414,0
3990,4,0,0,32,0.0,0.0,1.0,32,650,400,250,0.6153846153846154,9,4,5,405.28730563614573,0.7228242607526882,0.018715948890906553,0.2563051549753113,134202.38475907609,4478.10458579025,138680.48934486634,3976,63,749.75,30,2,20,30.4625005404938,0.6767361111111112,40.96102150537634,1036.1559139784938,34.53853046594979,0
3991,4,0,0,32,0.0,0.0,1.0,32,950,700,250,0.7368421052631579,12,7,5,403.63375951178637,0.7242523521505377,0.021426371417455625,0.25574526866026165,134272.02792591625,4439.344685801822,138711.37261171808,3977,64,750.75,30,2,21,30.435416936843474,0.6774305555555555,40.89381720430107,1036.4247311827953,34.54749103942651,0
3992,4,1,0,33,0.030303030303030304,0.0,1.0,33,450,200,250,0.4444444444444444,7,2,5,388.67120948235834,0.7302714646464648,0.015058351110553092,0.24838178575500508,134584.55615573458,3861.828443739145,138446.38459947373,3978,0,728.969696969697,31,2,22,30.510023214957947,0.677755376344086,40.592447916666664,1037.6302083333333,33.47194220430107,0
3993,4,0,0,33,0.0,0.0,1.0,33,750,600,150,0.8,9,6,3,386.5329364036091,0.7300347222222223,0.013566024105547525,0.24724458291627308,134618.33530002163,3806.8840874565876,138425.21938747822,3979,1,729.969696969697,31,2,22,30.53168130489336,0.6780913978494624,40.55989583333333,1037.760416666666,33.47614247311826,0
3994,4,1,0,34,0.029411764705882353,0.0,1.0,34,1100,800,300,0.7272727272727273,14,8,6,374.05810174966683,0.7406417112299466,0.013451504538632308,0.24164035929354455,134976.85982297722,3297.837593102743,138274.69741607996,3980,0,709.4705882352941,32,2,19,30.49716484406642,0.6790364583333334,40.214646464646464,1039.1414141414139,32.47316919191918,0
3995,4,0,2,32,0.0,0.058823529411764705,0.9411764705882353,34,600,500,100,0.8333333333333334,7,5,2,374.1385841262768,0.7408273915626857,0.012824544226632595,0.24191160140953527,135009.66299676045,3302.464831394744,138312.1278281552,3981,1,710.4705882352941,32,2,19,30.46232738022921,0.6793619791666667,40.1830808080808,1039.2676767676762,32.47711489898988,0
3996,4,0,0,32,0.0,0.0,1.0,32,1000,500,500,0.5,15,5,10,389.6250658060411,0.7279905913978495,0.03449475660279644,0.24995548241576931,134725.1488611401,4098.458998150084,138823.60785929018,3982,2,753.65625,30,2,23,30.344542982910404,0.6819444444444445,40.45698924731183,1038.1720430107532,34.605734767025105,0
3997,4,0,0,32,0.0,0.0,1.0,32,850,400,450,0.47058823529411764,13,4,9,391.49671554345434,0.7272765456989247,0.029017568267115434,0.25188135895123,134829.82362484102,4157.086621285704,138986.91024612673,3983,3,754.65625,30,2,19,30.191212631034034,0.6829861111111111,40.35618279569893,1038.5752688172045,34.619175627240146,0
3998,4,0,0,32,0.0,0.0,1.0,32,700,400,300,0.5714285714285714,10,4,6,392.3674936125904,0.7270245295698925,0.02820950316987969,0.2529281366248301,134899.6293827322,4186.045894034008,139085.6752767662,3984,4,755.65625,30,2,19,30.098762237460654,0.6836805555555555,40.28897849462366,1038.8440860215062,34.628136200716874,0
3999,4,0,0,32,0.0,0.0,1.0,32,550,400,150,0.7272727272727273,7,4,3,392.466363476515,0.7246303763440861,0.02574527935851023,0.2537249098997002,135004.37189270445,4196.934978032156,139201.30687073662,3985,5,756.65625,30,2,19,29.9914317123642,0.6847222222222222,40.18817204301076,1039.2473118279577,34.64157706093192,0
4000,4,0,0,32,0.0,0.0,1.0,32,900,700,200,0.7777777777777778,11,7,4,393.8710374409952,0.7234543010752689,0.024688065683992733,0.2551255111866547,135074.22281477624,4240.364854318412,139314.58766909465,3986,6,757.65625,30,2,20,29.885085337470898,0.6854166666666666,40.12096774193548,1039.5161290322578,34.65053763440859,0
4001,4,0,0,32,0.0,0.0,1.0,32,800,500,300,0.625,11,5,6,393.8710374409952,0.7240003360215055,0.024688065683992733,0.2551255111866547,135074.22281477624,4240.364854318412,139314.58766909465,3987,7,758.65625,30,2,20,29.885085337470898,0.6854166666666666,40.12096774193548,1039.5161290322578,34.65053763440859,0
4002,4,0,0,32,0.0,0.0,1.0,32,650,500,150,0.7692307692307693,8,5,3,391.09072312068776,0.7240003360215055,0.0200714008787799,0.25430756432839363,135213.9788559372,4176.186553358782,139390.16540929597,3988,8,759.65625,30,2,20,29.81767467907296,0.6868055555555554,39.98655913978495,1040.053763440861,34.668458781362034,0
4003,4,0,0,32,0.0,0.0,1.0,32,750,500,250,0.6666666666666666,10,5,5,392.8260965086224,0.7232862903225807,0.019114939930241714,0.2561808604105516,135318.84330919766,4231.354600242813,139550.19790944047,3989,9,760.65625,30,2,20,29.667786246393664,0.6878472222222222,39.88575268817205,1040.4569892473123,34.681899641577075,0
4004,4,0,0,32,0.0,0.0,1.0,32,700,500,200,0.7142857142857143,9,5,4,396.70608757086245,0.7229922715053764,0.022662706611570105,0.25946722484364537,135423.7484102209,4344.685079199916,139768.4334894208,3990,10,761.65625,30,2,20,29.462056646005504,0.6888888888888889,39.78494623655914,1040.860215053764,34.69534050179213,0
4005,4,0,0,32,0.0,0.0,1.0,32,650,400,250,0.6153846153846154,9,4,5,398.08352167895265,0.723538306451613,0.026262911555842594,0.2606218829588745,135458.7258100646,4384.777322522818,139843.50313258744,3991,11,762.65625,30,2,20,29.391273940176458,0.6892361111111112,39.7513440860215,1040.9946236559128,34.69982078853043,0
4006,4,0,0,32,0.0,0.0,1.0,32,650,400,250,0.6153846153846154,9,4,5,398.5624902182351,0.7237903225806452,0.025957628759520013,0.2614448443455265,135528.69415900685,4403.330768007869,139932.02492701472,3992,12,763.65625,30,2,20,29.30892603588486,0.6899305555555555,39.68413978494624,1041.2634408602153,34.70878136200717,0
4007,4,0,0,32,0.0,0.0,1.0,32,1100,900,200,0.8181818181818182,13,9,4,401.23885620865536,0.7221102150537635,0.03165327784230221,0.2637150039661469,135598.68057362124,4481.491899352527,140080.17247297376,3993,13,764.65625,30,2,20,29.16935518561534,0.690625,39.61693548387097,1041.5322580645163,34.71774193548388,0
4008,4,0,1,31,0.0,0.03125,0.96875,32,500,400,100,0.8,6,4,2,413.09785633262504,0.7221102150537635,0.034565563645819974,0.2568420059057574,133576.40921277023,4636.025660480975,138212.43487325122,3994,14,765.65625,30,2,19,30.890001300221037,0.6704861111111111,41.56586021505376,1033.7365591397847,34.45788530465949,5
4009,4,0,0,31,0.0,0.0,1.0,31,1150,900,250,0.782608695652174,14,9,5,418.7377157435223,0.7172939068100358,0.030256556887005237,0.2611324146923173,133687.58680555562,4996.006944444451,138683.59375000006,3995,15,767.258064516129,29,2,20,30.632218640881,0.6745689655172413,41.458333333333336,1034.1666666666672,35.660919540229905,0
4010,4,0,0,31,0.0,0.0,1.0,31,600,400,200,0.6666666666666666,8,4,4,420.2511859060282,0.7170250896057347,0.033345317664181806,0.2623311468099071,133723.49778163584,5039.491705246922,138762.98948688275,3996,16,768.258064516129,29,2,16,30.556907703325727,0.6749281609195401,41.423611111111114,1034.3055555555559,35.66570881226055,0
4011,4,0,0,31,0.0,0.0,1.0,31,1150,900,250,0.782608695652174,14,9,5,421.15220035133564,0.714605734767025,0.0363715089846286,0.2636625119846597,133831.25964506168,5072.665895061725,138903.9255401234,3997,17,769.258064516129,29,2,16,30.425055928411638,0.6760057471264368,41.31944444444444,1034.722222222222,35.68007662835248,0
4012,4,0,0,31,0.0,0.0,1.0,31,650,400,250,0.6153846153846154,9,4,5,418.1993356768486,0.7156810035842294,0.033911214589265715,0.26283792985963134,133975.00964506165,5005.652006172828,138980.6616512345,3998,18,770.258064516129,29,2,17,30.356743582863785,0.6774425287356323,41.18055555555555,1035.2777777777771,35.69923371647507,0
4013,4,0,0,31,0.0,0.0,1.0,31,750,400,350,0.5333333333333333,11,4,7,417.14395411593523,0.7148745519713262,0.03514813789284266,0.2626879494838186,134046.91358024685,4983.3719135802385,139030.28549382708,3999,19,771.258064516129,29,2,17,30.31171763233191,0.67816091954023,41.11111111111111,1035.555555555555,35.70881226053638,0
4014,4,0,0,31,0.0,0.0,1.0,31,550,500,50,0.9090909090909091,6,5,1,417.14395411593523,0.7148745519713262,0.03514813789284266,0.2626879494838186,134046.91358024685,4983.3719135802385,139030.28549382708,4000,20,772.258064516129,29,2,17,30.31171763233191,0.67816091954023,41.11111111111111,1035.555555555555,35.70881226053638,0
4015,4,0,0,31,0.0,0.0,1.0,31,1150,1000,150,0.8695652173913043,13,10,3,417.9867434625052,0.7134408602150538,0.03716295123660229,0.263734782804007,134118.8368055555,5011.9791666666615,139130.81597222216,4001,21,773.258064516129,29,2,17,30.217551622418874,0.6788793103448276,41.041666666666664,1035.833333333333,35.71839080459769,0
4016,4,0,0,31,0.0,0.0,1.0,31,700,700,0,1.0,7,7,0,416.5199203616791,0.7125448028673835,0.036063305370579,0.2633253055845867,134190.7793209875,4978.626543209859,139169.40586419735,4002,22,774.258064516129,29,2,17,30.183199285075965,0.6795977011494253,40.972222222222214,1036.11111111111,35.72796934865897,0
4017,4,0,0,31,0.0,0.0,1.0,31,800,600,200,0.75,10,6,4,436.4299608628836,0.7125448028673835,0.04336387394446661,0.2530332322264822,130936.92370756168,5228.959297839503,136165.88300540118,4003,23,775.258064516129,29,2,16,32.96509589722712,0.64691091954023,44.13194444444444,1023.472222222222,35.29214559386972,7
4018,4,1,1,31,0.03125,0.03125,0.96875,32,700,400,300,0.5714285714285714,10,4,6,426.16188839793483,0.7297547043010754,0.03920186253934954,0.24916090775658392,131259.24962423395,4787.5379379118895,136046.78756214585,4004,0,752.0,30,2,16,32.89966990206365,0.6472222222222221,43.817204301075265,1024.7311827956985,34.15770609318995,0
4019,4,0,0,31,0.0,0.0,1.0,31,800,500,300,0.625,11,5,6,435.2082734846309,0.714336917562724,0.04920721705850184,0.253728143632344,131150.23389274688,5215.533371913572,136365.76726466045,4005,25,777.258064516129,29,2,16,32.77895480225988,0.649066091954023,43.92361111111111,1024.3055555555552,35.32088122605363,0
4020,4,1,0,32,0.03125,0.0,1.0,32,550,500,50,0.9090909090909091,6,5,1,426.2140375045735,0.7252184139784947,0.04430701179554397,0.25054030093681773,131465.92994854887,4806.524959532884,136272.45490808177,4006,0,753.9375,30,2,17,32.688128003494974,0.6493055555555556,43.61559139784946,1025.5376344086014,34.18458781362005,0
4021,4,1,1,32,0.030303030303030304,0.030303030303030304,0.9696969696969697,33,850,700,150,0.8235294117647058,10,7,3,414.03173845603175,0.7390309343434344,0.04044501813264523,0.24592487597448623,131862.52170138882,4319.05381944444,136181.57552083326,4007,0,732.060606060606,31,2,17,32.59803921568627,0.6505376344086022,43.229166666666664,1027.0833333333328,33.13172043010751,0
4022,4,0,0,32,0.0,0.0,1.0,32,950,600,350,0.631578947368421,13,6,7,423.459927055094,0.7276965725806452,0.06270989727380494,0.2408487809834705,130193.99144771083,4626.387624291841,134820.37907200266,4008,1,755.90625,30,2,18,34.0546665788665,0.6364583333333333,44.85887096774194,1020.5645161290331,34.0188172043011,5
4023,4,0,1,31,0.0,0.03125,0.96875,32,550,400,150,0.7272727272727273,7,4,3,423.5639505538137,0.7286626344086022,0.06177574400842767,0.24112028789397771,130228.28686842415,4632.001531969021,134860.28840039318,4009,2,756.90625,30,2,18,34.01698709507505,0.6368055555555555,44.825268817204304,1020.6989247311832,34.023297491039436,0
4024,4,0,0,31,0.0,0.0,1.0,31,500,300,200,0.6,7,3,4,435.27971085196396,0.7128136200716846,0.07509170743733495,0.24670184657621763,130056.85492903803,5122.222041565498,135179.07697060352,4010,30,782.258064516129,30,1,18,33.893354416479994,0.6350694444444445,44.99327956989247,1020.0268817204301,34.00089605734767,0
4025,4,1,1,31,0.03125,0.03125,0.96875,32,950,700,250,0.7368421052631579,12,7,5,422.5042233788083,0.7297547043010754,0.07023483303594191,0.24196847712628683,130462.0446099175,4624.152967664926,135086.19757758244,4011,0,758.78125,31,1,19,33.805442263573795,0.6364247311827957,44.596354166666664,1021.614583333333,32.95530913978494,0
4026,4,0,0,31,0.0,0.0,1.0,31,850,400,450,0.47058823529411764,13,4,9,435.23346803117397,0.7139784946236559,0.08625073757582746,0.2488592267546194,130399.83171826228,5150.874197884161,135550.70591614646,4012,32,784.258064516129,30,1,19,33.543887353599175,0.6385416666666666,44.657258064516135,1021.3709677419359,34.0456989247312,0
4027,4,2,2,31,0.06060606060606061,0.06060606060606061,0.9393939393939394,33,500,400,100,0.8,6,4,2,415.9072270324821,0.7468434343434344,0.06713562877946444,0.24054934051707394,130843.25140610669,4283.730773645566,135126.98217975226,4013,0,737.6666666666666,32,1,17,33.585554732815005,0.6376953125,44.22348484848486,1023.106060606062,31.972064393939437,0
4028,4,1,1,31,0.03125,0.03125,0.96875,32,600,500,100,0.8333333333333334,7,5,2,430.33320928436154,0.7334089381720431,0.07000413801884364,0.24815249821728205,130728.22570800803,4851.339382595515,135579.56509060354,4014,0,761.6875,31,1,17,33.333863848569735,0.6391129032258063,44.335937500000014,1022.6562500000017,32.98891129032263,0
4029,4,1,1,31,0.03125,0.03125,0.96875,32,300,100,200,0.3333333333333333,5,1,4,429.357767721222,0.7276125672043011,0.0777113034623218,0.24801725170720038,130794.8133680558,4831.553819444477,135626.36718750026,4015,0,762.65625,31,1,18,33.290902919212506,0.639784946236559,44.27083333333335,1022.9166666666686,32.99731182795705,0
4030,4,0,0,31,0.0,0.0,1.0,31,650,400,250,0.6153846153846154,9,4,5,427.51626507804025,0.725089605734767,0.08578983947248009,0.24728372414696376,130846.37674875713,4987.790857324556,135834.1676060817,4016,1,776.1612903225806,30,1,18,33.285437467157124,0.6430555555555555,44.22043010752689,1023.1182795698928,34.10394265232976,0
4031,4,2,1,32,0.06060606060606061,0.030303030303030304,0.9696969696969697,33,500,300,200,0.6,7,3,4,409.14799391896315,0.7481849747474748,0.07390983000739104,0.23964382500967876,131328.12500000023,4146.527777777807,135474.65277777804,4017,0,730.060606060606,32,1,19,33.265582655826556,0.6425781249999998,43.750000000000014,1025.0000000000018,32.03125000000006,0
4032,4,1,0,33,0.030303030303030304,0.0,1.0,33,200,100,100,0.5,3,1,2,411.0410189836832,0.7515782828282829,0.08704618557335664,0.24159396011309628,131461.62245008687,4207.223849826398,135668.84629991328,4018,0,731.030303030303,31,2,20,33.08151345860843,0.646505376344086,43.61979166666667,1025.520833333334,33.081317204301094,0
4033,4,0,0,33,0.0,0.0,1.0,33,950,700,250,0.7368421052631579,12,7,5,409.7915431987424,0.7497632575757577,0.08244885402245794,0.24170339523997697,131595.18771701402,4185.319010416685,135780.5067274307,4019,1,732.030303030303,31,2,19,32.97800338409477,0.6478494623655913,43.48958333333334,1026.0416666666679,33.09811827956993,0
4034,4,1,1,33,0.029411764705882353,0.029411764705882353,0.9705882352941176,34,600,300,300,0.5,9,3,6,399.0349892534871,0.7585041592394534,0.08086066284921078,0.23732080939812664,131911.15702479347,3727.4334251607083,135638.59044995418,4020,0,711.4705882352941,32,2,20,32.933874139626354,0.6484375,43.18181818181819,1027.272727272728,32.10227272727275,0
4035,4,2,2,33,0.05714285714285714,0.05714285714285714,0.9428571428571428,35,1000,800,200,0.8,12,8,4,390.51445791125207,0.7658263305322128,0.07303554405556278,0.23408552362794502,132208.88600538266,3325.8962898885165,135534.78229527117,4021,0,692.0,33,2,20,32.85172386399745,0.648989898989899,42.892156862745104,1028.4313725490206,31.164587046940017,0
4036,4,0,0,33,0.0,0.0,1.0,33,600,500,100,0.8333333333333334,7,5,2,409.42361416833637,0.7436868686868687,0.08949535927223584,0.24318776118673474,131862.52170138896,4197.526041666677,136060.04774305565,4022,2,734.939393939394,31,2,20,32.71636240703178,0.650537634408602,43.22916666666667,1027.083333333334,33.13172043010755,0
4037,4,0,0,33,0.0,0.0,1.0,33,850,700,150,0.8235294117647058,10,7,3,408.4032506533915,0.7421875000000001,0.08314321926489199,0.24300917403131672,131929.39758300784,4176.07896592882,136105.47654893665,4023,3,735.939393939394,31,2,20,32.67479932403887,0.6512096774193548,43.1640625,1027.3437500000002,33.14012096774194,0
4038,4,0,0,33,0.0,0.0,1.0,33,850,700,150,0.8235294117647058,10,7,3,406.6307231706014,0.7409248737373738,0.0855380102814538,0.2425953362045016,132029.74319458008,4137.469991048178,136167.21318562826,4024,4,736.939393939394,31,2,20,32.61869694666161,0.6522177419354838,43.06640625,1027.734375,33.15272177419355,0
4039,4,0,0,33,0.0,0.0,1.0,33,1000,700,300,0.7,13,7,6,404.5951137856559,0.7406092171717172,0.08322392918288535,0.24159408685506567,132063.20020887593,4086.4251030816076,136149.62531195753,4025,5,737.939393939394,31,2,20,32.63712946541677,0.6525537634408602,43.03385416666667,1027.864583333334,33.15692204301077,0
4040,4,0,0,33,0.0,0.0,1.0,33,1200,1000,200,0.8333333333333334,14,10,4,406.9693427996251,0.7401357323232324,0.07996899474675856,0.24365708112878254,132163.59668307842,4157.306416829436,136320.90309990785,4026,6,738.939393939394,31,2,20,32.474489257523956,0.6535618279569892,42.93619791666667,1028.255208333334,33.16952284946238,0
4041,4,0,0,33,0.0,0.0,1.0,33,750,500,250,0.6666666666666666,10,5,5,408.91651978849535,0.7413983585858587,0.07966244725738414,0.24547420260859532,132264.03130425353,4216.989474826398,136481.02077907993,4027,7,739.939393939394,31,2,20,32.32278481012658,0.6545698924731183,42.83854166666667,1028.645833333334,33.182123655914,0
4042,4,1,0,34,0.029411764705882353,0.0,1.0,34,750,600,150,0.8,9,6,3,397.1447500051995,0.7476232917409389,0.07291395506236409,0.24032271061906083,132565.56404961486,3729.611375596798,136295.17542521167,4028,0,719.1470588235294,31,3,21,32.32090550849244,0.6575940860215054,42.54557291666667,1029.817708333334,33.21992607526884,0
4043,4,0,0,34,0.0,0.0,1.0,34,700,600,100,0.8571428571428571,8,6,2,395.1073168418326,0.7475118835412954,0.07883391130689321,0.23967885487825383,132658.02158261917,3682.8309930109235,136340.8525756301,4029,1,720.1470588235294,32,2,17,32.28004861706908,0.6559244791666666,42.45580808080808,1030.1767676767681,32.193023989899004,0
4044,4,0,1,33,0.0,0.029411764705882353,0.9705882352941176,34,900,800,100,0.8888888888888888,10,8,2,396.726849703566,0.7464349376114082,0.08913594835288396,0.24170731350596358,132820.66243240488,3738.704596469752,136559.36702887464,4030,2,721.1470588235294,32,2,19,32.074248734280594,0.6575520833333334,42.2979797979798,1030.8080808080808,32.212752525252526,0
4045,4,0,0,33,0.0,0.0,1.0,33,700,300,400,0.42857142857142855,11,3,8,405.5837672435208,0.7396622474747475,0.08971412813677682,0.24608732871401362,132666.15125868065,4161.4474826389,136827.59874131955,4031,11,743.939393939394,31,2,19,32.00202224469161,0.6586021505376343,42.44791666666667,1030.2083333333342,33.23252688172046,0
4046,4,0,0,33,0.0,0.0,1.0,33,850,500,350,0.5882352941176471,12,5,7,404.0650794371564,0.7388731060606061,0.08485154808126749,0.24560453445972782,132733.2305908203,4126.572672526042,136859.80326334634,4032,12,744.939393939394,31,2,19,31.973401566843577,0.6592741935483871,42.3828125,1030.46875,33.24092741935484,0
4047,4,0,0,33,0.0,0.0,1.0,33,700,500,200,0.7142857142857143,9,5,4,404.13988108080804,0.7381628787878789,0.0888113065980678,0.24609009989505187,132800.32687717004,4133.98166232638,136934.30853949641,4033,13,745.939393939394,31,2,19,31.903739262253662,0.6599462365591398,42.31770833333333,1030.7291666666658,33.24932795698922,0
4048,4,1,1,33,0.029411764705882353,0.029411764705882353,0.9705882352941176,34,400,200,200,0.5,6,2,4,392.62211305430617,0.7497029114676174,0.07973320279035612,0.24066881363591416,133048.5270157382,3647.5587631364124,136696.0857788746,4034,0,724.9705882352941,32,2,19,31.95039366866561,0.6598307291666667,42.0770202020202,1031.6919191919192,32.240372474747474,0
4049,4,0,0,33,0.0,0.0,1.0,33,600,400,200,0.6666666666666666,8,4,4,402.865797766332,0.7372159090909092,0.08321660658109264,0.24575434412279024,132867.44011772997,4105.549452039927,136972.9895697699,4035,15,747.939393939394,31,2,19,31.868843142207623,0.6606182795698925,42.252604166666664,1030.989583333333,33.25772849462365,0
4050,4,0,0,33,0.0,0.0,1.0,33,500,300,200,0.6,7,3,4,403.5197516411952,0.7380050505050506,0.08482858640706925,0.24637416447545277,132901.00309583865,4125.635952419697,137026.63904825834,4036,16,748.939393939394,31,2,19,31.818122027192004,0.6609543010752689,42.22005208333333,1031.1197916666658,33.261928763440835,0
4051,4,0,1,32,0.0,0.030303030303030304,0.9696969696969697,33,450,400,50,0.8888888888888888,5,4,1,402.20385674931117,0.7385574494949495,0.08399142944597493,0.24579124579124584,132934.57031250003,4093.359375000001,137027.92968750003,4037,17,749.939393939394,31,2,19,31.81818181818181,0.6612903225806452,42.1875,1031.2500000000002,33.26612903225807,0
4052,4,0,0,32,0.0,0.0,1.0,32,550,300,250,0.5454545454545454,8,3,5,413.61521395612215,0.7271085349462366,0.0957876890975482,0.25171440163615433,132778.68106139437,4583.8565152040655,137362.53757659844,4038,18,773.78125,30,2,19,31.68144670492088,0.6625000000000001,42.33870967741935,1030.6451612903224,34.354838709677416,0
4053,4,0,0,32,0.0,0.0,1.0,32,900,700,200,0.7777777777777778,11,7,4,411.90554981391153,0.7258484543010754,0.0906058582040925,0.2518367556750711,132951.89698592311,4552.724845357834,137504.62183128094,4039,19,774.78125,30,2,19,31.55056692297668,0.6642361111111111,42.17069892473118,1031.3172043010745,34.37724014336915,0
4054,4,0,0,32,0.0,0.0,1.0,32,700,500,200,0.7142857142857143,9,5,4,414.1438526069222,0.723622311827957,0.09042795726941111,0.2539111990903142,133055.88073765746,4620.8550121401195,137676.73574979758,4040,20,775.78125,30,2,19,31.38787562966823,0.6652777777777779,42.06989247311827,1031.7204301075262,34.390681003584206,0
4055,4,0,0,32,0.0,0.0,1.0,32,750,500,250,0.6666666666666666,10,5,5,413.6314596752243,0.723580309139785,0.09332687801067596,0.25477973069489934,133229.27731890953,4621.5640897791445,137850.84140868866,4041,21,776.78125,30,2,19,31.226131580089408,0.667013888888889,41.9018817204301,1032.392473118278,34.41308243727594,0
4056,4,0,0,32,0.0,0.0,1.0,32,600,200,400,0.3333333333333333,10,2,8,413.6314596752243,0.723580309139785,0.09332687801067596,0.25477973069489934,133229.27731890953,4621.5640897791445,137850.84140868866,4042,22,777.78125,30,2,19,31.226131580089408,0.667013888888889,41.9018817204301,1032.392473118278,34.41308243727594,0
4057,4,0,0,32,0.0,0.0,1.0,32,750,700,50,0.9333333333333333,8,7,1,412.8950344637826,0.7234543010752689,0.09186271638682841,0.25480100801487865,133298.66756633704,4607.671587755799,137906.33915409283,4043,23,778.78125,30,2,19,31.175159442925942,0.6677083333333333,41.83467741935483,1032.6612903225798,34.42204301075266,0
4058,4,0,0,32,0.0,0.0,1.0,32,1100,900,200,0.8181818181818182,13,9,4,403.2644295894658,0.7239583333333334,0.05518304620203551,0.2440609841638613,132570.97099375635,4292.231399583735,136863.2023933401,4044,24,779.78125,30,2,19,32.15788958496475,0.6604166666666668,42.540322580645146,1029.838709677418,34.32795698924726,6
4059,4,0,0,32,0.0,0.0,1.0,32,700,400,300,0.5714285714285714,10,4,6,403.91304329325385,0.7224042338709677,0.05350212002609256,0.24513012484899369,132674.80570369406,4317.816908024046,136992.6226117181,4045,25,780.78125,30,2,18,32.03631224179169,0.6614583333333334,42.439516129032256,1030.241935483871,34.34139784946237,0
4060,4,0,0,32,0.0,0.0,1.0,32,600,500,100,0.8333333333333334,7,5,2,405.81622315296556,0.7224042338709677,0.04977093387244036,0.24674012552845245,132744.0514257428,4373.937919123589,137117.9893448664,4046,26,781.78125,30,2,18,31.917362288596138,0.6621527777777778,42.372311827956985,1030.5107526881716,34.35035842293905,0
4061,4,1,1,32,0.030303030303030304,0.030303030303030304,0.9696969696969697,33,600,500,100,0.8333333333333334,7,5,2,396.96111587726034,0.7285353535353536,0.038593229351971736,0.24280532809758912,132968.14176771374,3956.6363864474783,136924.7781541612,4047,0,759.060606060606,31,2,18,31.919501956823638,0.6616263440860215,42.154947916666664,1031.3802083333333,33.270329301075265,0
4062,4,0,1,31,0.0,0.03125,0.96875,32,950,700,250,0.7368421052631579,12,7,5,411.19925750778964,0.722572244623656,0.05036668839634961,0.25070733744711815,132847.9538819517,4525.395999537523,137373.3498814892,4048,28,783.78125,30,2,18,31.67372881355934,0.6631944444444444,42.27150537634409,1030.9139784946237,34.36379928315412,0
4063,4,0,0,31,0.0,0.0,1.0,31,850,600,250,0.7058823529411765,11,6,5,417.83342709158325,0.7129928315412186,0.06457696870667906,0.2548543573788679,132862.96537422837,4902.917631172838,137765.8830054012,4049,34,809.1612903225806,29,2,18,31.48757802326103,0.666307471264368,42.25694444444444,1030.9722222222222,35.5507662835249,0
4064,4,0,0,31,0.0,0.0,1.0,31,900,700,200,0.7777777777777778,11,7,4,418.96244008249124,0.7122759856630825,0.06213501112347086,0.2557875949977313,132898.76543209865,4935.918209876527,137834.68364197516,4050,35,810.1612903225806,29,2,18,31.42230154454023,0.6666666666666667,42.222222222222214,1031.1111111111102,35.55555555555552,0
4065,4,0,0,31,0.0,0.0,1.0,31,1000,800,200,0.8,12,8,4,420.9730148636351,0.7117383512544803,0.06836433761732463,0.2577548706836123,133006.19454089503,4998.403742283941,138004.59828317896,4051,36,811.1612903225806,29,2,18,31.261921592388138,0.6677442528735633,42.11805555555555,1031.5277777777774,35.5699233716475,0
4066,4,0,0,31,0.0,0.0,1.0,31,1150,800,350,0.6956521739130435,15,8,7,417.080580989838,0.7123655913978495,0.07188716840090104,0.2563544910947465,133149.50086805553,4906.814236111108,138056.31510416663,4052,37,812.1612903225806,29,2,18,31.21761875925177,0.6691810344827587,41.979166666666664,1032.0833333333333,35.58908045977011,0
4067,4,0,0,31,0.0,0.0,1.0,31,900,600,300,0.6666666666666666,12,6,6,414.4084966591502,0.7128136200716846,0.06612861234053646,0.2554964744250071,133263.97018441424,4845.144308590571,138109.1144930048,4053,38,813.1612903225806,30,1,18,31.171081749544403,0.6673611111111111,41.868279569892465,1032.526881720429,34.417562724014296,0
4068,4,0,0,31,0.0,0.0,1.0,31,600,400,200,0.6666666666666666,8,4,4,414.9522348269396,0.7129032258064516,0.06715252472670485,0.2563097244702734,133333.36946467785,4865.395927274808,138198.76539195265,4054,39,814.1612903225806,30,1,18,31.0870531841055,0.6680555555555556,41.80107526881719,1032.79569892473,34.426523297491,0
4069,4,0,0,31,0.0,0.0,1.0,31,850,500,350,0.5882352941176471,12,5,7,412.0298233046787,0.7123655913978495,0.06531302601299438,0.2549956800389484,133404.95639377163,4793.364122178809,138198.32051595044,4055,40,815.1612903225806,31,0,18,31.090349550457937,0.665994623655914,41.73177083333333,1033.072916666666,33.324932795698906,0
4070,4,0,0,31,0.0,0.0,1.0,31,950,700,250,0.7368421052631579,12,7,5,411.2098576612353,0.7120071684587813,0.06400390267699252,0.25471898677142096,133438.58718872073,4774.252488878039,138212.83967759876,4056,41,816.1612903225806,31,0,18,31.07763600084015,0.6663306451612903,41.69921875,1033.2031250000002,33.329133064516135,0
4071,4,1,1,31,0.03125,0.03125,0.96875,32,650,500,150,0.7692307692307693,8,5,3,401.03481530027904,0.7230762768817205,0.053693809276341264,0.2507526379663888,133784.9051371545,4330.489421433852,138115.39455858836,4057,0,791.625,30,2,18,30.992053180892995,0.6725694444444444,41.36424731182795,1034.5430107526877,34.48476702508959,0
4072,4,0,0,31,0.0,0.0,1.0,31,700,600,100,0.8571428571428571,8,6,2,408.89946578407324,0.714336917562724,0.06343429091381791,0.2547096024515689,133645.8897885594,4729.5465877558145,138375.43637631522,4058,43,818.1612903225806,30,1,18,30.928549763854583,0.6711805555555556,41.498655913978496,1034.0053763440862,34.466845878136205,0
4073,4,0,0,31,0.0,0.0,1.0,31,750,700,50,0.9333333333333333,8,7,1,406.6233320533274,0.7137992831541219,0.06446581752014557,0.25352997705172614,133680.63685108107,4671.533197479487,138352.17004856057,4059,44,819.1612903225806,30,1,18,30.952419634347127,0.6715277777777777,41.465053763440864,1034.139784946237,34.47132616487456,0
4074,4,0,0,31,0.0,0.0,1.0,31,950,600,350,0.631578947368421,13,6,7,406.8744128183928,0.7130824372759856,0.06210211770819818,0.2544039281448552,133784.90513715448,4686.730944328815,138471.6360814833,4060,45,820.1612903225806,30,1,18,30.841020310943666,0.6725694444444444,41.36424731182795,1034.5430107526875,34.48476702508958,0
4075,4,0,0,31,0.0,0.0,1.0,31,700,500,200,0.7142857142857143,9,5,4,406.7713589501851,0.714516129032258,0.06650214313547198,0.25481958442290253,133854.43990996052,4689.630484738092,138544.07039469862,4061,46,821.1612903225806,30,1,18,30.77374767285794,0.6732638888888889,41.297043010752674,1034.8118279569878,34.49372759856626,0
4076,4,0,0,31,0.0,0.0,1.0,31,450,300,150,0.6666666666666666,6,3,3,406.62519084897497,0.7156810035842294,0.06908193741072588,0.25520950242281637,133923.9927484391,4691.373822118158,138615.36657055726,4062,47,822.1612903225806,30,1,18,30.707592087607672,0.6739583333333334,41.229838709677416,1035.0806451612902,34.50268817204301,0
4077,4,0,0,31,0.0,0.0,1.0,31,450,400,50,0.8888888888888888,5,4,1,404.26795294278196,0.7147849462365592,0.06647623993767815,0.2539699652173985,133958.7759423054,4631.048025783312,138589.82396808872,4063,48,823.1612903225806,30,1,18,30.73362979312733,0.6743055555555557,41.19623655913978,1035.2150537634402,34.507168458781344,0
4078,4,0,0,31,0.0,0.0,1.0,31,750,500,250,0.6666666666666666,10,5,5,404.26795294278196,0.7147849462365592,0.06647623993767815,0.2539699652173985,133958.7759423054,4631.048025783312,138589.82396808872,4064,49,824.1612903225806,30,1,18,30.73362979312733,0.6743055555555557,41.19623655913978,1035.2150537634402,34.507168458781344,0
4079,4,0,0,31,0.0,0.0,1.0,31,650,500,150,0.7692307692307693,8,5,3,404.16855751603526,0.714605734767025,0.06620797092042041,0.25414778763640977,133993.56365258986,4631.197067580057,138624.76072016993,4065,50,825.1612903225806,30,1,18,30.70124194036954,0.6746527777777779,41.162634408602145,1035.349462365591,34.5116487455197,0
4080,4,0,0,31,0.0,0.0,1.0,31,750,500,250,0.6666666666666666,10,5,5,402.1815959533038,0.714336917562724,0.06282068442421851,0.2532502163591942,134044.66629028306,4582.059563530804,138626.72585381387,4066,51,826.1612903225806,31,0,18,30.701333878201105,0.6723790322580645,41.11328124999999,1035.5468749999989,33.40473790322577,0
4081,4,0,0,31,0.0,0.0,1.0,31,800,600,200,0.75,10,6,4,403.3218397516151,0.7130824372759856,0.05890462057444967,0.25466893310030564,134145.81298828128,4620.787217881947,138766.60020616322,4067,52,827.1612903225806,31,0,18,30.570219540807766,0.6733870967741936,41.015625,1035.9375000000002,33.41733870967742,0
4082,4,0,0,31,0.0,0.0,1.0,31,850,600,250,0.7058823529411765,11,6,5,405.11761259958405,0.7113799283154122,0.048494475082154764,0.2569833716259194,134314.47558932827,4682.63193766275,138997.10752699102,4068,53,828.1612903225806,31,0,19,30.354357702131225,0.6750672043010754,40.85286458333333,1036.588541666666,33.43834005376342,0
4083,4,0,0,31,0.0,0.0,1.0,31,850,400,450,0.47058823529411764,13,4,9,403.0542969080523,0.7102150537634409,0.04589542261224677,0.2559105511947299,134348.22082519534,4629.925537109375,138978.14636230472,4069,54,829.1612903225806,31,0,19,30.373963828183882,0.6754032258064517,40.8203125,1036.7187500000002,33.442540322580655,0
4084,4,0,0,31,0.0,0.0,1.0,31,550,400,150,0.7272727272727273,7,4,3,403.0542969080523,0.7102150537634409,0.04589542261224677,0.2559105511947299,134348.22082519534,4629.925537109375,138978.14636230472,4070,55,830.1612903225806,31,0,19,30.373963828183882,0.6754032258064517,40.8203125,1036.7187500000002,33.442540322580655,0
4085,4,0,0,31,0.0,0.0,1.0,31,850,500,350,0.5882352941176471,12,5,7,403.91007582214866,0.7089605734767025,0.049506915335236545,0.2571657676997134,134449.48196411136,4661.100090874567,139110.58205498592,4071,56,831.1612903225806,31,0,19,30.25018309269721,0.6764112903225807,40.72265625,1037.1093750000002,33.45514112903226,0
4086,4,0,0,31,0.0,0.0,1.0,31,400,300,100,0.75,5,3,2,403.2447514883043,0.7097670250896058,0.051308421431955464,0.2572178490878557,134517.01058281783,4648.655700683583,139165.66628350143,4072,57,832.1612903225806,31,0,19,30.19970398728087,0.6770833333333335,40.65755208333333,1037.3697916666658,33.46354166666664,0
4087,4,0,0,31,0.0,0.0,1.0,31,800,500,300,0.625,11,5,6,404.76052001563545,0.7089605734767025,0.05931105931105907,0.2591675568458321,134655.38826742975,4700.641234158944,139356.0295015887,4073,58,833.1612903225806,30,1,19,30.021637313303977,0.68125,40.524193548387096,1037.9032258064515,34.596774193548384,0
4088,4,0,0,31,0.0,0.0,1.0,31,1050,800,250,0.7619047619047619,13,8,5,402.4812652601738,0.7082437275985664,0.05021516161387396,0.25888633642864073,134821.09917534716,4652.593315972212,139473.69249131938,4074,59,834.1612903225806,31,0,17,29.914744232698084,0.6801075268817205,40.36458333333333,1038.541666666666,33.50134408602148,0
4089,4,0,0,31,0.0,0.0,1.0,31,350,200,150,0.5714285714285714,5,2,3,383.83471907281444,0.7082437275985664,0.03670250896057348,0.22540629475752513,131428.2417297362,3889.344448513441,135317.58617824965,4075,60,835.1612903225806,31,0,22,33.81283068783068,0.6461693548387097,43.65234374999999,1025.390624999999,33.07711693548384,7
4090,4,0,0,31,0.0,0.0,1.0,31,950,800,150,0.8421052631578947,11,8,3,382.2232946828576,0.7077956989247312,0.034854105757970544,0.22504896229533256,131528.3966064452,3854.6434190538057,135383.040025499,4076,61,836.1612903225806,31,0,22,33.752750275027495,0.6471774193548387,43.55468749999999,1025.781249999999,33.08971774193545,0
4091,4,0,0,31,0.0,0.0,1.0,31,1000,800,200,0.8,12,8,4,383.3149311371041,0.706810035842294,0.0361598205110365,0.2258891804359942,131561.79004245327,3885.9196980794222,135447.70974053268,4077,62,837.1612903225806,31,0,19,33.69095591657148,0.6475134408602151,43.522135416666664,1025.9114583333328,33.093918010752674,0
4092,4,0,0,31,0.0,0.0,1.0,31,600,300,300,0.5,9,3,6,383.3149311371041,0.706810035842294,0.0361598205110365,0.2258891804359942,131561.79004245327,3885.9196980794222,135447.70974053268,4078,63,838.1612903225806,31,0,19,33.69095591657148,0.6475134408602151,43.522135416666664,1025.9114583333328,33.093918010752674,0
4093,4,1,1,31,0.03125,0.03125,0.96875,32,1150,900,250,0.782608695652174,14,9,5,374.94372204754654,0.7154317876344086,0.029790258143822967,0.22280256967544124,131878.73247946633,3489.420562952752,135368.1530424191,4079,0,812.9375,32,0,19,33.58533087482073,0.6481119791666667,43.213383838383834,1027.1464646464642,32.09832702020201,0
4094,4,0,0,31,0.0,0.0,1.0,31,700,500,200,0.7142857142857143,9,5,4,385.72468926019064,0.7046594982078853,0.04449388209121241,0.22911117084972754,131862.52170138882,3972.5260416666624,135835.04774305547,4080,65,840.1612903225806,31,0,20,33.32488167680865,0.6505376344086022,43.229166666666664,1027.0833333333328,33.13172043010751,0
4095,4,0,0,31,0.0,0.0,1.0,31,700,600,100,0.8571428571428571,8,6,2,386.69024820046235,0.7039426523297491,0.048145876773375784,0.23008944632742442,131929.3975830078,4003.1622992621533,135932.55988226997,4081,66,841.1612903225806,31,0,20,33.232467258132665,0.6512096774193548,43.1640625,1027.34375,33.140120967741936,0
4096,4,0,0,31,0.0,0.0,1.0,31,700,500,200,0.7142857142857143,9,5,4,388.31497017832726,0.7045698924731183,0.031725482805804006,0.2278384556769113,131394.86524793843,4004.518636067714,135399.38388400615,4082,67,842.1612903225806,31,0,20,33.73179663025992,0.6458333333333333,43.684895833333336,1025.2604166666672,33.072916666666686,7
4097,4,0,0,31,0.0,0.0,1.0,31,950,700,250,0.7368421052631579,12,7,5,387.72188798614667,0.703853046594982,0.02620942146797356,0.22808702850387458,131495.0074089899,3996.698506673195,135491.7059156631,4083,68,843.1612903225806,31,0,20,33.64555562608439,0.6468413978494623,43.58723958333334,1025.6510416666677,33.08551747311831,0
4098,4,0,0,31,0.0,0.0,1.0,31,700,500,200,0.7142857142857143,9,5,4,388.1630766626954,0.7051075268817204,0.025681972663767372,0.22854624199915685,131528.39660644546,4010.8934190538325,135539.2900254993,4084,69,844.1612903225806,31,0,20,33.60042735042733,0.6471774193548386,43.55468750000001,1025.7812500000011,33.08971774193552,0
4099,4,1,1,31,0.03125,0.03125,0.96875,32,500,300,200,0.6,7,3,4,378.3906461387076,0.7165238575268817,0.014074603467355562,0.2244676240004458,131813.89534550052,3575.4290059687883,135389.32435146932,4085,0,818.75,32,0,20,33.562338620435284,0.6474609375,43.276515151515156,1026.8939393939397,32.090435606060616,0
4100,4,2,1,32,0.06060606060606061,0.030303030303030304,0.9696969696969697,33,600,400,200,0.6666666666666666,8,4,4,369.22878904372993,0.7376104797979799,0.011054753544023965,0.22059053294151054,132082.88278546717,3153.760572856596,135236.64335832375,4086,0,794.8787878787879,33,0,21,33.526068987442386,0.6477272727272727,43.01470588235294,1027.9411764705885,31.149732620320865,0
4101,4,0,0,32,0.0,0.0,1.0,32,300,200,100,0.6666666666666666,4,2,2,381.0882307666909,0.7181199596774194,0.01887900847769952,0.22722909232308414,132008.45457415064,3661.3736799816315,135669.82825413227,4087,1,820.71875,32,0,21,33.29647376827618,0.6494140625,43.08712121212121,1027.6515151515155,32.11410984848486,0
4102,4,0,0,32,0.0,0.0,1.0,32,600,500,100,0.8333333333333334,7,5,2,382.4511966879777,0.718707997311828,0.01988775948900634,0.2284325159381384,132073.33953486895,3702.3213511376484,135775.6608860066,4088,2,821.71875,32,0,21,33.1959116406666,0.6500651041666666,43.0239898989899,1027.9040404040409,32.12200126262628,0
4103,4,1,1,32,0.030303030303030304,0.030303030303030304,0.9696969696969697,33,550,400,150,0.7272727272727273,7,4,3,373.2236227441854,0.7290877525252526,0.009078640657588233,0.2248444751653994,132398.00347222216,3282.812499999991,135680.81597222216,4089,0,797.7878787878788,33,0,21,33.10560053981108,0.6508838383838385,42.70833333333333,1029.166666666666,31.186868686868667,0
4104,4,0,0,32,0.0,0.0,1.0,32,1100,800,300,0.7272727272727273,14,8,6,389.4475156017432,0.7179519489247312,0.017084151429623162,0.23421459812831044,132333.03880025004,3907.3546385573,136240.39343880734,4090,4,823.71875,32,0,21,32.7537632429337,0.6526692708333333,42.77146464646465,1028.914141414142,32.15356691919194,0
4105,4,0,0,32,0.0,0.0,1.0,32,850,700,150,0.8235294117647058,10,7,3,391.917508491343,0.7163978494623656,0.023523730684326782,0.23671817512877127,132495.48037190086,3985.4597107438094,136480.94008264467,4091,5,824.71875,32,0,21,32.52621412803532,0.654296875,42.61363636363637,1029.545454545455,32.17329545454547,0
4106,4,1,1,32,0.030303030303030304,0.030303030303030304,0.9696969696969697,33,600,500,100,0.8333333333333334,7,5,2,381.11385921251195,0.7295612373737375,0.012989072456246697,0.23153217689731231,132713.49961553258,3515.790801614773,136229.29041714736,4092,0,800.6969696969697,33,0,17,32.58454249920711,0.654040404040404,42.40196078431373,1030.3921568627457,31.224004753416533,0
4107,4,1,1,32,0.030303030303030304,0.030303030303030304,0.9696969696969697,33,350,200,150,0.5714285714285714,5,2,3,383.15690651947375,0.7332702020202021,0.019601484524195634,0.23316567176763933,132776.64389898122,3574.8576268742854,136351.5015258555,4093,0,801.6666666666666,33,0,17,32.468291716210864,0.6546717171717171,42.34068627450981,1030.6372549019613,31.231431966726102,0
4108,4,0,0,32,0.0,0.0,1.0,32,1100,800,300,0.7272727272727273,14,8,6,393.79755959756835,0.7175319220430109,0.021871552041191622,0.23847117250463018,132592.9931416439,4042.959423783312,136635.95256542723,4094,8,827.71875,32,0,21,32.37939806301337,0.6552734375,42.518939393939405,1029.9242424242439,32.18513257575762,0
4109,4,0,0,32,0.0,0.0,1.0,32,1000,900,100,0.9,11,9,2,390.4095185188334,0.7149277553763441,0.021602811466372662,0.2376519686554244,132788.1262913225,3968.349690082671,136756.47598140515,4095,9,828.71875,32,0,17,32.26984564498346,0.6572265624999998,42.32954545454547,1030.6818181818198,32.20880681818187,0
4110,4,0,0,32,0.0,0.0,1.0,32,500,500,0,1.0,5,5,0,389.21097174747644,0.7142977150537635,0.022484382655560964,0.23712823681689546,132820.66243240502,3939.0518186919876,136759.714251097,4096,10,829.71875,32,0,17,32.267934427568186,0.6575520833333333,42.29797979797981,1030.808080808082,32.21275252525256,0
4111,4,0,0,32,0.0,0.0,1.0,32,550,400,150,0.7272727272727273,7,4,3,388.6561950043667,0.7134156586021506,0.025891763625229824,0.23699610397391013,132853.20255905026,3926.8440401489875,136780.04659919924,4097,11,830.71875,32,0,17,32.24943866095121,0.6578776041666665,42.26641414141415,1030.9343434343448,32.216698232323274,0
4112,4,0,0,32,0.0,0.0,1.0,32,750,700,50,0.9333333333333333,8,7,1,390.19684327458305,0.7116935483870969,0.033836312438785265,0.23855747124751492,132950.8468523622,3975.400150494873,136926.2470028571,4098,12,831.71875,32,0,18,32.11133896506693,0.6588541666666665,42.171717171717184,1031.313131313133,32.228535353535406,0
4113,4,0,0,32,0.0,0.0,1.0,32,650,500,150,0.7692307692307693,8,5,3,385.44532476112806,0.7117355510752689,0.03395009790723247,0.2362695985463752,133048.52701573842,3856.5865409142198,136905.11355665265,4099,13,832.71875,32,0,18,32.13549953086117,0.6598307291666665,42.077020202020215,1031.691919191921,32.24037247474753,0
4114,4,0,1,31,0.0,0.03125,0.96875,32,700,500,200,0.7142857142857143,9,5,4,386.469317035263,0.711903561827957,0.03873654104979796,0.23731132442743855,133113.6670524692,3888.8695987654405,137002.53665123464,4100,14,833.71875,32,0,18,32.04351727231942,0.6604817708333333,42.01388888888889,1031.944444444445,32.24826388888891,0
4115,4,0,0,31,0.0,0.0,1.0,31,650,400,250,0.6153846153846154,9,4,5,395.3001496986426,0.6948924731182796,0.04821200250832702,0.24200678407362058,133001.71746148018,4315.11976453995,137316.8372260201,4101,86,861.1612903225806,31,0,18,31.928490280232257,0.6619623655913978,42.12239583333334,1031.5104166666679,33.274529569892515,0
4116,4,0,0,31,0.0,0.0,1.0,31,450,300,150,0.6666666666666666,6,3,3,394.28199563548105,0.6939068100358423,0.04924820754601744,0.24160063816085975,133035.29739379883,4290.684509277343,137325.98190307617,4102,87,862.1612903225806,31,0,18,31.920910639909128,0.6622983870967742,42.08984375,1031.640625,33.27872983870968,0
4117,4,0,0,31,0.0,0.0,1.0,31,650,500,150,0.7692307692307693,8,5,3,394.55850264539873,0.693010752688172,0.05002361140512268,0.24198773800016574,133068.8815646702,4300.691731770844,137369.57329644106,4103,88,863.1612903225806,31,0,18,31.879942789836775,0.6626344086021505,42.05729166666667,1031.770833333334,33.2829301075269,0
4118,4,0,0,31,0.0,0.0,1.0,31,700,500,200,0.7142857142857143,9,5,4,394.58048776017466,0.6911290322580645,0.05520653624556515,0.24287531886356079,133203.26063368047,4311.881510416658,137515.14214409713,4104,89,864.1612903225806,31,0,18,31.744029599730922,0.663978494623656,41.92708333333333,1032.291666666666,33.29973118279568,0
4119,4,0,0,31,0.0,0.0,1.0,31,750,600,150,0.8,9,6,3,398.9915288525334,0.6904121863799283,0.05439786572966976,0.2464798136182473,133337.70751953125,4440.123155381944,137777.8306749132,4105,90,865.1612903225806,31,0,18,31.494789040174826,0.6653225806451613,41.796875,1032.8125,33.31653225806452,0
4120,4,0,0,31,0.0,0.0,1.0,31,850,700,150,0.8235294117647058,10,7,3,397.3725286160248,0.6913082437275986,0.061654526534859144,0.24637096774193545,133472.2222222223,4407.6388888889,137879.8611111112,4106,91,866.1612903225806,31,0,19,31.40120967741935,0.6666666666666666,41.66666666666667,1033.3333333333342,33.33333333333336,0
4121,4,0,0,31,0.0,0.0,1.0,31,550,400,150,0.7272727272727273,7,4,3,394.83182328613765,0.6888888888888889,0.059810896797760194,0.24546357439848462,133573.15275404198,4347.786288791243,137920.93904283323,4107,92,867.1612903225806,31,0,19,31.36533253558382,0.6676747311827957,41.56901041666667,1033.7239583333342,33.34593413978497,0
4122,4,0,0,31,0.0,0.0,1.0,31,700,300,400,0.42857142857142855,11,3,8,393.6399571090483,0.6879032258064516,0.057203217680994456,0.24494523976848318,133606.8047417536,4318.595377604186,137925.4001193578,4108,93,868.1612903225806,31,0,19,31.362300587741395,0.668010752688172,41.53645833333334,1033.8541666666679,33.35013440860219,0
4123,4,0,0,31,0.0,0.0,1.0,31,1000,600,400,0.6,14,6,8,399.59230959647584,0.6868279569892473,0.05043052941440629,0.2400896454845442,132297.51798841695,4373.01415337457,136670.5321417915,4109,94,869.1612903225806,31,0,19,32.52871471965572,0.6549059139784945,42.805989583333336,1028.7760416666672,33.1863239247312,5
4124,4,0,0,31,0.0,0.0,1.0,31,850,700,150,0.8235294117647058,10,7,3,400.6005116222475,0.6866487455197132,0.05146269485250543,0.24112306499243147,132364.50407240138,4405.0576104058255,136769.5616828072,4110,95,870.1612903225806,31,0,19,32.43507212450967,0.6555779569892473,42.74088541666667,1029.0364583333344,33.19472446236563,0
4125,4,1,1,31,0.03125,0.03125,0.96875,32,1200,800,400,0.6666666666666666,16,8,8,389.5530307599983,0.6970346102150539,0.039023003033367365,0.23636070393965522,132666.15125868047,3936.104498969179,136602.25575764966,4111,0,843.9375,31,1,16,32.41489720256151,0.6586021505376344,42.447916666666664,1030.2083333333328,33.23252688172041,0
4126,4,0,0,31,0.0,0.0,1.0,31,600,400,200,0.6666666666666666,8,4,4,403.2734547675319,0.6860215053763441,0.04567401800861304,0.24429126354811048,132605.57804731763,4495.2619161174725,137100.8399634351,4112,97,872.1612903225806,30,1,20,32.12269998695028,0.6607638888888889,42.50672043010753,1029.97311827957,34.33243727598566,0
4127,4,0,0,31,0.0,0.0,1.0,31,550,500,50,0.9090909090909091,6,5,1,405.77007904184313,0.6897849462365592,0.0432968179447053,0.24694007667403595,132778.68106139437,4575.523181870731,137354.2042432651,4113,98,873.1612903225806,30,1,16,31.883585463397672,0.6625000000000001,42.33870967741935,1030.6451612903224,34.354838709677416,0
4128,4,0,0,31,0.0,0.0,1.0,31,850,600,250,0.7058823529411765,11,6,5,404.3383439092014,0.6896057347670251,0.046414602346805944,0.24652425260600733,132847.95388195157,4543.104332870842,137391.0582148224,4114,99,874.1612903225806,30,1,16,31.85055410691005,0.6631944444444444,42.27150537634408,1030.9139784946228,34.363799283154094,0
4129,4,0,0,31,0.0,0.0,1.0,31,800,700,100,0.875,9,7,2,400.80608844555906,0.6904121863799283,0.048221034797341744,0.24505060690380656,132951.89698592311,4457.5859564689445,137409.48294239206,4115,100,875.1612903225806,30,1,16,31.836743559668104,0.6642361111111111,42.17069892473118,1031.3172043010745,34.37724014336915,0
4130,4,0,0,31,0.0,0.0,1.0,31,750,500,250,0.6666666666666666,10,5,5,399.9225880380695,0.6909498207885305,0.049511400651465864,0.24496455412547344,133021.2149706613,4439.63771100705,137460.85268166836,4116,101,876.1612903225806,30,1,18,31.789630836047778,0.6649305555555556,42.10349462365591,1031.586021505376,34.38620071684587,0
4131,4,1,1,31,0.03125,0.03125,0.96875,32,1000,700,300,0.7,13,7,6,391.8303054531343,0.6997227822580646,0.039854387291981874,0.24205591766777731,133337.70751953125,4049.1509331597235,137386.85845269097,4117,0,849.75,31,1,18,31.679694066229622,0.6653225806451613,41.796875,1032.8125,33.31653225806452,0
4132,4,1,1,31,0.03125,0.03125,0.96875,32,700,400,300,0.5714285714285714,10,4,6,391.8303054531343,0.7058551747311829,0.039854387291981874,0.24205591766777731,133337.70751953125,4049.1509331597235,137386.85845269097,4118,0,850.71875,31,1,18,31.679694066229622,0.6653225806451613,41.796875,1032.8125,33.31653225806452,0
4133,4,0,0,31,0.0,0.0,1.0,31,650,600,50,0.9230769230769231,7,6,1,402.22933205888955,0.6900537634408602,0.045306600703033606,0.2477564955528734,133229.27731890976,4517.744645334729,137747.0219642445,4119,104,879.1612903225806,30,1,19,31.520418348305345,0.6670138888888888,41.90188172043011,1032.39247311828,34.413082437275996,0
4134,4,0,0,31,0.0,0.0,1.0,31,850,500,350,0.5882352941176471,12,5,7,401.05114823298146,0.6881720430107527,0.04528301886792452,0.2479547927731668,133368.075879437,4497.483993814325,137865.55987325133,4120,105,880.1612903225806,30,1,20,31.411027976577763,0.6684027777777777,41.767473118279575,1032.9301075268822,34.43100358422941,0
4135,4,1,1,31,0.03125,0.03125,0.96875,32,600,500,100,0.8333333333333334,7,5,2,390.4895760242618,0.6982526881720431,0.03284772069008923,0.24320609593793452,133640.4609680177,4037.0413886176357,137677.50235663532,4121,0,853.625,31,1,21,31.409903244763473,0.6683467741935483,41.50390625000001,1033.984375000001,33.35433467741938,0
4136,4,0,0,31,0.0,0.0,1.0,31,750,500,250,0.6666666666666666,10,5,5,399.7019928089171,0.6884408602150538,0.036675770581350076,0.24804750788601806,133506.94670265348,4472.5985301769,137979.5452328304,4122,107,882.1612903225806,30,1,22,31.306086617245413,0.6697916666666666,41.63306451612903,1033.467741935484,34.4489247311828,0
4137,4,0,0,31,0.0,0.0,1.0,31,700,600,100,0.8571428571428571,8,6,2,399.7443186141799,0.6877240143369175,0.040572171651495736,0.24830644669976112,133541.67569950272,4476.505231818696,138018.18093132143,4123,108,883.1612903225806,30,1,22,31.27004768097096,0.670138888888889,41.59946236559139,1033.6021505376336,34.45340501792112,0
4138,4,0,0,31,0.0,0.0,1.0,31,700,500,200,0.7142857142857143,9,5,4,401.41624245679054,0.6868279569892473,0.04444444444444451,0.2505188958398218,133715.38843002077,4535.105756445829,138250.4941864666,4124,109,884.1612903225806,30,1,18,31.0520901017977,0.671875,41.431451612903224,1034.2741935483868,34.4758064516129,0
4139,4,0,0,31,0.0,0.0,1.0,31,700,600,100,0.8571428571428571,8,6,2,401.41624245679054,0.6859318996415771,0.04444444444444451,0.2505188958398218,133715.38843002077,4535.105756445829,138250.4941864666,4125,110,885.1612903225806,30,1,18,31.0520901017977,0.671875,41.431451612903224,1034.2741935483868,34.4758064516129,0
4140,4,0,0,31,0.0,0.0,1.0,31,800,700,100,0.875,9,7,2,400.66586112091574,0.6851254480286738,0.0522213561964151,0.2507581950332365,133819.6702653485,4523.394684356569,138343.0649497051,4126,111,886.1612903225806,30,1,18,30.966647181086007,0.6729166666666667,41.33064516129032,1034.677419354838,34.48924731182794,0
4141,4,0,0,31,0.0,0.0,1.0,31,650,200,450,0.3076923076923077,11,2,9,402.0879986967795,0.6858422939068101,0.05453837164004649,0.2523618319448981,133923.9927484391,4569.84604434038,138493.83879277948,4127,112,887.1612903225806,30,1,18,30.825001082110543,0.6739583333333334,41.229838709677416,1035.0806451612902,34.50268817204301,0
4142,4,0,0,31,0.0,0.0,1.0,31,950,800,150,0.8421052631578947,11,8,3,399.2009248745645,0.6848566308243728,0.05088265835929384,0.25126175859752,134028.35587929236,4500.848725286152,138529.2046045785,4128,113,888.1612903225806,30,1,20,30.7948792834891,0.675,41.12903225806451,1035.4838709677415,34.51612903225805,0
4143,4,0,0,31,0.0,0.0,1.0,31,700,600,100,0.8571428571428571,8,6,2,399.4050569318573,0.685573476702509,0.04957819597663837,0.25162845164840236,134063.15262241298,4509.100221123827,138572.25284353681,4129,114,889.1612903225806,30,1,20,30.754650659744748,0.6753472222222222,41.09543010752688,1035.6182795698924,34.520609318996414,0
4144,4,0,0,31,0.0,0.0,1.0,31,800,600,200,0.75,10,6,4,397.97996835293213,0.6850358422939068,0.05138852841941377,0.2509683826618406,134097.95388195154,4473.659888426394,138571.61377037794,4130,115,890.1612903225806,30,1,20,30.756607405484914,0.6756944444444445,41.06182795698924,1035.752688172042,34.525089605734735,0
4145,4,0,0,31,0.0,0.0,1.0,31,850,600,250,0.7058823529411765,11,6,5,400.59909854472903,0.6841397849462365,0.04774260508562511,0.25309982390022706,134167.56995028324,4549.481515204066,138717.0514654873,4131,116,891.1612903225806,30,1,20,30.618891627746073,0.6763888888888889,40.994623655913976,1036.0215053763438,34.53405017921146,0
4146,4,0,0,31,0.0,0.0,1.0,31,400,300,100,0.75,5,3,2,398.7850827119848,0.682078853046595,0.04149915704837226,0.2526731119796316,134272.02792591637,4509.136352468504,138781.16427838488,4132,117,892.1612903225806,30,1,20,30.561049150564138,0.6774305555555555,40.89381720430108,1036.4247311827962,34.54749103942654,0
4147,4,0,0,31,0.0,0.0,1.0,31,500,300,200,0.6,7,3,4,396.4465239743261,0.6797491039426523,0.04252560611953893,0.25167012670073885,134341.68915842872,4451.859138339696,138793.54829676842,4133,118,893.1612903225806,30,1,20,30.55177406110895,0.6781249999999999,40.82661290322581,1036.6935483870968,34.556451612903224,0
4148,4,0,0,31,0.0,0.0,1.0,31,400,200,200,0.5,6,2,4,392.7756863203,0.6799283154121863,0.04069993519118564,0.24981569826554934,134411.36845661348,4358.703498959415,138770.0719555729,4134,119,894.1612903225806,30,1,20,30.577068481313447,0.6788194444444444,40.759408602150536,1036.9623655913979,34.56541218637993,0
4149,4,0,0,31,0.0,0.0,1.0,31,1200,1000,200,0.8333333333333334,14,10,4,384.12113462548433,0.6799283154121863,0.004429173926495222,0.23558636770683722,133068.8815646701,4022.9139539930525,137091.79551866316,4135,120,895.1612903225806,31,0,20,32.14916708732963,0.6626344086021505,42.057291666666664,1031.770833333333,33.28293010752687,5
4150,4,1,0,32,0.03125,0.0,1.0,32,750,600,150,0.8,9,6,3,375.5656649589613,0.6990927419354839,-0.0005042787286064776,0.2320337718553099,133341.78272625245,3615.719059279669,136957.50178553213,4136,0,868.15625,32,0,21,32.09555827220865,0.6627604166666666,41.792929292929294,1032.828282828283,32.27588383838384,0
4151,4,0,0,32,0.0,0.0,1.0,32,850,700,150,0.8235294117647058,10,7,3,374.7011957873277,0.6989667338709677,-0.0031505865819383416,0.23211051363570803,133439.60636988576,3599.996014437307,137039.60238432308,4137,1,869.15625,32,0,22,32.01963420098577,0.6637369791666666,41.698232323232325,1033.2070707070711,32.28772095959597,0
4152,4,0,0,32,0.0,0.0,1.0,32,550,400,150,0.7272727272727273,7,4,3,375.483558470898,0.6977906586021506,-0.01020540623090982,0.23300477074179712,133504.8420601215,3625.774633965939,137130.61669408745,4138,2,870.15625,32,0,22,31.933923844430876,0.6643880208333333,41.63510101010102,1033.4595959595968,32.2956123737374,0
4153,4,0,0,32,0.0,0.0,1.0,32,1250,1000,250,0.8,15,10,5,373.19034337997437,0.6953965053763441,-0.024169921874999778,0.2330164095250573,133733.2925211714,3581.5946714621055,137314.8871926335,4139,3,871.15625,32,0,18,31.76396687825521,0.6666666666666666,41.41414141414142,1034.3434343434349,32.32323232323234,0
4154,4,0,0,32,0.0,0.0,1.0,32,800,600,200,0.75,10,6,4,370.9922976442503,0.6960265456989247,-0.030075503355704747,0.23225988381929968,133831.2596450618,3530.0733024691476,137361.33294753096,4140,4,872.15625,32,0,18,31.72259507829978,0.6676432291666666,41.31944444444445,1034.7222222222229,32.335069444444464,0
4155,4,1,1,32,0.030303030303030304,0.030303030303030304,0.9696969696969697,33,700,500,200,0.7142857142857143,9,5,4,363.4734518179999,0.7093592171717172,-0.032181732134405894,0.2292595234899803,134106.1430699731,3148.804546328337,137254.94761630145,4141,0,846.6969696969697,33,0,18,31.64191907240889,0.6679292929292929,41.05392156862745,1035.7843137254904,31.387403446226983,0
4156,4,0,1,31,0.0,0.03125,0.96875,32,900,600,300,0.6666666666666666,12,6,6,372.42415229030337,0.6950604838709677,-0.02515243902439046,0.23419310190034406,133994.61789613302,3580.5663962860885,137575.18429241912,4142,6,874.15625,32,0,18,31.521849593495933,0.6692708333333334,41.16161616161616,1035.353535353535,32.35479797979797,0
4157,4,0,0,31,0.0,0.0,1.0,31,750,700,50,0.9333333333333333,8,7,1,378.5801043483887,0.6747311827956989,-0.016622094887163597,0.23751643642188955,133909.863366021,3939.122009277333,137848.98537529833,4143,128,903.1612903225806,31,0,19,31.44748291189668,0.6710349462365592,41.24348958333333,1035.026041666666,33.38793682795697,0
4158,4,1,0,32,0.03125,0.0,1.0,32,850,500,350,0.5882352941176471,12,5,7,370.6880474852028,0.6905661962365592,-0.011940127970749392,0.23414129558245478,134158.07578627174,3546.1590335169803,137704.23481978872,4144,0,875.90625,32,0,20,31.40310786106033,0.6708984375,41.003787878787875,1035.984848484848,32.3745265151515,8
4159,4,0,0,32,0.0,0.0,1.0,32,800,400,400,0.5,12,4,8,369.34993568640493,0.6892641129032259,-0.01632917174177817,0.23434026058619664,134321.63331547804,3522.3373252729375,137843.97064075098,4145,1,876.90625,32,0,20,31.274106780349165,0.6725260416666666,40.8459595959596,1036.616161616162,32.39425505050506,0
4160,4,0,0,32,0.0,0.0,1.0,32,750,600,150,0.8,9,6,3,370.4940223222948,0.6880460349462366,-0.02147129550712301,0.23569848221014786,134419.81565975418,3560.3476367207513,137980.16329647493,4146,2,877.90625,32,0,20,31.1462518771054,0.6735026041666666,40.75126262626263,1036.99494949495,32.40609217171719,0
4161,4,0,0,32,0.0,0.0,1.0,32,1100,800,300,0.7272727272727273,14,8,6,367.7880695795001,0.6896841397849462,-0.016313275736188793,0.2350297321776309,134583.53261146825,3499.6435312723265,138083.1761427406,4147,3,878.90625,32,0,20,31.052770341526728,0.6751302083333333,40.593434343434346,1037.626262626263,32.42582070707072,0
4162,4,1,0,33,0.030303030303030304,0.0,1.0,33,450,200,250,0.4444444444444444,7,2,5,359.2565990795738,0.7016256313131314,-0.012883345666169888,0.231590736912361,134900.6560727845,3092.7901828623635,137993.44625564688,4148,0,853.2424242424242,33,0,19,30.957664857850652,0.6758207070707071,40.28799019607843,1038.8480392156864,31.480243612596556,0
4163,4,0,0,33,0.0,0.0,1.0,33,650,400,250,0.6153846153846154,9,4,5,359.1291384834459,0.6991003787878789,-0.0170097198399084,0.2321200529222273,134996.15532487506,3096.210592079968,138092.36591695502,4149,1,854.2424242424242,33,0,19,30.865762578616348,0.6767676767676767,40.19607843137255,1039.2156862745098,31.491384432560903,0
4164,4,0,0,33,0.0,0.0,1.0,33,850,600,250,0.7058823529411765,11,6,5,356.34395042590165,0.6994949494949495,-0.019675715066497013,0.23092939125003265,135091.68836805565,3027.821180555566,138119.5095486112,4150,2,855.2424242424242,33,0,19,30.842935871743485,0.6777146464646464,40.10416666666667,1039.5833333333342,31.502525252525277,0
4165,4,0,0,33,0.0,0.0,1.0,33,800,600,200,0.75,10,6,4,355.08040887962926,0.6993371212121213,-0.025739363943464655,0.2307207005936092,135187.25520232608,3000.469170511349,138187.72437283743,4151,3,856.2424242424242,33,0,19,30.780599418650326,0.6786616161616161,40.01225490196079,1039.9509803921571,31.51366607248961,0
4166,4,0,0,33,0.0,0.0,1.0,33,900,600,300,0.6666666666666666,12,6,6,355.4007278014322,0.6978377525252526,-0.018931363100974208,0.23174747918849145,135314.7302119377,3018.19071991542,138332.92093185312,4152,4,857.2424242424242,33,0,19,30.645367098547325,0.6799242424242424,39.88970588235294,1040.441176470588,31.52852049910873,0
4167,4,0,1,32,0.0,0.030303030303030304,0.9696969696969697,33,350,100,250,0.2857142857142857,6,1,5,356.4641704286699,0.698074494949495,-0.01844159922351163,0.2328533642523281,135378.49024413686,3051.516243752401,138430.00648788927,4153,5,858.2424242424242,33,0,19,30.55424713455803,0.6805555555555556,39.82843137254902,1040.6862745098038,31.535947712418295,0
4168,4,0,0,32,0.0,0.0,1.0,32,700,500,200,0.7142857142857143,9,5,4,367.35947513406273,0.6848118279569892,-0.012768572469045614,0.23904481486211754,135239.39680899904,3536.294765840219,138775.69157483926,4154,6,885.78125,32,0,19,30.4093833454722,0.681640625,39.96212121212121,1040.1515151515148,32.50473484848484,0
4169,4,0,0,32,0.0,0.0,1.0,32,1100,900,200,0.8181818181818182,13,9,4,365.98572514900525,0.6861139112903226,-0.0018765922600991747,0.23924031184799802,135403.6119560506,3511.1578219059543,138914.76977795654,4155,7,886.78125,32,0,20,30.281501475999843,0.6832682291666666,39.80429292929294,1040.7828282828298,32.52446338383843,0
4170,4,0,0,32,0.0,0.0,1.0,32,850,700,150,0.8235294117647058,10,7,3,369.2562697821529,0.6869539650537635,-0.0048767733721353235,0.2422638390527779,135535.05581382016,3609.4338269054365,139144.4896407256,4156,8,887.78125,32,0,21,30.065478355765734,0.6845703125,39.67803030303031,1041.28787878788,32.54024621212125,0
4171,4,0,0,32,0.0,0.0,1.0,32,750,600,150,0.8,9,6,3,366.6018835969698,0.6868699596774194,-0.0026246818567445818,0.2414071940589465,135666.5634405929,3547.1235396898387,139213.68698028274,4157,9,888.78125,32,0,21,30.003686421847856,0.6858723958333333,39.55176767676768,1041.79292929293,32.55602904040406,0
4172,4,0,0,32,0.0,0.0,1.0,32,500,200,300,0.4,8,2,6,368.0730522238295,0.6863239247311829,-0.0004998788172565494,0.2425989478395401,135699.45031119278,3589.4621722273246,139288.9124834201,4158,10,889.78125,32,0,21,29.932642591694933,0.6861979166666666,39.52020202020202,1041.9191919191921,32.559974747474755,0
4173,4,0,0,32,0.0,0.0,1.0,32,700,600,100,0.8571428571428571,8,6,2,367.9477702150673,0.6858618951612904,0.0006246214415508433,0.2431872572558349,135798.1348363686,3593.3241824813686,139391.45901884997,4159,11,890.78125,32,0,21,29.837724611346665,0.6871744791666667,39.425505050505045,1042.2979797979788,32.57181186868684,0
4174,4,0,0,32,0.0,0.0,1.0,32,850,800,50,0.9411764705882353,9,8,1,366.5014239115738,0.6848118279569892,0.0004996366279073072,0.24245478812611812,135831.0376492195,3556.4537419651133,139387.49139118462,4160,12,891.78125,32,0,21,29.84269016472869,0.6875,39.3939393939394,1042.4242424242427,32.575757575757585,0
4175,4,0,0,32,0.0,0.0,1.0,32,700,400,300,0.5714285714285714,10,4,6,369.8808106983097,0.684559811827957,0.001248486682808414,0.24559610099421544,135962.6887562495,3657.9979083767107,139620.6866646262,4161,13,892.78125,32,0,18,29.623688458434213,0.6888020833333333,39.267676767676775,1042.929292929294,32.59154040404044,0
4176,4,0,0,32,0.0,0.0,1.0,32,1100,800,300,0.7272727272727273,14,8,6,369.9050055806028,0.6826276881720431,-0.0032444941916749404,0.24652378759016963,136094.4036322825,3668.40022701766,139762.80385930018,4162,14,893.78125,32,0,20,29.492124475637304,0.6901041666666666,39.141414141414145,1043.434343434344,32.60732323232325,0
4177,4,1,1,32,0.030303030303030304,0.030303030303030304,0.9696969696969697,33,950,600,350,0.631578947368421,13,6,7,360.46068395284806,0.693576388888889,-0.007735733685991786,0.24231599921246672,136400.69324298354,3233.417435601698,139634.11067858525,4163,0,867.6666666666666,33,0,20,29.434537775692164,0.6906565656565655,38.84803921568628,1044.6078431372555,31.654783125371377,0
4178,4,0,0,32,0.0,0.0,1.0,32,400,200,200,0.5,6,2,4,369.4512145028343,0.6808635752688172,0.0009978229317852971,0.24713775416742986,136226.18227731864,3665.7856978879718,139891.96797520661,4164,16,895.78125,32,0,21,29.373034591194966,0.69140625,39.015151515151516,1043.939393939394,32.62310606060606,0
4179,4,0,0,32,0.0,0.0,1.0,32,450,100,350,0.2222222222222222,8,1,7,369.7908111839996,0.6811575940860216,0.004863798524610052,0.24759515932635578,136259.1369024845,3677.475353280284,139936.61225576478,4165,17,896.78125,32,0,21,29.331438706816623,0.6917317708333333,38.98358585858586,1044.065656565657,32.62705176767678,0
4180,4,0,0,32,0.0,0.0,1.0,32,750,600,150,0.8,9,6,3,368.2095656128046,0.6801075268817205,0.006733675937122152,0.24676605410193655,136292.09551321305,3636.8106570758205,139928.90617028886,4166,18,897.78125,32,0,21,29.339983877468757,0.6920572916666666,38.95202020202021,1044.19191919192,32.6309974747475,0
4181,4,0,0,32,0.0,0.0,1.0,32,1000,800,200,0.8,12,8,4,367.8375676586696,0.6782594086021506,0.007976794778825402,0.24743805161039284,136423.96981175395,3636.3722451790686,140060.34205693303,4167,19,898.78125,32,0,21,29.218787768914673,0.693359375,38.82575757575758,1044.69696969697,32.64678030303031,0
4182,4,0,0,32,0.0,0.0,1.0,32,750,600,150,0.8,9,6,3,366.03598753417776,0.6761592741935485,0.0072254771683981645,0.247148931876666,136555.90787929812,3596.875318845029,140152.78319814315,4168,20,899.78125,32,0,21,29.134956108560846,0.6946614583333333,38.699494949494955,1045.202020202021,32.662563131313156,0
4183,4,0,0,32,0.0,0.0,1.0,32,850,600,250,0.7058823529411765,11,6,5,366.82419659735353,0.6751512096774194,0.013700181159420621,0.24814578005115095,136621.90082644636,3623.243801652901,140245.14462809925,4169,21,900.78125,32,0,21,29.048913043478265,0.6953125,38.63636363636364,1045.454545454546,32.67045454545456,0
4184,4,0,0,32,0.0,0.0,1.0,32,600,400,200,0.6666666666666666,8,4,4,365.77388647731044,0.6754452284946237,0.017060892404298977,0.24766750236456334,136654.90327836457,3596.9590156616814,140251.86229402624,4170,22,901.78125,32,0,21,29.043644084852872,0.6956380208333333,38.604797979797986,1045.580808080809,32.67440025252528,0
4185,4,0,0,32,0.0,0.0,1.0,32,600,400,200,0.6666666666666666,8,4,4,362.7477510781603,0.675697244623656,0.022031532890766536,0.24654348791489414,136786.95294166417,3523.8319112845697,140310.78485294874,4171,23,902.78125,32,0,21,28.991903037618194,0.6969401041666666,38.47853535353536,1046.085858585859,32.69018308080809,0
4186,4,0,0,32,0.0,0.0,1.0,32,1000,800,200,0.8,12,8,4,364.1827953332539,0.6751512096774194,0.018166324806949907,0.24821932629292837,136886.03203754724,3570.3075579022634,140456.3395954495,4172,24,903.78125,32,0,21,28.856227879665383,0.6979166666666666,38.38383838383839,1046.4646464646469,32.702020202020215,0
4187,4,0,0,32,0.0,0.0,1.0,32,800,500,300,0.625,11,5,6,367.22141823444275,0.6726310483870969,0.0248733719247467,0.251237623762376,137018.19329660232,3663.2030532598565,140681.39634986216,4173,25,904.78125,32,0,20,28.64583333333333,0.69921875,38.25757575757575,1046.9696969696963,32.71780303030301,0
4188,4,0,0,32,0.0,0.0,1.0,32,900,500,400,0.5555555555555556,13,5,8,367.4127025448712,0.6726310483870969,0.024370026525198707,0.25184470701712075,137084.29783950615,3673.3024691357996,140757.60030864194,4174,26,905.78125,32,0,20,28.575375773651626,0.6998697916666667,38.19444444444444,1047.2222222222222,32.72569444444444,0
4189,4,0,0,32,0.0,0.0,1.0,32,800,700,100,0.875,9,7,2,366.22728565869556,0.672757056451613,0.022999547920433905,0.2512700855697998,137117.3560893021,3643.2234274563834,140760.5795167585,4175,27,906.78125,32,0,20,28.573688969258598,0.7001953125,38.16287878787879,1047.348484848485,32.729640151515156,0
4190,4,0,0,32,0.0,0.0,1.0,32,850,700,150,0.8235294117647058,10,7,3,368.40171524350774,0.6704049059139785,0.023479851825081388,0.25420637059321344,137315.7892848943,3717.474460514224,141033.26374540853,4176,28,907.78125,32,0,20,28.320383086375138,0.7021484375,37.973484848484844,1048.10606060606,32.75331439393938,0
4191,4,0,0,32,0.0,0.0,1.0,32,750,200,550,0.26666666666666666,13,2,11,371.2576285205548,0.6683887768817205,0.029435896663856376,0.2566654529230778,137381.96556792667,3800.8205476481867,141182.78611557485,4177,29,908.78125,32,0,20,28.180075474728007,0.7027994791666667,37.91035353535353,1048.3585858585852,32.76120580808079,0
4192,4,0,0,32,0.0,0.0,1.0,32,600,400,200,0.6666666666666666,8,4,4,371.2484129105549,0.6686827956989247,0.030798410404624166,0.2569039017341041,137415.05968778703,3803.024563820025,141218.08425160704,4178,30,909.78125,32,0,20,28.147579479768783,0.703125,37.87878787878788,1048.484848484849,32.76515151515153,0
4193,4,0,0,32,0.0,0.0,1.0,32,950,700,250,0.7368421052631579,12,7,5,367.2544146999853,0.6691868279569892,-0.024156302825404374,0.24890352393987547,136687.90971584537,3639.847655851448,140327.75737169682,4179,31,910.78125,32,0,21,28.972218868228286,0.6959635416666666,38.573232323232325,1045.7070707070711,32.67834595959597,8
4194,4,0,0,32,0.0,0.0,1.0,32,650,400,250,0.6153846153846154,9,4,5,367.1370295709594,0.6684727822580646,-0.02278386454183212,0.24905782276300215,136720.92013888882,3639.0624999999945,140359.98263888882,4180,32,911.78125,32,0,21,28.942563081009297,0.6962890625,38.541666666666664,1045.8333333333328,32.68229166666665,0
4195,4,0,0,32,0.0,0.0,1.0,32,600,500,100,0.8333333333333334,7,5,2,366.87267746168544,0.6672967069892474,-0.02327625226312624,0.24934701663413195,136786.95294166432,3636.6791335068056,140423.63207517113,4181,33,912.78125,32,0,21,28.884027358680342,0.6969401041666666,38.478535353535364,1046.08585858586,32.690183080808126,0
4196,4,0,0,32,0.0,0.0,1.0,32,450,100,350,0.2222222222222222,8,1,7,366.4084993348754,0.667926747311828,-0.019664192614047726,0.2492660776263364,136819.97532139573,3626.400367309454,140446.3756887052,4182,34,913.78125,32,0,22,28.863444363987455,0.697265625,38.446969696969695,1046.2121212121208,32.694128787878775,0
4197,4,0,0,32,0.0,0.0,1.0,32,800,500,300,0.625,11,5,6,366.22584593031655,0.6671286962365592,-0.022269724936663016,0.249847410445794,136919.06637396704,3628.6601813590573,140547.7265553261,4183,35,914.78125,32,0,24,28.770056701652802,0.6982421875,38.352272727272734,1046.59090909091,32.705965909090935,0
4198,4,0,0,32,0.0,0.0,1.0,32,650,500,150,0.7692307692307693,8,5,3,371.21206791013776,0.6663306451612904,-0.02561339522546424,0.25444899927658576,137084.29783950635,3777.469135802496,140861.76697530886,4184,36,915.78125,32,0,16,28.475906277630422,0.6998697916666666,38.19444444444446,1047.2222222222238,32.72569444444449,0
4199,4,0,0,32,0.0,0.0,1.0,32,750,400,350,0.5333333333333333,11,4,7,371.42173696770726,0.6666246639784946,-0.020756749427503607,0.2553178253207184,137183.4845455823,3790.5856226405763,140974.07016822288,4185,37,916.78125,32,0,17,28.372202804226426,0.7008463541666666,38.09974747474749,1047.6010101010118,32.73753156565662,0
4200,4,0,0,32,0.0,0.0,1.0,32,700,400,300,0.5714285714285714,10,4,6,372.4207124106429,0.6668346774193549,-0.021872740419378145,0.25624768421090494,137216.55475206615,3820.457415059692,141037.01216712585,4186,38,917.78125,32,0,17,28.313298385153043,0.701171875,38.06818181818182,1047.727272727273,32.74147727272728,0
4201,4,0,0,32,0.0,0.0,1.0,32,550,200,350,0.36363636363636365,9,2,7,371.22601248366954,0.6651545698924731,-0.020873493975903656,0.255911619901533,137282.70712172228,3792.5823895520884,141075.28951127437,4187,39,918.78125,32,0,18,28.279116465863453,0.7018229166666666,38.005050505050505,1047.9797979797981,32.74936868686869,0
4202,4,0,0,32,0.0,0.0,1.0,32,1100,900,200,0.8181818181818182,13,9,4,370.94096786330476,0.6667506720430109,-0.0193778607564441,0.2562023223961029,137348.8754336292,3789.664957657379,141138.54039128657,4188,40,919.78125,32,0,19,28.221111378784226,0.7024739583333334,37.94191919191919,1048.232323232323,32.7572601010101,0
4203,4,0,0,32,0.0,0.0,1.0,32,550,400,150,0.7272727272727273,7,4,3,369.62189509160476,0.66591061827957,-0.017382013002648744,0.2562670668306233,137481.2598841954,3763.2167635955407,141244.47664779093,4189,41,920.78125,32,0,19,28.12474917730154,0.7037760416666667,37.81565656565656,1048.7373737373732,32.77304292929291,0
4204,4,0,0,32,0.0,0.0,1.0,32,650,400,250,0.6153846153846154,9,4,5,367.64194542840175,0.6650705645161291,-0.019860375541646658,0.255382047041736,137547.47602285483,3713.6443347617596,141261.12035761657,4190,42,921.78125,32,0,19,28.111208072540535,0.7044270833333334,37.75252525252525,1048.989898989899,32.780934343434346,0
4205,4,0,0,32,0.0,0.0,1.0,32,750,500,250,0.6666666666666666,10,5,5,367.98294104514883,0.6644825268817205,-0.013647437439846088,0.2566001850643687,137679.95612692577,3732.775035710635,141412.7311626364,4191,43,922.78125,32,0,20,27.97135667308309,0.7057291666666667,37.62626262626262,1049.4949494949492,32.79671717171716,0
4206,4,0,0,32,0.0,0.0,1.0,32,650,400,250,0.6153846153846154,9,4,5,371.31519274376416,0.6646505376344086,-0.016121031746031855,0.2599206349206349,137812.5,3834.4387690031626,141646.93876900317,4192,44,923.78125,31,1,21,27.752976190476186,0.7096774193548387,37.5,1050.0,33.87096774193548,0
4207,4,0,0,32,0.0,0.0,1.0,32,350,200,150,0.5714285714285714,5,2,3,370.55991516554263,0.6633904569892474,-0.019425675675675436,0.2599075022369796,137880.86785210497,3818.624538845477,141699.49239095044,4193,45,924.78125,31,1,21,27.70528556079016,0.7103494623655915,37.43489583333333,1050.260416666666,33.879368279569874,0
4208,4,0,0,32,0.0,0.0,1.0,32,700,500,200,0.7142857142857143,9,5,4,371.89821350073134,0.6638524865591399,-0.020581535886947,0.2611055603403307,137915.05813598633,3858.0727471245664,141773.1308831109,4194,46,925.78125,31,1,21,27.63638382711458,0.7106854838709677,37.40234375,1050.390625,33.883568548387096,0
4209,4,0,0,32,0.0,0.0,1.0,32,700,300,400,0.42857142857142855,11,3,8,372.9696223216411,0.6639364919354839,-0.02239667245011767,0.2623794143429227,137983.4514194065,3892.7271525065153,141876.17857191304,4195,47,926.78125,31,1,21,27.540716528276953,0.7113575268817204,37.337239583333336,1050.651041666667,33.89196908602152,0
4210,4,0,0,32,0.0,0.0,1.0,32,1000,700,300,0.7,13,7,6,375.8857645520278,0.664020497311828,-0.022971905587907626,0.26495842844536394,138051.8616570368,3978.345913357215,142030.207570394,4196,48,927.78125,31,1,17,27.396568991863866,0.7120295698924731,37.27213541666667,1050.9114583333342,33.90036962365594,0
4211,4,0,0,32,0.0,0.0,1.0,32,600,400,200,0.6666666666666666,8,4,4,374.36386814787835,0.6628444220430108,-0.030065789473684212,0.26494200134041335,138188.73299492724,3946.5737236870573,142135.3067186143,4197,49,928.78125,31,1,17,27.3014705882353,0.7133736559139785,37.14192708333333,1051.432291666666,33.917170698924714,0
4212,4,0,0,32,0.0,0.0,1.0,32,800,600,200,0.75,10,6,4,375.60706718565893,0.6638104838709677,-0.029733159980188217,0.2660879539115247,138222.96142578125,3983.504231770833,142206.4656575521,4198,50,929.78125,31,1,17,27.235017335314517,0.7137096774193548,37.109375,1051.5625,33.921370967741936,0
4213,4,0,0,32,0.0,0.0,1.0,32,750,600,150,0.8,9,6,3,376.1781408195081,0.6633904569892474,-0.029315734092596912,0.26702697904569306,138291.43100314672,4004.442681206602,142295.8736843533,4199,51,930.78125,31,1,17,27.15245110175787,0.7143817204301075,37.044270833333336,1051.8229166666667,33.929771505376344,0
4214,4,0,0,32,0.0,0.0,1.0,32,1000,800,200,0.8,12,8,4,375.813137108985,0.6634744623655915,-0.031175023992322304,0.26821732114216607,138476.17590041837,4008.2332159983766,142484.40911641673,4200,52,931.78125,32,0,17,26.97986644273832,0.7135416666666666,36.86868686868687,1052.5252525252529,32.89141414141415,0
4215,4,0,0,32,0.0,0.0,1.0,32,400,300,100,0.75,5,3,2,374.8529848018365,0.6643565188172044,-0.03401628283555258,0.2677934305306694,138509.40154384755,3984.1325183654703,142493.53406221303,4201,53,932.78125,32,0,17,26.972382151853182,0.7138671875,36.83712121212121,1052.651515151515,32.895359848484844,0
4216,4,0,0,32,0.0,0.0,1.0,32,800,600,200,0.75,10,6,4,376.6135293204286,0.6638944892473119,-0.039073741007194296,0.2698416524512349,138609.10238751146,4040.4126492194678,142649.51503673094,4202,54,933.78125,32,0,17,26.82778776978417,0.71484375,36.74242424242424,1053.030303030303,32.90719696969697,0
4217,4,0,0,32,0.0,0.0,1.0,32,900,800,100,0.8888888888888888,10,8,2,376.5541336786123,0.6628444220430108,-0.03820360268552958,0.2700634590725113,138642.34397319157,4041.2695451994737,142683.61351839104,4203,55,934.78125,32,0,17,26.796597130639817,0.7151692708333333,36.71085858585859,1053.1565656565663,32.911142676767696,0
4218,4,0,0,32,0.0,0.0,1.0,32,1050,900,150,0.8571428571428571,12,9,3,373.7170358143297,0.6599042338709677,-0.037938136608747675,0.26908271474293205,138775.3501715387,3972.5425020406224,142747.89267357934,4204,56,935.78125,32,0,17,26.740313561014585,0.7164713541666666,36.584595959595966,1053.6616161616168,32.92692550505053,0
4219,4,0,0,32,0.0,0.0,1.0,32,500,500,0,1.0,5,5,0,370.9914781330442,0.6599042338709677,-0.03842323589313512,0.2676461424353084,138841.87718408828,3901.8306486582937,142743.7078327466,4205,57,936.78125,32,0,17,26.746635517750892,0.7171223958333334,36.52146464646464,1053.9141414141409,32.9348169191919,0
4220,4,0,0,32,0.0,0.0,1.0,32,300,100,200,0.3333333333333333,5,1,4,370.240088034422,0.6587701612903226,-0.03656564446574018,0.267367150078837,138875.1466687073,3883.429305683093,142758.5759743904,4206,58,937.78125,32,0,17,26.733698690305065,0.7174479166666667,36.48989898989899,1054.0404040404042,32.93876262626263,0
4221,4,0,0,32,0.0,0.0,1.0,32,650,400,250,0.6153846153846154,9,4,5,371.7551280815211,0.6570900537634409,-0.034376157836236154,0.26899922002467186,138942.73757934573,3930.5390265240694,142873.2766058698,4207,59,938.78125,31,1,17,26.62727450496068,0.720766129032258,36.42578125,1054.2968750000002,34.00957661290323,0
4222,4,0,0,32,0.0,0.0,1.0,32,600,300,300,0.5,9,3,6,372.526513595393,0.6576780913978495,-0.03642810840844546,0.27010673532758167,139011.3851759168,3957.0853339301107,142968.47050984693,4208,60,939.78125,31,1,18,26.539413302053756,0.7214381720430108,36.36067708333333,1054.557291666666,34.01797715053762,0
4223,4,0,0,32,0.0,0.0,1.0,32,1050,700,350,0.6666666666666666,14,7,7,374.23065736593094,0.6562920026881721,-0.04184923475684976,0.27217385870545513,139114.38835991744,4012.1738009982532,143126.5621609157,4209,61,940.78125,31,1,18,26.393174524808707,0.7224462365591398,36.26302083333333,1054.9479166666658,34.03057795698922,0
4224,4,0,0,32,0.0,0.0,1.0,32,550,300,250,0.5454545454545454,8,3,5,373.4341897158852,0.6544018817204301,-0.04565236898779634,0.2723527886252503,139208.0607208448,3997.0098714416845,143205.0705922865,4210,62,941.78125,32,0,17,26.322086623594164,0.720703125,36.17424242424242,1055.3030303030303,32.978219696969695,0
4225,4,0,0,32,0.0,0.0,1.0,32,400,200,200,0.5,6,2,4,372.8887320389724,0.6540238575268817,-0.042069176935039865,0.27222505773919387,139241.3740466534,3984.3078831241705,143225.68192977755,4211,63,942.78125,32,0,17,26.303734497746948,0.7210286458333334,36.14267676767677,1055.4292929292928,32.9821654040404,0
4226,4,0,0,32,0.0,0.0,1.0,32,700,600,100,0.8571428571428571,8,6,2,371.57607207770945,0.6516297043010754,-0.03526273314203743,0.2726194970928038,139408.00045913682,3960.1354453627177,143368.13590449953,4212,64,943.78125,32,0,18,26.174677187948344,0.72265625,35.984848484848484,1056.060606060606,33.00189393939394,0
4227,4,0,0,32,0.0,0.0,1.0,32,1450,1100,350,0.7586206896551724,18,11,7,371.267421843876,0.6499915994623656,-0.031914655275421255,0.2737565685825022,139574.7265106878,3963.9097732374353,143538.6362839252,4213,65,944.78125,32,0,18,26.01913808897916,0.7242838541666666,35.82702020202021,1056.69191919192,33.0216224747475,0
4228,4,0,0,32,0.0,0.0,1.0,32,750,500,250,0.6666666666666666,10,5,5,370.4734507099844,0.648395497311828,-0.032638391257613475,0.2742682761091687,139708.17909205693,3951.634240128562,143659.8133321855,4214,66,945.78125,32,0,21,25.90917233966322,0.7255859375,35.70075757575758,1057.1969696969697,33.037405303030305,0
4229,4,0,0,32,0.0,0.0,1.0,32,600,400,200,0.6666666666666666,8,4,4,369.087244375139,0.6470514112903226,-0.03115298507462727,0.27379146781592456,139774.92929611768,3917.82869732679,143692.75799344448,4215,67,946.78125,32,0,21,25.880348258706444,0.7262369791666667,35.637626262626256,1057.4494949494945,33.0452967171717,0
4230,4,0,0,32,0.0,0.0,1.0,32,1000,800,200,0.8,12,8,4,370.760741521483,0.6457493279569892,-0.05487204724409467,0.2769800833719313,140008.6805555555,3981.944444444439,143990.62499999994,4216,68,947.78125,32,0,18,25.60695538057742,0.728515625,35.416666666666664,1058.333333333333,33.07291666666666,1
4231,4,0,0,32,0.0,0.0,1.0,32,1000,600,400,0.6,14,6,8,375.5210897897324,0.6457493279569892,-0.04518045247785485,0.2727915812263846,139074.84727323733,4045.107642077329,143119.95491531465,4217,69,948.78125,32,0,18,26.398032878461414,0.7194010416666667,36.300505050505045,1054.797979797979,32.962436868686844,1
4232,4,0,0,32,0.0,0.0,1.0,32,550,400,150,0.7272727272727273,7,4,3,377.0887424956634,0.6446992607526882,-0.04158564676319232,0.274745476986596,139174.7513805988,4096.246397051312,143270.99777765013,4218,70,949.78125,32,0,16,26.258426069961313,0.7203776041666667,36.205808080808076,1055.176767676767,32.97427398989897,0
4233,4,0,0,32,0.0,0.0,1.0,32,800,700,100,0.875,9,7,2,379.2468208990715,0.643523185483871,-0.041565751704341625,0.27741755638995075,139308.01265495867,4166.424185032136,143474.4368399908,4219,71,950.78125,32,0,16,26.070446118885307,0.7216796875,36.07954545454545,1055.681818181818,32.99005681818181,0
4234,4,0,0,32,0.0,0.0,1.0,32,550,500,50,0.9090909090909091,6,5,1,377.75408960415456,0.6427671370967742,-0.033298312976176025,0.2529270094685628,136259.13690248423,3894.489242169142,140153.62614465336,4220,72,951.78125,32,0,18,29.123584069012786,0.6917317708333335,38.98358585858585,1044.065656565655,32.62705176767672,6
4235,4,0,0,32,0.0,0.0,1.0,32,650,400,250,0.6153846153846154,9,4,5,378.06982797646015,0.6409610215053764,-0.03366023936170215,0.2538468844984801,136358.02469135786,3910.5709876542987,140268.59567901216,4221,73,952.78125,32,0,18,29.017065602836883,0.6927083333333335,38.88888888888888,1044.444444444443,32.63888888888884,0
4236,4,0,0,32,0.0,0.0,1.0,32,850,700,150,0.8235294117647058,10,7,3,379.6401211299484,0.6404989919354839,-0.0352766529674845,0.25513913258392057,136390.9952587746,3955.8987922150764,140346.89405098968,4222,74,953.78125,32,0,18,28.943299488295263,0.6930338541666667,38.85732323232323,1044.570707070707,32.64283459595959,0
4237,4,0,0,32,0.0,0.0,1.0,32,600,500,100,0.8333333333333334,7,5,2,383.7028139575215,0.6398269489247312,-0.036763595166163454,0.25835156920248065,136456.94835029574,4071.783013212918,140528.73136350868,4223,75,954.78125,32,0,18,28.771651560926482,0.6936848958333334,38.79419191919191,1044.8232323232312,32.650726010100975,0
4238,4,0,0,32,0.0,0.0,1.0,32,550,300,250,0.5454545454545454,8,3,5,383.7028139575215,0.6398269489247312,-0.036763595166163454,0.25835156920248065,136456.94835029574,4071.783013212918,140528.73136350868,4224,76,955.78125,32,0,18,28.771651560926482,0.6936848958333334,38.79419191919191,1044.8232323232312,32.650726010100975,0
4239,4,0,0,32,0.0,0.0,1.0,32,350,200,150,0.5714285714285714,5,2,3,383.7028139575215,0.6398269489247312,-0.036763595166163454,0.25835156920248065,136456.94835029574,4071.783013212918,140528.73136350868,4225,77,956.78125,32,0,18,28.771651560926482,0.6936848958333334,38.79419191919191,1044.8232323232312,32.650726010100975,0
4240,4,0,0,32,0.0,0.0,1.0,32,1100,700,400,0.6363636363636364,15,7,8,384.6048050802183,0.639616935483871,-0.037880618656355836,0.25920108850520246,136489.93087440048,4098.9366518722445,140588.86752627272,4226,78,957.78125,32,0,18,28.715311342033182,0.6940104166666667,38.762626262626256,1044.9494949494942,32.654671717171695,0
4241,4,0,0,32,0.0,0.0,1.0,32,550,300,250,0.5454545454545454,8,3,5,393.89747487636293,0.6389868951612904,-0.06504285104306429,0.2470373069289631,133896.5909888022,4148.305817008475,138044.89680581068,4227,79,958.78125,32,0,18,31.06446464153553,0.6682942708333333,41.256313131313135,1034.9747474747478,32.34296085858587,8
4242,4,0,0,32,0.0,0.0,1.0,32,1050,900,150,0.8571428571428571,12,9,3,394.7082513476182,0.6402469758064516,-0.0670394255397001,0.24798566688115878,133961.9382747934,4175.176480716257,138137.11475550968,4228,80,959.78125,32,0,18,30.977863154043174,0.6689453125,41.19318181818182,1035.227272727273,32.35085227272728,0
4243,4,0,0,32,0.0,0.0,1.0,32,900,700,200,0.7777777777777778,11,7,4,396.3912950297228,0.6402469758064516,-0.02449047521507608,0.22040800709967073,129307.31336805563,3891.0385818411473,133198.35194989678,4229,81,960.78125,29,3,21,35.65009217533797,0.6303879310344827,45.72916666666667,1017.083333333334,35.071839080459796,8
4244,4,1,0,33,0.030303030303030304,0.0,1.0,33,900,600,300,0.6666666666666666,12,6,6,384.4071972590015,0.6642992424242424,-0.02065788526596135,0.21578057339471965,129680.10210718008,3369.992918256454,133050.09502543655,4230,0,932.6363636363636,30,3,20,35.574469956892756,0.6312499999999999,45.362903225806456,1018.5483870967747,33.95161290322582,0
4245,4,1,0,34,0.029411764705882353,0.0,1.0,34,750,700,50,0.9333333333333333,8,7,1,375.0369307892402,0.6829693998811647,-0.02124224721800938,0.21259329347343786,130063.2815890843,2955.706787109385,133018.98837619368,4231,0,906.1764705882352,31,3,21,35.423049102204054,0.6323924731182795,44.98697916666667,1020.0520833333342,32.904905913978524,0
4246,4,0,0,34,0.0,0.0,1.0,34,1000,700,300,0.7,13,7,6,376.2826874809863,0.6819667260843731,-0.01763955103419801,0.2134811626657154,130096.48852878161,2990.6112670898633,133087.09979587147,4232,1,907.1764705882352,31,3,21,35.3575037226122,0.6327284946236558,44.95442708333334,1020.1822916666679,32.90910618279574,0
4247,4,2,1,35,0.05555555555555555,0.027777777777777776,0.9722222222222222,36,350,200,150,0.5714285714285714,5,2,3,354.9221464984478,0.7083333333333334,-0.00471511241280731,0.20449036070816684,130694.93823581285,2077.5175306532315,132772.45576646607,4233,0,857.7222222222222,31,5,18,35.29556114436097,0.63877688172043,44.36848958333334,1022.5260416666678,32.98471102150541,0
4248,4,0,0,35,0.0,0.0,1.0,35,1000,800,200,0.8,12,8,4,365.4606740593125,0.6926470588235294,-0.0008042996204007391,0.20951976200594966,130502.812825182,2538.729188345456,133041.54201352745,4234,1,883.2285714285714,30,5,18,35.22099447513811,0.6395833333333334,44.55645161290322,1021.7741935483863,34.05913978494621,0
4249,4,0,0,35,0.0,0.0,1.0,35,550,300,250,0.5454545454545454,8,3,5,364.49087816401624,0.6919467787114846,9.769294356343217e-05,0.20933448924162978,130571.48947855238,2518.423372644227,133089.9128511966,4235,2,884.2285714285714,30,5,19,35.17611344906189,0.6402777777777778,44.48924731182795,1022.0430107526878,34.068100358422925,0
4250,4,0,0,35,0.0,0.0,1.0,35,1050,600,450,0.5714285714285714,15,6,9,361.7767819018598,0.6927871148459384,-0.003923067125206847,0.2080812831290478,130628.37600708008,2451.662699381511,133080.03870646158,4236,3,885.2285714285714,31,4,19,35.18779454846516,0.6381048387096775,44.43359375,1022.265625,32.97631048387097,0
4251,4,0,0,35,0.0,0.0,1.0,35,550,300,250,0.5454545454545454,8,3,5,362.96820028516555,0.6901960784313725,-0.015356915522414694,0.20948679009845517,130761.51741875536,2492.4545288085883,133253.97194756396,4237,4,886.2285714285714,31,4,19,35.02241141523447,0.6394489247311828,44.303385416666664,1022.7864583333328,32.99311155913977,0
4252,4,0,0,35,0.0,0.0,1.0,35,850,500,350,0.5882352941176471,12,5,7,362.5767295640385,0.6895658263305322,-0.01743759695388536,0.20988012974192652,130875.5484134273,2490.4856647281013,133366.0340781554,4238,5,887.2285714285714,32,3,20,34.916913458374474,0.6380208333333333,44.1919191919192,1023.232323232324,31.976010101010125,0
4253,4,0,0,35,0.0,0.0,1.0,35,1200,900,300,0.75,15,9,6,364.10103951854705,0.6895658263305322,-0.0074987666502221995,0.21147071836793552,131004.77629833693,2539.795046423839,133544.57134476077,4239,6,888.2285714285714,32,3,21,34.747060516362446,0.6393229166666666,44.06565656565657,1023.737373737374,31.991792929292938,0
4254,4,1,1,35,0.027777777777777776,0.027777777777777776,0.9722222222222222,36,1000,700,300,0.7,13,7,6,354.6169608037543,0.7028769841269842,-0.0029358626919604447,0.2077042198993417,131328.1249999999,2115.033223650633,133443.15822365053,4240,0,864.5277777777778,31,5,22,34.662940379403786,0.6451612903225807,43.74999999999999,1024.9999999999993,33.064516129032235,0
4255,4,0,1,34,0.0,0.02857142857142857,0.9714285714285714,35,1000,600,400,0.6,14,6,8,357.9338539753198,0.6859243697478992,-0.03465660696657724,0.2071925680439995,130875.54841342728,2368.9578869503225,133244.5063003776,4241,1,889.9428571428572,32,3,20,35.03568196775256,0.6380208333333333,44.1919191919192,1023.2323232323239,31.97601010101012,4
4256,4,0,0,34,0.0,0.0,1.0,34,800,700,100,0.875,9,7,2,367.6151247082201,0.6717914438502675,-0.03132886509154853,0.2121687586027236,130761.51741875536,2813.982306586367,133575.49972534174,4242,9,917.0882352941177,31,3,20,34.903591130914506,0.6394489247311828,44.303385416666664,1022.7864583333328,32.99311155913977,0
4257,4,1,0,35,0.02857142857142857,0.0,1.0,35,850,700,150,0.8235294117647058,10,7,3,356.8088070117902,0.6829131652661063,-0.021310609528504276,0.20828393238083925,131198.73769258242,2362.5730155086285,133561.31070809104,4243,0,891.8571428571429,32,3,21,34.73754210829021,0.6412760416666666,43.87626262626263,1024.4949494949499,32.015467171717184,0
4258,4,1,1,35,0.027777777777777776,0.027777777777777776,0.9722222222222222,36,950,800,150,0.8421052631578947,11,8,3,346.65151077925714,0.6973875661375661,-0.022668198856329536,0.20372674171846059,131457.5760764207,1914.057239057231,133371.63331547793,4244,0,868.0555555555555,32,4,23,34.73641549700402,0.6438802083333334,43.62373737373737,1025.50505050505,32.04703282828281,0
4259,4,0,0,35,0.0,0.0,1.0,35,800,500,300,0.625,11,5,6,358.42449282460683,0.6808123249299719,-0.016149226107310843,0.21011735160149864,131361.4930046928,2416.6353013780185,133778.12830607084,4245,2,893.8571428571429,31,4,23,34.5316535416402,0.6454973118279571,43.71744791666666,1025.1302083333323,33.06871639784943,0
4260,4,0,0,35,0.0,0.0,1.0,35,850,600,250,0.7058823529411765,11,6,5,360.6560103691505,0.6800420168067226,-0.01779502711329517,0.21216485389677342,131495.0074089897,2484.892951117612,133979.90036010733,4246,3,894.8571428571429,31,4,23,34.339559265371754,0.6468413978494624,43.58723958333333,1025.6510416666658,33.08551747311825,0
4261,4,1,1,35,0.027777777777777776,0.027777777777777776,0.9722222222222222,36,750,600,150,0.8,9,6,3,348.26536900734226,0.6987103174603175,-0.01990094283327326,0.2065191455705959,131799.59518274217,1980.2469302672027,133779.84211300936,4247,0,870.9722222222222,33,3,19,34.350136253331755,0.6448863636363636,43.29044117647059,1026.8382352941173,31.116310160427798,0
4262,4,0,0,35,0.0,0.0,1.0,35,750,500,250,0.6666666666666666,10,5,5,358.0804433174813,0.6780812324929971,-0.019066359787058174,0.21205769006660147,131749.07415378527,2435.3533759310258,134184.4275297163,4248,5,896.8571428571429,32,3,20,34.1491411470504,0.6468098958333334,43.339646464646464,1026.6414141414139,32.08254419191918,0
4263,4,2,1,36,0.05405405405405406,0.02702702702702703,0.972972972972973,37,850,700,150,0.8235294117647058,10,7,3,344.4633858390647,0.7088338338338338,-0.019464963690837278,0.2070133922406955,132306.1295351476,1714.9234693877759,134021.05300453538,4249,0,849.3243243243244,34,3,21,33.93793874874642,0.6476715686274509,42.79761904761906,1028.8095238095254,30.25910364145663,0
4264,4,0,0,36,0.0,0.0,1.0,36,800,600,200,0.75,10,6,4,352.7611752442971,0.6942460317460318,-0.014087490731914176,0.21145512733215308,132208.88600538266,2127.632400999627,134336.5184063823,4250,1,873.9166666666666,33,3,22,33.82239037178263,0.648989898989899,42.892156862745104,1028.4313725490206,31.164587046940017,0
4265,4,1,0,37,0.02702702702702703,0.0,1.0,37,1050,700,350,0.6666666666666666,14,7,7,344.09092951846935,0.7056431431431431,-0.010818765785652884,0.20783092142915555,132495.48037190083,1718.3689283524204,134213.84930025326,4251,0,851.2702702702703,32,5,23,33.757205052734875,0.654296875,42.61363636363637,1029.5454545454547,32.17329545454546,0
4266,4,0,0,37,0.0,0.0,1.0,37,650,300,350,0.46153846153846156,10,3,7,358.733739163826,0.7056431431431431,0.05267486587711301,0.19954564240987824,129322.44897959188,1878.4651360544237,131200.9141156463,4252,1,852.2702702702703,34,3,19,36.592199204119844,0.6176470588235294,45.714285714285715,1017.1428571428575,29.91596638655463,5
4267,4,3,1,39,0.075,0.025,0.975,40,800,500,300,0.625,11,5,6,340.63123635867055,0.7410256410256411,0.09159327676941276,0.19422029649329953,130290.57167830483,876.2077033317913,131166.77938163662,4253,0,789.275,37,3,19,36.07012762682132,0.6213400900900901,44.76425438596491,1020.94298245614,27.593053579895678,0
4268,4,1,0,40,0.025,0.0,1.0,40,950,600,350,0.631578947368421,13,6,7,341.5270449819616,0.7459668803418803,0.08782739373121551,0.1954340264773928,130430.54112803943,909.1114573715059,131339.65258541095,4254,0,790.2,37,3,20,35.905520967511094,0.6227477477477477,44.627192982456144,1021.4912280701757,27.607871028923668,0
4269,4,0,0,40,0.0,0.0,1.0,40,1050,500,550,0.47619047619047616,16,5,11,342.6789957449945,0.7445512820512821,0.08909871244635226,0.19666060593247217,130542.57079101261,946.8394121268087,131489.4102031394,4255,1,791.2,37,3,14,35.762696709585114,0.6238738738738738,44.51754385964912,1021.9298245614034,27.61972498814604,0
4270,4,1,1,40,0.024390243902439025,0.024390243902439025,0.975609756097561,41,900,400,500,0.4444444444444444,14,4,10,335.2257507393886,0.7546747967479674,0.09884427062247436,0.19426058477511188,130917.78897518064,577.4028188691433,131495.19179404978,4256,0,772.8780487804878,38,3,15,35.573911681803935,0.6258223684210527,44.150641025641015,1023.3974358974345,26.931511470985118,0
4271,4,1,0,41,0.024390243902439025,0.0,1.0,41,1150,800,350,0.6956521739130435,15,8,7,339.73630485109015,0.7503556910569106,0.125906729326571,0.19829712511634856,131194.69536675353,714.3202039930596,131909.0155707466,4257,0,773.8048780487804,39,2,17,35.17888917132689,0.6268696581196581,43.880208333333336,1024.479166666667,26.26869658119659,0
4272,4,1,0,42,0.023809523809523808,0.0,1.0,42,750,500,250,0.6666666666666666,10,5,5,345.689296126614,0.7627758420441347,0.1633624878522839,0.19696250593260545,130262.58680555539,617.1983506944248,130879.78515624981,4258,0,756.3571428571429,36,6,15,35.96938775510203,0.6229745370370372,44.79166666666666,1020.833333333332,28.356481481481445,2
4273,4,0,0,42,0.0,0.0,1.0,42,1250,900,350,0.72,16,9,7,345.48144698366946,0.7637679055361982,0.15693702776071294,0.19742729947667872,130377.57087746495,608.6063681924779,130986.17724565743,4259,1,757.3571428571429,36,6,15,35.858189068989596,0.6241319444444446,44.679054054054035,1021.283783783781,28.368993993993918,0
4274,4,0,0,42,0.0,0.0,1.0,42,750,600,150,0.8,9,6,3,347.4543627536131,0.7652922957801006,0.1474101599198041,0.19914424720552915,130492.60567577687,668.0450298270948,131160.65070560397,4260,2,758.3571428571429,36,6,14,35.691291009956274,0.6252893518518521,44.56644144144143,1021.7342342342322,28.38150650650645,0
4275,4,1,3,40,0.023255813953488372,0.06976744186046512,0.9302325581395349,43,1250,900,350,0.72,16,9,7,340.4023567791109,0.7733480989294943,0.15151485720668045,0.19712054251694794,130890.45606874114,311.08394513841654,131201.54001387957,4261,0,741.6976744186046,38,5,14,35.469087144149796,0.6255482456140352,44.17735042735042,1023.2905982905968,26.928699955015706,0
4276,4,1,0,41,0.024390243902439025,0.0,1.0,41,1200,900,300,0.75,15,9,6,358.9760202390991,0.7496951219512195,0.1647858804067015,0.20712961981013295,130751.61944038606,1187.3391973053842,131938.95863769145,4262,0,778.5853658536586,36,5,15,35.13451515818834,0.6278935185185188,44.31306306306305,1022.7477477477456,28.4096596596596,0
4277,4,0,0,41,0.0,0.0,1.0,41,1150,900,250,0.782608695652174,14,9,5,357.7990226102241,0.7483231707317073,0.16613605493307837,0.20706763818066837,130866.81909950476,1164.803993182352,132031.6230926871,4263,1,779.5853658536586,36,5,16,35.047967569154,0.629050925925926,44.20045045045044,1023.198198198197,28.42217217217214,0
4278,4,3,0,44,0.06818181818181818,0.0,1.0,44,1100,800,300,0.7272727272727273,14,8,6,349.35443565181146,0.7685870331219169,0.20361781076066765,0.19905078310393926,130262.58680555565,328.86598591835843,130591.452791474,4264,0,727.3636363636364,37,7,19,35.875850340136054,0.6210585585585585,44.79166666666667,1020.8333333333342,27.59009009009011,3
4279,4,0,0,44,0.0,0.0,1.0,44,700,400,300,0.5714285714285714,10,4,6,352.2899762982779,0.7668472515856237,0.2118087580703376,0.20116911241012483,130348.8201038876,384.11654898140836,130732.936652869,4265,1,728.3636363636364,36,8,19,35.7134980149978,0.6238425925925927,44.707207207207205,1021.1711711711706,28.36586586586585,0
4280,4,0,1,43,0.0,0.022727272727272728,0.9772727272727273,44,1150,900,250,0.782608695652174,14,9,5,347.8257224544191,0.767419837914024,0.16438219575101742,0.1939993711373015,129428.42306193303,240.68649864528732,129669.10956057832,4266,2,729.3636363636364,41,3,15,36.7617846348835,0.6059451219512195,45.610119047619044,1017.5595238095232,24.81852497096398,6
4281,4,1,1,43,0.022727272727272728,0.022727272727272728,0.9772727272727273,44,800,500,300,0.625,11,5,6,347.54902509484344,0.7708994009866104,0.16926868804974604,0.1945933248526119,129579.88989866772,207.072881235818,129786.96277990354,4267,0,730.2954545454545,41,3,15,36.61484215141769,0.6074695121951219,45.46130952380952,1018.1547619047612,24.833042973286858,0
4282,4,1,0,44,0.022727272727272728,0.0,1.0,44,1550,1300,250,0.8387096774193549,18,13,5,359.26974419372596,0.7648211768851304,0.19761980576341331,0.20311190488576003,129958.94451530617,538.0633503401391,130497.0078656463,4268,0,731.2727272727273,41,3,18,35.931115002918844,0.6112804878048781,45.089285714285715,1019.6428571428576,24.869337979094087,0
4283,4,0,0,44,0.0,0.0,1.0,44,600,400,200,0.6666666666666666,8,4,4,360.0879649956853,0.7651294926004228,0.20252033958259674,0.20383834141826224,130009.52695893166,562.9731985386711,130572.50015747033,4269,1,732.2727272727273,41,3,19,35.858868352788605,0.6117886178861789,45.03968253968254,1019.8412698412693,24.87417731320169,0
4284,4,1,1,44,0.022222222222222223,0.022222222222222223,0.9777777777777777,45,1500,1000,500,0.6666666666666666,20,10,10,358.93981996497035,0.7726010101010101,0.20305123158585348,0.20525011804626772,130402.54122662744,362.5631716374137,130765.10439826486,4270,0,716.9777777777778,37,8,19,35.48924226158526,0.6224662162162161,44.6546052631579,1021.3815789473686,27.60490753911807,0
4285,4,2,2,44,0.043478260869565216,0.043478260869565216,0.9565217391304348,46,1050,500,550,0.47619047619047616,16,5,11,352.9065165077136,0.7839975845410628,0.21597230105573817,0.2039275736609148,130808.47447083434,32.63261103806937,130841.10708187241,4271,0,702.3478260869565,38,8,18,35.23215839860749,0.6247258771929824,44.25747863247864,1022.9700854700861,26.92026540710753,0
4286,4,1,0,45,0.022222222222222223,0.0,1.0,45,1000,700,300,0.7,13,7,6,352.3581058565565,0.7813131313131314,0.2219810040705561,0.20447868032778121,130972.46334876545,229.8418209876518,131202.3051697531,4272,0,713.2444444444444,38,7,19,35.0802804161013,0.6263706140350876,44.09722222222222,1023.6111111111113,26.937134502923982,0
4287,4,1,0,46,0.021739130434782608,0.0,1.0,46,1650,1200,450,0.7272727272727273,21,12,9,345.81431878606037,0.7871175523349436,0.2219788558715483,0.20227329412057063,131276.04683059044,-120.57265847046554,131155.47417211998,4273,0,698.7173913043479,40,6,20,34.94107827581647,0.6260416666666666,43.80081300813009,1024.7967479674812,25.619918699187032,0
4288,4,1,2,45,0.02127659574468085,0.0425531914893617,0.9574468085106383,47,1100,600,500,0.5454545454545454,16,6,10,341.3071575082805,0.7944804193647856,0.22241719675367433,0.20120151218858282,131574.63480029564,-418.49609568267675,131156.13870461297,4274,0,684.8297872340426,38,9,17,34.755414974487145,0.6324013157894738,43.50961538461537,1025.9615384615365,26.99898785425096,0
4289,4,0,0,45,0.0,0.0,1.0,45,1050,600,450,0.5714285714285714,15,6,9,313.9538252144967,0.7815656565656566,0.0882086578518384,0.1807444284681166,130664.61334019229,-795.4689643346812,129869.1443758576,4275,2,716.0444444444445,44,1,18,36.37343023606836,0.6141098484848484,44.39814814814816,1022.4074074074093,23.23653198653203,4
4290,4,0,0,45,0.0,0.0,1.0,45,1300,700,600,0.5384615384615384,19,7,12,316.677405146205,0.7811868686868687,0.09106544763284097,0.1828716829404146,130782.97432270246,-716.7974108367538,130066.17691186571,4276,3,717.0444444444445,44,1,18,36.18440904016174,0.6152935606060606,44.28240740740741,1022.8703703703715,23.247053872053897,0
4291,4,0,1,44,0.0,0.022222222222222223,0.9777777777777777,45,1700,1300,400,0.7647058823529411,21,13,8,316.13032659979746,0.7805555555555556,0.09356619310469605,0.18300451750939603,130877.70168895781,-725.1178840877587,130152.58380487005,4277,4,718.0444444444445,44,1,18,36.10287907580008,0.6162405303030302,44.18981481481483,1023.2407407407434,23.25547138047144,0
4292,4,0,0,44,0.0,0.0,1.0,44,900,400,500,0.4444444444444444,14,4,10,322.1646090534973,0.7751717758985202,0.09346801346801281,0.18586419753086428,130746.38429752104,-375.62844352613706,130370.75585399491,4278,6,735.2727272727273,43,1,18,36.08101851851852,0.6162790697674417,44.318181818181834,1022.7272727272758,23.78435517970409,0
4293,4,0,0,44,0.0,0.0,1.0,44,1300,900,400,0.6923076923076923,17,9,8,321.05205311777735,0.7747973925299507,0.09868249522704087,0.18627222985239192,130964.38573411701,-390.7230149506191,130573.66271916639,4279,7,736.2727272727273,43,1,19,35.88955577142503,0.6184593023255813,44.10511363636365,1023.5795454545477,23.804175475687156,0
4294,4,0,0,44,0.0,0.0,1.0,44,1350,1200,150,0.8888888888888888,15,12,3,323.4076578204325,0.7737403100775194,0.10366335634580959,0.18787534598047828,131012.85515847417,-325.8878737660459,130686.96728470812,4280,8,737.2727272727273,43,1,19,35.7803972805476,0.6189437984496123,44.05776515151516,1023.7689393939412,23.80857998590561,0
4295,4,0,0,44,0.0,0.0,1.0,44,900,500,400,0.5555555555555556,13,5,8,321.04530653688585,0.773850422832981,0.09687668101129665,0.1870919200163234,131134.06795225,-380.0045913682011,130754.06336088182,4281,9,738.2727272727273,43,1,19,35.71868836291914,0.6201550387596898,43.93939393939395,1024.242424242426,23.81959126145177,0
4296,4,0,0,44,0.0,0.0,1.0,44,1100,800,300,0.7272727272727273,14,8,6,319.1563779065405,0.7740045806906273,0.0960107030941515,0.18657974961246254,131255.33679300133,-421.8044256485027,130833.53236735283,4282,10,739.2727272727273,43,1,19,35.64490727905616,0.6213662790697673,43.82102272727274,1024.7159090909115,23.830602536997944,0
4297,4,1,1,44,0.022222222222222223,0.022222222222222223,0.9777777777777777,45,1000,600,400,0.6,14,6,8,309.37121358193104,0.7793350168350168,0.07574689493118458,0.18286048517074896,131675.98101075686,-834.0632139675082,130841.91779678935,4283,0,723.8222222222222,42,3,17,35.47272312437059,0.6269841269841269,43.41085271317831,1026.3565891472892,24.43706164636403,2
4298,4,0,0,44,0.0,0.0,1.0,44,1050,700,350,0.6666666666666666,14,7,7,315.95562155639516,0.7747313248766737,0.07217984992003945,0.18679296346414073,131684.26890432098,-478.7229938271587,131205.54591049382,4284,12,741.2727272727273,41,3,17,35.29544429409112,0.6285569105691057,43.40277777777778,1026.388888888889,25.03387533875339,0
4299,4,0,0,44,0.0,0.0,1.0,44,750,400,350,0.5333333333333333,11,4,7,318.67926906112183,0.7749075052854123,0.07774703557312246,0.18890781413417002,131786.11288265293,-400.4995748299417,131385.613307823,4285,13,742.2727272727273,41,3,17,35.123188405797094,0.6295731707317074,43.30357142857142,1026.7857142857133,25.043554006968616,0
4300,4,1,1,44,0.022222222222222223,0.022222222222222223,0.9777777777777777,45,1200,600,600,0.5,18,6,12,311.33522426960167,0.7781144781144782,0.08265158655356619,0.18620443796507724,132123.90049426112,-773.0351616489414,131350.8653326122,4286,0,726.7555555555556,42,3,18,34.97270656613257,0.6314484126984127,42.974806201550386,1028.1007751937982,24.478589885566624,0
4301,4,0,1,43,0.0,0.022727272727272728,0.9772727272727273,44,1750,1500,250,0.8571428571428571,20,15,5,314.34372704203815,0.7713838971106414,0.0844168079894474,0.1884996790296154,132223.54144131954,-487.2718361276521,131736.2696051919,4287,1,743.5909090909091,42,2,19,34.7954352741662,0.6324404761904763,42.87790697674418,1028.4883720930225,24.487818383167202,0
4302,4,0,0,43,0.0,0.0,1.0,43,1350,900,450,0.6666666666666666,18,9,9,316.51067875231496,0.7733019564414912,0.07739384238772207,0.1906783845166388,132398.00347222234,-218.80859022894572,132179.1948819934,4288,2,751.1627906976744,40,3,20,34.564777327935225,0.6372395833333333,42.708333333333336,1029.1666666666674,25.729166666666686,0
4303,4,1,1,43,0.022727272727272728,0.022727272727272728,0.9772727272727273,44,1150,700,450,0.6086956521739131,16,7,9,310.7160085388516,0.7798185341789994,0.0776053748851051,0.18859063405470342,132678.92696719893,-554.906679106826,132124.0202880921,4289,0,735.0681818181819,41,3,16,34.43257502808538,0.6384654471544715,42.43551587301587,1030.2579365079368,25.12824235385212,0
4304,4,0,0,43,0.0,0.0,1.0,43,1250,600,650,0.48,19,6,13,313.98727239136286,0.773624953857512,0.0815935327115358,0.19057614399674488,132678.92696719893,-268.10112355127006,132410.82584364768,4290,4,753.1627906976744,41,2,17,34.348318889423844,0.6384654471544715,42.43551587301587,1030.2579365079368,25.12824235385212,0
4305,4,0,0,43,0.0,0.0,1.0,43,1350,1100,250,0.8148148148148148,16,11,5,313.1334413437855,0.7727482465854558,0.08731899956121048,0.19044673235826956,132755.59413580247,-285.95679012346324,132469.63734567902,4291,5,754.1627906976744,41,2,17,34.29357592093441,0.6392276422764227,42.36111111111111,1030.5555555555554,25.135501355013545,0
4306,4,0,0,43,0.0,0.0,1.0,43,1450,1000,450,0.6896551724137931,19,10,9,310.89542801142414,0.7710409745293466,0.08748137043657644,0.18992819431099753,132922.079690223,-335.026628507892,132587.05306171512,4292,6,755.1627906976744,42,1,17,34.184716218755895,0.6393849206349207,42.19961240310078,1031.2015503875975,24.55241786637137,0
4307,4,0,0,43,0.0,0.0,1.0,43,1000,800,200,0.8,12,8,4,307.9988907129419,0.7704411221853082,0.08972440385812708,0.18853641125010157,132997.03222650386,-407.4123212246854,132589.61990527916,4293,7,756.1627906976744,42,1,17,34.184476279943645,0.6401289682539681,42.126937984496124,1031.4922480620157,24.559339239571802,0
4308,4,0,0,43,0.0,0.0,1.0,43,1050,700,350,0.6666666666666666,14,7,7,311.11961958060397,0.7715023994093761,0.11212043298886365,0.18466756950302105,131835.77609592033,-394.118502552505,131441.65759336783,4294,8,757.1627906976744,39,4,18,35.26737414206985,0.6332799145299145,43.25520833333334,1026.9791666666683,26.332799145299187,4
4309,4,0,0,43,0.0,0.0,1.0,43,1200,800,400,0.6666666666666666,16,8,8,310.8864777038087,0.7719176818014027,0.11562580331727279,0.18478912336571776,131889.27001953125,-399.4818793402777,131489.78814019097,4295,9,758.1627906976744,39,4,18,35.21965740459047,0.6338141025641025,43.203125,1027.1875,26.338141025641026,0
4310,4,1,2,42,0.022727272727272728,0.045454545454545456,0.9545454545454546,44,1200,500,700,0.4166666666666667,19,5,14,301.5022690377552,0.7807875264270614,0.11357349427888841,0.1810086576038054,132267.2981112434,-824.2218999933752,131443.07621125004,4296,0,741.9090909090909,40,4,18,35.08179378251992,0.6359374999999999,42.835365853658544,1028.6585365853668,25.71646341463417,0
4311,4,0,1,41,0.0,0.023809523809523808,0.9761904761904762,42,750,400,350,0.5333333333333333,11,4,7,313.62308254200155,0.7645663956639567,0.11113256113256131,0.1871621621621622,132040.8950617284,-117.78549382715812,131923.10956790124,4297,11,777.1190476190476,38,4,18,34.99718468468469,0.6370614035087719,43.05555555555556,1027.7777777777778,27.046783625730995,0
4312,4,0,0,41,0.0,0.0,1.0,41,1400,1000,400,0.7142857142857143,18,10,8,319.10595648679816,0.7585365853658537,0.11548282236123097,0.19029635433642358,132013.44515897808,225.2553373146397,132238.70049629273,4298,12,796.0,38,3,18,34.88386699934159,0.6367872807017543,43.08226495726496,1027.6709401709406,27.043972109761597,0
4313,4,0,0,41,0.0,0.0,1.0,41,700,300,400,0.42857142857142855,11,3,8,318.40961013917007,0.7594512195121951,0.11333275876928406,0.19029424029559588,132095.8034279348,212.11465410182757,132307.91808203663,4299,13,797.0,38,3,18,34.81907780780156,0.637609649122807,43.00213675213675,1027.9914529914524,27.052406657669803,0
4314,4,0,0,41,0.0,0.0,1.0,41,1250,1000,250,0.8,15,10,5,322.94258628189834,0.7596544715447154,0.12015222998687491,0.19356446672164104,132205.6544031705,338.96719081014595,132544.62159398067,4300,14,798.0,38,3,18,34.59229344137407,0.6387061403508771,42.89529914529915,1028.418803418804,27.06365272154747,0
4315,4,0,1,40,0.0,0.024390243902439025,0.975609756097561,41,1100,800,300,0.7272727272727273,14,8,6,325.4899923792099,0.7573678861788617,0.1258078891900023,0.1958161718858888,132345.7135819456,415.4410610417355,132761.15464298733,4301,15,799.0,40,1,19,34.386213991769544,0.6367187499999998,42.75914634146343,1028.9634146341489,25.72408536585372,0
4316,4,0,0,40,0.0,0.0,1.0,40,1300,1100,200,0.8461538461538461,15,11,4,332.3495671970343,0.7572649572649572,0.12056500607533427,0.19965233124318194,132290.82031250012,793.3593750000144,133084.17968750012,4302,16,800.3,39,1,19,34.26488456865128,0.6378205128205128,42.81250000000001,1028.750000000001,26.378205128205153,0
4317,4,2,1,41,0.047619047619047616,0.023809523809523808,0.9761904761904762,42,1200,1000,200,0.8333333333333334,14,10,4,316.5918388466728,0.7673732094463802,0.12850862531781493,0.19303479045631772,132849.7770948754,12.004655278556072,132861.78175015395,4303,0,763.1428571428571,37,5,20,34.110207048145796,0.6469594594594594,42.26973684210527,1030.9210526315794,27.862731152204848,0
4318,4,0,0,41,0.0,0.0,1.0,41,750,400,350,0.5333333333333333,11,4,7,336.69304456476453,0.7630081300813009,0.15788949726231927,0.1918367346938776,130262.58680555565,573.1561634349123,130835.74296899055,4304,1,781.9024390243902,37,4,20,36.19897959183674,0.6210585585585585,44.79166666666667,1020.8333333333342,27.59009009009011,4
4319,4,2,2,41,0.046511627906976744,0.046511627906976744,0.9534883720930233,43,950,600,350,0.631578947368421,13,6,7,319.5861107317667,0.7801310446659283,0.15102188415736584,0.18407291430350373,130682.67549871115,-247.12639946907018,130435.54909924208,4305,0,746.4883720930233,37,6,15,36.21123771224306,0.6252815315315314,44.38048245614035,1022.4780701754387,27.63454243717402,0
4320,4,0,0,41,0.0,0.0,1.0,41,700,600,100,0.8571428571428571,8,6,2,335.0187546645911,0.7625,0.16493056035376252,0.19160988398671516,130410.31867551865,537.9805116169405,130948.29918713559,4306,3,783.9024390243902,35,6,20,36.092186024551474,0.6264880952380951,44.64699074074074,1021.4120370370367,29.18320105820105,0
4321,4,1,1,41,0.023809523809523808,0.023809523809523808,0.9761904761904762,42,1050,700,350,0.6666666666666666,14,7,7,330.1057186156975,0.7694057297715834,0.16582737964099503,0.18990492481579868,130636.47050766984,224.7691948705497,130861.23970254039,4307,0,766.2142857142857,36,6,16,35.98902107659545,0.6267361111111112,44.42567567567568,1022.2972972972974,28.39714714714715,0
4322,4,1,1,41,0.023809523809523808,0.023809523809523808,0.9761904761904762,42,650,500,150,0.7692307692307693,8,5,3,331.02571175998844,0.7689459930313589,0.17000697426861922,0.1908599675233306,130722.82745160707,254.52340008928095,130977.35085169635,4308,0,767.1904761904761,36,6,16,35.8782531292442,0.6276041666666666,44.34121621621622,1022.6351351351356,28.40653153153154,0
4323,4,0,0,41,0.0,0.0,1.0,41,900,600,300,0.6666666666666666,12,6,6,342.5921175137857,0.7603658536585366,0.18216903391444794,0.1974430109741876,130706.0335889274,755.7713638117231,131461.80495273913,4309,6,786.9024390243902,35,6,17,35.59953310696095,0.6294642857142857,44.357638888888886,1022.5694444444439,29.216269841269824,0
4324,4,1,0,42,0.023809523809523808,0.0,1.0,42,1000,700,300,0.7,13,7,6,333.3501460412952,0.7680507162214479,0.18262465585806087,0.19410787805646468,131103.44048168653,340.6702062172817,131444.1106879038,4310,0,769.1428571428571,37,5,18,35.434511063526045,0.6295045045045045,43.96929824561403,1024.1228070175428,27.678994784257913,0
4325,4,0,0,42,0.0,0.0,1.0,42,1000,800,200,0.8,12,8,4,329.0414318330255,0.7679539295392954,0.18269614892937014,0.1850082012947954,129745.05077069173,159.5079045208577,129904.55867521258,4311,1,770.1428571428571,38,4,15,36.918431907158826,0.6140350877192983,45.299145299145295,1018.8034188034183,26.81061628430048,4
4326,4,0,0,42,0.0,0.0,1.0,42,1350,900,450,0.6666666666666666,18,9,9,330.45419049430126,0.7679297328687572,0.18134018097334303,0.1864496411298717,129881.14458917748,183.95369913799146,130065.09828831546,4312,2,771.1428571428571,38,4,17,36.74448869790028,0.6154057017543859,45.16559829059829,1019.3376068376072,26.824673864147556,0
4327,4,1,0,43,0.023255813953488372,0.0,1.0,43,1150,900,250,0.782608695652174,14,9,5,324.15001148818607,0.776531930601698,0.18372496563969465,0.18431211042076381,130182.84640842024,-160.24576822915628,130022.60064019109,4313,0,754.1860465116279,39,4,19,36.59974567044334,0.6167200854700854,44.86979166666667,1020.5208333333342,26.167200854700877,0
4328,4,3,4,42,0.06521739130434782,0.08695652173913043,0.9130434782608696,46,1050,900,150,0.8571428571428571,12,9,3,303.3590664800669,0.8015499194847021,0.17130576434446199,0.17547660488617306,130848.09570312512,-1261.1355251735968,129586.96017795152,4314,0,705.9347826086956,39,7,15,36.459393877689536,0.6233974358974359,44.21875000000001,1023.1250000000009,26.233974358974383,0
4329,4,0,0,42,0.0,0.0,1.0,42,1050,700,350,0.6666666666666666,14,7,7,330.18090814269095,0.7748741773132017,0.18251089121738762,0.18826928188278447,130292.12648158861,203.99452910665264,130496.12101069526,4315,1,773.8809523809524,35,7,19,36.33528417035106,0.6252976190476189,44.76273148148148,1020.9490740740737,29.169973544973534,0
4330,4,0,0,42,0.0,0.0,1.0,42,1200,800,400,0.6666666666666666,16,8,8,330.91157471299323,0.7749951606658924,0.18164745499287682,0.1891168222323479,130380.7656035665,228.90089163236996,130609.66649519886,4316,2,774.8809523809524,35,7,19,36.226956784527054,0.6261904761904762,44.675925925925924,1021.2962962962961,29.179894179894173,0
4331,4,3,2,43,0.06666666666666667,0.044444444444444446,0.9555555555555556,45,1100,600,500,0.5454545454545454,16,6,10,310.9621627061234,0.7936447811447812,0.19112196003977955,0.18112440661887497,131114.67013888905,-845.6597222222023,130269.01041666685,4317,0,724.1555555555556,39,6,18,35.99640629237864,0.6260683760683761,43.95833333333334,1024.166666666668,26.260683760683797,0
4332,4,0,0,43,0.0,0.0,1.0,43,850,400,450,0.47058823529411764,13,4,9,326.4373599052518,0.7815153193060169,0.20423154647549735,0.18911482805684138,130906.99932912047,-53.41294917667062,130853.58637994381,4318,1,758.8372093023256,37,6,18,35.80964945176614,0.6275337837837838,44.161184210526315,1023.3552631578945,27.65825035561877,0
4333,4,0,0,43,0.0,0.0,1.0,43,800,500,300,0.625,11,5,6,325.73363086806603,0.7812846068660022,0.20258775549837305,0.18889395785206262,130945.12473518889,-69.35381510701762,130875.77092008186,4319,2,759.8372093023256,38,5,19,35.7891875434934,0.6260964912280702,44.123931623931625,1023.504273504274,26.93432298695458,0
4334,4,0,0,43,0.0,0.0,1.0,43,1350,1000,350,0.7407407407407407,17,10,7,326.7100013590846,0.7809154669619786,0.20502876945365966,0.18986427792747754,131027.14913662418,-38.42398549931647,130988.72515112486,4320,3,760.8372093023256,38,5,19,35.68145848551254,0.6269188596491229,44.043803418803414,1023.8247863247854,26.94275753486277,0
4335,4,0,0,43,0.0,0.0,1.0,43,1100,700,400,0.6363636363636364,15,7,8,327.95741357017295,0.7806386120339608,0.20289059857764147,0.19115620910702508,131141.34250217027,1.755099826398407,131143.09760199668,4321,4,761.8372093023256,39,4,20,35.53436133428251,0.62633547008547,43.93229166666667,1024.2708333333344,26.263354700854727,0
4336,4,0,0,43,0.0,0.0,1.0,43,1200,1000,200,0.8333333333333334,14,10,4,331.76059551150837,0.7799003322259136,0.21111523434268475,0.19418158829492735,131301.43364800335,112.1283637152734,131413.56201171863,4322,5,762.8372093023256,39,4,20,35.27554036656843,0.6279380341880343,43.776041666666664,1024.8958333333326,26.279380341880323,0
4337,4,1,1,43,0.022727272727272728,0.022727272727272728,0.9772727272727273,44,1000,600,400,0.6,14,6,8,322.17132375534294,0.7858306906272022,0.21121937476927855,0.1900932690859079,131609.25116381957,-319.8465287997343,131289.40463501983,4323,0,746.4772727272727,37,7,18,35.21140557099096,0.6345720720720721,43.47587719298245,1026.0964912280697,27.73233760075864,0
4338,4,2,0,45,0.044444444444444446,0.0,1.0,45,1250,700,550,0.56,18,7,11,328.46254008233115,0.7936447811447812,0.2532954903815827,0.1817722015010597,129119.93805473378,-513.0744456418977,128606.86360909189,4324,0,730.8444444444444,38,7,18,37.567670556081154,0.6077302631578947,45.91346153846154,1016.3461538461543,26.74595141700406,6
4339,4,2,1,46,0.0425531914893617,0.02127659574468085,0.9787234042553191,47,1000,700,300,0.7,13,7,6,315.89839661936065,0.8056968855997533,0.2564709243667467,0.17712608921033793,129636.22708013741,-1209.573380086194,128426.65370005122,4325,0,700.7021276595744,38,9,15,37.3633987270947,0.612938596491228,45.40598290598291,1018.3760683760689,26.799370220422865,0
4340,4,0,0,46,0.0,0.0,1.0,46,1200,900,300,0.75,15,9,6,320.3214900350675,0.8005636070853462,0.2553715602345312,0.17914847671599798,129536.03512619268,-901.3648430286239,128634.67028316406,4326,1,716.9347826086956,37,9,15,37.35234453540139,0.6137387387387387,45.50438596491228,1017.9824561403509,27.51303935514462,0
4341,4,0,0,46,0.0,0.0,1.0,46,1400,1200,200,0.8571428571428571,16,12,4,318.97548150077046,0.7997383252818036,0.2531269894768373,0.17890363962434513,129647.68005540161,-929.1137657740912,128718.56628962752,4327,2,717.9347826086956,37,9,16,37.27345320126327,0.6148648648648649,45.39473684210526,1018.4210526315785,27.524893314366988,0
4342,4,1,0,47,0.02127659574468085,0.0,1.0,47,1150,500,650,0.43478260869565216,18,5,13,312.4262251369928,0.8049259944495837,0.25707139162847104,0.17664667610826185,129962.83512309153,-1279.2404028782241,128683.59472021331,4328,0,703.6382978723404,38,9,17,37.121271654093306,0.6162280701754386,45.085470085470085,1019.6581196581196,26.83310841205578,0
4343,4,0,0,47,0.0,0.0,1.0,47,800,300,500,0.375,13,3,10,310.8037338979298,0.8027289546716003,0.2524463412991096,0.17600227637909938,130023.4388563367,-1317.6459418402828,128705.79291449641,4329,1,704.6382978723404,39,8,17,37.10135583699317,0.6151175213675215,45.026041666666664,1019.8958333333325,26.15117521367519,0
4344,4,2,1,48,0.04081632653061224,0.02040816326530612,0.9795918367346939,49,1550,1000,550,0.6451612903225806,21,10,11,299.97613682230883,0.8195861678004536,0.25173587142776044,0.17171754711491122,130444.20070725067,-1973.7507936305317,128470.44991362013,4330,0,676.8367346938776,40,9,18,36.95284520493435,0.6177083333333334,44.61382113821137,1021.544715447152,25.538617886178802,0
4345,4,1,2,47,0.02040816326530612,0.04081632653061224,0.9591836734693877,49,1050,800,250,0.7619047619047619,13,8,5,300.15498117921885,0.8172831632653061,0.2466065873500647,0.17239626760247848,130574.0023816013,-1961.512554531053,128612.48982707024,4331,0,677.8163265306123,40,9,15,36.81743230254219,0.6190104166666668,44.48678861788617,1022.0528455284532,25.55132113821133,0
4346,4,0,0,47,0.0,0.0,1.0,47,1500,1300,200,0.8666666666666667,17,13,4,315.62494529157425,0.8015340733888374,0.254050565298674,0.18046498068106728,130398.95171305402,-1168.5675998977554,129230.38411315627,4332,4,707.6382978723404,38,9,19,36.5988929567643,0.6206140350877194,44.658119658119645,1021.3675213675192,26.878092667566296,0
4347,4,1,1,47,0.020833333333333332,0.020833333333333332,0.9791666666666666,48,900,600,300,0.6666666666666666,12,6,6,309.3990032414196,0.8076425827423168,0.24428112899938892,0.17798603855869222,130635.03146701379,-1516.3302951388998,129118.70117187488,4333,0,693.875,39,9,16,36.51968276611644,0.6212606837606838,44.42708333333333,1022.2916666666658,26.212606837606817,0
4348,4,0,0,47,0.0,0.0,1.0,47,1350,1000,350,0.7407407407407407,17,10,7,321.13270364054256,0.8020736971939562,0.2548788054682656,0.18452111565940346,130589.98243343178,-1012.6571745562271,129577.32525887556,4334,6,709.6382978723404,38,9,17,36.26528692380057,0.6225328947368423,44.47115384615384,1022.1153846153833,26.89777327935219,0
4349,4,0,0,47,0.0,0.0,1.0,47,1350,1000,350,0.7407407407407407,17,10,7,319.5298867727323,0.8009559050262103,0.2507831292194922,0.1846376486942777,130807.80805902541,-1040.5991803820793,129767.20887864333,4335,7,710.6382978723404,40,7,17,36.08641300748394,0.6213541666666668,44.2581300813008,1022.9674796747944,25.57418699186986,0
4350,4,1,0,48,0.020833333333333332,0.0,1.0,48,1050,700,350,0.6666666666666666,14,7,7,314.54164413196355,0.8057402482269503,0.24905523255813966,0.18277419861722166,131023.24263038514,-1357.546768707521,129665.69586167762,4336,0,696.8125,41,7,18,35.99685077519378,0.6219512195121952,44.04761904761903,1023.809523809521,24.97096399535417,0
4351,4,0,0,48,0.0,0.0,1.0,48,1000,600,400,0.6,14,6,8,316.2188652260545,0.806035756501182,0.24512153786558333,0.18447887018780934,131175.63952664338,-1303.9576247166083,129871.68190192677,4337,1,697.8125,41,7,18,35.80040674026729,0.6234756097560978,43.8988095238095,1024.4047619047572,24.985481997677002,0
4352,4,0,1,47,0.0,0.020833333333333332,0.9791666666666666,48,1250,1100,150,0.88,14,11,3,314.9485414425441,0.8062573877068557,0.24364187967983542,0.1839812520372504,131226.45817586244,-1334.083679768251,129892.37449609418,4338,2,698.8125,41,7,18,35.78177446423962,0.6239837398373986,43.84920634920633,1024.6031746031706,24.99032133178465,0
4353,4,0,0,47,0.0,0.0,1.0,47,1000,500,500,0.5,15,5,10,321.41133529420574,0.79563675609004,0.24810129711224138,0.18788102333072138,131251.87119118462,-962.8321641156672,130289.03902706895,4339,3,714.3829787234042,41,6,18,35.59063074837835,0.6242378048780489,43.82440476190475,1024.7023809523794,24.99274099883852,0
4354,4,0,0,47,0.0,0.0,1.0,47,1350,900,450,0.6666666666666666,18,9,9,318.3749729146562,0.7962920135676842,0.24462510551835392,0.18688790782956374,131412.4312889543,-1032.225572448504,130380.2057165058,4340,4,715.3829787234042,37,10,19,35.5067862617189,0.6326013513513513,43.66776315789474,1025.3289473684213,27.711593172119493,0
4355,4,0,0,47,0.0,0.0,1.0,47,1150,900,250,0.782608695652174,14,9,5,316.7695312500001,0.7961763798951588,0.23881648936170263,0.18633501838235295,131492.43918474688,-1069.4403353057187,130422.99884944117,4341,5,716.3829787234042,38,9,19,35.467447916666664,0.631578947368421,43.58974358974359,1025.6410256410256,26.99055330634278,0
4356,4,1,1,47,0.020833333333333332,0.020833333333333332,0.9791666666666666,48,1050,600,450,0.5714285714285714,15,6,9,311.2235949715004,0.8003287529550828,0.23458527760871029,0.18459941030259044,131809.03320312515,-1395.5837673610972,130413.44943576405,4342,0,702.4375,39,9,12,35.291556772841,0.6330128205128205,43.28125000000001,1026.8750000000011,26.330128205128233,0
4357,4,0,0,47,0.0,0.0,1.0,47,1050,600,450,0.5714285714285714,15,6,9,319.55192646918476,0.7952513105149552,0.23491274802213358,0.18919127920162662,131739.10307774507,-980.5031640367981,130758.59991370827,4343,7,718.3829787234042,38,9,12,35.1480382974295,0.6340460526315788,43.349358974358985,1026.6025641025656,27.015856950067516,0
4358,4,0,0,47,0.0,0.0,1.0,47,850,400,450,0.47058823529411764,13,4,9,318.4263270678195,0.7954440333024976,0.23185068744880066,0.18866072768938036,131766.52444480988,-1008.4139181094145,130758.11052670046,4344,8,719.3829787234042,38,9,12,35.14936697884147,0.6343201754385963,43.32264957264958,1026.7094017094032,27.018668466036928,0
4359,4,0,0,47,0.0,0.0,1.0,47,850,400,450,0.47058823529411764,13,4,9,318.28049747172065,0.7954054887449892,0.23241542824379002,0.1887102937199699,131793.94866544328,-1010.5112910000457,130783.43737444324,4345,9,720.3829787234042,38,9,12,35.12555058439982,0.6345942982456139,43.295940170940185,1026.816239316241,27.021479982006344,0
4360,4,1,0,48,0.020833333333333332,0.0,1.0,48,1400,1000,400,0.7142857142857143,18,10,8,310.3145761810346,0.7988696808510638,0.23162857673727189,0.18523133231568506,132049.81689453154,-1404.6034071180266,130645.21348741351,4346,0,706.3541666666666,39,9,13,35.07324499172324,0.6354166666666665,43.046875000000014,1027.8125000000023,26.354166666666725,0
4361,4,0,2,46,0.0,0.041666666666666664,0.9583333333333334,48,850,600,250,0.7058823529411765,11,6,5,314.0223481127868,0.7980755023640662,0.22954552941951611,0.1880046223790048,132162.78029777278,-1299.5866795557893,130863.19361821699,4347,1,707.3541666666666,40,8,16,34.864638927324236,0.6348958333333332,42.936991869918714,1028.2520325203275,25.706300813008188,2
4362,4,0,0,46,0.0,0.0,1.0,46,950,600,350,0.631578947368421,13,6,7,328.09985796957466,0.7873188405797101,0.246556698903045,0.19548719292459485,131979.9735297279,-539.4778860135964,131440.4956437143,4348,2,738.4565217391304,40,6,17,34.68643886196552,0.6330729166666667,43.11483739837399,1027.5406504065058,25.688516260162647,0
4363,4,0,0,46,0.0,0.0,1.0,46,1250,700,550,0.56,18,7,11,326.00358937722297,0.7860305958132046,0.24810800589623128,0.19504307000173685,132136.6572993095,-584.5950864233988,131552.0622128861,4349,3,739.4565217391304,40,6,17,34.58288030048435,0.6346354166666666,42.96239837398375,1028.150406504067,25.703760162601675,0
4364,4,1,0,47,0.02127659574468085,0.0,1.0,47,850,500,350,0.5882352941176471,12,5,7,321.16640801858614,0.7883518347209374,0.26151136603409597,0.1937586351672569,132451.611328125,-891.6819583353988,131559.9293697896,4350,0,724.7021276595744,39,8,19,34.3912332186467,0.639423076923077,42.65625,1029.375,26.39423076923077,0
4365,4,0,0,47,0.0,0.0,1.0,47,1000,700,300,0.7,13,7,6,319.8882801055233,0.7885060129509712,0.2602864140564134,0.1935382825656796,132558.85959201396,-919.1948784722169,131639.66471354174,4351,1,725.7021276595744,39,8,20,34.31662620540832,0.6404914529914529,42.552083333333336,1029.7916666666672,26.404914529914542,0
4366,4,0,0,47,0.0,0.0,1.0,47,1250,1000,250,0.8,15,10,5,320.7215243055584,0.7880434782608695,0.261208878907754,0.19473643934354068,132692.98095703128,-888.5009765624991,131804.47998046878,4352,2,726.7021276595744,39,8,12,34.16079011222323,0.6418269230769231,42.421875,1030.3125000000002,26.418269230769237,0
4367,4,0,0,47,0.0,0.0,1.0,47,1150,700,450,0.6086956521739131,16,7,9,322.8715443230288,0.7879663891458526,0.2692322216021854,0.196552413116696,132790.50684942814,-825.1447964174899,131965.36205301064,4353,3,727.7021276595744,40,7,13,34.00771544074146,0.6411458333333334,42.32723577235772,1030.6910569105682,25.767276422764205,0
4368,4,0,0,47,0.0,0.0,1.0,47,1400,1000,400,0.7142857142857143,18,10,8,326.0610303117754,0.7881591119333949,0.26911202094100295,0.1987718204016015,132842.8845264062,-737.022440346361,132105.86208605985,4354,4,728.7021276595744,40,7,14,33.873061251314404,0.6416666666666667,42.27642276422764,1030.894308943089,25.772357723577226,0
4369,4,0,0,47,0.0,0.0,1.0,47,2000,1600,400,0.8,24,16,8,323.92612998673604,0.7877736663583101,0.2597893831936384,0.19795485721411643,132934.5703125,-787.8038194444448,132146.76649305556,4355,5,729.7021276595744,41,6,14,33.83627946127946,0.6410060975609756,42.1875,1031.25,25.152439024390244,0
4370,4,0,0,47,0.0,0.0,1.0,47,900,500,400,0.5555555555555556,13,5,8,326.0369012713531,0.7855766265803268,0.26401065568907,0.19979126318920437,133036.8965439184,-725.0124992126603,132311.88404470574,4356,6,730.7021276595744,41,6,15,33.679420296823416,0.6420223577235773,42.088293650793645,1031.6468253968246,25.162117692605477,0
4371,4,0,0,47,0.0,0.0,1.0,47,1150,800,350,0.6956521739130435,15,8,7,324.4983831245216,0.7846901017576318,0.2680639316655913,0.19943636922442481,133147.00067791907,-758.8027124271275,132388.19796549194,4357,7,731.7021276595744,42,5,15,33.60893343348042,0.6416170634920635,41.981589147286826,1032.0736434108535,24.573181985972703,0
4372,4,0,0,47,0.0,0.0,1.0,47,1200,900,300,0.75,15,9,6,326.3434831214018,0.7844202898550724,0.2717164878138416,0.20083981084299796,133197.0089406436,-706.4048321915748,132490.60410845204,4358,8,732.7021276595744,42,5,16,33.511295722644626,0.6421130952380952,41.93313953488372,1032.2674418604652,24.57779623477298,0
4373,4,0,0,47,0.0,0.0,1.0,47,1200,700,500,0.5833333333333334,17,7,10,326.3434831214018,0.78422756706753,0.2717164878138416,0.20083981084299796,133197.0089406436,-706.4048321915748,132490.60410845204,4359,9,733.7021276595744,42,5,16,33.511295722644626,0.6421130952380952,41.93313953488372,1032.2674418604652,24.57779623477298,0
4374,4,0,1,46,0.0,0.02127659574468085,0.9787234042553191,47,1150,800,350,0.6956521739130435,15,8,7,335.029985560492,0.7840733888374961,0.21337811455610312,0.19064095638530665,130211.95515243139,-668.1731929245852,129543.7819595068,4360,10,734.7021276595744,41,6,14,36.29268727319854,0.6138211382113821,44.84126984126984,1020.6349206349211,24.893534649632223,7
4375,4,0,0,46,0.0,0.0,1.0,46,1300,900,400,0.6923076923076923,17,9,8,336.6569848718997,0.7851851851851852,0.21085182243701261,0.19206616897458947,130313.22830057956,-425.82829428067123,129887.40000629889,4361,11,739.4347826086956,41,5,14,36.14862676512501,0.6148373983739837,44.742063492063494,1021.0317460317466,24.903213317847477,0
4376,4,3,2,47,0.061224489795918366,0.04081632653061224,0.9591836734693877,49,1550,1200,350,0.7741935483870968,19,12,7,317.7884691717435,0.8068664965986395,0.20174367819700478,0.18396439878559148,130877.70168895766,-1481.7151063099939,129395.98658264767,4362,0,695.1020408163265,44,5,12,36.06046209996081,0.6162405303030303,44.189814814814824,1023.2407407407422,23.255471380471416,0
4377,4,1,0,48,0.020833333333333332,0.0,1.0,48,1150,900,250,0.782608695652174,14,9,5,322.2128168763458,0.7981493794326241,0.2064842665432678,0.1864761374584313,130867.4737879504,-1166.5645266586394,129700.90926129176,4363,0,710.5625,43,5,14,35.95760064784823,0.6174903100775193,44.1998106060606,1023.2007575757565,23.79536645525015,0
4378,4,0,0,48,0.0,0.0,1.0,48,950,500,450,0.5263157894736842,14,5,9,324.33688125307856,0.7983894799054373,0.20824080927707866,0.1880597109754974,130940.15438475658,-1106.2557392102922,129833.89864554629,4364,1,711.5625,43,5,15,35.82994078460399,0.6182170542635659,44.128787878787875,1023.4848484848478,23.801973220577857,0
4379,4,2,0,50,0.04,0.0,1.0,50,1300,800,500,0.6153846153846154,18,8,10,315.11696606763013,0.8120918367346939,0.22163641289623404,0.184912038434916,131399.31520061716,-1718.1953690950018,129681.11983152216,4365,0,684.06,44,6,17,35.60349498780817,0.6214488636363636,43.68055555555555,1025.2777777777767,23.301767676767653,0
4380,4,0,0,50,0.0,0.0,1.0,50,1700,1300,400,0.7647058823529411,21,13,8,316.8815879516501,0.8115646258503401,0.22490658001624708,0.18664173912367502,131541.75347222202,-1663.3680555555743,129878.38541666644,4366,1,685.06,44,6,17,35.41497427565664,0.6228693181818183,43.54166666666666,1025.8333333333317,23.314393939393902,0
4381,4,0,1,49,0.0,0.02,0.98,50,900,700,200,0.7777777777777778,11,7,4,317.6288546943722,0.8111224489795918,0.22664560960202196,0.18731481313828272,131589.25004286665,-1640.691443758595,129948.55859910806,4367,2,686.06,44,6,11,35.348043197064044,0.6233428030303032,43.49537037037036,1026.0185185185164,23.318602693602646,0
4382,4,0,1,48,0.0,0.02040816326530612,0.9795918367346939,49,950,600,350,0.631578947368421,13,6,7,321.16496695097385,0.8141298185941044,0.22647463893532893,0.18975439731794183,131660.5109739367,-1343.0512688614724,130317.45970507523,4368,3,696.5918367346939,44,5,11,35.18566552387826,0.6240530303030304,43.42592592592592,1026.2962962962947,23.324915824915788,0
4383,4,0,3,45,0.0,0.0625,0.9375,48,1000,800,200,0.8,12,8,4,330.01799624326355,0.8120197990543735,0.2387888499492763,0.19564708219057964,131789.58553037452,-901.413011507139,130888.17251886737,4369,4,710.3958333333334,43,5,11,34.82863368071567,0.6266957364341086,43.300189393939384,1026.7992424242404,23.87905214940094,0
4384,4,0,0,45,0.0,0.0,1.0,45,1000,800,200,0.8,12,8,4,338.00055644311874,0.8029040404040404,0.22863648568820172,0.19969250464900393,131658.81406092507,-99.84951735326115,131558.9645435718,4370,5,738.0444444444445,41,4,11,34.75541727082326,0.6283028455284554,43.42757936507935,1026.2896825396806,25.031455671699526,0
4385,4,1,0,46,0.021739130434782608,0.0,1.0,46,1200,800,400,0.6666666666666666,16,8,8,345.4479077491109,0.8094605475040257,0.24587262581726832,0.1970943184957381,130315.76063368037,-190.33085022205768,130125.42978345831,4371,0,722.9782608695652,39,7,15,35.92166564646671,0.6180555555555557,44.73958333333332,1021.0416666666652,26.180555555555518,2
4386,4,0,1,45,0.0,0.021739130434782608,0.9782608695652174,46,1300,800,500,0.6153846153846154,18,8,10,345.49995649913666,0.8067028985507246,0.2448040176058366,0.1980718336236137,130501.95448133677,-182.3160807291697,130319.6384006076,4372,1,723.9782608695652,39,7,14,35.73174720494783,0.6199252136752137,44.557291666666664,1021.770833333333,26.19925213675213,0
4387,4,1,0,46,0.021739130434782608,0.0,1.0,46,1250,800,450,0.64,17,8,9,346.2087331890615,0.80829307568438,0.2462180779197769,0.19929845843112237,130661.6550021701,-152.75878906250517,130508.8962131076,4373,0,724.7391304347826,39,7,15,35.551982509763974,0.6215277777777778,44.401041666666664,1022.3958333333329,26.215277777777768,0
4388,4,0,0,46,0.0,0.0,1.0,46,950,500,450,0.5263157894736842,14,5,9,345.0707438578737,0.8083132045088567,0.2453289648454795,0.19932910027554807,130794.81336805546,-173.30729166667544,130621.50607638879,4374,1,725.7391304347826,39,7,15,35.44636795655125,0.6228632478632479,44.27083333333333,1022.9166666666658,26.228632478632456,0
4389,4,0,0,46,0.0,0.0,1.0,46,900,400,500,0.4444444444444444,14,4,10,345.6798693279478,0.8075281803542673,0.2458582120931796,0.2000950710906558,130874.74093967004,-151.84733072917592,130722.89360894087,4375,2,726.7391304347826,39,7,15,35.349965217686375,0.62366452991453,44.19270833333333,1023.2291666666658,26.236645299145277,0
4390,4,0,1,45,0.0,0.021739130434782608,0.9782608695652174,46,1700,1400,300,0.8235294117647058,20,14,6,347.6331725066806,0.8086553945249597,0.25329818718344743,0.20251139378741778,131119.8742894441,-83.67642441668349,131036.19786502741,4376,3,727.7391304347826,40,6,15,35.05221770192499,0.6244791666666667,43.953252032520325,1024.1869918699185,25.604674796747965,0
4391,4,1,1,45,0.021739130434782608,0.021739130434782608,0.9782608695652174,46,900,500,400,0.5555555555555556,13,5,8,349.01549846671344,0.8144726247987117,0.2511534705149363,0.2038819043079306,131226.4581758628,-39.986457545998775,131186.47171831678,4377,0,726.2826086956521,41,5,16,34.90914665633875,0.6239837398373984,43.84920634920634,1024.6031746031733,24.990321331784717,0
4392,4,1,1,45,0.021739130434782608,0.021739130434782608,0.9782608695652174,46,1550,1300,250,0.8387096774193549,18,13,5,351.81537004437394,0.8087359098228664,0.25835345167295487,0.20680194348168657,131465.04635336748,50.40288893881183,131515.4492423063,4378,0,727.0,38,8,17,34.59648574504289,0.6313048245614037,43.61645299145298,1025.5341880341866,26.98774179037333,0
4393,4,0,0,45,0.0,0.0,1.0,45,1150,600,550,0.5217391304347826,17,6,11,361.31125417639254,0.8063131313131313,0.2625554010860398,0.2120917475080629,131412.43128895407,496.15807267618624,131908.58936163026,4379,1,743.4444444444445,37,8,18,34.40619095996862,0.6326013513513514,43.667763157894726,1025.3289473684194,27.711593172119443,0
4394,4,0,0,45,0.0,0.0,1.0,45,1150,600,550,0.5217391304347826,17,6,11,367.9819174870193,0.8055976430976431,0.26533656358367796,0.21680345214159635,131553.00188519532,681.8251769775188,132234.82706217284,4380,2,744.4444444444445,37,8,19,34.09309533988885,0.6340090090090091,43.53070175438596,1025.8771929824552,27.726410621147437,0
4395,4,0,0,45,0.0,0.0,1.0,45,900,600,300,0.6666666666666666,12,6,6,369.9901717627992,0.80496632996633,0.26753104889458856,0.21830819844617094,131609.25116381943,738.8258887349725,132348.0770525544,4381,3,745.4444444444445,37,8,15,33.98473676711548,0.6345720720720722,43.475877192982445,1026.0964912280685,27.73233760075861,0
4396,4,0,0,45,0.0,0.0,1.0,45,850,500,350,0.5882352941176471,12,5,7,365.81475089104936,0.8046717171717173,0.2677953557220838,0.21642537725130534,131711.6845642485,636.415415662193,132348.0999799107,4382,4,746.4444444444445,38,7,15,33.98838641409936,0.6337719298245614,43.37606837606837,1026.4957264957252,27.013045434098032,0
4397,4,0,0,45,0.0,0.0,1.0,45,1100,800,300,0.7272727272727273,14,8,6,365.37368562694945,0.803409090909091,0.2688354778667965,0.2166321093498215,131793.94866544288,630.8081534443556,132424.75681888722,4383,5,747.4444444444445,38,7,15,33.91664932542574,0.6345942982456141,43.29594017094016,1026.816239316238,27.02147998200626,0
4398,4,0,1,44,0.0,0.022222222222222223,0.9777777777777777,45,1350,1200,150,0.8888888888888888,15,12,3,364.00067476105664,0.8034511784511785,0.26955149876042395,0.21620762970747087,131862.52170138882,599.609374999995,132462.13107638882,4384,6,748.4444444444445,39,6,15,33.88269100743746,0.6335470085470085,43.229166666666664,1027.0833333333328,26.33547008547007,0
4399,4,0,1,43,0.0,0.022727272727272728,0.9772727272727273,44,1050,700,350,0.6666666666666666,14,7,7,366.03233161513447,0.7971943269908387,0.2669550042091926,0.21702262425373553,131793.94866544288,848.1692645554672,132642.11792999835,4385,7,766.2954545454545,38,6,15,33.89974161551002,0.6345942982456141,43.29594017094016,1026.816239316238,27.02147998200626,0
4400,4,0,0,43,0.0,0.0,1.0,43,1400,1000,400,0.7142857142857143,18,10,8,374.91403537327193,0.7890826873385013,0.27048758986329613,0.22236035093544565,131806.2183195789,1283.2002394967449,133089.41855907565,4386,8,784.8372093023256,37,6,17,33.65934774870973,0.6365427927927929,43.283991228070164,1026.8640350877176,27.753082029397774,0
4401,4,0,0,43,0.0,0.0,1.0,43,700,400,300,0.5714285714285714,10,4,6,374.91403537327193,0.7890826873385013,0.27048758986329613,0.22236035093544565,131806.2183195789,1283.2002394967449,133089.41855907565,4387,9,785.8372093023256,37,6,17,33.65934774870973,0.6365427927927929,43.283991228070164,1026.8640350877176,27.753082029397774,0
4402,4,0,0,43,0.0,0.0,1.0,43,1100,900,200,0.8181818181818182,13,9,4,375.3358034281396,0.7886212624584718,0.2676031868159141,0.22343687916910185,131946.99931709733,1304.8865997229627,133251.8859168203,4388,10,786.8372093023256,37,6,17,33.50631447883315,0.6379504504504505,43.14692982456139,1027.4122807017525,27.767899478425743,0
4403,4,0,0,43,0.0,0.0,1.0,43,1300,1000,300,0.7692307692307693,16,10,6,373.4692327323663,0.7884828349944629,0.2601514655232313,0.2226560845526547,132003.3327562325,1259.836680517058,133263.16943674957,4389,11,787.8372093023256,37,6,17,33.4973858301323,0.6385135135135136,43.09210526315788,1027.6315789473667,27.77382645803694,0
4404,4,0,0,43,0.0,0.0,1.0,43,850,500,350,0.5882352941176471,12,5,7,372.69635229275667,0.7885289774824659,0.26020207099804904,0.22225456991345452,132013.44515897782,1240.1858928701663,133253.63105184797,4390,12,788.8372093023256,38,5,17,33.507034688290524,0.6367872807017545,43.08226495726495,1027.6709401709386,27.04397210976154,0
4405,4,0,0,43,0.0,0.0,1.0,43,1300,1200,100,0.9230769230769231,14,12,2,368.3621178359966,0.7870985603543743,0.25541635927807915,0.22069012850103303,132188.90587819743,1138.677064743198,133327.58294294061,4391,13,789.8372093023256,40,3,17,33.44142207728036,0.6351562500000001,42.911585365853654,1028.3536585365846,25.708841463414615,0
4406,4,0,0,43,0.0,0.0,1.0,43,800,600,200,0.75,10,6,4,368.89194840633,0.7865909929863418,0.2595241322431763,0.22161977410785025,132293.4340195154,1160.3965273646536,133453.83054688005,4392,14,790.8372093023256,40,3,17,33.322425828970324,0.6361979166666667,42.80995934959349,1028.7601626016253,25.719004065040632,0
4407,4,0,0,43,0.0,0.0,1.0,43,1300,1100,200,0.8461538461538461,15,11,4,388.38503778421614,0.7858065706902916,0.2549793607470734,0.21644593186785235,129396.54659366347,1475.5438124357033,130872.09040609917,4393,15,791.8372093023256,37,6,17,35.762541760965625,0.612331081081081,45.641447368421055,1017.4342105263161,27.49822190611665,6
4408,4,3,3,43,0.06521739130434782,0.06521739130434782,0.9347826086956522,46,1000,600,400,0.6,14,6,8,364.24234163983533,0.8043276972624799,0.23189922228721138,0.20615746747635394,130003.35784131502,270.54549623243395,130273.90333754745,4394,0,741.1304347826087,40,6,13,35.75921773791729,0.6132812499999998,45.04573170731709,1019.8170731707344,25.49542682926836,0
4409,4,1,0,44,0.022727272727272728,0.0,1.0,44,850,500,350,0.5882352941176471,12,5,7,383.89430626685834,0.7934284707540522,0.2671216566333916,0.21705493240585877,129962.83512309154,1178.3984860106666,131141.2336091022,4395,0,775.7954545454545,38,6,14,35.299446423582,0.6162280701754386,45.085470085470085,1019.6581196581197,26.833108412055783,0
4410,4,0,0,44,0.0,0.0,1.0,44,900,600,300,0.6666666666666666,12,6,6,384.7889580241133,0.7931642001409444,0.2707871106582749,0.21801662802707455,130044.5513391225,1207.9414812988393,131252.49282042132,4396,1,776.7954545454545,38,6,15,35.19342900038407,0.6170504385964912,45.005341880341874,1019.9786324786312,26.841542959963977,0
4411,4,0,0,44,0.0,0.0,1.0,44,1300,800,500,0.6153846153846154,18,8,10,385.1619539403805,0.7929880197322058,0.26861887219649816,0.21900357880173554,130182.84640841997,1228.2958984374811,131411.14230685745,4397,2,777.7954545454545,39,5,15,35.043146711578366,0.6167200854700856,44.86979166666666,1020.5208333333319,26.167200854700816,0
4412,4,0,1,43,0.0,0.022727272727272728,0.9772727272727273,44,1050,800,250,0.7619047619047619,13,8,5,384.6223262491897,0.7924154334038055,0.26777083004759317,0.2189955941264269,130236.00396050338,1218.3349609374902,131454.33892144088,4398,3,778.7954545454545,39,5,15,35.002827669490095,0.6172542735042736,44.81770833333333,1020.7291666666658,26.172542735042715,0
4413,4,0,0,43,0.0,0.0,1.0,43,1100,800,300,0.7272727272727273,14,8,6,389.0090018159288,0.7891288298265042,0.27152392033532724,0.2214893923330978,130235.32238476137,1532.5425524143318,131767.8649371757,4399,4,795.953488372093,38,5,15,34.8915811876352,0.6189692982456141,44.81837606837606,1020.7264957264948,26.861223571749864,0
4414,4,1,0,44,0.022727272727272728,0.0,1.0,44,1000,600,400,0.6,14,6,8,391.1551705651191,0.7943754404510219,0.3278852854733312,0.2127364163297063,128429.74044568224,1247.199966638646,129676.94041232088,4400,0,778.8409090909091,36,8,13,36.68134096211533,0.6044560185185185,46.59346846846847,1013.6261261261267,28.156281281281295,3
4415,4,3,0,47,0.06382978723404255,0.0,1.0,47,1150,800,350,0.6956521739130435,15,8,7,371.07007830951926,0.8142923219241442,0.32052260447510617,0.20549953599002801,129148.44292534744,184.6245659722483,129333.06749131969,4401,0,730.063829787234,39,8,18,36.45598483295758,0.6063034188034188,45.88541666666668,1016.4583333333351,26.063034188034234,0
4416,4,2,2,47,0.04081632653061224,0.04081632653061224,0.9591836734693877,49,1300,900,400,0.6923076923076923,17,9,8,358.3109442008351,0.8245110544217688,0.31868131868131866,0.20085136413459664,129625.34722222232,-510.7421874999886,129114.60503472234,4402,0,701.2244897959183,39,10,12,36.29466721222041,0.611111111111111,45.41666666666667,1018.3333333333342,26.111111111111132,0
4417,4,1,3,45,0.020833333333333332,0.0625,0.9375,48,1250,900,350,0.72,16,9,7,366.6817564508829,0.8187980200945626,0.32944626295690127,0.20554362678118285,129625.34722222218,-93.75000000000347,129531.59722222218,4403,0,716.8125,39,9,14,36.081560283687935,0.6111111111111112,45.416666666666664,1018.3333333333329,26.1111111111111,0
4418,4,0,0,45,0.0,0.0,1.0,45,950,600,350,0.631578947368421,13,6,7,392.3512207693746,0.8007996632996633,0.3467638334150842,0.21727762016297042,129147.0854792169,1134.2033293155093,130281.28880853241,4404,1,765.4666666666667,38,7,17,35.91658783547052,0.6080043859649124,45.886752136752136,1016.4529914529916,26.748762932973463,0
4419,4,1,0,46,0.021739130434782608,0.0,1.0,46,1450,1200,250,0.8275862068965517,17,12,5,384.5710092152204,0.8069645732689211,0.34267241379310365,0.2144722936007958,129424.43828870413,754.6001985084504,130179.03848721257,4405,0,749.804347826087,37,9,18,35.83108836206897,0.6126126126126126,45.614035087719294,1017.543859649122,27.501185395922217,0
4420,4,3,3,46,0.061224489795918366,0.061224489795918366,0.9387755102040817,49,1200,800,400,0.6666666666666666,16,8,8,336.6087333794173,0.8296839569160998,0.2499444656455938,0.1881543044771376,129514.47289837291,-1078.1543053953865,128436.31859297754,4406,0,704.8367346938776,43,6,14,36.95973656464167,0.6039244186046512,45.52556818181818,1017.8977272727271,23.67204016913319,6
4421,4,1,0,47,0.02127659574468085,0.0,1.0,47,1100,700,400,0.6363636363636364,15,7,8,347.1154167524754,0.8157570151094665,0.2945297936620179,0.1941008878091087,129529.3911111896,-407.67028454902675,129121.72082664058,4407,0,735.7872340425532,41,6,15,36.67720413864797,0.6069613821138212,45.51091269841269,1017.9563492063472,24.8282036391792,0
4422,4,0,1,46,0.0,0.02127659574468085,0.9787234042553191,47,1100,500,600,0.45454545454545453,17,5,12,345.2801784551803,0.8152944804193647,0.2927232099485091,0.1938881002094472,129694.42942130864,-443.8168529535665,129250.61256835508,4408,1,736.7872340425532,42,5,16,36.55623731608322,0.6071428571428572,45.34883720930232,1018.6046511627892,24.252491694352123,0
4423,4,1,0,47,0.02127659574468085,0.0,1.0,47,1500,1300,200,0.8666666666666667,17,13,4,336.25377922139586,0.817645698427382,0.27369834736436327,0.18863285778616676,129655.6565334468,-678.0755865307958,128977.580946916,4409,0,737.6595744680851,41,6,16,36.825443210598095,0.6082317073170731,45.386904761904766,1018.4523809523816,24.840301974448334,1
4424,4,0,0,47,0.0,0.0,1.0,47,850,400,450,0.47058823529411764,13,4,9,341.5691326753428,0.8173373419673141,0.28149234440246573,0.19235735366453513,129807.2562358276,-532.3696145124791,129274.88662131512,4410,1,738.6595744680851,41,6,16,36.53621495327102,0.6097560975609757,45.238095238095234,1019.0476190476186,24.854819976771186,0
4425,4,0,0,47,0.0,0.0,1.0,47,1200,700,500,0.5833333333333334,17,7,10,337.7334001152524,0.8159882824545174,0.27688828798912035,0.19053261629143498,129876.19447314057,-627.2942493112912,129248.90022382927,4411,2,739.6595744680851,43,4,16,36.564009661835726,0.6075581395348837,45.17045454545455,1019.3181818181824,23.705073995771684,0
4426,4,0,1,46,0.0,0.02127659574468085,0.9787234042553191,47,1300,1100,200,0.8461538461538461,15,11,4,341.4977985721537,0.8142923219241442,0.2785278255200614,0.19337178184133014,130021.0243414257,-519.6212838613332,129501.40305756437,4412,3,740.6595744680851,43,4,17,36.32118539151966,0.6090116279069768,45.02840909090909,1019.8863636363643,23.718287526427076,0
4427,4,3,2,47,0.061224489795918366,0.04081632653061224,0.9591836734693877,49,1250,800,450,0.64,17,8,9,335.73551073781766,0.8263534580498867,0.28035237617763564,0.19226830470987552,130460.49783854625,-1039.2830617079187,129421.21477683833,4413,0,711.2448979591836,42,7,19,36.02311170128679,0.6148313492063493,44.597868217054256,1021.608527131782,24.324012550756713,0
4428,4,3,2,48,0.06,0.04,0.96,50,1300,1000,300,0.7692307692307693,16,10,6,332.87688208564924,0.8317006802721089,0.28593833904268195,0.19216478906505025,130770.59771184833,-1293.898233040657,129476.69947880767,4414,0,697.96,43,7,15,35.78266287072186,0.6165213178294575,44.294507575757564,1022.8219696969675,23.786557434813197,0
4429,4,0,0,48,0.0,0.0,1.0,48,1200,1000,200,0.8333333333333334,14,10,4,340.83888502055265,0.8193151595744681,0.2858491311216438,0.19606598892948873,130633.79322907251,-694.9847139595232,129938.80851511299,4415,1,728.0416666666666,42,6,16,35.71741706161138,0.6165674603174605,44.4282945736434,1022.2868217054242,24.34016242155772,0
4430,4,0,0,48,0.0,0.0,1.0,48,1350,1000,350,0.7407407407407407,17,10,7,343.5193107842101,0.8200908687943262,0.29123247442212974,0.19836924751849672,130782.42368247098,-614.7423907818063,130167.68129168918,4416,2,729.0416666666666,42,6,16,35.49857111279525,0.6180555555555556,44.28294573643411,1022.8682170542634,24.35400516795865,0
4431,4,0,1,47,0.0,0.020833333333333332,0.9791666666666666,48,1150,900,250,0.782608695652174,14,9,5,346.21392383633383,0.8192043439716312,0.29652417962003463,0.20074463995832048,130940.15438475659,-533.3390725436259,130406.81531221296,4417,3,730.0416666666666,43,5,17,35.27017024426351,0.6182170542635659,44.128787878787875,1023.4848484848479,23.80197322057786,0
4432,4,0,1,46,0.0,0.02127659574468085,0.9787234042553191,47,1100,800,300,0.7272727272727273,14,8,6,333.3902382634793,0.8134057971014492,0.20665250606882757,0.1874533792500315,129745.05077069158,-745.9837168680664,128999.06705382351,4418,4,746.4042553191489,38,9,16,36.807667435682326,0.6140350877192984,45.29914529914529,1018.8034188034171,26.81061628430045,4
4433,4,1,0,47,0.02127659574468085,0.0,1.0,47,1150,500,650,0.43478260869565216,18,5,13,332.1300418970965,0.8114785692260252,0.22125519430721852,0.18778727013423474,129962.83512309122,-767.0876251004759,129195.74749799074,4419,0,747.2978723404256,38,9,18,36.61899273540097,0.6162280701754387,45.08547008547007,1019.6581196581171,26.833108412055715,0
4434,4,0,1,46,0.0,0.02127659574468085,0.9787234042553191,47,1000,800,200,0.8,12,8,4,329.37253841991657,0.8114014801110083,0.18535562885877632,0.1807838525434793,128794.39153928336,-901.465022098039,127892.92651718532,4420,1,748.2978723404256,38,9,15,37.875618355962516,0.6044407894736842,46.23397435897436,1015.0641025641025,26.71221322537112,3
4435,4,0,0,46,0.0,0.0,1.0,46,1350,1100,250,0.8148148148148148,16,11,5,331.8463009420703,0.8126610305958132,0.19495734801857223,0.18260419447560983,128895.01006319259,-645.3335401277195,128249.67652306487,4421,2,748.2608695652174,37,9,16,37.710447935788075,0.6072635135135135,46.13486842105264,1015.46052631579,27.44487908961595,0
4436,4,1,0,47,0.02127659574468085,0.0,1.0,47,1200,800,400,0.6666666666666666,16,8,8,322.83944110719,0.8152559358618563,0.18725282193789838,0.17915235924298117,129228.54487407774,-1055.9857595514636,128172.55911452627,4422,0,733.3191489361702,38,9,18,37.6002591853175,0.6088267543859649,45.80662393162393,1016.7735042735044,26.757197480881693,0
4437,4,0,0,47,0.0,0.0,1.0,47,1200,700,500,0.5833333333333334,17,7,10,326.8162458938936,0.8148704902867715,0.1872233159845984,0.1818595837028498,129337.19735051866,-946.1005414931724,128391.09680902549,4423,1,734.3191489361702,38,9,18,37.3888422084515,0.6099232456140351,45.699786324786324,1017.2008547008546,26.768443544759332,0
4438,4,1,1,47,0.020833333333333332,0.020833333333333332,0.9791666666666666,48,1550,1100,450,0.7096774193548387,20,11,9,323.4763989779233,0.8203494385342789,0.1948278800272667,0.18181604494276377,129731.4453125,-1206.987847222223,128524.45746527778,4424,0,720.0,39,9,15,37.073960463531,0.6121794871794872,45.3125,1018.75,26.121794871794872,0
4439,4,0,0,47,0.0,0.0,1.0,47,1250,800,450,0.64,17,8,9,328.48831141244614,0.8186478569226024,0.19723201153440129,0.18431307078839623,129663.42872242327,-881.4158494046142,128782.01287301866,4425,1,736.2765957446809,38,9,16,37.01528025455437,0.6132127192982455,45.37927350427351,1018.4829059829071,26.802181736392292,0
4440,4,1,0,48,0.020833333333333332,0.0,1.0,48,1400,900,500,0.6428571428571429,19,9,10,333.2702474916567,0.8237477836879432,0.21744943601711375,0.18914741860950346,130110.72137188223,-927.5935374149533,129183.12783446728,4426,0,721.9166666666666,41,7,14,36.44010112796576,0.6128048780487805,44.9404761904762,1020.2380952380964,24.883855981416986,1
4441,4,0,0,48,0.0,0.0,1.0,48,1100,800,300,0.7272727272727273,14,8,6,334.8659638857091,0.8229905437352245,0.22489025496484927,0.19067160500387714,130237.26974875598,-877.5942263479493,129359.67552240803,4427,1,722.9166666666666,41,7,14,36.27124032137881,0.6140752032520325,44.81646825396825,1020.734126984127,24.895954316686023,0
4442,4,0,1,47,0.0,0.020833333333333332,0.9791666666666666,48,1300,900,400,0.6923076923076923,17,9,8,331.8010940323261,0.8226765661938534,0.21724295190713128,0.18968151280004988,130392.29811124328,-947.136106185127,129445.16200505816,4428,2,723.9166666666666,40,8,15,36.192578772802655,0.6171875,44.66463414634146,1021.3414634146338,25.533536585365844,0
4443,4,0,0,47,0.0,0.0,1.0,47,1700,1300,400,0.7647058823529411,21,13,8,336.5365423970581,0.8167977181621955,0.23043282079761274,0.1928008415788752,130475.3472222221,-618.0555555555654,129857.29166666654,4429,3,740.0,39,8,15,35.98762914627516,0.6196581196581197,44.58333333333333,1021.6666666666656,26.19658119658117,0
4444,4,0,0,47,0.0,0.0,1.0,47,1450,900,550,0.6206896551724138,20,9,11,334.7245647606197,0.8165664508171445,0.23327035895396242,0.1922515675498318,130574.00238160166,-658.7347767532465,129915.26760484841,4430,4,741.0,40,7,12,35.934133770839544,0.6190104166666666,44.486788617886184,1022.0528455284561,25.551321138211403,0
4445,4,0,1,46,0.0,0.02127659574468085,0.9787234042553191,47,1200,700,500,0.5833333333333334,17,7,10,332.7182037002639,0.8156413814369411,0.23223213908041163,0.19148427512726854,130651.91436975346,-705.9459481789886,129945.96842157448,4431,5,742.0,40,7,12,35.90664347249837,0.6197916666666666,44.41056910569106,1022.3577235772358,25.558943089430894,0
4446,4,0,0,46,0.0,0.0,1.0,46,1250,900,350,0.72,16,9,7,341.0220735415573,0.8110708534621578,0.232502137803003,0.1960427421009553,130608.4106445315,-291.9297960069157,130316.48084852459,4432,6,758.6086956521739,39,7,12,35.73841248004349,0.6209935897435896,44.453125000000014,1022.1875000000019,26.209935897435948,0
4447,4,0,0,46,0.0,0.0,1.0,46,1000,600,400,0.6,14,6,8,341.5154276293145,0.8115740740740741,0.14454241410763213,0.19013178145547438,129356.41503899758,-350.40298936957936,129006.012049628,4433,7,759.6086956521739,40,6,19,36.99550449550451,0.6067708333333336,45.680894308943074,1017.2764227642247,25.431910569105618,7
4448,4,1,0,47,0.02127659574468085,0.0,1.0,47,1000,700,300,0.7,13,7,6,340.95408889269964,0.8170289855072463,0.1556940331448209,0.1913928720973941,129680.9169993225,-556.9522195452629,129123.96477977723,4434,0,744.4255319148937,41,6,16,36.68011996363754,0.6084857723577237,45.362103174603156,1018.5515873015843,24.842721641502056,0
4449,4,2,2,47,0.04081632653061224,0.04081632653061224,0.9591836734693877,49,1100,800,300,0.7272727272727273,14,8,6,333.1814692589228,0.8299674036281179,0.17764834640480776,0.18960031022558935,130214.25637769712,-1123.004548324186,129091.25182937294,4435,0,715.0,43,6,18,36.337523968577955,0.610949612403101,44.839015151515135,1020.6439393939369,23.735905567300858,0
4450,4,0,3,44,0.0,0.06382978723404255,0.9361702127659575,47,1300,900,400,0.6923076923076923,17,9,8,340.81797713148853,0.8218855997533148,0.18178219261641204,0.19406359843800494,130237.85848957363,-522.5193047293137,129715.33918484431,4436,1,741.8936170212766,42,5,18,36.11875830643629,0.6125992063492065,44.8158914728682,1020.7364341085246,24.303248431155346,0
4451,4,1,1,44,0.022222222222222223,0.022222222222222223,0.9777777777777777,45,1250,800,450,0.64,17,8,9,343.62934278316686,0.8152777777777778,0.19020274704948803,0.19592974958077544,130290.5716783047,-45.65790720845493,130244.91377109624,4437,0,768.8222222222222,37,8,18,35.99360523395266,0.6213400900900901,44.764254385964904,1020.942982456139,27.59305357989565,0
4452,4,0,0,44,0.0,0.0,1.0,44,1500,1000,500,0.6666666666666666,20,10,10,350.9580473763798,0.8073467230443975,0.20471143613126253,0.20010841268349464,130290.57167830468,345.3049255539987,130635.87660385868,4438,3,787.2954545454545,37,7,19,35.8065504958293,0.6213400900900901,44.764254385964904,1020.9429824561389,27.593053579895646,0
4453,4,0,0,44,0.0,0.0,1.0,44,1100,800,300,0.7272727272727273,14,8,6,350.38422099140405,0.8074127906976745,0.20354012532453636,0.20021341314809415,130374.54433094787,336.2366305016814,130710.78096144955,4439,4,788.2954545454545,37,7,19,35.736078305060474,0.6221846846846848,44.682017543859644,1021.2719298245605,27.601944049312447,0
4454,4,0,0,44,0.0,0.0,1.0,44,1250,700,550,0.56,18,7,11,346.58431088469723,0.8070604298801973,0.2122297200969443,0.1988649630241227,130535.38795976681,248.30349642046463,130783.69145618728,4440,5,789.2954545454545,38,6,16,35.67019515595049,0.6219846491228072,44.52457264957264,1021.9017094017081,26.892150247413372,0
4455,4,0,0,44,0.0,0.0,1.0,44,1000,600,400,0.6,14,6,8,343.9577287691189,0.8050123326286117,0.20170280931128426,0.19841227855788512,130741.54188368045,193.9127604166605,130935.4546440971,4441,6,790.2954545454545,39,5,17,35.528705778502086,0.6223290598290598,44.322916666666664,1022.7083333333325,26.223290598290575,0
4456,4,0,0,44,0.0,0.0,1.0,44,1250,700,550,0.56,18,7,11,349.3278655121434,0.8052986257928119,0.21024173322351003,0.20220669551713533,130874.7409396702,343.6387803819488,131218.37972005215,4442,7,791.2954545454545,39,5,18,35.25664681529744,0.62366452991453,44.192708333333336,1023.2291666666672,26.236645299145312,0
4457,4,0,0,44,0.0,0.0,1.0,44,1200,800,400,0.6666666666666666,16,8,8,353.1718542161389,0.8046599718111347,0.2143617119700978,0.2048563541633874,130954.6929253473,449.9023437500041,131404.5952690973,4443,8,792.2954545454545,39,5,18,35.07743062622973,0.624465811965812,44.114583333333336,1023.5416666666673,26.244658119658137,0
4458,4,1,0,45,0.022222222222222223,0.0,1.0,45,2000,1700,300,0.85,23,17,6,336.8804680058814,0.8110690235690237,0.1782203132456941,0.18633928262701083,129100.54878432817,-292.73581683835107,128807.81296748982,4444,0,775.6666666666666,41,4,18,37.373503188858514,0.6026422764227644,45.93253968253966,1016.2698412698383,24.78706929926435,8
4459,4,0,0,45,0.0,0.0,1.0,45,1250,700,550,0.56,18,7,11,336.3800358691226,0.810858585858586,0.17353101227164314,0.1866601363766258,129227.22012566886,-306.06924417323694,128921.15088149562,4445,1,776.6666666666666,40,5,18,37.2574129601866,0.6054687500000002,45.807926829268276,1016.7682926829236,25.41920731707309,0
4460,4,0,0,45,0.0,0.0,1.0,45,1450,900,550,0.6206896551724138,20,9,11,333.46274105514925,0.8096380471380472,0.16614496614496677,0.1856486116775326,129356.41503899761,-372.8910536056896,128983.52398539192,4446,2,777.6666666666666,40,5,18,37.20029970029971,0.6067708333333336,45.680894308943074,1017.2764227642249,25.43191056910562,0
4461,4,0,0,45,0.0,0.0,1.0,45,1400,1000,400,0.7142857142857143,18,10,8,332.0176998605941,0.8095538720538721,0.16167748377433933,0.18545216196898182,129485.6745013712,-401.6928374314511,129083.98166393976,4447,3,778.6666666666666,40,5,16,37.10579963388251,0.6080729166666669,45.55386178861787,1017.7845528455258,25.444613821138145,0
4462,4,0,0,45,0.0,0.0,1.0,45,1250,1100,150,0.88,14,11,3,330.016784961703,0.8101010101010101,0.11590694647795674,0.18265920918058615,129125.75511975626,-477.2666879251708,128648.48843183108,4448,4,779.6666666666666,41,4,14,37.522266959492434,0.6028963414634146,45.907738095238095,1016.3690476190478,24.78948896631824,3
4463,4,0,1,44,0.0,0.022222222222222223,0.9777777777777777,45,900,500,400,0.5555555555555556,13,5,8,329.5301962554462,0.8094276094276095,0.11507500305341822,0.18309876035137423,129278.89034511535,-479.71823430318886,128799.17211081216,4449,5,780.6666666666666,40,5,15,37.37904300323106,0.6059895833333333,45.75711382113821,1016.9715447154472,25.42428861788618,0
4464,4,0,1,43,0.0,0.022727272727272728,0.9772727272727273,44,1200,600,600,0.5,18,6,12,319.7034557345665,0.8086460535588443,0.10929164064590968,0.17092225676470266,127743.0604765054,-632.0204239103001,127111.0400525951,4450,6,795.3636363636364,41,3,13,39.19201831861303,0.5889227642276422,47.2718253968254,1010.9126984126983,24.656407278358497,3
4465,4,2,0,45,0.044444444444444446,0.0,1.0,45,750,500,250,0.6666666666666666,10,5,5,311.5430622360223,0.8152777777777778,0.13722562531904048,0.1681302641653904,128120.00480740328,-1017.0202737215429,127102.98453368174,4451,0,778.5111111111111,42,3,16,39.01404575038285,0.5912698412698414,46.899224806201545,1012.4031007751928,24.104835732742686,0
4466,4,3,3,45,0.0625,0.0625,0.9375,48,1000,700,300,0.7,13,7,6,292.15306575210667,0.8307661052009456,0.14233164522310515,0.16000526974399462,128707.64853395039,-2079.5308316474207,126628.11770230296,4452,0,730.7916666666666,44,4,12,38.90808924171914,0.5944602272727274,46.319444444444436,1014.7222222222204,23.061868686868646,0
4467,4,2,2,45,0.0425531914893617,0.0425531914893617,0.9574468085106383,47,1150,900,250,0.782608695652174,14,9,5,295.8434479451392,0.8315988282454517,0.131842204043209,0.16178513822543528,128648.39916386885,-1788.042803747694,126860.35636012115,4453,0,747.2765957446809,43,4,13,38.87459550701641,0.595203488372093,46.377840909090914,1014.4886363636367,23.592758985200852,0
4468,4,3,1,47,0.0625,0.020833333333333332,0.9791666666666666,48,1450,900,550,0.6206896551724138,20,9,11,292.97987286334774,0.8300458037825059,0.1506013119533529,0.1620840264389164,129107.270233196,-2034.8336762688805,127072.43655692712,4454,0,732.6458333333334,44,4,15,38.48206693391641,0.5984848484848486,45.92592592592592,1016.296296296295,23.09764309764307,0
4469,4,0,0,47,0.0,0.0,1.0,47,1150,700,450,0.6086956521739131,16,7,9,296.3209526608098,0.8264724020968238,0.14507404348382424,0.16373746900804256,129060.2237654321,-1751.3503086419762,127308.87345679013,4455,1,749.2340425531914,44,3,15,38.44484691088026,0.5980113636363636,45.97222222222222,1016.1111111111112,23.093434343434346,0
4470,4,0,0,47,0.0,0.0,1.0,47,1350,800,550,0.5925925925925926,19,8,11,325.34908700322273,0.8259713228492136,0.18501039833626676,0.17035995500562426,126901.1134067951,-1142.4134016937126,125758.70000510139,4456,2,750.2340425531914,43,4,12,39.910714285714306,0.5775193798449614,48.1060606060606,1007.5757575757566,23.4319943622269,4
4471,4,1,2,46,0.020833333333333332,0.041666666666666664,0.9583333333333334,48,1050,800,250,0.7619047619047619,13,8,5,319.4238851920801,0.8332594562647754,0.18716772354599032,0.16824715572263008,127140.87194279193,-1477.3467829507008,125663.52515984123,4457,0,735.5833333333334,42,6,13,39.81452568537023,0.5813492063492063,47.86821705426357,1008.527131782946,24.012550756736808,0
4472,4,2,3,45,0.041666666666666664,0.0625,0.9375,48,1300,900,400,0.6923076923076923,17,9,8,318.19187766000067,0.8358820921985816,0.19579571648098382,0.16800272972595998,127238.61621897737,-1502.7411588846637,125735.87506009272,4458,0,736.3125,42,6,13,39.74560603150214,0.5823412698412698,47.771317829457374,1008.9147286821717,24.02177925433742,0
4473,4,1,0,46,0.021739130434782608,0.0,1.0,46,1050,700,350,0.6666666666666666,14,7,7,330.1534629731709,0.821376811594203,0.20611867584949928,0.1739088623431924,127143.25550267688,-804.6427804217191,126338.61272225516,4459,0,769.2173913043479,40,6,15,39.541557503694726,0.5843750000000001,47.86585365853658,1008.5365853658529,25.213414634146325,0
4474,4,3,3,46,0.061224489795918366,0.061224489795918366,0.9387755102040817,49,900,300,600,0.3333333333333333,15,3,12,316.29472393406786,0.8373724489795918,0.21944557536417242,0.16927713120020238,127785.23090457104,-1716.441133637532,126068.78977093351,4460,0,723.0612244897959,43,6,15,39.235135493740444,0.586482558139535,47.230113636363626,1011.0795454545436,23.513477801268454,0
4475,4,1,0,47,0.02127659574468085,0.0,1.0,47,1050,600,450,0.5714285714285714,15,6,9,330.2783986148747,0.8240055504162812,0.2369245420143855,0.17635620152454592,127692.920918367,-965.1573129252051,126727.7636054418,4461,0,754.7234042553191,41,6,16,38.9760011778563,0.5884146341463417,47.321428571428555,1010.7142857142829,24.651567944250804,0
4476,4,1,2,46,0.020833333333333332,0.041666666666666664,0.9583333333333334,48,1000,700,300,0.7,13,7,6,328.3482127479931,0.8284759160756501,0.24236383807425943,0.17644280439021048,127948.38543544535,-1197.675263656049,126750.7101717893,4462,0,739.9791666666666,42,6,16,38.76384765188522,0.5895337301587302,47.068798449612395,1011.7248062015485,24.08868586194163,0
4477,4,2,0,48,0.041666666666666664,0.0,1.0,48,1300,600,700,0.46153846153846156,20,6,14,326.3391420684518,0.834552304964539,0.24785665294924564,0.17622313671696363,128144.53124999974,-1236.284722222253,126908.24652777749,4463,0,740.3541666666666,42,6,18,38.614540466392285,0.5915178571428573,46.874999999999986,1012.499999999998,24.107142857142808,0
4478,4,3,3,48,0.058823529411764705,0.058823529411764705,0.9411764705882353,51,1550,1100,450,0.7096774193548387,20,11,9,318.8328083576025,0.8497385620915033,0.26811788146430016,0.17527204261306345,128856.2845006956,-1983.277787623413,126873.00671307219,4464,0,697.7450980392157,45,6,16,38.08016995271656,0.594675925925926,46.173007246376805,1015.3079710144916,22.56239935587759,0
4479,4,0,0,48,0.0,0.0,1.0,48,850,600,250,0.7058823529411765,11,6,5,335.78663513465887,0.8311908983451537,0.27491517729140824,0.18289097154679515,128488.14791967126,-971.0794310738545,127517.0684885974,4465,1,742.3125,42,6,16,38.02486539870656,0.5949900793650793,46.53585271317829,1013.8565891472865,24.139442598744917,0
4480,4,0,0,48,0.0,0.0,1.0,48,1200,900,300,0.75,15,9,6,341.90017680940014,0.8305629432624113,0.28397781917773335,0.1866807068682312,128586.40861614388,-807.256831770927,127779.15178437295,4466,2,743.3125,42,6,16,37.76969682494187,0.5959821428571428,46.43895348837209,1014.2441860465117,24.148671096345517,0
4481,4,2,2,48,0.04,0.04,0.96,50,850,600,250,0.7058823529411765,11,6,5,331.899693195178,0.8450680272108844,0.2868088597210825,0.1830704642556209,128989.67013888898,-1437.6736111111009,127551.99652777788,4467,0,714.54,44,6,17,37.612797374897454,0.5973011363636364,46.04166666666667,1015.833333333334,23.08712121212123,0
4482,4,1,3,46,0.02040816326530612,0.061224489795918366,0.9387755102040817,49,1450,1200,250,0.8275862068965517,17,12,5,341.03152695510477,0.8371598639455783,0.28817255039252276,0.1879704089476083,128960.81285152677,-1004.0594151744548,127956.75343635232,4468,0,729.9591836734694,43,6,17,37.41026477717697,0.5983527131782945,46.070075757575765,1015.7196969696981,23.621388301620886,0
4483,4,0,1,45,0.0,0.021739130434782608,0.9782608695652174,46,1200,800,400,0.6666666666666666,16,8,8,353.0389696506592,0.828743961352657,0.29750630642873443,0.1945324527063216,128949.36244173619,-95.16998929199099,128854.1924524442,4469,2,766.3695652173913,41,5,17,37.1170313212216,0.6011178861788616,46.081349206349216,1015.6746031746051,24.772551296941586,0
4484,4,3,2,46,0.0625,0.041666666666666664,0.9583333333333334,48,1400,800,600,0.5714285714285714,20,8,12,341.68442528254315,0.8387632978723404,0.30423570113629106,0.19066789767891995,129447.79178685194,-753.6950843499499,128694.09670250199,4470,0,735.1875,42,6,16,36.89832888973528,0.6046626984126984,45.59108527131784,1017.6356589147302,24.22942045035072,0
4485,4,2,0,48,0.041666666666666664,0.0,1.0,48,1450,1000,450,0.6896551724137931,19,10,9,344.87155568580204,0.8363253546099291,0.32120831783810555,0.19360325954887736,129683.2135273188,-655.1896808998949,129028.0238464189,4471,0,736.1458333333334,43,5,18,36.57803396553864,0.6056201550387597,45.35984848484849,1018.5606060606074,23.687455954897846,0
4486,4,1,0,49,0.02040816326530612,0.0,1.0,49,1200,900,300,0.75,15,9,6,338.66194586457743,0.842828798185941,0.32353971280694216,0.19156055520321474,129979.17631172838,-996.1998456790154,128982.97646604937,4472,0,722.1020408163265,44,5,19,36.4359166439662,0.6072443181818181,45.06944444444444,1019.7222222222222,23.17550505050505,0
4487,4,0,0,49,0.0,0.0,1.0,49,1550,1200,350,0.7741935483870968,19,12,7,337.4728216646825,0.8431476757369615,0.3196328086507796,0.191466300159705,130097.22650891627,-1019.1443758573415,129078.08213305892,4473,1,723.1020408163265,44,5,19,36.34658437707994,0.6084280303030303,44.9537037037037,1020.1851851851848,23.186026936026927,0
4488,4,1,0,50,0.02,0.0,1.0,50,950,700,250,0.7368421052631579,12,7,5,331.9835094096108,0.8445408163265306,0.32457404458598704,0.18953240355385062,130340.40584308287,-1345.3018100406402,128995.10403304224,4474,0,709.62,40,10,20,36.240420979299365,0.6166666666666667,44.71544715447155,1021.1382113821143,25.528455284552855,0
4489,4,2,1,51,0.038461538461538464,0.019230769230769232,0.9807692307692307,52,1100,700,400,0.6363636363636364,15,7,8,329.3377668732788,0.8511657868275514,0.3427447552447562,0.19066923345295064,130881.5575987018,-1779.1520191094432,129102.40557959235,4475,0,683.2884615384615,42,10,18,35.761126893939405,0.6190476190476191,44.1860465116279,1023.2558139534867,24.363233665559207,0
4490,4,1,1,51,0.019230769230769232,0.019230769230769232,0.9807692307692307,52,1350,900,450,0.6666666666666666,18,9,9,328.3456060376872,0.8471122423328304,0.34542245833636587,0.19132376272427545,131129.55670482555,-1788.8372468601544,129340.71945796539,4476,0,684.2692307692307,42,10,19,35.53630558183539,0.6215277777777777,43.94379844961241,1024.2248062015512,24.386304909560742,0
4491,4,2,1,52,0.03773584905660377,0.018867924528301886,0.9811320754716981,53,1350,1100,250,0.8148148148148148,16,11,5,323.5585380731,0.848391388485728,0.3444471455018041,0.19002943243059287,131432.31232236128,-2094.3399398130546,129337.97238254822,4477,0,672.1509433962265,40,13,20,35.3538982490915,0.6276041666666665,43.64837398373985,1025.4065040650428,25.63516260162607,0
4492,4,0,0,52,0.0,0.0,1.0,52,1050,500,550,0.47619047619047616,16,5,11,328.88324212720266,0.845886752136752,0.350048462867282,0.19276593125514027,131354.8190646703,-1759.9202473958144,129594.89881727449,4478,1,686.0769230769231,39,13,20,35.295468787047405,0.6284722222222222,43.72395833333334,1025.104166666668,26.28472222222226,0
4493,4,3,3,52,0.05454545454545454,0.05454545454545454,0.9454545454545454,55,1650,1100,550,0.6666666666666666,22,11,11,309.75998640871484,0.8538720538720539,0.3339421868454122,0.18446190189542067,131959.80131571429,-2824.8267475895036,129134.97456812479,4479,0,649.6,43,12,16,35.17780337941628,0.628391472868217,43.13446969696971,1027.4621212121237,23.894467935165668,0
4494,4,0,2,50,0.0,0.038461538461538464,0.9615384615384616,52,1200,1000,200,0.8333333333333334,14,10,4,337.593532149569,0.8448969331322271,0.36249906423754075,0.1961861025134487,131026.55466452679,-1553.2565210827665,129473.29814344403,4480,3,688.0769230769231,45,7,19,35.403488012032184,0.6164351851851853,44.04438405797101,1023.8224637681152,22.751610305958117,1
4495,4,1,0,51,0.0196078431372549,0.0,1.0,51,1000,600,400,0.6,14,6,8,340.57369624648885,0.8470588235294119,0.3666687933307815,0.19873984046788754,131185.8024691356,-1264.3132716049608,129921.48919753065,4481,0,698.0196078431372,44,7,20,35.16641811279824,0.6193181818181819,43.88888888888888,1024.4444444444428,23.282828282828245,0
4496,4,1,0,52,0.019230769230769232,0.0,1.0,52,1400,1000,400,0.7142857142857143,18,10,8,335.552745822509,0.8509301156359979,0.3636067021467817,0.1969496527806175,131408.21533203125,-1580.659541377312,129827.55579065393,4482,0,685.5769230769231,39,13,21,35.070714382471465,0.6290064102564104,43.671875,1025.3125,26.290064102564102,0
4497,4,2,4,50,0.037037037037037035,0.07407407407407407,0.9259259259259259,54,1200,800,400,0.6666666666666666,16,8,8,322.9101245073704,0.8561175168879571,0.34937126166468024,0.1910320788037601,131709.7262081917,-2293.9191822562234,129415.80702593549,4483,0,661.1481481481482,41,13,15,35.091391224509536,0.628810975609756,43.3779761904762,1026.488095238096,25.036295005807222,0
4498,4,1,1,50,0.0196078431372549,0.0196078431372549,0.9803921568627451,51,1250,1100,150,0.88,14,11,3,335.49172106795766,0.8478758169934641,0.3594844298861699,0.19663931072244045,131354.8190646703,-1386.3091362847017,129968.5099283856,4484,0,700.7647058823529,39,12,21,35.126109304609976,0.6284722222222222,43.72395833333334,1025.104166666668,26.28472222222226,0
4499,4,0,0,50,0.0,0.0,1.0,50,1800,1400,400,0.7777777777777778,22,14,8,333.5772796053217,0.847517006802721,0.35150284321689695,0.19647542162399584,131541.75347222228,-1224.131944444435,130317.62152777784,4485,1,710.76,39,11,22,34.98679935012184,0.6303418803418803,43.54166666666667,1025.833333333334,26.30341880341882,0
4500,4,0,0,50,0.0,0.0,1.0,50,1050,600,450,0.5714285714285714,15,6,9,331.3944868795899,0.8476360544217687,0.3488785141581241,0.1958746178299101,131675.35942925356,-1272.702365451385,130402.65706380217,4486,2,711.76,39,11,16,34.908255522852585,0.6316773504273505,43.411458333333336,1026.3541666666672,26.316773504273517,0
4501,4,0,1,49,0.0,0.02,0.98,50,900,700,200,0.7777777777777778,11,7,4,331.3944868795899,0.847312925170068,0.3488785141581241,0.1958746178299101,131675.35942925356,-1272.702365451385,130402.65706380217,4487,3,712.76,39,11,16,34.908255522852585,0.6316773504273505,43.411458333333336,1026.3541666666672,26.316773504273517,0
4502,4,0,0,49,0.0,0.0,1.0,49,900,800,100,0.8888888888888888,10,8,2,336.92967025227773,0.8437854308390023,0.35423165517768984,0.19876367033801445,131602.03904594926,-931.8736759441895,130670.16537000507,4488,7,728.2448979591836,38,11,16,34.840083992780805,0.6326754385964912,43.48290598290598,1026.0683760683758,27.001799370220414,0
4503,4,0,1,48,0.0,0.02040816326530612,0.9795918367346939,49,1150,800,350,0.6956521739130435,15,8,7,339.2471631744615,0.8430059523809524,0.35447792107370724,0.20056292286874147,131684.26890432084,-865.2970679012485,130818.97183641959,4489,8,729.2448979591836,38,11,16,34.6977898060442,0.6334978070175439,43.40277777777777,1026.3888888888878,27.010233918128627,0
4504,4,0,1,47,0.0,0.020833333333333332,0.9791666666666666,48,1100,900,200,0.8181818181818182,13,9,4,339.22487912264774,0.8443964243498818,0.34455318552245284,0.20100814978158982,131771.2064268126,-659.9856856038186,131111.2207412088,4490,9,719.6041666666666,40,8,16,34.61080042231681,0.6309895833333334,43.318089430894304,1026.7276422764216,25.66819105691054,0
4505,4,0,1,46,0.0,0.02127659574468085,0.9787234042553191,47,1650,1200,450,0.7272727272727273,21,12,9,343.03640151071795,0.8377659574468085,0.34344273077049614,0.20361885484168277,131837.0496346685,-355.01858150669256,131482.03105316183,4491,14,735.7234042553191,41,6,18,34.44664477073672,0.6300813008130082,43.253968253968246,1026.9841269841256,25.048393341076235,0
4506,4,1,1,46,0.02127659574468085,0.02127659574468085,0.9787234042553191,47,1150,800,350,0.6956521739130435,15,8,7,338.385682980278,0.838691026827012,0.3259344450833821,0.20193984306887525,132040.8950617281,-463.85030864199996,131577.0447530861,4492,0,715.7872340425532,41,6,18,34.360923423423415,0.6321138211382115,43.05555555555554,1027.7777777777756,25.06775067750672,0
4507,4,0,0,46,0.0,0.0,1.0,46,1400,1300,100,0.9285714285714286,15,13,2,346.9503121450398,0.8356884057971015,0.3318324517266591,0.2065764226022585,131953.86860499688,-43.712819750162254,131910.15578524672,4493,16,732.3478260869565,40,6,18,34.228486646884285,0.6328125,43.14024390243902,1027.4390243902428,25.68597560975607,0
4508,4,0,0,46,0.0,0.0,1.0,46,800,400,400,0.5,12,4,8,353.34163940084494,0.8361916264090178,0.3376754233028263,0.2079971232303809,131519.83486969463,95.77918723490262,131615.61405692954,4494,17,733.3478260869565,38,8,21,34.50204839773634,0.6318530701754386,43.56303418803419,1025.747863247863,26.993364822312184,2
4509,4,0,0,46,0.0,0.0,1.0,46,1200,800,400,0.6666666666666666,16,8,8,355.9564808910853,0.8354669887278583,0.3399520177443811,0.21013902882353266,131629.4461451714,170.87088629557655,131800.31703146696,4495,18,734.3478260869565,38,8,18,34.32435363525943,0.6329495614035088,43.456196581196586,1026.1752136752143,27.00461088618985,0
4510,4,1,0,47,0.02127659574468085,0.0,1.0,47,1350,800,550,0.5925925925925926,19,8,11,350.1065704805033,0.8381128584643848,0.33585316668643705,0.20868890137704948,131996.29041883696,-157.44628906247937,131838.8441297745,4496,0,719.7021276595744,39,8,19,34.104684068254784,0.6348824786324785,43.09895833333334,1027.604166666668,26.348824786324823,0
4511,4,0,0,47,0.0,0.0,1.0,47,1100,900,200,0.8181818181818182,13,9,4,349.42807650251433,0.8370336108541473,0.33661312477223704,0.20857875564732664,132049.81689453125,-171.6172960069449,131878.1995985243,4497,1,720.7021276595744,39,8,19,34.068211377994,0.6354166666666666,43.046875,1027.8125,26.354166666666668,0
4512,4,0,0,47,0.0,0.0,1.0,47,1300,1000,300,0.7692307692307693,16,10,6,348.176357878008,0.8348365710761639,0.3384572680666018,0.20845256739702278,132162.7802977725,-196.80890177804025,131965.97139599445,4498,2,721.7021276595744,40,7,20,33.98666567832905,0.6348958333333334,42.9369918699187,1028.2520325203252,25.70630081300813,0
4513,4,0,0,47,0.0,0.0,1.0,47,1650,1200,450,0.7272727272727273,21,12,9,352.48796808052805,0.8335260561208757,0.34696215275515385,0.21176473002250357,132293.43401951555,-73.63125041310963,132219.80276910245,4499,3,722.7021276595744,40,7,20,33.744319865652464,0.6361979166666667,42.8099593495935,1028.7601626016265,25.71900406504066,0
4514,4,1,1,47,0.020833333333333332,0.020833333333333332,0.9791666666666666,48,750,500,250,0.6666666666666666,10,5,5,345.9370571050156,0.8327607860520094,0.3341916852975615,0.2095026935775254,132595.5597515585,-425.89120931580146,132169.6685422427,4500,0,708.625,37,11,20,33.609137123389765,0.6444256756756754,42.51644736842107,1029.9342105263183,27.83605974395455,0
4515,4,1,1,47,0.020833333333333332,0.020833333333333332,0.9791666666666666,48,1150,1000,150,0.8695652173913043,13,10,3,346.79938620475764,0.8360852541371159,0.336472967220093,0.2104991623242835,132680.2718144047,-397.3126346567932,132282.9591797479,4501,0,709.6041666666666,37,11,17,33.501844756634036,0.6452702702702702,42.4342105263158,1030.263157894739,27.844950213371323,0
4516,4,0,1,46,0.0,0.02127659574468085,0.9787234042553191,47,1450,1100,350,0.7586206896551724,18,11,7,352.84684683725663,0.8300570459451125,0.3399908073876001,0.21433108078407895,132708.51518015168,-34.84377404584785,132673.67140610583,4502,6,725.7021276595744,37,10,17,33.31770334503921,0.6455518018018017,42.40679824561404,1030.3728070175446,27.84791370317688,0
4517,4,0,0,46,0.0,0.0,1.0,46,1400,1200,200,0.8571428571428571,16,12,4,358.5603519638843,0.8291062801932367,0.3344641815775098,0.21731070621604742,132623.79410010795,310.72685826410304,132934.52095837204,4503,7,737.2608695652174,37,9,21,33.2557128663686,0.6447072072072071,42.48903508771931,1030.0438596491244,27.83902323376012,0
4518,4,0,1,45,0.0,0.021739130434782608,0.9782608695652174,46,1900,1300,600,0.6842105263157895,25,13,12,357.7154220486544,0.8276570048309179,0.3332986395407471,0.21761600335503586,132765.0109288436,298.4183835411066,133063.42931238472,4504,8,738.2608695652174,37,9,18,33.13550643685501,0.6461148648648647,42.351973684210535,1030.5921052631588,27.853840682788075,0
4519,4,0,0,45,0.0,0.0,1.0,45,1300,700,600,0.5384615384615384,19,7,12,361.2390304407717,0.8237794612794613,0.3408815567452079,0.21998808021453004,132803.95418645008,594.7943298027839,133398.74851625288,4505,9,752.8666666666667,36,9,18,33.00557194362502,0.6484375,42.31418918918919,1030.743243243244,28.63175675675678,0
4520,4,0,0,45,0.0,0.0,1.0,45,1500,1300,200,0.8666666666666667,17,13,4,361.134179363475,0.8231060606060606,0.33499757399320695,0.22112226490437398,133007.16256797352,606.6865006898947,133613.8490686634,4506,10,753.8666666666667,36,9,19,32.804084788937395,0.6504629629629629,42.117117117117125,1031.5315315315327,28.653653653653684,0
4521,4,0,0,45,0.0,0.0,1.0,45,1100,700,400,0.6363636363636364,15,7,8,361.061426670815,0.8232323232323233,0.33184441534507014,0.221767219437758,133123.35139193246,613.1414353542702,133736.49282728674,4507,11,754.8666666666667,36,9,19,32.68928233667975,0.6516203703703705,42.0045045045045,1031.9819819819818,28.66616616616616,0
4522,4,0,0,45,0.0,0.0,1.0,45,1200,900,300,0.75,15,9,6,361.9484467852594,0.8233585858585859,0.33798336848740496,0.22265902437810003,133181.46482631293,640.9648668939376,133822.42969320688,4508,12,755.8666666666667,36,9,20,32.60805331296823,0.6521990740740741,41.948198198198206,1032.2072072072083,28.672422422422454,0
4523,4,1,1,45,0.021739130434782608,0.021739130434782608,0.9782608695652174,46,1600,1000,600,0.625,22,10,12,350.7680114966601,0.8276167471819647,0.32250352987000364,0.21782742299479646,133532.02830289767,168.38688781059656,133700.41519070827,4509,0,740.4130434782609,35,11,21,32.54525942515864,0.6577380952380952,41.60879629629629,1033.5648148148139,29.530423280423253,0
4524,4,1,1,45,0.021739130434782608,0.021739130434782608,0.9782608695652174,46,1150,900,250,0.782608695652174,14,9,5,349.68247142153956,0.82920692431562,0.31681639323530963,0.21874119048545423,133801.3214404363,157.59535215191315,133958.91679258822,4510,0,741.3913043478261,35,11,19,32.30378584479994,0.6604166666666667,41.348379629629626,1034.6064814814808,29.560185185185166,0
4525,4,0,0,45,0.0,0.0,1.0,45,1800,1300,500,0.7222222222222222,23,13,10,361.7073909017839,0.8213383838383839,0.3259054634745244,0.2257553025973203,133718.36734693876,673.3843537415021,134391.75170068027,4511,15,758.8666666666667,34,11,19,32.07585174953961,0.661764705882353,41.42857142857143,1034.2857142857142,30.42016806722689,0
4526,4,0,0,45,0.0,0.0,1.0,45,1600,1300,300,0.8125,19,13,6,364.2335872747664,0.8207070707070707,0.32924178493798717,0.22771150168472817,133779.93905895698,745.4294217687104,134525.36848072568,4512,16,759.8666666666667,34,11,19,31.94883966244726,0.6623774509803921,41.36904761904762,1034.5238095238099,30.42717086834735,0
4527,4,0,0,45,0.0,0.0,1.0,45,1500,1100,400,0.7333333333333333,19,11,8,361.85502789220266,0.8200757575757576,0.3266707572736107,0.2266025866310536,133841.52494331056,686.2457482993076,134527.77069160988,4513,17,760.8666666666667,34,11,19,31.948678861788608,0.6629901960784315,41.3095238095238,1034.761904761904,30.43417366946776,0
4528,4,0,0,45,0.0,0.0,1.0,45,1100,900,200,0.8181818181818182,13,9,4,362.66171401763506,0.8207070707070707,0.3271751286065754,0.22741381814485936,133891.14610125177,711.4385073731182,134602.5846086249,4514,18,761.8666666666667,35,10,19,31.878121971221944,0.6613095238095238,41.261574074074076,1034.9537037037042,29.570105820105834,0
4529,4,0,0,45,0.0,0.0,1.0,45,1100,800,300,0.7272727272727273,14,8,6,361.3481378935651,0.8204545454545455,0.32700436095270047,0.22677448401278275,133921.0943528164,678.4276138117369,134599.52196662815,4515,19,762.8666666666667,35,10,19,31.88212848037571,0.6616071428571428,41.23263888888889,1035.069444444445,29.573412698412714,0
4530,4,0,0,45,0.0,0.0,1.0,45,550,400,150,0.7272727272727273,7,4,3,358.4984290079535,0.8200336700336701,0.3210510412511933,0.2252683566555104,133967.23740209805,605.408829437544,134572.6462315356,4516,20,763.8666666666667,36,9,19,31.909695783023317,0.6600115740740742,41.18806306306306,1035.2477477477478,28.75688188188188,0
4531,4,0,0,45,0.0,0.0,1.0,45,900,700,200,0.7777777777777778,11,7,4,358.4984290079535,0.8201178451178451,0.3210510412511933,0.2252683566555104,133967.23740209805,605.408829437544,134572.6462315356,4517,21,764.8666666666667,36,9,19,31.909695783023317,0.6600115740740742,41.18806306306306,1035.2477477477478,28.75688188188188,0
4532,4,0,0,45,0.0,0.0,1.0,45,1100,800,300,0.7272727272727273,14,8,6,357.8887315333419,0.8201178451178451,0.3197032848875847,0.22559990842441027,134083.8447188742,597.4194211102924,134681.2641399845,4518,22,765.8666666666667,36,9,19,31.80883259033742,0.6611689814814815,41.07545045045045,1035.6981981981976,28.76939439439438,0
4533,4,0,0,45,0.0,0.0,1.0,45,1200,900,300,0.75,15,9,6,358.7934782608698,0.819402356902357,0.3220000000000003,0.22671016483516468,134171.33349565763,627.959885561216,134799.29338121886,4519,23,766.8666666666667,36,9,19,31.69791666666665,0.6620370370370372,40.99099099099098,1036.0360360360346,28.77877877877874,0
4534,4,1,0,46,0.021739130434782608,0.0,1.0,46,1250,1000,250,0.8,15,10,5,327.0794886907122,0.8246376811594203,0.1535023022696711,0.20361366069602652,133622.45827324057,-434.4343778736516,133188.0238953669,4520,0,751.1739130434783,42,4,18,33.067010309278345,0.6463293650793652,41.52131782945735,1033.9147286821687,24.617017349575445,7
4535,4,0,1,45,0.0,0.021739130434782608,0.9782608695652174,46,1250,1100,150,0.88,14,11,3,322.5298765603332,0.8244363929146538,0.1530780132601368,0.20160005633244202,133772.77882939694,-570.8564314043922,133201.92239799254,4521,1,752.1739130434783,42,4,14,33.03457131260147,0.6478174603174605,41.37596899224805,1034.4961240310051,24.630860095976313,0
4536,4,0,0,45,0.0,0.0,1.0,45,1550,1200,350,0.7741935483870968,19,12,7,330.47574828747815,0.8220538720538721,0.16182685753237913,0.20718287296484175,133882.59007306604,-151.0101725875771,133731.57990047845,4522,2,764.3555555555556,41,4,14,32.71943698875255,0.6504065040650409,41.26984126984126,1034.9206349206331,25.241966705381294,0
4537,4,0,0,45,0.0,0.0,1.0,45,1000,700,300,0.7,13,7,6,329.4940910102476,0.8218013468013469,0.15894192064404833,0.20685567663062074,133933.93034297024,-173.9122732426598,133760.01806972758,4523,3,765.3555555555556,41,4,15,32.69359785317229,0.6509146341463415,41.22023809523808,1035.1190476190454,25.246806039488913,0
4538,4,0,0,45,0.0,0.0,1.0,45,1250,800,450,0.64,17,8,9,330.1844825551208,0.8220538720538721,0.1559152486458304,0.20830550950803678,134113.6987925954,-143.54755212273622,133970.15124047265,4524,4,766.3555555555556,41,4,15,32.496388436612065,0.6526930894308944,41.046626984126966,1035.8134920634893,25.263743708865594,0
4539,4,0,0,45,0.0,0.0,1.0,45,1000,700,300,0.7,13,7,6,331.79051591447245,0.8203282828282829,0.16159140471251532,0.20990623493196006,134216.47775140134,-93.6491205278578,134122.8286308735,4525,5,767.3555555555556,41,4,15,32.35230173926917,0.653709349593496,40.947420634920626,1036.2103174603162,25.273422377080884,0
4540,4,0,0,45,0.0,0.0,1.0,45,1350,1000,350,0.7407407407407407,17,10,7,334.6360336300307,0.8195286195286196,0.1663300922463231,0.21204188481675396,134274.4576648037,-13.385613845328749,134261.07205095835,4526,6,768.3555555555556,42,3,15,32.22076788830715,0.6527777777777778,40.89147286821705,1036.434108527131,24.67700258397931,0
4541,4,0,0,45,0.0,0.0,1.0,45,1200,1100,100,0.9166666666666666,13,11,2,333.42080754436085,0.8191077441077441,0.1655640690213671,0.21214444009154293,134425.14440989122,-35.97195931734666,134389.17245057388,4527,7,769.3555555555556,42,3,16,32.102060362549054,0.654265873015873,40.74612403100775,1037.015503875969,24.690845330380213,0
4542,4,0,0,45,0.0,0.0,1.0,45,900,500,400,0.5555555555555556,13,5,8,329.4835097158935,0.819402356902357,0.16018267683844534,0.21007272016132472,134500.51947186174,-136.85935716001967,134363.66011470172,4528,8,770.3555555555556,42,3,16,32.12906741398101,0.6550099206349207,40.673449612403104,1037.306201550388,24.69776670358067,0
4543,4,0,0,45,0.0,0.0,1.0,45,1300,1000,300,0.7692307692307693,16,10,6,325.90769926773845,0.8171296296296297,0.16220693170234446,0.20896434835402047,134705.2154195011,-219.6972431932959,134485.51817630779,4529,9,771.3555555555556,41,4,17,32.01810970948012,0.6585365853658536,40.476190476190474,1038.0952380952378,25.31939605110336,0
4544,4,0,0,45,0.0,0.0,1.0,45,1000,500,500,0.5,15,5,10,328.75787245946213,0.8159090909090909,0.16077519873488955,0.2115406371713649,134833.97822381262,-134.45363677878908,134699.52458703384,4530,10,772.3555555555556,41,4,12,31.816056133982872,0.6598069105691057,40.35218253968254,1038.5912698412694,25.331494386372427,0
4545,4,0,0,45,0.0,0.0,1.0,45,700,300,400,0.42857142857142855,11,3,8,332.99486461559883,0.8151094276094276,0.16373263723087073,0.2145716447624576,134885.5005688618,-16.764199892915997,134868.7363689689,4531,11,773.3555555555556,41,4,12,31.654788622544817,0.6603150406504066,40.30257936507937,1038.7896825396826,25.336333720480063,0
4546,4,0,0,45,0.0,0.0,1.0,45,1100,800,300,0.7272727272727273,14,8,6,350.4384587089047,0.8147306397306397,0.18701654209305074,0.21357220084716885,132832.28344868042,322.3113898337083,133154.59483851414,4532,12,774.3555555555556,41,4,15,33.255441407628396,0.639989837398374,42.28670634920635,1030.8531746031747,25.142760356174993,6
4547,4,0,0,45,0.0,0.0,1.0,45,1350,900,450,0.6666666666666666,18,9,9,347.0716605863003,0.8136784511784512,0.18588345945021656,0.21224452843853975,132960.14817964216,229.33988410178534,133189.48806374395,4533,13,775.3555555555556,41,4,15,33.21389637039887,0.641260162601626,42.16269841269841,1031.3492063492058,25.154858691444044,0
4548,4,0,0,45,0.0,0.0,1.0,45,750,500,250,0.6666666666666666,10,5,5,347.0716605863003,0.8136784511784512,0.18588345945021656,0.21224452843853975,132960.14817964216,229.33988410178534,133189.48806374395,4534,14,776.3555555555556,41,4,15,33.21389637039887,0.641260162601626,42.16269841269841,1031.3492063492058,25.154858691444044,0
4549,4,0,0,45,0.0,0.0,1.0,45,1050,900,150,0.8571428571428571,12,9,3,353.29605296599703,0.8125420875420876,0.19282761272954518,0.2167924629439137,133088.07442247742,403.8982780612363,133491.97270053867,4535,15,777.3555555555556,41,4,15,32.92501922892029,0.6425304878048781,42.03869047619048,1031.845238095239,25.166957026713145,0
4550,4,0,0,45,0.0,0.0,1.0,45,950,600,350,0.631578947368421,13,6,7,344.1785985034599,0.8122474747474748,0.14192867971788337,0.20549128366375383,132058.30379569027,114.4434990248696,132172.74729471514,4536,16,778.3555555555556,40,5,16,34.19455704963416,0.6338541666666667,43.038617886178855,1027.8455284552833,25.696138211382085,7
4551,4,0,0,45,0.0,0.0,1.0,45,1150,900,250,0.782608695652174,14,9,5,344.89231847750614,0.8122474747474748,0.13548571303068213,0.20648641883759788,132162.78029777238,116.385542666388,132279.16584043877,4537,17,779.3555555555556,40,5,16,34.07108618304012,0.6348958333333334,42.93699186991869,1028.2520325203243,25.706300813008106,0
4552,4,1,0,46,0.021739130434782608,0.0,1.0,46,1900,1500,400,0.7894736842105263,23,15,8,347.16287327116015,0.8180152979066023,0.15895561751186782,0.19902516796708422,130501.9544813369,-95.9417127934044,130406.0127685435,4538,0,763.3913043478261,39,7,16,35.689269208549966,0.6199252136752136,44.55729166666667,1021.7708333333342,26.199252136752158,4
4553,4,0,0,46,0.0,0.0,1.0,46,1050,500,550,0.47619047619047616,16,5,11,330.2049379153537,0.8175322061191627,0.13984748810433678,0.19354060714860016,131354.8190646702,-525.1980251736063,130829.6210394966,4539,1,764.3913043478261,39,7,18,35.2615968905599,0.6284722222222222,43.723958333333336,1025.1041666666672,26.284722222222236,1
4554,4,0,0,46,0.0,0.0,1.0,46,1650,1100,550,0.6666666666666666,22,11,11,328.61666248076097,0.8176529790660225,0.13746471780872738,0.19287858132368096,131408.21533203125,-563.4141710069441,130844.80116102431,4540,2,765.3913043478261,39,7,18,35.24850570625486,0.6290064102564104,43.671875,1025.3125,26.290064102564102,0
4555,4,0,0,46,0.0,0.0,1.0,46,1550,1000,550,0.6451612903225806,21,10,11,345.2411888506301,0.818659420289855,0.1272097586755092,0.1956626658663904,130055.18297846844,-212.49150211824673,129842.69147635018,4541,3,766.3913043478261,40,6,16,36.191092956062576,0.6138020833333333,44.99491869918699,1020.0203252032516,25.50050813008129,5
4556,4,0,0,46,0.0,0.0,1.0,46,1150,800,350,0.6956521739130435,15,8,7,344.00032907000707,0.8192028985507247,0.12579773646337533,0.19560879414048765,130184.79100568444,-243.27781082688955,129941.51319485756,4542,4,767.3913043478261,40,6,18,36.09133306778198,0.6151041666666668,44.86788617886179,1020.5284552845528,25.51321138211382,0
4557,4,0,0,46,0.0,0.0,1.0,46,1250,900,350,0.72,16,9,7,351.0011671269748,0.8196658615136876,0.12988203502099527,0.20026974055119412,130317.12420784951,-51.660985970450724,130265.46322187906,4543,5,768.3913043478261,38,8,18,35.778530570960214,0.6197916666666665,44.73824786324787,1021.0470085470097,26.86965811965815,0
4558,4,0,0,46,0.0,0.0,1.0,46,1650,1400,250,0.8484848484848485,19,14,5,350.1284860878608,0.8190217391304349,0.12957053583300127,0.20086318412408888,130528.56445312525,-59.646267361081584,130468.91818576417,4544,6,769.3913043478261,39,7,16,35.58656133197419,0.6201923076923076,44.531250000000014,1021.8750000000019,26.201923076923126,0
4559,4,0,1,45,0.0,0.021739130434782608,0.9782608695652174,46,1050,700,350,0.6666666666666666,14,7,7,349.0188404569066,0.8196457326892109,0.12249388330292987,0.20059608556088981,130599.97046235732,-83.62994910434082,130516.34051325297,4545,7,770.3913043478261,40,6,16,35.542602903161686,0.6192708333333332,44.46138211382115,1022.1544715447175,25.553861788617937,0
4560,4,0,0,45,0.0,0.0,1.0,45,1000,600,400,0.6,14,6,8,347.53744061365495,0.8153198653198653,0.13845021792041656,0.20006334191337405,130661.65500217036,81.96343315974633,130743.6184353301,4546,8,786.8888888888889,39,6,16,35.51802088639837,0.6215277777777777,44.40104166666668,1022.3958333333351,26.21527777777782,0
4561,4,0,0,45,0.0,0.0,1.0,45,1000,600,400,0.6,14,6,8,354.900704080991,0.8147727272727273,0.2000374032774621,0.1954626936844669,128929.98598327115,162.92960652998175,129092.91558980114,4547,9,787.8888888888889,38,7,14,37.08951364050775,0.605811403508772,46.100427350427346,1015.5982905982899,26.726270805218153,8
4562,4,1,3,43,0.021739130434782608,0.06521739130434782,0.9347826086956522,46,850,700,150,0.8235294117647058,10,7,3,344.9333465675356,0.822987117552335,0.1906400780550399,0.1911530113090618,129174.9145507812,-288.6528862847231,128886.26166449649,4548,0,771.7391304347826,39,7,14,37.093217371998506,0.6065705128205128,45.859375,1016.5624999999997,26.06570512820512,0
4563,4,1,0,44,0.022727272727272728,0.0,1.0,44,1050,900,150,0.8571428571428571,12,9,3,349.03177889552796,0.8174110288935871,0.17530898393474592,0.19382056426648953,129255.70371283495,222.86963985680114,129478.57335269175,3053,0,651.1136363636364,38,6,18,36.90682566365483,0.6091008771929826,45.77991452991452,1016.8803418803404,26.760008996851063,0
4564,4,0,1,43,0.0,0.022727272727272728,0.9772727272727273,44,950,600,350,0.631578947368421,13,6,7,348.58882166817756,0.8160456307258633,0.18091596494242967,0.1941089333289113,129364.36760355013,218.99449375408818,129583.36209730421,3054,1,652.1136363636364,38,6,19,36.80752467968914,0.6101973684210528,45.67307692307691,1017.3076923076909,26.77125506072871,0
4565,4,1,1,43,0.022727272727272728,0.022727272727272728,0.9772727272727273,44,1400,1000,400,0.7142857142857143,18,10,8,344.6915740587311,0.8232249823819592,0.17557128142524747,0.1932705931722248,129636.22708013712,136.90303345750036,129773.13011359463,3055,0,650.1136363636364,38,6,13,36.63034165617569,0.6129385964912282,45.405982905982896,1018.3760683760667,26.799370220422805,0
4566,4,0,0,43,0.0,0.0,1.0,43,1450,1100,350,0.7586206896551724,18,11,7,351.83024493875484,0.8187061646363971,0.18842440671517569,0.19775286181040358,129731.44531250001,528.6892361111121,130260.13454861112,3056,3,666.2325581395348,37,6,15,36.35182344921607,0.6157094594594594,45.3125,1018.7500000000001,27.533783783783786,0
4567,4,0,0,43,0.0,0.0,1.0,43,650,400,250,0.6153846153846154,9,4,5,344.44605118097303,0.8191214470284237,0.16471448754045492,0.19264079151591285,129536.03512619267,323.63515697137575,129859.67028316404,3057,4,667.2325581395348,37,6,15,36.738385035185985,0.6137387387387387,45.50438596491228,1017.9824561403508,27.513039355144617,4
4568,4,1,0,44,0.022727272727272728,0.0,1.0,44,1300,1000,300,0.7692307692307693,16,10,6,336.6737866381869,0.8249867864693446,0.17059748427672972,0.18982670948748834,129853.92011834319,-56.31780078895153,129797.60231755424,3058,0,653.0454545454545,38,6,17,36.61360062893082,0.6151315789473684,45.19230769230769,1019.2307692307692,26.821862348178136,0
4569,4,1,1,44,0.022222222222222223,0.022222222222222223,0.9777777777777777,45,1000,700,300,0.7,13,7,6,330.41677416694876,0.8281986531986533,0.1730896218387279,0.1873637214485773,130076.56385633688,-404.1042751736063,129672.45958116328,3059,0,639.5111111111111,39,6,18,36.54747013172674,0.6156517094017094,44.973958333333336,1020.1041666666673,26.15651709401711,0
4570,4,1,0,45,0.022222222222222223,0.0,1.0,45,1350,900,450,0.6666666666666666,18,9,9,329.73017044648327,0.8239057239057239,0.17979220543532493,0.1873571200518418,130156.27170138896,-416.7100694444407,129739.56163194453,3060,0,640.4888888888889,39,6,19,36.4842792976725,0.6164529914529915,44.895833333333336,1020.4166666666673,26.164529914529933,0
4571,4,0,0,45,0.0,0.0,1.0,45,1100,900,200,0.8181818181818182,13,9,4,341.3105349031713,0.8242424242424243,0.1693087076035351,0.19210009507611137,129784.51063368033,-135.3841145833545,129649.12651909697,3061,1,641.4888888888889,39,6,21,36.565886321815576,0.6127136752136754,45.26041666666666,1018.9583333333316,26.127136752136707,4
4572,4,0,1,44,0.0,0.022222222222222223,0.9777777777777777,45,1100,600,500,0.5454545454545454,16,6,10,342.4149473993826,0.822516835016835,0.17272747916524733,0.19324525232124318,129890.67382812499,-104.69835069444525,129785.97547743053,3062,2,642.4888888888889,39,6,21,36.43001907486887,0.6137820512820513,45.15625,1019.3749999999999,26.13782051282051,0
4573,4,0,0,44,0.0,0.0,1.0,44,1250,900,350,0.72,16,9,7,353.17795766023113,0.8161997885835095,0.1752984726205562,0.19927089852372934,129881.1445891773,374.2314769157539,130255.37606609306,3063,3,658.0,38,6,21,36.16540893686894,0.615405701754386,45.16559829059828,1019.3376068376057,26.824673864147517,0
4574,4,2,1,45,0.043478260869565216,0.021739130434782608,0.9782608695652174,46,1400,900,500,0.6428571428571429,19,9,10,341.56127112339226,0.8250603864734299,0.1787128343044968,0.19489084293511216,130318.55955678683,-295.96753105035395,130022.59202573648,3064,0,630.3478260869565,37,9,22,36.018041237113415,0.6216216216216215,44.736842105263165,1021.0526315789484,27.596017069701308,0
4575,4,2,0,47,0.0425531914893617,0.0,1.0,47,900,500,400,0.5555555555555556,13,5,8,334.33048606247013,0.8307893925377736,0.19396419082622862,0.19285879624919738,130741.54188368091,-657.8233506944068,130083.7185329865,3065,0,617.8936170212766,39,8,21,35.77485231207986,0.6223290598290596,44.322916666666686,1022.7083333333362,26.22329059829067,0
4576,4,0,1,46,0.0,0.02127659574468085,0.9787234042553191,47,1300,800,500,0.6153846153846154,18,8,10,339.9145125178097,0.8298257786000616,0.1970629376686257,0.19716646989374279,130954.6929253474,-497.31987847220404,130457.37304687519,3066,1,618.8936170212766,39,8,22,35.41666666666667,0.624465811965812,44.11458333333334,1023.541666666668,26.244658119658155,0
4577,4,1,1,46,0.02127659574468085,0.02127659574468085,0.9787234042553191,47,1500,1100,400,0.7333333333333333,19,11,8,341.62940097990685,0.8347209374036385,0.20233001556085095,0.19884894263075575,131088.00048828125,-443.2969835069449,130644.70350477431,3067,0,619.5957446808511,39,8,22,35.23812853897535,0.625801282051282,43.984375,1024.0625,26.25801282051282,0
4578,4,0,0,46,0.0,0.0,1.0,46,850,600,250,0.7058823529411765,11,6,5,350.8005970807036,0.8263486312399356,0.20651493289047385,0.20371947401377577,130999.80481591052,-9.038050624595598,130990.76676528592,3068,3,634.0652173913044,38,8,22,35.09249112920058,0.6266447368421053,44.07051282051282,1023.7179487179483,26.939946018893377,0
4579,4,0,0,46,0.0,0.0,1.0,46,1400,900,500,0.6428571428571429,19,9,10,354.80718218597895,0.8255233494363929,0.20690835869225044,0.20678033164844858,131136.55495516464,105.63830904374336,131242.19326420838,3069,4,635.0652173913044,38,8,23,34.85166544974096,0.6280153508771931,43.936965811965806,1024.252136752136,26.95400359874042,0
4580,4,1,0,47,0.02127659574468085,0.0,1.0,47,1650,1100,550,0.6666666666666666,22,11,11,346.71083151287917,0.8303654024051803,0.2123922740967379,0.20430373060040924,131559.08230865988,-276.98876136052405,131282.09354729936,3070,0,622.531914893617,36,11,18,34.63250091474572,0.6359953703703705,43.52477477477477,1025.9009009008998,28.497247247247216,0
4581,4,0,1,46,0.0,0.02127659574468085,0.9787234042553191,47,1250,1000,250,0.8,15,10,5,346.4174414800805,0.8296330558125192,0.22000984833103443,0.2052168819996032,131761.33639974432,-271.1149916808714,131490.22140806346,3071,1,623.531914893617,36,11,18,34.43612664984827,0.6380208333333335,43.3277027027027,1026.6891891891892,28.519144144144143,0
4582,4,0,0,46,0.0,0.0,1.0,46,1100,800,300,0.7272727272727273,14,8,6,348.6951190912124,0.8285628019323672,0.23092865332039825,0.20711649844815355,131862.52170138873,-4.0364583333536075,131858.4852430554,3072,2,636.5434782608696,35,11,19,34.27569303583502,0.6410714285714286,43.22916666666666,1027.083333333332,29.345238095238056,0
4583,4,0,0,46,0.0,0.0,1.0,46,1300,800,500,0.6153846153846154,18,8,10,352.53947207050646,0.8268921095008052,0.23325076004954393,0.21055165107317889,132070.63567654754,112.02243548526155,132182.6581120328,3073,3,637.5434782608696,35,11,20,33.96729441129003,0.6431547619047618,43.026620370370374,1027.893518518519,29.368386243386254,0
4584,4,1,1,46,0.02127659574468085,0.02127659574468085,0.9787234042553191,47,1300,800,500,0.6153846153846154,18,8,10,343.7197790489926,0.829131976564909,0.22792660866569037,0.20707020835390544,132398.0034722223,-298.0322734482122,132099.9711987741,3074,0,624.9574468085107,35,12,22,33.86470985155196,0.6464285714285714,42.708333333333336,1029.1666666666672,29.40476190476192,0
4585,4,0,1,45,0.0,0.021739130434782608,0.9782608695652174,46,1350,800,550,0.5925925925925926,19,8,11,350.1408180487961,0.8252818035426731,0.23379528883629241,0.21077197110845303,132368.22601862592,69.50378836594217,132437.72980699188,3075,5,639.5434782608696,35,11,23,33.729450193079145,0.6461309523809522,42.73726851851853,1029.050925925928,29.401455026455082,0
4586,4,0,0,45,0.0,0.0,1.0,45,900,600,300,0.6666666666666666,12,6,6,356.3984267832647,0.8195286195286196,0.23832304526748982,0.21383905606995912,132244.8979591838,426.3747165533113,132671.27267573713,3076,6,654.0222222222222,34,11,23,33.692611882716044,0.6470588235294116,42.85714285714287,1028.5714285714298,30.25210084033617,0
4587,4,0,0,45,0.0,0.0,1.0,45,1100,700,400,0.6363636363636364,15,7,8,357.01596631679763,0.8192760942760943,0.23323177394680328,0.21473131502269224,132336.7506377553,449.26658163267416,132786.01721938796,3077,7,655.0222222222222,34,11,23,33.58425893786878,0.6479779411764705,42.76785714285715,1028.928571428573,30.26260504201685,0
4588,4,0,0,45,0.0,0.0,1.0,45,950,500,450,0.5263157894736842,14,5,9,367.64382266070675,0.818476430976431,0.27078654508001065,0.21367787485260273,131031.70680084026,639.4499974629821,131671.15679830324,3078,8,656.0222222222222,35,10,19,34.62911673826212,0.6327380952380952,44.039351851851855,1023.8425925925931,29.252645502645517,5
4589,4,0,0,45,0.0,0.0,1.0,45,1050,700,350,0.6666666666666666,14,7,7,366.43444333580857,0.8189814814814815,0.27014111991623224,0.21306132203423284,131047.29940943362,604.048841951363,131651.34825138497,3079,9,657.0222222222222,37,8,19,34.644285000356966,0.6289414414414414,44.02412280701754,1023.9035087719294,27.67306780464674,0
4590,4,0,1,44,0.0,0.022222222222222223,0.9777777777777777,45,1200,1000,200,0.8333333333333334,14,10,4,366.7841810535348,0.8183501683501684,0.2732564916913487,0.21373244137374098,131131.51552641197,619.3931065327783,131750.90863294475,3080,10,658.0222222222222,37,8,19,34.55007939906505,0.629786036036036,43.94188596491228,1024.232456140351,27.68195827406354,0
4591,4,0,0,44,0.0,0.0,1.0,44,950,600,350,0.631578947368421,13,6,7,375.47335694539447,0.8109584214235377,0.2939102403918239,0.21876554653544913,131126.20380092924,1046.8791849281622,132173.0829858574,3081,11,673.6363636363636,36,8,19,34.33296683159245,0.6316550925925927,43.94707207207207,1024.2117117117111,28.45032532532531,0
4592,4,0,0,44,0.0,0.0,1.0,44,700,500,200,0.7142857142857143,9,5,4,376.7838073724231,0.8099894291754757,0.29307666177102343,0.22018984349914456,131241.56832085477,1089.9395594919395,132331.5078803467,3082,12,674.6363636363636,36,8,19,34.182556691211495,0.6328125,43.83445945945947,1024.6621621621632,28.462837837837867,0
4593,4,0,0,44,0.0,0.0,1.0,44,1100,600,500,0.5454545454545454,16,6,10,379.0469592522674,0.8104739252995067,0.28981483493795235,0.22237776024575528,131390.93888168014,1160.752772083782,132551.6916537639,3083,13,675.6363636363636,33,11,20,33.97332456769464,0.6407828282828283,43.68872549019608,1025.2450980392157,31.068033273915628,0
4594,4,1,0,45,0.022222222222222223,0.0,1.0,45,1700,1200,500,0.7058823529411765,22,12,10,372.0798151648813,0.8138888888888889,0.28859259259259273,0.22056277703072863,131786.11288265308,806.9905045351516,132593.10338718822,3084,0,661.6,34,11,17,33.75241545893719,0.6424632352941175,43.30357142857143,1026.7857142857144,30.199579831932777,0
4595,4,0,0,45,0.0,0.0,1.0,45,1150,800,350,0.6956521739130435,15,8,7,371.8078131404279,0.8127104377104377,0.28993973110801985,0.22093373359336188,131877.80612244914,806.6397392290427,132684.4458616782,3085,1,662.6,34,11,17,33.666792226858284,0.6433823529411764,43.21428571428572,1027.1428571428585,30.210084033613484,0
4596,4,0,0,45,0.0,0.0,1.0,45,1450,1000,450,0.6896551724137931,19,10,9,370.5401360415099,0.811868686868687,0.2888538459613028,0.22078223676352526,131981.42387902958,780.8829518175686,132762.30683084714,3086,2,663.6,35,10,17,33.59474731546145,0.6422619047619047,43.11342592592593,1027.546296296297,29.35846560846563,0
4597,4,0,1,44,0.0,0.022222222222222223,0.9777777777777777,45,1050,800,250,0.7619047619047619,13,8,5,371.36596055514957,0.8115319865319865,0.2925525525525523,0.2216216216216217,132040.89506172854,807.0987654321175,132847.99382716065,3087,3,664.6,35,10,17,33.51351351351351,0.6428571428571427,43.055555555555564,1027.777777777779,29.3650793650794,0
4598,4,0,0,44,0.0,0.0,1.0,44,1050,600,450,0.5714285714285714,15,6,9,379.81625872390714,0.8062896405919662,0.29365725521521346,0.22613205423823773,131951.69331114978,1223.4796971450694,133175.17300829483,3088,4,680.2045454545455,35,9,18,33.38649036836768,0.6419642857142855,43.142361111111114,1027.430555555556,29.355158730158745,0
4599,4,0,0,44,0.0,0.0,1.0,44,1100,600,500,0.5454545454545454,16,6,10,377.48460041982014,0.806972339675828,0.29352464262854694,0.2253847544162673,132059.678218298,1170.0989727608578,133229.77719105888,3089,5,681.2045454545455,37,7,18,33.33733376004552,0.6390765765765765,43.03728070175439,1027.850877192983,27.77975343764819,0
4600,4,0,0,44,0.0,0.0,1.0,44,800,600,200,0.75,10,6,4,379.80626488888873,0.806972339675828,0.29477575757575747,0.22693968982366697,132087.85545792946,1233.5590037319294,133321.4144616614,3090,6,682.2045454545455,37,7,18,33.24922222222222,0.6393581081081081,43.00986842105264,1027.9605263157903,27.78271692745379,0
4601,4,1,1,44,0.022222222222222223,0.022222222222222223,0.9777777777777777,45,1200,800,400,0.6666666666666666,16,8,8,374.563906326395,0.8119107744107744,0.2914108376884832,0.22532323434288007,132343.03232750745,914.1846327343125,133257.21696024176,3091,0,668.0222222222222,38,7,18,33.1265358391306,0.6400767543859649,42.761752136752136,1028.9529914529912,27.077710301394507,0
4602,4,0,0,44,0.0,0.0,1.0,44,1050,900,150,0.8571428571428571,12,9,3,380.07418847147983,0.8062235729386893,0.29656898372920115,0.22811746398278662,132256.9820161012,1253.4930218913607,133510.47503799255,3092,8,684.2045454545455,37,7,19,33.07161194613226,0.6410472972972973,42.84539473684211,1028.6184210526321,27.800497866287355,0
4603,4,0,0,44,0.0,0.0,1.0,44,1200,800,400,0.6666666666666666,16,8,8,377.5613098470137,0.8058271670190276,0.2862909865840073,0.22728754925684574,132369.793169533,1195.542498653434,133565.33566818642,3093,9,685.2045454545455,37,7,19,33.02244272775706,0.6421734234234234,42.73574561403509,1029.05701754386,27.81235182550973,0
4604,4,0,0,44,0.0,0.0,1.0,44,1250,700,550,0.56,18,7,11,378.2705288812481,0.8063336856941509,0.2856204272138596,0.22844158755342406,132489.9092970522,1223.4146294424993,133713.3239264947,3094,10,686.2045454545455,34,10,20,32.8830847209374,0.6495098039215685,42.61904761904762,1029.5238095238096,30.28011204481793,0
4605,4,0,0,44,0.0,0.0,1.0,44,850,700,150,0.8235294117647058,10,7,3,378.62193565925975,0.8063116631430586,0.28921104909658446,0.228840050420471,132520.5516581634,1235.037556689359,133755.58921485275,3095,11,687.2045454545455,34,10,20,32.843151424056735,0.6498161764705882,42.58928571428572,1029.6428571428582,30.283613445378183,0
4606,4,0,0,44,0.0,0.0,1.0,44,1150,700,450,0.6086956521739131,16,7,9,379.94470103999737,0.8069062720225512,0.29519711679905836,0.23020178945364567,132612.50000000012,1277.0833333333483,133889.58333333346,3096,12,688.2045454545455,34,10,20,32.71642394822006,0.650735294117647,42.50000000000001,1030.000000000001,30.29411764705885,0
4607,4,1,1,44,0.022222222222222223,0.022222222222222223,0.9777777777777777,45,1800,1600,200,0.8888888888888888,20,16,4,369.25689150002853,0.8097643097643098,0.2811061361678373,0.22556940329991773,132920.05423920567,816.3292092768761,133736.38344848255,3097,0,673.8888888888889,36,9,17,32.68219212988243,0.6495949074074073,42.20157657657659,1031.1936936936956,28.644269269269323,0
4608,4,1,1,44,0.022222222222222223,0.022222222222222223,0.9777777777777777,45,1250,900,350,0.72,16,9,7,366.6040096549972,0.8105639730639731,0.27917939764295086,0.2251715244288468,133123.35139193246,760.7108797987142,133884.06227173118,3098,0,674.8666666666667,36,9,17,32.54628619234686,0.6516203703703705,42.0045045045045,1031.9819819819818,28.66616616616616,0
4609,4,0,0,44,0.0,0.0,1.0,44,900,500,400,0.5555555555555556,13,5,8,373.38869276076576,0.8072806553911206,0.27792338915291603,0.22891243516296172,133053.9547432269,1136.1684456447053,134190.1231888716,3099,15,691.2045454545455,35,9,18,32.441010395632354,0.6529761904761905,42.07175925925925,1031.712962962962,29.477513227513196,0
4610,4,0,1,43,0.0,0.022727272727272728,0.9772727272727273,44,900,400,500,0.4444444444444444,14,4,10,357.3407698586379,0.8078312191684285,0.24068233557989083,0.21174274474380153,131771.20642681266,617.4448699517407,132388.6512967644,3100,16,692.2045454545455,40,4,20,34.14579827773928,0.6309895833333334,43.318089430894304,1026.727642276422,25.66819105691055,4
4611,4,1,2,42,0.022727272727272728,0.045454545454545456,0.9545454545454546,44,1100,900,200,0.8181818181818182,13,9,4,351.5986325325979,0.8135570824524313,0.2519727677167123,0.2100661646820571,132084.41904826814,520.1255659660164,132604.54461423415,3101,0,692.2727272727273,40,4,19,33.97759103641457,0.6341145833333335,43.013211382113816,1027.947154471544,25.6986788617886,4
4612,4,1,1,42,0.023255813953488372,0.023255813953488372,0.9767441860465116,43,950,700,250,0.7368421052631579,12,7,5,352.6018441617976,0.8096622369878184,0.23692937761567578,0.2112479609871656,132188.9058781973,722.010398076517,132910.91627627384,3102,0,671.7674418604652,40,3,19,33.846600454590366,0.6351562500000001,42.91158536585365,1028.3536585365837,25.708841463414593,0
4613,4,0,0,42,0.0,0.0,1.0,42,1100,800,300,0.7272727272727273,14,8,6,359.55863230962194,0.807079945799458,0.23831478077095714,0.21492938475249265,132103.35422091995,1099.7802734374793,133203.13449435742,3103,19,688.7619047619048,39,3,19,33.7539475461884,0.6359508547008548,42.99479166666666,1028.0208333333317,26.359508547008506,0
4614,4,0,0,42,0.0,0.0,1.0,42,900,800,100,0.8888888888888888,10,8,2,359.42894651256864,0.8056523422377081,0.24013522767827067,0.2156136948885236,132237.24500868033,1105.9787326388644,133343.2237413192,3104,20,689.7619047619048,39,3,20,33.62239214097629,0.637286324786325,42.86458333333332,1028.541666666665,26.372863247863204,0
4615,4,0,0,42,0.0,0.0,1.0,42,950,500,450,0.5263157894736842,14,5,9,359.9087986291255,0.8055797522260937,0.24379448012497873,0.21620798632975907,132290.8203124997,1122.5260416666374,133413.34635416634,3105,21,690.7619047619048,39,3,20,33.55609558525718,0.637820512820513,42.812499999999986,1028.7499999999977,26.37820512820507,0
4616,4,0,0,42,0.0,0.0,1.0,42,1500,1200,300,0.8,18,12,6,356.5047779835763,0.8058943089430894,0.2408906882591093,0.21477239063888595,132398.00347222204,1040.1475694444207,133438.15104166645,3106,22,691.7619047619048,38,4,21,33.535762483130895,0.6406250000000002,42.70833333333332,1029.1666666666652,27.083333333333293,0
4617,4,0,0,42,0.0,0.0,1.0,42,1000,600,400,0.6,14,6,8,349.7406580360678,0.8069589624467673,0.20967597565341967,0.2022413370382478,130835.79881656796,773.4210634450924,131609.21988001306,3107,23,692.7619047619048,38,4,18,35.285479323308266,0.625,44.230769230769226,1023.0769230769223,26.923076923076902,6
4618,4,0,0,42,0.0,0.0,1.0,42,1300,1100,200,0.8461538461538461,15,11,4,351.9187939383112,0.8062330623306233,0.2058554528283132,0.20407881633952887,130945.12473518873,816.4100737818565,131761.53480897058,3108,24,693.7619047619048,38,4,18,35.11917188587334,0.6260964912280702,44.12393162393162,1023.5042735042726,26.934322986954545,0
4619,4,0,0,42,0.0,0.0,1.0,42,1300,900,400,0.6923076923076923,17,9,8,350.9001028996178,0.8054103755323267,0.20517943725145438,0.2042450510127972,131088.00048828125,799.7585720486109,131887.75906032987,3109,25,694.7619047619048,39,3,19,35.000784084359,0.625801282051282,43.984375,1024.0625,26.25801282051282,0
4620,4,1,0,43,0.023255813953488372,0.0,1.0,43,1450,1100,350,0.7586206896551724,18,11,7,333.6325272371982,0.8099852344038391,0.19898075757726263,0.19773006234488133,131778.07113727304,206.33616683739655,131984.40730411044,3110,0,679.5813953488372,37,6,15,34.74743699273813,0.6362612612612613,43.31140350877193,1026.7543859649127,27.750118539592233,3
4621,4,0,0,43,0.0,0.0,1.0,43,1200,1100,100,0.9166666666666666,13,11,2,334.7168732556861,0.8102620893318567,0.2000377336007786,0.19896114648853205,131890.67790089254,229.20706371191022,132119.88496460445,3111,1,680.5813953488372,37,6,15,34.60628380301736,0.6373873873873874,43.20175438596491,1027.19298245614,27.761972498814597,0
4622,4,0,0,43,0.0,0.0,1.0,43,900,600,300,0.6666666666666666,12,6,6,336.44598683264746,0.8107696566998892,0.20270709688309063,0.20013729845302053,131918.83710612878,276.71266639735404,132195.54977252614,3112,2,681.5813953488372,37,6,15,34.53354591382929,0.637668918918919,43.17434210526316,1027.3026315789473,27.7649359886202,0
4623,4,1,0,44,0.022727272727272728,0.0,1.0,44,1150,800,350,0.6956521739130435,15,8,7,325.9748303702898,0.8161777660324172,0.2063725119915396,0.19566618870356317,132260.5970121997,-177.2748648549804,132083.3221473447,3113,0,667.0681818181819,38,6,17,34.45917289849052,0.6392543859649122,42.84188034188035,1028.6324786324797,27.069275753486306,0
4624,4,0,0,44,0.0,0.0,1.0,44,1150,700,450,0.6086956521739131,16,7,9,327.0098770984869,0.8156932699083862,0.2073769254001816,0.19685994601328885,132370.5164730804,-142.7067353349581,132227.80973774544,3114,1,668.0681818181819,38,6,19,34.32222452934661,0.6403508771929826,42.735042735042725,1029.0598290598277,27.080521817363888,0
4625,4,0,0,44,0.0,0.0,1.0,44,1350,800,550,0.5925925925925926,19,8,11,329.4895081045851,0.8130065186751234,0.20596364023581581,0.1992424964977565,132539.10007165655,-65.94856898454816,132473.151502672,3115,2,669.0681818181819,37,7,20,34.089265431441454,0.6438626126126127,42.571271929824555,1029.714912280701,27.83013276434327,0
4626,4,0,0,44,0.0,0.0,1.0,44,1050,700,350,0.6666666666666666,14,7,7,330.415787753398,0.8113328047921071,0.21093251011283787,0.20025328452615582,132623.79410010754,-35.80091951371864,132587.99318059382,3116,3,670.0681818181819,37,7,20,33.9804662550564,0.6447072072072073,42.48903508771929,1030.0438596491213,27.839023233760035,0
4627,4,0,0,44,0.0,0.0,1.0,44,1400,1200,200,0.8571428571428571,16,12,4,327.66373116188265,0.8103417899929528,0.20523716466570585,0.19903400657583775,132708.51518015144,-103.24655182365419,132605.2686283278,3117,4,671.0681818181819,37,7,14,33.96640328473626,0.6455518018018018,42.40679824561403,1030.3728070175428,27.847913703176832,0
4628,4,0,0,44,0.0,0.0,1.0,44,1150,800,350,0.6956521739130435,15,8,7,326.469895880489,0.8100995419309374,0.2004642166344297,0.198757579098225,132793.26331178815,-129.39943059403777,132663.86388119412,3118,5,672.0681818181819,37,7,14,33.9122340425532,0.6463963963963963,42.32456140350877,1030.7017543859643,27.856804172593627,0
4629,4,0,0,44,0.0,0.0,1.0,44,700,500,200,0.7142857142857143,9,5,4,325.7395981004194,0.8096811134601832,0.19893736342364332,0.1986124319935238,132849.77709487514,-145.11340027702863,132704.6636945981,3119,6,673.0681818181819,37,7,14,33.87444160816848,0.6469594594594594,42.26973684210525,1030.9210526315774,27.862731152204795,0
4630,4,0,1,43,0.0,0.022727272727272728,0.9772727272727273,44,700,500,200,0.7142857142857143,9,5,4,329.69169059258314,0.8098793164200141,0.12678650360984212,0.19749492533555735,132183.6805555558,-82.57300323173928,132101.10755232404,3120,7,674.0681818181819,39,5,14,34.44084278768234,0.6367521367521367,42.91666666666668,1028.3333333333353,26.36752136752142,2
4631,4,0,0,43,0.0,0.0,1.0,43,1500,1300,200,0.8666666666666667,17,13,4,338.32338674312695,0.8005260243632336,0.1252745394140744,0.20263612927209698,132178.18737900877,343.7944015267849,132521.98178053554,3121,11,690.5813953488372,38,5,14,34.224458874458875,0.6384320175438596,42.92200854700855,1028.3119658119665,27.060841205578065,0
4632,4,0,0,43,0.0,0.0,1.0,43,1450,1200,250,0.8275862068965517,17,12,5,338.4449506692588,0.7993263196751569,0.12471377088144098,0.20315137063862995,132260.59701219964,352.5862462561307,132613.18325845577,3122,12,691.5813953488372,38,5,14,34.13849362969119,0.6392543859649122,42.84188034188035,1028.6324786324792,27.069275753486295,0
4633,4,1,1,43,0.022727272727272728,0.022727272727272728,0.9772727272727273,44,1250,1000,250,0.8,15,10,5,333.95176764762516,0.8032945736434108,0.12646772161791886,0.2021911283975549,132585.67843967027,55.444335937510346,132641.12277560777,3123,0,676.8409090909091,39,5,15,33.92765331580188,0.6407585470085471,42.52604166666667,1029.8958333333344,26.407585470085497,0
4634,4,0,0,43,0.0,0.0,1.0,43,1100,700,400,0.6363636363636364,15,7,8,340.96357096417546,0.7986803248431155,0.13809180218682315,0.20601040334681855,132507.9800044743,436.0788087150146,132944.0588131893,3124,14,693.5813953488372,38,5,16,33.825144408702585,0.6417214912280702,42.60149572649572,1029.5940170940162,27.094579397210953,0
4635,4,0,0,43,0.0,0.0,1.0,43,750,400,350,0.5333333333333333,11,4,7,340.84512526869895,0.7984034699150978,0.13614748224871365,0.20624018596767013,132562.98539201161,436.689472386567,132999.67486439817,3125,15,694.5813953488372,38,5,18,33.7729536258948,0.6422697368421053,42.54807692307691,1029.8076923076906,27.10020242914975,0
4636,4,0,1,42,0.0,0.023255813953488372,0.9767441860465116,43,1000,600,400,0.6,14,6,8,342.0014276449442,0.7987264673311184,0.13966031700851245,0.20724297699088,132618.00219382325,471.10921634155835,133089.1114101648,3126,16,695.5813953488372,38,5,18,33.687938664730495,0.6428179824561404,42.494658119658105,1030.0213675213654,27.105825461088564,0
4637,4,0,0,42,0.0,0.0,1.0,42,1300,900,400,0.6923076923076923,17,9,8,347.6115526897244,0.7940863337204801,0.14135431713930946,0.21083347563072657,132652.0314543895,822.2757242612763,133474.30717865078,3127,17,709.3809523809524,37,5,13,33.509291289693095,0.644988738738739,42.46162280701753,1030.1535087719274,27.841986723565604,0
4638,4,0,1,41,0.0,0.023809523809523808,0.9761904761904762,42,900,600,300,0.6666666666666666,12,6,6,347.43845966873846,0.793723383662408,0.1339545394663504,0.2112048281996636,132736.761551631,823.5711949830436,133560.33274661403,3128,18,710.3809523809524,37,5,13,33.428655032985745,0.6458333333333335,42.37938596491227,1030.4824561403489,27.850877192982402,0
4639,4,0,0,41,0.0,0.0,1.0,41,700,400,300,0.5714285714285714,10,4,6,350.5425662157726,0.7878048780487805,0.14874050379848036,0.21297904919484165,132716.91243608456,1104.5854131157987,133821.49784920036,3129,19,727.2926829268292,36,5,13,33.36862477231328,0.6475694444444446,42.39864864864864,1030.405405405404,28.622372372372336,0
4640,4,0,0,41,0.0,0.0,1.0,41,1150,700,450,0.6086956521739131,16,7,9,352.4757757305875,0.7880589430894309,0.15061521819063528,0.21481779301183726,132832.97444403855,1164.081141952752,133997.0555859913,3130,20,728.2926829268292,36,5,14,33.202243099555744,0.6487268518518519,42.28603603603603,1030.8558558558552,28.63488488488487,0
4641,4,0,0,41,0.0,0.0,1.0,41,1200,1000,200,0.8333333333333334,14,10,4,351.91695004180735,0.7869918699186992,0.1442583298703235,0.21481010630551914,132891.0244704163,1153.3208039120138,134044.3452743283,3131,21,729.2926829268292,36,5,15,33.15835699723315,0.6493055555555556,42.229729729729726,1031.0810810810806,28.641141141141127,0
4642,4,0,0,41,0.0,0.0,1.0,41,1100,700,400,0.6363636363636364,15,7,8,351.3380055791774,0.7871951219512195,0.1423150359901897,0.2149569000066587,132978.12328798373,1144.0537243324193,134122.17701231616,3132,22,730.2926829268292,36,5,15,33.085853623030175,0.6501736111111112,42.14527027027026,1031.4189189189174,28.65052552552548,0
4643,4,0,1,40,0.0,0.024390243902439025,0.975609756097561,41,1100,900,200,0.8181818181818182,13,9,4,350.02590590740004,0.7860264227642276,0.14569190878549287,0.2146544410926101,133065.25063915248,1115.2569799529035,134180.5076191054,3133,23,731.2926829268292,36,5,15,33.03227097431419,0.6510416666666667,42.0608108108108,1031.7567567567553,28.65990990990987,0
4644,4,0,0,40,0.0,0.0,1.0,40,700,200,500,0.2857142857142857,12,2,10,345.98933740411906,0.7806623931623932,0.11278534923339034,0.19490954036105396,129819.89354263141,983.2597897376801,130803.1533323691,3134,50,750.0,35,5,18,36.41077512776831,0.6205357142857142,45.22569444444446,1019.0972222222241,29.117063492063547,8
4645,4,0,0,40,0.0,0.0,1.0,40,1050,500,550,0.47619047619047616,16,5,11,345.83373549436124,0.778926282051282,0.11171662125340598,0.1952630475791238,129908.3719135802,985.3395061728331,130893.71141975303,3135,51,751.0,35,5,18,36.32493188010899,0.6214285714285714,45.138888888888886,1019.444444444444,29.126984126984116,0
4646,4,1,0,41,0.024390243902439025,0.0,1.0,41,1150,700,450,0.6086956521739131,16,7,9,338.07902760040804,0.7863313008130082,0.11157978040435967,0.19205856232522248,130147.65346004801,600.038425249589,130747.6918852976,3136,0,733.6585365853658,36,5,19,36.28002795865063,0.6218171296296295,44.90427927927929,1020.3828828828838,28.343968968968994,0
4647,4,0,0,41,0.0,0.0,1.0,41,800,600,200,0.75,10,6,4,334.80364013401993,0.7864837398373984,0.10763567476804514,0.19061935893057536,130233.84871357857,520.5533235938788,130754.40203717245,3137,1,734.6585365853658,36,5,19,36.27629449838189,0.6226851851851851,44.81981981981983,1020.7207207207217,28.35335335335338,0
4648,4,0,0,41,0.0,0.0,1.0,41,900,700,200,0.7777777777777778,11,7,4,332.57603716559714,0.7861788617886178,0.09674280786325506,0.1900680668360899,130380.76560356648,472.3068398102767,130853.07244337676,3138,2,735.6585365853658,35,6,19,36.184459051072835,0.6261904761904762,44.675925925925924,1021.296296296296,29.17989417989417,0
4649,4,1,1,41,0.023809523809523808,0.023809523809523808,0.9761904761904762,42,1100,700,400,0.6363636363636364,15,7,8,323.8891146542845,0.7893921796360821,0.08917229189285569,0.18646729688942607,130665.25298524878,64.21062109406549,130729.46360634285,3139,0,719.1190476190476,36,6,15,36.118836509160325,0.627025462962963,44.39752252252252,1022.4099099099101,28.40027527527528,0
4650,4,0,0,41,0.0,0.0,1.0,41,850,400,450,0.47058823529411764,13,4,9,332.8341404873592,0.7843495934959349,0.099289918275697,0.19123346093974422,130587.70743580669,492.8094725222844,131080.51690832898,3140,4,737.6585365853658,35,6,15,35.96858132336843,0.6282738095238096,44.473379629629626,1022.106481481481,29.20304232804231,0
4651,4,0,0,41,0.0,0.0,1.0,41,1000,800,200,0.8,12,8,4,333.60199102187795,0.7861280487804878,0.10003890739212884,0.1928520600812545,130824.41332572454,528.6569519461682,131353.07027767072,3141,5,738.6585365853658,35,6,15,35.70975694837275,0.6306547619047618,44.24189814814815,1023.0324074074081,29.229497354497372,0
4652,4,0,2,39,0.0,0.04878048780487805,0.9512195121951219,41,950,700,250,0.7368421052631579,12,7,5,333.09462929468276,0.7859756097560976,0.1085549270057895,0.19315120044936904,130942.84664619763,523.2717924811338,131466.11843867876,3142,6,739.6585365853658,35,6,16,35.603137132948845,0.6318452380952382,44.126157407407405,1023.4953703703698,29.24272486772485,0
4653,4,0,0,39,0.0,0.0,1.0,39,1000,600,400,0.6,14,6,8,348.43351123884906,0.7740103463787674,0.12355010677359379,0.20094524196877656,130732.14215986647,1310.291864907735,132042.4340247742,3143,59,776.4358974358975,33,6,17,35.42378170561214,0.6341540404040404,44.33210784313726,1022.6715686274516,30.9900475341652,0
4654,4,0,0,39,0.0,0.0,1.0,39,650,200,450,0.3076923076923077,11,2,9,348.43351123884906,0.7740103463787674,0.12355010677359379,0.20094524196877656,130732.14215986647,1310.291864907735,132042.4340247742,3144,60,777.4358974358975,33,6,17,35.42378170561214,0.6341540404040404,44.33210784313726,1022.6715686274516,30.9900475341652,0
4655,4,0,0,39,0.0,0.0,1.0,39,750,500,250,0.6666666666666666,10,5,5,351.29623707028867,0.7723796671165093,0.12126349931812341,0.2030900960569785,130826.15460399848,1391.747164552099,132217.90176855057,3145,61,778.4358974358975,33,6,17,35.25545040728318,0.6351010101010102,44.240196078431374,1023.0392156862747,31.001188354129535,0
4656,4,0,0,39,0.0,0.0,1.0,39,850,700,150,0.8235294117647058,10,7,3,348.78717540017306,0.7710301394511921,0.12147947064811704,0.20194023691636728,130883.62328800141,1330.1058545524565,132213.72914255387,3146,62,779.4358974358975,35,4,17,35.26149474041398,0.6312500000000001,44.18402777777777,1023.2638888888879,29.236111111111082,0
4657,4,0,0,39,0.0,0.0,1.0,39,300,100,200,0.3333333333333333,5,1,4,349.7296349530818,0.7713675213675214,0.12322307866302484,0.2026415093220934,130913.23329260951,1356.8474579903746,132270.08075059988,3147,63,780.4358974358975,35,4,17,35.207437985372856,0.6315476190476191,44.15509259259258,1023.3796296296279,29.239417989417937,0
4658,4,0,0,39,0.0,0.0,1.0,39,1250,1000,250,0.8,15,10,5,350.42283039580195,0.7727732793522267,0.12185644618687919,0.20414033088692882,131120.59709630045,1389.5301515346252,132510.12724783507,3148,64,781.4358974358975,35,4,18,34.98005895204731,0.6336309523809525,43.95254629629629,1024.1898148148139,29.26256613756611,0
4659,4,0,0,39,0.0,0.0,1.0,39,1150,900,250,0.782608695652174,14,9,5,349.6795932673238,0.77361673414305,0.12103305641489137,0.20417966751994399,131209.51753257884,1376.258144718793,132585.77567729764,3149,65,782.4358974358975,35,4,19,34.909248380780255,0.6345238095238095,43.86574074074074,1024.537037037037,29.27248677248677,0
4660,4,1,1,39,0.025,0.025,0.975,40,750,500,250,0.6666666666666666,10,5,5,343.6064389216555,0.7767094017094017,0.11828418853029987,0.20189808082340668,131450.17715419506,1033.53262086729,132483.70977506234,3150,0,763.85,34,6,19,34.82194683074066,0.6390931372549019,43.63095238095239,1025.476190476191,30.161064425770324,0
4661,4,1,1,39,0.025,0.025,0.975,40,950,500,450,0.5263157894736842,14,5,9,340.7042942242806,0.7856837606837607,0.11147441104792866,0.20067319913401402,131541.75347222216,963.368055555552,132505.12152777772,3151,0,764.825,34,6,19,34.80402112103981,0.6400122549019608,43.541666666666664,1025.833333333333,30.17156862745097,0
4662,4,1,1,39,0.025,0.025,0.975,40,900,400,500,0.4444444444444444,14,4,10,339.6972453851992,0.7825053418803419,0.102639211136891,0.2005609763849602,131633.3616780046,943.0980725623668,132576.45975056698,3152,0,765.8,34,6,17,34.7375290023202,0.6409313725490196,43.452380952380956,1026.1904761904768,30.18207282913167,0
4663,4,1,1,39,0.025,0.025,0.975,40,950,700,250,0.7368421052631579,12,7,5,340.8563838758642,0.7811698717948717,0.10588474025973982,0.20189185814185812,131755.55555555565,981.94444444445,132737.5000000001,3153,0,766.775,34,6,18,34.58468614718613,0.642156862745098,43.333333333333336,1026.6666666666674,30.19607843137257,0
4664,4,0,0,39,0.0,0.0,1.0,39,900,700,200,0.7777777777777778,11,7,4,350.6087091371265,0.7750787224471435,0.10553457848334258,0.20688137572975054,131610.90573637543,1428.7859537197282,133039.69169009515,3154,70,787.4358974358975,33,6,18,34.48024901469009,0.6429924242424242,43.474264705882355,1026.1029411764707,31.094028520499112,0
4665,4,1,1,39,0.025,0.025,0.975,40,1050,800,250,0.7619047619047619,13,8,5,338.41318162176947,0.7796207264957264,0.1032503836877876,0.2012389206488776,131905.89871966562,927.7389720801912,132833.63769174583,3155,0,768.725,36,4,18,34.49604436161661,0.6394675925925927,43.18693693693694,1027.2522522522524,28.53478478478479,0
4666,4,0,0,39,0.0,0.0,1.0,39,1100,800,300,0.7272727272727273,14,8,6,346.09752036493563,0.7741228070175439,0.10902783800190807,0.20493224336695443,131743.6731074244,1319.2317172496375,133062.90482467404,3156,72,789.4358974358975,35,4,18,34.46213829387448,0.6398809523809523,43.3449074074074,1026.620370370369,29.332010582010543,0
4667,4,0,0,39,0.0,0.0,1.0,39,700,400,300,0.5714285714285714,10,4,6,348.06027054775956,0.7741228070175439,0.11029137660491228,0.20657784485419856,131832.80452942807,1377.1523223165211,133209.9568517446,3157,73,790.4358974358975,35,4,18,34.32193639881287,0.6407738095238096,43.25810185185185,1026.967592592592,29.341931216931197,0
4668,4,0,0,39,0.0,0.0,1.0,39,1400,1100,300,0.7857142857142857,17,11,6,349.8799396169831,0.7738978857399911,0.11939418835169957,0.20558429739841028,131450.17715419506,1399.5649907661234,132849.74214496117,3158,74,791.4358974358975,34,5,23,34.66111369089081,0.6390931372549019,43.63095238095239,1025.476190476191,30.161064425770324,3
4669,4,0,0,39,0.0,0.0,1.0,39,700,500,200,0.7142857142857143,9,5,4,351.9238824049423,0.7724358974358975,0.12204628356867864,0.2074473336912308,131572.28599773248,1460.6859410430939,133032.9719387756,3159,75,792.4358974358975,34,5,19,34.48547613522085,0.6403186274509803,43.511904761904766,1025.9523809523814,30.17507002801122,0
4670,4,0,0,39,0.0,0.0,1.0,39,1100,800,300,0.7272727272727273,14,8,6,351.8970612776631,0.7726045883940621,0.12014397049199799,0.20776388138448343,131633.3616780046,1464.2786281179224,133097.64030612254,3160,76,793.4358974358975,34,5,19,34.4245456303171,0.6409313725490196,43.452380952380956,1026.1904761904768,30.18207282913167,0
4671,4,0,0,39,0.0,0.0,1.0,39,1400,1100,300,0.7857142857142857,17,11,6,354.42014470656494,0.7715924426450742,0.1182288274947445,0.20975737184658266,131725.00177154187,1537.1988378684728,133262.20060941033,3161,77,794.4358974358975,34,5,19,34.26736634581932,0.6418504901960784,43.363095238095234,1026.5476190476184,30.192577030812306,0
4672,4,0,0,39,0.0,0.0,1.0,39,800,500,300,0.625,11,5,6,356.107007889768,0.7708052181736392,0.11463711127557197,0.21143394061011897,131847.23816609982,1590.3450963718856,133437.58326247171,3162,78,795.4358974358975,34,5,19,34.10078822302075,0.6430759803921569,43.24404761904762,1027.0238095238099,30.20658263305323,0
4673,4,0,0,39,0.0,0.0,1.0,39,750,600,150,0.8,9,6,3,362.6561472715316,0.7708052181736392,0.12670611439842205,0.19976821671736936,128936.76757812513,1551.9422743055707,130488.70985243071,3163,79,796.4358974358975,35,4,18,36.88568376068376,0.6116071428571428,46.09375000000001,1015.625000000001,29.01785714285717,4
4674,4,3,2,40,0.07142857142857142,0.047619047619047616,0.9523809523809523,42,600,400,200,0.6666666666666666,8,4,4,339.2304124168559,0.7964818041037554,0.1178890047503185,0.19004469572944352,129602.41280131515,393.55852368419426,129995.97132499934,3164,0,740.4761904761905,36,6,16,36.80371230553711,0.6163194444444443,45.43918918918921,1018.2432432432458,28.284534534534608,0
4675,4,1,1,40,0.024390243902439025,0.024390243902439025,0.975609756097561,41,900,600,300,0.6666666666666666,12,6,6,346.5573137871954,0.7933434959349593,0.12325739402931268,0.19376805942519956,129525.18332315271,777.5799200531874,130302.7632432059,3165,0,759.5121951219512,35,6,17,36.695684100814866,0.6175595238095237,45.51504629629631,1017.939814814817,29.083994708994773,0
4676,4,2,2,40,0.047619047619047616,0.047619047619047616,0.9523809523809523,42,1150,900,250,0.782608695652174,14,9,5,335.53230160531547,0.8015631049167634,0.11739525456896271,0.18905154311949818,129826.69850107757,312.21019157718683,130138.90869265476,3166,0,742.3809523809524,38,4,17,36.670292134046214,0.6148574561403508,45.2190170940171,1019.1239316239321,26.819050832208738,0
4677,4,1,0,41,0.024390243902439025,0.0,1.0,41,1200,800,400,0.6666666666666666,16,8,8,341.76074006248604,0.7940548780487805,0.13232474512077053,0.1931935028474807,129954.95158366038,682.7000856032646,130637.65166926365,3167,0,761.4634146341464,37,4,18,36.38148815284798,0.6179617117117117,45.093201754385966,1019.6271929824563,27.55749170222855,0
4678,4,0,0,41,0.0,0.0,1.0,41,500,400,100,0.8,6,4,2,343.80298300381554,0.79375,0.13296616837136122,0.1944870889255159,129982.9033933517,737.7019852262124,130720.60537857792,3168,1,762.4634146341464,37,4,18,36.3010752688172,0.6182432432432432,45.065789473684205,1019.7368421052624,27.56045519203412,0
4679,4,0,0,41,0.0,0.0,1.0,41,950,600,350,0.631578947368421,13,6,7,342.6604948245573,0.7940040650406504,0.13029081265042697,0.19401168941845917,130017.30974687697,710.3591387245141,130727.66888560148,3169,2,763.4634146341464,38,3,18,36.29530693484183,0.6167763157894737,45.03205128205128,1019.8717948717941,26.838731443994583,0
4680,4,0,0,41,0.0,0.0,1.0,41,1100,700,400,0.6363636363636364,15,7,8,344.1375475207928,0.7933943089430894,0.13053940551973575,0.19512026744231153,130071.79578493666,752.5177606106912,130824.31354554735,3170,3,764.4634146341464,38,3,18,36.20238968021226,0.6173245614035088,44.97863247863247,1020.085470085469,26.844354475933393,0
4681,4,0,0,41,0.0,0.0,1.0,41,1400,1100,300,0.7857142857142857,17,11,6,346.64923234261767,0.791869918699187,0.13641377619806394,0.1970948492462311,130180.80210387896,825.4150230111704,131006.21712689013,3171,4,765.4634146341464,38,3,18,36.02779522613066,0.618421052631579,44.87179487179487,1020.51282051282,26.855600539811054,0
4682,4,2,2,41,0.046511627906976744,0.046511627906976744,0.9534883720930233,43,1350,900,450,0.6666666666666666,18,9,9,336.5756043607553,0.8085548172757475,0.13309007333341194,0.19375305318479852,130661.65500217026,195.53078194342672,130857.18578411368,3172,0,730.8139534883721,39,4,17,35.798204279164544,0.6215277777777778,44.40104166666667,1022.3958333333343,26.215277777777803,0
4683,4,2,2,41,0.046511627906976744,0.046511627906976744,0.9534883720930233,43,1200,900,300,0.75,15,9,6,338.18793916772523,0.8044942783314876,0.13695879681588075,0.19562320014754989,130848.09570312497,250.24956597222157,131098.3452690972,3173,0,731.7674418604652,39,4,18,35.56853661847554,0.6233974358974359,44.21875,1023.1249999999998,26.233974358974354,0
4684,4,1,1,41,0.023809523809523808,0.023809523809523808,0.9761904761904762,42,1150,900,250,0.782608695652174,14,9,5,344.61051289955776,0.796965737514518,0.14367044216621183,0.1988521060872493,130753.83434007231,611.8291831032249,131365.66352317552,3174,0,749.952380952381,38,4,18,35.49958215815315,0.6241776315789473,44.31089743589744,1022.7564102564102,26.91464237516869,0
4685,4,2,2,41,0.046511627906976744,0.046511627906976744,0.9534883720930233,43,900,600,300,0.6666666666666666,12,6,6,336.93161063568573,0.806109265411591,0.1403301161133963,0.1954362459330727,130954.6929253474,224.55512152779653,131179.2480468752,3175,0,733.4651162790698,39,4,18,35.492994775764984,0.624465811965812,44.11458333333334,1023.541666666668,26.244658119658155,0
4686,4,0,0,41,0.0,0.0,1.0,41,850,600,250,0.7058823529411765,11,6,5,353.46270008409505,0.788109756097561,0.1451801477800303,0.2035849090972317,130682.67549871096,1038.2902671975812,131720.96576590854,3176,3,770.2439024390244,37,4,18,35.34528596961573,0.6252815315315317,44.38048245614034,1022.4780701754371,27.634542437173977,0
4687,4,0,0,41,0.0,0.0,1.0,41,1000,800,200,0.8,12,8,4,360.95661982501076,0.7888211382113821,0.094546657599206,0.20259371852293215,129675.59880203534,1172.6374942290038,130848.23629626434,3177,4,771.2439024390244,37,4,16,36.176189579072016,0.6151463963963963,45.367324561403514,1018.5307017543868,27.527856804172615,5
4688,4,0,1,40,0.0,0.024390243902439025,0.975609756097561,41,500,300,200,0.6,7,3,4,360.30141972440873,0.7880081300813008,0.09457912917484701,0.20265864358832986,129759.37307633134,1150.4972683902904,130909.87034472162,3178,5,772.2439024390244,37,4,16,36.107673267326746,0.6159909909909909,45.285087719298254,1018.8596491228083,27.536747273589413,0
4689,4,1,1,40,0.024390243902439025,0.024390243902439025,0.975609756097561,41,1100,800,300,0.7272727272727273,14,8,6,335.5886415300806,0.7882621951219512,0.06867420629513621,0.18856168961309006,129718.50419723711,506.411320972971,130224.91551821008,3179,0,773.0975609756098,40,1,14,36.778606344772555,0.6104166666666666,45.32520325203252,1018.69918699187,25.46747967479675,8
4690,4,0,0,40,0.0,0.0,1.0,40,850,600,250,0.7058823529411765,11,6,5,342.0855088604013,0.7813301282051281,0.06865087485930599,0.19136815558630257,129545.8021375869,863.1483289930645,130408.95046657996,3180,13,793.425,39,1,14,36.788537296633585,0.610309829059829,45.49479166666667,1018.0208333333342,26.10309829059831,0
4691,4,0,0,40,0.0,0.0,1.0,40,1000,900,100,0.9,11,9,2,341.82657846011887,0.7809027777777777,0.07280607548327733,0.1917405885028446,129651.86767578125,863.690863715277,130515.55853949653,3181,14,794.425,39,1,14,36.68739984998807,0.6113782051282051,45.390625,1018.4375,26.11378205128205,0
4692,4,0,0,40,0.0,0.0,1.0,40,1650,1200,450,0.7272727272727273,21,12,9,337.55638929889943,0.7790865384615384,0.06332396525293849,0.19037402128471068,129864.12896050338,767.293294270828,130631.42225477421,3182,15,795.425,39,1,14,36.580757111224685,0.6135149572649572,45.182291666666664,1019.2708333333326,26.135149572649553,0
4693,4,0,0,40,0.0,0.0,1.0,40,800,500,300,0.625,11,5,6,340.74400168742886,0.7783119658119658,0.06316918675929717,0.19256364252405017,129943.7717013887,855.5121527777579,130799.28385416645,3183,16,796.425,39,1,14,36.41874404032148,0.6143162393162394,45.10416666666666,1019.5833333333318,26.143162393162353,0
4694,4,2,2,40,0.047619047619047616,0.047619047619047616,0.9523809523809523,42,900,800,100,0.8888888888888888,10,8,2,329.26388125387194,0.7971835075493612,0.052638152599295385,0.1880933625764348,130363.87963750298,184.8233969513562,130548.70303445433,3184,0,759.452380952381,41,1,15,36.28610517453534,0.6153455284552847,44.69246031746031,1021.2301587301573,24.908052651955057,0
4695,4,1,0,41,0.024390243902439025,0.0,1.0,41,1600,1200,400,0.75,20,12,8,336.12831365560237,0.788109756097561,0.05294503094284675,0.19215526463246918,130392.29811124345,565.708655562179,130958.00676680563,3185,0,778.9512195121952,40,1,17,36.08208955223881,0.6171875,44.66463414634147,1021.3414634146353,25.533536585365884,0
4696,4,0,1,40,0.0,0.024390243902439025,0.975609756097561,41,900,500,400,0.5555555555555556,13,5,8,325.3644314868805,0.7875508130081301,0.04977600796416137,0.18538205980066458,130262.58680555562,279.9087224866246,130542.49552804224,3186,1,779.9512195121952,39,2,15,36.48809523809525,0.6175213675213675,44.79166666666667,1020.8333333333339,26.17521367521369,1
4697,4,2,2,40,0.047619047619047616,0.047619047619047616,0.9523809523809523,42,750,600,150,0.8,9,6,3,319.5370552214812,0.7977884243128146,0.04662395029367472,0.18331336325863942,130528.56445312515,-58.25737847220746,130470.30707465294,3187,0,762.3095238095239,39,3,14,36.36807679238872,0.6201923076923077,44.53125000000001,1021.8750000000011,26.201923076923105,0
4698,4,2,1,41,0.047619047619047616,0.023809523809523808,0.9761904761904762,42,1050,600,450,0.5714285714285714,15,6,9,320.19349819504333,0.7936507936507936,0.05604439272231776,0.18502111095472523,130807.80805902607,-23.23806927090692,130784.56998975515,3188,0,763.2619047619048,40,2,16,36.06944168487977,0.6213541666666664,44.25813008130083,1022.9674796747996,25.57418699186999,0
4699,4,0,0,41,0.0,0.0,1.0,41,1000,700,300,0.7,13,7,6,326.0311389015668,0.7838922764227643,0.05875718565700594,0.18807131150032858,130741.54188368094,325.1627604167062,131066.70464409764,3189,1,782.3658536585366,39,2,16,35.98704759964689,0.6223290598290596,44.322916666666686,1022.7083333333364,26.223290598290678,0
4700,4,1,0,42,0.023809523809523808,0.0,1.0,42,1350,800,550,0.5925925925925926,19,8,11,320.6105080383473,0.7911827332559039,0.06599787309464711,0.1863907021630904,131041.8228753556,2.6770812677972913,131044.4999566234,3190,0,764.7142857142857,40,2,17,35.822787427626146,0.6236979166666665,44.02947154471546,1023.8821138211408,25.59705284552852,0
4701,4,0,0,42,0.0,0.0,1.0,42,1200,700,500,0.5833333333333334,17,7,10,316.83870307382176,0.791352109949671,0.06228741496598622,0.18482257679306316,131171.92147531267,-87.93170401212552,131083.98977130055,3191,1,765.7142857142857,40,2,18,35.788277116402135,0.6249999999999998,43.90243902439026,1024.3902439024419,25.609756097561046,0
4702,4,0,0,42,0.0,0.0,1.0,42,850,500,350,0.5882352941176471,12,5,7,316.6558986483853,0.7916182733255904,0.060809821399048,0.1848412341791767,131197.94894118953,-91.0791154405045,131106.86982574902,3192,2,766.7142857142857,40,2,18,35.766747677148416,0.6252604166666664,43.87703252032522,1024.4918699187026,25.612296747967566,0
4703,4,1,0,43,0.023255813953488372,0.0,1.0,43,900,800,100,0.8888888888888888,10,8,2,312.5866968046236,0.8008951642672573,0.06470321118786959,0.18346056917171916,131406.2616188283,-384.76559918035593,131021.49601964795,3193,0,749.8604651162791,40,3,19,35.661363861631486,0.6273437499999999,43.67378048780489,1025.3048780487825,25.632621951219562,0
4704,4,1,1,43,0.022727272727272728,0.022727272727272728,0.9772727272727273,44,950,600,350,0.631578947368421,13,6,7,307.01242138956115,0.8084038054968288,0.0632826574102554,0.1813845516433475,131658.81406092548,-715.8217395754414,130942.99232135003,3194,0,733.7954545454545,41,3,14,35.55048735298857,0.6283028455284552,43.427579365079374,1026.289682539684,25.03145567169961,0
4705,4,1,2,42,0.022727272727272728,0.045454545454545456,0.9545454545454546,44,800,400,400,0.5,12,4,8,309.4576769586221,0.8072366102889359,0.06133069828722015,0.18344140644454418,131786.11288265322,-643.5551303854684,131142.55775226775,3195,0,734.7727272727273,41,3,15,35.35990338164252,0.6295731707317072,43.30357142857144,1026.7857142857156,25.043554006968673,0
4706,4,1,1,42,0.023255813953488372,0.023255813953488372,0.9767441860465116,43,1350,1000,350,0.7407407407407407,17,10,7,317.8151900710222,0.801125876707272,0.04350077918370987,0.18832181028079406,131771.2064268128,-224.22179671491452,131546.9846300979,3196,0,752.7906976744187,40,3,16,35.160348411362946,0.6309895833333332,43.31808943089431,1026.7276422764232,25.66819105691058,0
4707,4,1,1,42,0.023255813953488372,0.023255813953488372,0.9767441860465116,43,1100,600,500,0.5454545454545454,16,6,10,319.16716165061206,0.7980804724990771,0.05200577944248641,0.18977303940966966,131901.66650142102,-180.2638971511735,131721.40260426985,3197,0,753.7674418604652,40,3,17,34.994558765334396,0.6322916666666667,43.1910569105691,1027.235772357723,25.680894308943074,0
4708,4,0,0,42,0.0,0.0,1.0,42,1100,800,300,0.7272727272727273,14,8,6,325.892160733145,0.7933120402632597,0.04600148718988728,0.1938449028438041,131916.02105034702,198.07942708330816,132114.10047743033,3198,8,772.7142857142857,39,3,17,34.8074258095045,0.6340811965811968,43.17708333333332,1027.291666666665,26.34081196581192,0
4709,4,0,1,41,0.0,0.023809523809523808,0.9761904761904762,42,1400,1100,300,0.7857142857142857,17,11,6,328.3028714285033,0.79227158343012,0.052003464230409024,0.1964186960521682,132136.65729930912,276.1688024654459,132412.82610177458,3199,9,773.7142857142857,40,2,17,34.52378010609206,0.6346354166666668,42.96239837398373,1028.1504065040638,25.703760162601593,0
4710,4,0,0,41,0.0,0.0,1.0,41,1300,800,500,0.6153846153846154,18,8,10,340.6287820696417,0.7845528455284553,0.052141250895792135,0.20375794418347598,132130.12695312453,801.4648437499554,132931.59179687448,3200,10,793.3170731707318,39,2,17,34.213525835866264,0.6362179487179489,42.96874999999998,1028.1249999999964,26.362179487179393,0
4711,4,0,0,41,0.0,0.0,1.0,41,1200,900,300,0.75,15,9,6,336.1372065501018,0.7842479674796748,0.05413305879186936,0.2023582854057556,132371.203613281,698.9773220485822,133070.18093532958,3201,11,794.3170731707318,39,2,17,34.0867201471134,0.638621794871795,42.734374999999986,1029.062499999998,26.386217948717896,0
4712,4,1,1,41,0.023809523809523808,0.023809523809523808,0.9761904761904762,42,1100,700,400,0.6363636363636364,15,7,8,327.17626268956224,0.7900696864111498,0.04497667667244509,0.19847910083088488,132659.60784131437,280.61494067681457,132940.22278199118,3202,0,776.3809523809524,40,2,14,34.02798329551808,0.6398437500000002,42.45426829268291,1030.1829268292656,25.75457317073164,0
4713,4,0,0,41,0.0,0.0,1.0,41,950,700,250,0.7368421052631579,12,7,5,336.57061929365943,0.7833841463414634,0.04824763732617621,0.2037767123672018,132585.67843966995,724.8887803819243,133310.5672200519,3203,13,796.3170731707318,39,2,18,33.86022470584269,0.6407585470085472,42.52604166666666,1029.8958333333317,26.407585470085426,0
4714,4,1,0,42,0.023809523809523808,0.0,1.0,42,1000,600,400,0.6,14,6,8,348.5706483427491,0.789730933023616,0.05007245824117157,0.20673616983722903,131806.21831957914,875.4419929689963,132681.66031254813,3204,0,778.3333333333334,37,5,18,34.33562466631074,0.6365427927927928,43.28399122807018,1026.8640350877197,27.75308202939783,6
4715,4,0,0,42,0.0,0.0,1.0,42,1350,1000,350,0.7407407407407407,17,10,7,349.0245210165048,0.7889566395663956,0.039972970163218546,0.2081380575113304,132013.445158978,815.1858928701811,132828.63105184818,3205,1,779.3333333333334,38,4,18,34.11520601587135,0.6367872807017544,43.082264957264954,1027.67094017094,27.04397210976158,0
4716,4,0,0,42,0.0,0.0,1.0,42,1150,600,550,0.5217391304347826,17,6,11,348.30952122856746,0.78902922957801,0.04013124684502789,0.208163615730514,132095.80342793482,802.0452096573837,132897.8486375922,3206,2,780.3333333333334,38,4,18,34.05065648167393,0.637609649122807,43.00213675213675,1027.9914529914527,27.052406657669806,0
4717,4,1,0,43,0.023255813953488372,0.0,1.0,43,1400,1000,400,0.7142857142857143,18,10,8,339.45811273746483,0.7938353636028054,0.04368703511910299,0.2045028142589118,132398.0034722223,389.4058413689871,132787.40931359128,3207,0,763.1627906976744,37,6,19,33.97435897435896,0.642454954954955,42.708333333333336,1029.1666666666672,27.81531531531533,0
4718,4,1,2,42,0.022727272727272728,0.045454545454545456,0.9545454545454546,44,900,400,500,0.4444444444444444,14,4,10,336.9539287555028,0.7997709654686399,-0.03392137286666952,0.20584046331317188,132920.79863393973,218.4009514939098,133139.19958543364,3208,0,746.7954545454545,38,6,16,33.514211217018925,0.6458333333333333,42.200854700854705,1031.196581196582,27.136752136752158,6
4719,4,0,2,40,0.0,0.047619047619047616,0.9523809523809523,42,850,600,250,0.7058823529411765,11,6,5,349.47356751030594,0.788835656213705,-0.026285943198430473,0.2128231246454977,132803.95418645002,882.2943298027828,133686.24851625282,3209,2,783.2619047619048,36,6,16,33.30875122910522,0.6484375,42.31418918918919,1030.7432432432436,28.631756756756765,0
4720,4,0,0,40,0.0,0.0,1.0,40,1300,1000,300,0.7692307692307693,16,10,6,364.2286745297207,0.7826388888888889,-0.02696531791907486,0.22032014228546004,132551.19756235802,1655.7893990929424,134206.98696145095,3210,20,817.6,34,6,20,33.18280346820809,0.6501225490196079,42.559523809523796,1029.7619047619028,30.287114845938316,0
4721,4,0,0,40,0.0,0.0,1.0,40,950,700,250,0.7368421052631579,12,7,5,365.5322341175345,0.7822649572649573,-0.024988443314456932,0.22165034490672889,132643.15653344657,1697.0698696144968,134340.22640306107,3211,21,818.6,34,6,17,33.05669517315768,0.6510416666666667,42.47023809523809,1030.1190476190463,30.29761904761901,0
4722,4,0,1,39,0.0,0.025,0.975,40,700,400,300,0.5714285714285714,10,4,6,368.40759678597533,0.7820779914529915,-0.03695945945945911,0.2198561464690497,132040.8950617284,1728.9737654321023,133769.8688271605,3212,22,819.6,35,5,18,33.58952702702704,0.6428571428571428,43.05555555555556,1027.7777777777778,29.365079365079367,1
4723,4,0,0,39,0.0,0.0,1.0,39,1300,900,400,0.6923076923076923,17,9,8,368.688081666821,0.7801394511920828,-0.019233738316646987,0.2204979413625112,132122.47732426287,1942.3965419500955,134064.87386621296,3213,23,834.6153846153846,34,5,19,33.50002894858729,0.6458333333333334,42.97619047619047,1028.095238095237,30.238095238095205,0
4724,4,0,0,39,0.0,0.0,1.0,39,1100,700,400,0.6363636363636364,15,7,8,368.1738363235099,0.7796333783175888,-0.014619857726216434,0.2205815600630063,132189.6316256215,1933.752759559321,134123.3843851808,3214,24,835.6153846153846,35,4,19,33.44553085725004,0.6443452380952381,42.910879629629626,1028.3564814814808,29.38161375661374,0
4725,4,0,0,39,0.0,0.0,1.0,39,1100,700,400,0.6363636363636364,15,7,8,370.52494669900085,0.778621232568601,-0.00977469359339267,0.22236365723710097,132253.17166829002,2000.6198766334064,134253.7915449234,3215,25,836.6153846153846,36,3,19,33.32101671410846,0.6429398148148149,42.84909909909911,1028.6036036036046,28.57232232232235,0
4726,4,0,0,39,0.0,0.0,1.0,39,650,500,150,0.7692307692307693,8,5,3,371.3910118055098,0.7765969410706253,-0.0076434836776269055,0.22356858141493732,132369.03077063555,2032.1336539242047,134401.16442455977,3216,26,837.6153846153846,36,3,20,33.18195082804407,0.6440972222222222,42.73648648648649,1029.0540540540546,28.58483483483485,0
4727,4,0,0,39,0.0,0.0,1.0,39,850,500,350,0.5882352941176471,12,5,7,371.93517070130656,0.7759784075573549,-0.00518858134752187,0.22464884310358915,132495.48037190078,2055.9585034554243,134551.4388753562,3217,27,838.6153846153846,32,7,21,33.040532254108406,0.654296875,42.61363636363636,1029.5454545454543,32.173295454545446,0
4728,4,0,0,39,0.0,0.0,1.0,39,950,500,450,0.5263157894736842,14,5,9,373.02230446115067,0.7747413405308142,-0.00857424833889664,0.2260858811139723,132625.50536935008,2094.4543286399344,134719.95969799,3218,28,839.6153846153846,32,7,16,32.88157840974095,0.6555989583333334,42.48737373737374,1030.050505050505,32.189078282828284,0
4729,4,0,0,39,0.0,0.0,1.0,39,950,600,350,0.631578947368421,13,6,7,373.15665414515587,0.7738978857399911,-0.006497444066369651,0.22675587896341162,132723.06596584534,2105.2990447403336,134828.36501058567,3219,29,840.6153846153846,32,7,17,32.77988808561043,0.6565755208333334,42.39267676767677,1030.429292929293,32.20091540404041,0
4730,4,0,0,39,0.0,0.0,1.0,39,950,800,150,0.8421052631578947,11,8,3,371.5142708275928,0.774403958614485,-0.008507368478827493,0.22589034731664684,132745.06987997395,2063.3375684832677,134808.4074484572,3220,30,841.6153846153846,33,6,17,32.80005054108694,0.6543560606060608,42.37132352941176,1030.5147058823522,31.22771836007128,0
4731,4,0,0,39,0.0,0.0,1.0,39,900,800,100,0.8888888888888888,10,8,2,370.4884885264308,0.774685110211426,-0.005472296498973739,0.2257607193631501,132827.17013888876,2042.187499999981,134869.35763888873,3221,31,842.6153846153846,34,5,18,32.74386957693344,0.6528799019607844,42.29166666666666,1030.8333333333321,30.318627450980358,0
4732,4,0,0,39,0.0,0.0,1.0,39,1300,1000,300,0.7692307692307693,16,10,6,371.2979233328985,0.7750224921277553,0.001663233657693386,0.2271839835986038,132980.6122448978,2075.085034013583,135055.6972789114,3222,32,843.6153846153846,34,5,18,32.568674976915965,0.6544117647058825,42.14285714285713,1031.4285714285702,30.336134453781476,0
4733,4,0,0,39,0.0,0.0,1.0,39,1250,800,450,0.64,17,8,9,387.643750973606,0.7750224921277553,0.027087657504665463,0.21847387439664498,129837.58680555533,2276.268424036258,132113.8552295916,3223,33,844.6153846153846,34,5,18,35.33149359498501,0.6228553921568629,45.20833333333332,1019.1666666666648,29.975490196078376,6
4734,4,0,0,39,0.0,0.0,1.0,39,1100,800,300,0.7272727272727273,14,8,6,387.1821923936892,0.7735042735042735,0.02591754935948387,0.21877408164182188,129937.87140185597,2261.925984867953,132199.79738672392,3224,34,845.6153846153846,35,4,19,35.24106500927084,0.6217261904761906,45.109953703703695,1019.5601851851839,29.130291005290967,0
4735,4,0,0,39,0.0,0.0,1.0,39,800,600,200,0.75,10,6,4,386.88422443789307,0.7724921277552856,0.027794266559586944,0.21910178571636932,130026.38996056211,2261.0318072701994,132287.4217678323,3225,35,846.6153846153846,35,4,19,35.15849599031623,0.6226190476190478,45.02314814814813,1019.9074074074049,29.140211640211568,0
4736,4,3,1,41,0.07142857142857142,0.023809523809523808,0.9761904761904762,42,1100,1000,100,0.9090909090909091,12,10,2,359.6910331475338,0.7937475803329462,0.04038680318543797,0.20769699008766992,130780.41459956573,1008.5371579662675,131788.951757532,3226,0,787.0714285714286,36,6,13,35.08706741531798,0.6281828703703705,44.284909909909906,1022.86036036036,28.412787787787778,0
4737,4,1,0,42,0.023809523809523808,0.0,1.0,42,950,500,450,0.5263157894736842,14,5,9,358.11133473749425,0.7914972899728997,0.053483036598205747,0.20802492933537106,131010.89000740602,983.2969371398394,131994.18694454586,3227,0,788.047619047619,36,6,14,34.894171891614434,0.6304976851851851,44.05968468468468,1023.761261261261,28.437812812812805,0
4738,4,2,0,44,0.045454545454545456,0.0,1.0,44,1050,700,350,0.6666666666666666,14,7,7,343.5673810680139,0.8031404157857647,0.065684636013837,0.20241916985342198,131553.00188519555,239.8476842821494,131792.8495694777,3228,0,753.1818181818181,37,7,18,34.719253242126285,0.6340090090090089,43.53070175438597,1025.877192982457,27.726410621147487,0
4739,4,0,1,43,0.0,0.022727272727272728,0.9772727272727273,44,1200,1000,200,0.8333333333333334,14,10,4,341.2738026852336,0.8015988372093024,0.060724204229865686,0.20195988247403046,131721.78578985864,190.63894659898173,131912.42473645761,3229,1,754.1818181818181,37,7,12,34.60798974578083,0.6356981981981981,43.36622807017545,1026.5350877193,27.744191559981083,0
4740,4,0,0,43,0.0,0.0,1.0,43,1450,1100,350,0.7586206896551724,18,11,7,342.0886858092859,0.7965577703949797,0.06026954282284147,0.2023884293876616,131711.6845642489,411.41541566223646,132123.09997991112,3230,2,772.6976744186046,38,5,12,34.5972540244241,0.6337719298245613,43.37606837606839,1026.4957264957281,27.01304543409811,0
4741,4,1,2,42,0.022727272727272728,0.045454545454545456,0.9545454545454546,44,1350,1100,250,0.8148148148148148,16,11,5,329.0496141501466,0.8028321000704722,0.06496632484774789,0.19641455189470677,132049.81689453154,-109.81174045135984,131940.0051540802,3231,0,756.1136363636364,39,5,13,34.59184233640756,0.6354166666666665,43.046875000000014,1027.8125000000023,26.354166666666725,0
4742,4,0,0,42,0.0,0.0,1.0,42,1200,900,300,0.75,15,9,6,340.77717099696207,0.7919570267131243,0.06529697080625962,0.202263560428235,131834.3685076178,585.2286280394042,132419.5971356572,3232,1,792.047619047619,37,5,14,34.50734927752865,0.6368243243243243,43.256578947368425,1026.973684210527,27.75604551920343,0
4743,4,0,2,40,0.0,0.047619047619047616,0.9523809523809523,42,900,700,200,0.7777777777777778,11,7,4,339.40708782905574,0.7899970963995354,0.06553273460093845,0.20189873053145546,131918.83710612878,554.8376663973523,132473.67477252614,3233,2,793.047619047619,37,5,15,34.45749724267975,0.637668918918919,43.17434210526316,1027.3026315789473,27.7649359886202,0
4744,4,0,0,40,0.0,0.0,1.0,40,1300,1100,200,0.8461538461538461,15,11,4,354.926490411815,0.7763087606837606,0.07016183602120218,0.2096690999654602,131654.5718262386,1345.5390249913962,133000.11085122998,3234,3,833.35,35,5,16,34.32542479606029,0.6389880952380953,43.43171296296295,1026.273148148146,29.322089947089886,0
4745,4,0,0,40,0.0,0.0,1.0,40,1300,1000,300,0.7692307692307693,16,10,6,355.6324669555665,0.7755608974358974,0.06773075622675528,0.2110720320599828,131832.80452942822,1376.8051000943135,133209.60962952254,3235,4,834.35,35,5,17,34.12752639092376,0.6407738095238095,43.258101851851855,1026.967592592593,29.34193121693123,0
4746,4,0,0,40,0.0,0.0,1.0,40,1100,700,400,0.6363636363636364,15,7,8,357.1201372000649,0.7733707264957265,0.07023487664751604,0.21261941367706058,131951.69331114963,1424.5213638117202,133376.21467496135,3236,5,835.35,35,5,17,33.96945758702265,0.6419642857142858,43.14236111111111,1027.430555555555,29.355158730158713,0
4747,4,0,0,40,0.0,0.0,1.0,40,1100,900,200,0.8181818181818182,13,9,4,358.21767713659625,0.7737179487179487,0.06729729729729739,0.21377506538796856,132040.89506172828,1459.876543209865,133500.77160493814,3237,6,836.35,35,5,17,33.851351351351354,0.6428571428571428,43.05555555555555,1027.777777777777,29.36507936507934,0
4748,4,0,0,40,0.0,0.0,1.0,40,750,600,150,0.8,9,6,3,357.79760110794996,0.7739049145299145,0.06462954622227235,0.21369203062809022,132070.63567654742,1450.9113243741344,133521.54700092156,3238,7,837.35,35,5,17,33.832174492361965,0.643154761904762,43.02662037037037,1027.893518518518,29.36838624338623,0
4749,4,0,1,39,0.0,0.025,0.975,40,400,200,200,0.5,6,2,4,356.92985508674576,0.7731570512820513,0.05970111448834858,0.21350894967916245,132130.126953125,1432.2374131944443,133562.36436631944,3239,8,838.35,35,5,17,33.7945373184735,0.64375,42.96875,1028.125,29.375,0
4750,4,0,0,39,0.0,0.0,1.0,39,1200,800,400,0.6666666666666666,16,8,8,358.6988996589621,0.7719860548807917,0.07168756544389354,0.21558313178286065,132308.68115837174,1691.7956693672622,134000.476827739,3240,9,854.0769230769231,35,4,19,33.56922882213972,0.6455357142857143,42.79513888888888,1028.819444444443,29.394841269841226,0
4751,4,1,0,40,0.025,0.0,1.0,40,1200,700,500,0.5833333333333334,17,7,10,351.0203257164501,0.7776442307692307,0.07695505617977538,0.21281205033218004,132636.34366426602,1311.64065179183,133947.98431605785,3241,0,833.7,35,5,15,33.437265917602986,0.648809523809524,42.47685185185185,1030.092592592592,29.431216931216913,0
4752,4,0,0,40,0.0,0.0,1.0,40,1000,700,300,0.7,13,7,6,350.45830428650663,0.7778579059829059,0.07365198831723219,0.21280899213905047,132695.96220207462,1300.8803798010815,133996.8425818757,3242,1,834.7,35,5,16,33.391840784842366,0.6494047619047618,42.418981481481474,1030.324074074073,29.437830687830658,0
4753,4,1,0,41,0.024390243902439025,0.0,1.0,41,850,500,350,0.5882352941176471,12,5,7,342.5334476448021,0.7826727642276423,0.0837590954230687,0.2098962484196676,133036.2050183629,913.8699933041116,133950.075011667,3243,0,815.3170731707318,36,5,17,33.254648328057336,0.6507523148148149,42.08896396396396,1031.6441441441439,28.656781781781774,0
4754,4,0,0,41,0.0,0.0,1.0,41,1150,900,250,0.782608695652174,14,9,5,352.45152798864007,0.7826727642276423,0.14546102487238888,0.20052682289231452,130206.62607725472,986.8776249859412,131193.50370224068,3244,1,816.3170731707318,37,4,17,35.85356682423723,0.6204954954954953,44.846491228070185,1020.6140350877208,27.58416311047894,8
4755,4,0,0,41,0.0,0.0,1.0,41,950,800,150,0.8421052631578947,11,8,3,350.29180150426896,0.7808434959349594,0.14150585067229682,0.19972853421961134,130290.5716783051,927.9438144429325,131218.51549274803,3245,2,817.3170731707318,37,4,17,35.82355547202234,0.6213400900900898,44.764254385964925,1020.9429824561423,27.593053579895738,0
4756,4,1,1,41,0.023809523809523808,0.023809523809523808,0.9761904761904762,42,1150,900,250,0.782608695652174,14,9,5,343.00915131869994,0.7910859465737514,0.13513473143335175,0.1966750313676289,130508.09500328741,553.0941814595815,131061.189184747,3246,0,798.8333333333334,38,4,15,35.78915725637811,0.6217105263157894,44.55128205128206,1021.7948717948725,26.889338731444013,0
4757,4,1,1,41,0.023809523809523808,0.023809523809523808,0.9761904761904762,42,1300,800,500,0.6153846153846154,18,8,10,343.38105954147466,0.7883517228029423,0.13943872219734343,0.1977230288695496,130671.89554569374,574.0507889546541,131245.94633464838,3247,0,799.8095238095239,38,4,16,35.61389759665624,0.6233552631578946,44.39102564102565,1022.4358974358984,26.906207827260484,0
4758,4,0,0,41,0.0,0.0,1.0,41,900,600,300,0.6666666666666666,12,6,6,350.99357493179866,0.7828252032520325,0.15090351675717506,0.20201630201630208,130654.64854570647,971.7884349030574,131626.43698060952,3248,5,820.3170731707318,37,4,16,35.43677606177607,0.625,44.40789473684211,1022.3684210526324,27.631578947368443,0
4759,4,0,0,41,0.0,0.0,1.0,41,1100,900,200,0.8181818181818182,13,9,4,349.7330810613347,0.7823170731707317,0.15532376545630422,0.20216912306705398,130822.85534972291,950.6160549399746,131773.47140466288,3249,6,821.3170731707318,37,4,16,35.298767416934616,0.6266891891891893,44.243421052631575,1023.026315789473,27.64935988620197,0
4760,4,0,0,41,0.0,0.0,1.0,41,1050,900,150,0.8571428571428571,12,9,3,350.3092690928056,0.7820630081300813,0.16209986593597803,0.20294453187108374,130906.99932912066,971.5870508233434,131878.586379944,3250,7,822.3170731707318,37,4,16,35.19891335404836,0.6275337837837837,44.16118421052632,1023.355263157896,27.65825035561881,0
4761,4,0,0,41,0.0,0.0,1.0,41,950,700,250,0.7368421052631579,12,7,5,348.10736127061205,0.7820121951219512,0.1599958195618374,0.2019628475737208,130963.11034404836,917.8445531317498,131880.9548971801,3251,8,823.3170731707318,37,4,16,35.1985136582753,0.6280968468468467,44.106359649122815,1023.5745614035103,27.664177335230008,0
4762,4,0,0,41,0.0,0.0,1.0,41,850,400,450,0.47058823529411764,13,4,9,344.9263016290155,0.7822154471544716,0.16353137511458682,0.20070197700394868,131075.368442694,842.2684143198013,131917.6368570138,3252,9,824.3170731707318,37,4,16,35.16648374201379,0.6292229729729729,43.996710526315795,1024.0131578947373,27.67603129445236,0
4763,4,1,1,41,0.023809523809523808,0.023809523809523808,0.9761904761904762,42,900,600,300,0.6666666666666666,12,6,6,337.0969674478522,0.7865127758420442,0.15807816037173827,0.19716061657071957,131273.37643363292,450.37142048360926,131723.74785411652,3253,0,805.6666666666666,38,4,16,35.16710974423131,0.6293859649122806,43.80341880341881,1024.7863247863254,26.96806117858751,0
4764,4,1,0,42,0.023809523809523808,0.0,1.0,42,1050,700,350,0.6666666666666666,14,7,7,335.3902502159309,0.7890534262485482,0.156708197502196,0.1968648459524337,131410.269251315,414.7446170282863,131825.0138683433,3254,0,806.6428571428571,38,4,17,35.07280921121184,0.6307565789473684,43.6698717948718,1025.3205128205136,26.98211875843457,0
4765,4,0,0,42,0.0,0.0,1.0,42,950,600,350,0.631578947368421,13,6,7,338.491217774821,0.7889082462253194,0.16265418780781782,0.1992553146447613,131519.83486969463,503.66181331726017,132023.4966830119,3255,1,807.6428571428571,38,4,17,34.882868104016936,0.6318530701754386,43.56303418803419,1025.747863247863,26.993364822312184,0
4766,4,0,0,42,0.0,0.0,1.0,42,1150,800,350,0.6956521739130435,15,8,7,337.8210799782453,0.7889082462253194,0.15680077340670806,0.19943278876404705,131629.44614517127,493.4403307400064,132122.88647591128,3256,2,808.6428571428571,38,4,15,34.7896061079299,0.6329495614035088,43.45619658119658,1026.1752136752134,27.004610886189827,0
4767,4,0,1,41,0.0,0.023809523809523808,0.9761904761904762,42,850,500,350,0.5882352941176471,12,5,7,338.84860225160025,0.7886904761904762,0.15717258807789491,0.2007604850578221,131766.5244448095,529.7805263349876,132296.3049711445,3257,3,809.6428571428571,38,4,15,34.62517343045437,0.6343201754385965,43.32264957264956,1026.7094017094,27.018668466036843,0
4768,4,0,0,41,0.0,0.0,1.0,41,900,600,300,0.6666666666666666,12,6,6,349.38397297316834,0.78119918699187,0.16036735215092324,0.20630186770068656,131637.38031173046,998.3981850184607,132635.7784967489,3258,15,830.3170731707318,37,4,15,34.48496545214943,0.6348536036036037,43.4484649122807,1026.2061403508767,27.735301090564235,0
4769,4,0,0,41,0.0,0.0,1.0,41,900,600,300,0.6666666666666666,12,6,6,349.36798572233306,0.7815548780487804,0.15787348130932455,0.2065972024224105,131693.6476247499,1001.9088806171101,132695.556505367,3259,16,831.3170731707318,37,4,15,34.42863565146173,0.6354166666666666,43.39364035087719,1026.425438596491,27.74122807017543,0
4770,4,0,0,41,0.0,0.0,1.0,41,1300,1000,300,0.7692307692307693,16,10,6,349.5113879710535,0.78130081300813,0.15741893800053153,0.2068347417310369,131721.7857898584,1007.6528354878417,132729.43862534626,3260,17,832.3170731707318,37,4,16,34.39658548743145,0.6356981981981982,43.36622807017544,1026.5350877192982,27.744191559981033,0
4771,4,0,0,41,0.0,0.0,1.0,41,800,500,300,0.625,11,5,6,352.07683693591616,0.7809451219512195,0.15314489326012404,0.20866123424480504,131778.07113727304,1079.2012927054516,132857.2724299785,3261,18,833.3170731707318,37,4,16,34.27399259575678,0.6362612612612613,43.31140350877193,1026.7543859649127,27.750118539592233,0
4772,4,0,1,40,0.0,0.024390243902439025,0.975609756097561,41,1100,900,200,0.8181818181818182,13,9,4,349.8546207413575,0.7800813008130081,0.1574639145195893,0.20795926948636034,131890.67790089268,1028.5126192674784,132919.19052016016,3262,19,834.3170731707318,37,4,16,34.21754910333049,0.6373873873873873,43.20175438596492,1027.1929824561412,27.761972498814625,0
4773,4,0,0,40,0.0,0.0,1.0,40,950,700,250,0.7368421052631579,12,7,5,353.2418847652327,0.7780982905982906,0.15244410346339365,0.2103772164881192,131963.74584043518,1323.0244602711039,133286.7703007063,3263,20,845.975,36,4,16,34.056928613181356,0.6400462962962962,43.13063063063064,1027.4774774774787,28.541041041041076,0
4774,4,0,0,40,0.0,0.0,1.0,40,750,400,350,0.5333333333333333,11,4,7,352.56956580647136,0.7773504273504274,0.14929322813938217,0.21029737631044831,132021.60564280505,1309.3600357113983,133330.96567851646,3264,21,846.975,36,4,16,34.015906932573614,0.640625,43.07432432432433,1027.7027027027034,28.547297297297316,0
4775,4,0,0,40,0.0,0.0,1.0,40,1050,700,350,0.6666666666666666,14,7,7,354.4902049419263,0.7780448717948718,0.14614373356704657,0.21176613813546497,132079.47812677556,1364.1762539566753,133443.65438073225,3265,22,847.975,36,4,17,33.9082584721005,0.6412037037037036,43.018018018018026,1027.927927927929,28.553553553553584,0
4776,4,0,0,40,0.0,0.0,1.0,40,550,300,250,0.5454545454545454,8,3,5,356.0932797068286,0.7777510683760683,0.14740661627779583,0.21288641456736354,132108.41912436095,1408.584048575614,133517.00317293656,3266,23,848.975,36,4,17,33.837906671048316,0.6414930555555556,42.98986486486487,1028.0405405405415,28.55668168168171,0
4777,4,1,0,41,0.024390243902439025,0.0,1.0,41,950,600,350,0.631578947368421,13,6,7,339.6234738560624,0.7838922764227643,0.12431022478098641,0.20490907278667847,132454.4330947985,796.9269390581812,133251.36003385668,3267,0,829.2439024390244,37,4,20,33.91341783837523,0.6430180180180181,42.65350877192983,1029.3859649122815,27.821242294926527,2
4778,4,0,0,41,0.0,0.0,1.0,41,1050,800,250,0.7619047619047619,13,8,5,344.48806985864127,0.7815548780487804,0.12970396257081562,0.2087819953711017,132623.7941001078,937.4629693751999,133561.257069483,3268,1,830.2439024390244,37,4,21,33.6180895607125,0.6447072072072071,42.4890350877193,1030.0438596491233,27.839023233760088,0
4779,4,0,0,41,0.0,0.0,1.0,41,900,600,300,0.6666666666666666,12,6,6,344.34345712868867,0.7815548780487804,0.1218448025706178,0.20916583494753008,132708.5151801517,939.4617815097087,133647.97696166142,3269,2,831.2439024390244,37,4,15,33.53674488311874,0.6455518018018017,42.40679824561404,1030.3728070175448,27.847913703176886,0
4780,4,0,1,40,0.0,0.024390243902439025,0.975609756097561,41,1400,1000,400,0.7142857142857143,18,10,8,342.1832026677308,0.7800813008130081,0.12427792894327916,0.20879614890880446,132878.03849501783,893.7265552862536,133771.7650503041,3270,3,832.2439024390244,37,4,16,33.42228987202665,0.6472409909909909,42.242324561403514,1031.0307017543869,27.865694642010457,0
4781,4,0,0,40,0.0,0.0,1.0,40,1350,1000,350,0.7407407407407407,17,10,7,348.1662938513652,0.7730235042735043,0.13377307986452536,0.21202701847116068,132803.95418644993,1247.5721075805475,134051.52629403048,3271,28,853.975,36,4,16,33.34243781638079,0.6484375,42.314189189189186,1030.743243243243,28.631756756756747,0
4782,4,0,0,40,0.0,0.0,1.0,40,650,400,250,0.6153846153846154,9,4,5,348.60740788907344,0.7732104700854701,0.13346531949754215,0.21262497130076397,132861.99787202742,1263.3353370262143,134125.33320905364,3272,29,854.975,36,4,17,33.27280174767887,0.6490162037037037,42.25788288288288,1030.9684684684685,28.638013013013012,0
4783,4,0,0,40,0.0,0.0,1.0,40,850,300,550,0.35294117647058826,14,3,11,349.63072006009696,0.7722756410256411,0.1369484491044124,0.21341459152468328,132891.02447041645,1292.55691502314,134183.58138543958,3273,30,855.975,36,4,17,33.21728920926168,0.6493055555555556,42.22972972972973,1031.0810810810817,28.64114114114116,0
4784,4,0,0,40,0.0,0.0,1.0,40,1100,1000,100,0.9090909090909091,12,10,2,349.03710030327767,0.7725961538461539,0.12876173837082328,0.21338329536564868,132949.08717839463,1280.8327753429085,134229.91995373755,3274,31,856.975,36,4,18,33.17431935648248,0.6498842592592593,42.17342342342342,1031.3063063063064,28.6473973973974,0
4785,4,0,0,40,0.0,0.0,1.0,40,900,800,100,0.8888888888888888,10,8,2,351.01828721801644,0.7725160256410256,0.1242139737991268,0.2149283095532775,133007.1625679734,1337.5892784676598,134344.75184644107,3275,32,857.975,36,4,18,33.06495633187774,0.650462962962963,42.11711711711712,1031.5315315315318,28.65365365365366,0
4786,4,0,0,40,0.0,0.0,1.0,40,650,500,150,0.7692307692307693,8,5,3,353.28767241438067,0.771741452991453,0.1313796114385506,0.21665472922761406,133065.2506391526,1402.0625355084742,134467.31317466107,3276,33,858.975,36,4,18,32.948137233500695,0.6510416666666667,42.06081081081081,1031.7567567567562,28.659909909909896,0
4787,4,0,0,40,0.0,0.0,1.0,40,1200,900,300,0.75,15,9,6,355.6319937471257,0.770940170940171,0.1238001745200703,0.21911519614742253,133239.59094229358,1476.8522745718617,134716.44321686545,3277,34,859.975,36,4,19,32.712741783013385,0.6527777777777779,41.89189189189189,1032.4324324324318,28.67867867867866,0
4788,4,0,0,40,0.0,0.0,1.0,40,900,500,400,0.5555555555555556,13,5,8,356.85892473109624,0.7712873931623931,0.12505998473115953,0.22004300476526015,133268.65875588413,1511.6220527960265,134780.28080868017,3278,35,860.975,36,4,19,32.65191587595885,0.6530671296296298,41.86373873873873,1032.545045045044,28.681806806806776,0
4789,4,0,0,40,0.0,0.0,1.0,40,1100,900,200,0.8181818181818182,13,9,4,355.37760654876314,0.771607905982906,0.12414949296696154,0.21947259458981197,133326.80389426582,1476.2720913480966,134803.07598561392,3279,36,861.975,36,4,20,32.63184676334824,0.6536458333333335,41.80743243243243,1032.7702702702697,28.688063063063048,0
4790,4,1,0,41,0.024390243902439025,0.0,1.0,41,1100,600,500,0.5454545454545454,16,6,10,348.0985300393716,0.7755589430894309,0.1293817294996824,0.21667068503670994,133617.71981018182,1102.5056306306308,134720.22544081244,3280,0,841.9268292682926,36,5,21,32.52845550593618,0.6565393518518519,41.5259009009009,1033.8963963963965,28.71934434434435,0
4791,4,0,0,41,0.0,0.0,1.0,41,1150,900,250,0.782608695652174,14,9,5,348.90274876584255,0.7751524390243902,0.12875711990652872,0.21785667895406274,133734.17494775174,1132.0442486405273,134866.21919639228,3281,1,842.9268292682926,36,5,16,32.39112683723463,0.6576967592592593,41.413288288288285,1034.3468468468463,28.731856856856844,0
4792,4,0,1,40,0.0,0.024390243902439025,0.975609756097561,41,900,700,200,0.7777777777777778,11,7,4,348.4392459996521,0.7744410569105691,0.13168660912689445,0.2179109157929749,133792.42153893746,1123.7060962989867,134916.12763523645,3282,2,843.9268292682926,36,5,16,32.344844163854724,0.658275462962963,41.356981981981974,1034.572072072071,28.738113113113084,0
4793,4,0,0,40,0.0,0.0,1.0,40,750,400,350,0.5333333333333333,11,4,7,357.0521179556767,0.7705662393162394,0.1354744852282903,0.22280850042262043,133711.52692043892,1548.396776406033,135259.92369684495,3283,40,865.975,35,5,17,32.203073709340494,0.6595238095238095,41.43518518518518,1034.259259259259,29.55026455026454,0
4794,4,0,0,40,0.0,0.0,1.0,40,1250,1000,250,0.8,15,10,5,360.39818026215033,0.7682425213675214,0.1453355704697985,0.22562743218092607,133831.2596450617,1646.5084876543187,135477.76813271604,3284,41,866.975,35,5,18,31.996644295302,0.6607142857142857,41.31944444444444,1034.7222222222222,29.563492063492063,0
4795,4,0,0,40,0.0,0.0,1.0,40,600,400,200,0.6666666666666666,8,4,4,359.42729157094294,0.768482905982906,0.14704451403646135,0.22520248170538198,133861.20119866685,1622.6737986539792,135483.87499732082,3285,42,867.975,35,5,18,31.99178410319502,0.6610119047619047,41.29050925925926,1034.837962962963,29.566798941798943,0
4796,4,0,0,40,0.0,0.0,1.0,40,750,500,250,0.6666666666666666,10,5,5,359.0794927192355,0.7680021367521368,0.14281281449178107,0.2253507300623246,133921.09435281644,1617.663724922848,135538.75807773927,3286,43,868.975,35,5,19,31.940833612881583,0.6616071428571428,41.23263888888889,1035.0694444444453,29.57341269841272,0
4797,4,0,0,40,0.0,0.0,1.0,40,1300,1000,300,0.7692307692307693,16,10,6,360.7887297657358,0.7672542735042736,0.14479551881662012,0.2268872490742938,133996.38447569194,1668.8770696372121,135665.26154532915,3287,44,869.975,36,4,19,31.821251178304706,0.6603009259259258,41.15990990990991,1035.3603603603606,28.760010010010017,0
4798,4,0,0,40,0.0,0.0,1.0,40,700,500,200,0.7142857142857143,9,5,4,360.1544802495385,0.7669604700854701,0.14685426862425222,0.22666806611187598,134025.53471968605,1653.9793594270118,135679.51407911305,3288,45,870.975,36,4,19,31.808500996918635,0.6605902777777777,41.131756756756765,1035.4729729729743,28.763138138138174,0
4799,4,0,0,40,0.0,0.0,1.0,40,700,300,400,0.42857142857142855,11,3,8,358.86397266735275,0.7670940170940171,0.1473031752936056,0.2260351433321218,134054.68813408015,1621.4795876958165,135676.16772177597,3289,46,871.975,36,4,19,31.812744671596352,0.6608796296296295,41.10360360360361,1035.5855855855866,28.766266266266296,0
4800,4,0,0,40,0.0,0.0,1.0,40,900,800,100,0.8888888888888888,10,8,2,362.351843100189,0.7662927350427351,0.14447282608695677,0.2289585821786909,134171.33349565786,1723.4459966723552,135894.7794923302,3290,47,872.975,36,4,20,31.605751811594196,0.662037037037037,40.990990990990994,1036.0360360360364,28.77877877877879,0
4801,4,0,0,40,0.0,0.0,1.0,40,950,800,150,0.8421052631578947,11,8,3,366.40502298069754,0.7652510683760684,0.146623383679235,0.23207332598013503,134258.8508060426,1838.623462990023,136097.47426903262,3291,48,873.975,36,4,20,31.41321670469773,0.6629050925925926,40.906531531531535,1036.3738738738746,28.788163163163183,0
4802,4,0,0,40,0.0,0.0,1.0,40,1100,700,400,0.6363636363636364,15,7,8,369.07987116432093,0.7640491452991452,0.15339452530958098,0.23432753751301624,134346.39665002833,1916.910153396631,136263.30680342496,3292,49,874.975,36,4,20,31.256336447244557,0.6637731481481481,40.82207207207207,1036.711711711711,28.797547547547524,0
4803,4,0,0,40,0.0,0.0,1.0,40,750,400,350,0.5333333333333333,11,4,7,369.9330732657346,0.7644764957264957,0.15900108577633,0.23562127280618353,134463.16882761128,1948.4746570895081,136411.6434847008,3293,50,875.975,36,4,20,31.117444806369885,0.6649305555555556,40.70945945945945,1037.1621621621614,28.81006006006004,0
4804,4,0,0,40,0.0,0.0,1.0,40,700,500,200,0.7142857142857143,9,5,4,368.54244286382493,0.7642628205128205,0.15753012048192772,0.2353001750592111,134550.78124999988,1917.5917894245456,136468.37303942442,3294,51,876.975,34,6,20,31.065930388219545,0.6700367647058825,40.62499999999999,1037.499999999999,30.514705882352914,0
4805,4,0,0,40,0.0,0.0,1.0,40,1100,600,500,0.5454545454545454,16,6,10,368.28847898743265,0.7632211538461539,0.15016339869281037,0.23633876565484896,134736.1128826529,1924.3516156462408,136660.46449829914,3295,52,877.975,34,6,21,30.887369567710127,0.671875,40.44642857142856,1038.2142857142844,30.53571428571425,0
4806,4,0,0,40,0.0,0.0,1.0,40,1350,1100,250,0.8148148148148148,16,11,5,369.7918156081105,0.763167735042735,0.15060160427807512,0.23845196385764317,134911.26543209853,1977.8163580246649,136889.0817901232,3296,53,878.975,35,5,20,30.67346256684491,0.6714285714285715,40.277777777777764,1038.888888888887,29.68253968253963,0
4807,4,0,0,40,0.0,0.0,1.0,40,800,600,200,0.75,10,6,4,370.40668854104956,0.7638621794871795,0.15145355312987352,0.23924541364903168,134971.3930148318,1998.8613468792678,136970.25436171106,3297,54,879.975,35,5,20,30.597479022796463,0.6720238095238096,40.2199074074074,1039.120370370369,29.6891534391534,0
4808,4,0,0,40,0.0,0.0,1.0,40,800,500,300,0.625,11,5,6,367.7700011408678,0.7622061965811966,0.15050111358574636,0.23793765203494147,135031.533993484,1932.1094821673264,136963.6434756513,3298,55,880.975,35,5,20,30.605976243504085,0.6726190476190477,40.162037037037024,1039.35185185185,29.69576719576714,0
4809,4,0,0,40,0.0,0.0,1.0,40,950,600,350,0.631578947368421,13,6,7,365.30029675997,0.7619123931623931,0.15378032928942842,0.23682951823651974,135106.32253875487,1870.8759435110724,136977.19848226596,3299,56,881.975,36,4,20,30.595573367995385,0.6712962962962964,40.09009009009009,1039.639639639639,28.87887887887886,0
4810,4,0,0,40,0.0,0.0,1.0,40,1100,900,200,0.8181818181818182,13,9,4,370.039066068134,0.7612446581196581,0.16077306193157237,0.24068174747924534,135223.42443795147,2007.5899379108873,137231.01437586235,3300,57,882.975,36,4,20,30.35562833838603,0.6724537037037037,39.97747747747748,1040.0900900900901,28.891391391391394,0
4811,4,0,0,40,0.0,0.0,1.0,40,800,500,300,0.625,11,5,6,386.8112741274704,0.7601228632478633,0.17027220630372542,0.24907220418909046,134859.7381660996,2441.9210388684123,137301.659204968,3301,58,883.975,34,6,19,30.282951289398277,0.6731004901960785,40.32738095238094,1038.6904761904748,30.549719887955142,2
4812,4,0,1,39,0.0,0.025,0.975,40,1050,800,250,0.7619047619047619,13,8,5,389.24769023072315,0.7608173076923077,0.17369943852412018,0.25106907558340863,134921.5720663265,2503.582057823122,137425.15412414965,3302,59,884.975,34,6,19,30.157843474275225,0.6737132352941178,40.26785714285714,1038.928571428571,30.55672268907562,0
4813,4,0,0,39,0.0,0.0,1.0,39,1350,1000,350,0.7407407407407407,17,10,7,389.19614377617535,0.7585470085470086,0.1744400192330373,0.25133237647206347,134964.31848627943,2705.5184604479205,137669.83694672736,3303,60,897.5128205128206,33,6,19,30.116439635177112,0.6764520202020201,40.22671568627452,1039.093137254903,31.48767082590615,0
4814,4,0,0,39,0.0,0.0,1.0,39,1250,1100,150,0.88,14,11,3,390.7821670254245,0.7587156995051733,0.1726211531659001,0.2528011867690789,135027.99591803632,2753.306570790079,137781.3024888264,3304,61,898.5128205128206,33,6,19,30.011569979955187,0.6770833333333334,40.16544117647059,1039.3382352941176,31.495098039215684,0
4815,4,0,0,39,0.0,0.0,1.0,39,1100,800,300,0.7272727272727273,14,8,6,388.0525409844887,0.7576473234367972,0.17268482843026134,0.25192240323285303,135155.39583633706,2689.478956411005,137844.87479274807,3305,62,899.5128205128206,33,6,20,29.955190532311917,0.6783459595959596,40.04289215686275,1039.8284313725496,31.509952465834836,0
4816,4,0,0,39,0.0,0.0,1.0,39,900,500,400,0.5555555555555556,13,5,8,386.5138921838344,0.7563540260908682,0.17810395336897122,0.2520355564240211,135314.73021193774,2660.204608804309,137974.93482074206,3306,63,900.5128205128206,33,6,20,29.836081664703574,0.6799242424242424,39.88970588235294,1040.4411764705883,31.528520499108737,0
4817,4,0,0,39,0.0,0.0,1.0,39,1050,800,250,0.7619047619047619,13,8,5,386.9783853086066,0.7547795771479983,0.17511709884591253,0.2536858303689753,135506.05536332176,2687.582900807377,138193.63826412914,3307,64,901.5128205128206,33,6,20,29.633062617702453,0.6818181818181819,39.705882352941174,1041.176470588235,31.550802139037422,0
4818,4,0,1,38,0.0,0.02564102564102564,0.9743589743589743,39,1350,900,450,0.6666666666666666,18,9,9,386.4811857186592,0.7529802069275754,0.17373635694246414,0.25496636496691427,135732.34116735554,2691.659303994671,138424.0004713502,3308,65,902.5128205128206,32,7,20,29.420362292499696,0.6865234375,39.488636363636374,1042.0454545454559,32.563920454545496,0
4819,4,0,0,38,0.0,0.0,1.0,38,1100,700,400,0.6363636363636364,15,7,8,386.6930359892698,0.7477773826458037,0.18346492821228466,0.2565219103803517,135929.77000114782,2912.6190886134027,138842.38908976121,3309,66,918.4736842105264,32,6,19,29.21812568107519,0.6884765625,39.29924242424242,1042.8030303030303,32.587594696969695,0
4820,4,0,0,38,0.0,0.0,1.0,38,950,500,450,0.5263157894736842,14,5,9,390.05273368664785,0.745228781412992,0.176244149393447,0.26019256205973723,136127.34231519746,3019.368399908172,139146.71071510564,3310,67,919.4736842105264,32,6,19,28.93375680580761,0.6904296875,39.109848484848484,1043.5606060606062,32.611268939393945,0
4821,4,0,2,36,0.0,0.05263157894736842,0.9473684210526316,38,850,500,350,0.5882352941176471,12,5,7,392.2746142921973,0.7435988620199147,0.18481619737460098,0.2618033397580215,136144.78205497898,3081.2283737024386,139226.01042868142,3311,68,920.4736842105264,33,5,18,28.85842335994991,0.688131313131313,39.09313725490197,1043.6274509803932,31.625074272133126,3
4822,4,0,0,36,0.0,0.0,1.0,36,950,700,250,0.7368421052631579,12,7,5,397.26764300962736,0.7384259259259259,0.17366237712964105,0.26451430573638635,136061.46893493022,3610.563813641483,139672.0327485717,3312,69,912.25,32,4,18,28.811166243091698,0.6897786458333333,39.17297979797981,1043.3080808080817,32.603377525252554,0
4823,4,0,0,36,0.0,0.0,1.0,36,1000,600,400,0.6,14,6,8,397.26764300962736,0.7384259259259259,0.17366237712964105,0.26451430573638635,136061.46893493022,3610.563813641483,139672.0327485717,3313,70,913.25,32,4,18,28.811166243091698,0.6897786458333333,39.17297979797981,1043.3080808080817,32.603377525252554,0
4824,4,0,0,36,0.0,0.0,1.0,36,600,400,200,0.6666666666666666,8,4,4,397.26764300962736,0.7380621693121694,0.17366237712964105,0.26451430573638635,136061.46893493022,3610.563813641483,139672.0327485717,3314,71,914.25,32,4,18,28.811166243091698,0.6897786458333333,39.17297979797981,1043.3080808080817,32.603377525252554,0
4825,4,0,0,36,0.0,0.0,1.0,36,800,600,200,0.75,10,6,4,394.2776298050271,0.7382936507936508,0.17485518057067573,0.26349985170559115,136193.23163771574,3539.5889131211366,139732.82055083688,3315,72,915.25,32,4,18,28.757912987379555,0.6910807291666666,39.046717171717184,1043.813131313133,32.619160353535406,0
4826,4,0,0,36,0.0,0.0,1.0,36,500,400,100,0.8,6,4,2,392.6734113601798,0.7385912698412699,0.1748435054773081,0.26301709628842235,136272.70761245672,3502.1337946943454,139774.84140715108,3316,73,916.25,33,3,20,28.720657276995308,0.6893939393939394,38.970588235294116,1044.1176470588234,31.639928698752225,0
4827,4,0,0,36,0.0,0.0,1.0,36,900,500,400,0.5555555555555556,13,5,8,394.1438237072352,0.7373015873015873,0.17830510905132546,0.2647192915253557,136368.69120350337,3549.7754769800003,139918.46668048337,3317,74,917.25,33,3,20,28.586740779850604,0.6903409090909091,38.87867647058823,1044.4852941176464,31.651069518716557,0
4828,4,0,0,36,0.0,0.0,1.0,36,1300,1200,100,0.9230769230769231,14,12,2,391.7346324567299,0.7351521164021164,0.18022983114446522,0.26429691025245217,136528.73894655914,3496.6070742022475,140025.34602076138,3318,75,918.25,33,3,20,28.490462789243285,0.6919191919191918,38.72549019607844,1045.0980392156873,31.669637551990526,0
4829,4,0,0,36,0.0,0.0,1.0,36,850,600,250,0.7058823529411765,11,6,5,374.6158182094969,0.7351521164021164,0.2134888438133875,0.22251276912925533,131862.52170138885,2679.692456026524,134542.21415741538,3319,76,919.25,33,3,21,33.61012508451657,0.6455176767676768,43.229166666666664,1027.083333333333,31.123737373737363,8
4830,4,0,0,36,0.0,0.0,1.0,36,950,700,250,0.7368421052631579,12,7,5,374.50767673341244,0.7367063492063493,0.21571920757967344,0.22318741076116994,131988.41979346873,2686.1352905132544,134674.55508398198,3320,77,920.25,33,3,21,33.48576326774001,0.6467803030303031,43.10661764705882,1027.5735294117637,31.138591800356476,0
4831,4,0,0,36,0.0,0.0,1.0,36,900,300,600,0.3333333333333333,15,3,12,375.2983644471469,0.7345899470899472,0.21360746920937657,0.22459010540025406,132145.87688629373,2718.82629277201,134864.70317906575,3321,78,921.25,33,3,22,33.30651569328567,0.6483585858585859,42.95343137254902,1028.1862745098038,31.157159833630416,0
4832,4,2,1,37,0.05263157894736842,0.02631578947368421,0.9736842105263158,38,700,400,300,0.5714285714285714,10,4,6,357.6541608541466,0.7489331436699858,0.2042060329435138,0.2171785361475861,132695.96220207462,1891.8526020233037,134587.81480409793,3322,0,873.7105263157895,35,3,19,33.20648917846177,0.6494047619047618,42.418981481481474,1030.324074074073,29.437830687830658,0
4833,4,0,0,37,0.0,0.0,1.0,37,850,700,150,0.8235294117647058,10,7,3,368.81683266827963,0.7431181181181181,0.21870900026239837,0.22345961038136947,132612.5,2381.9444444444443,134994.44444444444,3323,1,898.3243243243244,34,3,23,33.0029665587918,0.650735294117647,42.5,1030.0,30.294117647058822,0
4834,4,2,1,38,0.05128205128205128,0.02564102564102564,0.9743589743589743,39,950,800,150,0.8421052631578947,11,8,3,351.3306125101921,0.7636077372919479,0.20900710291672975,0.21545455634661181,133065.2506391527,1549.9792021751543,134615.22984132788,3324,0,853.2051282051282,36,3,21,32.9986174779888,0.6510416666666666,42.060810810810814,1031.756756756757,28.65990990990992,0
4835,4,0,0,38,0.0,0.0,1.0,38,750,500,250,0.6666666666666666,10,5,5,358.2899704111825,0.7538229018492176,0.213237639553429,0.21895498191794488,132934.5703125,1925.8246527777776,134860.39496527778,3325,1,876.6578947368421,35,3,21,32.95033670033669,0.6517857142857143,42.1875,1031.25,29.464285714285715,0
4836,4,0,0,38,0.0,0.0,1.0,38,1050,500,550,0.47619047619047616,16,5,11,357.0784756531496,0.7556306306306306,0.2099890178666315,0.21891317276287334,133053.9547432271,1902.1406678669423,134956.09541109405,3326,2,877.6578947368421,35,3,21,32.861696956099,0.6529761904761904,42.07175925925926,1031.7129629629635,29.477513227513242,0
4837,4,0,0,38,0.0,0.0,1.0,38,1200,900,300,0.75,15,9,6,352.29942143481105,0.7532005689900427,0.21028235874887358,0.2172315665861321,133268.65875588427,1790.0942750182635,135058.75303090253,3327,3,878.6578947368421,36,2,21,32.76961318936999,0.6530671296296295,41.86373873873874,1032.545045045045,28.681806806806808,0
4838,4,0,0,38,0.0,0.0,1.0,38,950,800,150,0.8421052631578947,11,8,3,350.82009169697994,0.7520744428639166,0.21108012097630402,0.21665798390255925,133326.80389426593,1754.7443135703345,135081.54820783625,3328,4,879.6578947368421,36,2,21,32.749518409479165,0.6536458333333334,41.807432432432435,1032.7702702702707,28.688063063063073,0
4839,4,0,0,38,0.0,0.0,1.0,38,1000,500,500,0.5,15,5,10,345.84794300469923,0.7491109530583215,0.20668088986768973,0.21459408877309843,133501.3153990139,1634.2310638341096,135135.546462848,3329,5,880.6578947368421,36,2,21,32.703134648214736,0.6553819444444444,41.638513513513516,1033.4459459459463,28.706831831831842,0
4840,4,0,0,38,0.0,0.0,1.0,38,700,500,200,0.7142857142857143,9,5,4,345.49990597427404,0.7488738738738738,0.2093367882182311,0.21505319571185147,133617.7198101818,1632.9819261829396,135250.70173636472,3330,6,881.6578947368421,36,2,22,32.59562320734851,0.6565393518518519,41.5259009009009,1033.8963963963963,28.719344344344343,0
4841,4,0,0,38,0.0,0.0,1.0,38,1600,1300,300,0.8125,19,13,6,342.9534226316939,0.7476292081555239,0.20607922244636012,0.21397311368542646,133705.0564077591,1570.9213436409384,135275.97775140006,3331,7,882.6578947368421,36,2,17,32.574087180603954,0.6574074074074074,41.44144144144144,1034.2342342342342,28.72872872872873,0
4842,4,0,0,38,0.0,0.0,1.0,38,1000,600,400,0.6,14,6,8,341.05879808779395,0.7459992887624467,0.198983800380359,0.21346377635086178,133821.54959013071,1528.20337229122,135349.75296242195,3332,8,883.6578947368421,36,2,18,32.50662095486867,0.6585648148148149,41.32882882882883,1034.684684684685,28.741241241241248,0
4843,4,0,0,38,0.0,0.0,1.0,38,800,600,200,0.75,10,6,4,340.3823955896369,0.7447249881460408,0.1950242148769794,0.21405442852606846,133996.38447569183,1522.002069637198,135518.38654532903,3333,9,884.6578947368421,36,2,19,32.3494489159597,0.6603009259259259,41.159909909909906,1035.3603603603597,28.760010010009992,0
4844,4,0,0,38,0.0,0.0,1.0,38,800,500,300,0.625,11,5,6,337.1720092197643,0.7449917022285444,0.19156418282849685,0.21254084775833937,134083.8447188742,1441.863865554737,135525.70858442894,3334,10,885.6578947368421,36,2,20,32.345239389656044,0.6611689814814815,41.07545045045045,1035.6981981981976,28.76939439439438,0
4845,4,0,0,38,0.0,0.0,1.0,38,1100,900,200,0.8181818181818182,13,9,4,337.63338372540056,0.74641417733523,0.19184533647494773,0.21384996768237172,134258.85080604246,1466.0540185455638,135724.90482458804,3335,11,886.6578947368421,36,2,21,32.158671085515586,0.6629050925925927,40.90653153153153,1036.3738738738734,28.78816316316315,0
4846,4,0,0,38,0.0,0.0,1.0,38,1100,800,300,0.7272727272727273,14,8,6,335.5608460909552,0.7469476055002371,0.19010549186654768,0.21287647059043743,134317.2115316331,1414.3194292265352,135731.53096085964,3336,12,887.6578947368421,36,2,22,32.15417345645481,0.6634837962962963,40.85022522522523,1036.5990990991002,28.794419419419448,0
4847,4,0,0,38,0.0,0.0,1.0,38,1300,1000,300,0.7692307692307693,16,10,6,336.80208286989625,0.746354907539118,0.19191466014368097,0.21434764209736526,134433.9710276155,1455.5282901144446,135889.49931772996,3337,13,888.6578947368421,36,2,23,32.00560140442321,0.6646412037037037,40.737612612612615,1037.04954954955,28.806931931931942,0
4848,4,0,0,38,0.0,0.0,1.0,38,1050,600,450,0.5714285714285714,15,6,9,330.4785406686986,0.7467105263157895,0.18103994927076683,0.21099783750386172,134550.78125000015,1293.279893068759,135844.06114306892,3338,14,889.6578947368421,35,3,23,32.05321285140561,0.6678571428571427,40.62500000000001,1037.5000000000011,29.642857142857174,0
4849,4,0,0,38,0.0,0.0,1.0,38,1000,700,300,0.7,13,7,6,329.2983278530343,0.7461474632527264,0.17859805677048146,0.21041764142569166,134580.80317911954,1263.446689600484,135844.24986872,3339,15,890.6578947368421,35,3,23,32.05393660531696,0.6681547619047619,40.59606481481482,1037.615740740741,29.646164021164033,0
4850,4,0,0,38,0.0,0.0,1.0,38,850,600,250,0.7058823529411765,11,6,5,327.96160558186455,0.7446953532479849,0.17888163763556975,0.21008283420415447,134670.88906035668,1233.376200274349,135904.26526063104,3340,16,891.6578947368421,35,3,23,31.99895926256319,0.669047619047619,40.50925925925926,1037.962962962963,29.65608465608466,0
4851,4,0,0,38,0.0,0.0,1.0,38,1150,800,350,0.6956521739130435,15,8,7,330.45394707942614,0.7461178283546704,0.18052655043761856,0.21238057401121863,134791.0504543896,1308.446930727024,136099.4973851166,3341,17,892.6578947368421,35,3,17,31.814719869222767,0.6702380952380952,40.39351851851852,1038.425925925926,29.669312169312175,0
4852,4,0,0,38,0.0,0.0,1.0,38,550,500,50,0.9090909090909091,6,5,1,330.48996538260735,0.7454362256993836,0.1820989283640393,0.21257967450739312,134821.09917534713,1311.4040798611009,136132.50325520823,3342,18,893.6578947368421,35,3,18,31.783893346706787,0.6705357142857142,40.36458333333333,1038.5416666666658,29.672619047619023,0
4853,4,0,0,38,0.0,0.0,1.0,38,300,100,200,0.3333333333333333,5,1,4,329.24722806309705,0.7453176861071598,0.17595367248204052,0.2121316490930578,134881.20666420183,1281.852682398832,136163.05934660067,3343,19,894.6578947368421,35,3,18,31.756383472609105,0.6711309523809523,40.30671296296296,1038.773148148148,29.6792328042328,0
4854,4,1,0,39,0.02564102564102564,0.0,1.0,39,1050,900,150,0.8571428571428571,12,9,3,322.2374098209859,0.7535425101214576,0.17784626490636213,0.20942030117500393,135194.1442075522,912.9221704812991,136107.0663780335,3344,0,872.6923076923077,36,3,19,31.627639415268,0.6721643518518519,40.005630630630634,1039.977477477478,28.88826326326328,0
4855,4,0,0,39,0.0,0.0,1.0,39,800,400,400,0.5,12,4,8,322.85635079633613,0.7543859649122807,0.17844887896858497,0.20999304619401124,135223.42443795144,931.5482712442188,136154.97270919566,3345,1,873.6923076923077,36,3,19,31.582485202829506,0.6724537037037037,39.97747747747748,1040.09009009009,28.891391391391387,0
4856,4,0,0,39,0.0,0.0,1.0,39,750,400,350,0.5333333333333333,11,4,7,321.07133487003614,0.751855600539811,0.1777777777777776,0.20951265072027792,135340.57706355012,890.7959479750134,136231.37301152514,3346,2,874.6923076923077,36,3,20,31.512671356421357,0.6736111111111112,39.86486486486487,1040.5405405405413,28.903903903903924,0
4857,4,0,0,39,0.0,0.0,1.0,39,1050,800,250,0.7619047619047619,13,8,5,322.3511394809801,0.7506747638326586,0.1832650978042587,0.21103498111630184,135457.78041555072,932.9939737034392,136390.77438925416,3347,3,875.6923076923077,36,3,21,31.36313644886773,0.6747685185185186,39.752252252252255,1040.9909909909913,28.916416416416425,0
4858,4,0,0,39,0.0,0.0,1.0,39,550,300,250,0.5454545454545454,8,3,5,324.2568103393723,0.7498313090418354,0.18876253698358147,0.212803600085747,135545.71621875258,990.3243192516895,136536.04053800428,3348,4,876.6923076923077,36,3,21,31.22634367903104,0.6756365740740742,39.667792792792795,1041.3288288288293,28.925800800800815,0
4859,4,0,0,39,0.0,0.0,1.0,39,850,700,150,0.8235294117647058,10,7,3,326.07688941749,0.7501124606387765,0.1960712583280677,0.21487630918024356,135692.3392987583,1049.2271832643546,136741.56648202267,3349,5,877.6923076923077,36,3,21,31.033605346591717,0.6770833333333334,39.52702702702703,1041.8918918918926,28.94144144144146,0
4860,4,0,0,39,0.0,0.0,1.0,39,900,600,300,0.6666666666666666,12,6,6,326.8047613085165,0.7500562303193883,0.19704941196027148,0.21588708536119333,135780.35119156312,1074.733052309061,136855.08424387217,3350,6,878.6923076923077,36,3,23,30.92742661624348,0.677951388888889,39.442567567567565,1042.2297297297291,28.95082582582581,0
4861,4,0,0,39,0.0,0.0,1.0,39,1150,700,450,0.6086956521739131,16,7,9,325.46429376233505,0.7471322537112011,0.1897840129132642,0.21606629566544716,135956.46057797674,1049.7946848876,137006.25526286435,3351,7,879.6923076923077,36,3,18,30.78793686786885,0.6796875,39.27364864864865,1042.9054054054063,28.96959459459462,0
4862,4,0,0,39,0.0,0.0,1.0,39,650,300,350,0.46153846153846156,10,3,7,323.39957485808713,0.7443769680611786,0.18687170630175842,0.21522799292279599,136044.5580715852,999.3504484214036,137043.9085200066,3352,8,880.6923076923077,36,3,18,30.754578655728267,0.6805555555555556,39.18918918918919,1043.2432432432438,28.978978978978994,0
4863,4,0,0,39,0.0,0.0,1.0,39,1250,1000,250,0.8,15,10,5,321.5199785543488,0.7415092217723797,0.19001401919551397,0.21557879690054055,136309.02175401748,965.2147502231892,137274.23650424066,3353,9,881.6923076923077,36,3,18,30.54207555986914,0.6831597222222223,38.93581081081081,1044.2567567567564,29.007132132132124,0
4864,4,0,0,39,0.0,0.0,1.0,39,500,300,200,0.6,7,3,4,325.83720742356473,0.7415092217723797,0.19279271767076667,0.21005228780449928,134901.5162755661,991.1866680870056,135892.7029436531,3354,10,882.6923076923077,36,3,20,31.824751580849135,0.6692708333333334,40.28716216216216,1038.8513513513515,28.856981981981985,2
4865,4,0,0,39,0.0,0.0,1.0,39,800,700,100,0.875,9,7,2,324.3992812061219,0.7403846153846154,0.19274671290276002,0.20963281281303156,134989.2713659605,958.0845203311409,135947.35588629165,3355,11,883.6923076923077,36,3,20,31.77489705244908,0.6701388888888888,40.2027027027027,1039.189189189189,28.86636636636636,0
4866,4,0,0,39,0.0,0.0,1.0,39,600,300,300,0.5,9,3,6,342.0014646094795,0.7388101664417455,0.20610746037881733,0.21674615113785484,134280.73459201385,1386.3760535239583,135667.11064553782,3356,12,884.6923076923077,35,4,19,32.02365996649916,0.6651785714285714,40.885416666666664,1036.458333333333,29.61309523809523,2
4867,4,0,0,39,0.0,0.0,1.0,39,800,400,400,0.5,12,4,8,342.0501776135117,0.7383603238866397,0.21092799500748582,0.2171327739818726,134340.72151759677,1390.2535311642548,135730.97504876103,3357,13,885.6923076923077,35,4,20,31.962547914108146,0.6657738095238095,40.82754629629629,1036.689814814814,29.619708994708976,0
4868,4,0,0,39,0.0,0.0,1.0,39,700,400,300,0.5714285714285714,10,4,6,342.38487018804926,0.7383603238866397,0.21203717218897444,0.2177023457781927,134400.72183909905,1403.3547400120137,135804.07657911105,3358,14,886.6923076923077,35,4,21,31.894021840235133,0.6663690476190476,40.76967592592593,1036.9212962962972,29.62632275132278,0
4869,4,0,0,39,0.0,0.0,1.0,39,950,600,350,0.631578947368421,13,6,7,342.21540178571416,0.7383040935672515,0.21176739926739896,0.21777343749999994,134430.72702331963,1400.8530521261998,135831.58007544582,3359,15,887.6923076923077,35,4,22,31.868489583333343,0.6666666666666666,40.74074074074074,1037.0370370370372,29.629629629629633,0
4870,4,0,0,39,0.0,0.0,1.0,39,1100,600,500,0.5454545454545454,16,6,10,344.4936931175311,0.7363922627080522,0.21297193181691654,0.21976979923813697,134521.57393880375,1468.3667620323074,135989.94070083604,3360,16,888.6923076923077,36,3,22,31.71881784628745,0.6655092592592593,40.653153153153156,1037.387387387388,28.816316316316332,0
4871,4,0,0,39,0.0,0.0,1.0,39,900,600,300,0.6666666666666666,12,6,6,345.1983001289376,0.7367296446243815,0.2124149922499241,0.22075948352040334,134610.82845721877,1493.4890028761174,136104.3174600949,3361,17,889.6923076923077,35,4,23,31.61155104468732,0.668452380952381,40.567129629629626,1037.7314814814813,29.649470899470895,0
4872,4,0,0,39,0.0,0.0,1.0,39,1050,700,350,0.6666666666666666,14,7,7,346.07913052827564,0.7367296446243815,0.20893047562687417,0.22187160269536144,134700.9243853954,1523.4357585305409,136224.36014392594,3362,18,890.6923076923077,35,4,23,31.498889694131634,0.669345238095238,40.48032407407408,1038.078703703705,29.659391534391574,0
4873,4,0,0,39,0.0,0.0,1.0,39,650,500,150,0.7692307692307693,8,5,3,344.03476174068766,0.7362235717498876,0.2003851582634737,0.22147546283076988,134851.15124528468,1478.6967378257968,136329.84798311046,3363,19,891.6923076923077,35,4,17,31.402291805957955,0.6708333333333333,40.33564814814815,1038.6574074074078,29.675925925925938,0
4874,4,0,0,39,0.0,0.0,1.0,39,700,300,400,0.42857142857142855,11,3,8,345.30175041462724,0.736617183985605,0.20254097166893703,0.22321558077558948,135001.46182966817,1523.2482156635797,136524.71004533174,3364,20,892.6923076923077,35,4,20,31.219721015703314,0.6723214285714285,40.19097222222222,1039.2361111111109,29.69246031746031,0
4875,4,1,0,40,0.025,0.0,1.0,40,850,600,250,0.7058823529411765,11,6,5,337.1678347062639,0.7438568376068376,0.19881210087671808,0.21983723534588376,135311.28415155024,1124.5225377404458,136435.80668929068,3365,0,871.35,36,4,22,31.1230472273334,0.6733217592592593,39.89301801801802,1040.4279279279283,28.900775775775784,0
4876,4,0,0,40,0.0,0.0,1.0,40,850,700,150,0.8235294117647058,10,7,3,338.11768128495913,0.743616452991453,0.20136181645769669,0.2208585624965962,135376.81215614395,1154.6587651969558,136531.4709213409,3366,1,872.35,37,3,22,31.033237628630626,0.6720157657657658,39.83004385964911,1040.6798245614016,28.126481744902744,0
4877,4,0,0,40,0.0,0.0,1.0,40,1250,700,550,0.56,18,7,11,337.7024478866588,0.7424145299145299,0.19997366757952406,0.22111358898178887,135462.40790435512,1149.197349184357,136611.60525353948,3367,2,873.35,37,3,22,30.959026753739206,0.6728603603603605,39.747807017543856,1041.008771929824,28.135372214319567,0
4878,4,0,0,40,0.0,0.0,1.0,40,1050,800,250,0.7619047619047619,13,8,5,336.093516547476,0.7417467948717948,0.20193925713113092,0.22042849342339846,135522.4142103148,1109.6409525896645,136632.05516290446,3368,3,874.35,38,2,22,30.941326356111905,0.6716008771929824,39.69017094017094,1041.239316239316,27.401034637876734,0
4879,4,0,0,40,0.0,0.0,1.0,40,1000,800,200,0.8,12,8,4,336.9961981734982,0.7410256410256411,0.20088470612370513,0.22153580148303664,135605.85968889252,1139.731833041123,136745.59152193365,3369,4,875.35,38,2,22,30.835000170957695,0.6724232456140351,39.61004273504273,1041.5598290598289,27.40946918578497,0
4880,4,0,0,40,0.0,0.0,1.0,40,1150,700,450,0.6086956521739131,16,7,9,340.0261444283461,0.7395566239316239,0.20240502110642122,0.22407872270453627,135693.96888931727,1227.907973428553,136921.87686274582,3370,5,876.35,35,5,22,30.668647707916765,0.6791666666666668,39.52546296296295,1041.8981481481458,29.76851851851845,0
4881,4,0,0,40,0.0,0.0,1.0,40,900,600,300,0.6666666666666666,12,6,6,340.7450210143218,0.7388354700854701,0.19990836387870758,0.22474193583823693,135724.11807966794,1249.4634934413307,136973.58157310926,3371,6,877.35,35,5,22,30.6200016661113,0.6794642857142859,39.496527777777764,1042.0138888888869,29.77182539682534,0
4882,4,0,0,40,0.0,0.0,1.0,40,1200,800,400,0.6666666666666666,16,8,8,336.3963396624015,0.7388087606837607,0.1946964787211063,0.22277233995668905,135868.39161796926,1141.125923220512,137009.51754118977,3372,7,878.35,36,4,19,30.590210268596522,0.6788194444444444,39.358108108108105,1042.5675675675673,28.960210210210203,0
4883,4,0,0,40,0.0,0.0,1.0,40,950,700,250,0.7368421052631579,12,7,5,336.06201128491034,0.7379540598290598,0.19464478514359773,0.22328596474324505,135985.8232387792,1139.9338527716795,137125.75709155088,3373,8,879.35,36,4,19,30.482527171957084,0.6799768518518519,39.24549549549549,1043.0180180180173,28.972722722722704,0
4884,4,0,0,40,0.0,0.0,1.0,40,750,500,250,0.6666666666666666,10,5,5,335.7968048942343,0.7370192307692308,0.19423243009824076,0.2232940275474006,136015.18906998198,1134.6931813570166,137149.882251339,3374,9,880.35,36,4,19,30.46034402101551,0.6802662037037038,39.217342342342334,1043.1306306306294,28.97585085085082,0
4885,4,0,0,40,0.0,0.0,1.0,40,1200,800,400,0.6666666666666666,16,8,8,335.91706611779813,0.7360309829059829,0.19615384615384635,0.22385061632891906,136090.93663434882,1143.053631886713,137233.99026623555,3375,10,881.35,37,3,19,30.38216337396665,0.6790540540540542,39.14473684210525,1043.4210526315774,28.200568990042633,0
4886,4,0,0,40,0.0,0.0,1.0,40,850,600,250,0.7058823529411765,11,6,5,334.58461588931203,0.7338675213675213,0.19742861529014455,0.22376634372720505,136218.57792981577,1115.3281147271396,137333.9060445429,3376,11,882.35,38,2,19,30.290528093337418,0.678453947368421,39.02243589743589,1043.9102564102554,27.471322537111984,0
4887,4,0,0,40,0.0,0.0,1.0,40,1000,800,200,0.8,12,8,4,341.97398465036747,0.7338675213675213,0.13967767120232,0.21869748547611964,134610.82845721897,1209.4539455595138,135820.28240277848,3377,12,883.35,35,5,20,31.695200386645848,0.6684523809523808,40.56712962962964,1037.731481481483,29.64947089947094,8
4888,4,0,0,40,0.0,0.0,1.0,40,1100,800,300,0.7272727272727273,14,8,6,346.0690137869864,0.7333867521367521,0.1035917652212004,0.20736891298574556,132195.26113951797,1149.7367299732264,133344.9978694912,3378,13,884.35,36,4,18,34.00815812527376,0.642361111111111,42.90540540540541,1028.378378378379,28.566066066066085,8
4889,4,1,0,41,0.024390243902439025,0.0,1.0,41,850,600,250,0.7058823529411765,11,6,5,336.3719720946714,0.7398373983739838,0.10112611410578021,0.20279946074837055,132426.97934420916,709.1001897167583,133136.07953392592,3379,0,863.7560975609756,36,5,19,34.02466265499636,0.6446759259259258,42.68018018018019,1029.27927927928,28.591091091091112,0
4890,4,0,0,41,0.0,0.0,1.0,41,1100,700,400,0.6363636363636364,15,7,8,334.9278610592912,0.7392784552845528,0.09977511784305215,0.20239560037442833,132513.9259825705,676.5211579823207,133190.44714055283,3380,1,864.7560975609756,36,5,20,33.974534252068985,0.6455439814814814,42.59572072072073,1029.617117117118,28.6004754754755,0
4891,4,1,1,41,0.023809523809523808,0.023809523809523808,0.9761904761904762,42,900,700,200,0.7777777777777778,11,7,4,325.48936170212767,0.7486933797909407,0.09524822695035473,0.19816062176165805,132793.26331178827,244.55890273930905,133037.82221452758,3381,0,845.1428571428571,37,5,15,33.93750000000001,0.6463963963963963,42.324561403508774,1030.7017543859652,27.85680417259365,0
4892,4,0,0,41,0.0,0.0,1.0,41,700,500,200,0.7142857142857143,9,5,4,331.0892669995713,0.7409044715447154,0.09771669114860981,0.20126629568318055,132736.76155163127,589.5434172052946,133326.30496883657,3382,3,866.7560975609756,37,4,15,33.84984393842662,0.6458333333333333,42.37938596491228,1030.482456140351,27.850877192982455,0
4893,4,0,3,38,0.0,0.07317073170731707,0.926829268292683,41,1400,1200,200,0.8571428571428571,16,12,4,332.41068883234385,0.7397865853658536,0.08881813491250634,0.20344745282016002,132991.1141529125,641.5335728301055,133632.6477257426,3383,4,867.7560975609756,37,4,17,33.56088994011551,0.648367117117117,42.13267543859649,1031.4692982456145,27.877548601232824,0
4894,4,0,0,38,0.0,0.0,1.0,38,1000,700,300,0.7,13,7,6,368.29293338432257,0.7192982456140351,0.15830576934280094,0.2181055966021798,131749.07415378542,2106.187911557386,133855.2620653428,3384,40,935.078947368421,32,6,20,33.88702701594719,0.6468098958333333,43.33964646464647,1026.641414141415,32.08254419191922,4
4895,4,0,0,38,0.0,0.0,1.0,38,750,500,250,0.6666666666666666,10,5,5,367.7491580752316,0.7200094831673779,0.15902736427887265,0.21796910739561098,131781.48275686151,2092.505866748294,133873.9886236098,3385,41,936.078947368421,32,6,20,33.868257091326456,0.6471354166666666,43.30808080808081,1026.7676767676767,32.086489898989896,0
4896,4,0,0,38,0.0,0.0,1.0,38,1050,800,250,0.7619047619047619,13,8,5,366.61557022666955,0.718142484589853,0.16115557229388267,0.21848411914361246,131988.41979346902,2077.8019571799505,134066.22175064895,3386,42,937.078947368421,33,5,21,33.688506261180684,0.646780303030303,43.10661764705883,1027.573529411766,31.138591800356547,0
4897,4,1,1,38,0.02564102564102564,0.02564102564102564,0.9743589743589743,39,750,200,550,0.26666666666666666,13,2,11,357.585310856529,0.7257647323436798,0.15356725354411038,0.21489932242156645,132306.12953514745,1662.1456916099835,133968.27522675743,3387,0,914.025641025641,34,5,21,33.6004397130294,0.647671568627451,42.79761904761905,1028.8095238095243,30.259103641456598,0
4898,4,0,0,38,0.0,0.0,1.0,38,900,600,300,0.6666666666666666,12,6,6,367.08721575290406,0.7165718349928877,0.1614014177278713,0.21967630101047536,132145.87688629376,2101.8124038831206,134247.68929017687,3388,44,939.078947368421,33,5,21,33.51758045292013,0.6483585858585859,42.95343137254902,1028.186274509804,31.157159833630423,0
4899,4,0,0,38,0.0,0.0,1.0,38,800,400,400,0.5,12,4,8,363.0924203608823,0.716957088667615,0.11970370188531021,0.20703993331216247,130292.97052154179,1861.9182967304378,132154.88881827224,3389,45,940.078947368421,34,4,19,35.494402985074636,0.627450980392157,44.76190476190475,1020.9523809523797,30.028011204481757,8
4900,4,0,0,38,0.0,0.0,1.0,38,900,600,300,0.6666666666666666,12,6,6,363.93024759589605,0.7179943100995733,0.11479990920301142,0.20800516949534895,130384.14292800434,1890.146683673447,132274.28961167778,3390,46,941.078947368421,34,4,20,35.38048335081789,0.6283700980392158,44.67261904761904,1021.3095238095223,30.038515406162418,0
4901,4,1,1,38,0.02564102564102564,0.02564102564102564,0.9743589743589743,39,800,600,200,0.75,10,6,4,354.4792651228737,0.7305443094916779,0.1114130434782612,0.20382557744565197,130617.283950617,1460.2237654320666,132077.50771604906,3391,0,917.9230769230769,35,4,17,35.38552989130436,0.6285714285714287,44.44444444444443,1022.2222222222199,29.20634920634914,0
4902,4,0,0,38,0.0,0.0,1.0,38,1150,900,250,0.782608695652174,14,9,5,365.676785471926,0.7171052631578947,0.10796771700867214,0.20949520513485065,130475.34722222188,1942.3611111110715,132417.70833333296,3392,48,943.078947368421,34,4,20,35.243338771071244,0.6292892156862746,44.583333333333314,1021.6666666666639,30.049019607843057,0
4903,4,2,0,40,0.05,0.0,1.0,40,850,600,250,0.7058823529411765,11,6,5,341.87856384386896,0.7408653846153846,0.11532726881257371,0.19188579936832023,129675.59880203521,869.439274584483,130545.03807661969,3393,0,896.875,37,3,16,36.661979222736576,0.6151463963963963,45.36732456140351,1018.5307017543857,27.527856804172586,6
4904,4,1,0,41,0.024390243902439025,0.0,1.0,41,950,600,350,0.631578947368421,13,6,7,334.46778286863344,0.7476626016260163,0.112735877987447,0.18910903552714686,129962.83512309156,493.6762637884426,130456.51138688,3394,0,875.9756097560976,38,3,17,36.55940032131879,0.6162280701754386,45.085470085470085,1019.6581196581199,26.833108412055786,0
4905,4,2,1,42,0.046511627906976744,0.023255813953488372,0.9767441860465116,43,1100,900,200,0.8181818181818182,13,9,4,322.2388490109603,0.7669342930970837,0.11443290694025898,0.18437616010734792,130426.23325525929,-193.6295794068689,130232.60367585241,3395,0,836.1860465116279,38,5,18,36.40244221315761,0.620888157894737,44.631410256410234,1021.4743589743556,26.880904183535673,0
4906,4,3,2,43,0.06666666666666667,0.044444444444444446,0.9555555555555556,45,950,600,350,0.631578947368421,13,6,7,312.81756291795796,0.7773148148148149,0.12749989229244818,0.18129359432930633,130921.6939090451,-809.0789556563302,130112.61495338878,3396,0,799.9555555555555,41,4,12,36.143288742406625,0.6209349593495934,44.1468253968254,1023.4126984126984,24.961285327138985,0
4907,4,0,1,42,0.0,0.023255813953488372,0.9767441860465116,43,1050,800,250,0.7619047619047619,13,8,5,328.1141974635778,0.7633813215208564,0.1368816789101006,0.18914251770404863,130714.9102105036,-22.116427951383685,130692.79378255221,3397,1,838.1627906976744,39,4,13,35.9606846966147,0.6220619658119659,44.348958333333336,1022.6041666666677,26.220619658119684,0
4908,4,0,0,42,0.0,0.0,1.0,42,1050,500,550,0.47619047619047616,16,5,11,334.3758280871351,0.7558072009291521,0.13940448287742702,0.1922220270075604,130608.41064453125,334.459092881945,130942.86973741319,3398,2,859.047619047619,39,3,13,35.908255205679545,0.6209935897435896,44.453125,1022.1875,26.209935897435898,0
4909,4,0,0,42,0.0,0.0,1.0,42,750,400,350,0.5333333333333333,11,4,7,332.76277877622516,0.7571864111498258,0.13522461036976652,0.19182220782420464,130714.91021050357,299.4113498263939,131014.32156032996,3399,3,860.047619047619,39,3,15,35.841843231129666,0.6220619658119659,44.348958333333336,1022.6041666666674,26.220619658119677,0
4910,4,1,0,43,0.023255813953488372,0.0,1.0,43,1100,800,300,0.7272727272727273,14,8,6,327.9477515660086,0.7680878552971576,0.13443208895949232,0.19027014710673015,130963.79469892247,-10.143598387210488,130953.65110053527,3400,0,841.0232558139535,40,3,16,35.713694731268205,0.6229166666666668,44.105691056910565,1023.5772357723567,25.58943089430892,0
4911,4,0,0,43,0.0,0.0,1.0,43,850,300,550,0.35294117647058826,14,3,11,328.89083733044345,0.767672572905131,0.13226845172831658,0.19120456930780244,131041.82287535522,19.690970156642038,131061.51384551187,3401,1,842.0232558139535,40,3,16,35.61083540115797,0.6236979166666667,44.02947154471544,1023.8821138211378,25.597052845528445,0
4912,4,1,0,44,0.022727272727272728,0.0,1.0,44,1500,1100,400,0.7333333333333333,19,11,8,326.7828094792376,0.7742908738548274,0.15559879129963838,0.18776763593320517,130589.98243343194,-264.15047798009834,130325.83195545184,3402,0,823.8636363636364,38,6,13,36.12091042123968,0.6225328947368421,44.47115384615385,1022.1153846153845,26.897773279352226,1
4913,4,0,0,44,0.0,0.0,1.0,44,600,400,200,0.6666666666666666,8,4,4,327.43781998997656,0.7740926708949966,0.1505129666571674,0.18854271584260385,130671.89554569364,-242.61587771202804,130429.27966798161,3403,1,824.8636363636364,38,6,13,36.02142110762801,0.6233552631578947,44.39102564102564,1022.4358974358976,26.906207827260463,0
4914,4,0,0,44,0.0,0.0,1.0,44,750,400,350,0.5333333333333333,11,4,7,328.3453217344576,0.7738944679351657,0.156170764365688,0.18946653194478374,130753.83434007231,-213.51803911899694,130540.31630095332,3404,2,825.8636363636364,38,6,14,35.91546537135696,0.6241776315789473,44.31089743589744,1022.7564102564102,26.91464237516869,0
4915,4,1,1,44,0.022222222222222223,0.022222222222222223,0.9777777777777777,45,1550,1000,550,0.6451612903225806,21,10,11,322.4364391961265,0.780892255892256,0.165340202924096,0.1880687985204455,131168.01757812512,-541.3302951388729,130626.68728298624,3405,0,808.4888888888889,39,6,15,35.648854314961696,0.6266025641025641,43.90625000000001,1024.375000000001,26.266025641025664,0
4916,4,1,0,45,0.022222222222222223,0.0,1.0,45,1750,1300,450,0.7428571428571429,22,13,9,324.91815476274957,0.7776094276094276,0.18234822567715536,0.19044190357476015,131354.81906467033,-464.08691406248073,130890.73215060784,3406,0,809.3555555555556,39,6,16,35.39708447650984,0.6284722222222222,43.72395833333334,1025.1041666666683,26.284722222222264,0
4917,4,0,0,45,0.0,0.0,1.0,45,800,400,400,0.5,12,4,8,323.6336308347773,0.7776936026936028,0.1791505791505792,0.18982134652418836,131381.515842014,-496.10460069443366,130885.41124131955,3407,1,810.3555555555556,39,6,16,35.403119284698235,0.6287393162393162,43.69791666666667,1025.2083333333342,26.287393162393183,0
4918,4,1,1,45,0.021739130434782608,0.021739130434782608,0.9782608695652174,46,1200,1000,200,0.8333333333333334,14,10,4,317.23626764722104,0.7859903381642512,0.1810546395614716,0.18720833398211528,131614.739542022,-849.4062520655573,130765.33328995644,3408,0,793.7173913043479,40,6,15,35.33248324584862,0.6294270833333333,43.47052845528456,1026.1178861788624,25.65294715447156,0
4919,4,0,0,45,0.0,0.0,1.0,45,1450,1200,250,0.8275862068965517,17,12,5,327.54399294797514,0.7768518518518519,0.19678092466641828,0.19332749398025795,131621.90890842024,-377.6068793402671,131244.30202907996,3409,3,812.3555555555556,39,6,16,35.06084407674348,0.6311431623931624,43.46354166666667,1026.1458333333342,26.311431623931647,0
4920,4,0,1,44,0.0,0.022222222222222223,0.9777777777777777,45,1300,900,400,0.6923076923076923,17,9,8,329.6808047380123,0.7772727272727273,0.19495298017725515,0.19499847838465612,131702.08875868045,-316.06987847222626,131386.01888020823,3410,4,813.3555555555556,39,6,16,34.92532643258238,0.6319444444444444,43.385416666666664,1026.4583333333326,26.319444444444425,0
4921,4,0,0,44,0.0,0.0,1.0,44,1150,900,250,0.782608695652174,14,9,5,334.79856871754157,0.775854474982382,0.19090586096473783,0.19760938888175578,131621.90890842024,13.36534288195486,131635.2742513022,3411,5,831.3409090909091,39,5,16,34.87473775927993,0.6311431623931624,43.46354166666667,1026.1458333333342,26.311431623931647,0
4922,4,0,0,44,0.0,0.0,1.0,44,950,700,250,0.7368421052631579,12,7,5,343.2641154664288,0.7724409795630727,0.20251705697953182,0.20389061316258955,131862.52170138882,252.7343749999954,132115.25607638882,3412,6,832.3409090909091,39,5,17,34.415145368492226,0.6335470085470085,43.229166666666664,1027.0833333333328,26.33547008547007,0
4923,4,0,0,44,0.0,0.0,1.0,44,1300,1000,300,0.7692307692307693,16,10,6,342.6720912453137,0.7718683932346724,0.20236997842960114,0.20382582411708605,131916.0210503473,240.78776041667186,132156.808810764,3413,7,833.3409090909091,39,5,17,34.37647873994455,0.6340811965811965,43.177083333333336,1027.2916666666672,26.34081196581198,0
4924,4,0,0,44,0.0,0.0,1.0,44,1100,800,300,0.7272727272727273,14,8,6,342.8024970871586,0.7709214235377027,0.20710627400768278,0.2049132552242984,132103.35422092007,257.0719401041616,132360.42616102422,3414,8,834.3409090909091,39,5,17,34.184588948559465,0.6359508547008548,42.994791666666664,1028.0208333333328,26.359508547008534,0
4925,4,0,0,44,0.0,0.0,1.0,44,950,800,150,0.8421052631578947,11,8,3,340.9514711969036,0.771494009866103,0.20421750615464807,0.2041270405662882,132162.7802977725,212.2188759997369,132374.99917377223,3415,9,835.3409090909091,40,4,17,34.17239078869343,0.6348958333333334,42.9369918699187,1028.2520325203252,25.70630081300813,0
4926,4,0,0,44,0.0,0.0,1.0,44,1050,500,550,0.47619047619047616,16,5,11,339.6188426627506,0.7713178294573644,0.19905228171038436,0.2036103488001798,132215.03404058426,180.5433686958753,132395.57740928014,3416,10,836.3409090909091,40,4,17,34.15410902503294,0.6354166666666667,42.886178861788615,1028.4552845528451,25.711382113821127,0
4927,4,1,1,44,0.022222222222222223,0.022222222222222223,0.9777777777777777,45,1400,1000,400,0.7142857142857143,18,10,8,333.9747511148053,0.7788720538720539,0.19639183948743866,0.20191684494005235,132532.04345703154,-147.275722084315,132384.76773494724,3417,0,818.7333333333333,39,6,17,33.98088433653683,0.6402243589743588,42.578125000000014,1029.6875000000023,26.402243589743648,0
4928,4,0,0,44,0.0,0.0,1.0,44,950,700,250,0.7368421052631579,12,7,5,340.39224641824075,0.7705470401691332,0.2024555361607776,0.2053650152936603,132452.9860312114,217.193891993597,132670.179923205,3418,12,838.3409090909091,38,6,17,33.89508735512888,0.6411732456140349,42.65491452991454,1029.3803418803434,27.088956365272196,0
4929,4,1,0,45,0.022222222222222223,0.0,1.0,45,1150,900,250,0.782608695652174,14,9,5,341.92796481762497,0.7763888888888889,0.21669528908643998,0.2088059792553776,132907.71620008687,88.97298177084309,132996.6891818577,3419,0,820.6888888888889,39,6,16,33.399101761120654,0.6439636752136751,42.21354166666667,1031.145833333334,26.439636752136767,0
4930,4,1,1,45,0.021739130434782608,0.021739130434782608,0.9782608695652174,46,1100,700,400,0.6363636363636364,15,7,8,338.2675322084576,0.7811594202898551,0.21213846601708952,0.20795672258529654,133157.36747306507,-191.43718190229703,132965.93029116277,3420,0,803.8260869565217,40,6,16,33.243279834580534,0.6447916666666667,41.97154471544716,1032.1138211382122,25.802845528455304,0
4931,4,0,0,45,0.0,0.0,1.0,45,1450,1000,450,0.6896551724137931,19,10,9,346.08827929029917,0.7765572390572391,0.21650627004957723,0.21241328963133277,133095.75195312526,212.57595486113996,133308.32790798642,3421,2,822.6888888888889,39,6,16,33.103253920183064,0.6458333333333333,42.031250000000014,1031.875000000002,26.458333333333385,0
4932,4,0,0,45,0.0,0.0,1.0,45,1400,1100,300,0.7857142857142857,17,11,6,351.0479015311408,0.7757575757575758,0.22329419943710005,0.21592387686356793,133176.37939453148,350.25770399308453,133526.63709852457,3422,3,823.6888888888889,39,6,16,32.89444360345816,0.6466346153846152,41.953125000000014,1032.1875000000018,26.4663461538462,0
4933,4,1,1,45,0.021739130434782608,0.021739130434782608,0.9782608695652174,46,1050,500,550,0.47619047619047616,16,5,11,347.9448491155044,0.7809581320450886,0.22054698457222965,0.2157258064516129,133472.2222222223,88.19444444445449,133560.41666666677,3423,0,806.7608695652174,40,6,17,32.67809139784946,0.6479166666666667,41.66666666666667,1033.3333333333342,25.833333333333353,0
4934,4,0,0,45,0.0,0.0,1.0,45,1250,800,450,0.64,17,8,9,350.801151007123,0.775,0.22517084537653198,0.21718138674710652,133418.408203125,360.6662326388895,133779.07443576388,3424,5,825.6888888888889,39,6,18,32.65821402164415,0.6490384615384615,41.71875,1033.125,26.490384615384617,0
4935,4,0,0,45,0.0,0.0,1.0,45,1000,800,200,0.8,12,8,4,351.75942981376085,0.7742003367003367,0.23017270851753624,0.2182575790648252,133500.54974848026,392.0371532586921,133892.58690173895,3425,6,826.6888888888889,37,8,18,32.551171529619815,0.6534346846846846,41.63925438596491,1033.44298245614,27.930891417733516,0
4936,4,0,0,45,0.0,0.0,1.0,45,1150,700,450,0.6086956521739131,16,7,9,350.9080270880305,0.7732744107744108,0.23316950131419234,0.21806262171119717,133557.21381819394,373.25968086332966,133930.47349905726,3426,7,827.6888888888889,37,8,18,32.516420034652235,0.6539977477477478,41.5844298245614,1033.6622807017536,27.93681839734469,0
4937,4,1,1,45,0.021739130434782608,0.021739130434782608,0.9782608695652174,46,1150,900,250,0.782608695652174,14,9,5,347.3421840187088,0.7783212560386473,0.22644254081137904,0.2172908081419364,133803.62426035502,95.12861604207927,133898.7528763971,3427,0,810.6739130434783,38,8,15,32.36201466336227,0.6546052631578947,41.34615384615385,1034.6153846153845,27.226720647773277,0
4938,4,0,0,45,0.0,0.0,1.0,45,1200,900,300,0.75,15,9,6,331.56247715177705,0.7740319865319866,0.2040019714144894,0.20226706739054606,132869.07723783806,-187.03967135102425,132682.03756648704,3428,9,829.6888888888889,40,5,15,33.70502710694923,0.6419270833333333,42.25101626016261,1030.9959349593507,25.774898373983767,2
4939,4,0,0,45,0.0,0.0,1.0,45,900,600,300,0.6666666666666666,12,6,6,328.82358942965004,0.7740319865319866,0.20058361391694723,0.20094774909589724,132934.5703125,-257.5954861111122,132676.97482638888,3429,10,830.6888888888889,41,4,15,33.71001683501683,0.6410060975609756,42.1875,1031.25,25.152439024390244,0
4940,4,0,0,45,0.0,0.0,1.0,45,1200,800,400,0.6666666666666666,16,8,8,328.54011114409496,0.7730218855218856,0.1979316030598084,0.20137976760801252,133047.01232084903,-257.74395694370025,132789.2683639053,3430,11,831.6888888888889,42,3,16,33.60473216242447,0.640625,42.07848837209302,1031.6860465116274,24.563953488372082,0
4941,4,0,0,45,0.0,0.0,1.0,45,1700,1400,300,0.8235294117647058,20,14,6,328.6841388696914,0.7731481481481481,0.19558559686235188,0.20214454083371558,133172.0036355989,-245.6949326963463,132926.30870290255,3431,12,832.6888888888889,42,3,16,33.475912191763676,0.6418650793650793,41.957364341085274,1032.1705426356596,24.575489110372846,0
4942,4,0,0,45,0.0,0.0,1.0,45,850,500,350,0.5882352941176471,12,5,7,327.5796686808498,0.7731902356902357,0.19303339382183005,0.2017360572327037,133222.01659305327,-271.835188690585,132950.1814043627,3432,13,833.6888888888889,42,3,17,33.45437550841625,0.6423611111111112,41.90891472868217,1032.3643410852712,24.580103359173126,0
4943,4,0,0,45,0.0,0.0,1.0,45,1300,1100,200,0.8461538461538461,15,11,4,325.79366387784165,0.7736952861952863,0.19084084084084108,0.20090609272466914,133272.0389399676,-316.16282825550707,132955.8761117121,3433,14,834.6888888888889,42,3,17,33.450442630130134,0.6428571428571428,41.86046511627907,1032.5581395348843,24.584717607973435,0
4944,4,0,0,45,0.0,0.0,1.0,45,1150,700,450,0.6086956521739131,16,7,9,327.12762579556363,0.7732323232323233,0.1881810884906865,0.20213642686115427,133347.09006557593,-275.6966040201935,133071.39346155574,3434,15,835.6888888888889,42,3,17,33.34095599962472,0.6436011904761905,41.78779069767442,1032.848837209302,24.59163898117386,0
4945,4,0,0,45,0.0,0.0,1.0,45,1550,1100,450,0.7096774193548387,20,11,9,330.3850156087406,0.7731481481481481,0.19121863799283134,0.2048387096774194,133472.2222222223,-180.5555555555456,133291.66666666677,3435,16,836.6888888888889,42,3,17,33.13172043010753,0.6448412698412698,41.66666666666667,1033.3333333333342,24.603174603174622,0
4946,4,0,1,44,0.0,0.022222222222222223,0.9777777777777777,45,1000,600,400,0.6,14,6,8,329.3478629281073,0.7719276094276095,0.19020972595502283,0.20450007868847925,133527.4273595586,-204.6054313682651,133322.82192819036,3436,17,837.6888888888889,38,7,17,33.10333540073048,0.6518640350877194,41.61324786324786,1033.5470085470074,27.198605488079142,0
4947,4,0,0,44,0.0,0.0,1.0,44,950,600,350,0.631578947368421,13,6,7,332.50123343155803,0.770877378435518,0.19157521891089524,0.20676619117504838,133582.64391116946,83.27877310248459,133665.92268427194,3437,18,825.9545454545455,38,6,18,32.96666149924212,0.6524122807017544,41.559829059829056,1033.760683760683,27.20422852001797,0
4948,4,0,0,44,0.0,0.0,1.0,44,950,800,150,0.8421052631578947,11,8,3,333.6691305031312,0.770877378435518,0.18884912359803918,0.2078024353287837,133637.87187705436,118.16650230110196,133756.03837935548,3438,19,826.9545454545455,38,6,18,32.881277123372584,0.6529605263157896,41.50641025641025,1033.9743589743575,27.209851551956778,0
4949,4,0,0,44,0.0,0.0,1.0,44,1350,800,550,0.5925925925925926,19,8,11,332.5293695785809,0.7700405214940099,0.18575788880540967,0.20740233875777447,133693.11125721358,91.37720067204702,133784.48845788563,3439,20,827.9545454545455,38,6,18,32.85554407713498,0.6535087719298247,41.45299145299144,1034.1880341880324,27.21547458389559,0
4950,4,0,0,44,0.0,0.0,1.0,44,1100,800,300,0.7272727272727273,14,8,6,331.568556559043,0.7694899577167019,0.1786519016458088,0.20726780717632076,133775.99172921665,71.18249598215255,133847.1742251988,3440,21,828.9545454545455,38,6,15,32.797600605872844,0.6543311403508772,41.372863247863236,1034.508547008545,27.22390913180382,0
4951,4,0,0,44,0.0,0.0,1.0,44,1100,700,400,0.6363636363636364,15,7,8,332.35372049613517,0.7686090556730092,0.17986646897851966,0.20801950256383808,133822.27783203125,95.26638454861217,133917.54421657987,3441,22,829.9545454545455,39,5,15,32.731068995603884,0.6530448717948718,41.328125,1034.6875,26.53044871794872,0
4952,4,0,0,44,0.0,0.0,1.0,44,950,600,350,0.631578947368421,13,6,7,335.6489584872978,0.7678602889358703,0.18287951983604156,0.2105434375965777,133903.125,188.88888888889034,134092.01388888888,3442,23,830.9545454545455,39,5,15,32.56508319914118,0.653846153846154,41.25,1035.0,26.53846153846154,0
4953,4,0,1,43,0.0,0.022727272727272728,0.9772727272727273,44,900,600,300,0.6666666666666666,12,6,6,332.5789748551675,0.7680364693446089,0.18543076641668232,0.20923006392787102,134010.9592013888,113.8454861111029,134124.80468749988,3443,24,831.9545454545455,39,5,16,32.53688799463446,0.65491452991453,41.14583333333333,1035.4166666666658,26.549145299145277,0
4954,4,0,0,43,0.0,0.0,1.0,43,1000,800,200,0.8,12,8,4,339.4655209570008,0.7628737541528239,0.1896852580365651,0.2131614667888772,133941.8297195738,493.7266007377835,134435.5563203116,3444,25,851.1860465116279,38,5,17,32.42766711390925,0.6559758771929827,41.21260683760682,1035.1495726495702,27.240778227620268,0
4955,4,0,0,43,0.0,0.0,1.0,43,1300,800,500,0.6153846153846154,18,8,10,338.6440970391746,0.7622277593207826,0.19100007199942448,0.21280553179699058,133969.47937212326,473.59467455617437,134443.07404667942,3445,26,852.1860465116279,38,5,17,32.42131062951495,0.6562500000000002,41.18589743589742,1035.2564102564074,27.24358974358967,0
4956,4,0,0,43,0.0,0.0,1.0,43,1150,700,450,0.6086956521739131,16,7,9,339.25559132696503,0.7613971945367294,0.19574832358396344,0.21390097302244865,134091.86333550356,498.2828776041719,134590.14621310774,3446,27,853.1860465116279,39,4,18,32.283285561031214,0.655715811965812,41.067708333333336,1035.7291666666672,26.557158119658133,0
4957,4,0,0,43,0.0,0.0,1.0,43,1000,500,500,0.5,15,5,10,338.98992897364656,0.760797342192691,0.19625774960024644,0.21452110772454427,134226.7578125,500.30381944444497,134727.06163194444,3447,28,854.1860465116279,39,4,18,32.155542152526465,0.657051282051282,40.9375,1036.25,26.57051282051282,0
4958,4,0,0,43,0.0,0.0,1.0,43,1150,900,250,0.782608695652174,14,9,5,337.0509062893758,0.7608896271686969,0.20071372983432756,0.2137663204898393,134307.72705078125,453.708224826388,134761.43527560763,3448,29,855.1860465116279,39,4,18,32.12501674873547,0.6578525641025641,40.859375,1036.5625,26.578525641025642,0
4959,4,0,0,43,0.0,0.0,1.0,43,850,400,450,0.47058823529411764,13,4,9,339.0809648370055,0.7598744924326319,0.20332012263516042,0.21521261237614014,134334.72222222213,510.0694444444355,134844.79166666657,3449,30,856.1860465116279,39,4,18,32.04548499464094,0.6581196581196582,40.83333333333333,1036.6666666666658,26.58119658119656,0
4960,4,0,0,43,0.0,0.0,1.0,43,550,100,450,0.18181818181818182,10,1,9,337.6233910870454,0.7591362126245846,0.19862530430678826,0.21460429341509898,134388.720703125,474.5551215277787,134863.27582465278,3450,31,857.1860465116279,39,4,18,32.0294186591655,0.6586538461538463,40.78125,1036.875,26.58653846153846,0
4961,4,0,0,43,0.0,0.0,1.0,43,1450,1300,150,0.896551724137931,16,13,3,339.758071301874,0.7582133628645257,0.20483706349784958,0.2167656494905956,134524.4232930134,541.1517202062219,135065.5750132196,3451,32,858.1860465116279,40,3,18,31.838794736154647,0.6583333333333334,40.65040650406504,1037.3983739837395,25.934959349593488,0
4962,4,0,0,43,0.0,0.0,1.0,43,1300,800,500,0.6153846153846154,18,8,10,339.21262963842463,0.7586286452565522,0.20002380902362016,0.2170568676356856,134631.84814453125,533.7672303992965,135165.61537493055,3452,33,859.1860465116279,39,4,18,31.745897320084314,0.6610576923076923,40.546875,1037.8125,26.610576923076923,0
4963,4,0,0,43,0.0,0.0,1.0,43,1250,800,450,0.64,17,8,9,339.1876585611104,0.7584440753045404,0.20000233374951848,0.21736366672420993,134685.9063042534,536.759440104162,135222.66574435757,3453,34,860.1860465116279,39,4,18,31.692695266767007,0.6615918803418804,40.494791666666664,1038.020833333333,26.615918803418797,0
4964,4,0,0,43,0.0,0.0,1.0,43,700,500,200,0.7142857142857143,9,5,4,338.19622478014645,0.7591823551125877,0.20017828057255116,0.2168895480153758,134712.939453125,511.8815104166663,135224.82096354166,3454,35,861.1860465116279,39,4,18,31.691501103752756,0.6618589743589745,40.46875,1038.125,26.618589743589745,0
4965,4,0,0,43,0.0,0.0,1.0,43,1050,700,350,0.6666666666666666,14,7,7,337.5190501485241,0.7593207825765965,0.20259414206416038,0.2166163794481868,134739.97531467018,495.46169704861626,135235.4370117188,3455,36,862.1860465116279,39,4,18,31.682155279087663,0.6621260683760684,40.442708333333336,1038.229166666667,26.621260683760692,0
4966,4,0,1,42,0.0,0.023255813953488372,0.9767441860465116,43,1000,500,500,0.5,15,5,10,340.7712473385166,0.7581672203765226,0.20309890950475262,0.21952008258783512,134875.1953125,592.3177083333333,135467.51302083334,3456,37,863.1860465116279,39,4,14,31.463096670677896,0.6634615384615385,40.3125,1038.75,26.634615384615383,0
4967,4,0,0,42,0.0,0.0,1.0,42,800,400,400,0.5,12,4,8,346.7356801738686,0.7605255516840883,0.20161701044054015,0.22358473169832188,134911.26543209862,955.709876543196,135866.97530864182,3457,38,873.3809523809524,38,4,14,31.272281639928696,0.6655701754385965,40.27777777777777,1038.8888888888878,27.339181286549678,0
4968,4,0,0,42,0.0,0.0,1.0,42,1250,800,450,0.64,17,8,9,347.22986360794573,0.7604529616724739,0.19824298589591094,0.22441892912388606,134994.52257515147,974.8259323179078,135969.34850746937,3458,39,874.3809523809524,38,4,14,31.17653610225831,0.6663925438596492,40.19764957264957,1039.2094017094007,27.347615834457912,0
4969,4,1,0,43,0.023255813953488372,0.0,1.0,43,950,500,450,0.5263157894736842,14,5,9,350.03183200690984,0.7673495754891103,0.2093068837573957,0.22267611058594208,134419.01728468516,810.1869753453745,135229.20426003053,3459,0,855.0232558139535,40,3,17,31.67752842022736,0.6572916666666666,40.75203252032521,1036.9918699187,25.924796747967502,1
4970,4,0,1,42,0.0,0.023255813953488372,0.9767441860465116,43,950,700,250,0.7368421052631579,12,7,5,354.1963994476671,0.7672572905131044,0.21511457025616232,0.2258140318027695,134498.06791798872,927.7462778438843,135425.81419583262,3460,1,856.0232558139535,40,3,18,31.490643675908682,0.6580729166666666,40.675813008130085,1037.2967479674803,25.932418699187007,0
4971,4,0,0,42,0.0,0.0,1.0,42,750,500,250,0.6666666666666666,10,5,5,354.3491234012354,0.7669618660472319,0.21944922547332202,0.22623828647925048,134550.78125000012,1135.5902777777915,135686.3715277779,3461,2,866.0,39,3,18,31.434069611780455,0.6602564102564102,40.62500000000001,1037.500000000001,26.602564102564127,0
4972,4,0,0,42,0.0,0.0,1.0,42,750,500,250,0.6666666666666666,10,5,5,353.5899206514412,0.7662359659310879,0.2177266004648215,0.22646022928866988,134664.5662607725,1123.2066597414525,135787.77292051396,3462,3,867.0,37,5,18,31.340235227832945,0.6649774774774775,40.51535087719298,1037.9385964912276,28.052394499762908,0
4973,4,0,0,42,0.0,0.0,1.0,42,1100,1000,100,0.9090909090909091,12,10,2,333.4546817989473,0.7656310491676346,0.15525271409360797,0.2060121538676413,133340.98755907518,492.6353154537568,133833.62287452893,3463,4,868.0,40,2,13,33.18368919938339,0.6466145833333334,41.793699186991866,1032.8252032520318,25.820630081300795,5
4974,4,0,2,40,0.0,0.047619047619047616,0.9523809523809523,42,1050,800,250,0.7619047619047619,13,8,5,336.88865764828324,0.7642518389469609,0.1584101382488481,0.20887096774193536,133472.22222222204,593.1201046004165,134065.34232682246,3464,5,869.0,39,3,15,32.96370967741935,0.6495726495726497,41.66666666666666,1033.333333333332,26.49572649572646,0
4975,4,0,0,40,0.0,0.0,1.0,40,1350,1100,250,0.8148148148148148,16,11,5,355.0181092473357,0.7670673076923077,0.1576368264743322,0.22078566846859352,133585.55036164963,1485.0579024315061,135070.60826408112,3465,6,818.225,37,3,16,32.38182364587753,0.6542792792792793,41.557017543859644,1033.7719298245604,27.939781887150282,0
4976,4,0,0,40,0.0,0.0,1.0,40,900,700,200,0.7777777777777778,11,7,4,353.3231521432966,0.7665598290598291,0.15404251935107638,0.22023731975303554,133670.57802641182,1445.7819954216486,135116.36002183348,3466,7,819.225,37,3,18,32.34048616265506,0.6551238738738739,41.474780701754376,1034.1008771929812,27.94867235656706,0
4977,4,0,0,40,0.0,0.0,1.0,40,750,500,250,0.6666666666666666,10,5,5,353.17386820340374,0.7660256410256411,0.15830506677973322,0.2206518061344973,133755.63274276702,1447.7988419513702,135203.43158471838,3467,8,820.225,37,3,14,32.25920429651616,0.6559684684684685,41.39254385964912,1034.4298245614034,27.957562825983874,0
4978,4,0,0,40,0.0,0.0,1.0,40,1350,1000,350,0.7407407407407407,17,10,7,349.66244858322125,0.7663995726495727,0.1570772248606238,0.21907053538014762,133858.89788333702,1361.0859997078012,135219.98388304483,3468,9,821.225,38,2,15,32.246713469612516,0.6551535087719298,41.292735042735046,1034.82905982906,27.232343679712105,0
4979,4,0,0,40,0.0,0.0,1.0,40,800,600,200,0.75,10,6,4,353.0752847662842,0.7673878205128205,0.15384714624832285,0.22170748114715005,133941.82971957407,1458.309934071146,135400.13965364522,3469,10,822.225,38,2,15,32.0754635841332,0.6559758771929824,41.212606837606835,1035.1495726495723,27.240778227620325,0
4980,4,0,0,40,0.0,0.0,1.0,40,800,400,400,0.5,12,4,8,351.2791266090925,0.7680288461538461,0.11283281733746087,0.22074544337497412,133969.47937212343,1440.672026809823,135410.15139893326,3470,11,823.225,38,2,12,32.094298245614006,0.6562500000000002,41.185897435897424,1035.2564102564088,27.243589743589705,3
4981,4,0,1,39,0.0,0.025,0.975,40,1150,800,350,0.6956521739130435,15,8,7,348.2982446694629,0.768482905982906,0.09674459527400714,0.21992546306271796,134145.81298828125,1344.5502387152785,135490.36322699653,3471,12,824.225,39,1,14,31.995244679068197,0.65625,41.015625,1035.9375,26.5625,0
4982,4,0,0,39,0.0,0.0,1.0,39,1050,700,350,0.6666666666666666,14,7,7,356.5175901872367,0.7596153846153847,0.10684818481848168,0.22505172880569296,134135.43721236012,1764.3285667323917,135899.7657790925,3472,53,846.0512820512821,38,1,14,31.79274958745873,0.6578947368421054,41.025641025641015,1035.8974358974344,27.26045883940617,0
4983,4,0,0,39,0.0,0.0,1.0,39,800,600,200,0.75,10,6,4,356.359924961726,0.7581533963112911,0.10936962947686779,0.2252919525605487,134190.77932098755,1764.0432098765268,135954.82253086407,3473,54,847.0512820512821,38,1,15,31.741510277033047,0.6584429824561404,40.972222222222214,1036.1111111111104,27.266081871345012,0
4984,4,0,0,39,0.0,0.0,1.0,39,950,700,250,0.7368421052631579,12,7,5,353.453133499287,0.756016644174539,0.11182086681777603,0.22481101662805206,134412.26189823923,1701.6870297318799,136113.9489279711,3474,55,848.0512820512821,38,1,18,31.595576619273302,0.6606359649122808,40.758547008547,1036.9658119658102,27.28857399910027,0
4985,4,1,1,39,0.025,0.025,0.975,40,1000,700,300,0.7,13,7,6,345.09706283980853,0.7603632478632478,0.100722810988785,0.2216786750654393,134772.56059838185,1301.994301994296,136074.55490037616,3475,0,827.825,38,2,18,31.45299585005316,0.6641995614035088,40.41132478632478,1038.3547008547002,27.325123706702637,0
4986,4,0,0,39,0.0,0.0,1.0,39,1300,900,400,0.6923076923076923,17,9,8,355.0672649627672,0.7530926675663518,0.10786932902418966,0.228657525560319,134863.80575032698,1777.1445300477005,136640.95028037467,3476,57,850.0512820512821,37,2,15,31.10320120342024,0.6669481981981982,40.3234649122807,1038.706140350877,28.07313892840208,0
4987,4,0,0,39,0.0,0.0,1.0,39,700,300,400,0.42857142857142855,11,3,8,354.4659534892175,0.7532613585245165,0.10490199261832878,0.22880922174821686,134949.2391889812,1766.9821483533392,136716.22133733454,3477,58,851.0512820512821,37,2,16,31.033663993246094,0.6677927927927928,40.24122807017544,1039.0350877192982,28.08202939781887,0
4988,4,0,0,39,0.0,0.0,1.0,39,950,600,350,0.631578947368421,13,6,7,352.4146120683919,0.7535987404408457,0.10182825544716234,0.22784349885294777,135006.20984341326,1715.6322137580685,136721.84205717134,3478,59,852.0512820512821,37,2,16,31.030192727016953,0.6683558558558559,40.186403508771924,1039.2543859649115,28.087956377430043,0
4989,4,0,0,39,0.0,0.0,1.0,39,850,700,150,0.8235294117647058,10,7,3,355.1505278712457,0.7530926675663518,0.10430596126798664,0.22997452214613445,135063.19252077557,1793.5528239458226,136856.7453447214,3479,60,853.0512820512821,37,2,16,30.902338255977487,0.668918918918919,40.13157894736842,1039.473684210526,28.093883357041243,0
4990,4,0,0,39,0.0,0.0,1.0,39,1050,900,150,0.8571428571428571,12,9,3,358.1706183289551,0.7539923526765633,0.1090433155398356,0.23229642975343012,135120.1872210678,1879.216201138795,136999.4034222066,3480,61,854.0512820512821,37,2,16,30.767067426000143,0.6694819819819819,40.076754385964904,1039.692982456139,28.099810336652403,0
4991,4,0,0,39,0.0,0.0,1.0,39,1150,900,250,0.782608695652174,14,9,5,358.96392295375983,0.7527552856500225,0.11050022435221707,0.23354813258843357,135234.212690443,1908.8407009848952,137143.0533914279,3481,62,855.0512820512821,37,2,17,30.63286246398201,0.6706081081081081,39.96710526315788,1040.1315789473667,28.111664295874778,0
4992,4,0,0,39,0.0,0.0,1.0,39,1150,900,250,0.782608695652174,14,9,5,357.69314046953116,0.7542735042735043,0.10990246143038607,0.23345996582227285,135348.28625153878,1882.6307132963839,137230.91696483517,3482,63,856.0512820512821,37,2,18,30.55233579206183,0.6717342342342343,39.85745614035087,1040.5701754385952,28.123518255097167,0
4993,4,0,0,39,0.0,0.0,1.0,39,1100,700,400,0.6363636363636364,15,7,8,359.2777550650194,0.7538236617183985,0.11308959365012528,0.234680328514941,135376.81215614392,1927.5754318636223,137304.38758800755,3483,64,857.0512820512821,37,2,18,30.48271608190216,0.6720157657657658,39.83004385964911,1040.6798245614013,28.12648174490274,0
4994,4,0,0,39,0.0,0.0,1.0,39,900,700,200,0.7777777777777778,11,7,4,357.6476404642836,0.7533175888439047,0.1150442477876108,0.2338010608324365,135405.3410664819,1885.4801477377544,137290.82121421964,3484,65,858.0512820512821,37,2,18,30.496734091866823,0.6722972972972974,39.80263157894736,1040.7894736842097,28.12944523470837,0
4995,4,0,0,39,0.0,0.0,1.0,39,1150,700,450,0.6086956521739131,16,7,9,358.6633859837188,0.7524179037336932,0.11044783372886968,0.2353991829085952,135548.03070415874,1923.22313115571,137471.25383531445,3485,66,859.0512820512821,37,2,18,30.3283273665368,0.673704954954955,39.66557017543858,1041.3377192982437,28.144262683736315,0
4996,4,0,0,39,0.0,0.0,1.0,39,950,800,150,0.8421052631578947,11,8,3,359.45661292176084,0.7516306792622582,0.10861062298055701,0.2362960807019932,135605.12759935728,1948.8319723376171,137553.9595716949,3486,67,860.0512820512821,37,2,18,30.250881671754907,0.6742680180180181,39.610745614035075,1041.557017543858,28.15018966334751,0
4997,4,0,0,39,0.0,0.0,1.0,39,650,400,250,0.6153846153846154,9,4,5,358.7027793992827,0.7509559154295997,0.11339474763599311,0.23637593411696312,135692.33929875816,1934.6468556635405,137626.9861544217,3487,68,861.0512820512821,36,3,18,30.183789090647057,0.6770833333333335,39.527027027027025,1041.8918918918914,28.941441441441427,0
4998,4,0,0,39,0.0,0.0,1.0,39,900,700,200,0.7777777777777778,11,7,4,355.55128796522,0.7508996851102114,0.1078190965618635,0.23485163253018856,135776.49042253377,1855.10120902584,137631.5916315596,3488,69,862.0512820512821,37,2,18,30.182250569875492,0.6759572072072073,39.446271929824555,1042.214912280701,28.167970602181107,0
4999,4,0,0,39,0.0,0.0,1.0,39,1150,900,250,0.782608695652174,14,9,5,357.32135735946986,0.7511246063877643,0.11100141880701497,0.23620979298046718,135805.06141312703,1905.2097760849367,137710.27118921196,3489,70,863.0512820512821,37,2,18,30.107738971877403,0.6762387387387387,39.4188596491228,1042.3245614035081,28.170934091986705,0
5000,4,0,0,39,0.0,0.0,1.0,39,850,600,250,0.7058823529411765,11,6,5,357.8039284777834,0.7507309941520468,0.11459302592152065,0.2367182984021075,135833.63540945287,1920.3616737842312,137753.9970832371,3490,71,864.0512820512821,37,2,18,30.066770975772233,0.6765202702702704,39.39144736842105,1042.4342105263154,28.173897581792307,0
