period,mktsize,entries,exits,surviv,entryrate,exitrate,survivrate,firms,totresinv,totinninv,totimiinv,costshareinn,firmsres,firmsinn,firmsimi,hindex,div,gini,pcm,cs,totprofits,ts,maxage,minage,avgage,actfirms,inactfirms,profitablefirms,wmc,avgproxopt,price,totoutput,avgoutput,magtechshock
1,4,40,27,13,1.0,0.675,0.32499999999999996,40,0,0,0,0,0,0,0,338.5278857168527,1.001469017094017,-0.07563981042654011,0.14819374250260564,119279.94255829902,1075.9173525377232,120355.85991083675,0,0,0.0,35,5,13,47.519747235387065,0.5119047619047619,55.78703703703704,976.8518518518517,27.910052910052908,0
2,4,40,32,21,0.7547169811320755,0.6037735849056604,0.39622641509433965,53,600,400,200,0.6666666666666666,8,4,4,309.3052184170403,0.9968855829704886,-0.1518249260523924,0.143280500786929,121757.41705246922,-1267.9591049382636,120489.45794753096,1,0,0.24528301886792453,44,9,20,45.63221221502957,0.5234375,53.26388888888889,986.9444444444451,22.43055555555557,0
3,4,29,33,17,0.58,0.66,0.33999999999999997,50,500,300,200,0.6,7,3,4,259.46415685787645,0.9906292517006803,-0.0345403899721447,0.12759949631777792,124306.52006172884,-2949.382716049342,121357.1373456795,2,0,0.64,47,3,5,44.22585886722381,0.5460992907801416,50.694444444444464,997.2222222222258,21.21749408983459,0
4,4,28,23,22,0.6222222222222222,0.5111111111111111,0.48888888888888893,45,400,400,0,1.0,4,4,0,342.54877531852276,0.9989898989898991,-0.20013116408122056,0.16348075355125619,123037.04675959765,1229.2379372616158,124266.28469685926,3,0,0.8888888888888888,36,9,21,43.47450813469543,0.5491898148148147,51.970720720720735,992.1171171171189,27.55880880880886,0
5,4,20,23,19,0.47619047619047616,0.5476190476190477,0.45238095238095233,42,250,100,150,0.4,4,1,3,309.3750000000004,0.9894502516453736,-0.039484126984127066,0.15468749999999984,124999.9999999997,-665.6250000000273,124334.37499999967,4,0,1.4047619047619047,42,0,13,42.265624999999986,0.5595238095238096,49.999999999999986,999.9999999999976,23.809523809523753,0
6,4,14,14,19,0.42424242424242425,0.42424242424242425,0.5757575757575757,33,350,100,250,0.2857142857142857,6,1,5,372.82956491308886,0.9876104797979799,-0.11723526739501178,0.18343935908480757,124326.88899702036,2670.5479863513997,126997.43698337176,5,0,1.6363636363636365,33,0,14,41.378409928729404,0.5688131313131313,50.674019607843135,997.3039215686274,30.221330956625074,2
7,4,15,15,19,0.4411764705882353,0.4411764705882353,0.5588235294117647,34,600,400,200,0.6666666666666666,8,4,4,364.4508182424742,0.9716280451574569,-0.10521679553685015,0.18406297627203969,125417.01388888905,2341.666666666686,127758.68055555574,6,0,1.9411764705882353,34,0,16,40.45687742651138,0.5778186274509803,49.58333333333334,1001.666666666668,29.46078431372553,0
8,4,15,12,22,0.4411764705882353,0.35294117647058826,0.6470588235294117,34,600,300,300,0.5,9,3,6,363.9867422892612,0.9783868092691623,-0.17885815612739264,0.18542637790382788,125775.00708616777,2356.087018140587,128131.09410430836,7,0,2.0588235294117645,34,0,19,40.098356278186564,0.5814950980392157,49.226190476190474,1003.0952380952378,29.502801120448172,0
9,4,12,11,23,0.35294117647058826,0.3235294117647059,0.6764705882352942,34,750,400,350,0.5333333333333333,11,4,7,335.83367051573344,0.9707739156268569,-0.10458482624273846,0.17473684210526302,126642.26367630379,1706.1472505668848,128348.41092687067,8,0,2.7058823529411766,34,0,18,39.912280701754376,0.5903799019607843,48.363095238095234,1006.5476190476186,29.604341736694664,0
10,4,8,6,25,0.25806451612903225,0.1935483870967742,0.8064516129032258,31,750,300,450,0.4,12,3,9,356.0749141774534,0.9636200716845879,-0.07956877993424927,0.1855236682223769,126698.43885633691,2822.827148437509,129521.26600477443,9,0,3.5483870967741935,31,0,22,39.34514571477838,0.5981182795698924,48.30729166666667,1006.7708333333343,32.476478494623684,0
11,4,3,2,26,0.10714285714285714,0.07142857142857142,0.9285714285714286,28,650,500,150,0.7692307692307693,8,5,3,376.67710558878076,0.9562940917107583,-0.016402380612681622,0.19658449985642323,126766.25307586869,3949.989058990618,130716.2421348593,10,0,4.75,28,0,24,38.75671755362152,0.6075148809523809,48.23994252873563,1007.0402298850577,35.965722495894916,0
12,4,1,2,25,0.037037037037037035,0.07407407407407407,0.9259259259259259,27,850,600,250,0.7058823529411765,11,6,5,386.07504411986065,0.9495489078822412,-0.005508828882002881,0.20329685889668186,127129.52905771682,4416.307707979021,131545.83676569583,11,0,5.518518518518518,27,0,25,38.14571959077272,0.6145833333333334,47.879464285714285,1008.4821428571427,37.35119047619047,0
13,4,4,4,25,0.13793103448275862,0.13793103448275862,0.8620689655172413,29,500,200,300,0.4,8,2,6,363.30517677160714,0.9413998357963875,-0.05743966939015388,0.19379827464737642,127652.81635802465,3475.385802469127,131128.20216049376,12,0,5.517241379310345,29,0,22,38.18260949239508,0.6135057471264368,47.36111111111111,1010.5555555555552,34.846743295019145,0
14,4,2,2,25,0.07407407407407407,0.07407407407407407,0.9259259259259259,27,750,500,250,0.6666666666666666,10,5,5,390.93210474130433,0.9499050332383666,-0.04800672705729481,0.2070017538220348,127354.73632812481,4557.4110243055275,131912.14735243033,13,0,6.851851851851852,27,0,22,37.791322669418626,0.6168981481481483,47.656249999999986,1009.3749999999985,37.3842592592592,0
15,4,3,3,25,0.10714285714285714,0.10714285714285714,0.8928571428571429,28,650,300,350,0.46153846153846156,10,3,7,377.48001749146204,0.9455467372134039,-0.05240396329083097,0.20181986345516129,127744.7896023251,4044.2210827057447,131789.01068503084,14,0,7.5,28,0,22,37.73006679931778,0.617559523809524,47.27011494252872,1010.9195402298835,36.10426929392441,0
16,4,3,2,26,0.10714285714285714,0.07142857142857142,0.9285714285714286,28,750,400,350,0.5333333333333333,11,4,7,374.1553518506867,0.9427910052910052,-0.02763472689671964,0.20186053668759077,128108.16529594387,3986.471132249949,132094.6364281938,15,0,8.392857142857142,28,0,25,37.44145614533069,0.621279761904762,46.91091954022988,1012.3563218390796,36.15558292282427,0
17,4,4,3,27,0.13333333333333333,0.1,0.9,30,650,300,350,0.46153846153846156,10,3,7,354.8230391696336,0.9437260536398467,-0.06312000353341285,0.19390655152883599,128621.28434284312,3127.5590024858393,131748.84334532896,16,0,8.3,30,0,20,37.406419769444824,0.6204861111111111,46.40456989247312,1014.3817204301076,33.81272401433692,0
18,4,1,5,23,0.03571428571428571,0.17857142857142858,0.8214285714285714,28,900,500,400,0.5555555555555556,13,5,8,372.98814076717383,0.9358465608465608,-0.03052260859005007,0.2034428359764074,128544.89736094596,3989.1444543532843,132534.04181529925,17,0,9.857142857142858,28,0,21,37.023885425521854,0.6257440476190477,46.479885057471265,1014.080459770115,36.21715927750411,0
19,4,7,7,23,0.23333333333333334,0.23333333333333334,0.7666666666666666,30,750,400,350,0.5333333333333333,11,4,7,358.8318352419108,0.941044061302682,-0.07921355752681059,0.19710958920597477,128825.8780820037,3245.3652517632095,132071.2433337669,18,0,9.466666666666667,30,0,21,37.095911116995474,0.6225694444444445,46.20295698924731,1015.1881720430107,33.83960573476703,0
20,4,5,5,23,0.17857142857142858,0.17857142857142858,0.8214285714285714,28,850,600,250,0.7058823529411765,11,6,5,385.1751915174357,0.9358465608465608,-0.07576248531734775,0.20932402164591632,128399.23743228972,4291.240173734991,132690.4776060247,19,0,10.964285714285714,28,0,21,36.86413146205463,0.6242559523809523,46.623563218390814,1013.5057471264378,36.196633825944204,0
21,4,3,3,23,0.11538461538461539,0.11538461538461539,0.8846153846153846,26,1100,900,200,0.8181818181818182,13,9,4,406.3117367540856,0.9292307692307692,-0.042095514969639036,0.2196225384333041,128183.59672687098,5216.499961896061,133400.09668876705,20,0,12.692307692307692,26,0,23,36.55008635578584,0.6290064102564101,46.836419753086425,1012.654320987655,38.94824311490981,0
22,4,3,2,24,0.11538461538461539,0.07692307692307693,0.9230769230769231,26,1250,1000,250,0.8,15,10,5,409.04282753649585,0.9225641025641026,-0.049028796363551175,0.22196489302517586,128339.91817177243,5299.304602956844,133639.22277472928,21,0,13.576923076923077,26,0,24,36.32031170677225,0.6306089743589745,46.68209876543209,1013.2716049382703,38.97198480531809,0
23,4,2,2,24,0.07692307692307693,0.07692307692307693,0.9230769230769231,26,500,100,400,0.2,9,1,8,405.73934329257776,0.9239102564102564,-0.03208152371141271,0.22125420952494007,128535.45393709028,5230.378134049672,133765.83207113994,22,0,14.5,26,0,22,36.20326687972403,0.6326121794871795,46.48919753086419,1014.0432098765424,39.00166191832855,0
24,4,0,0,24,0.0,0.0,1.0,24,850,500,350,0.5882352941176471,12,5,7,441.55024481228526,0.9169685990338163,-0.030909990108803242,0.2361943373043493,127765.125,6482.944444444445,134248.06944444444,23,1,16.666666666666668,24,0,22,36.0898175623695,0.6328125,47.25,1011.0,42.125,2
25,4,6,5,25,0.2,0.16666666666666666,0.8333333333333334,30,1050,600,450,0.5714285714285714,15,6,9,371.96472158436836,0.9255268199233717,-0.10007046285286503,0.2071671065248037,129372.25627601445,3624.3830572898437,132996.63933330428,24,0,14.133333333333333,30,0,20,36.20496983309111,0.628125,45.66532258064515,1017.3387096774184,33.91129032258061,0
26,4,1,1,25,0.038461538461538464,0.038461538461538464,0.9615384615384616,26,950,700,250,0.7368421052631579,12,7,5,431.9346715128215,0.9133974358974359,-0.021108877367474355,0.22920912860570886,127442.37075617281,5809.355709876541,133251.72646604935,25,0,17.26923076923077,26,0,17,36.66609353507566,0.6213942307692308,47.56944444444444,1009.7222222222221,38.83547008547008,6
27,4,2,2,25,0.07407407407407407,0.07407407407407407,0.9259259259259259,27,650,500,150,0.7692307692307693,8,5,3,425.7251008592326,0.91820987654321,-0.04395388766249664,0.22795918521185837,127805.74876434942,5482.023056618471,133287.7718209679,26,0,17.444444444444443,27,0,18,36.447909001716965,0.6215277777777778,47.20982142857142,1011.1607142857138,37.45039682539681,2
28,4,2,1,26,0.07407407407407407,0.037037037037037035,0.962962962962963,27,1650,1400,250,0.8484848484848485,19,14,5,454.71834140709285,0.9160731244064578,-0.07847516449349123,0.23702806609864344,126717.16668438213,6124.123972505678,132841.2906568878,27,0,18.37037037037037,27,0,17,36.84291555818308,0.6103395061728394,48.28869047619048,1006.8452380952384,37.290564373897716,7
29,4,2,2,26,0.07142857142857142,0.07142857142857142,0.9285714285714286,28,800,600,200,0.75,10,6,4,444.36779677701605,0.915950176366843,-0.08368961094484828,0.23356770262054866,127055.79759958397,5691.900969414739,132747.69856899872,28,0,18.642857142857142,28,0,18,36.75241081183792,0.6104910714285714,47.95258620689656,1008.189655172415,36.00677339901482,0
30,4,5,4,27,0.16129032258064516,0.12903225806451613,0.8709677419354839,31,700,400,300,0.5714285714285714,10,4,6,409.7740870485168,0.9289426523297492,-0.09489278460982564,0.21964909138066482,127848.07205200208,4277.765401204439,132125.83745320654,29,0,17.548387096774192,31,0,19,36.807567271790916,0.6098790322580644,47.16796875000001,1011.328125000001,32.623487903225836,0
31,4,2,1,28,0.06896551724137931,0.034482758620689655,0.9655172413793104,29,650,300,350,0.46153846153846156,10,3,7,428.89355281614183,0.9172824302134647,-0.04630528344231022,0.23018656928223746,127898.5556520062,5170.973186728399,133069.5288387346,30,0,19.689655172413794,29,0,20,36.27211199597237,0.6160201149425287,47.11805555555556,1011.5277777777779,34.880268199233726,0
32,4,2,2,28,0.06666666666666667,0.06666666666666667,0.9333333333333333,30,750,200,550,0.26666666666666666,13,2,11,419.8108389560809,0.9217911877394637,-0.041547332104541757,0.22793886429232016,128362.83535225931,4778.094528027348,133140.92988028665,31,0,19.966666666666665,28,2,21,36.023973250153595,0.6238839285714285,46.6594827586207,1013.362068965518,36.19150246305421,0
33,4,3,1,30,0.0967741935483871,0.03225806451612903,0.967741935483871,31,700,400,300,0.5714285714285714,10,4,6,404.65395467770514,0.9225806451612903,-0.029735974179438518,0.2235988166481941,129060.22376543205,4244.945987654321,133305.16975308637,32,0,19.35483870967742,29,2,19,35.69288773464553,0.6278735632183907,45.97222222222222,1016.1111111111107,35.0383141762452,0
34,4,0,2,28,0.0,0.06666666666666667,0.9333333333333333,30,900,500,400,0.5555555555555556,13,5,8,418.53102742510595,0.9189176245210728,-0.02723330033470095,0.23102520647329605,129018.86240338879,4799.679407781732,133818.54181117052,33,1,21.0,28,2,19,35.382784141799824,0.6305803571428572,46.012931034482754,1015.9482758620687,36.283866995073886,0
35,4,0,1,27,0.0,0.03571428571428571,0.9642857142857143,28,1000,700,300,0.7,13,7,6,441.3854761526119,0.909887566137566,-0.015008147745790179,0.24164109123259125,128691.98971669699,5760.555031626256,134452.54474832324,34,2,23.178571428571427,26,2,19,35.13846641318124,0.6342147435897436,46.334876543209866,1014.6604938271593,39.025403608736895,0
36,4,0,1,26,0.0,0.037037037037037035,0.962962962962963,27,650,400,250,0.6153846153846154,9,4,5,448.31237679151815,0.9071699905033239,-0.015916463909164458,0.2456751824817517,128731.13854595317,6142.352537722884,134873.49108367605,35,3,24.037037037037038,26,1,19,34.92244525547446,0.6346153846153847,46.29629629629628,1014.8148148148133,39.03133903133897,0
37,4,3,2,27,0.10344827586206896,0.06896551724137931,0.9310344827586207,29,950,700,250,0.7368421052631579,12,7,5,428.24790426261507,0.9128694581280787,-0.03421044669241868,0.23885474464500497,129428.42306193299,5286.347524477878,134714.77058641086,36,0,23.0,27,2,18,34.7159257092717,0.6381172839506173,45.61011904761904,1017.5595238095228,37.687389770723065,0
38,4,1,1,27,0.03571428571428571,0.03571428571428571,0.9642857142857143,28,700,400,300,0.5714285714285714,10,4,6,440.41474885955256,0.9028880070546736,-0.012424478659130989,0.2464305426824823,129554.63927469122,5811.554783950597,135366.19405864182,37,0,24.785714285714285,26,2,19,34.276944065484315,0.6430288461538463,45.4861111111111,1018.0555555555543,39.15598290598286,0
39,4,3,2,28,0.1,0.06666666666666667,0.9333333333333333,30,700,600,100,0.8571428571428571,8,6,2,404.5260257107616,0.9055555555555556,-0.02997960571040159,0.23153999370448622,130439.87509645049,4553.264853395036,134993.13994984553,38,0,22.966666666666665,29,1,21,34.287191253115786,0.6418821839080461,44.61805555555554,1021.5277777777767,35.22509578544057,0
40,4,1,2,27,0.034482758620689655,0.06896551724137931,0.9310344827586207,29,1100,700,400,0.6363636363636364,15,7,8,413.7307736371394,0.9018883415435139,-0.029955014039894756,0.23418349531709862,130006.03819857317,4957.499752279038,134963.53795085222,39,0,24.517241379310345,28,1,20,34.49475204282898,0.640625,45.043103448275865,1019.8275862068969,36.42241379310346,1
41,4,0,1,26,0.0,0.037037037037037035,0.962962962962963,27,800,500,300,0.625,11,5,6,439.19621099148026,0.8961301044634379,-0.021350036200771028,0.2462409342678655,129633.204851585,5986.882477899693,135620.0873294847,40,2,27.296296296296298,26,1,20,34.22740819316057,0.6438301282051282,45.40895061728394,1018.3641975308633,39.16785375118705,0
42,4,1,1,26,0.037037037037037035,0.037037037037037035,0.962962962962963,27,600,400,200,0.6666666666666666,8,4,4,435.7641111731929,0.8961301044634379,-0.03438993202772722,0.24554489677369992,129829.722984301,5915.026768023139,135744.74975232413,41,0,27.11111111111111,26,1,20,34.11347920452251,0.6458333333333335,45.21604938271604,1019.1358024691344,39.197530864197475,0
43,4,1,1,26,0.037037037037037035,0.037037037037037035,0.962962962962963,27,1000,800,200,0.8,12,8,4,438.5649256754757,0.8922127255460589,-0.036700947771728165,0.2491229629352443,130144.46159122078,6015.3592249656995,136159.8208161865,42,0,28.074074074074073,26,1,20,33.71994101633395,0.6490384615384615,44.907407407407405,1020.3703703703698,39.24501424501422,0
44,4,1,1,26,0.037037037037037035,0.037037037037037035,0.962962962962963,27,1000,700,300,0.7,13,7,6,437.30167445894847,0.8938746438746439,-0.032893189530625255,0.24890819921441332,130223.20578036875,5989.365188233488,136212.57096860223,43,0,29.037037037037038,26,1,20,33.67163088398346,0.6498397435897436,44.83024691358024,1020.6790123456783,39.2568850902184,0
45,4,0,0,26,0.0,0.0,1.0,26,750,500,250,0.6666666666666666,10,5,5,450.1001666745018,0.8892307692307693,-0.018928588696030646,0.2548431904552073,130017.30974687719,6504.1625575279595,136521.47230440515,44,6,31.153846153846153,25,1,20,33.55593966059082,0.6516666666666666,45.03205128205129,1019.8717948717959,40.79487179487184,0
46,4,0,0,26,0.0,0.0,1.0,26,550,400,150,0.7272727272727273,7,4,3,449.00112905417944,0.8878205128205128,-0.017484714468692042,0.2547541165382269,130099.04308431956,6482.923446745567,136581.96653106512,45,7,32.15384615384615,25,1,20,33.50023562676719,0.6525000000000001,44.95192307692308,1020.1923076923081,40.80769230769232,0
47,4,0,1,25,0.0,0.038461538461538464,0.9615384615384616,26,300,200,100,0.6666666666666666,4,2,2,449.00112905417944,0.8878205128205128,-0.017484714468692042,0.2547541165382269,130099.04308431956,6482.923446745567,136581.96653106512,46,8,33.15384615384615,25,1,20,33.50023562676719,0.6525000000000001,44.95192307692308,1020.1923076923081,40.80769230769232,0
48,4,1,0,26,0.038461538461538464,0.0,1.0,26,950,600,350,0.631578947368421,13,6,7,447.52526882413184,0.8894230769230769,-0.025192277507455563,0.25525366944302097,130303.48878718774,6462.820769641692,136766.30955682942,47,0,32.5,25,1,21,33.32859179615969,0.6545833333333333,44.75160256410257,1020.9935897435901,40.839743589743605,0
49,4,0,0,26,0.0,0.0,1.0,26,650,500,150,0.7692307692307693,8,5,3,445.9109313674717,0.8871794871794871,-0.029734818766671722,0.25486909108564093,130385.31201203982,6428.047183185415,136813.35919522523,48,1,33.5,25,1,21,33.286096291647056,0.6554166666666665,44.671474358974365,1021.314102564103,40.852564102564116,0
50,4,0,0,26,0.0,0.0,1.0,26,600,400,200,0.6666666666666666,8,4,4,444.72370511123097,0.8850641025641026,-0.03230865746549583,0.2549962539378787,130508.09500328741,6408.00871137411,136916.10371466153,49,2,34.5,25,1,19,33.190872020075275,0.6566666666666666,44.55128205128206,1021.7948717948725,40.8717948717949,0
51,4,2,4,24,0.07142857142857142,0.14285714285714285,0.8571428571428572,28,750,500,250,0.6666666666666666,10,5,5,417.4102716636921,0.8898258377425043,-0.048490127758420765,0.24448315911730553,131328.12500000012,5363.541666666681,136691.6666666668,50,0,32.964285714285715,27,1,21,33.05386178861787,0.6574074074074073,43.75000000000001,1025.000000000001,37.962962962963,0
52,4,2,2,24,0.07692307692307693,0.07692307692307693,0.9230769230769231,26,800,500,300,0.625,11,5,6,437.7467727596669,0.8817307692307692,-0.07081979053810039,0.2547542693929211,131081.84633875755,6276.1310404339465,137357.9773791915,50,0,32.84615384615385,25,1,21,32.783646322378715,0.6624999999999999,43.99038461538463,1024.0384615384628,40.96153846153851,0
53,4,0,1,23,0.0,0.041666666666666664,0.9583333333333334,24,650,500,150,0.7692307692307693,8,5,3,466.68241965973544,0.8786986714975845,-0.04608242753623182,0.2683423913043481,130617.28395061739,7391.3580246913825,138008.64197530877,51,2,36.583333333333336,23,1,22,32.51811594202899,0.6666666666666665,44.44444444444446,1022.2222222222231,44.44444444444448,0
54,4,1,1,23,0.041666666666666664,0.041666666666666664,0.9583333333333334,24,600,400,200,0.6666666666666666,8,4,4,451.90506408312035,0.8762832125603864,-0.07989333984693026,0.26205372979550906,130944.03124999997,7034.854166666666,137978.88541666663,52,0,35.541666666666664,24,0,22,32.561879172773175,0.6653645833333333,44.125,1023.4999999999998,42.64583333333332,0
55,4,0,0,23,0.0,0.0,1.0,23,250,0,250,0.0,5,0,5,469.26769657051415,0.8713768115942029,-0.06728690635167733,0.27138317329637296,130839.21456042632,7679.723367573305,138518.93792799962,53,4,38.08695652173913,23,0,22,32.224850104643934,0.6689311594202898,44.22743055555556,1023.0902777777778,44.48218599033817,0
56,4,1,1,23,0.041666666666666664,0.041666666666666664,0.9583333333333334,24,450,300,150,0.6666666666666666,6,3,3,454.0332122284418,0.871225845410628,-0.07864193513396267,0.2647521937719169,131157.34722222228,7109.958333333345,138267.30555555562,54,0,37.458333333333336,24,0,22,32.28963282351665,0.6675347222222222,43.91666666666667,1024.333333333334,42.68055555555558,0
57,4,1,1,23,0.041666666666666664,0.041666666666666664,0.9583333333333334,24,700,400,300,0.5714285714285714,10,4,6,454.2569344585878,0.872433574879227,-0.08268271524615067,0.2654725886930989,131242.72222222234,7123.583333333355,138366.30555555568,55,0,38.416666666666664,24,0,22,32.19678486228584,0.6684027777777778,43.83333333333334,1024.6666666666677,42.694444444444485,0
58,4,1,1,23,0.041666666666666664,0.041666666666666664,0.9583333333333334,24,900,400,500,0.4444444444444444,14,4,10,451.896134510054,0.8734903381642511,-0.07585609016038142,0.2652733797238409,131413.5555555555,7077.055555555551,138490.61111111107,56,0,39.375,24,0,22,32.08306241872562,0.670138888888889,43.666666666666664,1025.333333333333,42.72222222222221,0
59,4,1,1,23,0.041666666666666664,0.041666666666666664,0.9583333333333334,24,500,400,100,0.8,6,4,2,451.63495695085203,0.8705464975845411,-0.07158813972380185,0.2660108287112434,131541.75347222216,7081.770833333329,138623.5243055555,57,0,40.333333333333336,24,0,22,31.959111833197948,0.6714409722222222,43.541666666666664,1025.833333333333,42.74305555555554,0
60,4,0,0,23,0.0,0.0,1.0,23,750,500,250,0.6666666666666666,10,5,5,466.56725626842467,0.8616600790513834,-0.046981248712136825,0.27454973605914873,131506.13667052472,7671.291473765437,139177.42814429017,58,9,43.08695652173913,23,0,22,31.612502821033626,0.6757246376811594,43.57638888888889,1025.6944444444448,44.59541062801934,0
61,4,0,0,23,0.0,0.0,1.0,23,700,400,300,0.5714285714285714,10,4,6,467.24077631147657,0.8598484848484849,-0.04589045125610436,0.276232746955345,131684.268904321,7705.6520061728415,139389.92091049385,59,10,44.08695652173913,23,0,20,31.413509246729806,0.677536231884058,43.40277777777778,1026.3888888888891,44.62560386473431,0
62,4,0,0,23,0.0,0.0,1.0,23,450,200,250,0.4444444444444444,7,2,5,467.3730533630592,0.8595191040843215,-0.043765027684027014,0.2766343207743513,131728.82080078125,7713.300238715277,139442.12103949653,60,11,45.08695652173913,23,0,20,31.364683747674615,0.6779891304347826,43.359375,1026.5625,44.63315217391305,0
63,4,0,0,23,0.0,0.0,1.0,23,500,300,200,0.6,7,3,4,467.42914754321146,0.8580368906455863,-0.039502979623928125,0.27796766492594804,131907.1037386671,7731.44501109183,139638.54874975892,61,12,46.08695652173913,23,0,20,31.18151794265111,0.6798007246376812,43.18576388888889,1027.2569444444448,44.66334541062803,0
64,4,0,0,23,0.0,0.0,1.0,23,300,200,100,0.6666666666666666,4,2,2,468.85102970178514,0.8565546772068512,-0.03737411578042704,0.27946920894308835,131996.29041883687,7777.31933593752,139773.6097547744,62,13,47.08695652173913,23,0,20,31.054126541645545,0.6807065217391304,43.09895833333334,1027.6041666666674,44.67844202898554,0
65,4,0,0,23,0.0,0.0,1.0,23,650,500,150,0.7692307692307693,8,5,3,469.21110299488686,0.8557312252964427,-0.0352526439482963,0.28001307759372285,132040.8950617284,7791.010802469139,139831.90586419753,63,14,48.08695652173913,23,0,20,30.99943693693694,0.681159420289855,43.05555555555556,1027.7777777777778,44.68599033816425,0
66,4,0,0,23,0.0,0.0,1.0,23,1100,900,200,0.8181818181818182,13,9,4,469.5566443279342,0.8557312252964427,-0.033836822510886044,0.2805494340126842,132085.50723982457,7804.325508777022,139889.8327486016,64,15,49.08695652173913,23,0,20,30.945117660305122,0.6816123188405796,43.012152777777786,1027.9513888888896,44.693538647343026,0
67,4,0,0,23,0.0,0.0,1.0,23,750,400,350,0.5333333333333333,11,4,7,469.54744136218983,0.8540843214756259,-0.03523478848116035,0.28120621791589995,132174.75420163007,7812.463529610354,139987.21773124044,65,16,50.08695652173913,23,0,20,30.854472677134346,0.6825181159420288,42.92534722222223,1028.2986111111115,44.7086352657005,0
68,4,0,0,23,0.0,0.0,1.0,23,600,500,100,0.8333333333333334,7,5,2,469.54744136218983,0.8540843214756259,-0.03523478848116035,0.28120621791589995,132174.75420163007,7812.463529610354,139987.21773124044,66,17,51.08695652173913,23,0,20,30.854472677134346,0.6825181159420288,42.92534722222223,1028.2986111111115,44.7086352657005,0
69,4,0,0,23,0.0,0.0,1.0,23,700,600,100,0.8571428571428571,8,6,2,473.0351349852135,0.8517786561264823,-0.036625629136157745,0.2843008326493282,132308.68115837197,7917.330970293218,140226.0121286652,67,18,52.08695652173913,23,0,20,30.62844526943412,0.6838768115942029,42.79513888888889,1028.819444444445,44.73128019323674,0
70,4,1,0,24,0.041666666666666664,0.0,1.0,24,500,300,200,0.6,7,3,4,455.2346743831377,0.8523550724637681,-0.04145098673568426,0.2764499761332573,132698.34722222234,7281.777777777801,139980.12500000015,68,0,50.875,24,0,21,30.690580179014347,0.6831597222222221,42.41666666666668,1030.3333333333344,42.9305555555556,0
71,4,0,0,24,0.0,0.0,1.0,24,500,300,200,0.6,7,3,4,455.1881402338391,0.8516757246376812,-0.038243301525688445,0.2767382764076526,132741.28124999997,7284.45138888889,140025.73263888885,69,1,51.875,24,0,21,30.64821553722573,0.68359375,42.375,1030.4999999999998,42.93749999999999,0
72,4,0,0,24,0.0,0.0,1.0,24,850,600,250,0.7058823529411765,11,6,5,463.359771206593,0.8529589371980676,-0.03798979702594152,0.2689939238894988,130986.68055555566,7338.791666666686,138325.47222222236,70,2,52.875,24,0,20,32.22518452187128,0.665798611111111,44.08333333333334,1023.6666666666675,42.652777777777814,6
73,4,2,0,26,0.07692307692307693,0.0,1.0,26,1050,800,250,0.7619047619047619,13,8,5,431.168353263375,0.8603205128205128,-0.038866214200650284,0.25543749370091146,131763.47748533005,6162.448321521118,137925.92580685116,71,0,49.73076923076923,26,0,21,32.25863019189337,0.6654647435897436,43.32561728395062,1026.6975308641981,39.48836657169993,0
74,4,0,0,26,0.0,0.0,1.0,26,750,600,150,0.8,9,6,3,432.17862664621737,0.8590384615384615,-0.036669941628619585,0.25656991617578767,131842.7098813063,6195.920257963737,138038.63013927004,72,1,50.73076923076923,26,0,21,32.15220385674931,0.6662660256410255,43.24845679012346,1027.006172839507,39.50023741690411,0
75,4,1,1,26,0.037037037037037035,0.037037037037037035,0.962962962962963,27,900,600,300,0.6666666666666666,12,6,6,418.7878037820128,0.860636277302944,-0.038114224773174055,0.2510184312174754,132206.63542109556,5673.305298681977,137879.94071977754,73,0,49.81481481481482,27,0,21,32.127073988327794,0.6662808641975309,42.89434523809524,1028.4226190476193,38.089726631393305,0
76,4,0,0,26,0.0,0.0,1.0,26,800,400,400,0.5,12,4,8,432.92713834532947,0.8545512820512821,-0.028530019747554425,0.25863028417203954,132080.54995903836,6236.250904968769,138316.80086400712,74,3,52.73076923076923,26,0,22,31.891482760346292,0.6686698717948718,43.01697530864198,1027.9320987654328,39.53584995251664,0
77,4,0,0,26,0.0,0.0,1.0,26,700,400,300,0.5714285714285714,10,4,6,432.80157200935605,0.8533333333333333,-0.023686397635977574,0.2593695751681969,132199.55037341875,6243.234644109143,138442.7850175279,75,4,53.73076923076923,26,0,22,31.77395958383354,0.6698717948717949,42.90123456790124,1028.3950617283956,39.55365622032291,0
78,4,0,0,26,0.0,0.0,1.0,26,700,600,100,0.8571428571428571,8,6,2,432.8906848492884,0.8508333333333333,-0.018535611680954744,0.2602418571587199,132318.6043714753,6255.898252933989,138574.50262440927,76,5,54.73076923076923,26,0,22,31.650917454127292,0.671073717948718,42.78549382716049,1028.8580246913573,39.57146248812913,0
79,4,1,2,25,0.037037037037037035,0.07407407407407407,0.9259259259259259,27,900,600,300,0.6666666666666666,12,6,6,422.80953463217554,0.8532763532763533,-0.030853499368808546,0.2568011594555423,132704.48022959172,5821.743905895677,138526.2241354874,77,0,53.666666666666664,27,0,20,31.519593683805116,0.6712962962962964,42.41071428571428,1030.357142857142,38.16137566137563,0
80,4,0,0,25,0.0,0.0,1.0,25,850,700,150,0.8235294117647058,10,7,3,462.97376093294463,0.8448611111111111,-0.06073469387755126,0.2637873754152823,130262.58680555555,7061.63194444444,137324.21875,78,7,56.04,25,0,19,32.97619047619046,0.6541666666666668,44.791666666666664,1020.8333333333333,40.83333333333333,8
81,4,1,0,26,0.038461538461538464,0.0,1.0,26,1150,900,250,0.782608695652174,14,9,5,444.14541109743413,0.8443589743589743,-0.056666125553674784,0.2580088141173713,131011.95749504656,6437.671944063412,137449.62943910997,79,0,54.84615384615385,26,0,20,32.69112400763741,0.6578525641025641,44.058641975308646,1023.765432098766,39.37559354226023,0
82,4,0,0,26,0.0,0.0,1.0,26,500,200,300,0.4,8,2,6,441.9174197256105,0.8437820512820513,-0.06025737638397799,0.25697827168093157,131051.4575950695,6382.784398338684,137434.24199340818,80,1,55.84615384615385,26,0,20,32.70786234614418,0.6582532051282051,44.02006172839507,1023.9197530864209,39.38152896486234,0
83,4,1,2,25,0.037037037037037035,0.07407407407407407,0.9259259259259259,27,600,300,300,0.5,9,3,6,430.1667716406057,0.8493589743589745,-0.06532279739826907,0.2524573302047508,131404.4009530897,5905.161387471674,137309.5623405614,81,0,54.74074074074074,27,0,20,32.64937106918239,0.658179012345679,43.67559523809525,1025.2976190476202,37.9739858906526,0
84,4,0,0,25,0.0,0.0,1.0,25,900,600,300,0.6666666666666666,12,6,6,458.0206547263595,0.8366666666666667,-0.04265497808390728,0.2659850856719988,130999.80481591071,7000.123274161756,137999.92809007247,82,3,59.72,25,0,20,32.34841369233981,0.6616666666666666,44.07051282051283,1023.7179487179498,40.94871794871799,0
85,4,0,0,25,0.0,0.0,1.0,25,800,500,300,0.625,11,5,6,452.52122098806245,0.8348611111111112,-0.04653316645807215,0.26391566099960745,131163.91354372134,6870.890861275503,138034.80440499683,83,4,60.72,25,0,20,32.32165206508136,0.6633333333333333,43.91025641025642,1024.3589743589753,40.97435897435901,0
86,4,1,1,25,0.038461538461538464,0.038461538461538464,0.9615384615384616,26,750,500,250,0.6666666666666666,10,5,5,435.3430580354232,0.8375641025641025,-0.058421271868925206,0.2565745256932176,131565.50068587108,6255.225480109742,137820.72616598083,84,0,59.34615384615385,26,0,18,32.352775270758116,0.6634615384615383,43.51851851851852,1025.925925925926,39.45868945868946,0
87,4,0,0,25,0.0,0.0,1.0,25,600,400,200,0.6666666666666666,8,4,4,449.1859708034344,0.8294444444444444,-0.04876523913723041,0.2636598019449888,131410.26925131513,6805.529873438561,138215.79912475368,85,6,62.72,25,0,20,32.15588204647285,0.6658333333333333,43.66987179487181,1025.3205128205145,41.01282051282058,0
88,4,0,0,25,0.0,0.0,1.0,25,950,500,450,0.5263157894736842,14,5,9,451.9644629616607,0.8265277777777778,-0.05459147008279919,0.2661476106179939,131533.5337822569,6889.696591469461,138423.23037372637,86,7,63.72,25,0,20,31.959036348487224,0.6670833333333333,43.5496794871795,1025.8012820512836,41.03205128205134,0
89,4,1,1,25,0.038461538461538464,0.038461538461538464,0.9615384615384616,26,800,600,200,0.75,10,6,4,433.7149457872946,0.8307051282051282,-0.06565434865479958,0.25855933965958805,132001.24611816052,6250.182660798682,138251.4287789592,87,0,62.23076923076923,26,0,18,31.95174450618211,0.6678685897435896,43.09413580246915,1027.623456790125,39.5239791073125,0
90,4,1,1,25,0.038461538461538464,0.038461538461538464,0.9615384615384616,26,600,500,100,0.8333333333333334,7,5,2,433.73179877478333,0.8333974358974359,-0.06561493436774857,0.25965453506166936,132159.87761488336,6264.388288751705,138424.26590363507,88,0,63.19230769230769,26,0,19,31.790297163439877,0.6694711538461537,42.93981481481481,1028.2407407407402,39.54772079772078,0
91,4,0,0,25,0.0,0.0,1.0,25,800,600,200,0.75,10,6,4,444.10453107846354,0.8241666666666667,-0.0538490330630067,0.2646466778136719,131985.99810979626,6723.115959894819,138709.11406969107,89,10,66.72,25,0,19,31.70032751091703,0.6716666666666666,43.108974358974365,1027.5641025641032,41.10256410256413,0
92,4,0,0,25,0.0,0.0,1.0,25,850,700,150,0.8235294117647058,10,7,3,446.03571719915334,0.8222222222222222,-0.053507951356407846,0.26637552049491375,132068.34781804754,6781.440047666038,138849.7878657136,90,11,67.72,25,0,19,31.567014863319823,0.6724999999999999,43.02884615384617,1027.884615384617,41.115384615384684,0
93,4,1,2,24,0.038461538461538464,0.07692307692307693,0.9230769230769231,26,800,400,400,0.5,12,4,8,434.6929161489602,0.8242948717948718,-0.06271542035066713,0.2629833027617417,132556.87311861763,6324.306746303917,138881.17986492155,91,0,66.07692307692308,26,0,19,31.363017633248415,0.6734775641025641,42.55401234567901,1029.783950617284,39.60707502374169,0
94,4,0,0,24,0.0,0.0,1.0,24,750,500,250,0.6666666666666666,10,5,5,464.82451151683506,0.8128774154589372,-0.06492405749932206,0.2707437557602799,131114.670138889,7389.062500000017,138503.73263888902,92,13,68.91666666666667,24,0,21,32.05688906970436,0.6671006944444444,43.95833333333334,1024.1666666666677,42.67361111111115,2
95,4,1,0,25,0.04,0.0,1.0,25,700,500,200,0.7142857142857143,9,5,4,450.88993575336053,0.8169444444444445,-0.06367015461502412,0.2660873971086423,131615.74223886436,6868.842712442493,138484.58495130687,93,0,67.12,25,0,18,31.90285152792962,0.6679166666666665,43.46955128205129,1026.1217948717958,41.04487179487183,0
96,4,1,1,25,0.038461538461538464,0.038461538461538464,0.9615384615384616,26,950,600,350,0.631578947368421,13,6,7,438.9172616089588,0.8211538461538461,-0.07800943047337294,0.2608422583276099,131882.33500990708,6377.0866674287545,138259.42167733583,94,0,65.5,26,0,18,31.93891476362179,0.6666666666666666,43.20987654320988,1027.160493827161,39.50617283950619,0
97,4,0,1,24,0.0,0.04,0.96,25,450,300,150,0.6666666666666666,6,3,3,478.47355389509704,0.8165277777777777,-0.07030985915492971,0.27845592070944186,131081.84633875746,7543.83937376727,138625.68571252472,95,2,69.12,25,0,18,31.74100156494523,0.6624999999999999,43.99038461538462,1024.0384615384621,40.96153846153848,6
98,4,0,0,24,0.0,0.0,1.0,24,800,600,200,0.75,10,6,4,494.806310942291,0.8081219806763285,-0.058699782844734094,0.28661422162128936,130901.38888888895,8154.166666666675,139055.55555555562,96,17,72.91666666666667,24,0,18,31.507871878393054,0.6649305555555556,44.16666666666667,1023.3333333333338,42.63888888888891,0
99,4,1,0,25,0.04,0.0,1.0,25,700,500,200,0.7142857142857143,9,5,4,476.92987053139933,0.81125,-0.0555923726164429,0.2799447074917334,131410.269251315,7534.696540105212,138944.96579142023,97,0,70.96,25,0,19,31.444722309054907,0.6658333333333333,43.6698717948718,1025.3205128205136,41.01282051282055,0
100,4,0,1,24,0.0,0.04,0.96,25,450,200,250,0.4444444444444444,7,2,5,476.92987053139933,0.81125,-0.0555923726164429,0.2799447074917334,131410.269251315,7534.696540105212,138944.96579142023,98,1,71.96,25,0,19,31.444722309054907,0.6658333333333333,43.6698717948718,1025.3205128205136,41.01282051282055,0
101,4,1,0,25,0.04,0.0,1.0,25,750,500,250,0.6666666666666666,10,5,5,468.619949159823,0.8127777777777778,-0.049353730877302326,0.277447263800169,131739.103077745,7347.114357330726,139086.21743507573,99,0,70.4,25,0,18,31.322197939431792,0.6691666666666667,43.349358974358985,1026.602564102565,41.064102564102605,0
102,4,0,0,25,0.0,0.0,1.0,25,450,300,150,0.6666666666666666,6,3,3,472.2596526223088,0.8131944444444444,-0.042540716612377905,0.27355417614160166,130901.38888888895,7365.532544378708,138266.92143326765,100,1,71.4,24,1,17,32.08469055374593,0.6649305555555556,44.16666666666667,1023.3333333333338,42.63888888888891,2
103,4,3,3,25,0.10714285714285714,0.10714285714285714,0.8928571428571429,28,600,400,200,0.6666666666666666,8,4,4,427.9552363288984,0.8328924162257495,-0.06408704290060241,0.25445090408082566,131900.7344148597,5689.521993693308,137590.25640855302,101,0,64.64285714285714,27,1,17,32.201729924187546,0.6631944444444444,43.191964285714285,1027.232142857143,38.045634920634924,0
104,4,0,0,25,0.0,0.0,1.0,25,700,500,200,0.7142857142857143,9,5,4,472.115067544486,0.8130555555555555,-0.03712426805465174,0.27590907179310864,131242.7222222223,7392.333333333354,138635.05555555565,102,3,73.4,24,1,18,31.739319019735426,0.6684027777777777,43.83333333333334,1024.6666666666674,42.69444444444448,0
105,4,1,0,26,0.038461538461538464,0.0,1.0,26,750,600,150,0.8,9,6,3,452.146944272214,0.8205769230769231,-0.03509930593914379,0.2676943923297418,131739.10307774507,6713.086579552948,138452.189657298,103,0,71.53846153846153,25,1,19,31.74497866583409,0.6691666666666666,43.349358974358985,1026.6025641025656,41.064102564102626,0
106,4,0,1,25,0.0,0.038461538461538464,0.9615384615384616,26,750,500,250,0.6666666666666666,10,5,5,454.6275328269786,0.8171153846153846,-0.030903594222371655,0.2709174480006123,131985.99810979626,6800.893737672595,138786.89184746885,104,1,72.53846153846153,25,1,19,31.4300010397172,0.6716666666666666,43.108974358974365,1027.5641025641032,41.10256410256413,0
107,4,1,1,25,0.038461538461538464,0.038461538461538464,0.9615384615384616,26,650,500,150,0.7692307692307693,8,5,3,439.45102879849253,0.8186538461538462,-0.07398668528112107,0.2641857537420694,132318.6043714754,6429.509364045116,138748.1137355205,105,0,69.5,26,0,20,31.482175891205433,0.6710737179487178,42.785493827160494,1028.8580246913582,39.571462488129164,0
108,4,1,0,26,0.038461538461538464,0.0,1.0,26,750,500,250,0.6666666666666666,10,5,5,436.38964727498575,0.8185897435897436,-0.06599335915882698,0.26373113465749126,132517.14677640598,6365.822187928662,138882.96896433464,106,0,69.46153846153847,26,0,21,31.359599820143885,0.6730769230769231,42.59259259259259,1029.6296296296293,39.60113960113959,0
109,4,0,0,26,0.0,0.0,1.0,26,400,100,300,0.25,7,1,6,436.1732104532256,0.8166025641025642,-0.0661192739844425,0.2644374368551572,132636.34366426617,6370.483967764069,139006.82763203024,107,1,70.46153846153847,26,0,18,31.24438202247191,0.674278846153846,42.476851851851855,1030.092592592593,39.618945868945886,0
110,4,0,1,25,0.0,0.038461538461538464,0.9615384615384616,26,850,800,50,0.9411764705882353,9,8,1,438.132533184153,0.8151282051282052,-0.0622019489944019,0.26647077018249304,132755.59413580244,6432.908950617277,139188.50308641972,108,2,71.46153846153847,26,0,19,31.07311320754717,0.6754807692307692,42.36111111111111,1030.5555555555552,39.63675213675212,0
111,4,0,0,25,0.0,0.0,1.0,25,650,400,250,0.6153846153846154,9,4,5,452.8705696754617,0.8084722222222223,-0.04887643946467468,0.2740250735154912,132562.98539201188,7006.774942472068,139569.76033448393,109,4,75.24,25,0,20,30.888837016287997,0.6775,42.54807692307693,1029.8076923076926,41.19230769230771,0
112,4,0,0,25,0.0,0.0,1.0,25,800,500,300,0.625,11,5,6,452.78532122028344,0.8079166666666666,-0.053067828251400107,0.27457585328339473,132645.51487508236,7011.988412228822,139657.50328731118,110,5,76.24,25,0,19,30.807275461522508,0.6783333333333332,42.46794871794873,1030.1282051282064,41.20512820512826,0
113,4,1,1,25,0.038461538461538464,0.038461538461538464,0.9615384615384616,26,750,500,250,0.6666666666666666,10,5,5,438.96277254050943,0.814551282051282,-0.06728323300222139,0.26839782332005724,132954.46399653264,6472.412027511063,139426.8760240437,111,0,74.26923076923077,26,0,19,30.850354132375685,0.6774839743589742,42.168209876543216,1031.3271604938277,39.6664292497626,0
114,4,0,1,24,0.0,0.04,0.96,25,700,500,200,0.7142857142857143,9,5,4,453.19641178078575,0.805,-0.059160708734846024,0.2766476008916107,132893.25741699548,7045.349482248535,139938.606899244,112,7,78.24,25,0,19,30.545409802093054,0.6808333333333333,42.22756410256411,1031.089743589744,41.243589743589766,0
115,4,0,0,24,0.0,0.0,1.0,24,700,500,200,0.7142857142857143,9,5,4,468.85642788885554,0.7934782608695652,-0.046490944372574616,0.28537481791975217,132784.2222222221,7651.347222222201,140435.5694444443,113,10,82.20833333333333,24,0,19,30.252466041397145,0.6840277777777779,42.33333333333332,1030.6666666666656,42.9444444444444,0
116,4,0,0,24,0.0,0.0,1.0,24,950,800,150,0.8421052631578947,11,8,3,486.3369786093039,0.7934782608695652,-0.047100262123197845,0.2708577479408023,129370.88888888902,7783.569444444466,137154.4583333335,114,11,83.20833333333333,24,0,20,33.297496177370036,0.6493055555555556,45.66666666666668,1017.3333333333345,42.388888888888935,7
117,4,1,1,24,0.04,0.04,0.96,25,800,600,200,0.75,10,6,4,487.11600274656917,0.8076388888888889,-0.04855520504731847,0.26901702590707766,129038.51290269567,7571.344921104553,136609.85782380024,115,0,80.84,25,0,19,33.620531019978976,0.6416666666666666,45.99358974358975,1016.0256410256417,40.641025641025664,4
118,4,1,0,25,0.04,0.0,1.0,25,700,300,400,0.42857142857142855,11,3,8,487.3145835002212,0.8015277777777777,-0.035076438140268174,0.27051715068319376,129242.1239367604,7596.31435938528,136838.43829614567,116,0,81.8,25,0,20,33.40540451799317,0.64375,45.79326923076923,1016.8269230769234,40.673076923076934,0
119,4,0,0,25,0.0,0.0,1.0,25,750,500,250,0.6666666666666666,10,5,5,488.7072005143365,0.8022222222222222,-0.0350543392660263,0.2724145755983777,129405.12833353876,7648.243600016429,137053.37193355517,117,1,82.8,25,0,21,33.2019149997375,0.6454166666666667,45.63301282051282,1017.4679487179484,40.698717948717935,0
120,4,1,1,25,0.038461538461538464,0.038461538461538464,0.9615384615384616,26,850,300,550,0.35294117647058826,14,3,11,476.0731257728804,0.8133974358974358,-0.048296878095393514,0.267451804529939,129711.79424344616,7150.459867017226,136862.25411046337,118,0,80.57692307692308,26,0,18,33.2077210523658,0.6446314102564102,45.33179012345679,1018.6728395061731,39.179724596391274,0
121,4,1,1,25,0.038461538461538464,0.038461538461538464,0.9615384615384616,26,450,200,250,0.4444444444444444,7,2,5,472.39070423773745,0.8100641025641026,-0.04545136825918339,0.26591609719367265,129790.40745027433,7062.356395747593,136852.76384602193,119,0,81.53846153846153,26,0,19,33.22069513857337,0.6454326923076923,45.254629629629626,1018.9814814814813,39.19159544159543,0
122,4,0,0,25,0.0,0.0,1.0,25,650,400,250,0.6153846153846154,9,4,5,484.696624636864,0.8006944444444445,-0.03829425649095186,0.27186646509861156,129649.82754458406,7568.166759122274,137217.99430370633,120,4,85.8,25,0,19,33.05189483346446,0.6479166666666667,45.3926282051282,1018.4294871794864,40.73717948717945,0
123,4,2,3,24,0.07407407407407407,0.1111111111111111,0.8888888888888888,27,1050,800,250,0.7619047619047619,13,8,5,456.5187825338964,0.8214624881291548,-0.05833522242732392,0.26061829332342706,130338.55273880366,6500.399482709719,136838.95222151338,121,0,80.37037037037037,27,0,19,33.063125425046145,0.6473765432098766,44.71726190476189,1021.1309523809508,37.81966490299818,0
124,4,2,0,26,0.07692307692307693,0.0,1.0,26,600,400,200,0.6666666666666666,8,4,4,456.2232441180914,0.8077564102564102,-0.04314502539309928,0.2609975499410237,130420.17044372033,6700.142651653687,137120.313095374,122,0,81.61538461538461,26,0,22,32.98710782091957,0.6518429487179487,44.637345679012334,1021.4506172839494,39.286562203228826,0
125,4,0,0,26,0.0,0.0,1.0,26,800,600,200,0.75,10,6,4,455.8369310247258,0.8083333333333333,-0.04455031373460394,0.2610415643065472,130459.58123761615,6693.6590268251675,137153.24026444132,123,1,82.61538461538461,26,0,22,32.956633937562934,0.6522435897435898,44.59876543209876,1021.6049382716044,39.29249762583094,0
126,4,1,3,24,0.037037037037037035,0.1111111111111111,0.8888888888888888,27,800,700,100,0.875,9,7,2,441.8470934782368,0.8149335232668566,-0.06035425793900995,0.2549802748510427,130756.7612005738,6154.898977820267,136911.66017839406,124,0,80.51851851851852,27,0,18,33.010360589747314,0.6516203703703705,44.3080357142857,1022.7678571428557,37.88029100529096,0
127,4,2,1,25,0.07692307692307693,0.038461538461538464,0.9615384615384616,26,600,400,200,0.6666666666666666,8,4,4,454.2519207187995,0.8064102564102564,-0.037927511667324554,0.26172810666806645,130696.17102956858,6673.797344154841,137369.96837372342,125,0,84.38461538461539,26,0,19,32.75511872421772,0.6546474358974359,44.36728395061728,1022.5308641975301,39.32811016144347,0
128,4,0,1,24,0.0,0.04,0.96,25,800,500,300,0.625,11,5,6,464.47130485421917,0.7952777777777778,-0.02185353614552299,0.2666006760625883,130549.035508095,7127.256173980933,137676.29168207594,126,1,88.76,25,0,19,32.64449715122053,0.6570833333333334,44.51121794871795,1021.9551282051282,40.878205128205124,0
129,4,1,0,25,0.04,0.0,1.0,25,700,500,200,0.7142857142857143,9,5,4,461.96091769986015,0.7973611111111111,-0.02639511201629352,0.26685036540074275,130794.81336805559,7084.418402777783,137879.23177083337,127,0,88.64,25,0,21,32.457145281737944,0.6595833333333333,44.270833333333336,1022.916666666667,40.91666666666668,0
130,4,1,1,25,0.038461538461538464,0.038461538461538464,0.9615384615384616,26,950,700,250,0.7368421052631579,12,7,5,451.0478213897342,0.8021794871794872,-0.04130066980323088,0.2630980174327818,131169.9936175888,6632.787970583756,137802.78158817257,128,0,86.1923076923077,26,0,21,32.35318117907,0.6594551282051282,43.90432098765432,1024.382716049383,39.39933523266858,0
131,4,2,1,26,0.07407407407407407,0.037037037037037035,0.962962962962963,27,900,700,200,0.7777777777777778,11,7,4,438.0324151614316,0.8061490978157645,-0.04903177288964078,0.2583604364874313,131595.18771701393,6128.591579861119,137723.77929687506,129,0,83.92592592592592,27,0,19,32.25359560067682,0.660108024691358,43.489583333333336,1026.041666666667,38.00154320987655,0
132,4,0,0,26,0.0,0.0,1.0,26,900,500,400,0.5555555555555556,13,5,8,449.00899076635005,0.8023076923076923,-0.03437579573601224,0.2640808630648817,131486.3516422802,6607.710810089937,138094.06245237016,130,1,88.15384615384616,26,0,23,32.08289447286589,0.6626602564102564,43.595679012345684,1025.6172839506178,39.4468186134853,0
133,4,0,0,26,0.0,0.0,1.0,26,700,600,100,0.8571428571428571,8,6,2,448.8687458457688,0.8029487179487179,-0.03124132185504047,0.26454604808357024,131565.50068587117,6611.128257887532,138176.6289437587,131,2,89.15384615384616,26,0,19,32.00586642599278,0.6634615384615383,43.518518518518526,1025.9259259259268,39.45868945868949,0
134,4,0,0,26,0.0,0.0,1.0,26,450,300,150,0.6666666666666666,6,3,3,448.3482390185991,0.8023076923076923,-0.02717177559282824,0.264788258390203,131644.67354442933,6604.531511964662,138249.20505639398,132,3,90.15384615384616,26,0,20,31.93859649122807,0.6642628205128205,43.44135802469137,1026.2345679012356,39.47056030389368,0
135,4,0,0,26,0.0,0.0,1.0,26,650,500,150,0.7692307692307693,8,5,3,445.9913151134633,0.8000641025641025,-0.02138422227104031,0.26421907564112856,131763.4774853301,6553.073321521131,138316.55080685124,133,4,91.15384615384616,26,0,20,31.878162733603887,0.6654647435897435,43.32561728395063,1026.6975308641986,39.48836657169995,0
136,4,0,1,25,0.0,0.038461538461538464,0.9615384615384616,26,750,600,150,0.8,9,6,3,449.4462809917356,0.8,-0.0242307692307695,0.25224025974025965,129672.49657064467,6456.164266117962,136128.66083676263,134,5,92.15384615384616,26,0,18,33.926136363636374,0.6442307692307693,45.37037037037037,1018.5185185185181,39.17378917378916,5
137,4,2,2,25,0.07407407407407407,0.07407407407407407,0.9259259259259259,27,600,500,100,0.8333333333333334,7,5,2,431.8788534619115,0.8145773979107312,-0.03207175081719171,0.2448742382532177,130072.76885363513,5835.135655824824,135907.90450945997,135,0,89.4074074074074,27,0,18,33.96380379285195,0.6446759259259259,44.97767857142857,1020.0892857142851,37.78108465608463,0
138,4,2,2,25,0.07407407407407407,0.07407407407407407,0.9259259259259259,27,500,300,200,0.6,7,3,4,430.5441305015164,0.8131528964862299,-0.035399951373692895,0.24411745364664134,130072.76885363513,5800.413433602603,135873.18228723772,136,0,90.33333333333333,27,0,18,33.99784220763435,0.6446759259259259,44.97767857142857,1020.0892857142851,37.78108465608463,0
139,4,0,0,25,0.0,0.0,1.0,25,650,500,150,0.7692307692307693,8,5,3,458.80516847973513,0.79,-0.004252240918383388,0.2584182521136082,129813.08876253298,6911.783212113757,136724.87197464672,137,8,98.56,25,0,18,33.54350133668816,0.6495833333333333,45.2323717948718,1019.0705128205136,40.76282051282055,0
140,4,1,1,25,0.038461538461538464,0.038461538461538464,0.9615384615384616,26,900,600,300,0.6666666666666666,12,6,6,448.27479995149525,0.8055769230769231,-0.023083902336889173,0.25489606638686485,130183.83070892398,6471.626133592445,136655.45684251643,138,0,95.73076923076923,26,0,18,33.43193961389183,0.6494391025641025,44.86882716049383,1020.5246913580249,39.25094966761635,0
141,4,1,1,25,0.038461538461538464,0.038461538461538464,0.9615384615384616,26,550,400,150,0.7272727272727273,7,4,3,446.31403581840925,0.8005769230769231,-0.016169544740973096,0.2542952064546749,130262.5868055555,6427.604166666662,136690.19097222216,139,0,96.6923076923077,26,0,18,33.401360544217695,0.6502403846153846,44.791666666666664,1020.8333333333329,39.2628205128205,0
142,4,0,0,25,0.0,0.0,1.0,25,800,500,300,0.625,11,5,6,459.00952959629143,0.7880555555555555,-0.0026138862708133814,0.26043267962655897,130099.04308431954,6943.340113412235,137042.38319773177,140,11,101.56,25,0,19,33.24497329563306,0.6525000000000001,44.95192307692308,1020.1923076923078,40.807692307692314,0
143,4,0,0,25,0.0,0.0,1.0,25,750,600,150,0.8,9,6,3,459.00952959629143,0.7880555555555555,-0.0026138862708133814,0.26043267962655897,130099.04308431954,6943.340113412235,137042.38319773177,141,12,102.56,25,0,19,33.24497329563306,0.6525000000000001,44.95192307692308,1020.1923076923078,40.807692307692314,0
144,4,0,0,25,0.0,0.0,1.0,25,800,600,200,0.75,10,6,4,460.7537673465007,0.7869444444444444,-0.00751138326267875,0.26224671530204324,130221.69124445271,7000.026966222888,137221.7182106756,142,13,103.56,25,0,19,33.074756633694456,0.65375,44.831730769230774,1020.6730769230774,40.826923076923094,0
145,4,1,0,26,0.038461538461538464,0.0,1.0,26,600,400,200,0.6666666666666666,8,4,4,445.4124314702742,0.7957051282051282,-0.005172714078374385,0.25637335868727773,130656.72451322209,6439.22587067521,137095.9503838973,143,0,100.53846153846153,26,0,18,33.02138364779875,0.6542467948717949,44.40586419753087,1022.3765432098767,39.32217473884141,0
146,4,1,0,27,0.037037037037037035,0.0,1.0,27,750,700,50,0.9333333333333333,8,7,1,431.0032449972957,0.8056742640075973,-0.00572782084409984,0.25044783155248274,131023.24263038555,5894.28854875284,136917.5311791384,144,0,97.77777777777777,27,0,20,33.01598837209302,0.654320987654321,44.04761904761905,1023.8095238095242,37.9188712522046,0
147,4,0,0,27,0.0,0.0,1.0,27,700,600,100,0.8571428571428571,8,6,2,431.0032449972957,0.8056742640075973,-0.00572782084409984,0.25044783155248274,131023.24263038555,5894.28854875284,136917.5311791384,145,1,98.77777777777777,27,0,20,33.01598837209302,0.654320987654321,44.04761904761905,1023.8095238095242,37.9188712522046,0
148,4,0,0,27,0.0,0.0,1.0,27,700,500,200,0.7142857142857143,9,5,4,446.70295660698304,0.8056742640075973,0.028065129403561206,0.24008959699374505,127956.26339728586,6031.688235189883,133987.95163247574,146,2,99.77777777777777,27,0,19,35.76215252242975,0.623070987654321,47.06101190476189,1011.7559523809513,37.47244268077597,8
149,4,3,2,28,0.1,0.06666666666666667,0.9333333333333333,30,700,500,200,0.7142857142857143,9,5,4,411.4832284403676,0.8383620689655172,0.015729097727773755,0.22642066940036226,128894.11212640174,4607.553076945293,133501.66520334705,147,0,90.7,30,0,17,35.68966468122655,0.6232638888888891,46.13575268817203,1015.4569892473106,33.84856630824369,0
150,4,1,0,29,0.034482758620689655,0.0,1.0,29,600,400,200,0.6666666666666666,8,4,4,424.0308886138682,0.8291256157635468,0.030292735405696325,0.23264397402328432,128778.1249999999,5121.180555555539,133899.30555555545,148,0,94.79310344827586,29,0,18,35.49021620142308,0.625,46.24999999999999,1014.9999999999992,34.99999999999997,0
151,4,1,1,29,0.03333333333333333,0.03333333333333333,0.9666666666666667,30,850,600,250,0.7058823529411765,11,6,5,411.829923569569,0.8347222222222223,0.01735661067759997,0.22778683629184404,129098.9226536303,4633.359889871639,133732.28254350193,149,0,92.6,30,0,19,35.470947405546,0.6253472222222223,45.934139784946225,1016.2634408602137,33.87544802867379,0
152,4,2,1,30,0.06451612903225806,0.03225806451612903,0.967741935483871,31,750,500,250,0.6666666666666666,10,5,5,401.710392989409,0.8422043010752688,0.018223309825153855,0.22445819456742022,129499.41211276577,4204.251946343307,133703.66405910908,150,0,90.54838709677419,31,0,16,35.318456569016256,0.6266801075268817,45.54036458333333,1017.8385416666661,32.833501344086,0
153,4,0,0,30,0.0,0.0,1.0,30,700,300,400,0.42857142857142855,11,3,8,412.50694199232106,0.8349616858237549,0.019388653981676995,0.22954798066160917,129338.07376575323,4670.570658457621,134008.64442421086,151,1,94.56666666666666,30,0,20,35.208828840732906,0.6277777777777779,45.69892473118279,1017.2043010752685,33.906810035842284,0
154,4,0,0,30,0.0,0.0,1.0,30,1200,800,400,0.6666666666666666,16,8,8,412.9846320808005,0.8352490421455939,0.021829064342927307,0.23101518488773895,129543.23657359237,4699.873178980235,134243.1097525726,152,2,95.56666666666666,30,0,17,34.9867419241264,0.6298611111111111,45.49731182795699,1018.0107526881724,33.93369175627241,0
155,4,3,2,31,0.09090909090909091,0.06060606060606061,0.9393939393939394,33,700,500,200,0.7142857142857143,9,5,4,385.264173185498,0.8532986111111112,0.005681349732796548,0.2196929551747488,130294.81207274769,3441.5763490880086,133736.3884218357,153,0,87.78787878787878,32,1,18,34.926622145271665,0.6321614583333334,44.76010101010101,1020.9595959595961,31.904987373737377,0
156,4,0,3,28,0.0,0.0967741935483871,0.9032258064516129,31,700,600,100,0.8571428571428571,8,6,2,402.2261151181974,0.8415770609318997,0.020824409370984398,0.22761813104087572,129996.88042534715,4257.628038194435,134254.50846354157,154,1,94.45161290322581,31,0,18,34.797412325502215,0.631720430107527,45.05208333333333,1019.791666666666,32.89650537634406,0
157,4,0,0,28,0.0,0.0,1.0,28,700,400,300,0.5714285714285714,10,4,6,426.01490963011264,0.8293650793650793,0.04149871009351824,0.23889190502043026,129639.97886114412,5445.712775796006,135085.69163694012,155,2,99.89285714285714,28,0,18,34.55605718585402,0.6369047619047619,45.40229885057471,1018.3908045977009,36.371100164203604,0
158,4,2,0,30,0.06666666666666667,0.0,1.0,30,800,500,300,0.625,11,5,6,423.16625703269705,0.8473180076628353,0.0009328782707622718,0.23571808614178744,129377.9538001543,4951.168377088196,134329.1221772425,156,0,94.16666666666667,29,1,21,34.89689988623436,0.6311063218390804,45.65972222222222,1017.361111111111,35.081417624521066,4
159,4,2,1,31,0.0625,0.03125,0.96875,32,1050,500,550,0.47619047619047616,16,5,11,402.6204017420641,0.8542086693548387,0.00295834396529715,0.22900861457578375,130196.13477918842,4083.924018012158,134280.0587972006,157,0,89.21875,31,1,19,34.58418389044824,0.6337365591397849,44.856770833333336,1020.5729166666671,32.921706989247326,0
160,4,0,0,31,0.0,0.0,1.0,31,750,500,250,0.6666666666666666,10,5,5,409.5429762147697,0.8490143369175627,0.014788310435532415,0.2325236149922452,130125.41415553828,4458.389878887738,134583.80403442602,158,1,93.09677419354838,30,1,20,34.47970183989813,0.6357638888888888,44.92607526881721,1020.2956989247317,34.00985663082439,0
161,4,0,0,31,0.0,0.0,1.0,31,850,400,450,0.47058823529411764,13,4,9,412.81943994263196,0.8459677419354839,0.011040011549550588,0.235626542843289,130331.20022907274,4560.650617123369,134891.85084619612,159,2,94.09677419354838,30,1,21,34.18619191786231,0.6378472222222221,44.7244623655914,1021.1021505376345,34.036738351254485,0
162,4,1,1,31,0.03125,0.03125,0.96875,32,900,600,300,0.6666666666666666,12,6,6,405.0247977808507,0.8472782258064517,0.011191416199694437,0.2331565038251645,130661.65500217032,4184.242078993077,134845.8970811634,160,0,92.125,31,1,18,34.04865002547121,0.6384408602150536,44.40104166666668,1022.3958333333347,32.98051075268822,0
163,4,4,3,32,0.11428571428571428,0.08571428571428572,0.9142857142857143,35,650,400,250,0.6153846153846154,9,4,5,373.7785417207792,0.8619747899159663,-0.005642558278541765,0.21910704285173954,131359.53006355764,2821.5701386636565,134181.1002022213,161,0,84.62857142857143,33,2,19,34.1401424586571,0.6404671717171715,43.71936274509806,1025.1225490196107,31.06431966726093,0
164,4,2,2,32,0.058823529411764705,0.058823529411764705,0.9411764705882353,34,750,600,150,0.8,9,6,3,380.64183859740865,0.8618909685086156,0.015356136296124978,0.22313581859728251,131360.48179076126,3200.259061575367,134560.74085233663,162,0,88.05882352941177,32,2,21,33.9632857084206,0.6429036458333333,43.71843434343435,1025.1262626262635,32.035195707070734,0
165,4,0,0,32,0.0,0.0,1.0,32,650,500,150,0.7692307692307693,8,5,3,397.79980754378244,0.8509324596774194,0.030725524475524235,0.23158367774477048,131094.66764662004,4029.8867119683196,135124.55435858836,163,1,94.0,31,1,21,33.7933089637635,0.6428091397849462,43.977864583333336,1024.088541666667,33.03511424731184,0
166,4,0,0,32,0.0,0.0,1.0,32,850,600,250,0.7058823529411765,11,6,5,394.17806103710706,0.8510584677419355,0.025721276054905706,0.23007366351928477,131194.69536675353,3942.8141276041697,135137.50949435768,164,2,95.0,31,1,21,33.78452804609387,0.6438172043010753,43.880208333333336,1024.479166666667,33.04771505376345,0
167,4,1,2,31,0.030303030303030304,0.06060606060606061,0.9393939393939394,33,800,600,200,0.75,10,6,4,388.64821994680653,0.8521148989898991,0.020836130880443893,0.22879551730781578,131522.3255280075,3623.18353994492,135145.50906795243,165,0,93.0909090909091,32,1,22,33.59413466272771,0.64453125,43.56060606060607,1025.757575757577,32.05492424242428,0
168,4,2,1,32,0.06060606060606061,0.030303030303030304,0.9696969696969697,33,1050,900,150,0.8571428571428571,12,9,3,391.39928579226785,0.8511679292929294,0.033428321320146726,0.23258094886195013,131878.7324794663,3723.448340730526,135602.18082019684,166,0,93.57575757575758,32,1,17,33.16277402171686,0.6481119791666667,43.213383838383834,1027.146464646464,32.098327020202,0
169,4,1,2,31,0.030303030303030304,0.06060606060606061,0.9393939393939394,33,700,600,100,0.8571428571428571,8,6,2,390.97881665449245,0.8495896464646465,0.03259623259623279,0.2333260680034874,132040.8950617284,3725.0385802469154,135765.9336419753,167,0,94.54545454545455,32,1,17,33.009572072072075,0.6497395833333334,43.05555555555556,1027.7777777777778,32.11805555555556,0
170,4,0,4,27,0.0,0.12903225806451613,0.8709677419354839,31,700,400,300,0.5714285714285714,10,4,6,396.5015045029742,0.8435483870967742,0.023659593982344518,0.22631269193907558,130331.20022907275,4135.303394901148,134466.5036239739,168,2,96.58064516129032,30,1,19,34.60274889210653,0.6378472222222221,44.7244623655914,1021.1021505376347,34.03673835125449,4
171,4,2,1,28,0.06896551724137931,0.034482758620689655,0.9655172413793104,29,900,600,300,0.6666666666666666,12,6,6,416.0107121602856,0.8315886699507389,0.036949975716367156,0.23591661791837293,130079.31199630076,5022.877444180221,135102.189440481,169,0,103.03448275862068,28,1,20,34.36179577464788,0.6413690476190477,44.9712643678161,1020.1149425287362,36.43267651888343,0
172,4,2,1,29,0.06666666666666667,0.03333333333333333,0.9666666666666667,30,1300,1100,200,0.8461538461538461,15,11,4,404.69287757289305,0.8351053639846744,0.04846109561135492,0.2174249314411967,127940.47948100937,4355.320159845071,132295.79964085444,170,0,100.53333333333333,30,0,19,36.840983570258196,0.6135416666666667,47.07661290322581,1011.6935483870968,33.723118279569896,8
173,4,2,3,28,0.06451612903225806,0.0967741935483871,0.9032258064516129,31,550,400,150,0.7272727272727273,7,4,3,395.46269299215294,0.8470430107526882,0.04007377821419533,0.21411354268684274,128250.02170138896,3943.944973768649,132193.9666751576,171,0,98.19354838709677,29,2,19,36.75656451391745,0.6196120689655172,46.770833333333336,1012.9166666666673,34.928160919540254,0
174,4,1,1,28,0.034482758620689655,0.034482758620689655,0.9655172413793104,29,650,500,150,0.7692307692307693,8,5,3,418.14472502299964,0.826252052545156,0.05512694826875819,0.2240258824792097,127828.3203125,4890.147569444446,132718.46788194444,172,0,105.41379310344827,29,0,19,36.61627867051229,0.615301724137931,47.1875,1011.25,34.87068965517241,0
175,4,4,3,29,0.125,0.09375,0.90625,32,600,400,200,0.6666666666666666,8,4,4,387.5865800280411,0.8566868279569894,0.03424827723297108,0.21163012539013012,128587.20119377962,3568.5159592149375,132155.71715299456,173,0,96.40625,30,2,19,36.61045587065996,0.6201388888888889,46.43817204301075,1014.2473118279569,33.808243727598565,0
176,4,0,0,29,0.0,0.0,1.0,29,1000,900,100,0.9,11,9,2,421.12070480412217,0.8292282430213465,0.07218782615744734,0.22783366589005194,128219.87714356561,4999.20900651925,133219.08615008486,174,1,107.37931034482759,27,2,20,36.13784405916349,0.6257716049382717,46.80059523809523,1012.7976190476179,37.51102292768955,0
177,4,2,1,30,0.06451612903225806,0.03225806451612903,0.967741935483871,31,950,800,150,0.8421052631578947,11,8,3,398.56420304034623,0.8433691756272401,0.06346572277218998,0.21886594740960855,128813.37046682091,4068.0796682098644,132881.45013503078,175,0,101.38709677419355,29,2,20,36.10032722214621,0.6253591954022989,46.21527777777777,1015.1388888888882,35.00478927203063,0
178,4,1,0,31,0.03225806451612903,0.0,1.0,31,1050,600,450,0.5714285714285714,15,6,9,382.78985522509333,0.8407706093189964,0.04266885481306737,0.20936940777094212,128655.3720083245,3649.594244999401,132304.9662533239,176,0,102.35483870967742,30,1,20,36.662305688040995,0.6208333333333333,46.37096774193547,1014.5161290322568,33.81720430107523,2
179,4,0,0,31,0.0,0.0,1.0,31,700,400,300,0.5714285714285714,10,4,6,379.4881753858601,0.8402329749103943,0.042376213039789556,0.20817102935487508,128771.51701185423,3573.4536064995477,132344.97061835378,177,1,103.35483870967742,31,0,21,36.62724502886466,0.6192876344086022,46.25651041666666,1014.9739583333321,32.741095430107485,0
180,4,1,0,32,0.03125,0.0,1.0,32,1500,1200,300,0.8,18,12,6,372.88363343187314,0.8480342741935485,0.029200819672131173,0.20678092399403858,129201.38888888883,3236.13298204209,132437.5218709309,178,0,101.09375,31,1,23,36.3558743169399,0.6236559139784946,45.83333333333333,1016.6666666666662,32.79569892473117,0
181,4,2,2,32,0.058823529411764705,0.058823529411764705,0.9411764705882353,34,700,500,200,0.7142857142857143,9,5,4,354.00487619238794,0.8597370766488414,0.028810297124985063,0.19897515454951456,129731.4453125,2385.1128472222226,132116.55815972222,179,0,96.08823529411765,33,1,16,36.29643830947511,0.6240530303030303,45.3125,1018.75,30.87121212121212,0
182,4,0,0,32,0.0,0.0,1.0,32,550,300,250,0.5454545454545454,8,3,5,373.25432350455895,0.844674059139785,0.035250256016384984,0.20768253384740842,129333.80126953124,3254.8800998263873,132588.68136935763,180,1,103.0625,31,1,23,36.21138419525517,0.625,45.703125,1017.1874999999999,32.81249999999999,0
183,4,3,2,33,0.08571428571428572,0.05714285714285714,0.9428571428571428,35,750,500,250,0.6666666666666666,10,5,5,345.6001174810808,0.857422969187675,0.022507792056269293,0.1962981184181807,130141.08737244912,1995.3550170068147,132136.44238945594,181,0,95.14285714285714,34,1,19,36.09482557461206,0.6259191176470588,44.91071428571429,1020.3571428571439,30.010504201680703,0
184,4,1,2,32,0.029411764705882353,0.058823529411764705,0.9411764705882353,34,1150,900,250,0.782608695652174,14,9,5,355.4956758560362,0.8514928698752229,0.03567920862038543,0.20173834366063423,130106.2560823963,2450.442287822007,132556.6983702183,182,0,98.91176470588235,33,1,19,35.87775275275276,0.627840909090909,44.94485294117648,1020.2205882352949,30.915775401069542,0
185,4,0,2,30,0.0,0.0625,0.9375,32,1100,800,300,0.7272727272727273,14,8,6,377.65844361207775,0.8428679435483871,0.04952340656533405,0.21317144592926887,129897.31046888577,3411.363220214863,133308.67368910063,183,2,105.875,31,1,21,35.52510431302423,0.6307123655913978,45.14973958333334,1019.4010416666678,32.88390456989251,0
186,4,0,0,30,0.0,0.0,1.0,30,700,400,300,0.5714285714285714,10,4,6,397.64447066662444,0.8331417624521074,0.05743519781718964,0.22249877633483664,129554.63927469148,4303.337191358045,133857.97646604953,184,3,113.26666666666667,29,1,21,35.36550704865848,0.6329022988505746,45.48611111111112,1018.0555555555566,35.10536398467436,0
187,4,1,2,29,0.03225806451612903,0.06451612903225806,0.935483870967742,31,850,600,250,0.7058823529411765,11,6,5,388.93784827930017,0.8411290322580646,0.0418538178848511,0.21947207152903353,129885.53590010398,3903.48017111804,133789.01607122202,185,0,110.58064516129032,30,1,22,35.249648382559776,0.6333333333333333,45.16129032258064,1019.3548387096768,33.97849462365589,0
188,4,1,1,29,0.03333333333333333,0.03333333333333333,0.9666666666666667,30,800,500,300,0.625,11,5,6,390.3925099948341,0.8393678160919541,0.040036900369003536,0.22106704222692547,130022.58209041515,4151.968435657309,134174.55052607245,186,0,110.1,30,0,22,35.072922157793016,0.6347222222222222,45.02688172043011,1019.8924731182801,33.99641577060934,0
189,4,0,0,29,0.0,0.0,1.0,29,700,500,200,0.7142857142857143,9,5,4,400.6154238411141,0.8309729064039408,0.04790576653923084,0.22660388612029733,129979.17631172838,4614.332561728391,134593.50887345677,187,6,114.89655172413794,29,0,22,34.85653318805048,0.637212643678161,45.06944444444444,1019.7222222222222,35.162835249042146,0
190,4,1,0,30,0.03333333333333333,0.0,1.0,30,750,600,150,0.8,9,6,3,389.24361927027945,0.8368773946360154,0.03835219794682776,0.22236639242222436,130365.5137154585,4148.788877326865,134514.30259278536,188,0,112.03333333333333,30,0,23,34.753114854786354,0.6381944444444445,44.69086021505377,1021.2365591397854,34.04121863799285,0
191,4,0,0,30,0.0,0.0,1.0,30,650,400,250,0.6153846153846154,9,4,5,389.0145429362881,0.8373563218390805,0.04133333333333322,0.2226288046924541,130434.15423748412,4148.156578795239,134582.31081627935,189,1,113.03333333333333,30,0,23,34.68914473684209,0.6388888888888888,44.623655913978496,1021.5053763440862,34.05017921146954,0
192,4,3,1,32,0.09090909090909091,0.030303030303030304,0.9696969696969697,33,950,600,350,0.631578947368421,13,6,7,350.3197636852421,0.8467487373737375,0.0493039083877127,0.19753284573357002,129856.32216274984,2498.247218617834,132354.56938136768,190,0,103.66666666666667,33,0,21,36.26345136467477,0.6253156565656566,45.189950980392155,1019.2401960784309,30.88606654783124,7
193,4,1,0,33,0.030303030303030304,0.0,1.0,33,600,400,200,0.6666666666666666,8,4,4,350.15815815815813,0.8458806818181819,0.06311766311766309,0.19870938423085652,130106.25608239608,2511.553398933089,132617.80948132917,191,0,104.57575757575758,33,0,22,36.013888888888886,0.6278409090909092,44.944852941176464,1020.2205882352932,30.915775401069492,0
194,4,3,2,34,0.08333333333333333,0.05555555555555555,0.9444444444444444,36,1450,1000,450,0.6896551724137931,19,10,9,325.7365571304694,0.8569113756613758,0.06282979044173076,0.18902979732689454,130972.46334876542,1332.597722163483,132305.0610709289,192,0,96.77777777777777,35,1,19,35.761533242876524,0.6321428571428571,44.09722222222222,1023.6111111111111,29.246031746031747,0
195,4,0,0,34,0.0,0.0,1.0,34,1200,1000,200,0.8333333333333334,14,10,4,345.77752919429884,0.8493761140819965,0.07565290945617376,0.19941350940749297,130732.1421598663,2240.8474204632753,132972.98958032957,193,1,103.47058823529412,33,1,19,35.49168663870583,0.6341540404040404,44.33210784313725,1022.6715686274501,30.990047534165157,0
196,4,0,0,34,0.0,0.0,1.0,34,900,500,400,0.5555555555555556,13,5,8,344.6411129836134,0.8494875222816399,0.0645227192673472,0.19956680259453347,130888.84833958097,2221.935673779317,133110.7840133603,194,2,104.47058823529412,33,1,19,35.362275449101794,0.6357323232323233,44.17892156862745,1023.2843137254906,31.008615567439108,0
197,4,0,0,34,0.0,0.0,1.0,34,1600,1200,400,0.75,20,12,8,344.34141625756445,0.8461452762923352,0.06144744432094762,0.20135544914305964,131265.326136582,2240.017661476343,133505.34379805834,195,3,105.47058823529412,33,1,21,34.98963565335248,0.6395202020202021,43.811274509803916,1024.7549019607836,31.053178847296472,0
198,4,0,0,34,0.0,0.0,1.0,34,750,300,450,0.4,12,3,9,346.34398112780644,0.8454768270944742,0.06815401274064525,0.20319170730120797,131390.93888168002,2301.292171280259,133692.23105296027,196,4,106.47058823529412,33,1,21,34.811538768029315,0.6407828282828283,43.68872549019607,1025.2450980392148,31.0680332739156,0
199,4,0,1,33,0.0,0.029411764705882353,0.9705882352941176,34,500,400,100,0.8,6,4,2,346.98412890231106,0.8453654188948307,0.06421234682471066,0.20373447063337805,131422.35145436844,2320.2940275374817,133742.64548190593,197,5,107.47058823529412,33,1,21,34.763430739811156,0.6410984848484849,43.658088235294116,1025.3676470588232,31.0717468805704,0
200,4,0,0,33,0.0,0.0,1.0,33,1150,700,450,0.6086956521739131,16,7,9,358.1733577446451,0.840356691919192,0.06637699709207667,0.20612151227138545,130649.5530589992,2759.037821395792,133408.590880395,198,6,111.18181818181819,32,1,18,35.25842904779547,0.6357421875,44.412878787878796,1022.3484848484859,31.948390151515184,2
201,4,0,1,32,0.0,0.030303030303030304,0.9696969696969697,33,950,600,350,0.631578947368421,13,6,7,356.8618092411915,0.8388573232323233,0.06493666767639361,0.2063990892420686,130843.25140610679,2738.5918847566923,133581.84329086347,199,7,112.18181818181819,32,1,18,35.09579785264717,0.6376953124999998,44.223484848484865,1023.1060606060628,31.972064393939462,0
202,4,0,0,32,0.0,0.0,1.0,32,1000,700,300,0.7,13,7,6,376.0110320298678,0.834929435483871,0.09147361248761143,0.21195258732856798,129844.02101826343,3364.5568691970175,133208.57788746044,200,8,116.125,32,0,18,35.6213350677238,0.6276041666666667,45.2020202020202,1019.1919191919192,31.849747474747474,3
203,4,2,2,32,0.058823529411764705,0.058823529411764705,0.9411764705882353,34,850,600,250,0.7058823529411765,11,6,5,368.67971678467313,0.8478535353535354,0.06326530612244952,0.21006169909824376,130262.5868055554,2805.034722222203,133067.6215277776,201,0,110.23529411764706,34,0,16,35.38265306122448,0.6271446078431373,44.79166666666666,1020.8333333333321,30.024509803921532,2
204,4,1,2,31,0.030303030303030304,0.06060606060606061,0.9393939393939394,33,900,500,400,0.5555555555555556,13,5,8,377.5657914059259,0.8383049242424243,0.0712772694516628,0.21443470526914965,130137.51471789673,3227.094747212581,133364.6094651093,202,0,114.54545454545455,33,0,16,35.283049083193205,0.6281565656565657,44.914215686274495,1020.3431372549002,30.91948900772425,0
205,4,0,0,31,0.0,0.0,1.0,31,850,600,250,0.7058823529411765,11,6,5,392.0834751897758,0.831899641577061,0.1586655851583787,0.20811823067054835,127453.32717895509,3794.4686889648447,131247.79586791995,203,11,119.74193548387096,31,0,18,37.66078336557059,0.6058467741935484,47.55859375,1009.7656250000001,32.57308467741936,6
206,4,4,4,31,0.11428571428571428,0.11428571428571428,0.8857142857142857,35,800,500,300,0.625,11,5,6,362.5099846595527,0.8614145658263305,0.11799425437451072,0.19632966495918316,128261.7455418379,2299.2326817558032,130560.9782235937,204,0,106.94285714285714,35,0,18,37.5790295551493,0.6047619047619048,46.759259259259245,1012.962962962961,28.941798941798886,0
207,4,1,0,32,0.03125,0.0,1.0,32,900,400,500,0.4444444444444444,14,4,10,388.1035739240705,0.8382896505376345,0.16085132268530034,0.20874241888775194,127984.77993317023,3534.270099989814,131519.05003316005,205,0,117.9375,32,0,20,37.21508193993844,0.6087239583333333,47.03282828282829,1011.868686868688,31.6208964646465,0
208,4,2,1,33,0.058823529411764705,0.029411764705882353,0.9705882352941176,34,1000,700,300,0.7,13,7,6,372.0691657484528,0.8448083778966132,0.1564473929461474,0.20336121625032497,128627.12762188209,2771.6376133786885,131398.76523526077,206,0,111.94117647058823,34,0,18,36.96309118648046,0.6106004901960784,46.398809523809526,1014.4047619047619,29.83543417366947,0
209,4,3,3,33,0.08333333333333333,0.08333333333333333,0.9166666666666666,36,1350,1000,350,0.7407407407407407,17,10,7,362.9065299956021,0.8593584656084656,0.16354652706649953,0.2016989044320908,129289.65627411265,2185.2911578404514,131474.9474319531,207,0,106.63888888888889,35,1,19,36.519503243427785,0.6151785714285715,45.74652777777778,1017.0138888888889,29.057539682539684,0
210,4,0,0,33,0.0,0.0,1.0,33,800,600,200,0.75,10,6,4,389.1460408431808,0.8426452020202021,0.18909207993970178,0.2134375834611404,128765.68657487485,3421.7314254132802,132187.41800028813,208,1,117.27272727272727,33,0,19,36.38815101022298,0.6142676767676769,46.26225490196077,1014.9509803921553,30.7560903149138,0
211,4,0,0,33,0.0,0.0,1.0,33,950,600,350,0.631578947368421,13,6,7,386.5421982198019,0.8419349747474748,0.18753131800808376,0.21250843478772763,128858.98940611772,3361.8874050845707,132220.8768112023,209,2,118.27272727272727,33,0,19,36.35875578354456,0.6152146464646465,46.170343137254896,1015.3186274509794,30.767231134878163,0
212,4,1,1,33,0.029411764705882353,0.029411764705882353,0.9705882352941176,34,700,400,300,0.5714285714285714,10,4,6,378.61924107436954,0.8500816993464053,0.18292346808701265,0.20947974472144473,129110.63102324256,2976.7538265306052,132087.38484977317,210,0,115.76470588235294,34,0,19,36.302760532583655,0.6155024509803921,45.922619047619044,1016.3095238095232,29.891456582633033,0
213,4,1,1,33,0.029411764705882353,0.029411764705882353,0.9705882352941176,34,1400,1100,300,0.7857142857142857,17,11,6,379.95199428657804,0.8454396910279264,0.18560815504799244,0.21103357754953292,129263.69214965386,3022.8314119765423,132286.5235616304,211,0,116.73529411764706,33,1,19,36.11261749819235,0.6193181818181819,45.772058823529406,1016.9117647058813,30.815508021390343,0
214,4,2,1,34,0.05714285714285714,0.02857142857142857,0.9714285714285714,35,1100,700,400,0.6363636363636364,15,7,8,373.22062067882234,0.8547619047619047,0.19230011190726803,0.20904754215232238,129595.04145408135,2673.5083616779716,132268.54981575932,212,0,114.34285714285714,34,1,19,35.94596437897034,0.6204044117647061,45.446428571428555,1018.2142857142834,29.94747899159657,0
215,4,1,1,34,0.02857142857142857,0.02857142857142857,0.9714285714285714,35,1050,800,250,0.7619047619047619,13,8,5,376.9210775778993,0.8523109243697479,0.19549293893766895,0.21193762036213293,129746.60572562362,2780.8460884353813,132527.451814059,213,0,115.31428571428572,34,1,19,35.69734945859626,0.6219362745098038,45.29761904761905,1018.8095238095241,29.964985994397768,0
216,4,0,0,34,0.0,0.0,1.0,34,1100,800,300,0.7272727272727273,14,8,6,388.4243969482541,0.8457739156268569,0.210603240213183,0.21797401505988787,129669.02941476837,3273.322910659365,132942.35232542775,214,2,119.70588235294117,33,1,19,35.483470701479966,0.6234217171717171,45.37377450980392,1018.5049019607844,30.86378490790256,0
217,4,2,2,34,0.05555555555555555,0.05555555555555555,0.9444444444444444,36,850,500,350,0.5882352941176471,12,5,7,371.6984182696885,0.8548280423280424,0.19244096670950883,0.21146042918078117,130203.51750042844,2479.2883016117707,132682.8058020402,215,0,114.0,35,1,20,35.36563468662584,0.6244047619047619,44.849537037037024,1020.6018518518499,29.160052910052855,0
218,4,0,0,34,0.0,0.0,1.0,34,1100,800,300,0.7272727272727273,14,8,6,391.7922522189349,0.8434343434343435,0.21083144796380093,0.22144779473244156,129950.01922337568,3382.6821414840515,133332.70136485973,216,4,121.70588235294117,33,1,20,35.11117788461538,0.6262626262626263,45.09803921568628,1019.6078431372554,30.897207367795616,0
219,4,2,2,34,0.05555555555555555,0.05555555555555555,0.9444444444444444,36,1600,900,700,0.5625,23,9,14,375.92531068498084,0.8481150793650795,0.1950822257883118,0.21706136435203346,130778.6693481532,2633.7287508000877,133412.39809895327,217,0,115.88888888888889,32,4,19,34.673702835040935,0.6370442708333334,44.28661616161616,1022.853535353535,31.96417297979797,0
220,4,0,1,33,0.0,0.029411764705882353,0.9705882352941176,34,1050,700,350,0.6666666666666666,14,7,7,392.00827720040024,0.839795008912656,0.2144806182954897,0.22469605194971065,130495.30241224491,3431.0477362738625,133926.35014851877,218,6,123.70588235294117,31,3,19,34.55049169534005,0.636760752688172,44.56380208333333,1021.7447916666658,32.95950940860212,0
221,4,2,2,33,0.05714285714285714,0.05714285714285714,0.9428571428571428,35,950,600,350,0.631578947368421,13,6,7,373.7478622598025,0.8523109243697479,0.18890257252326248,0.2167737601106854,130951.5570934256,2788.5729046520564,133740.12999807764,219,0,118.2,33,2,19,34.55409881864624,0.6363636363636364,44.11764705882353,1023.5294117647059,31.016042780748663,0
222,4,0,0,33,0.0,0.0,1.0,33,700,500,200,0.7142857142857143,9,5,4,401.0200156166915,0.8390940656565657,0.19679247558181556,0.22185850497059537,129107.96215698298,3754.9754000865128,132862.9375570695,220,8,126.36363636363636,33,0,20,35.73633888018006,0.617739898989899,45.92524509803922,1016.2990196078439,30.79693998811648,4
223,4,1,1,33,0.029411764705882353,0.029411764705882353,0.9705882352941176,34,500,300,200,0.6,7,3,4,392.6044993497399,0.8427658942364825,0.18448424901157745,0.2187518492350027,129388.34372597077,3359.72297313533,132748.0666991061,221,0,123.61764705882354,33,1,20,35.66359511764234,0.6205808080808082,45.64950980392157,1017.4019607843137,30.830362448009506,0
224,4,0,0,33,0.0,0.0,1.0,33,1400,1100,300,0.7857142857142857,17,11,6,395.7454664971551,0.8360164141414143,0.18402860010600985,0.22107444251098887,129490.376061754,3649.045856290185,133139.4219180442,222,10,128.36363636363637,32,1,18,35.479469048505145,0.6240234375,45.54924242424243,1017.803030303031,31.80634469696972,0
225,4,0,0,33,0.0,0.0,1.0,33,750,600,150,0.8,9,6,3,389.00721629820475,0.8360164141414143,0.1477359448199307,0.21623381701666444,129294.84941188479,3459.325890282572,132754.17530216736,223,11,129.36363636363637,33,0,20,35.85057938707475,0.6196338383838385,45.741421568627445,1017.0343137254897,30.819221628045142,4
226,4,2,1,34,0.05714285714285714,0.02857142857142857,0.9714285714285714,35,550,300,250,0.5454545454545454,8,3,5,374.4891604257049,0.8443977591036413,0.15856510387104095,0.21160198936433813,129937.871401856,2732.0648737568426,132669.93627561285,224,0,122.91428571428571,35,0,19,35.56459775986681,0.6217261904761906,45.109953703703695,1019.5601851851841,29.130291005290974,0
227,4,0,0,34,0.0,0.0,1.0,34,950,400,550,0.42105263157894735,15,4,11,382.942429702148,0.8386066547831255,0.16479248862433526,0.21532334516366475,129746.6057256234,3137.0960884353526,132883.70181405876,225,1,127.52941176470588,34,0,19,35.543984186336374,0.621936274509804,45.29761904761904,1018.8095238095224,29.96498599439772,0
228,4,0,0,34,0.0,0.0,1.0,34,700,400,300,0.5714285714285714,10,4,6,384.4153965411829,0.8382352941176471,0.1678807036833425,0.2164865654205606,129807.25623582749,3179.9815759636963,132987.2378117912,226,2,128.52941176470588,34,0,19,35.44465537383177,0.6225490196078433,45.23809523809523,1019.0476190476177,29.97198879551817,0
229,4,1,0,35,0.02857142857142857,0.0,1.0,35,1200,800,400,0.6666666666666666,16,8,8,373.0142522587216,0.8433473389355741,0.16357272491573815,0.21188747731397453,130144.46159122066,2709.1478052126013,132853.60939643325,227,0,125.82857142857142,35,0,20,35.39209013914097,0.6238095238095239,44.9074074074074,1020.3703703703688,29.15343915343911,0
230,4,0,0,35,0.0,0.0,1.0,35,950,600,350,0.631578947368421,13,6,7,372.6984552566533,0.8435574229691876,0.16610180475002512,0.21202935344859114,130203.51750042841,2705.3299682784373,132908.84746870684,228,1,126.82857142857142,35,0,20,35.34011869660544,0.6244047619047619,44.849537037037024,1020.6018518518497,29.160052910052848,0
231,4,1,0,36,0.027777777777777776,0.0,1.0,36,1300,700,600,0.5384615384615384,19,7,12,365.74224603434146,0.8473875661375662,0.18056014490093109,0.21056270461292237,130665.25298524876,2357.9606210940647,133023.21360634282,229,0,124.27777777777777,36,0,17,35.04906010206703,0.627025462962963,44.39752252252252,1022.40990990991,28.400275275275277,0
232,4,0,0,36,0.0,0.0,1.0,36,950,600,350,0.631578947368421,13,6,7,368.35976407679715,0.8462962962962963,0.1855521307304666,0.21286132931766052,130809.21292914526,2436.970162730286,133246.18309187554,230,1,125.27777777777777,36,0,17,34.83620468222517,0.6284722222222223,44.25675675675675,1022.9729729729721,28.415915915915892,0
233,4,1,1,36,0.02702702702702703,0.02702702702702703,0.972972972972973,37,600,500,100,0.8333333333333334,7,5,2,361.7891328871564,0.8475975975975976,0.19478667364785363,0.21113028535694556,131187.67463305997,2092.4550101954205,133280.12964325538,231,0,122.86486486486487,37,0,19,34.62117360590816,0.6303490990990992,43.88706140350876,1024.4517543859633,27.687885253674686,0
234,4,0,0,36,0.0,0.0,1.0,36,1300,1000,300,0.7692307692307693,16,10,6,370.2915952777468,0.8413690476190476,0.2019838214988332,0.21542299909536475,131068.54056336744,2506.7157951870804,133575.25635855453,232,1,127.16666666666667,36,0,19,34.52403863777997,0.6310763888888888,44.00337837837838,1023.9864864864867,28.444069069069073,0
235,4,0,0,36,0.0,0.0,1.0,36,700,500,200,0.7142857142857143,9,5,4,366.53635605593774,0.8405092592592593,0.1990012827560934,0.21355849829139983,131126.20380092924,2412.5041849281633,133538.7079858574,233,2,128.16666666666666,36,0,19,34.56180135605644,0.6316550925925927,43.94707207207207,1024.2117117117111,28.45032532532531,0
236,4,1,2,35,0.02702702702702703,0.05405405405405406,0.9459459459459459,37,750,500,250,0.6666666666666666,10,5,5,362.27292277328036,0.843968968968969,0.19889089440934815,0.21250854954432621,131385.8453047641,2119.6621875253522,133505.50749228947,234,0,125.67567567567568,36,1,19,34.40841022261278,0.6342592592592593,43.69369369369369,1025.2252252252244,28.478478478478458,0
237,4,1,0,36,0.027777777777777776,0.0,1.0,36,1350,1100,250,0.8148148148148148,16,11,5,365.9982980804998,0.8444444444444446,0.20016302984700296,0.2150361353443783,131446.78605109718,2421.8599965706157,133868.6460476678,235,0,127.22222222222223,35,1,20,34.251316779533475,0.636904761904762,43.634259259259245,1025.4629629629612,29.29894179894175,0
238,4,0,1,35,0.0,0.027777777777777776,0.9722222222222222,36,950,700,250,0.7368421052631579,12,7,5,365.7192919168235,0.8440145502645503,0.19980259447264537,0.21570868415453348,131595.18771701382,2425.3797743055457,134020.56749131935,236,1,128.22222222222223,35,1,18,34.108502538071065,0.6383928571428572,43.48958333333333,1026.041666666666,29.315476190476172,0
239,4,0,0,35,0.0,0.0,1.0,35,550,300,250,0.5454545454545454,8,3,5,374.00854035514857,0.8368347338935573,0.2122875383467373,0.21993744540338597,131480.69905045352,2834.980867346935,134315.67991780044,237,2,132.2,34,1,21,34.01165602631068,0.6393995098039216,43.601190476190474,1025.595238095238,30.16456582633053,0
240,4,1,2,34,0.027777777777777776,0.05555555555555555,0.9444444444444444,36,1250,800,450,0.64,17,8,9,362.900823195826,0.8427579365079365,0.1945008078758499,0.215049646130272,131773.38023244598,2364.133632330244,134137.51386477624,238,0,129.5,35,1,18,34.00088772404464,0.6401785714285715,43.31597222222222,1026.736111111111,29.33531746031746,0
241,4,0,0,34,0.0,0.0,1.0,34,900,600,300,0.6666666666666666,12,6,6,381.5732233967881,0.8293597742127155,0.21363505373472158,0.22441224923455516,131485.18786344197,3234.2453923971634,134719.43325583913,239,8,138.02941176470588,33,1,20,33.81315469789302,0.6417297979797979,43.5968137254902,1025.6127450980396,31.07917409387999,0
242,4,1,0,35,0.02857142857142857,0.0,1.0,35,1450,1000,450,0.6896551724137931,19,10,9,369.4316783858397,0.8351540616246498,0.2016806722689073,0.2194335149930352,131862.52170138908,2742.8385416666915,134605.36024305577,240,0,135.05714285714285,35,0,19,33.74323867478027,0.6410714285714285,43.22916666666668,1027.0833333333348,29.345238095238138,0
243,4,1,1,35,0.027777777777777776,0.027777777777777776,0.9722222222222222,36,500,200,300,0.4,8,2,6,360.7338151490036,0.8406084656084657,0.19028751582432557,0.21549595973037347,132079.47812677556,2329.1068095122305,134408.58493628778,241,0,132.27777777777777,36,0,19,33.747808939526735,0.6412037037037036,43.018018018018026,1027.927927927929,28.553553553553584,0
244,4,1,1,35,0.027777777777777776,0.027777777777777776,0.9722222222222222,36,800,700,100,0.875,9,7,2,360.7338151490036,0.8429894179894181,0.19028751582432557,0.21549595973037347,132079.47812677556,2329.1068095122305,134408.58493628778,242,0,133.25,36,0,19,33.747808939526735,0.6412037037037036,43.018018018018026,1027.927927927929,28.553553553553584,0
245,4,2,0,37,0.05405405405405406,0.0,1.0,37,1300,800,500,0.6153846153846154,18,8,10,357.9413998881531,0.8426551551551551,0.20807258218785063,0.2171803953922596,132666.15125868047,2098.108816692532,134764.260075373,243,0,130.59459459459458,35,2,19,33.22906134142232,0.6491071428571429,42.447916666666664,1030.2083333333328,29.434523809523796,0
246,4,1,2,36,0.02631578947368421,0.05263157894736842,0.9473684210526316,38,750,500,250,0.6666666666666666,10,5,5,354.6046186283409,0.844387150308203,0.21465422644046006,0.2172931713213532,133036.2050183629,1835.0505488596675,134871.25556722257,244,0,128.1315789473684,36,2,20,32.94331950660408,0.6507523148148149,42.08896396396396,1031.6441441441439,28.656781781781774,0
247,4,1,1,36,0.02702702702702703,0.02702702702702703,0.972972972972973,37,750,500,250,0.6666666666666666,10,5,5,354.9308664927609,0.8406531531531531,0.2104278713819161,0.2174930881565339,133036.2050183629,2043.731104415223,135079.93612277813,245,0,130.45945945945945,36,1,20,32.93490521413237,0.6507523148148149,42.08896396396396,1031.6441441441439,28.656781781781774,0
248,4,0,0,36,0.0,0.0,1.0,36,1150,1000,150,0.8695652173913043,13,10,3,362.8609325579021,0.8343584656084657,0.21745230078563416,0.22174834767427368,132934.57031250012,2447.3524305555698,135381.92274305568,246,2,135.08333333333334,35,1,21,32.832491582491585,0.6517857142857142,42.18750000000001,1031.250000000001,29.46428571428574,0
249,4,0,0,36,0.0,0.0,1.0,36,1150,800,350,0.6956521739130435,15,8,7,364.95655440214244,0.8327380952380953,0.22294805178622634,0.22428101968324626,133143.52823055978,2518.320660793893,135661.84889135367,247,3,136.08333333333334,35,1,21,32.56852547568316,0.6538690476190476,41.9849537037037,1032.0601851851848,29.48743386243385,0
250,4,0,0,36,0.0,0.0,1.0,36,1000,700,300,0.7,13,7,6,364.39967782698164,0.8323412698412699,0.2202881488956161,0.22429818678667005,133203.26063368047,2507.845052083322,135711.1056857638,248,4,137.08333333333334,35,1,21,32.52291456441306,0.6544642857142857,41.92708333333333,1032.291666666666,29.494047619047603,0
251,4,0,0,36,0.0,0.0,1.0,36,800,500,300,0.625,11,5,6,366.41161156515915,0.8323412698412699,0.22256162114361877,0.22589896245838154,133263.00643272023,2565.8225898062237,135828.82902252645,249,5,138.08333333333334,35,1,22,32.4110011956806,0.6550595238095238,41.869212962962955,1032.5231481481471,29.50066137566135,0
252,4,0,0,36,0.0,0.0,1.0,36,1250,900,350,0.72,16,9,7,369.7767831296598,0.8293650793650794,0.2239981312956778,0.22945191239089194,133502.9779620182,2673.424445813569,136176.40240783177,250,6,139.08333333333334,34,2,22,32.08323733824828,0.6596200980392157,41.636904761904766,1033.4523809523814,30.395658263305336,0
253,4,0,0,36,0.0,0.0,1.0,36,900,700,200,0.7777777777777778,11,7,4,367.5837144461759,0.8272817460317461,0.2252603167293472,0.22904104330555844,133656.80980725627,2626.0133219954696,136282.82312925174,251,7,140.08333333333334,34,2,22,31.98561862000154,0.6611519607843137,41.48809523809524,1034.0476190476193,30.41316526610645,0
254,4,0,0,36,0.0,0.0,1.0,36,1150,1100,50,0.9565217391304348,12,11,1,367.8431850521017,0.8262566137566139,0.229463178220227,0.22977637921766442,133749.15143140592,2639.7427721088466,136388.89420351476,252,8,141.08333333333334,34,2,18,31.886340967506815,0.6620710784313726,41.398809523809526,1034.4047619047622,30.42366946778712,0
255,4,0,0,36,0.0,0.0,1.0,36,1100,900,200,0.8181818181818182,13,9,4,367.6921550493452,0.8247685185185186,0.231202382778545,0.23025794032340843,133841.52494331068,2642.4957482993195,136484.02069161,253,9,142.08333333333334,34,2,18,31.797677941402053,0.6629901960784313,41.30952380952381,1034.7619047619048,30.43417366946779,0
256,4,0,0,36,0.0,0.0,1.0,36,1200,900,300,0.75,15,9,6,364.9829412694912,0.8227513227513228,0.22418650109233051,0.22951964137532663,133995.55165816337,2581.21811224491,136576.76977040828,254,10,143.08333333333334,34,2,18,31.71352190410487,0.6645220588235293,41.16071428571429,1035.3571428571436,30.451680672268928,0
257,4,0,0,36,0.0,0.0,1.0,36,1200,900,300,0.75,15,9,6,375.46756961461324,0.8228835978835979,0.209601990049751,0.22191537724222932,131673.78720023565,2707.7524177563346,134381.53961799198,255,11,144.08333333333334,33,3,17,33.77898009950248,0.6436237373737372,43.41299019607844,1026.3480392156875,31.101455733808713,6
258,4,0,0,36,0.0,0.0,1.0,36,550,300,250,0.5454545454545454,8,3,5,373.2465279333924,0.8220238095238096,0.20616303900892619,0.22096722010586795,131736.68368235786,2634.051957179944,134370.7356395378,256,12,145.08333333333334,33,3,17,33.772407584258474,0.6442550505050504,43.35171568627452,1026.593137254903,31.108882947118275,0
259,4,0,0,36,0.0,0.0,1.0,36,700,200,500,0.2857142857142857,12,2,10,372.4512146050189,0.821660052910053,0.20399326277817575,0.22067866166625538,131768.1375552673,2615.4405757401128,134383.57813100744,257,13,146.08333333333334,33,3,17,33.76104082119838,0.644570707070707,43.321078431372555,1026.7156862745105,31.112596553773045,0
260,4,0,0,36,0.0,0.0,1.0,36,550,300,250,0.5454545454545454,8,3,5,372.4512146050189,0.821660052910053,0.20399326277817575,0.22067866166625538,131768.1375552673,2615.4405757401128,134383.57813100744,258,14,147.08333333333334,33,3,17,33.76104082119838,0.644570707070707,43.321078431372555,1026.7156862745105,31.112596553773045,0
261,4,0,0,36,0.0,0.0,1.0,36,1350,1000,350,0.7407407407407407,17,10,7,373.42242165798746,0.8208333333333334,0.20070739839596285,0.22242987724845334,131969.53125,2656.0763888888882,134625.60763888888,259,15,148.08333333333334,34,2,18,33.532711543660454,0.6443014705882353,43.125,1027.5,30.220588235294116,0
262,4,0,0,36,0.0,0.0,1.0,36,650,400,250,0.6153846153846154,9,4,5,372.47919467002674,0.8190476190476191,0.2027761693366792,0.22258531806060067,132091.88102324257,2640.2954931972763,134732.17651643985,260,16,149.08333333333334,34,2,18,33.433458791739056,0.6455269607843137,43.00595238095238,1027.9761904761901,30.234593837535005,0
263,4,1,2,35,0.02702702702702703,0.05405405405405406,0.9459459459459459,37,1150,900,250,0.782608695652174,14,9,5,367.70193752550034,0.8250125125125125,0.14837460263327795,0.21874814996490208,131921.96609224955,2301.5925068586985,134223.55859910825,261,0,146.02702702702703,35,2,19,33.72765509989483,0.6416666666666667,43.17129629629629,1027.314814814814,29.35185185185183,5
264,4,0,0,35,0.0,0.0,1.0,35,1300,800,500,0.6153846153846154,18,8,10,379.7912879515286,0.8151260504201681,0.16366859395967648,0.2247728398082382,131725.00177154198,3005.6016156462633,134730.60338718825,262,19,154.88571428571427,34,1,19,33.616249178553474,0.6418504901960784,43.36309523809524,1026.5476190476193,30.19257703081233,0
265,4,0,0,35,0.0,0.0,1.0,35,600,400,200,0.6666666666666666,8,4,4,368.59089174461093,0.8156862745098039,0.17079288305406815,0.20027901936451603,128392.81316080359,2494.8729614394833,130887.68612224307,263,20,155.88571428571427,33,2,16,37.29091092301491,0.6104797979797979,46.629901960784316,1013.4803921568631,30.71152703505646,8
266,4,3,0,38,0.07894736842105263,0.0,1.0,38,800,500,300,0.625,11,5,6,343.4248784240683,0.8351706970128023,0.16870732830747515,0.19030671439742575,129172.76810171656,1272.2284362064725,130444.99653792303,264,0,144.5,36,2,19,37.133737675861305,0.6119791666666667,45.861486486486484,1016.5540540540538,28.237612612612608,0
267,4,2,2,38,0.05,0.05,0.95,40,850,600,250,0.7058823529411765,11,6,5,330.06919021121894,0.8471420940170941,0.15804471032745604,0.18455981480824477,129527.44904667967,550.6040433924861,130078.05309007215,265,0,138.225,38,2,13,37.112982787573465,0.611842105263158,45.512820512820504,1017.9487179487168,26.788124156545177,0
268,4,1,1,38,0.02564102564102564,0.02564102564102564,0.9743589743589743,39,1150,800,350,0.6956521739130435,15,8,7,339.2357301276491,0.8375506072874495,0.16309382742647882,0.1895921302092091,129508.13140822161,986.7571031471057,130494.88851136871,266,0,142.74358974358975,37,2,14,36.89932762397214,0.6134572072072073,45.53179824561403,1017.8728070175426,27.51007586533899,0
269,4,1,3,36,0.02564102564102564,0.07692307692307693,0.9230769230769231,39,1000,600,400,0.6,14,6,8,336.9154074773907,0.8393499775078723,0.15485135937478423,0.18856296313608006,129563.9418498959,930.4176525469097,130494.3595024428,267,0,143.71794871794873,37,2,14,36.90170077185424,0.6140202702702704,45.47697368421051,1018.0921052631561,27.516002844950165,0
270,4,1,0,37,0.02702702702702703,0.0,1.0,37,800,400,400,0.5,12,4,8,376.66574849352935,0.8285785785785785,0.19783348616011098,0.19576262302159217,126596.5005170825,2136.9131247856694,128733.41364186817,268,0,152.2972972972973,35,2,16,38.93197718995593,0.587797619047619,48.40856481481482,1006.3657407407409,28.753306878306883,4
271,4,1,0,38,0.02631578947368421,0.0,1.0,38,1000,700,300,0.7,13,7,6,370.2158670928514,0.8381638217164533,0.19480271244655434,0.1940868069486775,126950.11470507659,1799.7893586153634,128749.90406369195,269,0,149.26315789473685,36,2,18,38.73011882146982,0.5894097222222223,48.05743243243243,1007.7702702702693,27.99361861861859,0
272,4,1,1,38,0.02564102564102564,0.02564102564102564,0.9743589743589743,39,850,500,350,0.5882352941176471,12,5,7,366.51985520016706,0.8426675663517769,0.19707956442650354,0.19340970820562645,127215.61418685103,1525.7267382059658,128741.340925057,270,0,146.4102564102564,33,6,18,38.55027129899578,0.5984848484848486,47.79411764705881,1008.8235294117633,30.570409982174645,0
273,4,2,1,39,0.05,0.025,0.975,40,1050,900,150,0.8571428571428571,12,9,3,354.7681101544604,0.8497863247863248,0.13975983458806085,0.18577557173052292,126903.5599409198,1004.2672264226871,127907.82716734249,271,0,143.7,38,2,13,39.1671526525996,0.5852521929824561,48.103632478632484,1007.5854700854708,26.515407107512388,6
274,4,2,0,41,0.04878048780487805,0.0,1.0,41,800,500,300,0.625,11,5,6,348.1017771911061,0.8592479674796748,0.14768089861945644,0.18377394353889914,127233.99233270429,658.4952446049117,127892.4875773092,272,0,141.09756097560975,36,5,15,38.995935186218716,0.5923032407407407,47.7759009009009,1008.8963963963961,28.024899899899893,0
275,4,3,4,40,0.06818181818181818,0.09090909090909091,0.9090909090909091,44,500,300,200,0.6,7,3,4,327.84416625964377,0.8734363988724454,0.14624302356069996,0.17564631159208713,127828.32031249985,-418.4461805555694,127409.87413194428,273,0,132.4090909090909,39,5,13,38.899189671748374,0.5929487179487181,47.18749999999999,1011.2499999999989,25.92948717948715,0
276,4,3,2,41,0.06976744186046512,0.046511627906976744,0.9534883720930233,43,1400,1000,400,0.7142857142857143,18,10,8,339.6251593176542,0.856266149870801,0.15514409794542505,0.18267545944693764,127986.37695312503,93.47873263889001,128079.85568576392,274,0,136.37209302325581,39,4,15,38.43979479788621,0.594551282051282,47.03125,1011.8750000000002,25.945512820512825,0
277,4,2,2,41,0.046511627906976744,0.046511627906976744,0.9534883720930233,43,1400,800,600,0.5714285714285714,20,8,12,350.0028528199397,0.8613418235511259,0.17445750927989767,0.18390532525109765,127042.00227544724,293.01264487276535,127335.01492032001,275,0,137.25581395348837,41,2,16,39.145017385029185,0.5818089430894309,47.96626984126984,1008.134920634921,24.58865660085173,5
278,4,3,3,41,0.06818181818181818,0.06818181818181818,0.9318181818181819,44,1300,1000,300,0.7692307692307693,16,10,6,345.8748176776901,0.8660147991543341,0.18426492908358227,0.18372616461961697,127483.14122498645,18.64164563427869,127501.78287062074,276,0,135.0,42,2,12,38.79673607113159,0.5848214285714286,47.52906976744186,1009.8837209302324,24.044850498338867,0
279,4,1,1,41,0.023809523809523808,0.023809523809523808,0.9761904761904762,42,1000,600,400,0.6,14,6,8,359.4207949462105,0.8526906697638404,0.1909532920005177,0.19016557882849297,127322.68248273172,752.4839505254652,128075.16643325718,277,0,142.4047619047619,40,2,13,38.619390460846496,0.5861979166666667,47.68800813008129,1009.2479674796738,25.231199186991844,0
280,4,3,4,40,0.06818181818181818,0.09090909090909091,0.9090909090909091,44,1400,800,600,0.5714285714285714,20,8,12,343.78309157162295,0.8626673713883016,0.17705665046090546,0.18395039884401573,127776.8810843697,-14.493757887170048,127762.38732648252,278,0,136.86363636363637,42,2,15,38.548854705769585,0.5877976190476191,47.238372093023244,1011.0465116279051,24.072535991140597,0
281,4,1,0,41,0.024390243902439025,0.0,1.0,41,1250,1000,250,0.8,15,10,5,364.2855747328965,0.8474085365853659,0.18977793656624442,0.1933945433439593,127459.90125868046,1086.3606770833242,128546.26193576379,279,0,147.78048780487805,39,2,16,38.35576989202943,0.5892094017094018,47.55208333333333,1009.7916666666658,25.892094017093996,0
282,4,1,0,42,0.023809523809523808,0.0,1.0,42,1100,700,400,0.6363636363636364,15,7,8,358.9226534683464,0.8533681765389083,0.19056233548695833,0.1922110011846098,127810.33631601573,774.8050102452354,128585.14132626097,280,0,145.23809523809524,40,2,18,38.13190954773869,0.5911458333333333,47.205284552845534,1011.178861788619,25.279471544715474,0
283,4,2,2,42,0.045454545454545456,0.045454545454545456,0.9545454545454546,44,1750,1400,350,0.8,21,14,7,348.26891178355913,0.8656404157857647,0.17622107969151646,0.18868608173231843,128276.40109592026,136.2455780676895,128412.64667398794,281,0,139.5909090909091,39,5,19,37.92470008568979,0.5974893162393162,46.74479166666667,1013.0208333333344,25.97489316239319,0
284,4,1,0,43,0.023255813953488372,0.0,1.0,43,900,600,300,0.6666666666666666,12,6,6,355.1224488068167,0.8570967146548542,0.18219057453953136,0.19228531908266322,128252.72715547167,509.0845067207367,128761.81166219241,282,0,143.8139534883721,38,5,21,37.775331364483336,0.5989583333333333,46.7681623931624,1012.9273504273515,26.655982905982935,0
285,4,0,0,43,0.0,0.0,1.0,43,1350,1100,250,0.8148148148148148,16,11,5,353.04780942934735,0.8558508674787744,0.17540940893564438,0.1917812472327262,128381.94580078151,464.9929470486395,128846.93874783015,283,1,144.8139534883721,39,4,15,37.69582776578615,0.5985576923076922,46.640625000000014,1013.437500000002,25.985576923076977,0
286,4,0,1,42,0.0,0.023255813953488372,0.9767441860465116,43,1450,1400,50,0.9655172413793104,15,14,1,353.6430496543744,0.855251015134736,0.17891777475242843,0.19257331131834324,128479.16253552811,487.15257122086746,128966.31510674898,284,2,145.8139534883721,40,3,15,37.58144546912589,0.5979166666666664,46.54471544715449,1013.8211382113847,25.345528455284615,0
287,4,5,2,45,0.10638297872340426,0.0425531914893617,0.9574468085106383,47,1300,900,400,0.6923076923076923,17,9,8,322.999310759718,0.8783919210607462,0.18712362509024505,0.18100968086198974,129614.99851279006,-1018.7919310595489,128596.20658173051,285,0,133.4255319148936,40,7,15,37.204133399866926,0.609375,45.426829268292686,1018.2926829268297,25.457317073170742,0
288,4,0,2,43,0.0,0.044444444444444446,0.9555555555555556,45,1300,900,400,0.6923076923076923,17,9,8,333.48488985911507,0.8692340067340067,0.18952829544678784,0.18567921518609573,129360.29188368065,-372.0594618055502,128988.2324218751,286,1,140.35555555555555,39,6,20,37.1957983480101,0.608440170940171,45.677083333333336,1017.2916666666674,26.084401709401728,0
289,4,0,0,43,0.0,0.0,1.0,43,1250,1000,250,0.8,15,10,5,348.0247245364146,0.8603266888150609,0.19367136866183698,0.19299552906110273,129201.38888888898,393.05555555556066,129594.44444444454,287,2,147.4418604651163,37,6,20,36.98770491803276,0.6103603603603605,45.833333333333336,1016.6666666666674,27.4774774774775,0
290,4,2,2,43,0.044444444444444446,0.044444444444444446,0.9555555555555556,45,1450,900,550,0.6206896551724138,20,9,11,332.52884247068874,0.8655723905723907,0.18792507728677976,0.18639919518311096,129625.34722222229,-379.16666666665657,129246.18055555563,288,0,141.84444444444443,39,6,16,36.951036552100376,0.611111111111111,45.41666666666667,1018.3333333333339,26.111111111111125,0
291,4,1,1,43,0.022727272727272728,0.022727272727272728,0.9772727272727273,44,1200,600,600,0.5,18,6,12,341.90415219074225,0.8645833333333334,0.19822199077518254,0.19165452934728747,129625.34722222218,63.888888888884594,129689.23611111107,289,0,146.04545454545453,39,5,16,36.71235679214402,0.6111111111111112,45.416666666666664,1018.3333333333329,26.1111111111111,0
292,4,0,0,43,0.0,0.0,1.0,43,1500,800,700,0.5333333333333333,22,8,14,344.9872776865669,0.8575581395348837,0.19796585975138314,0.19325218563817698,129598.82948133671,341.9894748263799,129940.81895616309,290,5,150.4418604651163,39,4,16,36.66080562659847,0.6108440170940173,45.44270833333333,1018.2291666666658,26.10844017094015,0
293,4,0,0,43,0.0,0.0,1.0,43,1200,900,300,0.75,15,9,6,343.2842582431057,0.8570505721668512,0.19815234135748638,0.19288572895901862,129718.50419723714,306.0640987507501,130024.56829598789,291,6,151.4418604651163,40,3,16,36.58261838254856,0.6104166666666667,45.32520325203252,1018.6991869918702,25.467479674796756,0
294,4,1,1,43,0.022727272727272728,0.022727272727272728,0.9772727272727273,44,1350,1000,350,0.7407407407407407,17,10,7,340.7336833242124,0.8597383720930233,0.2068970852156693,0.193257830425972,130085.41907793198,64.89679783949447,130150.31587577147,292,0,148.97727272727272,41,3,18,36.275385749943275,0.6125508130081301,44.96527777777777,1020.1388888888879,24.881436314363118,0
295,4,2,2,43,0.044444444444444446,0.044444444444444446,0.9555555555555556,45,1200,900,300,0.75,15,9,6,336.5912744975256,0.8614057239057239,0.20765918876048084,0.19265593960539293,130439.8750964505,-218.89467592593587,130220.98042052456,293,0,146.35555555555555,41,4,19,36.02212213913437,0.6161077235772358,44.61805555555555,1021.5277777777768,24.915311653116508,0
296,4,2,2,43,0.044444444444444446,0.044444444444444446,0.9555555555555556,45,1350,1100,250,0.8148148148148148,16,11,5,333.7665406427222,0.8713804713804715,0.19293478260869557,0.19191576086956527,130617.28395061726,-280.8641975308667,130336.41975308639,294,0,141.62222222222223,41,4,15,35.91485507246378,0.6178861788617886,44.44444444444444,1022.2222222222221,24.93224932249322,0
297,4,0,0,43,0.0,0.0,1.0,43,1100,800,300,0.7272727272727273,14,8,6,347.1459256066326,0.8584348468069398,0.19612411008495267,0.19819869008280844,130342.35161675356,449.5632595486209,130791.91487630218,295,2,149.2093023255814,39,4,21,35.85137627937027,0.6183226495726495,44.71354166666667,1021.145833333334,26.183226495726515,0
298,4,1,1,43,0.022727272727272728,0.022727272727272728,0.9772727272727273,44,1350,1100,250,0.8148148148148148,16,11,5,338.6760500535244,0.8614341085271319,0.1914571116191235,0.19504406065188964,130677.89019639444,51.49433620861649,130729.38453260306,296,0,146.79545454545453,40,4,15,35.728100255110505,0.6200520833333333,44.38516260162602,1022.4593495934967,25.561483739837417,0
299,4,0,0,43,0.0,0.0,1.0,43,1500,1300,200,0.8666666666666667,17,13,4,340.29774677142376,0.8570967146548542,0.18904175809593315,0.19576096640180285,130635.03146701407,290.96137152779886,130925.99283854186,297,4,151.2093023255814,39,4,15,35.72999456558659,0.6212606837606837,44.42708333333334,1022.2916666666681,26.212606837606874,0
300,4,0,0,43,0.0,0.0,1.0,43,950,500,450,0.5263157894736842,14,5,9,341.06381683452366,0.8565430047988187,0.19114445515728495,0.19660736875305473,130714.91021050366,316.42523871529744,131031.33544921895,298,5,152.2093023255814,39,4,16,35.62962632847782,0.6220619658119657,44.34895833333334,1022.6041666666681,26.220619658119695,0
301,4,0,2,41,0.0,0.046511627906976744,0.9534883720930233,43,1050,700,350,0.6666666666666666,14,7,7,343.7433891513638,0.8560815799187892,0.196466631932932,0.19856235773331748,130794.81336805574,391.97048611113047,131186.78385416686,299,6,153.2093023255814,39,4,17,35.48031228784792,0.6228632478632479,44.27083333333334,1022.9166666666681,26.228632478632516,0
302,4,1,1,41,0.023809523809523808,0.023809523809523808,0.9761904761904762,42,1250,600,650,0.48,19,6,13,345.3800283588755,0.8569492837785521,0.18430873621713317,0.2001981580310298,130928.03955078141,643.9860026041821,131572.02555338558,300,0,154.83333333333334,39,3,17,35.30375318066157,0.6241987179487178,44.14062500000001,1023.4375000000013,26.24198717948721,0
303,4,0,0,41,0.0,0.0,1.0,41,1100,700,400,0.6363636363636364,15,7,8,353.6662047574482,0.8528963414634146,0.18350488161386092,0.2048013850765926,130890.45606874143,1058.306167360666,131948.7622361021,301,8,159.609756097561,38,3,18,35.129767870815066,0.625548245614035,44.17735042735043,1023.2905982905992,26.92869995501577,0
304,4,2,1,42,0.046511627906976744,0.023255813953488372,0.9767441860465116,43,1050,600,450,0.5714285714285714,15,6,9,344.6382167919191,0.8619416758951642,0.19572977020435145,0.20229314780134838,131410.26925131484,459.26119968586636,131869.5304510007,302,0,153.13953488372093,38,5,19,34.83575596540584,0.6307565789473685,43.66987179487179,1025.320512820512,26.982118758434527,0
305,4,1,1,42,0.023255813953488372,0.023255813953488372,0.9767441860465116,43,1150,800,350,0.6956521739130435,15,8,7,344.59951435496083,0.8585271317829457,0.19864118978275513,0.2024153083708025,131437.65637555698,458.6705109942261,131896.3268865512,303,0,154.11627906976744,38,5,20,34.80911821907341,0.6310307017543859,43.64316239316239,1025.4273504273501,26.98493027440395,0
306,4,1,1,42,0.023255813953488372,0.023255813953488372,0.9767441860465116,43,1000,600,400,0.6,14,6,8,342.53335969205614,0.8590808416389811,0.2103549025068323,0.2026004637698391,131702.0887586805,422.4717881944405,132124.56054687494,304,0,154.67441860465115,39,4,17,34.59551112915229,0.6319444444444444,43.385416666666664,1026.458333333333,26.319444444444436,0
307,4,0,1,41,0.0,0.023809523809523808,0.9761904761904762,42,1100,700,400,0.6363636363636364,15,7,8,350.6807278982593,0.8556184668989547,0.2124860563694504,0.20702448626077322,131629.44614517127,831.9819974066749,132461.42814257793,305,1,159.33333333333334,38,4,18,34.4596998091272,0.6329495614035088,43.45619658119658,1026.1752136752134,27.004610886189827,0
308,4,0,0,41,0.0,0.0,1.0,41,950,800,150,0.8421052631578947,11,8,3,359.4038371235851,0.8555386178861789,0.21744752291473324,0.21174951512142692,131553.00188519532,1256.130732533076,132809.1326177284,306,2,162.70731707317074,37,4,20,34.313096764999294,0.6340090090090091,43.53070175438596,1025.8771929824552,27.726410621147437,0
309,4,0,0,41,0.0,0.0,1.0,41,1750,1200,550,0.6857142857142857,23,12,11,359.6861074637361,0.8549288617886179,0.2259587483334642,0.20792263832940866,130822.85534972293,1211.0327216066403,132033.88807132957,307,3,163.70731707317074,37,4,19,35.044212218649506,0.6266891891891893,44.243421052631575,1023.0263157894731,27.649359886201974,1
310,4,1,0,42,0.023809523809523808,0.0,1.0,42,1350,700,650,0.5185185185185185,20,7,13,352.5749910648764,0.8572638404955478,0.21936594013974386,0.20577246435307942,131191.2749858461,850.9525211848714,132042.22750703097,308,0,160.78571428571428,38,4,20,34.85352139604409,0.6285635964912282,43.883547008547,1024.4658119658104,26.95962663067922,0
311,4,0,0,42,0.0,0.0,1.0,42,950,800,150,0.8421052631578947,11,8,3,354.3446207233113,0.8568524970963995,0.21701083772700658,0.20785782390882904,131385.84530476425,911.3161830136071,132297.16148777786,309,1,161.78571428571428,36,6,20,34.61161760398359,0.6342592592592593,43.693693693693696,1025.2252252252256,28.47847847847849,0
312,4,0,1,41,0.0,0.023809523809523808,0.9761904761904762,42,950,500,450,0.5263157894736842,14,5,9,362.5594392480218,0.8556184668989547,0.21717535911544505,0.21412859169586673,131645.74361100968,1145.881396599307,132791.625007609,310,2,162.78571428571428,36,6,17,34.138501774022465,0.6368634259259258,43.44031531531532,1026.238738738739,28.506631631631635,0
313,4,1,0,42,0.023809523809523808,0.0,1.0,42,1750,1200,550,0.6857142857142857,23,12,11,381.7925976020516,0.8638695315524584,0.21614735347479663,0.21593578833770039,129975.34855379055,1539.451698319972,131514.80025211052,311,0,160.33333333333334,36,6,18,35.34028161236885,0.6200810185185184,45.07319819819821,1019.7072072072094,28.32520020020026,6
314,4,0,0,42,0.0,0.0,1.0,42,1450,1300,150,0.896551724137931,16,13,3,378.9204623074103,0.8629258614014712,0.21769721245380813,0.21494304746667714,130090.20580969502,1458.7681854151701,131548.9739951102,312,1,161.33333333333334,36,6,18,35.29662030393349,0.6212384259259258,44.9605855855856,1020.1576576576591,28.337712712712754,0
315,4,0,0,42,0.0,0.0,1.0,42,1150,800,350,0.6956521739130435,15,8,7,381.40100102840483,0.8632162214479288,0.22332970141542452,0.2171536341635121,130234.60493853888,1534.3217384195214,131768.9266769584,313,2,162.33333333333334,37,5,18,35.086453074086,0.620777027027027,44.819078947368425,1020.7236842105272,27.587126600284517,0
316,4,1,2,41,0.023255813953488372,0.046511627906976744,0.9534883720930233,43,1250,900,350,0.72,16,9,7,368.78897434021303,0.8636489479512734,0.20933476046835953,0.21179803018022947,130570.58572108719,1030.60148314865,131601.18720423584,314,0,159.53488372093022,37,6,16,35.06720934806707,0.6241554054054055,44.49013157894736,1022.0394736842101,27.622688477951623,0
317,4,1,1,41,0.023809523809523808,0.023809523809523808,0.9761904761904762,42,1200,700,500,0.5833333333333334,17,7,10,365.456627016467,0.8636517615176151,0.20492322143265507,0.21095169658475285,130766.7743921207,1157.9168590335519,131924.69125115426,315,0,160.95238095238096,37,5,16,34.95345554602629,0.6261261261261261,44.29824561403509,1022.8070175438601,27.643432906590814,0
318,4,0,0,41,0.0,0.0,1.0,41,1200,700,500,0.5833333333333334,17,7,10,373.58174543314055,0.8577743902439025,0.21296480306798204,0.21555714180583133,130751.61944038642,1569.2836417498702,132320.9030821363,316,5,165.8780487804878,36,5,17,34.76106584452764,0.6278935185185185,44.31306306306307,1022.7477477477485,28.40965965965968,0
319,4,0,0,41,0.0,0.0,1.0,41,1450,1000,450,0.6896551724137931,19,10,9,366.4326225417892,0.8557418699186992,0.20752504367380564,0.21254027481061394,130953.25213304511,1397.1087218975658,132350.36085494267,317,6,166.8780487804878,36,5,18,34.73956614222319,0.6299189814814815,44.11599099099099,1023.5360360360353,28.431556556556536,0
320,4,0,1,40,0.0,0.024390243902439025,0.975609756097561,41,1050,900,150,0.8571428571428571,12,9,3,366.69154474890206,0.854979674796748,0.21118002425074844,0.21316876757397807,131039.7137001866,1410.2310080350537,132449.94470822165,318,7,167.8780487804878,36,5,18,34.64538422056019,0.6307870370370371,44.03153153153153,1023.8738738738733,28.440940940940926,0
321,4,1,2,39,0.024390243902439025,0.04878048780487805,0.9512195121951219,41,850,600,250,0.7058823529411765,11,6,5,353.26476158552964,0.8561991869918699,0.13659625988199808,0.20850875772193211,131621.90890841995,1099.476453993036,132721.38536241298,319,0,168.21951219512195,39,2,15,34.40101258755457,0.6311431623931625,43.46354166666666,1026.1458333333317,26.311431623931583,6
322,4,0,1,38,0.0,0.02564102564102564,0.9743589743589743,39,800,500,300,0.625,11,5,6,366.16459126230075,0.8515519568151148,0.1439209493101714,0.21509869707820525,131440.5393967371,1825.774276700488,133266.31367343757,320,9,174.94871794871796,37,2,17,34.25336826347305,0.632882882882883,43.640350877192965,1025.4385964912253,27.71455666192501,0
323,4,1,1,38,0.02564102564102564,0.02564102564102564,0.9743589743589743,39,1150,1000,150,0.8695652173913043,13,10,3,362.64857055487755,0.8452541610436347,0.17098643350334863,0.2143978349120431,131684.2689043206,1751.0223765431676,133435.29128086378,321,0,175.69230769230768,38,1,17,34.09731619305366,0.6334978070175441,43.40277777777776,1026.388888888886,27.010233918128577,0
324,4,1,0,39,0.02564102564102564,0.0,1.0,39,1050,700,350,0.6666666666666666,14,7,7,355.4937735663293,0.8486842105263158,0.16217988707071762,0.21184257212893096,131985.9981097957,1584.040105193905,133570.03821498962,322,0,170.92307692307693,38,1,19,33.976658348929085,0.6365131578947371,43.108974358974336,1027.564102564099,27.041160593792075,0
325,4,0,0,39,0.0,0.0,1.0,39,1100,800,300,0.7272727272727273,14,8,6,355.69758948137365,0.8485717498875394,0.16230076230076262,0.21227114210985165,132040.89506172802,1593.3256172839108,133634.22067901192,323,1,171.92307692307693,38,1,19,33.91610360360359,0.637061403508772,43.055555555555536,1027.7777777777749,27.046783625730917,0
326,4,0,0,39,0.0,0.0,1.0,39,900,700,200,0.7777777777777778,11,7,4,356.9236512909987,0.8483468286099866,0.16591126494483088,0.2134665193519744,132123.2618913904,1631.5834109503453,133754.84530234075,324,2,172.92307692307693,38,1,19,33.80161245626796,0.6378837719298249,42.975427350427324,1028.0982905982867,27.055218173639123,0
327,4,0,0,39,0.0,0.0,1.0,39,1100,900,200,0.8181818181818182,13,9,4,355.2009050791105,0.8475033738191633,0.15920922640208168,0.21336428665045215,132288.07259706667,1597.7686235298063,133885.84122059649,325,3,173.92307692307693,38,1,19,33.67994253470419,0.63952850877193,42.81517094017092,1028.7393162393137,27.072087269455622,0
328,4,0,0,39,0.0,0.0,1.0,39,700,500,200,0.7142857142857143,9,5,4,361.25040823947535,0.8459851551956815,0.15978936558399726,0.21795750851877865,132454.43309479847,1769.8892628217864,134224.32235762026,326,4,174.92307692307693,37,2,20,33.35685627041613,0.6430180180180181,42.65350877192983,1029.3859649122812,27.82124229492652,0
329,4,0,0,39,0.0,0.0,1.0,39,700,300,400,0.42857142857142855,11,3,8,353.2861244153962,0.8459851551956815,0.17566147750695826,0.20648185370311187,131246.00643080217,1473.4785913872583,132719.48502218942,327,5,175.92307692307693,38,1,20,34.78000208528831,0.629111842105263,43.83012820512821,1024.6794871794878,26.9652496626181,3
330,4,1,0,40,0.025,0.0,1.0,40,1000,600,400,0.6,14,6,8,347.4195565476998,0.849599358974359,0.1729578392621871,0.20441197164318173,131501.32395909436,1137.303377411889,132638.62733650624,328,0,172.5,36,4,21,34.672586370955926,0.6354166666666665,43.58108108108109,1025.6756756756768,28.490990990991023,0
331,4,1,1,40,0.024390243902439025,0.024390243902439025,0.975609756097561,41,1000,600,400,0.6,14,6,8,335.3798301698056,0.8498983739837398,0.17303755564856682,0.19942344261488448,131903.6740836621,647.5663625903976,132551.2404462525,329,0,169.26829268292684,38,3,18,34.57618304732188,0.6356907894736842,43.18910256410256,1027.2435897435898,27.032726045883944,0
332,4,1,1,40,0.024390243902439025,0.024390243902439025,0.975609756097561,41,950,700,250,0.7368421052631579,12,7,5,340.882269709586,0.8478658536585366,0.1736510220073315,0.20347763794461496,132049.81689453125,802.6882595486107,132852.50515407987,330,0,170.21951219512195,39,2,19,34.287798554102906,0.6354166666666666,43.046875,1027.8125,26.354166666666668,0
333,4,0,0,40,0.0,0.0,1.0,40,1300,900,400,0.6923076923076923,17,9,8,343.53542731921124,0.8436965811965812,0.1725000000000001,0.20501307759372273,132040.89506172828,1072.1450617283836,133113.04012345665,331,2,175.475,38,2,19,34.228603603603595,0.637061403508772,43.05555555555555,1027.777777777777,27.04678362573097,0
334,4,0,0,40,0.0,0.0,1.0,40,1150,700,450,0.6086956521739131,16,7,9,333.7985882945368,0.8437767094017093,0.12592136275980303,0.19352024988454675,130935.05333371794,765.782099620382,131700.83543333833,332,3,176.475,37,3,19,35.59299335761733,0.6278153153153154,44.133771929824555,1023.4649122807007,27.661213845424342,4
335,4,0,0,40,0.0,0.0,1.0,40,1100,800,300,0.7272727272727273,14,8,6,332.3209123339688,0.8439369658119658,0.12132683658170951,0.19322619423254023,131047.29940943349,709.9516197291273,131757.2510291626,333,4,177.475,37,3,19,35.51750910259156,0.6289414414414415,44.024122807017534,1023.9035087719284,27.673067804646713,0
336,4,0,0,40,0.0,0.0,1.0,40,1000,700,300,0.7,13,7,6,331.76468293009265,0.8439102564102564,0.12120200333889897,0.19293887871371376,131054.49631090638,695.8506830301553,131750.34699393655,334,5,178.475,38,2,19,35.5244852531998,0.6271929824561404,44.01709401709401,1023.9316239316224,26.94556905083217,0
337,4,0,0,40,0.0,0.0,1.0,40,1050,600,450,0.5714285714285714,15,6,9,335.3715265457006,0.8427083333333333,0.13103295442694773,0.1957320491811758,131191.2749858461,799.5636322959825,131990.8386181421,335,6,179.475,38,2,20,35.294130427225646,0.6285635964912282,43.883547008547,1024.4658119658104,26.95962663067922,0
338,4,1,2,39,0.024390243902439025,0.04878048780487805,0.9512195121951219,41,1100,800,300,0.7272727272727273,14,8,6,327.28615131089776,0.8472052845528455,0.13059545615218981,0.19256603786431892,131501.3239590942,407.92645981380326,131909.25041890802,336,0,176.0731707317073,36,5,21,35.188844971453655,0.6354166666666666,43.58108108108108,1025.6756756756756,28.49099099099099,0
339,4,0,0,39,0.0,0.0,1.0,39,1050,700,350,0.6666666666666666,14,7,7,333.65667899672223,0.8446356275303644,0.12973829065783105,0.1958953630674007,131419.65880102038,969.8093820861661,132389.46818310654,337,1,179.05128205128204,34,5,21,35.107782808932235,0.6387867647058822,43.660714285714285,1025.3571428571427,30.157563025210077,0
340,4,0,1,38,0.0,0.02564102564102564,0.9743589743589743,39,1350,1000,350,0.7407407407407407,17,10,7,334.10520661413386,0.8450854700854701,0.12685121539711375,0.19678636810621933,131541.7534722221,989.7569444444398,132531.51041666654,338,2,180.05128205128204,34,5,21,34.973260222041716,0.6400122549019608,43.541666666666664,1025.8333333333326,30.17156862745096,0
341,4,0,0,38,0.0,0.0,1.0,38,850,400,450,0.47058823529411764,13,4,9,336.01203913688045,0.8393492176386913,0.14752957550452384,0.19870341573650094,131694.45153061222,1250.1842403628175,132944.63577097503,339,3,184.8421052631579,34,4,18,34.77054821000543,0.6415441176470588,43.392857142857146,1026.4285714285713,30.1890756302521,0
342,4,0,1,37,0.0,0.02631578947368421,0.9736842105263158,38,800,400,400,0.5,12,4,8,334.7917094152774,0.8386379800853485,0.1455757989920312,0.1986185203174818,131816.6737528346,1226.2259070294967,133042.8996598641,340,4,185.8421052631579,34,4,18,34.678829507689926,0.6427696078431371,43.27380952380953,1026.904761904763,30.20308123249303,0
343,4,2,0,39,0.05128205128205128,0.0,1.0,39,850,400,450,0.47058823529411764,13,4,9,324.1828810812304,0.8369320737741791,0.14889207178363817,0.1939573856010245,132137.36329234645,767.3342261180161,132904.69751846447,341,0,181.92307692307693,36,3,20,34.62897042716321,0.6417824074074073,42.961711711711715,1028.1531531531534,28.559809809809817,0
344,4,0,0,39,0.0,0.0,1.0,39,1450,1200,250,0.8275862068965517,17,12,5,324.9079982734258,0.8363697705802969,0.15358789083334723,0.19498749383899294,132253.17166829004,794.022654411184,133047.19432270122,342,1,182.92307692307693,36,3,21,34.49406065250711,0.6429398148148149,42.84909909909911,1028.6036036036048,28.572322322322357,0
345,4,1,1,39,0.025,0.025,0.975,40,900,700,200,0.7777777777777778,11,7,4,318.0550377976189,0.8411858974358974,0.152286151826734,0.1920514633781925,132484.94059938332,427.5798179936885,132912.520417377,343,0,179.325,36,4,21,34.43789652154891,0.6452546296296295,42.62387387387388,1029.5045045045058,28.597347347347384,0
346,4,0,0,39,0.0,0.0,1.0,39,750,400,350,0.5333333333333333,11,4,7,323.77544375497007,0.8365384615384616,0.15930479468385594,0.19535520339037535,132455.9583865963,777.1973409220266,133233.15572751831,344,3,184.92307692307693,36,3,21,34.319731612150385,0.6449652777777777,42.65202702702704,1029.3918918918937,28.59421921921927,0
347,4,0,0,39,0.0,0.0,1.0,39,1150,600,550,0.5217391304347826,17,6,11,320.9656848837827,0.8369883040935673,0.1512613052083851,0.1944074274137141,132600.9011545332,712.0678110543247,133312.96896558753,345,4,185.92307692307693,36,3,21,34.246756323347185,0.6464120370370369,42.511261261261275,1029.9549549549572,28.609859859859924,0
348,4,0,0,39,0.0,0.0,1.0,39,1350,1100,250,0.8148148148148148,16,11,5,319.5697877310724,0.8367071524966262,0.15006906909431206,0.1943111712642558,132745.9231824733,684.3172987176681,133430.240481191,346,5,186.92307692307693,36,3,19,34.13743488871891,0.6478587962962962,42.37049549549551,1030.5180180180205,28.625500500500568,0
349,4,0,1,38,0.0,0.02564102564102564,0.9743589743589743,39,850,600,250,0.7058823529411765,11,6,5,318.55324929210803,0.8363697705802969,0.14957218277808093,0.19429413705991036,132861.99787202768,664.7242259151301,133526.7220979428,347,6,187.92307692307693,36,3,19,34.0474239941744,0.6490162037037035,42.257882882882896,1030.9684684684705,28.63801301301307,0
350,4,0,0,38,0.0,0.0,1.0,38,1050,900,150,0.8571428571428571,12,9,3,326.66610075271245,0.8362671882408724,0.1509819677167772,0.19931107024008005,132874.8981910154,1081.1449759945485,133956.04316700995,348,7,184.8684210526316,35,3,20,33.8254003891633,0.651190476190476,42.24537037037039,1031.018518518521,29.457671957672027,0
351,4,0,0,38,0.0,0.0,1.0,38,1000,600,400,0.6,14,6,8,329.7431096810285,0.8350817923186344,0.15260677779942933,0.20199315028089415,133024.10361207582,1172.7563175154564,134196.85992959127,349,8,185.8684210526316,35,3,20,33.59664254459778,0.6526785714285713,42.10069444444446,1031.5972222222238,29.474206349206394,0
352,4,0,0,38,0.0,0.0,1.0,38,1250,1100,150,0.88,14,11,3,344.95218308452786,0.8346372688477952,0.18078082300652332,0.20188262027020376,131297.6208191608,1466.9908834482585,132764.61170260905,350,9,186.8684210526316,34,4,21,34.9413888566229,0.637561274509804,43.77976190476189,1024.8809523809507,30.14355742296914,4
353,4,0,0,38,0.0,0.0,1.0,38,1000,700,300,0.7,13,7,6,346.30136844582734,0.8306958274063537,0.17505375555881297,0.20380687093778993,131511.2244897958,1508.503401360526,133019.72789115633,351,10,187.8684210526316,34,4,22,34.691272051996265,0.6397058823529412,43.57142857142856,1025.7142857142846,30.168067226890724,0
354,4,2,2,38,0.05,0.05,0.95,40,1200,1000,200,0.8333333333333334,14,10,4,329.22795283927474,0.8392361111111111,0.15918803418803407,0.19637479069354363,132021.60564280482,693.0405912669239,132714.64623407176,352,0,179.425,36,4,18,34.6156129008693,0.6406250000000002,43.074324324324316,1027.7027027027016,28.547297297297266,0
355,4,0,0,38,0.0,0.0,1.0,38,1100,700,400,0.6363636363636364,15,7,8,343.49173553719004,0.8282064959696539,0.17254784688995195,0.20345279720279705,131755.55555555536,1451.3888888888644,133206.94444444423,353,12,189.8684210526316,34,4,19,34.517045454545446,0.6421568627450982,43.33333333333332,1026.6666666666652,30.196078431372506,0
356,4,0,0,38,0.0,0.0,1.0,38,800,400,400,0.5,12,4,8,347.34910956661764,0.8261320531057373,0.17493336423687578,0.20656619341490967,131908.37762188187,1563.651502267546,133472.0291241494,354,13,190.8684210526316,34,4,20,34.264061111754934,0.6436887254901962,43.184523809523796,1027.261904761903,30.213585434173616,0
357,4,0,0,38,0.0,0.0,1.0,38,1050,700,350,0.6666666666666666,14,7,7,346.46364499471787,0.8265469416785206,0.17515308148736564,0.20659843545386808,132011.1577958888,1547.413381987282,133558.5711778761,355,14,191.8684210526316,35,3,22,34.18330236137704,0.6425595238095239,43.084490740740726,1027.662037037035,29.361772486772427,0
358,4,0,0,38,0.0,0.0,1.0,38,750,300,450,0.4,12,3,9,346.3014518408359,0.8260431484115695,0.17676959169648554,0.20731415755754612,132159.87761488333,1553.4314986282475,133713.30911351158,356,15,192.8684210526316,35,3,22,34.03778328080445,0.644047619047619,42.93981481481481,1028.24074074074,29.378306878306855,0
359,4,0,0,38,0.0,0.0,1.0,38,1050,800,250,0.7619047619047619,13,8,5,346.67016341851195,0.8241465149359887,0.1801619433198376,0.20884763503505485,132398.0034722223,1579.9018347050805,133977.9053069274,357,16,193.8684210526316,34,4,22,33.78879892037786,0.6485906862745099,42.708333333333336,1029.1666666666672,30.26960784313727,0
360,4,0,1,37,0.0,0.02631578947368421,0.9736842105263158,38,1200,800,400,0.6666666666666666,16,8,8,334.1880911340545,0.8239094357515411,0.09188693032954909,0.1961943206995749,131417.1157648532,1183.6070119598594,132600.72277681305,358,17,194.8684210526316,35,3,22,35.09672367084322,0.6366071428571429,43.663194444444436,1025.3472222222208,29.295634920634882,5
361,4,0,0,37,0.0,0.0,1.0,37,850,700,150,0.8235294117647058,10,7,3,341.2526802190384,0.8181931931931932,0.11162259438121525,0.20035510120835534,131419.65880102027,1569.4621598639294,132989.1209608842,359,18,200.67567567567568,34,3,23,34.91306745617089,0.6387867647058825,43.66071428571428,1025.3571428571418,30.157563025210052,0
362,4,0,0,37,0.0,0.0,1.0,37,1150,800,350,0.6956521739130435,15,8,7,339.6634801205908,0.8175675675675675,0.11436411030319693,0.20034043587950992,131595.18771701367,1539.6158854166429,133134.80360243033,360,19,201.67567567567568,35,2,19,34.776861252115054,0.6383928571428572,43.48958333333332,1026.041666666665,29.31547619047614,0
363,4,0,0,37,0.0,0.0,1.0,37,750,500,250,0.6666666666666666,10,5,5,340.78528384735256,0.8174424424424425,0.11381340745346158,0.20147225981055467,131684.2689043209,1575.2121913580127,133259.4810956789,361,20,202.67567567567568,35,2,19,34.65832205683356,0.6392857142857145,43.40277777777777,1026.3888888888882,29.32539682539681,0
364,4,1,0,38,0.02631578947368421,0.0,1.0,38,700,500,200,0.7142857142857143,9,5,4,330.21421817591676,0.8223980559506875,0.11479635973563052,0.1969630689590468,132021.60564280496,1119.0822579336073,133140.68790073856,362,0,198.31578947368422,36,2,20,34.590273212068084,0.640625,43.07432432432432,1027.7027027027027,28.5472972972973,0
365,4,0,0,38,0.0,0.0,1.0,38,1100,700,400,0.6363636363636364,15,7,8,331.7376245997633,0.8220424371740161,0.11072807978324795,0.1984773599341964,132137.36329234633,1166.98700389578,133304.3502962421,363,1,199.31578947368422,36,2,20,34.43478459291712,0.6417824074074074,42.96171171171171,1028.1531531531525,28.559809809809792,0
366,4,0,0,38,0.0,0.0,1.0,38,1500,1100,400,0.7333333333333333,19,11,8,329.41371730794765,0.8219535324798483,0.0994123239132314,0.19784314974412232,132282.13168827596,1115.1097465708765,133397.24143484683,364,2,200.31578947368422,36,2,21,34.349115124977196,0.6432291666666667,42.82094594594594,1028.716216216215,28.575450450450415,0
367,4,0,0,38,0.0,0.0,1.0,38,650,600,50,0.9230769230769231,7,6,1,329.5368763612442,0.8211237553342816,0.09748967471760328,0.19822109541228994,132340.06123944873,1122.1860796607284,133462.24731910945,365,3,201.31578947368422,36,2,22,34.28778592535844,0.6438078703703705,42.76463963963963,1028.94144144144,28.58170670670667,0
368,4,0,0,38,0.0,0.0,1.0,38,1350,1200,150,0.8888888888888888,15,12,3,328.23688780570217,0.8220720720720721,0.09939876676174286,0.1980555549622737,132457.5684263545,1095.5046869160037,133553.0731132705,366,4,202.31578947368422,35,3,23,34.20330185143541,0.6470238095238096,42.650462962962955,1029.3981481481474,29.41137566137564,0
369,4,0,0,38,0.0,0.0,1.0,38,1100,700,400,0.6363636363636364,15,7,8,329.9384482894244,0.8195531057373163,0.10875891684707395,0.19971376278090464,132576.73852237655,1148.4326774691347,133725.17119984567,367,5,203.31578947368422,35,3,23,34.03995279838165,0.6482142857142856,42.53472222222222,1029.861111111111,29.424603174603174,0
370,4,0,0,38,0.0,0.0,1.0,38,1150,900,250,0.782608695652174,14,9,5,329.5617779951906,0.8172119487908962,0.10650756397902517,0.2002790791461558,132725.77649444877,1148.2685774605654,133874.04507190935,368,6,204.31578947368422,35,3,18,33.90020685911115,0.649702380952381,42.3900462962963,1030.4398148148152,29.441137566137577,0
371,4,0,1,37,0.0,0.02631578947368421,0.9736842105263158,38,1400,800,600,0.5714285714285714,20,8,12,332.2174608544424,0.8160561877667141,0.11149569357082845,0.20247128073645618,132832.9744440389,1225.8866975083517,134058.86114154727,369,7,205.31578947368422,36,2,18,33.72432816255188,0.6487268518518517,42.28603603603605,1030.8558558558582,28.63488488488495,0
372,4,0,0,37,0.0,0.0,1.0,37,1100,1000,100,0.9090909090909091,12,10,2,330.7814835162135,0.8133133133133134,0.1132232428892539,0.2028527410960878,133065.2506391529,1403.1042021751696,134468.35484132805,370,8,206.13513513513513,36,1,20,33.52866004511386,0.6510416666666665,42.06081081081082,1031.7567567567585,28.659909909909956,0
373,4,0,0,37,0.0,0.0,1.0,37,1250,1100,150,0.88,14,11,3,325.77443158264634,0.8133133133133134,0.10954703339604066,0.20040593556285505,133181.46482631305,1277.4232002272847,134458.88802654034,371,9,207.13513513513513,36,1,21,33.54153029311223,0.652199074074074,41.94819819819821,1032.2072072072092,28.67242242242248,0
374,4,0,0,37,0.0,0.0,1.0,37,1000,700,300,0.7,13,7,6,324.5386727618033,0.8125,0.11743346399834964,0.20027049994789642,133297.7297398752,1252.0536583881435,134549.78339826336,372,10,208.13513513513513,36,1,21,33.45715194474736,0.6533564814814814,41.8355855855856,1032.6576576576592,28.68493493493498,0
375,4,0,0,37,0.0,0.0,1.0,37,1550,1100,450,0.7096774193548387,20,11,9,325.6396587694615,0.8102477477477478,0.11627365785403887,0.20173827611139847,133443.13221583085,1290.8752079782637,134734.00742380912,373,11,209.13513513513513,36,1,21,33.28337874659402,0.6548032407407407,41.69481981981983,1033.2207207207218,28.700575575575606,0
376,4,0,0,37,0.0,0.0,1.0,37,950,700,250,0.7368421052631579,12,7,5,325.05633765388166,0.8094344344344344,0.11499810083533801,0.20201029948036447,133559.5112637978,1282.873118050507,134842.3843818483,374,12,210.13513513513513,36,1,21,33.18217307622473,0.6559606481481481,41.58220720720722,1033.6711711711728,28.71308808808813,0
377,4,0,0,37,0.0,0.0,1.0,37,1050,700,350,0.6666666666666666,14,7,7,325.21095286538815,0.8096846846846847,0.106118965999205,0.20306339918889113,133734.17494775177,1298.3636930849714,135032.53864083675,375,13,211.13513513513513,36,1,20,33.00376519687897,0.6576967592592593,41.413288288288285,1034.3468468468466,28.73185685685685,0
378,4,0,0,37,0.0,0.0,1.0,37,1000,700,300,0.7,13,7,6,326.7041874839138,0.8091216216216216,0.10178307184946989,0.20431799662455516,133792.4215389376,1342.1088740767793,135134.53041301438,376,14,212.13513513513513,36,1,20,32.907006276985584,0.658275462962963,41.35698198198198,1034.5720720720722,28.738113113113116,0
379,4,0,0,37,0.0,0.0,1.0,37,550,300,250,0.5454545454545454,8,3,5,326.035490935189,0.8081206206206206,0.12154470582666721,0.1959644898147294,132311.09487866238,1227.6225549874102,133538.71743364978,377,15,213.13513513513513,36,1,19,34.406924985405716,0.6435185185185186,42.79279279279279,1028.8288288288284,28.578578578578565,8
380,4,0,0,37,0.0,0.0,1.0,37,1450,1100,350,0.7586206896551724,18,11,7,329.67363066566986,0.8076201201201201,0.12847373136181806,0.19891397081946482,132455.95838659626,1333.4473409220268,133789.4057275183,378,16,214.13513513513513,36,1,19,34.16794296758197,0.6449652777777777,42.65202702702704,1029.3918918918935,28.594219219219262,0
381,4,1,1,37,0.02631578947368421,0.02631578947368421,0.9736842105263158,38,1100,800,300,0.7272727272727273,14,8,6,323.2014486192849,0.8117591275486012,0.12676371780515105,0.19676772130966805,132793.26331178815,983.7950138504056,133777.05832563856,379,0,209.47368421052633,37,1,15,33.996453900709234,0.6463963963963963,42.32456140350877,1030.7017543859643,27.856804172593627,0
382,4,1,1,37,0.02631578947368421,0.02631578947368421,0.9736842105263158,38,1250,1000,250,0.8,15,10,5,326.53623620461633,0.8094179706021811,0.14360246848651337,0.19985207377858352,132991.11415291257,1085.2835728301204,134076.3977257427,380,0,210.44736842105263,37,1,18,33.71237287835301,0.648367117117117,42.1326754385965,1031.4692982456152,27.877548601232842,0
383,4,0,0,37,0.0,0.0,1.0,37,600,300,300,0.5,9,3,6,332.41809843443116,0.809496996996997,0.14333766080490995,0.2035394239077133,133007.1625679735,1442.7976118010065,134449.9601797745,381,1,211.0,36,1,19,33.544623362445414,0.6504629629629629,42.117117117117125,1031.5315315315324,28.653653653653677,0
384,4,0,0,37,0.0,0.0,1.0,37,1100,700,400,0.6363636363636364,15,7,8,335.4960221224919,0.8087462462462462,0.12151672827304183,0.20336528259472703,132629.8992193205,1499.360720517796,134129.2599398383,382,2,212.0,36,1,12,33.84351882220035,0.6467013888888891,42.4831081081081,1030.0675675675664,28.612987987987953,1
385,4,0,0,37,0.0,0.0,1.0,37,1200,900,300,0.75,15,9,6,340.9038377487896,0.8084334334334334,0.12210002835002842,0.2074436119067102,132774.9370992613,1652.6971227984586,134427.63422205974,383,3,213.0,36,1,12,33.55869391025641,0.6481481481481483,42.342342342342334,1030.6306306306296,28.6286286286286,0
386,4,0,0,37,0.0,0.0,1.0,37,1150,800,350,0.6956521739130435,15,8,7,344.1401756196729,0.8080580580580581,0.121052041340314,0.21038956797896938,132949.08717839446,1750.6244420095613,134699.71162040404,384,4,214.0,36,1,13,33.30057508917522,0.6498842592592593,42.173423423423415,1031.306306306305,28.647397397397363,0
387,4,0,0,37,0.0,0.0,1.0,37,950,500,450,0.5263157894736842,14,5,9,344.46181516468755,0.8061186186186187,0.11639643572416669,0.21140680591788563,133094.29943034257,1769.1807939696478,134863.48022431222,385,5,215.0,36,1,14,33.146667758012285,0.6513310185185186,42.03265765765766,1031.8693693693697,28.663038038038046,0
388,4,1,0,38,0.02631578947368421,0.0,1.0,38,1000,700,300,0.7,13,7,6,339.45804709396833,0.8138632053105738,0.11626276116025269,0.2096626456116779,133330.6296769198,1452.0310335872573,134782.66071050707,386,0,210.31578947368422,37,1,15,33.0390478465513,0.6517454954954955,41.80372807017544,1032.7850877192982,27.913110478899952,0
389,4,0,0,38,0.0,0.0,1.0,38,950,700,250,0.7368421052631579,12,7,5,338.91583866999156,0.8116702228544334,0.11459363148399482,0.2099673864422963,133443.8977016965,1445.2501009925923,134889.14780268908,387,1,211.31578947368422,37,1,15,32.93968216067069,0.6528716216216217,41.69407894736841,1033.2236842105249,27.924964438122295,0
390,4,0,0,38,0.0,0.0,1.0,38,1000,600,400,0.6,14,6,8,340.0724225890655,0.8110478899952585,0.11399414956568377,0.21149094987926814,133585.5503616495,1485.752346875936,135071.30270852544,388,2,212.31578947368422,37,1,16,32.76808442935934,0.6542792792792793,41.55701754385964,1033.7719298245595,27.939781887150257,0
391,4,0,0,38,0.0,0.0,1.0,38,1050,700,350,0.6666666666666666,14,7,7,343.90686492333066,0.8117294926505453,0.12143881599874984,0.21436785479788037,133670.5780264119,1594.045884310551,135264.62391072247,389,3,213.31578947368422,37,1,17,32.583920934506764,0.6551238738738738,41.47478070175438,1034.1008771929821,27.948672356567084,0
392,4,0,0,38,0.0,0.0,1.0,38,1000,600,400,0.6,14,6,8,342.2924654758564,0.8098921289710763,0.11404624438680133,0.21401785366233966,133783.99032635044,1558.6503780009257,135342.64070435136,390,4,214.31578947368422,37,1,12,32.51225490196079,0.65625,41.36513157894737,1034.5394736842109,27.960526315789483,0
393,4,0,0,38,0.0,0.0,1.0,38,1300,1200,100,0.9230769230769231,14,12,2,342.59282533754657,0.810692271218587,0.1185325602140943,0.21503166696718345,133925.8233302555,1576.4052400738672,135502.22857032935,391,5,215.31578947368422,37,1,12,32.362729519774014,0.6576576576576576,41.228070175438596,1035.0877192982457,27.975343764817453,0
394,4,0,0,38,0.0,0.0,1.0,38,1350,900,450,0.6666666666666666,18,9,9,342.28653139996794,0.8098032242769085,0.11750150471477316,0.2155036001694197,134039.34383656504,1575.9724145890966,135615.31625115414,392,6,216.31578947368422,37,1,13,32.25725328250742,0.6587837837837838,41.118421052631575,1035.526315789473,27.987197724039813,0
395,4,0,1,37,0.0,0.02631578947368421,0.9736842105263158,38,550,200,350,0.36363636363636365,9,2,7,340.87022794586306,0.8082029397818872,0.11435447212442607,0.21527686588452644,134152.9124345953,1545.746768236381,135698.65920283168,393,7,217.31578947368422,37,1,14,32.180532034998585,0.6599099099099099,41.00877192982456,1035.9649122807018,27.999051683262213,0
396,4,0,0,37,0.0,0.0,1.0,37,1100,800,300,0.7272727272727273,14,8,6,347.53205102129436,0.7996746746746747,0.11546148149018998,0.2188975850131385,134054.68813408,1917.6601432513567,135972.34827733136,394,14,224.0,36,1,14,32.10612403943744,0.6608796296296295,41.1036036036036,1035.5855855855852,28.766266266266257,0
397,4,0,0,37,0.0,0.0,1.0,37,750,600,150,0.8,9,6,3,346.8529270676409,0.7979854854854854,0.11472457347008946,0.2189910827793567,134142.16739966313,1905.5206811541243,136047.68808081726,395,15,225.0,36,1,14,32.0363173533355,0.6617476851851851,41.01914414414414,1035.9234234234232,28.775650650650643,0
398,4,0,0,37,0.0,0.0,1.0,37,900,500,400,0.5555555555555556,13,5,8,349.6506552136759,0.7978603603603603,0.11920440327308435,0.2212850982996042,134229.67519884746,1986.6987764791788,136216.37397532663,396,16,226.0,36,1,14,31.876448960370947,0.6626157407407407,40.93468468468468,1036.2612612612609,28.785035035035023,0
399,4,0,0,37,0.0,0.0,1.0,37,750,300,450,0.4,12,3,9,351.00773496530275,0.7935435435435435,0.12132079957033826,0.2233884057564252,134433.97102761548,2037.4727345588888,136471.44376217437,397,17,227.0,36,1,17,31.637302276758255,0.6646412037037037,40.737612612612615,1037.0495495495497,28.80693193193194,0
400,4,0,0,37,0.0,0.0,1.0,37,600,300,300,0.5,9,3,6,349.83306720859343,0.7921046046046046,0.1289482253337677,0.2233549582947173,134550.78125,2014.0625000000005,136564.84375,398,18,228.0,36,1,17,31.55120481927711,0.6657986111111112,40.625,1037.5,28.819444444444443,0
401,4,0,0,37,0.0,0.0,1.0,37,1100,900,200,0.8181818181818182,13,9,4,341.1571091797988,0.7915415415415415,0.16272498094623944,0.2190437706572245,134755.3211995779,1794.5471654086466,136549.86836498656,399,19,229.0,36,1,19,31.57244215473608,0.6678240740740742,40.427927927927925,1038.288288288288,28.841341341341334,3
402,4,0,0,37,0.0,0.0,1.0,37,800,700,100,0.875,9,7,2,342.81845353837684,0.7907282282282282,0.166422493612433,0.2208210485641053,134872.27091956823,1847.340668371078,136719.6115879393,400,20,230.0,36,1,17,31.412845114194862,0.6689814814814814,40.31531531531532,1038.738738738739,28.85385385385386,0
403,4,0,0,37,0.0,0.0,1.0,37,1100,700,400,0.6363636363636364,15,7,8,342.9510912453983,0.7904779779779779,0.16187507689783875,0.2212634103377655,134930.7648019642,1854.9306062819664,136785.69540824616,401,21,231.0,36,1,17,31.35116337885685,0.6695601851851851,40.25900900900901,1038.9639639639645,28.860110110110124,0
404,4,0,0,37,0.0,0.0,1.0,37,900,600,300,0.6666666666666666,12,6,6,335.04664956935267,0.7907907907907907,0.10457239627434367,0.21159898028952154,134152.91243459514,1589.4967682363663,135742.4092028315,402,22,232.0,37,0,20,32.33135760654812,0.6599099099099099,41.008771929824555,1035.964912280701,27.999051683262188,2
405,4,0,0,37,0.0,0.0,1.0,37,1300,1100,200,0.8461538461538461,15,11,4,335.7555459113345,0.7912287287287287,0.10038855103913846,0.212870367236743,134294.94081111465,1618.0542330332084,135912.99504414786,403,23,233.0,37,0,20,32.171334496985075,0.6613175675675678,40.87171052631577,1036.5131578947344,28.013869132290118,0
406,4,0,0,37,0.0,0.0,1.0,37,800,700,100,0.875,9,7,2,340.7061201172682,0.7895395395395395,0.10271356037293233,0.21701947408681727,134465.474052112,1762.6419908048422,136228.11604291684,404,24,234.0,37,0,21,31.87297371110405,0.6630067567567568,40.70723684210525,1037.1710526315774,28.031650071123714,0
407,4,0,0,37,0.0,0.0,1.0,37,1450,1000,450,0.6896551724137931,19,10,9,339.7400794647641,0.7887262262262262,0.10028246570569332,0.21708037623059148,134579.2229940942,1744.3911828639452,136323.61417695813,405,25,235.0,37,0,21,31.784648103138544,0.664132882882883,40.59758771929824,1037.6096491228059,28.043504030346107,0
408,4,0,1,36,0.0,0.02702702702702703,0.972972972972973,37,900,600,300,0.6666666666666666,12,6,6,337.9918316380322,0.7872247247247247,0.09459887689527524,0.21663972038708515,134693.02002779683,1705.0281096106303,136398.04813740746,406,26,236.0,37,0,21,31.71664289989789,0.6652590090090091,40.48793859649122,1038.0482456140337,28.055357989568478,0
409,4,0,0,36,0.0,0.0,1.0,36,600,500,100,0.8333333333333334,7,5,2,363.3120434934384,0.7835648148148149,0.1270817390036807,0.22022632616530696,132629.89921932074,2437.2079427400477,135067.1071620608,407,27,240.19444444444446,36,0,16,33.12720928537591,0.6467013888888888,42.48310810810811,1030.0675675675682,28.612987987988006,5
410,4,0,0,36,0.0,0.0,1.0,36,850,600,250,0.7058823529411765,11,6,5,377.1786709654084,0.7844246031746033,0.13852999501198315,0.22618337504445696,132224.21481870403,2774.430722952703,134998.64554165673,408,28,241.19444444444446,36,0,17,33.1791306252053,0.6426504629629629,42.87725225225226,1028.4909909909925,28.569194194194235,5
411,4,0,0,36,0.0,0.0,1.0,36,1000,600,400,0.6,14,6,8,371.3910118055094,0.7831349206349207,0.13159334646530962,0.22356858141493735,132369.0307706357,2632.1336539242193,135001.16442455992,409,29,242.19444444444446,36,0,17,33.18195082804407,0.6440972222222221,42.7364864864865,1029.0540540540558,28.584834834834883,0
412,4,0,0,36,0.0,0.0,1.0,36,1400,1300,100,0.9285714285714286,15,13,2,371.25309852165884,0.7827380952380953,0.14927082943152192,0.22490002203840975,132606.53941883135,2646.120899095248,135252.6603179266,410,30,243.19444444444446,35,1,18,32.94623459564745,0.6485119047619048,42.50578703703703,1029.976851851851,29.42791005291003,0
413,4,0,0,36,0.0,0.0,1.0,36,600,300,300,0.5,9,3,6,369.4571097743224,0.7825396825396826,0.15221148926079886,0.22452400329834743,132725.7764944486,2607.2963552383285,135333.07284968693,411,31,244.19444444444446,35,1,13,32.87246340184958,0.649702380952381,42.39004629629629,1030.4398148148139,29.441137566137538,0
414,4,1,1,36,0.02702702702702703,0.02702702702702703,0.972972972972973,37,1150,900,250,0.782608695652174,14,9,5,361.4426428350779,0.7905405405405406,0.1459483069004801,0.22096740474523646,132949.0871783946,2210.693886454019,135159.78106484862,412,0,238.56756756756758,36,1,14,32.85447150032757,0.6498842592592593,42.17342342342342,1031.3063063063062,28.647397397397395,0
415,4,0,0,36,0.0,0.0,1.0,36,1300,1000,300,0.7692307692307693,16,10,6,374.18331727096626,0.7809854497354498,0.1441751446239774,0.22903308540651435,132994.25582990394,2752.846364883394,135747.10219478732,413,33,246.19444444444446,35,1,15,32.48055056852184,0.6523809523809524,42.129629629629626,1031.481481481481,29.470899470899457,0
416,4,0,0,36,0.0,0.0,1.0,36,600,400,200,0.6666666666666666,8,4,4,375.998327497984,0.7813822751322752,0.14755191583775895,0.23051231714697587,133053.95474322702,2805.6128900891626,135859.56763331618,414,34,247.19444444444446,35,1,15,32.373700545957675,0.6529761904761904,42.07175925925926,1031.7129629629628,29.477513227513224,0
417,4,1,1,36,0.02702702702702703,0.02702702702702703,0.972972972972973,37,1350,1000,350,0.7407407407407407,17,10,7,366.34063663676926,0.7888513513513513,0.13641989132612764,0.2264202371450436,133355.88121905687,2370.735685009334,135726.6169040662,415,0,241.48648648648648,36,1,16,32.31960495711587,0.6539351851851851,41.77927927927928,1032.8828828828828,28.691191191191187,0
418,4,0,0,36,0.0,0.0,1.0,36,750,500,250,0.6666666666666666,10,5,5,374.07814599426825,0.7801256613756614,0.14086901292684773,0.2308108726528949,133292.88435570977,2772.3910108024556,136065.2753665122,416,36,249.19444444444446,35,1,16,32.183086751849366,0.655357142857143,41.84027777777777,1032.638888888888,29.503968253968228,0
419,4,0,0,36,0.0,0.0,1.0,36,900,600,300,0.6666666666666666,12,6,6,375.70310853482414,0.7803902116402117,0.1388639872503612,0.23218660253218606,133352.6502486281,2820.2010459533412,136172.85129458146,417,37,250.19444444444446,35,1,16,32.08109218586583,0.6559523809523811,41.7824074074074,1032.870370370369,29.510582010581974,0
420,4,0,0,36,0.0,0.0,1.0,36,850,600,250,0.7058823529411765,11,6,5,371.76212772458666,0.7793320105820106,0.13754511249328116,0.23087545013625616,133533.73724489793,2728.6108399120913,136262.34808481002,418,38,251.19444444444446,34,2,16,32.0010750211165,0.6599264705882353,41.607142857142854,1033.5714285714282,30.399159663865536,0
421,4,0,0,36,0.0,0.0,1.0,36,650,500,150,0.7692307692307693,8,5,3,373.10234083086357,0.7786044973544974,0.1350823993039565,0.23209317534206433,133595.26643990926,2768.9413265306052,136364.20776643985,419,39,252.19444444444446,34,2,17,31.904700214954712,0.6605392156862746,41.547619047619044,1033.8095238095234,30.406162464985982,0
422,4,0,0,36,0.0,0.0,1.0,36,1100,800,300,0.7272727272727273,14,8,6,374.3893989991437,0.7776455026455027,0.12971170203241122,0.2334760020894156,133687.58680555547,2810.2430555555466,136497.829861111,420,40,253.19444444444446,34,2,19,31.778807413376313,0.6614583333333334,41.45833333333333,1034.166666666666,30.41666666666665,0
423,4,0,0,36,0.0,0.0,1.0,36,950,700,250,0.7368421052631579,12,7,5,376.18536341519854,0.7768518518518519,0.1301633874122654,0.2353799131347366,133810.73022959186,2867.5276360544244,136678.2578656463,421,41,254.19444444444446,34,2,15,31.608848233805087,0.6626838235294117,41.339285714285715,1034.6428571428573,30.430672268907568,0
424,4,0,0,36,0.0,0.0,1.0,36,850,400,450,0.47058823529411764,13,4,9,375.45733681232326,0.7758267195767197,0.12144791986098369,0.23590874284103772,133964.73922902494,2859.608843537415,136824.34807256237,422,42,255.19444444444446,34,2,16,31.47328273535725,0.6642156862745099,41.19047619047619,1035.2380952380952,30.448179271708682,0
425,4,0,0,36,0.0,0.0,1.0,36,500,200,300,0.4,8,2,6,373.6102542265299,0.7750330687830689,0.11698091515290865,0.235141967529838,134026.36763038562,2814.7250566893554,136841.09268707497,423,43,256.19444444444446,34,2,16,31.45933931171916,0.664828431372549,41.13095238095239,1035.4761904761915,30.45518207282916,0
426,4,0,0,36,0.0,0.0,1.0,36,1450,1200,250,0.8275862068965517,17,12,5,373.9926014004492,0.7750992063492064,0.11877394636015337,0.23577794436115274,134088.01020408163,2829.5847505668917,136917.59495464852,424,44,257.19444444444446,34,2,16,31.38769157088122,0.6654411764705883,41.07142857142857,1035.7142857142856,30.462184873949575,0
427,4,0,1,35,0.0,0.027777777777777776,0.9722222222222222,36,850,700,150,0.8235294117647058,10,7,3,371.60579381310043,0.7749007936507937,0.1325742931518854,0.2197520681931793,131694.45153061228,2587.6842403628184,134282.1357709751,425,45,258.19444444444446,34,2,16,33.85718704090311,0.6415441176470588,43.392857142857146,1026.4285714285718,30.189075630252113,6
428,4,0,0,35,0.0,0.0,1.0,35,1200,900,300,0.75,15,9,6,374.0981521190132,0.7708683473389355,0.14591958530846116,0.22165447796697965,131768.1375552672,2858.843353517877,134626.98090878507,426,46,263.8285714285714,33,2,17,33.718767406700096,0.6445707070707071,43.32107843137255,1026.7156862745096,31.112596553773017,0
429,4,0,0,35,0.0,0.0,1.0,35,1000,700,300,0.7,13,7,6,374.0981521190132,0.7708683473389355,0.14591958530846116,0.22165447796697965,131768.1375552672,2858.843353517877,134626.98090878507,427,47,264.8285714285714,33,2,17,33.718767406700096,0.6445707070707071,43.32107843137255,1026.7156862745096,31.112596553773017,0
430,4,0,1,34,0.0,0.02857142857142857,0.9714285714285714,35,650,600,50,0.9230769230769231,7,6,1,375.60327341400296,0.7702380952380952,0.15137641263401935,0.22309929372663068,131862.52170138896,2905.598958333344,134768.1206597223,428,48,265.8285714285714,33,2,17,33.58477011494253,0.6455176767676767,43.22916666666667,1027.083333333334,31.12373737373739,0
431,4,0,0,34,0.0,0.0,1.0,34,900,600,300,0.6666666666666666,12,6,6,384.9459896772984,0.768716577540107,0.1681896059394632,0.22913719956138828,131943.58555568312,3358.2308246607513,135301.81638034387,429,49,271.11764705882354,32,2,19,33.26292450124943,0.6487630208333334,43.150252525252526,1027.3989898989903,32.10621843434345,0
432,4,0,0,34,0.0,0.0,1.0,34,750,400,350,0.5333333333333333,11,4,7,380.4794386663831,0.7681224004753417,0.16773123694877823,0.22725481365979636,132073.33953486895,3250.238017804315,135323.57755267326,430,50,272.11764705882354,32,2,19,33.24658109159399,0.6500651041666666,43.0239898989899,1027.9040404040409,32.12200126262628,0
433,4,0,0,34,0.0,0.0,1.0,34,950,800,150,0.8421052631578947,11,8,3,381.73454755162214,0.7686794414735592,0.16060571048945027,0.22898450842087725,132235.62168401186,3295.781042750746,135531.4027267626,431,51,273.11764705882354,32,2,19,33.050474670594994,0.6516927083333333,42.86616161616162,1028.5353535353536,32.1417297979798,0
434,4,1,1,34,0.02857142857142857,0.02857142857142857,0.9714285714285714,35,750,500,250,0.6666666666666666,10,5,5,373.47130539396375,0.7778011204481792,0.15512438995357702,0.22555948501902864,132492.61289227701,2896.4378183871595,135389.0507106642,432,0,266.2857142857143,33,2,20,33.00388346625402,0.651830808080808,42.61642156862745,1029.5343137254902,31.198009506833035,0
435,4,0,0,34,0.0,0.0,1.0,34,900,500,400,0.5555555555555556,13,5,8,385.68080119326646,0.766971182412359,0.16611097880447723,0.23234916559691932,132398.00347222236,3412.6736111111313,135810.6770833335,433,53,275.11764705882354,32,2,20,32.78508771929825,0.6533203125,42.70833333333334,1029.1666666666679,32.16145833333337,0
436,4,0,0,34,0.0,0.0,1.0,34,1350,1100,250,0.8148148148148148,16,11,5,383.51511399434906,0.7672311348781937,0.1649302674583879,0.2314432808583218,132462.98408644527,3360.311288388941,135823.2953748342,434,54,276.11764705882354,32,2,20,32.77525655178053,0.6539713541666666,42.64520202020202,1029.419191919192,32.16934974747475,0
437,4,1,1,34,0.02857142857142857,0.02857142857142857,0.9714285714285714,35,500,300,200,0.6,7,3,4,374.9000770413933,0.7775210084033612,0.15248063069185802,0.22775721443381744,132713.49961553246,2950.860246059202,135664.35986159166,435,0,269.2,33,2,17,32.744608309546464,0.6540404040404041,42.40196078431372,1030.3921568627447,31.22400475341651,0
438,4,0,0,34,0.0,0.0,1.0,34,650,400,250,0.6153846153846154,9,4,5,386.2687764753526,0.7679738562091504,0.16756809380611393,0.2339119829034486,132592.9931416438,3443.306646005518,136036.2997876493,436,56,278.11764705882354,32,2,20,32.57324996935148,0.6552734375,42.5189393939394,1029.924242424243,32.18513257575759,0
439,4,1,1,34,0.02857142857142857,0.02857142857142857,0.9714285714285714,35,1000,800,200,0.8,12,8,4,374.2380596004258,0.7764005602240895,0.15462417734672762,0.22841972052144355,132888.5363520406,2946.3895975056485,135834.92594954625,437,0,271.14285714285717,34,1,17,32.585488588692606,0.6534926470588236,42.23214285714285,1031.0714285714268,30.32563025210079,0
440,4,0,0,34,0.0,0.0,1.0,34,1000,800,200,0.8,12,8,4,381.058168119235,0.7660799168152109,0.15832558204592018,0.23208401535487935,132808.22167255377,3321.5315323433197,136129.7532048971,438,58,280.11764705882354,33,1,18,32.49056295327546,0.6549873737373737,42.31004901960784,1030.7598039215682,31.235145573380855,0
441,4,0,0,34,0.0,0.0,1.0,34,1100,700,400,0.6363636363636364,15,7,8,380.586895791924,0.7658942364824718,0.156203246689691,0.23238448049297883,132902.97752066507,3316.2263312187497,136219.20385188382,439,59,281.11764705882354,33,1,18,32.40729736154029,0.6559343434343434,42.218137254901954,1031.1274509803916,31.2462863933452,0
442,4,0,1,33,0.0,0.029411764705882353,0.9705882352941176,34,650,300,350,0.46153846153846156,10,3,7,382.69564330170397,0.7659313725490197,0.15977421271538939,0.23386955979548563,132934.5703124999,3374.696180555542,136309.26649305545,440,60,282.11764705882354,33,1,18,32.32112794612793,0.65625,42.18749999999999,1031.2499999999993,31.24999999999998,0
443,4,0,0,33,0.0,0.0,1.0,33,1500,1200,300,0.8,18,12,6,393.13229937674066,0.7637310606060607,0.16018588630053632,0.23951732030684392,132820.6624324048,3843.2184853586264,136663.88091776342,441,61,286.45454545454544,32,1,18,32.16688102237465,0.6575520833333335,42.29797979797979,1030.8080808080801,32.212752525252505,0
444,4,0,0,33,0.0,0.0,1.0,33,1000,600,400,0.6,14,6,8,393.3173569807826,0.7627840909090909,0.15774942666933844,0.24004705060575984,132885.7466712578,3853.254132231376,136739.00080348918,442,62,287.45454545454544,32,1,19,32.09649767327944,0.6582031250000002,42.23484848484847,1031.0606060606044,32.22064393939389,0
445,4,0,0,33,0.0,0.0,1.0,33,950,600,350,0.631578947368421,13,6,7,392.4148959228404,0.7623895202020202,0.1573887522216162,0.23970474607343573,132918.2947690286,3831.823761605949,136750.11853063456,443,63,288.45454545454544,32,1,19,32.08695563446389,0.6585286458333335,42.20328282828282,1031.1868686868681,32.22458964646463,0
446,4,0,0,33,0.0,0.0,1.0,33,950,500,450,0.5263157894736842,14,5,9,390.25431677948063,0.7619160353535355,0.1547090441691985,0.2388005628293313,132983.40292125783,3779.4694100091547,136762.872331267,444,64,289.45454545454544,32,1,19,32.07705961562002,0.6591796875000002,42.1401515151515,1031.4393939393924,32.23248106060601,0
447,4,0,0,33,0.0,0.0,1.0,33,850,600,250,0.7058823529411765,11,6,5,393.3006440817575,0.7626262626262627,0.16121568103946915,0.24129526001772697,133081.09504132235,3868.176078971537,136949.27112029388,445,65,290.45454545454544,32,1,19,31.900085658345564,0.66015625,42.04545454545455,1031.8181818181822,32.244318181818194,0
448,4,0,0,33,0.0,0.0,1.0,33,850,700,150,0.8235294117647058,10,7,3,395.93005542707687,0.7638099747474748,0.1607387800194262,0.2433332536136033,133146.24304917865,3943.3198780736643,137089.56292725232,446,66,291.45454545454544,32,1,19,31.76662792594405,0.6608072916666667,41.98232323232323,1032.070707070707,32.25220959595959,0
449,4,0,0,33,0.0,0.0,1.0,33,550,300,250,0.5454545454545454,8,3,5,395.93005542707687,0.7638099747474748,0.1607387800194262,0.2433332536136033,133146.24304917865,3943.3198780736643,137089.56292725232,447,67,292.45454545454544,32,1,19,31.76662792594405,0.6608072916666667,41.98232323232323,1032.070707070707,32.25220959595959,0
450,4,0,0,33,0.0,0.0,1.0,33,800,600,200,0.75,10,6,4,394.6063319304078,0.7642834595959597,0.16417600664176013,0.24294438026076912,133211.40699928574,3913.212937455357,137124.6199367411,448,68,293.45454545454544,32,1,19,31.7351598173516,0.6614583333333334,41.91919191919192,1032.3232323232319,32.260101010100996,0
451,4,0,0,33,0.0,0.0,1.0,33,750,500,250,0.6666666666666666,10,5,5,395.1971423788423,0.7648358585858587,0.16198670490673406,0.24373470817301476,133276.58689164388,3934.1052571166415,137210.6921487605,449,69,294.45454545454544,32,1,19,31.65428588897042,0.662109375,41.856060606060616,1032.5757575757589,32.267992424242465,0
452,4,0,0,33,0.0,0.0,1.0,33,1200,900,300,0.75,15,9,6,397.5905385874676,0.761679292929293,0.16312915347735157,0.24672316590890248,133504.84206012142,4016.0524117437003,137520.89447186512,450,70,295.45454545454544,32,1,19,31.362757075951944,0.6643880208333334,41.63510101010101,1033.459595959596,32.29561237373738,0
453,4,0,0,33,0.0,0.0,1.0,33,850,600,250,0.7058823529411765,11,6,5,393.3100353705506,0.7630208333333334,0.16082663469082603,0.24471296121687455,133602.72548719522,3909.4585373941463,137512.18402458937,451,71,296.45454545454544,32,1,19,31.374928757531343,0.6653645833333334,41.54040404040404,1033.838383838384,32.3074494949495,0
454,4,0,0,33,0.0,0.0,1.0,33,900,500,400,0.5555555555555556,13,5,8,392.0326315930712,0.7621527777777778,0.15790875790875747,0.24434910599294157,133668.00103305784,3880.4436409550035,137548.44467401283,452,72,297.45454545454544,32,1,19,31.342338217338227,0.666015625,41.47727272727273,1034.090909090909,32.31534090909091,0
455,4,0,0,33,0.0,0.0,1.0,33,550,400,150,0.7272727272727273,7,4,3,388.76861333847046,0.7610479797979799,0.15010949337121215,0.24274332930402068,133733.2925211714,3798.2613381287724,137531.55385930015,453,73,298.45454545454544,32,1,18,31.36113484700521,0.6666666666666666,41.41414141414142,1034.3434343434349,32.32323232323234,0
456,4,0,0,33,0.0,0.0,1.0,33,400,200,200,0.5,6,2,4,387.41355661932363,0.7608112373737375,0.15134503443021874,0.2423257009876897,133798.59995153546,3767.078295582075,137565.67824711752,454,74,299.45454545454544,32,1,18,31.330597591733788,0.6673177083333334,41.3510101010101,1034.595959595959,32.331123737373716,0
457,4,0,0,33,0.0,0.0,1.0,33,700,500,200,0.7142857142857143,9,5,4,373.214778202947,0.7601010101010102,0.09554587607137854,0.22730698765133847,132808.22167255366,3313.1981990099725,136121.41987156362,455,75,300.45454545454544,33,0,17,32.69267922958029,0.6549873737373739,42.31004901960783,1030.7598039215673,31.235145573380827,7
458,4,0,0,33,0.0,0.0,1.0,33,950,500,450,0.5263157894736842,14,5,9,376.30658242854463,0.7597853535353536,0.09646848715289824,0.23015960739234242,132966.16685890043,3407.208765859285,136373.3756247597,456,76,301.45454545454544,33,0,17,32.45405576679341,0.6565656565656566,42.15686274509804,1031.3725490196077,31.25371360665478,0
459,4,0,0,33,0.0,0.0,1.0,33,900,600,300,0.6666666666666666,12,6,6,378.0750503551661,0.7587594696969697,0.10009357230259885,0.23202565043662537,133092.59059015766,3463.7975778546806,136556.38816801234,457,77,302.45454545454544,33,0,18,32.28127474267618,0.6578282828282829,42.0343137254902,1031.8627450980396,31.268568033273926,0
460,4,0,0,33,0.0,0.0,1.0,33,900,600,300,0.6666666666666666,12,6,6,375.82438869762,0.7591540404040404,0.09343044690225732,0.23162549193690185,133250.70473195406,3415.772929882742,136666.4776618368,458,78,303.45454545454544,33,0,19,32.18039070227498,0.6594065656565655,41.881127450980394,1032.4754901960785,31.28713606654783,0
461,4,0,0,33,0.0,0.0,1.0,33,650,400,250,0.6153846153846154,9,4,5,375.82438869762,0.7591540404040404,0.09343044690225732,0.23162549193690185,133250.70473195406,3415.772929882742,136666.4776618368,459,79,304.45454545454544,33,0,19,32.18039070227498,0.6594065656565655,41.881127450980394,1032.4754901960785,31.28713606654783,0
462,4,1,1,33,0.029411764705882353,0.029411764705882353,0.9705882352941176,34,900,600,300,0.6666666666666666,12,6,6,366.9128920019604,0.7693478906714202,0.085240937328519,0.22805330288139042,133564.50007086174,3001.3073979591923,136565.80746882095,460,0,296.47058823529414,34,0,19,32.09552190103266,0.6602328431372548,41.577380952380956,1033.6904761904768,30.40266106442579,0
463,4,1,1,33,0.029411764705882353,0.029411764705882353,0.9705882352941176,34,1000,800,200,0.8,12,8,4,364.3040590268236,0.7638146167557933,0.08815404614884592,0.22737598166846587,133718.36734693885,2942.828798185945,136661.1961451248,461,0,297.44117647058823,34,0,15,32.00870933087783,0.6617647058823529,41.42857142857143,1034.285714285715,30.42016806722691,0
464,4,0,0,33,0.0,0.0,1.0,33,750,500,250,0.6666666666666666,10,5,5,373.4688495488074,0.7591540404040404,0.09306435622225084,0.23234389489629373,133598.8862456749,3379.0044694348535,136977.89071510974,462,82,307.45454545454544,33,0,20,31.891595542911347,0.6628787878787878,41.54411764705883,1033.823529411766,31.327985739750485,0
465,4,0,0,33,0.0,0.0,1.0,33,950,600,350,0.631578947368421,13,6,7,372.82181442465344,0.7587594696969697,0.10205371248025297,0.23273787823550865,133725.61034217622,3371.164936562877,137096.7752787391,463,83,308.45454545454544,33,0,18,31.78120063191154,0.664141414141414,41.42156862745099,1034.3137254901972,31.342840166369612,0
466,4,0,0,33,0.0,0.0,1.0,33,850,600,250,0.7058823529411765,11,6,5,371.22634845819124,0.7586805555555556,0.09979726214184481,0.232739904434256,133884.09994052784,3340.2611075067534,137224.3610480346,464,84,309.45454545454544,33,0,18,31.66358298796132,0.6657196969696968,41.26838235294119,1034.9264705882367,31.361408199643538,0
467,4,0,0,33,0.0,0.0,1.0,33,700,500,200,0.7142857142857143,9,5,4,372.0319763688016,0.7578125000000001,0.09707874196510535,0.23384867086038977,133979.2387543254,3368.9121972318535,137348.15095155727,465,85,310.45454545454544,33,0,18,31.547407670454565,0.6666666666666665,41.176470588235304,1035.29411764706,31.372549019607877,0
468,4,0,0,33,0.0,0.0,1.0,33,650,300,350,0.46153846153846156,10,3,7,370.9172859782891,0.7563131313131314,0.09410718639303628,0.23395469411108225,134106.1430699732,3348.4573241061285,137454.60039407932,466,86,311.45454545454544,33,0,20,31.44916390597886,0.6679292929292928,41.05392156862746,1035.784313725491,31.387403446227,0
469,4,0,0,33,0.0,0.0,1.0,33,750,500,250,0.6666666666666666,10,5,5,370.8691192562565,0.7556029040404041,0.08578750246402511,0.2345324161040876,134201.36072964736,3354.228091359105,137555.58882100647,467,87,312.45454545454544,33,0,21,31.35509067612853,0.6688762626262625,40.962009803921575,1036.1519607843145,31.398544266191347,0
470,4,0,0,33,0.0,0.0,1.0,33,900,800,100,0.8888888888888888,10,8,2,365.6058504404483,0.7532354797979799,0.08452893994920219,0.23200749353906644,134328.3701731307,3222.247603085374,137550.6177762161,468,88,313.45454545454544,33,0,21,31.364399850258096,0.6701388888888888,40.83946078431374,1036.6421568627466,31.413398692810503,0
471,4,0,0,33,0.0,0.0,1.0,33,600,300,300,0.5,9,3,6,365.9630356174796,0.7532354797979799,0.0874417938247729,0.23243598208137223,134360.13192041524,3234.16834871204,137594.30026912727,469,89,314.45454545454544,33,0,21,31.32338455476754,0.6704545454545454,40.80882352941177,1036.7647058823532,31.41711229946525,0
472,4,0,0,33,0.0,0.0,1.0,33,1300,1000,300,0.7692307692307693,16,10,6,364.0649958369216,0.7544191919191919,0.08326172881938465,0.2320366057803996,134487.21645520968,3192.4175797770254,137679.6340349867,470,90,315.45454545454544,33,0,21,31.245569470699426,0.6717171717171716,40.68627450980393,1037.2549019607854,31.431966726084408,0
473,4,0,0,33,0.0,0.0,1.0,33,1050,800,250,0.7619047619047619,13,8,5,362.60588006287026,0.7513415404040404,0.0834558836684236,0.23211709737357908,134646.1566014274,3164.697622308738,137810.85422373615,471,91,316.45454545454544,33,0,21,31.12466544653048,0.6732954545454545,40.53308823529412,1037.8676470588243,31.450534759358312,0
474,4,0,0,33,0.0,0.0,1.0,33,800,600,200,0.75,10,6,4,378.8684714069484,0.7518939393939394,0.09509657114334624,0.23857014672204732,134044.6662902831,3588.785642442759,137633.45193272585,472,92,317.45454545454544,31,2,18,31.304879709962698,0.6723790322580645,41.11328124999999,1035.546874999999,33.40473790322578,3
475,4,0,0,33,0.0,0.0,1.0,33,750,400,350,0.5333333333333333,11,4,7,378.18601034398887,0.752761994949495,0.09105386274106397,0.23835907498225717,134078.37761772992,3541.3133409288,137619.69095865873,473,93,318.45454545454544,31,2,18,31.288764562903356,0.672715053763441,41.08072916666666,1035.6770833333323,33.40893817204298,0
476,4,0,0,33,0.0,0.0,1.0,33,750,700,50,0.9333333333333333,8,7,1,377.1090547371421,0.7528409090909092,0.08964938917395338,0.2377729112996755,134092.68067352832,3513.512811192747,137606.19348472107,474,94,319.45454545454544,32,1,18,31.302318257548055,0.6702473958333333,41.0669191919192,1035.732323232324,32.366635101010125,0
477,4,0,0,33,0.0,0.0,1.0,33,900,700,200,0.7777777777777778,11,7,4,375.8741887025708,0.7522885101010102,0.08416605735640581,0.23762893624755765,134190.77932098776,3487.7700617284086,137678.54938271616,475,95,320.45454545454544,32,1,19,31.236036639857023,0.6712239583333333,40.97222222222223,1036.111111111112,32.37847222222225,0
478,4,0,0,33,0.0,0.0,1.0,33,500,300,200,0.6,7,3,4,377.42807930081415,0.7526041666666667,0.08790462481083683,0.2394655742704547,134321.63331547804,3539.3512141618253,137860.98452963986,476,96,321.45454545454544,32,1,20,31.06475842468534,0.6725260416666666,40.8459595959596,1036.616161616162,32.39425505050506,0
479,4,0,0,33,0.0,0.0,1.0,33,950,600,350,0.631578947368421,13,6,7,378.2433758052913,0.7506313131313131,0.09119319334831322,0.24062841560719284,134419.81565975418,3568.6809700540844,137988.49662980827,477,97,322.45454545454544,32,1,20,30.945350866512435,0.6735026041666666,40.75126262626263,1036.99494949495,32.40609217171719,0
480,4,0,0,33,0.0,0.0,1.0,33,850,500,350,0.5882352941176471,12,5,7,376.28425347978265,0.7485006313131314,0.09054399415845182,0.2402430233755535,134550.78125,3525.9318245587183,138076.7130745587,478,98,323.45454545454544,31,2,21,30.86512717536813,0.6774193548387097,40.625,1037.5,33.46774193548387,0
481,4,0,0,33,0.0,0.0,1.0,33,550,300,250,0.5454545454545454,8,3,5,376.5381158012561,0.749368686868687,0.08977605414242817,0.24085142720192687,134618.33530002163,3537.786865234366,138156.122165256,479,99,324.45454545454544,31,2,21,30.790987034713517,0.6780913978494624,40.55989583333333,1037.760416666666,33.47614247311826,0
482,4,0,0,33,0.0,0.0,1.0,33,850,600,250,0.7058823529411765,11,6,5,366.94440799778397,0.749368686868687,0.10223161851068818,0.2186800896276773,131988.4197934689,3086.482512735491,135074.9023062044,480,100,325.45454545454544,33,0,18,33.680058636453985,0.646780303030303,43.106617647058826,1027.573529411765,31.13859180035652,8
483,4,1,0,34,0.029411764705882353,0.0,1.0,34,550,400,150,0.7272727272727273,7,4,3,383.7885578184628,0.7595439691027926,0.15891072920829852,0.2204945617842765,130585.01882779812,3281.355174448593,133866.3740022467,481,0,316.8529411764706,32,2,16,34.66929174387481,0.6350911458333334,44.4760101010101,1022.0959595959591,31.940498737373723,7
484,4,1,1,34,0.02857142857142857,0.02857142857142857,0.9714285714285714,35,1250,1100,150,0.88,14,11,3,372.82713614686793,0.7712885154061624,0.14958426005132575,0.21588811281736106,130888.84833958093,2759.782896001538,133648.63123558246,482,0,308.77142857142854,33,2,16,34.64121756487025,0.6357323232323233,44.17892156862745,1023.2843137254903,31.0086155674391,0
485,4,0,0,34,0.0,0.0,1.0,34,600,500,100,0.8333333333333334,7,5,2,382.2256147083386,0.7599524658348188,0.15692327807882878,0.22014673029218537,130681.82615294361,3189.9882665034243,133871.81441944704,483,2,318.8529411764706,32,2,16,34.61091215938092,0.6360677083333333,44.381313131313135,1022.4747474747478,31.95233585858587,0
486,4,1,0,35,0.02857142857142857,0.0,1.0,35,800,600,200,0.75,10,6,4,372.3085636775692,0.769047619047619,0.1569957932897843,0.21629108073452102,131014.28086553246,2755.5477460592037,133769.82861159166,484,0,310.7142857142857,33,2,17,34.52737211714946,0.6369949494949496,44.056372549019606,1023.7745098039214,31.023469994058225,0
487,4,0,0,35,0.0,0.0,1.0,35,1150,800,350,0.6956521739130435,15,8,7,369.4219105545996,0.7675070028011204,0.14757642682785077,0.21517513178748943,131114.67013888882,2687.326388888878,133801.9965277777,485,1,311.7142857142857,34,1,18,34.49959316517493,0.6357230392156863,43.95833333333333,1024.166666666666,30.122549019607824,0
488,4,0,0,35,0.0,0.0,1.0,35,850,700,150,0.8235294117647058,10,7,3,369.8862345711435,0.7683473389355742,0.14842930198578808,0.21561660990854445,131145.15306122435,2701.7573696145014,133846.91043083885,486,2,312.7142857142857,34,1,18,34.45684177901752,0.636029411764706,43.92857142857142,1024.2857142857133,30.12605042016804,0
489,4,1,1,35,0.027777777777777776,0.027777777777777776,0.9722222222222222,36,1200,900,300,0.75,15,9,6,361.72885742702044,0.775462962962963,0.13699253067069228,0.21237700402310317,131419.65880102024,2307.7841553287803,133727.44295634903,487,0,305.0,34,2,18,34.38818259220559,0.6387867647058825,43.66071428571428,1025.3571428571415,30.157563025210045,0
490,4,1,1,35,0.027777777777777776,0.027777777777777776,0.9722222222222222,36,1000,700,300,0.7,13,7,6,363.1149896134003,0.7785052910052911,0.13595473012188108,0.21353144269757288,131480.69905045346,2348.5225340136017,133829.22158446707,488,0,305.97222222222223,34,2,18,34.29096537047786,0.6393995098039216,43.601190476190474,1025.5952380952376,30.164565826330517,0
491,4,1,0,36,0.027777777777777776,0.0,1.0,36,850,400,450,0.47058823529411764,13,4,9,367.635367423286,0.7794642857142857,0.10310687540661423,0.19979750130715745,128400.34060618813,2259.0595841948666,130659.40019038299,489,0,306.94444444444446,32,4,17,37.30742078817325,0.6129557291666667,46.62247474747475,1013.5101010101008,31.67219065656565,7
492,4,1,1,36,0.02702702702702703,0.02702702702702703,0.972972972972973,37,700,400,300,0.5714285714285714,10,4,6,365.563457117971,0.7857232232232232,0.12949777072183033,0.20102454711535625,128868.76594387752,2021.9423185941025,130890.70826247161,490,0,299.6216216216216,34,3,18,36.88127760190722,0.6130514705882353,46.160714285714285,1015.3571428571425,29.86344537815125,0
493,4,1,0,37,0.02702702702702703,0.0,1.0,37,1750,1400,350,0.8,21,14,7,361.47842026452884,0.7913538538538538,0.13870855307519148,0.20061447845717692,129232.53864198856,1943.383496168064,131175.92213815663,491,0,300.43243243243245,33,4,19,36.61401209272428,0.6190025252525253,45.80269607843137,1016.7892156862738,30.81179441473557,0
494,4,2,2,37,0.05128205128205128,0.05128205128205128,0.9487179487179487,39,600,500,100,0.8333333333333334,7,5,2,346.3776588380411,0.8105038236617185,0.1250666596728649,0.19424965074033898,129643.02722318652,1181.0896508487394,130824.11687403526,492,0,285.97435897435895,35,4,12,36.58050630753494,0.6187500000000001,45.39930555555554,1018.4027777777761,29.097222222222175,0
495,4,0,0,37,0.0,0.0,1.0,37,1150,800,350,0.6956521739130435,15,8,7,364.55262499488526,0.7923548548548548,0.1375478672775967,0.2032505731135868,129413.28125000003,2035.5902777777787,131448.8715277778,493,2,302.43243243243245,34,3,19,36.351692601692605,0.6185661764705883,45.625,1017.5000000000002,29.9264705882353,0
496,4,0,0,37,0.0,0.0,1.0,37,450,200,250,0.4444444444444444,7,2,5,363.90684313121983,0.7921046046046046,0.1376323692113166,0.2033597064556818,129504.14540816336,2025.4889455782438,131529.6343537416,494,3,303.43243243243245,34,3,15,36.27558479532165,0.619485294117647,45.53571428571429,1017.8571428571436,29.936974789915986,0
497,4,1,0,38,0.02631578947368421,0.0,1.0,38,1250,800,450,0.64,17,8,9,356.1176667878333,0.7999940730203888,0.1359405153819957,0.2012213294890328,129937.8714018561,1654.6343182013024,131592.5057200574,495,0,296.42105263157896,35,3,17,36.03286884625573,0.6217261904761904,45.1099537037037,1019.5601851851849,29.130291005290996,0
498,4,1,0,39,0.02564102564102564,0.0,1.0,39,1100,700,400,0.6363636363636364,15,7,8,347.88909172955323,0.8043747188484031,0.14071181160936375,0.19881951719051666,130380.7656035665,1272.0144515174863,131652.78005508397,496,0,289.79487179487177,35,4,20,35.79347990329405,0.6261904761904762,44.675925925925924,1021.2962962962961,29.179894179894173,0
499,4,0,0,39,0.0,0.0,1.0,39,1250,800,450,0.64,17,8,9,348.1890076674822,0.8042622582096267,0.13886879707656874,0.19944609803250254,130469.43486636224,1285.6046114111732,131755.03947777342,497,1,290.79487179487177,35,4,20,35.69599429779842,0.6270833333333334,44.58912037037037,1021.643518518518,29.1898148148148,0
500,4,2,1,40,0.04878048780487805,0.024390243902439025,0.975609756097561,41,1050,700,350,0.6666666666666666,14,7,7,332.2489938607333,0.8138211382113821,0.13264154492444669,0.19290277404750034,130991.17036011082,504.33691135734557,131495.50727146817,498,0,277.5609756097561,37,4,15,35.575996143958875,0.6283783783783783,44.078947368421055,1023.6842105263158,27.667140825035563,0
501,4,0,1,39,0.0,0.025,0.975,40,900,700,200,0.7777777777777778,11,7,4,338.92298000148776,0.8065438034188034,0.14401958626760547,0.19643699249065819,130924.43795146496,874.6601331060757,131799.09808457104,499,1,285.5,36,4,16,35.47260123239436,0.6296296296296295,44.14414414414414,1023.4234234234233,28.428428428428425,0
502,4,1,0,40,0.025,0.0,1.0,40,1100,800,300,0.7272727272727273,14,8,6,337.9849510979464,0.8063568376068376,0.14026766595289142,0.19680669845728277,131103.44048168653,862.1979839950598,131965.63846568158,500,0,286.375,37,3,17,35.31584582441113,0.6295045045045045,43.96929824561403,1024.1228070175428,27.678994784257913,0
503,4,0,0,40,0.0,0.0,1.0,40,900,300,600,0.3333333333333333,15,3,12,338.62998738859915,0.8053685897435897,0.13835224232045418,0.1976152387365195,131187.67463305994,884.8161213065315,132072.49075436647,501,1,287.375,37,3,17,35.21430928681009,0.6303490990990992,43.88706140350876,1024.451754385963,27.68788525367468,0
504,4,0,0,40,0.0,0.0,1.0,40,1100,800,300,0.7272727272727273,14,8,6,336.97317029517393,0.8051014957264957,0.13262935296056266,0.19751878745634038,131356.983567182,852.8309819222019,132209.8145491042,502,2,288.375,36,4,18,35.08596067230582,0.6339699074074074,43.721846846846844,1025.1126126126123,28.475350350350343,0
505,4,0,0,40,0.0,0.0,1.0,40,1100,700,400,0.6363636363636364,15,7,8,336.69028820813713,0.8048611111111111,0.133050521691378,0.19765087518601482,131414.71021274658,849.2113312636957,132263.92154401029,503,3,289.375,36,4,20,35.03500823723226,0.6345486111111112,43.66554054054054,1025.3378378378382,28.481606606606615,0
506,4,1,1,40,0.024390243902439025,0.024390243902439025,0.975609756097561,41,950,800,150,0.8421052631578947,11,8,3,330.9118521168514,0.8109756097560976,0.13703455697093014,0.19568325001047696,131693.64762475019,515.797769506029,132209.4453942562,504,0,283.2926829268293,37,4,15,34.90223177723177,0.6354166666666665,43.393640350877206,1026.4254385964932,27.74122807017549,0
507,4,0,0,40,0.0,0.0,1.0,40,1100,800,300,0.7272727272727273,14,8,6,335.032944943555,0.8040331196581196,0.13508762556101672,0.19768211215522022,131609.25116381986,818.6869998461275,132427.938163666,505,5,291.375,37,3,16,34.88147396167271,0.634572072072072,43.475877192982466,1026.096491228072,27.7323376007587,0
508,4,0,0,40,0.0,0.0,1.0,40,1250,800,450,0.64,17,8,9,335.4802032250467,0.8016292735042735,0.14225408522909322,0.19867812414902677,131749.92696069946,839.8984543321042,132589.82541503158,506,6,292.375,37,3,16,34.72834116558083,0.6359797297297296,43.338815789473685,1026.6447368421054,27.747155049786635,0
509,4,1,0,41,0.024390243902439025,0.0,1.0,41,750,400,350,0.5333333333333333,11,4,7,330.23814639431623,0.8068089430894309,0.13375344104719367,0.1973634437643548,132095.8034279349,524.6146541018428,132620.41808203675,507,0,286.219512195122,38,3,17,34.515086953509325,0.6376096491228069,43.00213675213676,1027.9914529914536,27.05240665766983,0
510,4,1,1,41,0.023809523809523808,0.023809523809523808,0.9761904761904762,42,850,600,250,0.7058823529411765,11,6,5,320.44452457834063,0.8143631436314364,0.12926547137073396,0.19304828675817134,132398.00347222242,85.24305555557544,132483.24652777798,508,0,280.3809523809524,39,3,19,34.463562753036435,0.6388888888888888,42.70833333333334,1029.1666666666683,26.388888888888932,0
511,4,0,0,41,0.0,0.0,1.0,41,1200,700,500,0.5833333333333334,17,7,10,329.2979949529622,0.8117886178861788,0.11179601347941981,0.19637429717622695,132013.44515897793,494.35255953684674,132507.79771851478,509,1,287.9756097560976,38,3,15,34.62201545552206,0.6367872807017544,43.082264957264954,1027.6709401709395,27.043972109761565,2
512,4,1,0,42,0.023809523809523808,0.0,1.0,42,1200,900,300,0.75,15,9,6,323.4802567966899,0.8153552071234998,0.1197173597760468,0.19529354782661476,132478.41932508667,170.83062065971185,132649.2499457464,510,0,282.0952380952381,39,3,18,34.30480370332896,0.639690170940171,42.63020833333333,1029.4791666666656,26.396901709401682,0
513,4,0,0,42,0.0,0.0,1.0,42,750,500,250,0.6666666666666666,10,5,5,323.8194378137265,0.8160085172280295,0.11968356747798348,0.19563761145176461,132505.23003472202,181.55381944442473,132686.78385416645,511,1,283.0952380952381,39,3,18,34.269189262107105,0.6399572649572651,42.60416666666666,1029.5833333333317,26.399572649572608,0
514,4,0,1,41,0.0,0.023809523809523808,0.9761904761904762,42,650,600,50,0.9230769230769231,7,6,1,327.38188749594156,0.8157181571815718,0.12320850670365258,0.19835490830636454,132612.5,282.98611111111114,132895.48611111112,512,2,284.0952380952381,39,3,19,34.0699163969795,0.6410256410256411,42.5,1030.0,26.41025641025641,0
515,4,0,1,40,0.0,0.024390243902439025,0.975609756097561,41,850,600,250,0.7058823529411765,11,6,5,333.24409014996286,0.8090447154471545,0.12923793138346307,0.20178850684960056,132590.49236613335,636.999598217536,133227.4919643509,513,3,291.7317073170732,38,3,19,33.941044260027645,0.6425438596491229,42.521367521367516,1029.9145299145293,27.103013945119194,0
516,4,0,0,40,0.0,0.0,1.0,40,800,400,400,0.5,12,4,8,340.17497221166167,0.8030982905982906,0.1288862862010225,0.20585846256520132,132567.32840874104,1019.2174515235336,133586.54586026457,514,4,299.225,37,3,21,33.785846110164684,0.6441441441441442,42.5438596491228,1029.824561403508,27.833096254148863,0
517,4,0,0,40,0.0,0.0,1.0,40,900,700,200,0.7777777777777778,11,7,4,342.3811364267117,0.8018429487179487,0.13218846440353293,0.2079738551390955,132708.51518015144,1087.3784481763455,133795.8936283278,515,5,300.225,37,3,14,33.587292930367845,0.6455518018018018,42.40679824561403,1030.3728070175428,27.847913703176832,0
518,4,0,0,40,0.0,0.0,1.0,40,900,600,300,0.6666666666666666,12,6,6,342.0748824821091,0.8010683760683761,0.1267974898957671,0.20857250616710668,132849.77709487517,1088.914377500749,133938.6914723759,516,6,301.225,37,3,15,33.453431893923266,0.6469594594594594,42.26973684210525,1030.9210526315776,27.8627311522048,0
519,4,0,0,40,0.0,0.0,1.0,40,1350,1200,150,0.8888888888888888,15,12,3,342.45494289343253,0.8,0.12749840527322998,0.20943635844314837,132962.84072983972,1106.756405817148,134069.59713565686,517,7,302.225,37,3,15,33.330232475724706,0.6480855855855856,42.16008771929823,1031.3596491228052,27.874585111427166,0
520,4,0,0,40,0.0,0.0,1.0,40,850,600,250,0.7058823529411765,11,6,5,341.71484198983404,0.8005876068376069,0.1279968119022321,0.20961777464956552,133075.95245652492,1094.8056132656022,134170.75806979052,518,8,303.225,37,3,16,33.23591923485654,0.6492117117117118,42.05043859649122,1031.7982456140337,27.88643907064956,0
521,4,1,2,39,0.024390243902439025,0.04878048780487805,0.9512195121951219,41,1000,600,400,0.6,14,6,8,330.0875103867122,0.8109756097560976,0.11414230584911866,0.20434995041226012,133417.0284991598,607.8589560961259,134024.8874552559,519,0,296.8048780487805,38,3,17,33.19458807307825,0.6507675438596492,41.720085470085465,1033.119658119657,27.187359424201503,0
522,4,1,0,40,0.025,0.0,1.0,40,750,600,150,0.8,9,6,3,337.7896781929402,0.801655982905983,0.12429936305732525,0.2087912577806754,133358.9421745151,1009.4548322560659,134368.39700677118,520,0,304.625,37,3,18,33.053786270346784,0.6520270270270271,41.77631578947368,1032.8947368421043,27.916073968705522,0
523,4,0,0,40,0.0,0.0,1.0,40,750,500,250,0.6666666666666666,10,5,5,337.03124438884663,0.8003739316239317,0.12303651029505414,0.20864049833322668,133415.5761869035,993.0435326254006,134408.61971952888,521,1,305.625,37,3,18,33.01669850704025,0.6525900900900903,41.721491228070164,1033.1140350877179,27.9220009483167,0
524,4,0,0,40,0.0,0.0,1.0,40,1550,1200,350,0.7741935483870968,19,12,7,336.4791140442838,0.7992788461538461,0.11731299734748024,0.2087765404784314,133500.54974848017,984.0293407586789,134484.57908923886,522,2,306.625,37,3,20,32.9459549071618,0.6534346846846848,41.639254385964904,1033.4429824561394,27.930891417733495,0
525,4,0,0,40,0.0,0.0,1.0,40,850,500,350,0.5882352941176471,12,5,7,334.43003046328425,0.7981837606837607,0.12144182840173912,0.20814130410813889,133613.8899108378,936.8994546398666,134550.78936547769,523,3,307.625,37,3,20,32.885579064587965,0.6545608108108109,41.52960526315788,1033.8815789473672,27.94274537695587,0
526,4,0,0,40,0.0,0.0,1.0,40,1200,900,300,0.75,15,9,6,333.69609241741796,0.7985576923076924,0.12237065309584372,0.2081628005080082,133698.92659279768,922.9618728839472,134621.88846568164,524,4,308.625,37,3,20,32.819568136839116,0.6554054054054055,41.44736842105262,1034.2105263157885,27.95163584637266,0
527,4,0,0,40,0.0,0.0,1.0,40,700,500,200,0.7142857142857143,9,5,4,337.7505252376667,0.7979967948717949,0.13014573396926377,0.21117801230068792,133783.99032635018,1037.1226002231201,134821.1129265733,525,5,309.625,37,3,13,32.62972531354884,0.6562500000000002,41.365131578947356,1034.5394736842086,27.960526315789423,0
528,4,0,0,40,0.0,0.0,1.0,40,1350,900,450,0.6666666666666666,18,9,9,336.21110580328184,0.7982638888888889,0.1328010803940265,0.21118889220816914,133954.19894823394,1007.3778710757024,134961.57681930964,526,6,310.625,37,3,14,32.49953659569961,0.6579391891891893,41.200657894736835,1035.1973684210516,27.978307254623015,0
529,4,0,0,40,0.0,0.0,1.0,40,1050,900,150,0.8571428571428571,12,9,3,336.5227511762536,0.7973557692307692,0.13832451032292248,0.21203851800264933,134067.7314774738,1023.3683681517334,135091.09984562555,527,7,311.625,37,3,15,32.37813216869595,0.6590653153153154,41.09100877192982,1035.6359649122803,27.990161213845415,0
530,4,0,0,40,0.0,0.0,1.0,40,950,700,250,0.7368421052631579,12,7,5,336.37050548622045,0.7970352564102564,0.14163138956503385,0.21259965928690924,134181.31209843402,1026.9271554709023,135208.23925390493,528,8,312.625,37,3,17,32.26873655060499,0.6601914414414415,40.9813596491228,1036.074561403508,28.002015173067782,0
531,4,0,1,39,0.0,0.025,0.975,40,1000,900,100,0.9,11,9,2,336.0787358804844,0.7955128205128205,0.14694541415423656,0.21307527097774764,134294.94081111494,1026.7347885887928,135321.67559970374,529,9,313.625,37,3,18,32.16295973059699,0.6613175675675675,40.87171052631579,1036.5131578947367,28.01386913229018,0
532,4,0,0,39,0.0,0.0,1.0,39,950,600,350,0.631578947368421,13,6,7,342.8603658683195,0.7838506522717049,0.15010114857974033,0.21698769509768093,134229.67519884772,1404.4071098125414,135634.08230866026,530,10,322.4102564102564,36,3,18,32.052361805404644,0.6626157407407407,40.9346846846847,1036.2612612612631,28.785035035035087,0
533,4,0,1,38,0.0,0.02564102564102564,0.9743589743589743,39,1500,900,600,0.6,21,9,12,344.43300901512634,0.7812640575798471,0.15649656170828807,0.2193795306382654,134463.16882761163,1462.7107682006626,135925.8795958123,531,11,323.4102564102564,36,3,19,31.778637350705772,0.6649305555555554,40.709459459459474,1037.1621621621641,28.810060060060113,0
534,4,0,0,38,0.0,0.0,1.0,38,1550,1200,350,0.7741935483870968,19,12,7,350.7521545489668,0.7735597439544808,0.16842281465296982,0.22338948521061064,134460.73555652009,1832.4785397376572,136293.21409625775,532,12,332.36842105263156,35,3,20,31.61721627050553,0.6669642857142857,40.71180555555556,1037.1527777777778,29.63293650793651,0
535,4,0,0,38,0.0,0.0,1.0,38,1000,800,200,0.8,12,8,4,348.22018999693535,0.772818871503082,0.16307334601564127,0.22232519822881283,134550.78125000012,1770.659722222236,136321.44097222236,533,13,333.36842105263156,35,3,20,31.593038821954483,0.6678571428571427,40.62500000000001,1037.500000000001,29.642857142857167,0
536,4,0,0,38,0.0,0.0,1.0,38,1250,800,450,0.64,17,8,9,346.3320073115553,0.7719890943575154,0.1596084323207665,0.22185038868357337,134670.88906035665,1728.1678669410155,136399.05692729767,534,14,334.36842105263156,35,3,21,31.52226434730896,0.669047619047619,40.50925925925926,1037.9629629629628,29.65608465608465,0
537,4,0,0,38,0.0,0.0,1.0,38,1150,800,350,0.6956521739130435,15,8,7,347.19797004561076,0.7698850165955429,0.1489663749208061,0.22314184722415614,134791.0504543896,1759.8358196159134,136550.88627400552,535,15,335.36842105263156,35,3,17,31.380034180413137,0.6702380952380952,40.39351851851852,1038.425925925926,29.669312169312175,0
538,4,1,1,38,0.02564102564102564,0.02564102564102564,0.9743589743589743,39,1250,900,350,0.72,16,9,7,338.9308263951574,0.7772717049032839,0.15105703253048852,0.21937808749139578,135047.79061155763,1354.3718549630878,136402.16246652073,536,0,327.7435897435897,36,3,18,31.339156735283503,0.6707175925925926,40.146396396396405,1039.4144144144154,28.87262262262265,0
539,4,0,0,38,0.0,0.0,1.0,38,1250,1000,250,0.8,15,10,5,346.4050597186627,0.7760787102892366,0.14663077040257377,0.22467557050200304,135121.7705788107,1761.373001328859,136883.1435801396,537,1,323.6578947368421,35,3,19,31.071305985379784,0.6735119047619048,40.075231481481474,1039.6990740740728,29.705687830687793,0
540,4,0,0,38,0.0,0.0,1.0,38,850,600,250,0.7058823529411765,11,6,5,346.4050597186627,0.7760787102892366,0.14663077040257377,0.22467557050200304,135121.7705788107,1761.373001328859,136883.1435801396,538,2,324.6578947368421,35,3,19,31.071305985379784,0.6735119047619048,40.075231481481474,1039.6990740740728,29.705687830687793,0
541,4,0,0,38,0.0,0.0,1.0,38,1250,900,350,0.72,16,9,7,348.00152524258027,0.7749525841631105,0.1477719278724241,0.22646558344352422,135242.13291162977,1812.8937060613848,137055.02661769115,539,3,325.6578947368421,35,3,19,30.91004135603278,0.6747023809523809,39.95949074074074,1040.162037037037,29.71891534391534,0
542,4,0,0,38,0.0,0.0,1.0,38,600,400,200,0.6666666666666666,8,4,4,366.4458569030934,0.7749525841631105,0.14039965796073406,0.22630807768742567,133326.80389426593,2171.4109802369985,135498.21487450294,540,4,326.6578947368421,36,2,18,32.34607276560172,0.6536458333333334,41.807432432432435,1032.7702702702707,28.688063063063073,6
543,4,0,0,38,0.0,0.0,1.0,38,750,400,350,0.5333333333333333,11,4,7,366.34063663676903,0.7740931721194879,0.14419744301879822,0.2264202371450437,133355.881219057,2170.735685009348,135526.61690406632,541,5,327.6578947368421,36,2,19,32.31960495711587,0.6539351851851851,41.77927927927929,1032.8828828828837,28.691191191191212,0
544,4,0,0,38,0.0,0.0,1.0,38,1000,700,300,0.7,13,7,6,363.5006258623515,0.7735597439544808,0.14075246979449862,0.22501718904596607,133414.04537983952,2099.217798879981,135513.2631787195,542,6,328.6578947368421,36,2,19,32.33458687595379,0.6545138888888888,41.72297297297298,1033.1081081081097,28.69744744744749,0
545,4,0,0,38,0.0,0.0,1.0,38,800,700,100,0.875,9,7,2,359.9638432776918,0.7741228070175439,0.13481427788483602,0.22371865583250278,133561.93636670522,2015.5062676344614,135577.44263433968,543,7,329.6578947368421,35,3,19,32.27767047363117,0.6580357142857143,41.57986111111111,1033.6805555555552,29.533730158730148,0
546,4,0,0,38,0.0,0.0,1.0,38,1100,600,500,0.5454545454545454,16,6,10,358.4199869006354,0.7732337600758653,0.14115367855754823,0.22402502398027133,133771.3865847908,1989.267725480113,135760.6543102709,544,8,330.6578947368421,35,3,16,32.107760871186684,0.6601190476190476,41.37731481481482,1034.4907407407409,29.55687830687831,0
547,4,0,0,38,0.0,0.0,1.0,38,1500,1200,300,0.8,18,12,6,359.4386385103476,0.7734708392603129,0.1409578122852817,0.22568032549092346,133938.0934989045,2028.5051943835902,135966.59869328808,545,9,331.6578947368421,36,2,16,31.914527125036265,0.6597222222222221,41.216216216216225,1035.1351351351366,28.753753753753795,0
548,4,0,0,38,0.0,0.0,1.0,38,950,500,450,0.5263157894736842,14,5,9,357.2451267179158,0.774656235182551,0.1395915844417479,0.2250154921436957,134054.68813408024,1978.0768099180525,136032.76494399828,546,10,332.6578947368421,36,2,18,31.85465600985938,0.6608796296296295,41.10360360360362,1035.5855855855873,28.766266266266314,0
549,4,0,1,37,0.0,0.02631578947368421,0.9736842105263158,38,800,600,200,0.75,10,6,4,347.50004316273794,0.7752785680417259,0.09421790698073584,0.21939964976348858,134142.16739966327,1722.8817922652502,135865.04919192853,547,11,333.6578947368421,36,2,16,32.01955828532086,0.6617476851851851,41.01914414414415,1035.9234234234243,28.775650650650675,4
550,4,0,0,37,0.0,0.0,1.0,37,850,400,450,0.47058823529411764,13,4,9,351.72686840559845,0.7666416416416416,0.09881113990703083,0.22189188858674191,134113.0044740688,2034.2294152260538,136147.23388929485,548,28,343.3783783783784,36,1,16,31.93923497861855,0.6614583333333333,41.047297297297305,1035.8108108108117,28.77252252252255,0
551,4,0,0,37,0.0,0.0,1.0,37,800,500,300,0.625,11,5,6,354.8724006729112,0.7651401401401401,0.09780370523768012,0.22441106244614836,134200.5027620527,2124.810917336272,136325.31367938896,549,29,344.3783783783784,36,1,17,31.77032387783937,0.6623263888888888,40.962837837837846,1036.1486486486497,28.781906906906936,0
552,4,0,0,37,0.0,0.0,1.0,37,1400,1200,200,0.8571428571428571,16,12,4,354.70094913667697,0.7645145145145145,0.09875259875259879,0.22483936197341442,134288.02958363784,2126.4183102021098,136414.44789383994,550,30,345.3783783783784,36,1,17,31.687309865275964,0.6631944444444444,40.878378378378386,1036.4864864864876,28.791291291291323,0
553,4,0,0,37,0.0,0.0,1.0,37,1050,600,450,0.5714285714285714,15,6,9,342.96174289078164,0.7652027027027027,0.01909857396910386,0.2114417213772398,133263.00643272026,1747.5311564810074,135010.53758920127,551,31,346.3783783783784,35,2,19,33.016314501363816,0.6550595238095238,41.869212962962955,1032.5231481481474,29.500661375661352,3
554,4,0,0,37,0.0,0.0,1.0,37,1350,1100,250,0.8148148148148148,16,11,5,340.55195112430073,0.7643268268268268,0.018074551467648803,0.21046299250922829,133352.6502486281,1682.7010459533412,135035.35129458146,552,32,347.3783783783784,35,2,19,32.98875691020469,0.6559523809523811,41.7824074074074,1032.870370370369,29.510582010581974,0
555,4,0,0,37,0.0,0.0,1.0,37,600,500,100,0.8333333333333334,7,5,2,341.1160249739855,0.763013013013013,0.018744551002615406,0.21149193548387094,133472.22222222207,1705.9027777777596,135178.12499999983,553,33,348.3783783783784,35,2,19,32.85450268817203,0.6571428571428573,41.66666666666666,1033.3333333333321,29.52380952380949,0
556,4,0,0,37,0.0,0.0,1.0,37,850,700,150,0.8235294117647058,10,7,3,338.6065268178398,0.7633258258258259,0.016363878432843704,0.21061514606803242,133591.84777949247,1647.0143175582962,135238.86209705076,554,34,349.3783783783784,35,2,19,32.79967159277503,0.6583333333333334,41.550925925925924,1033.7962962962963,29.537037037037038,0
557,4,0,0,37,0.0,0.0,1.0,37,600,400,200,0.6666666666666666,8,4,4,341.68184776563845,0.7616366366366366,0.019966238905123834,0.21287208005147923,133651.6806520061,1733.2706404320882,135384.95129243817,555,35,350.3783783783784,35,2,19,32.66034251175285,0.6589285714285715,41.49305555555555,1034.0277777777771,29.543650793650777,0
558,4,0,0,37,0.0,0.0,1.0,37,1200,1000,200,0.8333333333333334,14,10,4,340.86541338209383,0.761448948948949,0.030265915462290627,0.21288009779145842,133741.45507812483,1717.567274305542,135459.02235243036,556,36,351.3783783783784,35,2,17,32.59168345082243,0.6598214285714286,41.40624999999999,1034.3749999999986,29.553571428571388,0
559,4,0,0,37,0.0,0.0,1.0,37,1200,900,300,0.75,15,9,6,340.6185171757996,0.7618243243243243,0.02565482055529067,0.21359121883492269,133891.1461012516,1721.1607295953272,135612.3068308469,557,37,352.3783783783784,35,2,17,32.44846417654515,0.6613095238095239,41.26157407407407,1034.9537037037028,29.570105820105795,0
560,4,0,0,37,0.0,0.0,1.0,37,1000,800,200,0.8,12,8,4,340.5847075502191,0.7620745745745746,0.022071266257312816,0.21391781069727245,133951.04595336074,1724.335562414265,135675.381515775,558,38,353.3783783783784,35,2,17,32.389497614788326,0.6619047619047619,41.2037037037037,1035.185185185185,29.576719576719572,0
561,4,0,0,37,0.0,0.0,1.0,37,1050,600,450,0.5714285714285714,15,6,9,340.78845570331976,0.7608858858858859,0.022136364597524993,0.21456962091327236,134040.92084887254,1735.9196834276354,135776.84053230018,559,39,354.3783783783784,35,2,18,32.29446089937038,0.662797619047619,41.116898148148145,1035.532407407407,29.586640211640198,0
562,4,0,0,37,0.0,0.0,1.0,37,650,300,350,0.46153846153846156,10,3,7,341.14594608681534,0.759009009009009,0.024107226430989392,0.2154973439254116,134160.80092860505,1753.6826721107627,135914.48360071582,560,40,355.3783783783784,35,2,21,32.16551688824341,0.6639880952380952,41.001157407407405,1035.9953703703698,29.599867724867707,0
563,4,0,0,37,0.0,0.0,1.0,37,750,500,250,0.6666666666666666,10,5,5,341.14594608681534,0.759009009009009,0.024107226430989392,0.2154973439254116,134160.80092860505,1753.6826721107627,135914.48360071582,561,41,356.3783783783784,35,2,21,32.16551688824341,0.6639880952380952,41.001157407407405,1035.9953703703698,29.599867724867707,0
564,4,0,0,37,0.0,0.0,1.0,37,700,300,400,0.42857142857142855,11,3,8,346.16783850203063,0.759009009009009,0.03328669268723794,0.1954516872773004,129908.37191358033,1594.5860393089943,131502.95795288932,562,42,357.3783783783784,35,2,17,36.31641689373295,0.6214285714285714,45.13888888888889,1019.444444444445,29.126984126984144,7
565,4,0,0,37,0.0,0.0,1.0,37,850,700,150,0.8235294117647058,10,7,3,345.0947706051102,0.7597597597597597,0.035700588771312214,0.19499293356384959,129937.87140185611,1568.1759848679687,131506.0473867241,563,43,358.3783783783784,35,2,17,36.31383149808907,0.6217261904761904,45.1099537037037,1019.560185185185,29.130291005291,0
566,4,1,1,37,0.02631578947368421,0.02631578947368421,0.9736842105263158,38,1000,700,300,0.7,13,7,6,337.6628431003835,0.7702702702702703,0.03615444481873342,0.19196365647275274,130176.38204082476,1191.1454528853285,131367.52749371008,564,0,349.92105263157896,36,2,17,36.261540866622525,0.6221064814814814,44.87612612612613,1020.4954954954967,28.34709709709713,0
567,4,0,0,37,0.0,0.0,1.0,37,800,500,300,0.625,11,5,6,346.7190352430196,0.7594469469469469,0.04512989103934273,0.1965038493631337,130055.9028447573,1618.5714323988177,131674.4742771561,565,45,360.3783783783784,35,2,17,36.15267691667611,0.6229166666666668,44.994212962962955,1020.0231481481475,29.143518518518498,0
568,4,2,2,37,0.05128205128205128,0.05128205128205128,0.9487179487179487,39,1100,800,300,0.7272727272727273,14,8,6,333.97199640048893,0.776259559154296,0.031612374175156166,0.19138690421031715,130486.54994806103,915.7707179132155,131402.32066597426,566,0,342.84615384615387,37,2,17,36.04180081562568,0.6233108108108107,44.57236842105264,1021.7105263157902,27.613798008534868,0
569,4,1,0,38,0.02631578947368421,0.0,1.0,38,900,500,400,0.5555555555555556,13,5,8,344.70746827618564,0.7662991939307728,0.005593188924828407,0.19389519765081537,129760.92470689729,1348.6171266580404,131109.54183355533,567,0,352.8421052631579,35,3,17,36.50329906471279,0.6199404761904761,45.28356481481482,1018.8657407407408,29.110449735449738,6
570,4,0,0,38,0.0,0.0,1.0,38,1350,1100,250,0.8148148148148148,16,11,5,343.2729599380676,0.7672771455666193,0.0026238091253567575,0.193525075878017,129849.38298396782,1314.7564086076832,131164.1393925755,568,1,353.8421052631579,35,3,18,36.450052994170626,0.6208333333333333,45.19675925925926,1019.2129629629635,29.120370370370384,0
571,4,4,3,39,0.09523809523809523,0.07142857142857142,0.9285714285714286,42,1150,900,250,0.782608695652174,14,9,5,316.82478570429237,0.7987320944638018,0.00913139015410569,0.18263469884081274,130714.91021050357,-117.25531684027223,130597.6548936633,569,0,321.04761904761904,39,3,13,36.24929968422125,0.6220619658119659,44.348958333333336,1022.6041666666674,26.220619658119677,0
572,4,1,1,39,0.025,0.025,0.975,40,1000,900,100,0.9,11,9,2,328.8532149131588,0.7811965811965812,0.016372464856744706,0.1885897298323526,130514.5588666706,584.0264552554767,131098.58532192608,570,0,338.075,37,3,14,36.144234896448125,0.6235923423423422,44.544956140350884,1021.8201754385972,27.616761498340463,0
573,4,1,0,40,0.025,0.0,1.0,40,800,600,200,0.75,10,6,4,334.67044899574654,0.7816506410256411,0.04131996568732532,0.1929009028018747,130710.70545744846,749.0020967990135,131459.7075542475,571,0,339.05,37,3,15,35.79732289656157,0.6255630630630631,44.353070175438596,1022.5877192982458,27.637505926979617,0
574,4,0,0,40,0.0,0.0,1.0,40,1050,900,150,0.8571428571428571,12,9,3,334.4717739109858,0.7804220085470085,0.03877277599142581,0.19334706633144344,130822.85534972293,751.3104993844172,131574.16584910735,572,1,340.05,37,3,16,35.68908538763844,0.6266891891891893,44.243421052631575,1023.0263157894731,27.649359886201974,0
575,4,1,1,40,0.024390243902439025,0.024390243902439025,0.975609756097561,41,800,600,200,0.75,10,6,4,326.7969657971967,0.7883130081300813,0.04187874099108235,0.1900498859344862,131054.49631090659,365.64234969683594,131420.13866060344,573,0,332.7317073170732,38,3,17,35.65165031997775,0.6271929824561404,44.01709401709402,1023.9316239316241,26.945569050832216,0
576,4,0,0,40,0.0,0.0,1.0,40,1050,900,150,0.8571428571428571,12,9,3,334.2370413447795,0.7800213675213675,0.05113538988860378,0.19405702848226708,130991.17036011055,756.4202446906484,131747.5906048012,574,3,342.05,37,3,18,35.525117823479015,0.6283783783783785,44.07894736842104,1023.6842105263138,27.667140825035506,0
577,4,0,0,40,0.0,0.0,1.0,40,1350,1200,150,0.8888888888888888,15,12,3,334.2747729062588,0.7795138888888888,0.053485821294810165,0.19535945921256948,131243.84576263835,774.3013475299874,132018.14711016833,575,4,343.05,37,3,20,35.269194756554306,0.6309121621621623,43.83223684210525,1024.6710526315776,27.693812233285882,0
578,4,0,0,40,0.0,0.0,1.0,40,900,700,200,0.7777777777777778,11,7,4,333.3385667698014,0.7782318376068376,0.04596561573107749,0.19538834341954292,131356.98356718203,757.2967790905589,132114.2803462726,576,5,344.05,36,4,21,35.17910762019845,0.6339699074074074,43.721846846846844,1025.1126126126126,28.47535035035035,0
579,4,1,0,41,0.024390243902439025,0.0,1.0,41,1050,800,250,0.7619047619047619,13,8,5,327.28654015863174,0.7838922764227643,0.06499201409063482,0.1935394379295612,131693.64762474995,420.31165839488665,132113.95928314482,577,0,336.6341463414634,37,4,14,34.99525958765088,0.6354166666666667,43.39364035087719,1026.4254385964914,27.741228070175442,0
580,4,0,0,41,0.0,0.0,1.0,41,900,600,300,0.6666666666666666,12,6,6,324.64529176709226,0.7830792682926829,0.06676979005536432,0.19268870739484037,131834.36850761747,359.8814058171518,132194.2499134346,578,1,337.6341463414634,37,4,15,34.92152466367713,0.6368243243243243,43.25657894736841,1026.9736842105244,27.75604551920336,0
581,4,0,0,41,0.0,0.0,1.0,41,950,700,250,0.7368421052631579,12,7,5,324.51534777621174,0.7830284552845529,0.06878631980171246,0.1928971940334738,131890.6779008924,360.10984148967077,132250.78774238206,579,2,338.6341463414634,37,4,16,34.86825718758895,0.6373873873873874,43.201754385964904,1027.192982456139,27.761972498814565,0
582,4,0,1,40,0.0,0.024390243902439025,0.975609756097561,41,1350,1000,350,0.7407407407407407,17,10,7,323.5423749107446,0.7830792682926829,0.06957191517930306,0.19303390706800788,132031.50398439888,343.557272429956,132375.06125682883,580,3,339.6341463414634,37,4,18,34.751747039368404,0.638795045045045,43.06469298245613,1027.741228070174,27.77678994784254,0
583,4,0,0,40,0.0,0.0,1.0,40,1850,1400,450,0.7567567567567568,23,14,9,329.58222438104605,0.7816239316239316,0.07145789992335572,0.19764113297912622,132224.21481870383,715.7501673971316,132939.96498610097,581,4,340.225,36,4,19,34.40294353808535,0.642650462962963,42.877252252252255,1028.490990990991,28.569194194194193,0
584,4,0,0,40,0.0,0.0,1.0,40,1250,800,450,0.64,17,8,9,328.04986703580835,0.7800213675213675,0.06527171017581224,0.19748223233682216,132369.79316953273,684.7786097645162,133054.57177929726,582,5,341.225,37,3,20,34.29619516959688,0.6421734234234235,42.735745614035075,1029.057017543858,27.812351825509673,0
585,4,0,0,40,0.0,0.0,1.0,40,700,400,300,0.5714285714285714,10,4,6,328.28933415445465,0.7809561965811965,0.06553248136315237,0.19836787951803928,132510.8747403047,700.3813673437962,133211.25610764849,583,6,342.225,37,3,20,34.14847355342564,0.643581081081081,42.598684210526315,1029.6052631578946,27.82716927453769,0
586,4,0,0,40,0.0,0.0,1.0,40,800,700,100,0.875,9,7,2,327.52467911053066,0.7807692307692308,0.0649371738898945,0.19805436326638712,132539.10007165655,681.965244113558,133221.0653157701,584,7,343.225,37,3,20,34.139845774322936,0.6438626126126126,42.571271929824555,1029.714912280701,27.83013276434327,0
587,4,0,0,40,0.0,0.0,1.0,40,800,500,300,0.625,11,5,6,328.1249511316139,0.7794070512820512,0.06375878220140518,0.19886488973744396,132623.7941001078,703.4351915974205,133327.2292917052,585,8,344.225,37,3,20,34.039457809949596,0.6447072072072071,42.4890350877193,1030.0438596491233,27.839023233760088,0
588,4,0,0,40,0.0,0.0,1.0,40,1200,900,300,0.75,15,9,6,327.96622269149367,0.7776976495726495,0.06563730184062133,0.19951809236746598,132765.01092884352,708.487827985536,133473.49875682907,586,9,345.225,37,3,16,33.90198868673973,0.6461148648648647,42.35197368421053,1030.5921052631581,27.853840682788057,0
589,4,1,0,41,0.024390243902439025,0.0,1.0,41,1000,700,300,0.7,13,7,6,321.23567763589335,0.7860264227642276,0.06365702166338427,0.19740054999762935,133141.23109796204,353.94271860619756,133495.17381656825,587,0,337.780487804878,38,3,19,33.698887163561075,0.6480263157894736,41.987179487179496,1032.0512820512834,27.159244264507457,0
590,4,0,0,41,0.0,0.0,1.0,41,900,600,300,0.6666666666666666,12,6,6,323.81939301841885,0.7842479674796748,0.07185595497962183,0.19972651139266254,133279.09412895414,431.6710725765463,133710.76520153068,588,1,338.780487804878,38,3,19,33.49435247456458,0.6493969298245613,41.85363247863249,1032.585470085472,27.173301844354526,0
591,4,0,0,41,0.0,0.0,1.0,41,950,600,350,0.631578947368421,13,6,7,323.22892080780514,0.7832317073170731,0.07717984493385854,0.19965840111495564,133334.25931633092,419.4977491051521,133753.75706543608,589,2,339.780487804878,38,3,19,33.454449846557026,0.6499451754385963,41.80021367521369,1032.7991452991475,27.178924876293355,0
592,4,0,0,41,0.0,0.0,1.0,41,1000,600,400,0.6,14,6,8,326.99149126422657,0.7824186991869919,0.08466021894609255,0.20289390908261054,133501.315399014,530.9015200398369,134032.21691905384,590,3,340.780487804878,36,5,19,33.19031273836765,0.6553819444444444,41.63851351351352,1033.4459459459472,28.706831831831867,0
593,4,0,0,41,0.0,0.0,1.0,41,950,700,250,0.7368421052631579,12,7,5,327.65609426377546,0.7814532520325204,0.08403593568564527,0.2036259505245224,133559.51126379764,552.3175624949363,134111.8288262926,591,4,341.780487804878,36,5,20,33.114990739732,0.6559606481481481,41.58220720720721,1033.6711711711716,28.7130880880881,0
594,4,0,1,40,0.0,0.024390243902439025,0.975609756097561,41,1150,1000,150,0.8695652173913043,13,10,3,328.22594776894164,0.7822154471544716,0.08652255094912897,0.20462314177611615,133675.94103816658,575.1824882314784,134251.12352639806,592,5,342.780487804878,36,5,20,32.98395586046681,0.6571180555555556,41.4695945945946,1034.121621621622,28.725600600600607,0
595,4,0,0,40,0.0,0.0,1.0,40,850,500,350,0.5882352941176471,12,5,7,333.9513848853672,0.7811698717948717,0.0827000559597093,0.20822439804262077,133681.6021117327,928.6312317815568,134610.23334351426,593,6,339.325,35,5,20,32.830278865883244,0.6592261904761905,41.464120370370374,1034.1435185185187,29.546957671957678,0
596,4,0,0,40,0.0,0.0,1.0,40,1050,800,250,0.7619047619047619,13,8,5,334.00550938575225,0.7805288461538461,0.08086392121754704,0.20842690166697522,133711.52692043904,932.0773319616019,134643.60425240063,594,7,340.325,35,5,17,32.79897791703969,0.6595238095238094,41.43518518518519,1034.25925925926,29.550264550264572,0
597,4,1,0,41,0.024390243902439025,0.0,1.0,41,700,500,200,0.7142857142857143,9,5,4,324.18689227527267,0.7883638211382114,0.08045013449916993,0.20386965031319135,133996.38447569194,487.9742918594337,134484.35876755137,595,0,333.0,36,5,18,32.76865346965414,0.6603009259259258,41.15990990990991,1035.3603603603606,28.760010010010017,0
598,4,0,0,41,0.0,0.0,1.0,41,1100,600,500,0.5454545454545454,16,6,10,327.4610456352747,0.7876016260162602,0.08025416559482523,0.20641941307111888,134083.84471887443,581.4471988880987,134665.29191776254,596,1,334.0,36,5,19,32.596680076836655,0.6611689814814814,41.07545045045046,1035.6981981981996,28.769394394394435,0
599,4,1,1,41,0.023809523809523808,0.023809523809523808,0.9761904761904762,42,1400,1000,400,0.7142857142857143,18,10,8,321.4764759606161,0.7899003097173829,0.08391749254693415,0.20429311536852054,134380.1939058172,240.0142351492782,134620.20814096648,597,0,327.0238095238095,37,5,20,32.45646503102087,0.6621621621621621,40.78947368421053,1036.8421052631581,28.022759601706976,0
600,4,1,0,42,0.023809523809523808,0.0,1.0,42,1300,1000,300,0.7692307692307693,16,10,6,352.5817094590769,0.7945702671312428,0.16282433641515093,0.20446324313668,130945.1247351887,908.8062918489552,131853.93102703764,598,0,318.3333333333333,38,4,17,35.102209464161454,0.6260964912280702,44.12393162393162,1023.5042735042724,26.934322986954538,8
601,4,0,1,41,0.0,0.023809523809523808,0.9761904761904762,42,700,400,300,0.5714285714285714,10,4,6,350.560020386374,0.7941105303910182,0.15535695651525794,0.20372448000986187,131027.14913662434,786.5760145006986,131813.72515112505,599,1,319.3333333333333,38,4,17,35.07100246965112,0.6269188596491228,44.04380341880342,1023.8247863247866,26.942757534862807,0
602,4,0,1,40,0.0,0.024390243902439025,0.975609756097561,41,900,600,300,0.6666666666666666,12,6,6,354.02636651066194,0.7895833333333333,0.15287606397190734,0.20603173788735257,131081.84633875746,1081.285954963851,132163.1322937213,600,2,315.1707317073171,38,3,17,34.92696922274387,0.6274671052631577,43.99038461538462,1024.0384615384621,26.948380566801635,0
603,4,0,0,40,0.0,0.0,1.0,40,1050,500,550,0.47619047619047616,16,5,11,360.08165863737815,0.7822916666666667,0.1485754070265639,0.20906233613423877,130991.17036011073,1433.5035780239982,132424.6739381347,601,3,323.925,37,3,17,34.86369965724079,0.6283783783783784,44.07894736842105,1023.6842105263152,27.667140825035546,0
604,4,1,0,41,0.024390243902439025,0.0,1.0,41,700,400,300,0.5714285714285714,10,4,6,353.94752020118955,0.7865345528455284,0.1561219741068225,0.20686841354354715,131246.00643080214,1090.8397024983558,132336.84613330048,602,0,317.0,38,3,18,34.76305911792304,0.6291118421052632,43.830128205128204,1024.6794871794873,26.96524966261809,0
605,4,0,2,39,0.0,0.04878048780487805,0.9512195121951219,41,850,400,450,0.47058823529411764,13,4,9,352.9645052548086,0.7857215447154472,0.15744596470354955,0.20673635307781651,131328.125,1070.8590154503624,132398.98401545038,603,1,318.0,37,4,18,34.70528455284553,0.6317567567567568,43.75,1025.0,27.7027027027027,0
606,4,0,0,39,0.0,0.0,1.0,39,1100,700,400,0.6363636363636364,15,7,8,362.6600576676592,0.7903171390013496,0.14638889358607976,0.21177671403468326,131212.72243527317,1717.1226970213518,132929.84513229452,604,2,310.3333333333333,36,3,19,34.57353264453726,0.6325231481481481,43.862612612612615,1024.54954954955,28.45970970970972,0
607,4,0,0,39,0.0,0.0,1.0,39,1050,800,250,0.7619047619047619,13,8,5,364.3345283863644,0.7895299145299146,0.14892465180373016,0.21356127848564072,131357.78523930474,1771.68607340997,133129.4713127147,605,3,311.3333333333333,35,4,19,34.38393831620941,0.6360119047619047,43.72106481481482,1025.115740740741,29.289021164021175,0
608,4,0,0,39,0.0,0.0,1.0,39,750,500,250,0.6666666666666666,10,5,5,364.43325037295944,0.7893049932523617,0.15396443205339416,0.2139371208669117,131414.7102127467,1778.3779979303772,133193.08821067706,606,4,312.3333333333333,36,3,19,34.32386051619988,0.634548611111111,43.66554054054055,1025.337837837839,28.48160660660664,0
609,4,0,1,38,0.0,0.02564102564102564,0.9743589743589743,39,700,400,300,0.5714285714285714,10,4,6,339.6338064803805,0.7893049932523617,0.10914014146772777,0.18941116130636595,129424.43828870416,995.0479080656523,130419.48619676981,607,5,313.3333333333333,37,2,18,36.97422772988505,0.6126126126126126,45.614035087719294,1017.5438596491223,27.501185395922224,7
610,4,2,1,39,0.05,0.025,0.975,40,950,600,350,0.631578947368421,13,6,7,333.88484838652323,0.7971688034188035,0.11561877294179368,0.18760118028081874,129717.84056770016,662.1643061947353,130380.0048738949,608,0,305.7,38,2,17,36.82267086173745,0.6137609649122808,45.32585470085469,1018.6965811965796,26.807804768331042,0
611,4,0,0,39,0.0,0.0,1.0,39,650,500,150,0.7692307692307693,8,5,3,342.7757152527649,0.7904295996401259,0.1147467651882903,0.19197920939910568,129591.8515793319,1084.187923207115,130676.039502539,609,1,314.53846153846155,37,2,17,36.72419053772704,0.6143018018018018,45.44956140350876,1018.2017543859632,27.518966334755763,0
612,4,0,0,39,0.0,0.0,1.0,39,1100,900,200,0.8181818181818182,13,9,4,341.92750937701794,0.7909356725146199,0.11459636160831388,0.19164036086809672,129619.76431450043,1064.1126356186282,130683.87695011905,610,2,315.53846153846155,37,2,17,36.71743207350776,0.6145833333333335,45.42214912280701,1018.3114035087705,27.521929824561365,0
613,4,0,0,39,0.0,0.0,1.0,39,1300,900,400,0.6923076923076923,17,9,8,338.5597875889332,0.7908232118758435,0.10251995099175493,0.19042963355183795,129759.37307633094,986.261157279135,130745.63423361008,611,3,316.53846153846155,37,2,17,36.66146505954943,0.6159909909909911,45.28508771929823,1018.8596491228052,27.53674727358933,0
614,4,1,0,40,0.025,0.0,1.0,40,600,500,100,0.8333333333333334,7,5,2,335.52126444592716,0.7974358974358975,0.11592051523719804,0.19036794736744836,130099.04308431942,730.199087771195,130829.24217209061,612,0,309.6,38,2,18,36.39451775054981,0.6175986842105263,44.95192307692307,1020.1923076923068,26.847165991902813,0
615,4,1,1,40,0.024390243902439025,0.024390243902439025,0.975609756097561,41,1100,800,300,0.7272727272727273,14,8,6,330.19104268218496,0.803099593495935,0.11505507955936367,0.18864760970024128,130368.9453125,409.3315972222224,130778.27690972222,613,0,303.0243902439024,39,2,18,36.25730994152046,0.6185897435897436,44.6875,1021.25,26.185897435897434,0
616,4,0,0,40,0.0,0.0,1.0,40,1050,800,250,0.7619047619047619,13,8,5,334.01535900603943,0.7959401709401709,0.11530553520979403,0.19057819618034139,130317.12420784937,705.5842053838863,131022.70841323325,614,2,311.6,38,2,19,36.21211328520108,0.6197916666666666,44.738247863247864,1021.0470085470085,26.86965811965812,0
617,4,1,0,41,0.024390243902439025,0.0,1.0,41,1150,800,350,0.6956521739130435,15,8,7,328.778280508242,0.8006605691056911,0.12515372785387213,0.18952533057835677,130714.91021050366,395.24468315974224,131110.1548936634,615,0,304.9756097560976,39,2,14,35.943707344402576,0.6220619658119657,44.34895833333334,1022.6041666666681,26.220619658119695,0
618,4,0,0,41,0.0,0.0,1.0,41,1000,700,300,0.7,13,7,6,329.80616473301495,0.7993394308943089,0.12686900799761536,0.19051156103989464,130794.81336805562,427.3871527777825,131222.2005208334,616,1,305.9756097560976,39,2,14,35.836727766463,0.6228632478632479,44.270833333333336,1022.9166666666672,26.22863247863249,0
619,4,0,0,41,0.0,0.0,1.0,41,1050,800,250,0.7619047619047619,13,8,5,328.2926078791291,0.7990853658536585,0.12266624294907502,0.1901619445639482,130901.38888888879,394.7916666666613,131296.18055555545,617,2,306.9756097560976,39,2,14,35.767847448425634,0.6239316239316239,44.166666666666664,1023.3333333333325,26.239316239316217,0
620,4,0,1,40,0.0,0.024390243902439025,0.975609756097561,41,1600,1100,500,0.6875,21,11,10,333.3559582459102,0.7970020325203252,0.12765070908793308,0.19443787030784576,131168.01757812497,545.1280381944434,131713.1456163194,618,3,307.9756097560976,39,2,14,35.36921225679614,0.6266025641025641,43.90625,1024.3749999999998,26.266025641025635,0
621,4,0,0,40,0.0,0.0,1.0,40,1150,800,350,0.6956521739130435,15,8,7,343.2230954853517,0.7948985042735043,0.1245514759570252,0.20002916817131083,131136.5549551646,1001.8188645992991,132138.37381976392,619,4,316.15,38,2,15,35.14829108862695,0.6280153508771931,43.936965811965806,1024.2521367521358,26.954003598740417,0
622,4,1,1,40,0.024390243902439025,0.024390243902439025,0.975609756097561,41,1150,800,350,0.6956521739130435,15,8,7,334.561876773688,0.8002540650406504,0.1248528730334546,0.1963680711439123,131408.21533203122,592.8358289930547,132001.05116102428,620,0,309.4146341463415,39,2,16,35.096113143011955,0.6290064102564104,43.671875,1025.3124999999998,26.290064102564095,0
623,4,0,0,40,0.0,0.0,1.0,40,950,700,250,0.7368421052631579,12,7,5,339.68394898335396,0.7935363247863247,0.13378399499843696,0.1993851289537155,131410.2692513149,927.5918392504934,132337.8610905654,621,6,318.15,38,2,16,34.962748775659065,0.6307565789473684,43.669871794871796,1025.3205128205127,26.982118758434545,0
624,4,0,0,40,0.0,0.0,1.0,40,1350,1100,250,0.8148148148148148,16,11,5,342.2065219597347,0.7945779914529915,0.1344283631820078,0.20187662388828576,131602.0390459493,1007.0152129446997,132609.054258894,622,7,319.15,38,2,13,34.704723726225176,0.6326754385964912,43.48290598290598,1026.068376068376,27.00179937022042,0
625,4,1,0,41,0.024390243902439025,0.0,1.0,41,750,700,50,0.9333333333333333,8,7,1,338.2517104014751,0.8034552845528455,0.14665799501957322,0.20133835966745625,131942.77479383687,725.9738498263991,132668.74864366328,623,0,312.3414634146341,39,2,15,34.46308171955795,0.6343482905982906,43.15104166666667,1027.395833333334,26.34348290598292,0
626,4,0,0,41,0.0,0.0,1.0,41,800,500,300,0.625,11,5,6,338.1001901612126,0.8036077235772358,0.14452159120131314,0.2013901132699399,131969.53125000015,723.784722222237,132693.3159722224,624,1,313.3414634146341,39,2,15,34.440051365233856,0.6346153846153846,43.12500000000001,1027.5000000000011,26.346153846153875,0
627,4,0,0,41,0.0,0.0,1.0,41,1200,800,400,0.6666666666666666,16,8,8,335.43873577925,0.8039126016260163,0.13855082207084735,0.20036982110591048,132076.58420138902,660.7204861111308,132737.30468750015,625,2,314.3414634146341,39,2,15,34.400756654506154,0.6356837606837606,43.02083333333334,1027.9166666666679,26.356837606837637,0
628,4,0,0,41,0.0,0.0,1.0,41,1000,600,400,0.6,14,6,8,332.5359912602077,0.8038617886178862,0.13807877720150907,0.19905777863732646,132156.9023980036,589.3853081597417,132746.28770616336,626,3,315.3414634146341,39,2,15,34.394628203829406,0.6364850427350428,42.94270833333334,1028.2291666666679,26.364850427350458,0
629,4,0,0,41,0.0,0.0,1.0,41,750,600,150,0.8,9,6,3,341.91727502391876,0.8038617886178862,0.15306239882153472,0.19238141899133415,129772.26382725182,796.894036869249,130569.15786412107,627,4,316.3414634146341,38,3,13,36.562860438292965,0.6143092105263158,45.2724358974359,1018.9102564102566,26.81342780026991,7
630,4,1,1,41,0.023809523809523808,0.023809523809523808,0.9761904761904762,42,950,700,250,0.7368421052631579,12,7,5,334.7544972308378,0.8129355400696864,0.14420650318740735,0.1898234389914071,130076.56385633704,308.7429470486316,130385.30680338568,628,0,309.7857142857143,39,3,13,36.43684689744375,0.6156517094017093,44.97395833333334,1020.1041666666686,26.156517094017143,0
631,4,0,0,41,0.0,0.0,1.0,41,950,500,450,0.5263157894736842,14,5,9,344.7385808287524,0.803150406504065,0.14500788141850252,0.19532458345234993,130044.5513391225,766.274814632174,130810.82615375466,629,6,318.3414634146341,38,3,13,36.2146922244335,0.6170504385964912,45.005341880341874,1019.9786324786312,26.841542959963977,0
632,4,1,0,42,0.023809523809523808,0.0,1.0,42,1500,1200,300,0.8,18,12,6,348.1333927704883,0.8051684088269454,0.16224940536867138,0.19971863058938544,130528.56445312504,688.2703993055569,131216.8348524306,630,0,311.73809523809524,39,3,13,35.63752973156642,0.6201923076923077,44.53125,1021.8750000000003,26.201923076923087,0
633,4,2,0,44,0.045454545454545456,0.0,1.0,44,850,500,350,0.5882352941176471,12,5,7,340.5044527434645,0.8163979915433404,0.19178736517719552,0.19851544181684191,131150.23389274688,131.44772376542494,131281.6816165123,631,0,298.52272727272725,41,3,15,35.20409604519773,0.6232215447154472,43.92361111111111,1024.3055555555552,24.983062330623298,0
634,4,1,0,45,0.022222222222222223,0.0,1.0,45,800,600,200,0.75,10,6,4,332.4043724205744,0.8231060606060606,0.19517406195967024,0.19509178088139473,131406.26161882802,-263.7556883487223,131142.5059304793,632,0,292.8666666666667,40,5,16,35.153384874615924,0.6273437500000001,43.673780487804876,1025.3048780487802,25.632621951219505,0
635,4,0,0,45,0.0,0.0,1.0,45,1250,800,450,0.64,17,8,9,332.30606602037113,0.8236531986531987,0.18826249215627988,0.19556647955356285,131510.47992473052,-259.6539551523726,131250.82596957815,633,1,293.8666666666667,40,5,16,35.05090161498069,0.6283854166666667,43.57215447154471,1025.71138211382,25.6427845528455,0
636,4,0,1,44,0.0,0.022222222222222223,0.9777777777777777,45,950,700,250,0.7368421052631579,12,7,5,330.74403319260296,0.8235690235690236,0.18434583553442474,0.19504624761171258,131588.6707647564,-295.566461762184,131293.1043029942,634,2,294.8666666666667,40,5,13,35.01221605916533,0.6291666666666667,43.49593495934959,1026.0162601626014,25.650406504065035,0
637,4,0,0,44,0.0,0.0,1.0,44,1100,800,300,0.7272727272727273,14,8,6,332.34478914948727,0.8226964411557435,0.17168067529382136,0.1967964279008278,131745.12215777647,-43.03903100006352,131702.08312677642,635,3,288.20454545454544,40,4,13,34.81365076222531,0.6307291666666668,43.34349593495935,1026.6260162601627,25.665650406504067,0
638,4,0,0,44,0.0,0.0,1.0,44,1600,1000,600,0.625,22,10,12,329.18528470565036,0.8226083509513742,0.17233236781030126,0.19546101570125177,131849.47472569245,-119.41862482648887,131730.05610086594,636,4,289.20454545454544,40,4,14,34.78977010356881,0.6317708333333333,43.24186991869919,1027.032520325204,25.6758130081301,0
639,4,0,1,43,0.0,0.022727272727272728,0.9772727272727273,44,1600,1100,500,0.6875,21,11,10,356.11806851207814,0.8228505990133897,0.20780319342300269,0.19656024460658167,129016.12548828125,532.1463909725329,129548.27187925378,637,5,290.20454545454544,39,5,16,36.970782494275284,0.6049679487179487,46.015625,1015.9375,26.049679487179485,8
640,4,0,0,43,0.0,0.0,1.0,43,900,700,200,0.7777777777777778,11,7,4,362.0600362795907,0.8162144702842377,0.21871766458496933,0.1995423052121777,128957.11343277435,738.0434335963048,129695.15686637066,638,7,297.83720930232556,38,5,16,36.880062059535085,0.6060855263157896,46.07371794871794,1015.7051282051272,26.72908232118756,0
641,4,1,1,43,0.022727272727272728,0.022727272727272728,0.9772727272727273,44,1250,800,450,0.64,17,8,9,354.4103383504159,0.8199876673713883,0.21238788006151643,0.1966719061271665,129228.5448740776,360.21760172399786,129588.7624758016,639,0,292.04545454545456,38,6,16,36.79774788974115,0.6088267543859649,45.806623931623925,1016.7735042735034,26.75719748088167,0
642,4,3,2,44,0.06521739130434782,0.043478260869565216,0.9565217391304348,46,850,600,250,0.7058823529411765,11,6,5,344.67079105267334,0.8319645732689211,0.216378416598346,0.1935369937658791,129692.62390318248,-259.74814511865975,129432.87575806382,640,0,280.2826086956522,40,6,16,36.5735890784529,0.6101562500000001,45.350609756097555,1018.5975609756085,25.464939024390212,0
643,4,0,0,44,0.0,0.0,1.0,44,950,600,350,0.631578947368421,13,6,7,366.38646878860163,0.8204281183932347,0.19485287573206134,0.19884545123309122,128345.50284234065,604.8111142605231,128950.31395660117,641,1,294.02272727272725,41,3,18,37.39516023758242,0.595020325203252,46.676587301587304,1013.2936507936508,24.714479287650022,5
644,4,2,0,46,0.043478260869565216,0.0,1.0,46,1200,800,400,0.6666666666666666,16,8,8,373.32556388937326,0.8324074074074075,0.23872628071273705,0.20616514406432299,129036.70374657087,434.54003772292896,129471.2437842938,642,0,282.19565217391306,44,2,17,36.51272821167109,0.5977746212121211,45.99537037037038,1016.0185185185203,23.091329966330008,0
645,4,1,1,46,0.02127659574468085,0.02127659574468085,0.9787234042553191,47,1050,800,250,0.7619047619047619,13,8,5,366.40529130218135,0.838613937711995,0.24284208166958576,0.20370862507754695,129302.2683610482,75.82715699449176,129378.0955180427,643,0,277.17021276595744,41,6,17,36.417690857068536,0.6046747967479674,45.73412698412699,1017.0634920634927,24.806426635694944,0
646,4,2,2,46,0.041666666666666664,0.041666666666666664,0.9583333333333334,48,1300,1000,300,0.7692307692307693,16,10,6,361.731576391347,0.8413489952718676,0.24740019217655362,0.2028186325606128,129634.99070965366,-221.38609102384854,129413.60461862982,644,0,272.3541666666667,43,5,14,36.19777137189262,0.6051356589147285,45.40719696969698,1018.3712121212146,23.68305144467941,0
647,4,0,0,46,0.0,0.0,1.0,46,700,200,500,0.2857142857142857,12,2,10,373.6751212762345,0.8338365539452496,0.2575969396184692,0.20922137314009792,129579.88989866784,484.1562145691632,130064.046113237,645,1,282.5,41,5,15,35.94983192049108,0.6074695121951219,45.461309523809526,1018.1547619047622,24.833042973286883,0
648,4,0,1,45,0.0,0.021739130434782608,0.9782608695652174,46,900,600,300,0.6666666666666666,12,6,6,371.402972002592,0.8339774557165862,0.2613904911950802,0.2083509787201425,129655.65653344667,430.89923469387156,130086.55576814055,646,2,283.5,41,5,16,35.930498733684,0.6082317073170731,45.38690476190476,1018.4523809523806,24.84030197444831,0
649,4,1,1,45,0.021739130434782608,0.021739130434782608,0.9782608695652174,46,1850,1500,350,0.8108108108108109,22,15,7,371.18342315300737,0.8314814814814815,0.2616136312904589,0.20922332501196841,129842.5246755002,439.0785559761947,130281.6032314764,647,0,284.39130434782606,42,4,17,35.74586423274386,0.6086309523809523,45.20348837209302,1019.1860465116274,24.266334440753035,0
650,4,0,0,45,0.0,0.0,1.0,45,1100,600,500,0.5454545454545454,16,6,10,374.7047174240914,0.8253787878787879,0.26156059671783605,0.21088176178974444,129781.98346757663,725.984288391261,130507.9677559679,648,1,291.35555555555555,41,4,17,35.7177773991497,0.6095020325203253,45.262896825396815,1018.948412698411,24.85240030971734,0
651,4,0,2,43,0.0,0.044444444444444446,0.9555555555555556,45,1450,1100,350,0.7586206896551724,18,11,7,375.3004478986802,0.8250420875420876,0.26677044820652607,0.2121748076734118,129958.94451530582,754.7300170067751,130713.6745323126,649,2,292.35555555555555,41,4,17,35.522475189725625,0.6112804878048781,45.0892857142857,1019.6428571428547,24.869337979094016,0
652,4,2,1,44,0.044444444444444446,0.022222222222222223,0.9777777777777777,45,1050,800,250,0.7619047619047619,13,8,5,368.42894743382783,0.8288299663299664,0.2716815162438506,0.21020608514239683,130315.76063368046,603.1283216411468,130918.88895532161,650,0,291.53333333333336,39,6,18,35.3350506699313,0.6180555555555556,44.73958333333333,1021.0416666666658,26.180555555555536,0
653,4,3,4,43,0.06382978723404255,0.0851063829787234,0.9148936170212766,47,1050,600,450,0.5714285714285714,15,6,9,365.70407476041515,0.8370336108541473,0.2675007840483301,0.2113867947830383,130820.18455530364,168.29491055681703,130988.47946586045,651,0,280.06382978723406,41,6,14,34.89300491336953,0.6199186991869918,44.24603174603175,1023.0158730158734,24.95160665892374,0
654,4,2,1,44,0.044444444444444446,0.022222222222222223,0.9777777777777777,45,1150,600,550,0.5217391304347826,17,6,11,382.02401443518437,0.8308922558922559,0.29322288986205836,0.22052285700994,130768.17626953138,991.3167317708475,131759.49300130224,652,0,293.44444444444446,39,6,15,34.52840156838783,0.6225961538461537,44.29687500000001,1022.812500000001,26.225961538461565,0
655,4,0,1,43,0.0,0.022727272727272728,0.9772727272727273,44,1050,600,450,0.5714285714285714,15,6,9,383.5002856130664,0.8251629668780832,0.27937640871525193,0.21779682150913215,130136.02612630682,1181.4406375976132,131317.46676390443,653,1,301.1136363636364,41,3,16,35.13318343866471,0.6130589430894309,44.915674603174594,1020.3373015873001,24.886275648470733,1
656,4,0,0,43,0.0,0.0,1.0,43,1200,600,600,0.5,18,6,12,390.748162727576,0.8180140273163529,0.27902344111924426,0.2218954498747093,130132.94004891258,1569.8414468900705,131702.78149580266,654,2,308.9767441860465,40,3,17,34.95144422310757,0.6145833333333334,44.918699186991866,1020.3252032520317,25.50813008130079,0
657,4,0,0,43,0.0,0.0,1.0,43,1350,900,450,0.6666666666666666,18,9,9,387.58522822904104,0.8175064599483204,0.27484843200213405,0.22132385702650773,130348.82010388761,1504.5136340498198,131853.33373793744,655,3,309.9767441860465,36,7,17,34.812435671224826,0.6238425925925927,44.707207207207205,1021.1711711711707,28.365865865865853,0
658,4,1,1,43,0.022727272727272728,0.022727272727272728,0.9772727272727273,44,1100,800,300,0.7272727272727273,14,8,6,374.3864758605322,0.8231589147286822,0.266656105288813,0.21563643529335783,130682.67549871112,985.1652671975962,131667.8407659087,656,0,303.90909090909093,37,7,15,34.810433422698836,0.6252815315315315,44.38048245614035,1022.4780701754385,27.634542437174012,0
659,4,0,0,43,0.0,0.0,1.0,43,1450,1200,250,0.8275862068965517,17,12,5,384.0114700494457,0.8166297526762643,0.2788546018540097,0.22108054131762322,130665.25298524875,1435.391176649619,132100.64416189838,657,5,311.9767441860465,36,7,16,34.58209421008187,0.627025462962963,44.39752252252252,1022.4099099099099,28.400275275275273,0
660,4,0,0,43,0.0,0.0,1.0,43,1050,800,250,0.7619047619047619,13,8,5,381.82186190316776,0.8166758951642672,0.2773541337296581,0.2200785342465353,130710.70545744844,1381.6409856879013,132092.34644313634,658,6,312.9767441860465,37,6,16,34.591911501894344,0.6255630630630631,44.353070175438596,1022.5877192982456,27.63750592697961,0
661,4,0,0,43,0.0,0.0,1.0,43,900,600,300,0.6666666666666666,12,6,6,381.1581999410986,0.8156146179401993,0.27897503907545107,0.22017491314244642,130794.81336805559,1370.7031250000043,132165.5164930556,659,7,313.9767441860465,37,6,16,34.523506449422946,0.6264076576576576,44.270833333333336,1022.916666666667,27.646396396396405,0
662,4,1,1,43,0.022727272727272728,0.022727272727272728,0.9772727272727273,44,1050,700,350,0.6666666666666666,14,7,7,374.1558691307995,0.822872621564482,0.27669695704962805,0.21759161709645536,131054.49631090667,1006.9617941412947,132061.45810504796,660,0,307.8181818181818,38,6,17,34.43934335002784,0.6271929824561402,44.017094017094024,1023.9316239316248,26.945569050832233,0
663,4,0,0,43,0.0,0.0,1.0,43,700,200,500,0.2857142857142857,12,2,10,380.42416133123544,0.8143226282761166,0.285099771811429,0.22060916861702398,130945.12473518885,1362.937851559649,132308.0625867485,661,9,315.9767441860465,38,5,17,34.38978775226166,0.6260964912280702,44.123931623931625,1023.5042735042737,26.93432298695457,0
664,4,0,0,43,0.0,0.0,1.0,43,1050,900,150,0.8571428571428571,12,9,3,380.3725441704857,0.8134920634920635,0.287835289720896,0.22104973261284222,131027.14913662446,1367.8260145007132,132394.97515112517,662,10,316.9767441860465,38,5,17,34.30793244982436,0.6269188596491228,44.04380341880343,1023.8247863247876,26.94275753486283,0
665,4,2,1,44,0.044444444444444446,0.022222222222222223,0.9777777777777777,45,950,700,250,0.7368421052631579,12,7,5,375.68799578237065,0.8216329966329967,0.3008380423871235,0.22174370559928924,131621.90890842036,890.0995135664596,132512.00842198683,663,0,303.84444444444443,39,6,15,33.825774879030895,0.6311431623931623,43.46354166666668,1026.145833333335,26.311431623931668,0
666,4,0,0,44,0.0,0.0,1.0,44,1250,1000,250,0.8,15,10,5,386.49961093656225,0.8168164200140945,0.3139572860753743,0.22784258832558651,131574.63480029578,1370.7090318869045,132945.3438321827,664,1,311.75,38,6,15,33.596271998333854,0.6324013157894737,43.50961538461538,1025.9615384615377,26.99898785425099,0
667,4,0,0,44,0.0,0.0,1.0,44,900,600,300,0.6666666666666666,12,6,6,389.47199224719424,0.8151206835799859,0.3191329282834592,0.23009028029068543,131656.85609796178,1455.3316074950599,133112.18770545683,665,2,312.75,38,6,15,33.436784301478234,0.6332236842105263,43.429487179487175,1026.2820512820506,27.007422402159225,0
668,4,0,0,44,0.0,0.0,1.0,44,1100,700,400,0.6363636363636364,15,7,8,384.14509629022183,0.8140636011275546,0.32258728161859973,0.22776178411137096,131793.94866544305,1325.5998201110374,133119.54848555409,666,3,313.75,38,6,15,33.43477959282766,0.6345942982456141,43.29594017094017,1026.8162393162393,27.021479982006298,0
669,4,0,0,44,0.0,0.0,1.0,44,1250,800,450,0.64,17,8,9,384.07908859256156,0.8139094432699084,0.3211813927102545,0.22838097939501995,131903.67408366172,1332.28858481259,133235.96266847433,667,4,314.75,38,6,16,33.32553302132085,0.6356907894736843,43.18910256410255,1027.243589743587,27.032726045883873,0
670,4,0,0,44,0.0,0.0,1.0,44,950,700,250,0.7368421052631579,12,7,5,385.11225775071784,0.8154950669485553,0.3200108729705329,0.22971690054223565,132023.05230034704,1368.7391493055368,133391.79144965258,668,5,315.75,39,5,17,33.17833975268599,0.6351495726495727,43.07291666666666,1027.708333333332,26.35149572649569,0
671,4,0,1,43,0.0,0.022727272727272728,0.9772727272727273,44,1250,700,550,0.56,18,7,11,382.07605827348027,0.813953488372093,0.3058123262194561,0.22919921016964415,132237.24500868047,1304.9370659722115,133542.1820746527,669,6,316.75,39,5,17,33.04005468908243,0.6372863247863249,42.86458333333333,1028.541666666666,26.372863247863233,0
672,4,0,1,42,0.0,0.023255813953488372,0.9767441860465116,43,1350,1200,150,0.8888888888888888,15,12,3,384.07308054785443,0.8153839055001846,0.30176767371820135,0.2307074044039478,132288.07259706667,1561.6575124186934,133849.73010948536,670,7,314.93023255813955,38,5,17,32.93739398345275,0.63952850877193,42.81517094017092,1028.7393162393137,27.072087269455622,0
673,4,0,0,42,0.0,0.0,1.0,42,1600,1300,300,0.8125,19,13,6,394.57497500994793,0.8160327138985676,0.3057854917668008,0.23718832767451895,132315.55103550272,2041.6810486521777,134357.2320841549,671,8,310.9761904761905,38,4,18,32.63953790238836,0.6398026315789475,42.788461538461526,1028.846153846152,27.074898785425052,0
674,4,0,0,42,0.0,0.0,1.0,42,700,400,300,0.5714285714285714,10,4,6,393.805848644412,0.8160327138985676,0.3042499445617495,0.23690707508584025,132344.4064670137,2023.6002604166483,134368.00672743036,672,9,311.9761904761905,39,3,18,32.63017142471486,0.6383547008547009,42.76041666666666,1028.9583333333317,26.383547008546966,0
675,4,0,0,42,0.0,0.0,1.0,42,1150,700,450,0.6086956521739131,16,7,9,392.9296095379096,0.8158633372048006,0.30467010534110317,0.2372486240483236,132482.65241468514,2011.293078158647,134493.94549284378,673,10,312.9761904761905,37,5,18,32.513113750133115,0.6432995495495495,42.62609649122806,1029.4956140350866,27.824205784732072,0
676,4,0,0,42,0.0,0.0,1.0,42,1100,700,400,0.6363636363636364,15,7,8,394.98380790639806,0.8153310104529616,0.3099142542758775,0.23884693754339875,132539.10007165655,2070.159688558004,134609.25976021454,674,11,313.9761904761905,37,5,18,32.403254002058695,0.6438626126126127,42.571271929824555,1029.714912280701,27.83013276434327,0
677,4,1,1,42,0.023255813953488372,0.023255813953488372,0.9767441860465116,43,1200,1100,100,0.9166666666666666,13,11,2,391.19545308284484,0.8202750092284976,0.2996644683558951,0.23827359415045976,132810.6508875738,1790.9845496383782,134601.6354372122,675,0,307.6511627906977,38,5,17,32.22688640132669,0.6447368421052633,42.3076923076923,1030.7692307692296,27.12550607287446,0
678,4,0,0,42,0.0,0.0,1.0,42,850,400,450,0.47058823529411764,13,4,9,399.2884367840509,0.815379403794038,0.3067620365162136,0.24254126958369226,132708.51518015133,2197.795114842999,134906.31029499433,676,13,315.9761904761905,37,5,17,32.121399560143296,0.6455518018018019,42.40679824561402,1030.3728070175418,27.847913703176808,0
679,4,0,0,42,0.0,0.0,1.0,42,1350,1100,250,0.8148148148148148,16,11,5,397.7939730897731,0.8153310104529616,0.30630123937210674,0.24181550835043197,132736.76155163086,2160.376750538585,134897.13830216945,677,14,316.9761904761905,37,5,17,32.13139320422784,0.6458333333333335,42.37938596491226,1030.4824561403477,27.85087719298237,0
680,4,0,0,42,0.0,0.0,1.0,42,1000,800,200,0.8,12,8,4,397.2881436922208,0.8156213704994193,0.308693185846983,0.2422375568738168,132849.77709487517,2155.9282663896374,135005.70536126482,678,15,317.9761904761905,37,5,17,32.03041905977451,0.6469594594594594,42.26973684210525,1030.9210526315776,27.8627311522048,0
681,4,0,0,42,0.0,0.0,1.0,42,1200,900,300,0.75,15,9,6,392.88481287902937,0.8148712737127372,0.30470066653508066,0.24082431298884605,133047.67001625494,2054.4817876654292,135102.15180392037,679,16,318.9761904761905,37,5,17,31.94448134764588,0.6489301801801801,42.07785087719298,1031.6885964912276,27.88347558084399,0
682,4,0,0,42,0.0,0.0,1.0,42,1150,500,650,0.43478260869565216,18,5,13,395.2292199181565,0.8109756097560976,0.2991766800178013,0.24355224703857087,133245.71021852875,2132.5196214219695,135378.2298399507,680,17,319.9761904761905,37,5,18,31.684544038515988,0.6509009009009009,41.8859649122807,1032.456140350877,27.90422000948316,0
683,4,0,0,42,0.0,0.0,1.0,42,1050,700,350,0.6666666666666666,14,7,7,393.21848634919314,0.8112417731320171,0.2954026045668581,0.2430713763442452,133361.8461903717,2088.06865914236,135449.91484951405,681,18,320.9761904761905,38,4,18,31.619561095021368,0.6502192982456141,41.773504273504265,1032.9059829059818,27.18173639226268,0
684,4,0,0,42,0.0,0.0,1.0,42,1200,800,400,0.6666666666666666,16,8,8,393.7731902225955,0.8111933797909407,0.29771386324466276,0.2439622906819442,133445.31385633684,2109.43739149306,135554.7512478299,682,19,321.9761904761905,39,3,18,31.52125970359916,0.6493055555555556,41.692708333333336,1033.229166666667,26.493055555555564,0
685,4,0,1,41,0.0,0.023809523809523808,0.9761904761904762,42,800,500,300,0.625,11,5,6,391.1000190204801,0.8100077429345722,0.29816618435655684,0.24362824794070875,133646.82883897406,2053.863598210747,135700.6924371848,683,20,322.9761904761905,36,6,18,31.387724170478474,0.6568287037037037,41.497747747747745,1034.0090090090087,28.72247247247246,0
686,4,0,1,40,0.0,0.024390243902439025,0.975609756097561,41,1100,700,400,0.6363636363636364,15,7,8,391.1816128529635,0.8079268292682927,0.2917695538810392,0.24444859154199455,133763.2966581445,2265.1484254524694,136028.44508359698,684,21,323.5121951219512,36,5,14,31.268597140576244,0.6579861111111112,41.38513513513513,1034.4594594594585,28.73498498498496,0
687,4,0,0,40,0.0,0.0,1.0,40,1000,600,400,0.6,14,6,8,400.9926710675561,0.8089476495726495,0.28818711222379445,0.25077737706587055,133792.42153893757,2729.9560962990004,136522.37763523657,685,22,322.625,36,4,14,30.98558651718007,0.658275462962963,41.35698198198198,1034.572072072072,28.73811311311311,0
688,4,0,0,40,0.0,0.0,1.0,40,1000,500,500,0.5,15,5,10,406.44754877543005,0.8059027777777777,0.3006173175242033,0.25539797101110917,133967.23740209802,2890.131051659767,136857.36845375778,686,23,323.625,36,4,14,30.66871532687915,0.6600115740740742,41.18806306306306,1035.2477477477476,28.756881881881878,0
689,4,1,0,41,0.024390243902439025,0.0,1.0,41,1050,600,450,0.5714285714285714,15,6,9,397.7453388409743,0.8068089430894309,0.2944009492977009,0.2525642833271597,134351.7732018504,2487.558311211129,136839.3315130615,687,0,316.7073170731707,37,4,17,30.507998413537816,0.6618806306306306,40.816885964912274,1036.7324561403495,28.01979611190134,0
690,4,0,0,41,0.0,0.0,1.0,41,1000,600,400,0.6,14,6,8,395.64886280246446,0.8064532520325203,0.2890726137119699,0.2518201173880017,134437.04433094786,2437.9727416127957,136875.01707256064,688,1,317.7073170731707,37,4,18,30.476844998942695,0.6627252252252254,40.734649122807014,1037.061403508771,28.028686581318137,0
691,4,0,0,41,0.0,0.0,1.0,41,950,600,350,0.631578947368421,13,6,7,382.7323934697513,0.8060975609756098,0.2541161786884394,0.22954155055922443,132228.78674207453,1921.6960987996385,134150.48284087417,689,2,318.7073170731707,37,4,14,33.031716417910445,0.6407657657657657,42.87280701754386,1028.5087719298251,27.79753437648176,7
692,4,1,1,41,0.023809523809523808,0.023809523809523808,0.9761904761904762,42,950,400,550,0.42105263157894735,15,4,11,376.52464220441243,0.8091850561362757,0.2524413681036237,0.22753237301222368,132513.9259825705,1579.1681262802576,134093.09410885075,690,0,312.0952380952381,36,6,14,32.90381530496921,0.6455439814814814,42.59572072072073,1029.617117117118,28.6004754754755,0
693,4,0,0,41,0.0,0.0,1.0,41,950,700,250,0.7368421052631579,12,7,5,380.6276631696089,0.8051829268292683,0.25795177444226836,0.22983474879105453,132484.9405993832,1885.4866691015382,134370.42726848475,691,4,320.7073170731707,36,5,14,32.82742652957048,0.6452546296296295,42.623873873873876,1029.504504504505,28.59734734734736,0
694,4,0,0,41,0.0,0.0,1.0,41,1000,700,300,0.7,13,7,6,378.9011257426182,0.8026422764227642,0.25976436453627616,0.22949865536701902,132600.901154533,1848.5261443876443,134449.42729892064,692,5,321.7073170731707,36,5,14,32.75498396384577,0.646412037037037,42.51126126126127,1029.9549549549556,28.609859859859878,0
695,4,0,0,41,0.0,0.0,1.0,41,1050,700,350,0.6666666666666666,14,7,7,377.22183166808657,0.8016768292682926,0.2618654539035812,0.22896487922179207,132680.2718144044,1809.9790320098455,134490.25084641424,693,6,322.7073170731707,37,4,14,32.71826663828578,0.6452702702702702,42.43421052631579,1030.2631578947367,27.84495021337126,0
696,4,0,0,41,0.0,0.0,1.0,41,1050,600,450,0.5714285714285714,15,6,9,377.78451788139455,0.8017784552845528,0.2625324338349768,0.22999834637856906,132793.26331178812,1833.4477916281837,134626.7111034163,694,7,323.7073170731707,37,4,14,32.589982269503544,0.6463963963963963,42.32456140350877,1030.701754385964,27.856804172593623,0
697,4,0,0,41,0.0,0.0,1.0,41,1150,900,250,0.782608695652174,14,9,5,373.3064891253276,0.8022357723577236,0.2511749022211618,0.22795936517757015,132906.30290089257,1722.9570637119095,134629.25996460448,695,8,324.7073170731707,37,4,14,32.59162767616618,0.6475225225225225,42.21491228070175,1031.1403508771928,27.86865813181602,0
698,4,0,0,41,0.0,0.0,1.0,41,1150,700,450,0.6086956521739131,16,7,9,375.33889204525923,0.801219512195122,0.25446610220007204,0.23041841572328342,133104.23790252768,1791.839436172667,134896.07733870033,696,9,325.7073170731707,37,4,15,32.34014716820742,0.6494932432432432,42.02302631578947,1031.9078947368419,27.889402560455185,0
699,4,0,0,41,0.0,0.0,1.0,41,1400,800,600,0.5714285714285714,20,8,12,376.0245187888727,0.8006605691056911,0.25375697835576316,0.23154158563749103,133217.40974386354,1818.6024786472817,135036.01222251082,697,10,326.7073170731707,37,4,15,32.20868737829704,0.6506193693693694,41.91337719298246,1032.3464912280706,27.901256519677585,0
700,4,0,0,41,0.0,0.0,1.0,41,1050,800,250,0.7619047619047619,13,8,5,375.9884047667218,0.8004573170731707,0.2534026423411728,0.23187182761546984,133274.0136989268,1821.8967615035635,135095.91046043037,698,11,327.7073170731707,37,4,15,32.152733531556414,0.6511824324324322,41.85855263157896,1032.565789473686,27.90718349928881,0
701,4,0,0,41,0.0,0.0,1.0,41,1050,800,250,0.7619047619047619,13,8,5,383.6541998207067,0.8004573170731707,0.26395089434448105,0.2332770486750353,132745.9231824728,1985.8534685006227,134731.77665097342,699,12,328.7073170731707,36,5,13,32.48643135540742,0.6478587962962965,42.37049549549548,1030.5180180180164,28.625500500500454,1
702,4,0,0,41,0.0,0.0,1.0,41,750,400,350,0.5333333333333333,11,4,7,382.7874555282972,0.8004573170731707,0.27996269444451793,0.22849582123000467,132050.5402995902,1909.4580644834077,133959.99836407363,700,13,329.7073170731707,36,5,14,33.210300938607055,0.6409143518518519,43.046171171171174,1027.815315315316,28.550425425425445,1
703,4,1,0,42,0.023809523809523808,0.0,1.0,42,1150,1000,150,0.8695652173913043,13,10,3,373.57005234489696,0.8026519550909795,0.2810176396139852,0.22488917151162785,132370.51647308053,1489.9321535539418,133860.44862663446,701,0,322.8333333333333,38,4,16,33.12439437984495,0.6403508771929824,42.73504273504273,1029.0598290598286,27.080521817363913,0
704,4,0,0,42,0.0,0.0,1.0,42,700,400,300,0.5714285714285714,10,4,6,368.3759703415724,0.8026519550909795,0.24318474318474315,0.20538221908084917,129413.28124999999,1134.5514646796694,130547.83271467965,702,1,323.8333333333333,39,3,16,36.25443625443626,0.608974358974359,45.625,1017.4999999999999,26.089743589743588,8
705,4,0,0,42,0.0,0.0,1.0,42,1200,900,300,0.75,15,9,6,369.34446203310785,0.8014421215640728,0.24026417117512366,0.2061997368036262,129466.28146701369,1163.5308159722028,130629.81228298589,703,2,324.8333333333333,39,3,14,36.17579324462642,0.6095085470085471,45.57291666666666,1017.7083333333317,26.095085470085426,0
706,4,0,0,42,0.0,0.0,1.0,42,700,600,100,0.8571428571428571,8,6,2,368.16124629434734,0.8002322880371661,0.2357907763064302,0.2060943883895159,129572.31445312487,1140.700954861095,130713.01540798596,704,3,325.8333333333333,39,3,15,36.09789577791419,0.6105769230769231,45.46874999999999,1018.124999999999,26.105769230769205,0
707,4,3,3,42,0.06666666666666667,0.06666666666666667,0.9333333333333333,45,1050,700,350,0.6666666666666666,14,7,7,349.7526641937898,0.8186026936026937,0.23146318811212452,0.1983941836547531,130089.53788834794,99.83249203772601,130189.37038038566,705,0,305.0444444444444,42,3,16,36.04119174265451,0.6111111111111112,44.961240310077514,1020.1550387596891,24.289405684754502,0
708,4,1,0,43,0.023255813953488372,0.0,1.0,43,900,500,400,0.5555555555555556,13,5,8,364.39957302265094,0.8082779623477298,0.2569767441860471,0.20693278920517016,130132.94004891244,884.0775580011646,131017.0176069136,706,0,315.3488372093023,40,3,17,35.62354747675964,0.6145833333333335,44.91869918699186,1020.3252032520305,25.508130081300763,0
709,4,0,0,43,0.0,0.0,1.0,43,1400,1000,400,0.7142857142857143,18,10,8,366.9079070806099,0.8068014027316353,0.2630333509303253,0.20891286954181634,130236.65229030317,956.9715034040348,131193.6237937072,707,1,316.3488372093023,40,3,17,35.45420981016857,0.6156250000000001,44.817073170731696,1020.7317073170715,25.518292682926788,0
710,4,1,0,44,0.022727272727272728,0.0,1.0,44,1200,800,400,0.6666666666666666,16,8,8,370.9549237002806,0.814437984496124,0.26723924097730367,0.20756485425366836,129554.63927469128,811.7888473938863,130366.42812208516,708,0,310.1363636363636,41,3,14,36.04479308776717,0.6072154471544715,45.48611111111111,1018.055555555555,24.830623306233047,3
711,4,2,1,45,0.043478260869565216,0.021739130434782608,0.9782608695652174,46,950,500,450,0.5263157894736842,14,5,9,365.1246960462169,0.8223228663446055,0.27269260106788695,0.20713472093237997,130093.46954093497,300.0677047463348,130393.5372456813,709,0,297.60869565217394,43,3,15,35.64515068535537,0.6097383720930232,44.95738636363637,1020.170454545455,23.724894291754765,0
712,4,0,1,44,0.0,0.022222222222222223,0.9777777777777777,45,1500,1100,400,0.7333333333333333,19,11,8,368.4931233993237,0.8204545454545455,0.26665822597832856,0.20942261643379823,130163.68762581884,592.8847612823827,130756.57238710123,710,1,305.22222222222223,42,3,15,35.48788497451968,0.6118551587301586,44.88856589147287,1020.4457364341091,24.29632705795498,0
713,4,1,1,44,0.022222222222222223,0.022222222222222223,0.9777777777777777,45,1150,1000,150,0.8695652173913043,13,10,3,371.477691609788,0.8212542087542088,0.2685694998206869,0.2115214055901355,130237.85848957392,676.0918063818262,130913.95029595574,711,0,306.0888888888889,42,3,16,35.33637111575218,0.6125992063492064,44.815891472868216,1020.7364341085269,24.303248431155403,0
714,4,1,2,43,0.022222222222222223,0.044444444444444446,0.9555555555555556,45,1050,600,450,0.5714285714285714,15,6,9,374.78414534773253,0.8185185185185185,0.2766137350244253,0.21397839119649525,130342.35161675356,770.0564127545582,131112.4080295081,712,0,307.06666666666666,39,6,16,35.145809956135885,0.6183226495726495,44.71354166666667,1021.145833333334,26.183226495726515,0
715,4,0,0,43,0.0,0.0,1.0,43,1200,600,600,0.5,18,6,12,389.00458142440635,0.8155684754521964,0.2803986710963451,0.2216421452301851,130262.58680555563,1534.5486111111206,131797.13541666674,713,4,314.6279069767442,39,4,16,34.863945578231295,0.6175213675213675,44.79166666666667,1020.833333333334,26.175213675213694,0
716,4,0,0,43,0.0,0.0,1.0,43,1400,1100,300,0.7857142857142857,17,11,6,389.0015925654273,0.8144149132521226,0.2781009832660011,0.22227980571499342,130374.54433094812,1543.1810749461565,131917.72540589428,714,5,315.6279069767442,37,6,16,34.75010736525662,0.6221846846846846,44.68201754385966,1021.2719298245626,27.6019440493125,0
717,4,0,1,42,0.0,0.023255813953488372,0.9767441860465116,43,1150,900,250,0.782608695652174,14,9,5,385.71909214498373,0.813999630860096,0.27564192950809274,0.22147592049573342,130562.68376981537,1472.1039703411725,132034.78774015655,715,6,316.6279069767442,38,5,14,34.642658024949476,0.6222587719298245,44.49786324786326,1022.0085470085485,26.894961763382856,0
718,4,0,0,42,0.0,0.0,1.0,42,1500,1300,200,0.8666666666666667,17,13,4,386.48409143262455,0.810322299651568,0.2732855400393295,0.22175886829952354,130535.38795976709,1689.9701630871605,132225.35812285426,716,7,323.6666666666667,38,4,15,34.65085380728349,0.6219846491228069,44.524572649572654,1021.9017094017104,26.89215024741343,0
719,4,0,0,42,0.0,0.0,1.0,42,1250,900,350,0.72,16,9,7,390.06980052331977,0.810515873015873,0.27342766591538936,0.22476568698426808,130699.20562358461,1796.3626132296,132495.5682368142,717,8,324.6666666666667,38,4,15,34.39274022219901,0.6236293859649122,44.36431623931624,1022.5427350427349,26.909019343229865,0
720,4,1,2,41,0.023255813953488372,0.046511627906976744,0.9534883720930233,43,1100,800,300,0.7272727272727273,14,8,6,384.95413749788986,0.8190753045404208,0.2726713424387841,0.22360102029132767,131008.00781250013,1486.4149305555707,132494.4227430557,718,0,318.09302325581393,39,4,15,34.210080043413384,0.625,44.06250000000001,1023.750000000001,26.250000000000025,0
721,4,0,0,41,0.0,0.0,1.0,41,1100,600,500,0.5454545454545454,16,6,10,395.00621820507473,0.8105691056910569,0.27116765809749843,0.22867233426115113,130878.94833025541,2139.599684518311,133018.54801477373,719,10,324.9512195121951,37,4,15,34.08388698385483,0.6272522522522522,44.18859649122807,1023.2456140350873,27.65528686581317,0
722,4,0,1,40,0.0,0.024390243902439025,0.975609756097561,41,750,400,350,0.5333333333333333,11,4,7,396.7268702908287,0.8107723577235773,0.27293657700318597,0.22983562262099955,130906.99932912046,2186.8648286011075,133093.86415772157,720,11,325.9512195121951,37,4,15,34.01137094181936,0.6275337837837838,44.161184210526315,1023.3552631578943,27.658250355618765,0
723,4,1,1,40,0.024390243902439025,0.024390243902439025,0.975609756097561,41,1300,900,400,0.6923076923076923,17,9,8,397.80024402637315,0.8096544715447155,0.2715430613105725,0.2313832188626774,131061.33355034719,2227.2460937499964,133288.5796440972,721,0,326.6341463414634,39,2,15,33.8271447948457,0.625534188034188,44.010416666666664,1023.958333333333,26.255341880341874,0
724,4,0,0,40,0.0,0.0,1.0,40,700,500,200,0.7142857142857143,9,5,4,402.96328903726874,0.8022702991452991,0.2757359081419626,0.23367967972015954,130945.12473518886,2553.215629337428,133498.3403645263,722,13,335.8,38,2,15,33.813065414057064,0.6260964912280702,44.123931623931625,1023.5042735042738,26.934322986954573,0
725,4,0,0,40,0.0,0.0,1.0,40,950,700,250,0.7368421052631579,12,7,5,404.092357462416,0.8008012820512821,0.2840539165818925,0.2350430694589079,131061.33355034704,2592.176649305537,133653.51019965258,723,14,336.8,39,1,15,33.66607324516785,0.6255341880341881,44.01041666666666,1023.9583333333319,26.25534188034184,0
726,4,0,0,40,0.0,0.0,1.0,40,1100,800,300,0.7272727272727273,14,8,6,404.4982793278324,0.8007478632478633,0.27762355094569857,0.23593333801363608,131168.01757812503,2611.447482638891,133779.46506076393,724,15,337.8,39,1,15,33.547301877838784,0.6266025641025641,43.90625,1024.3750000000002,26.266025641025646,0
727,4,0,0,40,0.0,0.0,1.0,40,1350,800,550,0.5925925925925926,19,8,11,402.20768061339186,0.8001602564102565,0.27256097560975645,0.23557878435927204,131328.12499999977,2564.626736111083,133892.75173611086,725,16,338.8,35,5,15,33.443428184281835,0.6357142857142859,43.749999999999986,1024.9999999999982,29.285714285714235,0
728,4,0,1,39,0.0,0.025,0.975,40,850,500,350,0.5882352941176471,12,5,7,403.23581669811995,0.8009615384615385,0.27617530755711805,0.23653729866106218,131385.84530476423,2595.895726807895,133981.7410315721,726,17,339.8,36,4,15,33.35850541886351,0.6342592592592593,43.693693693693696,1025.2252252252254,28.478478478478483,0
729,4,0,0,39,0.0,0.0,1.0,39,1100,900,200,0.8181818181818182,13,9,4,394.5545309128829,0.7980769230769231,0.26348572164538875,0.23263054478587541,131581.12502164117,2583.1858119805997,134164.31083362177,727,18,343.4871794871795,37,2,15,33.383095543443424,0.6342905405405406,43.503289473684205,1025.9868421052624,27.72937411095304,0
730,4,0,0,39,0.0,0.0,1.0,39,600,400,200,0.6666666666666666,8,4,4,365.747757735003,0.7975708502024291,0.16443265026974974,0.20962914756346696,130492.6056757771,1781.14160762029,132273.7472833974,728,19,344.4871794871795,36,3,15,35.22401631213491,0.6252893518518519,44.56644144144144,1021.734234234234,28.3815065065065,6
731,4,0,0,39,0.0,0.0,1.0,39,900,700,200,0.7777777777777778,11,7,4,365.95258708025585,0.7972896986054882,0.1670078133597448,0.2100171250977821,130542.5707910125,1754.4783010156837,132297.0490920282,729,20,345.4871794871795,37,2,15,35.16809728183119,0.6238738738738739,44.517543859649116,1021.9298245614026,27.619724988146015,0
732,4,0,0,39,0.0,0.0,1.0,39,750,200,550,0.26666666666666666,13,2,11,362.9743924040046,0.7957714799820064,0.1657067097959608,0.20860957373551972,130598.60365689435,1680.7897622345233,132279.39341912887,730,21,346.4871794871795,37,2,15,35.18737037831652,0.6244369369369369,44.46271929824561,1022.149122807017,27.625651967757214,0
733,4,0,0,39,0.0,0.0,1.0,39,1100,900,200,0.8181818181818182,13,9,4,367.5436171495124,0.7945906432748538,0.16665841842766582,0.21184868810484234,130710.70545744829,1808.3770967989983,132519.0825542473,731,22,347.4871794871795,37,2,15,34.956930445349926,0.6255630630630631,44.35307017543859,1022.5877192982443,27.63750592697958,0
734,4,0,0,39,0.0,0.0,1.0,39,1100,1000,100,0.9090909090909091,12,10,2,369.30736631939067,0.7957714799820064,0.1609256052985959,0.21348436974968488,130822.85534972296,1862.7688327177525,132685.62418244072,732,23,348.4871794871795,37,2,15,34.79814219364058,0.6266891891891893,44.243421052631575,1023.0263157894733,27.64935988620198,0
735,4,0,0,39,0.0,0.0,1.0,39,1000,900,100,0.9,11,9,2,369.80269118109914,0.7967836257309941,0.16025366261114238,0.21408180608573285,130878.9483302553,1879.8774622960734,132758.82579255136,733,24,349.4871794871795,37,2,16,34.72862194599228,0.6272522522522523,44.18859649122806,1023.2456140350864,27.655286865813146,0
736,4,1,1,39,0.025,0.025,0.975,40,1050,700,350,0.6666666666666666,14,7,7,363.7434776407487,0.8009882478632478,0.15496244914989044,0.21198837204509782,131136.55495516476,1540.0133090437603,132676.56826420853,734,0,341.725,38,2,16,34.62283995688606,0.628015350877193,43.93696581196581,1024.252136752137,26.954003598740446,0
737,4,0,1,38,0.0,0.02564102564102564,0.9743589743589743,39,1100,800,300,0.7272727272727273,14,8,6,370.3855200293547,0.7971210076473235,0.15325298028521805,0.21520159306248182,131019.23338190591,1905.5253780009161,132924.75875990684,735,26,351.4871794871795,37,2,16,34.57157455999428,0.6286599099099099,44.051535087719294,1023.7938596491223,27.670104314841144,0
738,4,0,1,37,0.0,0.02631578947368421,0.9736842105263158,38,1500,1100,400,0.7333333333333333,19,11,8,377.2905368381753,0.7940967283072546,0.16963438071641934,0.2193302788320132,131039.7137001865,2288.0087858128186,133327.72248599931,736,27,360.4736842105263,36,2,16,34.374083443320124,0.6307870370370372,44.03153153153152,1023.8738738738725,28.440940940940905,0
739,4,1,1,37,0.02631578947368421,0.02631578947368421,0.9736842105263158,38,1150,900,250,0.782608695652174,14,9,5,374.02970655717905,0.7930891417733523,0.16798727588201268,0.21874487979886437,131270.4173768363,2219.8071382192984,133490.2245150556,737,0,358.1842105263158,36,2,16,34.2239010989011,0.6331018518518519,43.806306306306304,1024.7747747747746,28.465965965965964,0
740,4,0,0,37,0.0,0.0,1.0,37,1150,800,350,0.6956521739130435,15,8,7,379.75771250420485,0.7912912912912913,0.15716340418484975,0.21522859937617742,130055.90284475748,2496.2586635489165,132552.1615083064,738,29,368.86486486486484,35,2,18,35.31017152691102,0.6229166666666666,44.99421296296297,1020.023148148149,29.14351851851854,6
741,4,0,0,37,0.0,0.0,1.0,37,800,400,400,0.5,12,4,8,378.4951204390751,0.7903528528528528,0.15597491990004753,0.2148380223226303,130114.93866008664,2449.573875814479,132564.51253590113,739,30,369.86486486486484,35,2,18,35.282307619587826,0.6235119047619048,44.936342592592595,1020.2546296296301,29.15013227513229,0
742,4,0,0,37,0.0,0.0,1.0,37,900,800,100,0.8888888888888888,10,8,2,378.34235735110366,0.7901026026026026,0.15863210148924445,0.21556715709539637,130262.58680555563,2456.770833333343,132719.357638889,740,31,370.86486486486484,35,2,20,35.136054421768705,0.625,44.79166666666667,1020.833333333334,29.166666666666686,0
743,4,0,0,37,0.0,0.0,1.0,37,1150,700,450,0.6086956521739131,16,7,9,372.31378773057014,0.7902277277277278,0.15138410756637066,0.21313039443068876,130444.94224773248,2313.2901077097567,132758.23235544225,741,32,371.86486486486484,34,3,20,35.10468865322612,0.6289828431372548,44.61309523809524,1021.5476190476195,30.045518207282925,0
744,4,0,0,37,0.0,0.0,1.0,37,750,600,150,0.8,9,6,3,371.32189699836056,0.7898523523523523,0.14538242377496902,0.213230667941868,130566.58340419504,2296.446286848076,132863.0296910431,742,33,372.86486486486484,34,3,15,35.006552125800816,0.6302083333333333,44.49404761904762,1022.0238095238097,30.059523809523817,0
745,4,0,0,37,0.0,0.0,1.0,37,900,600,300,0.6666666666666666,12,6,6,370.1755329854156,0.7891016016016016,0.14158902178462074,0.21324196195920433,130688.28125000001,2275.5208333333344,132963.80208333334,743,34,373.86486486486484,34,3,16,34.912387938060306,0.6314338235294117,44.375,1022.5000000000001,30.07352941176471,0
746,4,0,0,37,0.0,0.0,1.0,37,950,800,150,0.8421052631578947,11,8,3,371.10997572779354,0.7892892892892893,0.14394487619167462,0.21394863701353994,130718.714569161,2302.203798185941,133020.91836734695,744,35,374.86486486486484,34,3,16,34.857634846721,0.6317401960784313,44.345238095238095,1022.6190476190477,30.07703081232493,0
747,4,2,0,39,0.05128205128205128,0.0,1.0,39,1100,800,300,0.7272727272727273,14,8,6,355.27794302333274,0.8035312640575799,0.15217844486137166,0.20809136662795213,131328.12500000012,1533.0144557823278,132861.13945578245,745,0,356.5897435897436,35,4,18,34.646002710027105,0.6357142857142857,43.75000000000001,1025.000000000001,29.285714285714313,0
748,4,0,0,39,0.0,0.0,1.0,39,900,700,200,0.7777777777777778,11,7,4,353.84215058245314,0.8042622582096267,0.1549951480297429,0.2079124341826228,131450.17715419497,1502.5226757369594,132952.69982993192,746,1,357.5897435897436,34,5,18,34.559534865722455,0.639093137254902,43.63095238095238,1025.4761904761904,30.161064425770306,0
749,4,0,0,39,0.0,0.0,1.0,39,1200,900,300,0.75,15,9,6,353.90314927479926,0.8037561853351327,0.1546851848545978,0.20861404517443366,131572.2859977324,1512.7692743764128,133085.05527210882,747,2,358.5897435897436,34,5,17,34.4347102962791,0.6403186274509804,43.51190476190476,1025.9523809523807,30.1750700280112,0
750,4,0,0,39,0.0,0.0,1.0,39,1000,600,400,0.6,14,6,8,339.08228177817057,0.8044309491677913,0.019379946499937795,0.1915956266955678,129937.87140185609,1017.0918011944989,130954.96320305059,748,3,359.5897435897436,35,4,19,36.46708385363455,0.6217261904761905,45.1099537037037,1019.5601851851848,29.130291005290992,6
751,4,0,1,38,0.0,0.02564102564102564,0.9743589743589743,39,700,400,300,0.5714285714285714,10,4,6,339.08228177817057,0.8044309491677913,0.019379946499937795,0.1915956266955678,129937.87140185609,1011.9259848679683,130949.79738672405,749,4,360.5897435897436,35,4,19,36.46708385363455,0.6217261904761905,45.1099537037037,1019.5601851851848,29.130291005290992,0
752,4,0,0,38,0.0,0.0,1.0,38,900,700,200,0.7777777777777778,11,7,4,342.66651535645326,0.7981567093409199,0.027268258211202268,0.19372532699854916,129958.944515306,1306.5157312925053,131265.4602465985,750,5,370.9736842105263,34,4,20,36.354349095154696,0.6240808823529412,45.08928571428571,1019.6428571428562,29.9894957983193,0
753,4,0,0,38,0.0,0.0,1.0,38,1600,1100,500,0.6875,21,11,10,341.4668683598184,0.7976232811759127,0.033992507523183946,0.19379940806911528,130110.7213718819,1285.7001133786687,131396.42148526057,751,6,371.9736842105263,34,4,21,36.23103850641775,0.6256127450980392,44.94047619047618,1020.2380952380937,30.007002801120404,0
754,4,0,0,38,0.0,0.0,1.0,38,750,500,250,0.6666666666666666,10,5,5,341.4974644515919,0.7959637268847796,0.03935550412248978,0.19427058810507597,130201.83000283432,1292.7189625850165,131494.54896541935,752,7,372.9736842105263,34,4,21,36.13792332516815,0.6265318627450981,44.85119047619047,1020.5952380952369,30.017507002801086,0
755,4,3,2,39,0.07317073170731707,0.04878048780487805,0.9512195121951219,41,1000,600,400,0.6,14,6,8,315.16451390001737,0.8087906504065041,0.03928885961955042,0.18258413458900477,130906.99932912066,51.44816193445476,130958.44749105512,753,0,346.609756097561,37,4,17,36.09805260902174,0.6275337837837838,44.16118421052632,1023.355263157896,27.65825035561881,0
756,4,0,0,39,0.0,0.0,1.0,39,900,500,400,0.5555555555555556,13,5,8,330.2221172022686,0.7974021592442645,0.042781493868450315,0.18987771739130435,130617.28395061725,826.54320987654,131443.8271604938,754,1,365.38461538461536,35,4,18,36.00543478260871,0.6285714285714286,44.44444444444444,1022.222222222222,29.2063492063492,0
757,4,0,0,39,0.0,0.0,1.0,39,1000,1000,0,1.0,10,10,0,329.309554624828,0.7976833108412056,0.04243611510164991,0.1897879918532523,130706.03358892753,808.5491415895142,131514.58273051705,755,2,366.38461538461536,35,4,19,35.939091680814926,0.6294642857142856,44.35763888888889,1022.5694444444449,29.216269841269856,0
758,4,0,0,39,0.0,0.0,1.0,39,950,800,150,0.8421052631578947,11,8,3,328.59687557584823,0.7971772379667117,0.04736048265460058,0.19010447513681267,130854.0166323731,799.6442043895729,131653.66083676266,756,3,367.38461538461536,35,4,20,35.80788084464555,0.6309523809523809,44.21296296296296,1023.148148148148,29.23280423280423,0
759,4,0,0,39,0.0,0.0,1.0,39,1050,800,250,0.7619047619047619,13,8,5,349.78192172714137,0.7970647773279352,0.07488142961191468,0.18248249382054246,126751.58900454507,1067.0828767957114,127818.67188134078,757,4,368.38461538461536,36,3,19,39.44890218444793,0.5873842592592593,48.2545045045045,1006.9819819819818,27.971721721721718,7
760,4,2,1,40,0.04878048780487805,0.024390243902439025,0.975609756097561,41,750,300,450,0.4,12,3,9,337.79390274628366,0.8120426829268292,0.07899341850561314,0.17913313024424107,127415.40310650867,408.0292570676913,127823.43236357637,758,0,351.3658536585366,38,3,13,39.0701058201058,0.5904605263157896,47.59615384615383,1009.615384615383,26.56882591093113,0
761,4,2,1,41,0.047619047619047616,0.023809523809523808,0.9761904761904762,42,900,500,400,0.5555555555555556,13,5,8,329.97910274796345,0.8200009678668215,0.08678638895022228,0.17644337146936548,127749.32861328113,30.921766493040934,127780.25037977418,759,0,343.95238095238096,39,3,14,38.92591877039327,0.5921474358974359,47.26562499999999,1010.9374999999991,25.921474358974336,0
762,4,3,1,43,0.06818181818181818,0.022727272727272728,0.9772727272727273,44,850,500,350,0.5882352941176471,12,5,7,320.77595999751605,0.8357117688513037,0.09674109188148083,0.17356175064306323,128223.64501953124,-572.5667317708328,127651.0782877604,760,0,329.25,39,5,18,38.674727450375386,0.5969551282051282,46.796875,1012.8124999999999,25.969551282051277,0
763,4,0,0,43,0.0,0.0,1.0,43,1500,1200,300,0.8,18,12,6,326.3570002138646,0.827750092284976,0.09170318534476407,0.17635186134703593,128171.57594601516,-234.0617923149877,127937.51415370018,761,1,337.90697674418607,38,5,19,38.58650735035519,0.5981359649122806,46.8482905982906,1012.6068376068384,26.647548358074697,0
764,4,2,1,44,0.044444444444444446,0.022222222222222223,0.9777777777777777,45,950,700,250,0.7368421052631579,12,7,5,319.2311615192871,0.8396464646464646,0.11964887687326864,0.17507751840159924,128762.65290377755,-778.9897506444573,127983.6631531331,762,0,323.84444444444443,40,5,13,38.165239811755285,0.60078125,46.265243902439025,1014.9390243902441,25.373475609756103,0
765,4,0,0,44,0.0,0.0,1.0,44,1150,800,350,0.6956521739130435,15,8,7,325.4734640857112,0.8354915433403806,0.11375766284418631,0.17845177043258822,128751.69406467049,-418.9480251735731,128332.74603949691,763,1,332.15909090909093,39,5,14,38.01800010263781,0.6022970085470085,46.276041666666686,1014.8958333333362,26.02297008547016,0
766,4,0,1,43,0.0,0.022727272727272728,0.9772727272727273,44,800,400,400,0.5,12,4,8,325.8857668915475,0.835799859055673,0.1169480852651712,0.1789158759638386,128804.55864800363,-404.885525173592,128399.67312283003,764,2,333.15909090909093,39,5,14,37.95375833760904,0.6028311965811964,46.22395833333334,1015.104166666668,26.028311965812,0
767,4,0,0,43,0.0,0.0,1.0,43,1050,600,450,0.5714285714285714,15,6,9,337.49165655382643,0.8289959394610557,0.11751543002078546,0.18498749253345667,128740.17373666845,89.74689988315342,128829.9206365516,765,3,341.7906976744186,38,5,14,37.724804365371796,0.603892543859649,46.28739316239318,1014.85042735043,26.70659019343237,0
768,4,1,0,44,0.022727272727272728,0.0,1.0,44,1400,1000,400,0.7142857142857143,18,10,8,332.36899999999974,0.8359540169133193,0.11759545454545428,0.18383241150442503,129098.08976138574,-218.35940081958444,128879.73036056616,766,0,335.0,40,4,16,37.49062500000002,0.6041666666666665,45.93495934959351,1016.2601626016285,25.406504065040714,0
769,4,1,1,44,0.022222222222222223,0.022222222222222223,0.9777777777777777,45,1050,700,350,0.6666666666666666,14,7,7,326.72588869545734,0.8397306397306398,0.11541717875187785,0.18167150211972974,129307.31336805593,-550.3080022225136,128757.0053658334,767,0,328.53333333333336,39,6,16,37.42148026764986,0.6079059829059827,45.729166666666686,1017.0833333333363,26.079059829059904,0
770,4,3,3,44,0.06382978723404255,0.06382978723404255,0.9361702127659575,47,550,400,150,0.7272727272727273,7,4,3,313.8551411194401,0.8513336416897933,0.11920529801324542,0.17629456176227667,129706.17992567427,-1258.209719072782,128447.97020660149,768,0,315.48936170212767,41,6,11,37.34458187248411,0.6087398373983738,45.3373015873016,1018.650793650796,24.845141308556,0
771,4,1,1,44,0.022222222222222223,0.022222222222222223,0.9777777777777777,45,950,600,350,0.631578947368421,13,6,7,324.90799013115554,0.8399410774410775,0.1175005825759845,0.18124254624976407,129433.96297053693,-589.174247306473,128844.78872323046,769,0,330.4888888888889,40,5,11,37.339167415692934,0.6075520833333332,45.60467479674798,1017.5813008130099,25.439532520325248,0
772,4,0,0,44,0.0,0.0,1.0,44,1350,1100,250,0.8148148148148148,16,11,5,328.8848028789737,0.8357117688513037,0.116151527258199,0.18334045915502747,129408.11107806239,-287.9277794301978,129120.18329863218,770,4,339.0,40,4,20,37.26424124384072,0.6072916666666666,45.630081300813025,1017.479674796751,25.436991869918778,0
773,4,0,0,44,0.0,0.0,1.0,44,850,500,350,0.5882352941176471,12,5,7,329.000956877215,0.8356457011980268,0.11509326918712803,0.18376712677776427,129485.67450137174,-279.8178374314056,129205.85666394034,771,5,340.0,40,4,11,37.18255949409218,0.6080729166666665,45.553861788617894,1017.7845528455301,25.444613821138255,0
774,4,0,2,42,0.0,0.045454545454545456,0.9545454545454546,44,750,400,350,0.5333333333333333,11,4,7,330.7165489023328,0.8345225510923185,0.11924445089747526,0.18509041267617743,129563.2611623375,-230.25708077199897,129333.0040815655,772,6,341.0,40,4,12,37.060166699940105,0.6088541666666666,45.47764227642278,1018.0894308943111,25.452235772357778,0
775,4,1,1,42,0.023255813953488372,0.023255813953488372,0.9767441860465116,43,950,600,350,0.631578947368421,13,6,7,335.4660624678618,0.8355481727574751,0.11615775990637722,0.18817278787999348,129651.8676757813,98.76030815972342,129750.62798394101,773,0,343.2093023255814,39,4,13,36.84934455013466,0.6113782051282051,45.390625,1018.4375000000003,26.11378205128206,0
776,4,2,1,43,0.045454545454545456,0.022727272727272728,0.9772727272727273,44,1350,900,450,0.6666666666666666,18,9,9,331.5584285935206,0.838354474982382,0.13470839711250182,0.18790807158628822,130055.18297846847,-175.82158024324482,129879.36139822523,774,0,336.3636363636364,40,4,14,36.54001029524094,0.6138020833333333,44.99491869918699,1020.0203252032518,25.500508130081293,0
777,4,1,1,43,0.022727272727272728,0.022727272727272728,0.9772727272727273,44,1250,800,450,0.64,17,8,9,329.6951844832283,0.8397418957011981,0.1494206400547975,0.18798133549652296,130289.8540799179,-208.48201345594475,130081.37206646196,775,0,337.34090909090907,38,6,17,36.34998081484584,0.6195175438596492,44.76495726495725,1020.9401709401686,26.866846603688646,0
778,4,2,1,44,0.044444444444444446,0.022222222222222223,0.9777777777777777,45,700,400,300,0.5714285714285714,10,4,6,323.1640641910524,0.8396043771043772,0.1563188711083936,0.18552151163127045,130555.17713758668,-561.8516710069546,129993.32546657973,776,0,330.5111111111111,39,6,13,36.24853480786872,0.6204594017094018,44.50520833333333,1021.9791666666656,26.20459401709399,0
779,4,1,1,44,0.022222222222222223,0.022222222222222223,0.9777777777777777,45,1000,800,200,0.8,12,8,4,323.74183536005916,0.841919191919192,0.15607867115051466,0.18610888285812888,130608.41064453125,-543.3186848958337,130065.09195963542,777,0,331.4888888888889,39,6,13,36.18000356669723,0.6209935897435898,44.453125,1022.1875,26.209935897435898,0
780,4,0,0,44,0.0,0.0,1.0,44,1050,700,350,0.6666666666666666,14,7,7,326.7133337216572,0.8376937984496124,0.15220428881031145,0.18733131437133843,130508.09500328718,-272.2530407626697,130235.8419625245,778,2,340.02272727272725,38,6,13,36.20543182768716,0.6217105263157896,44.551282051282044,1021.7948717948707,26.889338731443967,0
781,4,0,0,44,0.0,0.0,1.0,44,800,500,300,0.625,11,5,6,325.30442792580243,0.8370110993657506,0.15199591313025707,0.1866548802105757,130535.38795976678,-307.2520591350911,130228.13590063169,779,3,341.02272727272725,38,6,13,36.2138438752396,0.6219846491228072,44.52457264957264,1021.9017094017079,26.892150247413365,0
782,4,0,0,44,0.0,0.0,1.0,44,950,500,450,0.5263157894736842,14,5,9,326.45045031225555,0.8363063777307964,0.14879985176316302,0.18757666415239316,130589.98243343183,-273.7682856673381,130316.21414776449,780,4,342.02272727272725,38,6,13,36.12940315668443,0.6225328947368423,44.47115384615384,1022.1153846153836,26.8977732793522,0
783,4,0,0,44,0.0,0.0,1.0,44,1300,1000,300,0.7692307692307693,16,10,6,324.3176793914585,0.8355355884425653,0.15037613624490676,0.1868780559575947,130699.20562358458,-322.3873867704002,130376.81823681419,781,5,343.02272727272725,38,6,13,36.07359906662489,0.6236293859649124,44.36431623931624,1022.5427350427346,26.909019343229858,0
784,4,0,1,43,0.0,0.022727272727272728,0.9772727272727273,44,850,600,250,0.7058823529411765,11,6,5,321.5101978173307,0.8353594080338267,0.1445565635993329,0.18571942015095239,130794.81336805568,-389.6267361111061,130405.18663194457,782,6,344.02272727272725,39,5,13,36.04887983706719,0.6228632478632479,44.270833333333336,1022.9166666666677,26.228632478632505,0
785,4,0,0,43,0.0,0.0,1.0,43,1150,800,350,0.6956521739130435,15,8,7,322.3558138146161,0.8329180509413068,0.1474025705967057,0.1865378627735698,130863.12601587042,-163.10210296588338,130700.02391290454,783,7,348.06976744186045,38,5,14,35.95832898263201,0.6252741228070176,44.20405982905983,1023.1837606837607,26.925888439046336,0
786,4,0,0,43,0.0,0.0,1.0,43,1200,1000,200,0.8333333333333334,14,10,4,323.51118379539287,0.8329180509413068,0.16067918959004612,0.18355367166144995,130099.04308431933,-182.30091222881947,129916.74217209051,784,8,349.06976744186045,38,5,16,36.70083254791077,0.6175986842105263,44.951923076923066,1020.1923076923061,26.847165991902795,1
787,4,0,0,43,0.0,0.0,1.0,43,750,300,450,0.4,12,3,9,331.52488219609256,0.8329180509413068,0.12139990832007541,0.18023934426328525,128415.10662073552,-85.43938107240683,128329.6672396631,785,9,350.06976744186045,38,5,16,38.207327571062145,0.6006030701754386,46.607905982905976,1013.5683760683752,26.672852001799345,8
788,4,1,1,43,0.022727272727272728,0.022727272727272728,0.9772727272727273,44,1500,1100,400,0.7333333333333333,19,11,8,327.15898667603886,0.8367248062015504,0.12264982784843226,0.17937591486689058,128751.69406467008,-375.5452473958379,128376.14881727424,786,0,343.09090909090907,39,5,16,37.975234356289995,0.6022970085470085,46.276041666666664,1014.8958333333328,26.02297008547007,0
789,4,0,0,43,0.0,0.0,1.0,43,900,600,300,0.6666666666666666,12,6,6,346.139812001002,0.8322720561092654,0.10879576329725982,0.18400063690579585,127512.5,227.4305555555557,127739.93055555556,787,11,352.06976744186045,39,4,13,38.759969746974704,0.5897435897435896,47.5,1010.0,25.897435897435898,2
790,4,1,0,44,0.022727272727272728,0.0,1.0,44,1100,800,300,0.7272727272727273,14,8,6,340.0161712356737,0.8382663847780127,0.049699149771092355,0.18094275574945848,127556.5445004054,-69.49242458388204,127487.05207582153,788,0,345.04545454545456,42,2,15,38.86950439648281,0.5855654761904763,47.4563953488372,1010.1744186046493,24.05177187153927,7
791,4,3,3,44,0.06382978723404255,0.06382978723404255,0.9361702127659575,47,1100,500,600,0.45454545454545453,17,5,12,322.25498481576983,0.8534150477952512,0.06397255762689014,0.17391810551838977,128121.60428645478,-1142.4348712193057,126979.16941523548,789,0,323.9574468085106,45,2,16,38.741295368465,0.5872685185185187,46.89764492753622,1012.4094202898528,22.497987117552285,0
792,4,4,3,45,0.08333333333333333,0.0625,0.9375,48,1600,1100,500,0.6875,21,11,10,321.72503995534754,0.8577497044917257,0.09260880732231236,0.17530330803063124,128504.33601820757,-1331.38131850844,127172.95469969913,790,0,318.125,43,5,13,38.36479639488185,0.59375,46.51988636363636,1013.920454545454,23.579545454545443,0
793,4,2,1,46,0.0425531914893617,0.02127659574468085,0.9787234042553191,47,1800,1400,400,0.7777777777777778,22,14,8,326.6447132635375,0.8510252852297255,0.08510638297872353,0.17873705096555392,128672.41753472247,-993.9670138888646,127678.4505208336,791,0,325.8510638297872,43,4,16,38.06895961670091,0.5954457364341084,46.35416666666668,1014.5833333333353,23.594961240310123,0
794,4,0,0,46,0.0,0.0,1.0,46,1650,1300,350,0.7878787878787878,20,13,7,354.24750696973445,0.8440418679549114,0.03420464994089034,0.18730978403671286,127297.04231112447,-114.87878722154863,127182.16352390293,792,1,333.9347826086956,40,6,16,38.77622524337025,0.5859375,47.713414634146346,1009.1463414634158,25.228658536585392,8
795,4,0,0,46,0.0,0.0,1.0,46,1250,900,350,0.72,16,9,7,354.4425890296339,0.843377616747182,0.04201930183576774,0.18797093426548134,127417.32927256562,-167.57438507808956,127249.75488748754,793,2,334.9347826086956,41,5,14,38.64791113949759,0.585619918699187,47.59424603174604,1009.6230158730167,24.624951606658943,0
796,4,2,1,47,0.041666666666666664,0.020833333333333332,0.9791666666666666,48,1200,1000,200,0.8333333333333334,14,10,4,339.4456691923815,0.8509714834515366,0.06219488939740625,0.18223311724455887,127910.26341735272,-916.2830075445675,126993.98040980815,794,0,321.9375,44,4,16,38.522120518688006,0.5864109848484848,47.10648148148149,1011.5740740740756,22.9903198653199,0
797,4,1,0,48,0.020833333333333332,0.0,1.0,48,1000,800,200,0.8,12,8,4,341.1991936469652,0.8504358747044917,0.08079543403717748,0.18437533957458888,128172.28768707682,-852.0434157209787,127320.24427135584,795,0,322.9166666666667,37,11,17,38.21004782530228,0.5999436936936937,46.84758771929825,1012.6096491228072,27.367828354670465,0
798,4,1,2,47,0.02040816326530612,0.04081632653061224,0.9591836734693877,49,1250,900,350,0.72,16,9,7,334.5667750876635,0.8553004535147393,0.08797000406571365,0.18189312293734483,128415.10662073581,-1207.314381072379,127207.79223966342,796,0,317.3061224489796,38,11,13,38.13024841010504,0.6006030701754386,46.60790598290599,1013.5683760683776,26.67285200179941,0
799,4,2,1,48,0.04081632653061224,0.02040816326530612,0.9795918367346939,49,1600,1000,600,0.625,22,10,12,334.3173378682884,0.8556193310657597,0.0937322915087031,0.1830512704345212,128697.58204207617,-1194.8333963214848,127502.74864575469,797,0,317.83673469387753,41,8,15,37.84871594316257,0.5985772357723577,46.32936507936508,1014.6825396825404,24.748354626403426,0
800,4,0,0,48,0.0,0.0,1.0,48,1400,600,800,0.42857142857142855,22,6,16,338.36631262939073,0.8468158983451537,0.09244524298425749,0.18515100477585777,128672.41753472232,-892.3177083333237,127780.09982638899,798,1,325.4583333333333,41,7,16,37.77164613278577,0.5983231707317073,46.35416666666667,1014.5833333333342,24.745934959349615,0
801,4,1,1,48,0.02040816326530612,0.02040816326530612,0.9795918367346939,49,1350,900,450,0.6666666666666666,18,9,9,336.0041922241179,0.8505881519274376,0.11826469242699833,0.18566515636794909,129060.22376543206,-1127.0447530864212,127933.17901234564,799,0,319.7959183673469,44,5,17,37.43678239475123,0.5980113636363636,45.97222222222222,1016.1111111111109,23.09343434343434,0
802,4,0,1,47,0.0,0.020833333333333332,0.9791666666666666,48,1500,1000,500,0.6666666666666666,20,10,10,340.80577718087454,0.8462618203309692,0.12282715279015899,0.18833296593177568,129063.29175199526,-802.8969097878708,128260.39484220739,800,1,327.3541666666667,45,3,18,37.31168657514708,0.5967592592592593,45.96920289855072,1016.1231884057961,22.58051529790658,0
803,4,0,0,47,0.0,0.0,1.0,47,1700,1400,300,0.8235294117647058,20,14,6,349.45613783879844,0.8398088189947579,0.11807405511673608,0.19309827072723934,129060.22376543209,-379.8225308641986,128680.4012345679,801,2,335.06382978723406,44,3,18,37.095065609622736,0.5980113636363636,45.97222222222222,1016.1111111111111,23.093434343434343,0
804,4,2,0,49,0.04081632653061224,0.0,1.0,49,1450,1000,450,0.6896551724137931,19,10,9,342.89348946834957,0.8441043083900227,0.1532128861519675,0.19279345103310147,129744.38707325312,-901.8359125410561,128842.55116071207,802,0,322.3469387755102,40,9,18,36.566292601828785,0.6106770833333335,45.29979674796747,1018.8008130081282,25.470020325203205,0
805,4,1,1,49,0.02,0.02,0.98,50,1700,1200,500,0.7058823529411765,22,12,10,340.91191539751225,0.8467687074829932,0.16932573599240253,0.19362472864810146,130138.96869929675,-1126.814982573179,129012.15371672357,803,0,316.88,42,8,19,36.21656378600823,0.6116071428571429,44.91279069767441,1020.348837209301,24.294019933554786,0
806,4,1,0,50,0.02,0.0,1.0,50,1600,1100,500,0.6875,21,11,10,341.6749399931407,0.848452380952381,0.1940865241173546,0.19598069147923727,130522.07396597594,-1080.5995896083284,129441.47437636761,804,0,317.04,40,10,17,35.80909166252279,0.6184895833333333,44.53760162601626,1021.849593495935,25.546239837398375,0
807,4,0,1,49,0.0,0.02,0.98,50,2000,1600,400,0.8,24,16,8,339.69443774727347,0.8474829931972789,0.18489860834990002,0.19549920158681783,130651.91436975366,-1123.6542815123084,129528.26008824135,805,1,318.04,40,10,18,35.728338303512245,0.6197916666666665,44.41056910569107,1022.3577235772375,25.558943089430937,0
808,4,1,0,50,0.02,0.0,1.0,50,1500,1000,500,0.6666666666666666,20,10,10,330.81172969240004,0.8496428571428571,0.19088055797733205,0.19260967205948382,131099.4300063777,-1326.1541595804879,129773.2758467972,806,0,310.16,41,9,19,35.50354790274145,0.6227134146341463,43.97321428571429,1024.1071428571438,24.9782229965157,0
809,4,1,3,48,0.0196078431372549,0.058823529411764705,0.9411764705882353,51,1700,1400,300,0.8235294117647058,20,14,6,324.40046598503363,0.8543137254901961,0.19812350069928786,0.1908715359895266,131501.9954949374,-1668.1382766960915,129833.85721824132,807,0,305.05882352941177,42,9,21,35.26216343882853,0.6252480158730158,43.58042635658916,1025.678294573645,24.420911775562974,0
810,4,0,0,48,0.0,0.0,1.0,48,1450,1100,350,0.7586206896551724,18,11,7,338.11275348166794,0.8491245567375887,0.19149322362052223,0.19777490053599292,131277.28666698182,-722.6950270848881,130554.59163989693,808,1,317.9583333333333,41,7,21,35.137141013230064,0.6244918699186991,43.799603174603185,1024.801587301589,24.995160665892417,0
811,4,0,0,48,0.0,0.0,1.0,48,1250,900,350,0.72,16,9,7,340.8698631641259,0.8486443557919622,0.19147088021178016,0.19952299627487344,131303.29574732608,-648.5327091220288,130654.76303820405,809,2,318.9583333333333,42,6,21,35.04026031325834,0.6232638888888888,43.77422480620156,1024.9031007751953,24.402454780361793,0
812,4,0,0,48,0.0,0.0,1.0,48,1150,900,250,0.782608695652174,14,9,5,344.80421815688834,0.8467235520094563,0.19641795481569568,0.2027834597691911,131484.42147531238,-532.7186759489363,130951.70279936344,810,3,319.9583333333333,40,8,21,34.756696723477354,0.6281249999999999,43.59756097560976,1025.6097560975616,25.64024390243904,0
813,4,0,0,48,0.0,0.0,1.0,48,1050,600,450,0.5714285714285714,15,6,9,347.403652930911,0.8456153959810875,0.20090005156965063,0.20483743321616238,131582.4642935881,-457.55424855124454,131124.91004503684,811,4,320.9583333333333,41,7,17,34.59114935860245,0.6275406504065039,43.50198412698414,1025.9920634920659,25.024196670538192,0
814,4,0,0,48,0.0,0.0,1.0,48,1150,900,250,0.782608695652174,14,9,5,345.07419955791187,0.8448581560283688,0.20406441246117368,0.20405124108064443,131692.36868866242,-511.27225737486486,131181.09643128756,812,5,321.9583333333333,43,5,17,34.54010594458283,0.6257267441860463,43.394886363636374,1026.4204545454563,23.870243128964102,0
815,4,0,0,48,0.0,0.0,1.0,48,1900,1300,600,0.6842105263157895,25,13,12,350.07425669215564,0.8426972517730497,0.20462070925908815,0.2080687924569764,131886.8382421519,-365.9626269800036,131520.87561517188,813,6,322.9583333333333,43,5,17,34.21577778802128,0.6276647286821704,43.205492424242436,1027.1780303030323,23.88786116983796,0
816,4,0,0,48,0.0,0.0,1.0,48,800,500,300,0.625,11,5,6,346.9591678659398,0.8420323581560284,0.20025228089576963,0.20674650908914424,131984.12682399293,-441.37943712693874,131542.747386866,814,7,323.9583333333333,43,5,17,34.197788990262026,0.6286337209302325,43.11079545454546,1027.5568181818194,23.896670190274868,0
817,4,1,1,48,0.02040816326530612,0.02040816326530612,0.9795918367346939,49,1350,700,650,0.5185185185185185,20,7,13,323.8904507175252,0.8464073129251701,0.13236433023100402,0.18836270736004918,131055.1323256567,-1293.1668577557302,129761.96546790097,815,0,318.3265306122449,42,7,15,35.72541087031955,0.62078373015873,44.016472868217065,1023.9341085271334,24.37938353636032,5
818,4,0,0,48,0.0,0.0,1.0,48,1750,1000,750,0.5714285714285714,25,10,15,339.85274436735733,0.8435098995271867,0.10407583564539591,0.19987143916989358,131484.4214753125,-640.2772849567934,130844.1441903557,816,1,325.7291666666667,40,8,17,34.88365371911747,0.6281249999999998,43.59756097560977,1025.6097560975625,25.64024390243906,4
819,4,1,0,49,0.02040816326530612,0.0,1.0,49,1150,700,450,0.6086956521739131,16,7,9,339.0674308472773,0.8458758503401361,0.1167363497122984,0.20139788362374456,131862.52170138914,-857.942708333308,131004.57899305582,817,0,320.0612244897959,41,8,16,34.522903989181884,0.6303353658536585,43.22916666666668,1027.0833333333353,25.05081300813013,0
820,4,0,1,48,0.0,0.02040816326530612,0.9795918367346939,49,1300,900,400,0.6923076923076923,17,9,8,336.9392698917725,0.8462301587301587,-0.0006688032288122425,0.19481954060883538,130831.98594585656,-956.3864992713852,129875.59944658518,818,1,321.0612244897959,42,7,12,35.61675191008397,0.6185515873015873,44.234496124031004,1023.0620155038755,24.35861941675894,7
821,4,0,2,46,0.0,0.041666666666666664,0.9583333333333334,48,1150,500,650,0.43478260869565216,18,5,13,341.1258257479511,0.8439901004728132,0.0036058857752352402,0.19730962652488063,130845.55820302671,-673.040182508175,130172.51802051853,819,2,328.4166666666667,41,7,12,35.49595575164033,0.6201727642276422,44.221230158730165,1023.1150793650804,24.954026325977573,0
822,4,0,0,46,0.0,0.0,1.0,46,1050,800,250,0.7619047619047619,13,8,5,331.50486699950125,0.8344001610305959,-0.035874961380401804,0.18681017546274684,129832.5314645533,-573.6659304925797,129258.86553406072,820,3,343.32608695652175,41,5,14,36.76699033064019,0.610010162601626,45.213293650793645,1019.1468253968245,24.85723964382499,7
823,4,2,2,46,0.041666666666666664,0.041666666666666664,0.9583333333333334,48,1150,900,250,0.782608695652174,14,9,5,316.87312359020666,0.8383569739952719,-0.02140578611584909,0.1827474834082537,130732.87080854527,-1306.2884609624434,129426.58234758282,821,0,329.9791666666667,42,6,12,36.22994441286083,0.6175595238095237,44.33139534883721,1022.674418604652,24.34939091915838,1
824,4,1,0,47,0.02127659574468085,0.0,1.0,47,1800,1400,400,0.7777777777777778,22,14,8,320.93632786151164,0.8402328091273512,-0.009781868460696286,0.18526615566921512,130769.44464128233,-1006.2669280675292,129763.1777132148,822,0,337.8936170212766,41,6,13,36.08915292596186,0.619410569105691,44.29563492063492,1022.8174603174594,24.946767324816083,0
825,4,0,0,47,0.0,0.0,1.0,47,1850,1300,550,0.7027027027027027,24,13,11,320.98852146661994,0.8381514030218933,-0.009751185669261586,0.18643450958190436,131005.52780970195,-989.745864881919,130015.78194482003,823,1,338.8936170212766,42,5,15,35.8497002681811,0.6202876984126984,44.064922480620154,1023.7403100775194,24.374769287559985,0
826,4,0,0,47,0.0,0.0,1.0,47,1100,700,400,0.6363636363636364,15,7,8,310.7489287694682,0.8385368485969781,-0.03321748037010819,0.1743877197168118,129669.75509472113,-1333.6911656450634,128336.06392907606,824,2,339.8936170212766,42,5,13,37.46055719405069,0.6068948412698412,45.37306201550389,1018.5077519379865,24.25018456995206,6
827,4,0,1,46,0.0,0.02127659574468085,0.9787234042553191,47,750,400,350,0.5333333333333333,11,4,7,312.62080821524097,0.8373419673142152,-0.03158608269847529,0.17588056706170482,129768.46648526248,-1286.335425304953,128482.13105995754,825,3,340.8936170212766,42,5,14,37.3129656046917,0.6078869047619047,45.27616279069768,1018.8953488372108,24.25941306755264,0
828,4,1,1,46,0.02127659574468085,0.02127659574468085,0.9787234042553191,47,1100,800,300,0.7272727272727273,14,8,6,311.6588008268335,0.8428923835954363,-0.022906412905886797,0.1761156768152495,129941.30179226027,-1300.529941109285,128640.77185115099,826,0,337.1276595744681,42,5,14,37.16261167078503,0.6096230158730158,45.10658914728683,1019.5736434108543,24.275562938353673,0
829,4,1,1,46,0.02127659574468085,0.02127659574468085,0.9787234042553191,47,1250,900,350,0.72,16,9,7,316.6480276658521,0.841427690410114,-0.02715499037107283,0.17972976190262857,130114.25212014018,-1159.9157389880274,128954.33638115216,827,0,338.1063829787234,42,5,16,36.86049640674961,0.6113591269841269,44.937015503875976,1020.2519379844975,24.291712809154703,0
830,4,0,1,45,0.0,0.021739130434782608,0.9782608695652174,46,1000,700,300,0.7,13,7,6,322.4522636232933,0.8342391304347826,-0.030782473341595673,0.1824153449523297,129984.23450688145,-817.2578695830196,129166.97663729843,828,1,346.3478260869565,41,5,16,36.844030709861535,0.6115345528455285,45.06448412698413,1019.7420634920634,24.871757646147888,0
831,4,0,1,44,0.0,0.022222222222222223,0.9777777777777777,45,1350,1200,150,0.8888888888888888,15,12,3,344.41801697835183,0.8364478114478114,0.07859821367696229,0.19332487772757265,129678.3908420135,-37.87017845336544,129640.52066356014,829,2,349.24444444444447,39,6,17,36.59448080725438,0.6116452991452994,45.364583333333314,1018.5416666666636,26.116452991452913,5
832,4,1,0,45,0.022222222222222223,0.0,1.0,45,1350,1000,350,0.7407407407407407,17,10,7,335.91987299334346,0.8393518518518519,0.10648591174906952,0.1897493336638071,129925.63950029723,-271.0791360962621,129654.56036420097,830,0,349.64444444444445,40,5,18,36.56009104199892,0.6125000000000002,45.121951219512184,1019.5121951219495,25.48780487804874,0
833,4,1,1,45,0.021739130434782608,0.021739130434782608,0.9782608695652174,46,950,500,450,0.5263157894736842,14,5,9,333.98148283145366,0.8398550724637681,0.12609907227914707,0.19067306474377527,130340.40584308273,-493.3072451913648,129847.09859789137,831,0,343.0217391304348,40,6,19,36.189415804140104,0.6166666666666667,44.71544715447154,1021.1382113821131,25.528455284552827,0
834,4,0,0,45,0.0,0.0,1.0,45,1550,1200,350,0.7741935483870968,19,12,7,333.66508738232295,0.8339646464646465,0.1374709899874016,0.19125819775039196,130496.11363110579,-291.6005684447111,130204.51306266108,832,1,350.84444444444443,40,5,16,36.03996750878589,0.6182291666666667,44.5630081300813,1021.7479674796746,25.543699186991866,0
835,4,0,0,45,0.0,0.0,1.0,45,1050,600,450,0.5714285714285714,15,6,9,332.3339288603567,0.8329545454545455,0.13584417265255966,0.19084192503452582,130566.58340419493,-321.65887188209786,130244.92453231283,833,2,351.84444444444443,41,4,16,36.002717918850706,0.6173780487804879,44.49404761904761,1022.0238095238088,24.92740998838558,0
836,4,1,0,46,0.021739130434782608,0.0,1.0,46,1250,1000,250,0.8,15,10,5,327.5192877995157,0.8366747181964573,0.1433173047904559,0.18954718289629152,130867.47378795038,-627.6756377697527,130239.79815018064,834,0,345.17391304347825,43,3,17,35.82186102113221,0.6174903100775193,44.1998106060606,1023.2007575757564,23.795366455250146,0
837,4,1,1,46,0.02127659574468085,0.02127659574468085,0.9787234042553191,47,1400,1200,200,0.8571428571428571,16,12,4,322.03525625572007,0.8405026210299105,0.1447700965928984,0.18768988433618433,131138.3787722909,-953.7637174211143,130184.61505486978,835,0,338.8085106382979,44,3,18,35.68899535948895,0.618844696969697,43.93518518518519,1024.25925925926,23.278619528619547,0
838,4,0,0,46,0.0,0.0,1.0,46,950,600,350,0.631578947368421,13,6,7,327.05743840615577,0.8371376811594203,0.1468818864707495,0.19011532387351382,131037.09323347113,-628.6687901744626,130408.42444329667,836,1,347.0652173913044,43,3,18,35.662535454433375,0.6191860465116279,44.034090909090914,1023.8636363636367,23.810782241014806,0
839,4,1,0,47,0.02127659574468085,0.0,1.0,47,1550,1300,250,0.8387096774193549,18,13,5,327.9273510124891,0.8426611162503854,0.1724361547725659,0.1924548082177219,131404.40095308988,-780.812085078487,130623.58886801139,837,0,340.6595744680851,41,6,20,35.27001693275279,0.625762195121951,43.675595238095255,1025.2976190476215,25.0072590011615,0
840,4,1,0,48,0.020833333333333332,0.0,1.0,48,1550,1200,350,0.7741935483870968,19,12,7,324.0303042863499,0.8450428486997635,0.17859165565414425,0.1917752538329382,131725.71228441814,-1063.3754732287518,130662.3368111894,838,0,334.5416666666667,42,6,18,35.04656723931787,0.6274801587301586,43.362403100775204,1026.5503875969005,24.4416758951643,0
841,4,0,0,48,0.0,0.0,1.0,48,1150,800,350,0.6956521739130435,15,8,7,323.76700969074363,0.8440639775413712,0.1791666666666667,0.19174463206670944,131750.5814422963,-1068.701644282178,130681.87979801412,839,1,335.5416666666667,42,6,18,35.02831524303918,0.6277281746031744,43.33817829457365,1026.6472868217068,24.443983019564445,0
842,4,0,0,48,0.0,0.0,1.0,48,1450,1100,350,0.7586206896551724,18,11,7,320.6888572445709,0.8430851063829787,0.1771383647798741,0.19054382773500309,131874.96244216108,-1141.8337990505224,130733.12864311055,840,2,336.5416666666667,42,6,18,34.98231132075473,0.6289682539682538,43.2170542635659,1027.1317829457375,24.45551864156518,0
843,4,0,0,48,0.0,0.0,1.0,48,1400,1200,200,0.8571428571428571,16,12,4,319.298349933105,0.8421616430260047,0.17288402457757268,0.19014199213908864,131959.80131571426,-1173.0906364783941,130786.71067923587,841,3,337.5416666666667,43,5,18,34.932795698924735,0.628391472868217,43.13446969696971,1027.4621212121235,23.894467935165665,0
844,4,0,1,47,0.0,0.020833333333333332,0.9791666666666666,48,1600,1200,400,0.75,20,12,8,320.06588289982466,0.8418661347517731,0.1738209285187915,0.19133453880839796,132105.7879935725,-1143.488865932004,130962.29912764051,842,4,338.5416666666667,43,5,18,34.76648857774504,0.6298449612403099,42.99242424242426,1028.0303030303064,23.907681465821078,0
845,4,0,1,46,0.0,0.02127659574468085,0.9787234042553191,47,1100,800,300,0.7272727272727273,14,8,6,323.31934976160284,0.8368023435090964,0.16626879205267175,0.19286417455408125,132024.29710504191,-862.798021453026,131161.4990835889,843,5,346.59574468085106,42,5,18,34.764716512665785,0.6304563492063491,43.071705426356594,1027.7131782945748,24.469361387966067,0
846,4,0,0,46,0.0,0.0,1.0,46,1450,800,650,0.5517241379310345,21,8,13,336.8986521170457,0.8324074074074075,0.1669771657309731,0.20132317377374986,132091.88102324252,-299.68466553289585,131792.19635770962,844,6,354.9347826086956,41,5,18,34.347857556456276,0.6326219512195121,43.00595238095237,1027.9761904761895,25.072590011614377,0
847,4,0,0,46,0.0,0.0,1.0,46,1150,900,250,0.782608695652174,14,9,5,338.01364987352963,0.8304549114331723,0.15980535626679893,0.2029451960358207,132270.40939350252,-258.159230127259,132012.25016337525,845,7,355.9347826086956,41,5,18,34.13972337416016,0.6344004065040652,42.83234126984126,1028.670634920633,25.089527680991047,0
848,4,0,0,46,0.0,0.0,1.0,46,600,300,300,0.5,9,3,6,338.00505950192246,0.8299315619967794,0.1646142367936827,0.2034896391302053,132372.47973552824,-251.48642211516218,132120.99331341308,846,8,356.9347826086956,41,5,19,34.03738471673254,0.6354166666666667,42.73313492063491,1029.0674603174587,25.09920634920631,0
849,4,1,0,47,0.02127659574468085,0.0,1.0,47,1250,1000,250,0.8,15,10,5,331.4301074031413,0.8329478877582485,0.16957902180961204,0.20134031509649183,132711.9596986747,-603.0472677275213,132108.91243094718,847,0,350.3191489361702,40,7,17,33.86593023638097,0.6403645833333333,42.40345528455284,1030.3861788617883,25.759654471544707,0
850,4,0,0,47,0.0,0.0,1.0,47,1500,1100,400,0.7333333333333333,19,11,8,331.36968360268224,0.8324082639531297,0.16954983909338495,0.20172577017397383,132790.50684942826,-599.4503519730304,132191.05649745523,848,1,351.3191489361702,40,7,18,33.7887415368435,0.6411458333333333,42.327235772357724,1030.6910569105692,25.76727642276423,0
851,4,0,0,47,0.0,0.0,1.0,47,1300,1100,200,0.8461538461538461,15,11,4,332.7384870218957,0.8312133826703669,0.16938661254033827,0.2032689601331233,132921.47040658674,-554.3822088373254,132367.08819774943,849,2,352.3191489361702,40,7,18,33.62221181958544,0.6424479166666666,42.20020325203252,1031.1991869918702,25.779979674796756,0
852,4,0,0,47,0.0,0.0,1.0,47,1000,700,300,0.7,13,7,6,329.0075563802154,0.8302497687326549,0.17214509665845146,0.20169593673743644,133052.49851279007,-644.9445188049344,132407.55399398514,850,3,353.3191489361702,40,7,19,33.58718314946153,0.6437499999999999,42.07317073170732,1031.7073170731712,25.79268292682928,0
853,4,0,0,47,0.0,0.0,1.0,47,1300,1000,300,0.7692307692307693,16,10,6,329.28282231031983,0.8307123034227567,0.17245880344029252,0.2022908082614218,133131.14636005374,-632.4400778306357,132498.7062822231,851,4,354.3191489361702,40,7,19,33.50135401280158,0.64453125,41.996951219512205,1032.0121951219528,25.80030487804882,0
854,4,1,0,48,0.020833333333333332,0.0,1.0,48,1750,1200,550,0.6857142857142857,23,12,11,323.9350882810005,0.8304890661938534,0.175610392136063,0.20130099388431033,133557.21381819385,-945.4810240742227,132611.73279411963,852,0,347.9166666666667,37,11,20,33.21344277076481,0.6539977477477479,41.58442982456139,1033.6622807017527,27.936818397344666,0
855,4,0,1,47,0.0,0.020833333333333332,0.9791666666666666,48,1200,700,500,0.5833333333333334,17,7,10,324.28180175980424,0.8291038711583925,0.1792567854113658,0.2022900763358777,133698.92659279768,-928.7742382271647,132770.1523545705,853,1,348.9166666666667,37,11,20,33.06297709923662,0.6554054054054055,41.44736842105262,1034.2105263157885,27.95163584637266,0
856,4,0,0,47,0.0,0.0,1.0,47,1250,800,450,0.64,17,8,9,326.56543531129273,0.8267036694418748,0.17141259094538142,0.20402770309448556,133755.63274276673,-664.0067136042142,133091.62602916252,854,2,355.3191489361702,37,10,16,32.94731821072715,0.6559684684684686,41.39254385964911,1034.4298245614013,27.95756282598382,0
857,4,0,1,46,0.0,0.02127659574468085,0.9787234042553191,47,1100,800,300,0.7272727272727273,14,8,6,324.6957564788116,0.8260484119642306,0.16929457299634043,0.20342840215095498,133858.89788333682,-707.3167780700051,133151.5811052668,855,3,356.3191489361702,38,9,16,32.8926199325487,0.65515350877193,41.29273504273503,1034.8290598290585,27.232343679712063,0
858,4,0,0,46,0.0,0.0,1.0,46,1450,1200,250,0.8275862068965517,17,12,5,329.1832710518521,0.8221014492753623,0.1677756570768183,0.20588465038331166,133795.3342013887,-391.3628472222418,133403.97135416645,856,9,365.0,39,7,17,32.8399785206068,0.6527777777777779,41.35416666666666,1034.5833333333317,26.527777777777736,0
859,4,0,0,46,0.0,0.0,1.0,46,1100,800,300,0.7272727272727273,14,8,6,329.58822178078026,0.8211956521739131,0.17066366162666058,0.20659047213829948,133876.1732313366,-375.198025173631,133500.97520616298,857,10,366.0,39,7,17,32.74880473074987,0.6535790598290598,41.27604166666666,1034.8958333333317,26.535790598290557,0
860,4,0,1,45,0.0,0.021739130434782608,0.9782608695652174,46,1200,900,300,0.75,15,9,6,336.15032419552244,0.8215780998389695,0.17470482011390498,0.20311785998686951,132510.87474030454,-287.8944573089959,132222.98028299556,858,11,367.0,37,9,20,33.946130635427764,0.6435810810810811,42.59868421052631,1029.6052631578934,27.82716927453766,4
861,4,1,1,45,0.021739130434782608,0.021739130434782608,0.9782608695652174,46,1100,1000,100,0.9090909090909091,12,10,2,335.6772018418208,0.8248188405797102,0.18323245784515096,0.20374825507143063,132680.2718144044,-292.4515235457099,132387.82029085868,859,0,367.54347826086956,37,9,14,33.78831417624521,0.6452702702702702,42.43421052631579,1030.2631578947367,27.84495021337126,0
862,4,0,0,45,0.0,0.0,1.0,45,1400,900,500,0.6428571428571429,19,9,10,341.3468743104073,0.8223484848484849,0.18918277264921812,0.20684633659501162,132618.0021938234,53.748105230462556,132671.75029905385,860,1,375.8666666666667,38,7,21,33.70479376274937,0.6428179824561404,42.49465811965811,1030.0213675213665,27.105825461088592,0
863,4,0,0,45,0.0,0.0,1.0,45,1050,700,350,0.6666666666666666,14,7,7,346.23870820754246,0.8219276094276095,0.20104810937194073,0.21073595066739156,132783.12108490372,194.93126324053196,132978.05234814424,861,2,376.8666666666667,38,7,15,33.41302131923569,0.6444627192982457,42.334401709401696,1030.6623931623913,27.12269455690503,0
864,4,0,0,45,0.0,0.0,1.0,45,1350,900,450,0.6666666666666666,18,9,9,341.0151376347791,0.8203282828282829,0.1988926873625929,0.2084749286629841,132948.3427044523,67.47947713490305,133015.82218158722,862,3,377.8666666666667,38,7,16,33.38189336648365,0.646107456140351,42.17414529914529,1031.3034188034173,27.13956365272151,0
865,4,0,0,45,0.0,0.0,1.0,45,1050,900,150,0.8571428571428571,12,9,3,343.88254746370177,0.8201599326599327,0.19706863624859072,0.2110049328719461,133086.10586054495,153.197823069616,133239.30368361456,863,4,378.8666666666667,38,7,17,33.16982467039415,0.6474780701754386,42.04059829059829,1031.8376068376067,27.153621232568597,0
866,4,0,0,45,0.0,0.0,1.0,45,1650,1100,550,0.6666666666666666,22,11,11,346.2038598952987,0.8191498316498317,0.20242160819621247,0.21321656457414084,133223.94035585134,224.5284763313523,133448.4688321827,864,5,379.8666666666667,38,7,17,32.97177377625995,0.6488486842105263,41.90705128205128,1032.3717948717942,27.167678812415637,0
867,4,0,0,45,0.0,0.0,1.0,45,1000,500,500,0.5,15,5,10,345.7026057838485,0.8174663299663301,0.19414333655128035,0.21369902766740692,133361.8461903717,220.70754803125027,133582.55373840296,865,6,380.8666666666667,38,7,17,32.84654702799613,0.6502192982456141,41.773504273504265,1032.9059829059818,27.18173639226268,0
868,4,0,0,45,0.0,0.0,1.0,45,1050,800,250,0.7619047619047619,13,8,5,344.06367163475255,0.8162457912457913,0.18957478831328523,0.21316077952464402,133444.62393390675,182.68945412374882,133627.3133880305,866,7,381.8666666666667,38,7,19,32.80598352462689,0.6510416666666666,41.69337606837607,1033.2264957264956,27.190170940170937,0
869,4,0,0,45,0.0,0.0,1.0,45,1150,700,450,0.6086956521739131,16,7,9,342.71264796988277,0.8171296296296297,0.18569443008603592,0.21264011826893353,133499.82336410612,150.4155937248812,133650.238957831,867,8,382.8666666666667,38,7,19,32.78563182742342,0.6515899122807018,41.63995726495726,1033.4401709401702,27.195793972109744,0
870,4,1,0,46,0.021739130434782608,0.0,1.0,46,1200,1000,200,0.8333333333333334,14,10,4,335.1903112181222,0.8200684380032206,0.1835286805962828,0.20994833238592872,133849.22417534734,-227.00737847221694,133622.21679687512,868,0,375.5217391304348,39,7,16,32.630779813435325,0.6533119658119659,41.302083333333336,1034.7916666666674,26.533119658119677,0
871,4,0,1,45,0.0,0.021739130434782608,0.9782608695652174,46,900,600,300,0.6666666666666666,12,6,6,335.21753617175335,0.8189412238325282,0.18211033861151282,0.2104268260858316,133930.07948133687,-220.85774739582837,133709.22173394106,869,1,376.5217391304348,39,7,16,32.54933162255542,0.6541132478632479,41.223958333333336,1035.1041666666672,26.54113247863249,0
872,4,1,0,46,0.021739130434782608,0.0,1.0,46,950,700,250,0.7368421052631579,12,7,5,331.93966906515357,0.8227254428341385,0.18642845277542186,0.20975044145629096,134172.79188368062,-292.54557291666225,133880.24631076396,870,0,374.80434782608694,39,7,18,32.392000134057234,0.656517094017094,40.989583333333336,1036.0416666666672,26.565170940170955,0
873,4,0,0,46,0.0,0.0,1.0,46,1650,1300,350,0.7878787878787878,20,13,7,333.58836240320136,0.8217995169082126,0.18813784426114966,0.21172649123958268,134334.7222222221,-237.50000000000807,134097.2222222221,871,1,375.80434782608694,39,7,18,32.18783494105038,0.6581196581196582,40.83333333333333,1036.6666666666656,26.581196581196554,0
874,4,0,0,46,0.0,0.0,1.0,46,1450,900,550,0.6206896551724138,20,9,11,333.9959060715403,0.8218196457326893,0.18416164284344827,0.21262808617966733,134445.36491382445,-219.15970569766552,134226.20520812678,872,2,376.80434782608694,40,6,18,32.06700146986772,0.6575520833333334,40.72662601626016,1037.0934959349595,25.927337398373986,0
875,4,0,0,46,0.0,0.0,1.0,46,1250,700,550,0.56,18,7,11,338.0556952025279,0.8218196457326893,0.1791820191599116,0.2121838937973316,133925.82333025566,-144.95729214898722,133780.86603810667,873,3,377.80434782608694,37,9,17,32.48013771186442,0.6576576576576575,41.22807017543861,1035.0877192982473,27.975343764817495,1
876,4,0,0,46,0.0,0.0,1.0,46,950,800,150,0.8421052631578947,11,8,3,337.8311661716226,0.8206723027375201,0.18152323583997632,0.21220652294253434,133954.19894823417,-149.21935114649114,133804.9795970877,874,4,378.80434782608694,37,9,17,32.45760953994988,0.657939189189189,41.20065789473685,1035.1973684210536,27.978307254623072,0
877,4,0,0,46,0.0,0.0,1.0,46,1300,1100,200,0.8461538461538461,15,11,4,339.94712743260334,0.8199677938808374,0.1811302598197877,0.21386547130886577,134010.959201389,-88.67187499999483,133922.287326389,875,5,379.80434782608694,37,9,17,32.34616029510395,0.6585022522522521,41.145833333333336,1035.4166666666674,27.984234234234254,0
878,4,0,0,46,0.0,0.0,1.0,46,1200,900,300,0.75,15,9,6,337.59669319597947,0.8193639291465379,0.18454213668015096,0.21304448634752302,134124.51577648908,-144.00139946905455,133980.51437702,876,6,380.80434782608694,37,9,17,32.2936514237324,0.6596283783783783,41.03618421052632,1035.855263157896,27.996088193456647,0
879,4,0,1,45,0.0,0.021739130434782608,0.9782608695652174,46,1500,1100,400,0.7333333333333333,19,11,8,334.5067488574765,0.818659420289855,0.17932765575974852,0.21179604855858533,134246.13284388947,-218.7525111403134,134027.38033274916,877,7,381.80434782608694,38,8,17,32.252362542955325,0.6589912280701753,40.91880341880343,1036.324786324788,27.271704903283894,0
880,4,0,0,45,0.0,0.0,1.0,45,950,500,450,0.5263157894736842,14,5,9,339.2688978783264,0.8161616161616162,0.1764300040112312,0.21400207969618568,134107.77043839946,99.71909471107821,134207.48953311052,878,8,391.0888888888889,38,7,17,32.26706205948081,0.6576206140350876,41.052350427350426,1035.7905982905984,27.2576473234368,0
881,4,0,0,45,0.0,0.0,1.0,45,750,400,350,0.5333333333333333,11,4,7,337.8952986871433,0.815530303030303,0.17354199479463328,0.21367098131220721,134199.77349175373,69.09450954863561,134268.86800130235,879,9,392.0888888888889,39,6,17,32.21082152072652,0.6567841880341879,40.96354166666668,1036.1458333333353,26.56784188034193,0
882,4,0,0,45,0.0,0.0,1.0,45,1550,1000,550,0.6451612903225806,21,10,11,336.1731164896971,0.8154040404040405,0.16362986780993238,0.2133670188332569,134334.72222222236,31.94444444446296,134366.66666666683,880,10,393.0888888888889,39,6,18,32.12084673097536,0.658119658119658,40.83333333333334,1036.6666666666679,26.58119658119661,0
883,4,0,0,45,0.0,0.0,1.0,45,800,500,300,0.625,11,5,6,337.1023745944587,0.8143097643097643,0.16356412660149067,0.214590232830079,134442.73003472248,64.19270833335776,134506.92274305585,881,11,394.0888888888889,39,6,20,31.989085308691582,0.6591880341880341,40.72916666666668,1037.0833333333353,26.591880341880394,0
884,4,0,1,44,0.0,0.022222222222222223,0.9777777777777777,45,900,500,400,0.5555555555555556,13,5,8,337.55013690481775,0.8135942760942761,0.16083721034017207,0.21535309503107514,134523.76437717027,81.70301649306418,134605.46739366333,882,12,395.0888888888889,39,6,20,31.896714027512793,0.6599893162393162,40.65104166666667,1037.3958333333344,26.59989316239319,0
885,4,0,0,44,0.0,0.0,1.0,44,1200,600,600,0.5,18,6,12,336.44829267337,0.8106721282593375,0.13991970486111116,0.2153269073109568,134638.42220598977,259.7815939091538,134898.20379989894,883,13,385.04545454545456,36,8,20,31.811071325231477,0.6666666666666666,40.54054054054054,1037.8378378378377,28.828828828828826,0
886,4,1,1,44,0.022222222222222223,0.022222222222222223,0.9777777777777777,45,1350,900,450,0.6666666666666666,18,9,9,332.5418876601638,0.8140572390572391,0.1517986849805506,0.20787624907768637,133775.99172921665,-99.11085480106343,133676.8808744156,884,0,377.46666666666664,38,7,14,32.77242762229337,0.6543311403508772,41.372863247863236,1034.508547008545,27.22390913180382,2
887,4,1,1,44,0.022222222222222223,0.022222222222222223,0.9777777777777777,45,1100,700,400,0.6363636363636364,15,7,8,332.176030892159,0.8127104377104377,0.15494082025873968,0.2084275509898468,133914.18292059304,-103.38364745417698,133810.79927313887,885,0,378.44444444444446,38,7,15,32.64390655105973,0.655701754385965,41.23931623931623,1035.042735042734,27.237966711650895,0
888,4,0,0,44,0.0,0.0,1.0,44,800,500,300,0.625,11,5,6,339.0482076140115,0.8060253699788584,0.18489118471314092,0.19707302381065106,131034.6693250864,85.41395399301544,131120.0832790794,886,1,387.45454545454544,39,5,13,35.35806033167159,0.6252670940170941,44.036458333333314,1023.8541666666634,26.25267094017086,7
889,4,0,0,44,0.0,0.0,1.0,44,1050,800,250,0.7619047619047619,13,8,5,339.0482076140115,0.8060253699788584,0.18489118471314092,0.19707302381065106,131034.6693250864,85.41395399301544,131120.0832790794,887,2,388.45454545454544,39,5,13,35.35806033167159,0.6252670940170941,44.036458333333314,1023.8541666666634,26.25267094017086,0
890,4,0,0,44,0.0,0.0,1.0,44,1550,1100,450,0.7096774193548387,20,11,9,343.0445771601534,0.8043957011980268,0.19294495540047185,0.2002280959270092,131194.69536675327,201.12575954858704,131395.82112630186,888,3,389.45454545454544,39,5,14,35.0941577698695,0.6268696581196582,43.88020833333332,1024.479166666665,26.268696581196536,0
891,4,0,0,44,0.0,0.0,1.0,44,1350,900,450,0.6666666666666666,18,9,9,345.313485525333,0.8060914376321353,0.19036256456217848,0.20211418108767087,131301.43364800327,268.0311414930343,131569.4647894963,889,4,390.45454545454544,39,5,16,34.92828285394857,0.6279380341880343,43.77604166666666,1024.8958333333317,26.279380341880298,0
892,4,0,0,44,0.0,0.0,1.0,44,1300,900,400,0.6923076923076923,17,9,8,342.51255646111196,0.8042635658914729,0.19503536276845224,0.20145631009056797,131488.330078125,207.2808159722218,131695.61089409722,890,5,391.45454545454544,39,5,16,34.8115139819893,0.6298076923076923,43.59375,1025.625,26.298076923076923,0
893,4,0,0,44,0.0,0.0,1.0,44,1050,700,350,0.6666666666666666,14,7,7,336.81877914916623,0.8036909795630727,0.18820950622981036,0.19866257333049642,131595.18771701405,64.7460937500203,131659.93381076408,891,6,392.45454545454544,39,5,10,34.84983079526227,0.6308760683760684,43.48958333333334,1026.041666666668,26.30876068376072,0
894,4,0,0,44,0.0,0.0,1.0,44,1200,900,300,0.75,15,9,6,336.8554852051857,0.8040213178294574,0.18558876435588778,0.19938203043225888,131728.8208007815,74.71516927086265,131803.53597005238,892,7,393.45454545454544,39,5,11,34.71429477422629,0.6322115384615383,43.359375000000014,1026.562500000002,26.322115384615437,0
895,4,0,0,44,0.0,0.0,1.0,44,900,600,300,0.6666666666666666,12,6,6,339.10319293497884,0.8029642353770261,0.18043273796899917,0.20127744606537995,131835.7760959203,141.18652343752035,131976.96261935783,893,8,394.45454545454544,39,5,11,34.54891047097407,0.6332799145299144,43.25520833333334,1026.979166666668,26.332799145299184,0
896,4,0,0,44,0.0,0.0,1.0,44,1800,1400,400,0.7777777777777778,22,14,8,341.71705845148364,0.8005857998590558,0.18197021911799882,0.20383195276193145,132023.0523003476,222.9058159722611,132245.95811631985,894,9,395.45454545454544,39,5,13,34.29327995134807,0.6351495726495724,43.072916666666686,1027.7083333333364,26.351495726495806,0
897,4,0,0,44,0.0,0.0,1.0,44,900,500,400,0.5555555555555556,13,5,8,341.8683243395385,0.7999471458773785,0.18100509503671458,0.2040662284487742,132049.81689453172,228.7299262153221,132278.54682074703,895,10,396.45454545454544,39,5,14,34.262461572244185,0.6354166666666665,43.04687500000002,1027.8125000000036,26.35416666666676,0
898,4,0,0,44,0.0,0.0,1.0,44,1200,800,400,0.6666666666666666,16,8,8,346.1435293031268,0.7999471458773785,0.19595867264971512,0.20359194680517245,131488.33007812497,302.76692708333246,131791.0970052083,896,11,397.45454545454544,39,5,16,34.71841356896203,0.6298076923076923,43.59375,1025.6249999999998,26.298076923076916,1
899,4,1,3,42,0.022222222222222223,0.06666666666666667,0.9333333333333333,45,750,400,350,0.5333333333333333,11,4,7,339.5542589542111,0.8053030303030303,0.19107635795748257,0.20120332423544826,131771.20642681263,-51.30513004826224,131719.90129676435,897,0,389.6,40,5,14,34.60234583786994,0.6309895833333334,43.318089430894304,1026.7276422764219,25.668191056910548,0
900,4,0,0,42,0.0,0.0,1.0,42,1400,1200,200,0.8571428571428571,16,12,4,352.633603623403,0.7945218737901665,0.1993279410015465,0.2086270728826141,131711.68456424854,889.1931934399718,132600.87775768852,898,13,410.45238095238096,38,4,15,34.32664619761308,0.6337719298245614,43.37606837606837,1026.4957264957254,27.013045434098036,0
901,4,0,0,42,0.0,0.0,1.0,42,1450,1100,350,0.7586206896551724,18,11,7,351.21279688097167,0.7940137437088657,0.19215333620702535,0.20823603891567025,131793.94866544288,857.544264555467,132651.49292999835,899,14,411.45238095238096,38,4,15,34.28016508861375,0.6345942982456141,43.29594017094016,1026.816239316238,27.02147998200626,0
902,4,0,0,42,0.0,0.0,1.0,42,1250,800,450,0.64,17,8,9,350.09396551882804,0.7920296167247387,0.1856360713199412,0.20838725298202748,131942.7747938366,838.4738498263694,132781.24864366298,900,15,412.45238095238096,39,3,16,34.15891463043698,0.6343482905982907,43.15104166666666,1027.3958333333317,26.343482905982864,0
903,4,0,0,42,0.0,0.0,1.0,42,1050,700,350,0.6666666666666666,14,7,7,347.3058341188099,0.7906987998451414,0.18364657843676757,0.2071656202790915,132023.05230034704,770.4752604166481,132793.5275607637,901,16,413.45238095238096,39,3,17,34.14968916818704,0.6351495726495727,43.07291666666666,1027.708333333332,26.35149572649569,0
904,4,0,1,41,0.0,0.023809523809523808,0.9761904761904762,42,1000,700,300,0.7,13,7,6,346.3295702075774,0.7903842431281456,0.17859675528604724,0.20731468693262536,132156.9023980033,753.9686414930313,132910.87103949633,902,17,414.45238095238096,39,3,19,34.04005419916927,0.6364850427350428,42.94270833333332,1028.2291666666652,26.364850427350387,0
905,4,0,0,41,0.0,0.0,1.0,41,1150,900,250,0.782608695652174,14,9,5,355.7723301939238,0.7902947154471545,0.1730779950641812,0.21324187113615836,132205.65440317008,1207.0227463656577,133412.67714953574,903,18,419.7317073170732,38,3,19,33.74822529261029,0.6387061403508774,42.89529914529913,1028.4188034188007,27.06365272154739,0
906,4,0,0,41,0.0,0.0,1.0,41,850,600,250,0.7058823529411765,11,6,5,357.1501311177122,0.7901930894308943,0.17429853982794086,0.2143791435412297,132260.5970121992,1247.3779129227378,133507.97492512193,904,19,420.7317073170732,38,3,19,33.65747472649217,0.6392543859649125,42.84188034188032,1028.6324786324756,27.0692757534862,0
907,4,0,0,41,0.0,0.0,1.0,41,900,700,200,0.7777777777777778,11,7,4,357.4882394400826,0.7889227642276423,0.16589315690727724,0.21536486619926898,132398.00347222207,1266.217172547275,133664.22064476935,905,20,421.7317073170732,37,4,19,33.51045883940619,0.642454954954955,42.70833333333332,1029.1666666666654,27.81531531531528,0
908,4,0,0,41,0.0,0.0,1.0,41,1250,900,350,0.72,16,9,7,343.9965896663658,0.7879065040650407,0.1354209871422647,0.2089107752356695,132700.54879830522,934.0475244722059,133634.59632277742,906,21,422.7317073170732,38,3,16,33.55367758882898,0.643640350877193,42.414529914529915,1030.3418803418804,27.11426000899685,7
909,4,2,1,42,0.046511627906976744,0.023255813953488372,0.9767441860465116,43,1150,700,450,0.6086956521739131,16,7,9,342.1418701605502,0.7940199335548173,0.17079124675413748,0.2116781564322579,133393.47367844885,527.8985103113378,133921.3721887602,907,0,404.0232558139535,40,3,17,32.90682898835873,0.6471354166666666,41.742886178861795,1033.0284552845542,25.825711382113855,0
910,4,0,0,42,0.0,0.0,1.0,42,850,500,350,0.5882352941176471,12,5,7,350.560106404691,0.7883275261324042,0.17630191071788825,0.2164042898440914,133310.81271701396,946.6905381944562,134257.50325520843,908,1,414.64285714285717,39,3,17,32.77225808620807,0.6479700854700854,41.82291666666667,1032.708333333334,26.47970085470087,0
911,4,0,1,41,0.0,0.023809523809523808,0.9761904761904762,42,1500,1200,300,0.8,18,12,6,348.56471563793644,0.7873354626403407,0.17657643022059455,0.21627110290992696,133499.82336410627,906.7632499748942,134406.58661408117,909,2,415.64285714285717,38,4,18,32.63443778214273,0.6515899122807017,41.63995726495727,1033.4401709401714,27.195793972109772,0
912,4,0,0,41,0.0,0.0,1.0,41,1400,1100,300,0.7857142857142857,17,11,6,357.83891398526686,0.7860264227642276,0.1847510518389719,0.22219957860508047,133528.88028047077,1356.3659010464607,134885.24618151723,910,3,421.7073170731707,37,4,18,32.36570832449253,0.6537162162162162,41.61184210526315,1033.5526315789461,27.933854907539086,0
913,4,0,1,40,0.0,0.024390243902439025,0.975609756097561,41,1200,1000,200,0.8333333333333334,14,10,4,355.92074861776996,0.7863821138211382,0.1831169133449364,0.22185648249928527,133670.57802641182,1315.2264398660939,134985.8044662779,911,4,422.7073170731707,37,4,19,32.273331742833896,0.655123873873874,41.474780701754376,1034.1008771929812,27.94867235656706,0
914,4,0,1,39,0.0,0.025,0.975,40,1150,700,450,0.6086956521739131,16,7,9,352.6564961594224,0.7864316239316239,0.1806656144552088,0.2205483478704294,133792.4215389373,1436.553318521194,135228.9748574585,912,5,426.875,36,4,14,32.23576793294874,0.6582754629629631,41.35698198198197,1034.57207207207,28.73811311311305,0
915,4,0,0,39,0.0,0.0,1.0,39,1300,1000,300,0.7692307692307693,16,10,6,350.9917862778399,0.7896986054880792,0.1618062843739425,0.22009597145136334,133891.14610125154,1598.9385073730898,135490.08460862463,913,6,415.56410256410254,35,4,15,32.18006784462834,0.6613095238095239,41.26157407407406,1034.9537037037023,29.57010582010578,0
916,4,0,0,39,0.0,0.0,1.0,39,450,400,50,0.8888888888888888,5,4,1,349.3332394609596,0.7893612235717499,0.15834136048805147,0.2194126751221081,133951.0459533606,1558.7105624142496,135509.75651577485,914,7,416.56410256410254,35,4,15,32.16308884913536,0.661904761904762,41.203703703703695,1035.1851851851839,29.57671957671954,0
917,4,0,0,39,0.0,0.0,1.0,39,900,800,100,0.8888888888888888,10,8,2,371.0017287292893,0.7893612235717499,0.18084585545889365,0.2164625116007211,131179.87403817297,1933.5920085305174,133113.46604670348,915,8,417.56410256410254,35,4,16,34.393124129100286,0.6342261904761906,43.894675925925924,1024.421296296296,29.26917989417989,5
918,4,0,0,39,0.0,0.0,1.0,39,1550,1300,250,0.8387096774193549,18,13,5,387.52196136777815,0.7893049932523617,0.22693064292486187,0.21609099027781462,129419.51600646375,2247.469841382659,131666.9858478464,916,9,418.56410256410254,33,6,20,35.76104520454453,0.6208964646464648,45.6188725490196,1017.5245098039206,30.834076054664262,3
919,4,1,0,40,0.025,0.0,1.0,40,1000,700,300,0.7,13,7,6,379.15918107962796,0.7997061965811966,0.2204049755765085,0.21327401092932663,129760.92470689717,1840.0091896004699,131600.93389649765,917,0,409.075,35,5,17,35.62575731758113,0.6199404761904762,45.28356481481481,1018.8657407407399,29.11044973544971,0
920,4,0,0,40,0.0,0.0,1.0,40,950,800,150,0.8421052631578947,11,8,3,383.1000467250389,0.7989583333333333,0.22287052810902885,0.21581547737773324,129819.89354263128,1946.8014564043315,131766.69499903562,918,1,410.075,35,5,17,35.46528960817718,0.6205357142857142,45.22569444444445,1019.0972222222231,29.117063492063515,0
921,4,2,0,42,0.047619047619047616,0.0,1.0,42,1050,700,350,0.6666666666666666,14,7,7,366.2917683635554,0.8140969802555168,0.2147175351664128,0.20901849809206247,130321.66950660155,1148.6579968278484,131470.3275034294,919,0,391.5,35,7,19,35.38360538048816,0.6255952380952381,44.7337962962963,1021.0648148148152,29.173280423280435,0
922,4,3,4,41,0.06666666666666667,0.08888888888888889,0.9111111111111111,45,1000,600,400,0.6,14,6,8,346.0796775086268,0.8269781144781145,0.21629629629629665,0.20140702543534839,131081.84633875734,72.9526216305025,131154.79896038785,920,0,366.3333333333333,38,7,15,35.130412102243085,0.6274671052631579,43.99038461538461,1024.0384615384612,26.94838056680161,0
923,4,0,0,41,0.0,0.0,1.0,41,800,500,300,0.625,11,5,6,376.6392610021944,0.8054369918699187,0.23193612660983853,0.21560650424681965,130444.94224773227,1626.1373299319503,132071.0795776642,921,1,403.0243902439024,34,7,19,34.99422173017908,0.628982843137255,44.61309523809523,1021.5476190476178,30.045518207282875,0
924,4,2,2,41,0.046511627906976744,0.046511627906976744,0.9534883720930233,43,1200,800,400,0.6666666666666666,16,8,8,360.9802152703688,0.8217054263565892,0.21449962876405837,0.2092788403312805,130935.05333371782,852.9927477685171,131788.04608148633,922,0,385.2325581395349,37,6,16,34.897507320905646,0.6278153153153154,44.13377192982455,1023.4649122806998,27.661213845424317,0
925,4,0,0,41,0.0,0.0,1.0,41,1100,800,300,0.7272727272727273,14,8,6,353.7844677917533,0.8044207317073171,0.15790254192404207,0.19731135127569102,129426.12879106699,1031.9722974554832,130458.10108852248,923,3,405.0243902439024,32,9,12,36.61253464036068,0.6233723958333335,45.61237373737372,1017.5505050505031,31.798453282828223,8
926,4,2,1,42,0.046511627906976744,0.023255813953488372,0.9767441860465116,43,1200,900,300,0.75,15,9,6,334.99596088955786,0.8176448874123292,0.15257503365625769,0.1894296800665597,129967.37423911157,107.70908350477272,130075.08332261634,924,0,387.13953488372096,35,8,14,36.54133560348089,0.6220238095238096,45.081018518518505,1019.675925925924,29.13359788359783,0
927,4,0,0,42,0.0,0.0,1.0,42,1000,700,300,0.7,13,7,6,343.4785937942109,0.8123548199767712,0.15709170169702702,0.19403368583467132,129928.5997732424,525.5385487528076,130454.13832199521,925,1,397.35714285714283,34,8,15,36.36443250817375,0.6237745098039217,45.119047619047606,1019.5238095238076,29.985994397759047,0
928,4,0,1,41,0.0,0.023809523809523808,0.9761904761904762,42,1500,1200,300,0.8,18,12,6,348.6016676285922,0.8118466898954704,0.16728892000155593,0.19800297503278066,130141.08737244873,673.4800170067729,130814.56738945551,926,2,398.35714285714283,34,8,16,36.018259246295656,0.625919117647059,44.91071428571427,1020.3571428571408,30.010504201680614,0
929,4,0,0,41,0.0,0.0,1.0,41,1000,700,300,0.7,13,7,6,350.6959622442934,0.8091463414634147,0.17909014524066746,0.19997591111958987,130293.86421388404,938.7631063454744,131232.6273202295,927,3,405.4146341463415,33,8,17,35.809901772496296,0.6297348484848485,44.7610294117647,1020.9558823529408,30.938057040998206,0
930,4,0,0,41,0.0,0.0,1.0,41,1000,700,300,0.7,13,7,6,349.0442266392386,0.8091971544715447,0.17642143795010545,0.19996645881294686,130475.34722222216,908.3333333333237,131383.68055555547,928,4,406.4146341463415,34,7,19,35.66816204458945,0.6292892156862746,44.58333333333333,1021.6666666666661,30.04901960784312,0
931,4,1,1,41,0.023809523809523808,0.023809523809523808,0.9761904761904762,42,900,400,500,0.4444444444444444,14,4,10,340.93827035004955,0.8165166473093303,0.16694690551639435,0.19664037577108595,130735.62349965706,514.5554698216711,131250.17896947873,929,0,397.7142857142857,35,7,13,35.61189074996227,0.6297619047619047,44.3287037037037,1022.6851851851851,29.219576719576718,0
932,4,0,0,41,0.0,0.0,1.0,41,700,400,300,0.5714285714285714,10,4,6,349.3369755243157,0.8083841463414634,0.1744156652000899,0.20092140715521067,130627.42524092959,926.5979308389904,131554.02317176858,930,6,408.4146341463415,34,7,14,35.50667675944257,0.6308210784313726,44.4345238095238,1022.2619047619038,30.066526610644228,0
933,4,1,0,42,0.023809523809523808,0.0,1.0,42,750,500,250,0.6666666666666666,10,5,5,342.96876294486594,0.814677700348432,0.18191509982554765,0.19902990416564284,130972.46334876555,583.892746913594,131556.35609567913,931,0,399.6666666666667,35,7,16,35.320556309362274,0.6321428571428571,44.09722222222223,1023.6111111111121,29.246031746031775,0
934,4,0,0,42,0.0,0.0,1.0,42,1250,700,550,0.56,18,7,11,341.70936438270536,0.81431475029036,0.18270115777745488,0.19875757703443753,131061.3335503473,556.9769965277876,131618.3105468751,932,1,400.6666666666667,35,7,17,35.26301288572398,0.6330357142857143,44.01041666666667,1023.958333333334,29.2559523809524,0
935,4,0,0,42,0.0,0.0,1.0,42,950,800,150,0.8421052631578947,11,8,3,350.9259508509004,0.8140727835849787,0.1316381234825399,0.19216538482884718,128701.77636584791,633.2299168381323,129335.00628268604,933,2,401.6666666666667,35,7,14,37.42312554655716,0.6092261904761904,46.32523148148148,1014.699074074074,28.991402116402114,7
936,4,0,0,42,0.0,0.0,1.0,42,1450,1200,250,0.8275862068965517,17,12,5,349.68212847598295,0.8128387533875339,0.13794759896435504,0.19233613248400008,128877.99968117729,613.2666484482374,129491.26632962552,934,3,402.6666666666667,35,7,14,37.27499620046354,0.6110119047619047,46.15162037037038,1015.3935185185198,29.011243386243425,0
937,4,1,1,42,0.023255813953488372,0.023255813953488372,0.9767441860465116,43,1000,600,400,0.6,14,6,8,348.70664826408824,0.8181524547803617,0.16888463231716289,0.194076842499662,129344.54038075256,420.660229486266,129765.20061023883,935,0,394.27906976744185,36,7,15,36.82469832835161,0.6137152777777777,45.69256756756758,1017.2297297297313,28.256381381381424,0
938,4,1,2,41,0.023255813953488372,0.046511627906976744,0.9534883720930233,43,850,600,250,0.7058823529411765,11,6,5,350.8811637518586,0.8182447397563676,0.168957245951594,0.19571371578159247,129430.46932067223,482.9427400373569,129913.41206070958,936,0,395.16279069767444,36,7,13,36.6819758005017,0.6145833333333333,45.60810810810812,1017.5675675675693,28.265765765765813,0
939,4,1,1,41,0.023809523809523808,0.023809523809523808,0.9761904761904762,42,900,500,400,0.5555555555555556,13,5,8,360.8923188500904,0.8123306233062331,0.17565722089450309,0.2005794311028302,129289.65627411267,931.9287712191356,130221.5850453318,937,0,405.26190476190476,35,7,15,36.57071526118129,0.6151785714285714,45.74652777777778,1017.013888888889,29.057539682539687,0
940,4,0,0,41,0.0,0.0,1.0,41,700,400,300,0.5714285714285714,10,4,6,366.7402546606593,0.8032012195121951,0.17814389644072093,0.203218366940128,129171.13272392306,1274.4508219954841,130445.58354591855,938,3,416.1463414634146,34,7,15,36.542871920989974,0.6161151960784312,45.86309523809525,1016.5476190476203,29.898459383753536,0
941,4,3,2,42,0.06818181818181818,0.045454545454545456,0.9545454545454546,44,900,600,300,0.6666666666666666,12,6,6,347.39185556086767,0.8239297040169133,0.19367312618549426,0.19623629848146687,129927.00277970133,227.11651662048234,130154.11929632182,939,0,388.70454545454544,37,7,15,36.26631175163117,0.6176801801801801,45.12061403508771,1019.5175438596483,27.554528212422927,0
942,4,0,1,41,0.0,0.023809523809523808,0.9761904761904762,42,1100,800,300,0.7272727272727273,14,8,6,365.1374382224928,0.8148470770421989,0.19493726362264052,0.20507814893402426,129701.96926708256,1071.8089581190088,130773.77822520157,940,1,406.57142857142856,35,7,15,36.04289758739539,0.619345238095238,45.34143518518519,1018.6342592592599,29.103835978836,0
943,4,1,0,42,0.023809523809523808,0.0,1.0,42,900,500,400,0.5555555555555556,13,5,8,358.01095777434193,0.8179684475416182,0.21379674758276956,0.20278331735848773,130032.77084094245,910.6313661634807,130943.40220710593,941,0,403.9761904761905,36,6,16,35.88821721688565,0.6206597222222221,45.0168918918919,1019.9324324324338,28.331456456456493,0
944,4,0,0,42,0.0,0.0,1.0,42,1200,800,400,0.6666666666666666,16,8,8,356.5668493431483,0.8191540843979869,0.21192552526033026,0.20226293601750667,130090.20580969492,877.1709631929327,130967.37677288784,942,1,404.9761904761905,36,6,16,35.86672553997866,0.6212384259259258,44.96058558558559,1020.1576576576583,28.33771271271273,0
945,4,0,0,42,0.0,0.0,1.0,42,750,600,150,0.8,9,6,3,357.087886135785,0.8192750677506775,0.211805172350366,0.20285726246246716,130147.65346004801,894.8300919162552,131042.48355196427,943,2,405.9761904761905,36,6,16,35.7951201118346,0.6218171296296295,44.90427927927929,1020.3828828828838,28.343968968968994,0
946,4,2,2,42,0.045454545454545456,0.045454545454545456,0.9545454545454546,44,1100,900,200,0.8181818181818182,13,9,4,340.5342484328658,0.8285544397463003,0.20227784767533707,0.19557114785229454,130570.58572108716,92.80198159597114,130663.38770268313,944,0,388.47727272727275,37,7,16,35.78914547795299,0.6241554054054055,44.49013157894736,1022.0394736842098,27.622688477951616,0
947,4,1,1,42,0.023255813953488372,0.023255813953488372,0.9767441860465116,43,1000,600,400,0.6,14,6,8,347.2588836704197,0.825812107788852,0.20544258833057372,0.19917996905343802,130521.3723013554,464.9412080999849,130986.31350945539,945,0,398.48837209302326,36,7,16,35.667153405333906,0.6255787037037037,44.538288288288285,1021.8468468468468,28.384634634634633,0
948,4,0,0,42,0.0,0.0,1.0,42,1400,1100,300,0.7857142857142857,17,11,6,347.30800470622626,0.8187911343399148,0.16443583606282042,0.1989127663317477,130463.8422205989,662.227345588821,131126.06956618774,946,5,408.9761904761905,36,6,18,35.72416042034097,0.625,44.59459459459459,1021.621621621621,28.37837837837836,1
949,4,1,0,43,0.023255813953488372,0.0,1.0,43,550,300,250,0.5454545454545454,8,3,5,339.9832842529209,0.8256275378368402,0.16454124253774127,0.19596317113366746,130710.70545744844,287.89098568790223,130998.59644313634,947,0,400.4418604651163,37,6,18,35.66150189434556,0.6255630630630631,44.353070175438596,1022.5877192982456,27.63750592697961,0
950,4,0,0,43,0.0,0.0,1.0,43,1050,700,350,0.6666666666666666,14,7,7,340.11182220568,0.8237356958287191,0.16088137790074541,0.1966073916467777,130822.85534972291,298.8799438288636,131121.73529355178,948,1,401.4418604651163,37,6,18,35.54483744194355,0.6266891891891893,44.243421052631575,1023.026315789473,27.64935988620197,0
951,4,0,1,42,0.0,0.023255813953488372,0.9767441860465116,43,1300,1000,300,0.7692307692307693,16,10,6,345.58855844039715,0.8219361387966039,0.16297248099368233,0.20108732381774885,131075.36844269387,459.6295254308975,131534.99796812478,949,2,402.4418604651163,37,6,19,35.149529749794766,0.629222972972973,43.99671052631579,1024.0131578947364,27.676031294452336,0
952,4,0,1,41,0.0,0.023809523809523808,0.9761904761904762,42,1150,800,350,0.6956521739130435,15,8,7,354.39660381466484,0.8220334881920248,0.16924321691725175,0.20617583611559492,131068.54056336744,890.049128520413,131958.58969188784,950,3,407.3095238095238,36,6,19,34.930945049305315,0.6310763888888888,44.00337837837838,1023.9864864864867,28.444069069069073,0
953,4,0,0,41,0.0,0.0,1.0,41,1050,800,250,0.7619047619047619,13,8,5,356.20753785092336,0.8213922764227642,0.14591779822811457,0.20769639514692279,131155.0401753103,1143.682787517233,132298.72296282754,949,4,395.0731707317073,36,5,19,34.797117780709485,0.6319444444444444,43.91891891891891,1024.3243243243232,28.453453453453424,0
954,4,0,1,40,0.0,0.024390243902439025,0.975609756097561,41,950,600,350,0.631578947368421,13,6,7,357.6026809707884,0.8201727642276423,0.14265839987776707,0.20898052627830455,131241.56832085454,1186.4673372696882,132428.03565812422,950,5,396.0731707317073,36,5,19,34.6739110524966,0.6328125000000002,43.83445945945945,1024.6621621621614,28.462837837837817,0
955,4,0,0,40,0.0,0.0,1.0,40,900,600,300,0.6666666666666666,12,6,6,358.05661515666606,0.8211271367521368,0.12629840803883985,0.2098813660120837,131357.78523930436,1406.7333250534612,132764.51856435783,951,6,383.35,35,5,19,34.54482800797862,0.6360119047619048,43.721064814814795,1025.115740740738,29.289021164021083,0
956,4,1,1,40,0.024390243902439025,0.024390243902439025,0.975609756097561,41,900,400,500,0.4444444444444444,14,4,10,351.4554533526019,0.8274390243902439,0.12243040441599717,0.20725635181200994,131587.96623904296,1049.4616660579345,132637.4279051009,952,0,374.9756097560976,36,5,17,34.48167050817692,0.6362847222222223,43.496621621621614,1026.0135135135124,28.500375375375345,0
957,4,0,0,40,0.0,0.0,1.0,40,1050,800,250,0.7619047619047619,13,8,5,358.5879445104788,0.8188034188034188,0.1277081922816521,0.21100971874182337,131506.13667052455,1431.3030478394867,132937.43971836404,953,8,385.35,35,5,19,34.38134732566011,0.6375000000000001,43.57638888888888,1025.6944444444432,29.30555555555552,0
958,4,0,0,40,0.0,0.0,1.0,40,1050,800,250,0.7619047619047619,13,8,5,357.85329040461016,0.8179220085470086,0.1284288292352811,0.21123350683936562,131624.8780971363,1420.479145233176,133045.35724236947,954,9,386.35,35,5,18,34.28030303030302,0.6386904761904763,43.46064814814814,1026.157407407406,29.31878306878303,0
959,4,0,0,40,0.0,0.0,1.0,40,1300,1100,200,0.8461538461538461,15,11,4,358.28958162475146,0.8179754273504274,0.13612614135948609,0.21231709275839464,131773.38023244584,1442.6058545524534,133215.98608699828,955,10,387.35,35,5,18,34.11925092999661,0.6401785714285715,43.315972222222214,1026.73611111111,29.335317460317427,0
960,4,1,0,41,0.024390243902439025,0.0,1.0,41,1050,600,450,0.5714285714285714,15,6,9,355.32920889951845,0.823170731707317,0.15316357303316752,0.21275482009583638,132166.3106307321,1192.5101199172168,133358.82075064932,956,0,378.8780487804878,36,5,19,33.799237031358366,0.6420717592592593,42.93355855855856,1028.265765765766,28.562937937937946,0
961,4,0,0,41,0.0,0.0,1.0,41,1150,800,350,0.6956521739130435,15,8,7,351.8164406404027,0.8236788617886179,0.1525287135199218,0.21131509898132228,132285.18029586007,1108.02025623267,133393.20055209275,957,1,379.8780487804878,37,4,19,33.76989625524053,0.6413288288288289,42.81798245614034,1028.728070175437,27.803461356092896,0
962,4,0,2,39,0.0,0.04878048780487805,0.9512195121951219,41,1300,900,400,0.6923076923076923,17,9,8,346.59187959875857,0.8221036585365854,0.1425739281362135,0.20895683839393356,132426.21678064394,979.5702764312026,133405.78705707515,958,2,380.8780487804878,37,4,19,33.76245072973261,0.6427364864864864,42.680921052631575,1029.2763157894728,27.818278805120887,0
963,4,0,0,39,0.0,0.0,1.0,39,1100,900,200,0.8181818181818182,13,9,4,362.6437431656229,0.8155645524066577,0.15234846869892693,0.21781841218821227,132285.18029586028,1794.4785895660168,134079.6588854263,959,3,397.02564102564105,37,2,19,33.491437504441116,0.6413288288288288,42.81798245614035,1028.7280701754387,27.80346135609294,0
964,4,0,0,39,0.0,0.0,1.0,39,1100,800,300,0.7272727272727273,14,8,6,363.0966898263013,0.814327485380117,0.14961051784156498,0.21908031958430502,132455.95838659615,1818.9120993092092,134274.87048590535,960,4,398.02564102564105,36,3,19,33.30780731502754,0.6449652777777778,42.65202702702703,1029.3918918918926,28.594219219219237,0
965,4,0,0,39,0.0,0.0,1.0,39,850,400,450,0.47058823529411764,13,4,9,366.69863091028935,0.813540260908682,0.14869719583708463,0.22159455270408293,132513.92598257042,1918.5350468711954,134432.46102944162,961,5,399.02564102564105,36,3,19,33.156741040504585,0.6455439814814815,42.59572072072072,1029.617117117117,28.600475475475474,0
966,4,0,0,39,0.0,0.0,1.0,39,1300,1000,300,0.7692307692307693,16,10,6,365.153732996454,0.8125843454790823,0.14971376025388716,0.22117192331030247,132600.9011545329,1883.9428110542972,134484.8439655872,962,6,400.02564102564105,36,3,19,33.108963845761345,0.6464120370370371,42.51126126126126,1029.954954954955,28.60985985985986,0
967,4,0,0,39,0.0,0.0,1.0,39,1250,900,350,0.72,16,9,7,363.1999409291828,0.8113472784525416,0.14786801020822637,0.22118223947603527,132803.95418644996,1846.877663136103,134650.83184958607,963,7,401.02564102564105,36,3,16,32.95504206271167,0.6484375,42.314189189189186,1030.7432432432431,28.631756756756754,0
968,4,0,1,38,0.0,0.02564102564102564,0.9743589743589743,39,1350,1000,350,0.7407407407407407,17,10,7,362.11313666787447,0.8114597390913181,0.14436793192251707,0.22172167993835076,133007.16256797328,1832.7281673565344,134839.89073532983,964,8,402.02564102564105,36,3,18,32.77883915574964,0.650462962962963,42.11711711711711,1031.5315315315308,28.653653653653635,0
969,4,0,0,38,0.0,0.0,1.0,38,1000,700,300,0.7,13,7,6,370.3233918790515,0.808854907539118,0.1528064072199351,0.22648948147112047,132964.41139671195,2247.9663655263817,135212.37776223832,965,9,410.05263157894734,35,3,18,32.61009333034078,0.6520833333333333,42.1585648148148,1031.3657407407393,29.467592592592553,0
970,4,0,0,38,0.0,0.0,1.0,38,1100,800,300,0.7272727272727273,14,8,6,369.2703282985862,0.8073435277382646,0.15489033651581496,0.2264561410891328,133065.25063915254,2227.4097577306957,135292.66039688324,966,10,411.05263157894734,36,2,19,32.53588190351452,0.6510416666666667,42.06081081081081,1031.756756756756,28.65990990990989,0
971,4,1,0,39,0.02564102564102564,0.0,1.0,39,750,500,250,0.6666666666666666,10,5,5,365.952482545185,0.8107849752586594,0.1271376194256868,0.2165825845564259,131725.00177154175,1899.4233935051757,133624.42516504694,967,0,401.4871794871795,34,5,19,33.97140399706211,0.6418504901960785,43.36309523809523,1026.5476190476174,30.192577030812277,5
972,4,0,0,39,0.0,0.0,1.0,39,800,500,300,0.625,11,5,6,365.7427340084268,0.8089856050382367,0.12309832527778308,0.2169805243161408,131816.67375283426,1842.198129251676,133658.87188208595,968,1,402.4871794871795,34,5,19,33.884235644176506,0.6427696078431373,43.27380952380951,1026.9047619047603,30.203081232492952,0
973,4,0,0,39,0.0,0.0,1.0,39,700,600,100,0.8571428571428571,8,6,2,365.7427340084268,0.8083108412055781,0.12309832527778308,0.2169805243161408,131816.67375283426,1842.198129251676,133658.87188208595,969,2,403.4871794871795,34,5,19,33.884235644176506,0.6427696078431373,43.27380952380951,1026.9047619047603,30.203081232492952,0
974,4,0,0,39,0.0,0.0,1.0,39,1300,900,400,0.6923076923076923,17,9,8,365.6722989336871,0.8080859199280253,0.13008552785504524,0.21771113330880845,131951.6933111495,1850.2158082561518,133801.90911940564,970,3,404.4871794871795,35,4,20,33.74978877999325,0.6419642857142858,43.1423611111111,1027.4305555555538,29.35515873015868,0
975,4,0,0,39,0.0,0.0,1.0,39,1000,700,300,0.7,13,7,6,366.764061358656,0.8073549257759784,0.13264033264033293,0.21887532693984307,132040.8950617283,1885.5709876543108,133926.4660493826,971,4,405.4871794871795,35,4,20,33.63175675675676,0.6428571428571429,43.05555555555555,1027.7777777777771,29.365079365079346,0
976,4,0,1,38,0.0,0.02564102564102564,0.9743589743589743,39,1350,1000,350,0.7407407407407407,17,10,7,371.4205721293899,0.8062865497076024,0.12843820290978347,0.22238958977793194,132166.3106307322,2017.857342139453,134184.16797287163,972,5,406.4871794871795,36,3,20,33.385582083013915,0.6420717592592593,42.933558558558566,1028.2657657657667,28.562937937937964,0
977,4,0,0,38,0.0,0.0,1.0,38,1300,700,600,0.5384615384615384,19,7,12,374.69257135187735,0.8070175438596491,0.11377005732722623,0.22503725439180788,132282.13168827607,2313.0264132375587,134595.15810151363,973,6,392.7894736842105,36,2,21,33.18463783981024,0.6432291666666667,42.820945945945944,1028.7162162162158,28.57545045045044,0
978,4,0,0,38,0.0,0.0,1.0,38,1450,1100,350,0.7586206896551724,18,11,7,382.1775746441783,0.8066619250829777,0.12071582142405424,0.2308539406196731,132498.52710300032,2527.8467784405157,135026.37388144084,974,7,393.7894736842105,31,7,21,32.773834366173425,0.6569220430107526,42.610677083333336,1029.5572916666674,33.21152553763444,0
979,4,0,0,38,0.0,0.0,1.0,38,700,600,100,0.8571428571428571,8,6,2,383.8217877800347,0.8065137505926979,0.12795927872779234,0.2324678668713687,132599.08888075093,2578.883870442714,135177.97275119365,975,8,394.7894736842105,31,7,22,32.63010956595027,0.6579301075268817,42.513020833333336,1029.9479166666672,33.22412634408604,0
980,4,0,0,38,0.0,0.0,1.0,38,1000,800,200,0.8,12,8,4,381.22406858404327,0.8060099573257468,0.11859892941450245,0.23192840144832466,132766.77661471907,2522.77815077041,135289.55476548948,976,9,395.7894736842105,31,7,18,32.52803221730888,0.6596102150537634,42.35026041666667,1030.5989583333342,33.24512768817207,0
981,4,1,1,38,0.02564102564102564,0.02564102564102564,0.9743589743589743,39,950,500,450,0.5263157894736842,14,5,9,371.7967064517822,0.813540260908682,0.11360734375539239,0.22830161396171433,133113.6670524692,2098.244598765441,135211.91165123464,977,0,386.61538461538464,32,7,18,32.42205024674742,0.6604817708333333,42.01388888888889,1031.944444444445,32.24826388888891,0
982,4,0,0,38,0.0,0.0,1.0,38,1100,500,600,0.45454545454545453,17,5,12,382.246851258238,0.8047060218112849,0.11542141139265727,0.23401542161265554,133001.71746148015,2567.897542317728,135569.61500379787,978,11,397.7894736842105,31,7,18,32.26510561306067,0.6619623655913978,42.12239583333334,1031.5104166666677,33.27452956989251,0
983,4,0,0,38,0.0,0.0,1.0,38,900,400,500,0.4444444444444444,14,4,10,382.5369923873969,0.8042022285443338,0.11924975255252868,0.23440375798030533,133035.29739379894,2578.184509277359,135613.48190307632,979,12,398.7894736842105,31,7,18,32.22382620219614,0.662298387096774,42.08984375000001,1031.640625000001,33.27872983870971,0
984,4,0,0,38,0.0,0.0,1.0,38,1150,1000,150,0.8695652173913043,13,10,3,378.65320878430197,0.8039058795637744,0.11326027326696919,0.23271513748893902,133146.24304917888,2483.2504336292504,135629.49348280815,980,13,399.7894736842105,32,6,19,32.21240110920805,0.6608072916666665,41.982323232323246,1032.070707070709,32.252209595959656,0
985,4,0,1,37,0.0,0.02631578947368421,0.9736842105263158,38,1300,900,400,0.6923076923076923,17,9,8,380.3335419328323,0.8036688003793268,0.11309054282004283,0.23463820360777998,133287.7621882086,2538.761337868481,135826.5235260771,981,14,400.7894736842105,34,4,19,32.0267465990316,0.6574754901960784,41.845238095238095,1032.6190476190475,30.37114845938375,0
986,4,0,0,37,0.0,0.0,1.0,37,700,600,100,0.8571428571428571,8,6,2,387.1755640511573,0.8038038038038038,0.10606760606760579,0.23841863681044978,133219.07439446382,2915.834054209939,136134.90844867376,978,15,386.1081081081081,33,4,21,31.919218898385573,0.659090909090909,41.91176470588236,1032.3529411764719,31.283422459893085,0
987,4,0,0,37,0.0,0.0,1.0,37,1100,700,400,0.6363636363636364,15,7,8,388.5722828027805,0.8016766766766766,0.10309214113248699,0.23991918528926146,133318.4966695012,2960.774518140604,136279.2711876418,979,16,387.1081081081081,34,3,23,31.78314121037464,0.657781862745098,41.8154761904762,1032.7380952380959,30.374649859943997,0
988,4,0,0,37,0.0,0.0,1.0,37,1250,1100,150,0.88,14,11,3,388.47626697253315,0.8009259259259259,0.10581321772091368,0.24066118218347032,133442.32420535426,2967.83519268692,136410.15939804117,980,17,388.1081081081081,35,2,23,31.6610890183339,0.656845238095238,41.69560185185186,1033.217592592594,29.520502645502685,0
989,4,0,0,37,0.0,0.0,1.0,37,1050,600,450,0.5714285714285714,15,6,9,383.48572135026984,0.7989864864864865,0.1081392344780574,0.238354081494946,133564.50007086186,2844.019080272307,136408.51915113415,981,18,389.1081081081081,34,3,23,31.66724250451073,0.6602328431372548,41.57738095238096,1033.6904761904777,30.402661064425814,0
990,4,0,0,37,0.0,0.0,1.0,37,1100,800,300,0.7272727272727273,14,8,6,386.37573808966613,0.7969219219219219,0.10891692797770136,0.2411517537732054,133718.36734693882,2933.1065759637236,136651.47392290254,982,19,390.1081081081081,34,3,15,31.43799877225291,0.661764705882353,41.42857142857143,1034.2857142857147,30.420168067226903,0
991,4,0,0,37,0.0,0.0,1.0,37,550,500,50,0.9090909090909091,6,5,1,387.962731183221,0.7961086086086085,0.11168516888392577,0.24234422510790846,133749.1514314058,2977.937216553277,136727.08864795908,983,20,391.1081081081081,34,3,15,31.366047109372,0.6620710784313726,41.39880952380952,1034.4047619047612,30.423669467787096,0
992,4,0,1,36,0.0,0.02702702702702703,0.972972972972973,37,1200,1000,200,0.8333333333333334,14,10,4,390.2334036059443,0.7965465465465466,0.1063672368020192,0.24478277135281967,133903.125,3050.694444444445,136953.81944444444,984,21,392.1081081081081,34,3,17,31.15271068169619,0.6636029411764706,41.25,1035.0,30.441176470588236,0
993,4,0,1,35,0.0,0.027777777777777776,0.9722222222222222,36,900,500,400,0.5555555555555556,13,5,8,396.8315645648171,0.7931878306878307,0.11194967312523829,0.2492220242289227,133947.52206182727,3430.920949875055,137378.44301170233,985,22,400.02777777777777,33,3,17,30.93738901385107,0.6663510101010102,41.20710784313726,1035.1715686274515,31.368835412953075,0
994,4,0,0,35,0.0,0.0,1.0,35,850,700,150,0.8235294117647058,10,7,3,409.39093277963025,0.7928571428571428,0.1518427778267386,0.23717752038448187,130907.84940631049,3719.852713489123,134627.70211979962,986,23,401.51428571428573,32,3,18,33.6865103845363,0.6383463541666667,44.16035353535353,1023.3585858585851,31.979955808080785,8
995,4,1,1,35,0.027777777777777776,0.027777777777777776,0.9722222222222222,36,800,600,200,0.75,10,6,4,399.4316092134692,0.7986772486772488,0.14396719044960316,0.23280679147881275,131139.77346453277,3276.274149365622,134416.0476138984,987,0,391.3333333333333,33,3,18,33.70573103613305,0.6382575757575758,43.93382352941176,1024.2647058823522,31.03832442067734,0
996,4,0,0,35,0.0,0.0,1.0,35,900,700,200,0.7777777777777778,11,7,4,411.16005114630667,0.7915966386554621,0.159168574951559,0.23920430522213396,131069.41415416796,3778.10140546883,134847.51555963678,988,25,403.51428571428573,32,3,19,33.47693177147555,0.6399739583333334,44.00252525252525,1023.9898989898991,31.999684343434346,0
997,4,1,0,36,0.027777777777777776,0.0,1.0,36,700,300,400,0.42857142857142855,11,3,8,401.4531862740889,0.8012896825396826,0.15396097276831222,0.23598519347236496,131465.92994854887,3356.248520904172,134822.17846945304,989,0,393.27777777777777,30,6,21,33.32295762341634,0.6493055555555556,43.61559139784946,1025.5376344086014,34.18458781362005,0
998,4,1,1,36,0.02702702702702703,0.02702702702702703,0.972972972972973,37,950,600,350,0.631578947368421,13,6,7,388.9931424000154,0.8078078078078078,0.14555544137293186,0.2314597204778372,131929.3975830078,2863.9261881510415,134793.32377115884,990,0,383.6216216216216,31,6,19,33.173320659062114,0.6512096774193548,43.1640625,1027.34375,33.140120967741936,0
999,4,0,0,36,0.0,0.0,1.0,36,1000,800,200,0.8,12,8,4,397.9048959609937,0.7955026455026456,0.1485589437101018,0.23623864102858996,131845.26616155045,3292.375382992248,135137.64154454268,991,1,395.25,30,6,19,33.029599092614404,0.653125,43.24596774193548,1027.0161290322578,34.23387096774193,0
1000,4,0,0,36,0.0,0.0,1.0,36,1050,700,350,0.6666666666666666,14,7,7,399.4498461105304,0.7941798941798942,0.15620600326631706,0.23810107141271208,131996.29041883687,3345.1795789930616,135341.46999782993,992,2,396.25,31,5,19,32.83705017739483,0.6518817204301075,43.098958333333336,1027.6041666666672,33.14852150537636,0
1001,4,1,0,37,0.02702702702702703,0.0,1.0,37,1300,1000,300,0.7692307692307693,16,10,6,387.5524745247559,0.7975475475475475,0.15752062170119085,0.23367808966906883,132430.49178655245,2864.7529588817574,135295.2447454342,993,0,386.5135135135135,32,5,21,32.704142132809935,0.6536458333333333,42.67676767676768,1029.2929292929298,32.165404040404056,0
1002,4,0,0,37,0.0,0.0,1.0,37,1300,900,400,0.6923076923076923,17,9,8,389.1705802769076,0.7978603603603603,0.15475831441496646,0.23526212617925765,132527.98064291922,2915.198225946345,135443.17886886557,994,1,387.5135135135135,32,5,21,32.56412221540975,0.6546223958333333,42.58207070707071,1029.6717171717182,32.177241161616195,0
1003,4,0,0,37,0.0,0.0,1.0,37,600,300,300,0.5,9,3,6,386.4398886877525,0.7976101101101101,0.14696898418398807,0.23421817324774794,132625.50536935017,2850.3571064177268,135475.8624757679,995,2,388.5135135135135,32,5,17,32.53605867451173,0.6555989583333333,42.487373737373744,1030.0505050505058,32.189078282828305,0
1004,4,0,1,36,0.0,0.02702702702702703,0.972972972972973,37,1050,800,250,0.7619047619047619,13,8,5,388.386678200692,0.7972972972972973,0.15212639109697923,0.2358061974789917,132690.54178145094,2907.047750229579,135597.5895316805,996,3,389.5135135135135,32,5,17,32.42034313725491,0.65625,42.42424242424243,1030.303030303031,32.19696969696972,0
1005,4,0,0,36,0.0,0.0,1.0,36,850,600,250,0.7058823529411765,11,6,5,395.2811956156075,0.7932208994708996,0.15276549449006782,0.24048045067621351,132766.7766147192,3296.042039659314,136062.8186543785,997,4,396.75,31,5,17,32.16585070541166,0.6596102150537633,42.35026041666668,1030.598958333335,33.2451276881721,0
1006,4,1,1,36,0.02702702702702703,0.02702702702702703,0.972972972972973,37,1000,800,200,0.8,12,8,4,385.08080282970934,0.8018643643643644,0.1468722088061134,0.23584034176302318,133015.96297571695,2844.378762371208,135860.34173808814,998,0,387.0,32,5,18,32.17768257853937,0.6595052083333333,42.10858585858587,1031.565656565658,32.23642676767681,0
1007,4,0,0,36,0.0,0.0,1.0,36,1000,600,400,0.6,14,6,8,398.94763499245346,0.7923941798941799,0.15823055660787744,0.2435825999618536,132901.00309583888,3404.1081746419472,136305.11127048082,999,6,398.75,31,5,18,31.93598202635013,0.6609543010752688,42.22005208333334,1031.1197916666679,33.2619287634409,0
1008,4,0,0,36,0.0,0.0,1.0,36,850,500,350,0.5882352941176471,12,5,7,400.77755429655383,0.7904761904761906,0.16726158908878297,0.24566792169220875,133048.52701573828,3464.5726520253165,136513.0996677636,1000,7,399.75,32,4,19,31.74004609798883,0.6598307291666666,42.07702020202021,1031.6919191919199,32.240372474747495,0
1009,4,0,0,36,0.0,0.0,1.0,36,700,500,200,0.7142857142857143,9,5,4,402.4461596706087,0.7888227513227514,0.16849857933303425,0.24712189804567147,133113.66705246922,3514.2168209876636,136627.88387345689,1001,8,400.75,32,4,20,31.631336922386716,0.6604817708333333,42.01388888888889,1031.9444444444453,32.248263888888914,0
1010,4,0,0,36,0.0,0.0,1.0,36,850,500,350,0.5882352941176471,12,5,7,400.4444648575605,0.7866402116402117,0.16491717962306218,0.2467546638387545,133243.9949526834,3471.3640508621575,136715.35900354554,1002,9,401.75,32,4,20,31.551659125188543,0.6617838541666666,41.88762626262626,1032.449494949495,32.264046717171716,0
1011,4,0,0,36,0.0,0.0,1.0,36,1200,800,400,0.6666666666666666,16,8,8,402.4364791676235,0.7847552910052911,0.15938102610065408,0.24907225964822233,133406.99450311207,3537.5682328333987,136944.56273594548,1003,10,402.75,32,4,20,31.33606290230587,0.6634114583333333,41.729797979797986,1033.0808080808092,32.28377525252529,0
1012,4,0,0,36,0.0,0.0,1.0,36,950,500,450,0.5263157894736842,14,5,9,402.67369203812063,0.7840939153439154,0.15764729045310766,0.2494382151361046,133439.60636988573,3546.523792215086,136986.13016210083,1004,11,403.75,32,4,20,31.29709967819463,0.6637369791666666,41.698232323232325,1033.207070707071,32.287720959595966,0
1013,4,0,0,36,0.0,0.0,1.0,36,1000,700,300,0.7,13,7,6,399.7443186141797,0.7835317460317461,0.1613711891345182,0.2483064466997611,133541.67569950287,3476.513202944107,137018.18890244697,1005,12,404.75,30,6,20,31.270047680970965,0.6701388888888888,41.5994623655914,1033.6021505376348,34.453405017921156,0
1014,4,0,0,36,0.0,0.0,1.0,36,950,700,250,0.7368421052631579,12,7,5,396.85005251533323,0.7822420634920636,0.15937572187572213,0.24790243540243548,133750.14452537868,3415.7503757659865,137165.89490114467,1006,13,405.75,30,6,19,31.135221760221754,0.6722222222222222,41.39784946236559,1034.4086021505377,34.48028673835126,0
1015,4,0,0,36,0.0,0.0,1.0,36,500,200,300,0.4,8,2,6,397.46617237254276,0.7810515873015873,0.1629964055259625,0.24852129396843736,133784.9051371547,3434.994833217735,137219.89997037244,1007,14,406.75,30,6,19,31.08435104586204,0.6725694444444443,41.36424731182797,1034.5430107526893,34.484767025089646,0
1016,4,0,0,36,0.0,0.0,1.0,36,800,400,400,0.5,12,4,8,400.9443394494348,0.7794642857142857,0.16564277826700802,0.25154747863327215,133909.8633660211,3538.0803426106822,137447.9437086318,1008,15,407.75,31,5,19,30.868793768608214,0.6710349462365591,41.243489583333336,1035.026041666667,33.387936827957,0
1017,4,0,0,36,0.0,0.0,1.0,36,800,600,200,0.75,10,6,4,404.0829691520812,0.7784391534391535,0.1722473668035649,0.25468113602501236,134078.3776177301,3635.7577853732746,137714.13540310337,1009,16,408.75,31,5,19,30.618242393764145,0.6727150537634408,41.08072916666667,1035.677083333334,33.40893817204303,0
1018,4,0,0,36,0.0,0.0,1.0,36,950,600,350,0.631578947368421,13,6,7,405.87863942829716,0.776686507936508,0.17752652149637038,0.25722881925551333,134280.73459201396,3700.3363715277883,137981.07096354174,1010,17,409.75,31,5,19,30.368509212730324,0.6747311827956989,40.88541666666667,1036.458333333334,33.434139784946254,0
1019,4,0,0,36,0.0,0.0,1.0,36,500,300,200,0.6,7,3,4,406.41018445641,0.7769179894179895,0.18089924493014564,0.25780330505637294,134314.4755893284,3717.3541598849883,138031.8297492134,1011,18,410.75,31,5,19,30.320861072729564,0.6750672043010753,40.852864583333336,1036.588541666667,33.43834005376345,0
1020,4,0,1,35,0.0,0.027777777777777776,0.9722222222222222,36,750,500,250,0.6666666666666666,10,5,5,406.64910732146996,0.7764550264550265,0.1838690775154863,0.25867040660608515,134415.72401258675,3732.006835937491,138147.73084852425,1012,19,411.75,31,5,19,30.21304202243428,0.6760752688172043,40.75520833333333,1036.9791666666663,33.45094086021504,0
1021,4,0,0,35,0.0,0.0,1.0,35,850,500,350,0.5882352941176471,12,5,7,416.902582061082,0.7721988795518206,0.19548872180451116,0.2649082799027335,134376.526549312,4204.384177361537,138580.91072667352,1013,20,422.25714285714287,30,5,21,29.98660444213983,0.6784722222222221,40.79301075268817,1036.8279569892468,34.56093189964156,0
1022,4,0,0,35,0.0,0.0,1.0,35,900,800,100,0.8888888888888888,10,8,2,416.6710278560296,0.7724089635854341,0.19127117859457465,0.26501376586226427,134411.36845661336,4201.064610070512,138612.43306668388,1014,21,423.25714285714287,30,5,21,29.95760423417584,0.6788194444444444,40.75940860215053,1036.962365591397,34.5654121863799,0
1023,4,0,0,35,0.0,0.0,1.0,35,1350,1100,250,0.8148148148148148,16,11,5,416.60618377122927,0.7718487394957982,0.18864027538726313,0.2659870250231695,134550.78125000003,4211.0097626893275,138761.79101268935,1015,22,424.25714285714287,29,6,21,29.819277108433727,0.6831896551724139,40.625,1037.5000000000002,35.77586206896552,0
1024,4,0,0,35,0.0,0.0,1.0,35,1500,1300,200,0.8666666666666667,17,13,4,410.2469809193032,0.7708683473389355,0.1896820258596772,0.26293256710703544,134690.26630607576,4051.255022256897,138741.52132833266,1016,23,425.25714285714287,30,5,21,29.844296257930853,0.6815972222222222,40.49059139784946,1038.0376344086014,34.60125448028671,0
1025,4,0,0,35,0.0,0.0,1.0,35,1000,800,200,0.8,12,8,4,410.2469809193032,0.7710084033613445,0.1896820258596772,0.26293256710703544,134690.26630607576,4051.255022256897,138741.52132833266,1017,24,426.25714285714287,30,5,21,29.844296257930853,0.6815972222222222,40.49059139784946,1038.0376344086014,34.60125448028671,0
1026,4,0,0,35,0.0,0.0,1.0,35,1150,700,450,0.6086956521739131,16,7,9,410.489278316614,0.7703781512605041,0.1955369853389779,0.2641008037928791,134829.82362484108,4069.2393990634823,138899.06302390457,1018,25,427.25714285714287,30,5,20,29.698082481342468,0.6829861111111111,40.35618279569893,1038.575268817205,34.61917562724016,0
1027,4,0,0,35,0.0,0.0,1.0,35,1150,1000,150,0.8695652173913043,13,10,3,412.2467696128557,0.7705882352941176,0.20032526335243084,0.26599895902398796,134934.53903630478,4125.265565383286,139059.80460168805,1019,26,428.25714285714287,30,5,20,29.547488141440294,0.6840277777777777,40.255376344086024,1038.978494623656,34.632616487455195,0
1028,4,0,0,35,0.0,0.0,1.0,35,1150,900,250,0.782608695652174,14,9,5,409.4945322368417,0.7700980392156862,0.200816326530612,0.2655021128962257,135109.15505043944,4065.2920496589327,139174.44710009836,1020,27,429.25714285714287,30,5,20,29.444085326438277,0.6857638888888888,40.087365591397855,1039.6505376344094,34.65501792114698,0
1029,4,0,0,35,0.0,0.0,1.0,35,800,500,300,0.625,11,5,6,408.5775538396184,0.7694677871148459,0.2013331117635111,0.26542103560513247,135179.03307101986,4046.223732512436,139225.2568035323,1021,28,430.25714285714287,30,5,20,29.397968635560726,0.6864583333333332,40.020161290322584,1039.9193548387102,34.66397849462367,0
1030,4,0,0,35,0.0,0.0,1.0,35,1150,900,250,0.782608695652174,14,9,5,406.80280966020973,0.7691876750700279,0.1958139534883716,0.2650381941725611,135283.88397502608,4006.7728205572953,139290.65679558337,1022,29,431.25714285714287,30,5,20,29.339201119724375,0.6875,39.91935483870968,1040.322580645162,34.67741935483873,0
1031,4,0,0,35,0.0,0.0,1.0,35,1100,600,500,0.5454545454545454,16,6,10,406.0004733069803,0.7661764705882352,0.201881641086187,0.26554625551429534,135423.74841022087,3996.421190311027,139420.1696005319,1023,30,432.25714285714287,30,5,20,29.220202737603312,0.6888888888888888,39.78494623655914,1040.8602150537638,34.695340501792124,0
1032,4,0,0,35,0.0,0.0,1.0,35,750,400,350,0.5333333333333333,11,4,7,404.0067042778537,0.7657563025210083,0.19956849656088083,0.2650160828146091,135528.69415900685,3950.900212452313,139479.59437145916,1024,31,433.25714285714287,30,5,20,29.167204509272413,0.6899305555555555,39.68413978494624,1041.2634408602153,34.70878136200717,0
1033,4,0,0,35,0.0,0.0,1.0,35,550,200,350,0.36363636363636365,9,2,7,404.0067042778537,0.7657563025210083,0.19956849656088083,0.2650160828146091,135528.69415900685,3950.900212452313,139479.59437145916,1025,32,434.25714285714287,30,5,20,29.167204509272413,0.6899305555555555,39.68413978494624,1041.2634408602153,34.70878136200717,0
1034,4,0,0,35,0.0,0.0,1.0,35,1050,800,250,0.7619047619047619,13,8,5,405.16825246202995,0.7642857142857142,0.20074450832964774,0.2670802970310932,135703.69406867845,3996.5657156896746,139700.25978436813,1026,33,435.25714285714287,30,5,20,28.96214955280358,0.6916666666666667,39.516129032258064,1041.9354838709676,34.73118279569892,0
1035,4,0,0,35,0.0,0.0,1.0,35,1100,900,200,0.8181818181818182,13,9,4,398.3207117720033,0.7642857142857142,0.19942417421347414,0.24761212355940698,133570.09369260792,3657.006063317403,137227.09975592533,1027,34,436.25714285714287,32,3,20,31.278245999755708,0.6650390625,41.571969696969695,1033.7121212121212,32.30350378787879,5
1036,4,1,0,36,0.027777777777777776,0.0,1.0,36,850,500,350,0.5882352941176471,12,5,7,390.51899913921545,0.7738756613756614,0.20004867524403447,0.2450463199650679,133915.8091238947,3259.333549596319,137175.142673491,1028,0,425.1111111111111,33,3,18,31.132587418107214,0.6660353535353535,41.23774509803922,1035.0490196078435,31.36512180629829,0
1037,4,0,0,36,0.0,0.0,1.0,36,1150,800,350,0.6956521739130435,15,8,7,391.605164184301,0.7729166666666667,0.19735077129443335,0.24636426151847804,134010.95920138893,3295.8767361111168,137306.83593750006,1029,1,426.1111111111111,33,3,18,31.00897048960428,0.6669823232323232,41.145833333333336,1035.416666666667,31.376262626262637,0
1038,4,0,0,36,0.0,0.0,1.0,36,700,600,100,0.8571428571428571,8,6,2,392.81889244632555,0.7719907407407408,0.1976393326233583,0.24755499329335567,134074.41135921294,3333.392355103825,137407.80371431677,1030,2,427.1111111111111,33,3,19,30.913871139510125,0.6676136363636362,41.08455882352942,1035.6617647058833,31.383689839572224,0
1039,4,0,1,35,0.0,0.027777777777777776,0.9722222222222222,36,1050,800,250,0.7619047619047619,13,8,5,429.620610002267,0.7715608465608466,0.2038232233752355,0.2583608873849251,132331.00891113293,4231.681491099443,136562.69040223237,1031,3,428.1111111111111,31,5,19,31.72245423099637,0.6552419354838709,42.77343750000001,1028.906250000001,33.19052419354842,8
1040,4,0,0,35,0.0,0.0,1.0,35,850,500,350,0.5882352941176471,12,5,7,426.9861823665362,0.7710084033613445,0.1786003470213997,0.25723313913301094,132398.00347222234,4306.42361111113,136704.42708333346,1032,4,412.74285714285713,31,4,20,31.722334682861003,0.6559139784946235,42.70833333333334,1029.1666666666677,33.19892473118283,0
1041,4,0,0,35,0.0,0.0,1.0,35,600,300,300,0.5,9,3,6,426.7159239794228,0.770798319327731,0.18172592620229078,0.25730634219168674,132432.58794369298,4302.218825875832,136734.80676956882,1033,5,413.74285714285713,30,5,20,31.694252198137033,0.6590277777777778,42.6747311827957,1029.3010752688178,34.31003584229393,0
1042,4,1,0,36,0.027777777777777776,0.0,1.0,36,1250,800,450,0.64,17,8,9,417.16041658006355,0.7741402116402117,0.17827985958037407,0.25459880132980567,132885.746671258,3886.9346877869607,136772.68135904497,1034,0,403.22222222222223,32,4,18,31.4819066862601,0.658203125,42.234848484848484,1031.060606060606,32.22064393939394,0
1043,4,0,0,36,0.0,0.0,1.0,36,850,500,350,0.5882352941176471,12,5,7,416.69088647744206,0.7741732804232805,0.1695331945974614,0.25497736716361247,132983.4029212582,3882.5944100091974,136865.9973312674,1035,1,404.22222222222223,32,4,19,31.39536662994246,0.6591796875,42.14015151515152,1031.4393939393951,32.2324810606061,0
1044,4,1,1,36,0.02702702702702703,0.02702702702702703,0.972972972972973,37,1000,700,300,0.7,13,7,6,411.03602049177067,0.7785285285285285,0.16045573225729903,0.2535424237674715,133282.33882401,3556.7684304113827,136839.10725442137,1036,0,394.27027027027026,33,4,20,31.239615475907907,0.6597222222222222,41.85049019607843,1032.5980392156864,31.29084967320262,0
1045,4,0,0,36,0.0,0.0,1.0,36,1050,500,550,0.47619047619047616,16,5,11,420.4846934200542,0.7709656084656085,0.16306710133116042,0.2597858604362568,133341.7827262523,4013.6357259463207,137355.41845219862,1037,3,406.22222222222223,32,4,20,30.93571719641403,0.6627604166666667,41.79292929292929,1032.8282828282818,32.275883838383805,0
1046,4,0,0,36,0.0,0.0,1.0,36,1050,600,450,0.5714285714285714,15,6,9,418.765081688452,0.7708664021164021,0.16310433638475974,0.26010619862620754,133539.5050048828,3984.400113404205,137523.90511828702,1038,4,407.22222222222223,31,5,20,30.780738221214417,0.6673387096774194,41.6015625,1033.59375,33.341733870967744,0
1047,4,0,1,35,0.0,0.027777777777777776,0.9722222222222222,36,1100,800,300,0.7272727272727273,14,8,6,419.14624130333,0.7695436507936508,0.16332546369791467,0.26101814220783054,133635.36126734526,4002.5518760840805,137637.91314342935,1039,5,408.22222222222223,32,4,20,30.67427850368381,0.6656901041666666,41.50883838383839,1033.964646464647,32.31139520202022,0
1048,4,0,0,35,0.0,0.0,1.0,35,900,500,400,0.5555555555555556,13,5,8,428.48798581136435,0.7688375350140055,0.16087934229226275,0.26687239963357207,133640.46096801758,4452.666388617621,138093.1273566352,1040,6,398.77142857142854,31,4,20,30.42765919489569,0.6683467741935484,41.50390625,1033.984375,33.35433467741935,0
1049,4,0,0,35,0.0,0.0,1.0,35,1250,700,550,0.56,18,7,11,423.28605569846627,0.765266106442577,0.15896025454349383,0.26507913984520975,133842.48733520508,4330.731709798178,138173.21904500326,1041,7,399.77142857142854,31,4,17,30.358547250534805,0.6703629032258065,41.30859375,1034.765625,33.379536290322584,0
1050,4,0,0,35,0.0,0.0,1.0,35,1000,800,200,0.8,12,8,4,425.8185138961359,0.7654061624649859,0.15658421799500633,0.26813417585241245,134044.6662902832,4415.740119086372,138460.40640936958,1042,8,400.77142857142854,31,4,17,30.08940546544281,0.6723790322580645,41.11328125,1035.546875,33.40473790322581,0
1051,4,0,0,35,0.0,0.0,1.0,35,700,400,300,0.5714285714285714,10,4,6,427.3902320793645,0.765266106442577,0.15875570243184023,0.2693709909634918,134078.3776177301,4460.757785373275,138539.13540310337,1043,9,401.77142857142854,31,4,17,30.014772441538852,0.6727150537634409,41.08072916666667,1035.677083333334,33.40893817204303,0
1052,4,0,1,34,0.0,0.02857142857142857,0.9714285714285714,35,900,600,300,0.6666666666666666,12,6,6,407.527980059255,0.7645658263305322,0.13137973137973136,0.25732481026598675,134145.81298828125,3933.6344401041674,138079.4474283854,1044,10,402.77142857142854,31,4,17,30.46128707893413,0.6733870967741936,41.015625,1035.9375,33.417338709677416,1
1053,4,0,0,34,0.0,0.0,1.0,34,850,500,350,0.5882352941176471,12,5,7,414.48686948443844,0.7600638740344623,0.14161615853193132,0.26137772637046486,134097.95388195154,4316.368221759728,138414.32210371128,1045,17,415.3235294117647,30,4,17,30.32918072497621,0.6756944444444444,41.06182795698924,1035.752688172042,34.525089605734735,0
1054,4,0,0,34,0.0,0.0,1.0,34,950,500,450,0.5263157894736842,14,5,9,415.31310445877165,0.7595811051693405,0.14800500560841834,0.2626455063390211,134202.38475907606,4347.201808012473,138549.58656708853,1046,18,416.3235294117647,30,4,17,30.202793271933242,0.6767361111111112,40.96102150537634,1036.1559139784936,34.53853046594978,0
1055,4,0,0,34,0.0,0.0,1.0,34,850,500,350,0.5882352941176471,12,5,7,414.6240935913362,0.7592097445038622,0.14493046602637993,0.26270882380302313,134272.02792591622,4334.48357469071,138606.51150060692,1047,19,417.3235294117647,30,4,17,30.150650585743314,0.6774305555555555,40.89381720430107,1036.424731182795,34.547491039426504,0
1056,4,0,0,34,0.0,0.0,1.0,34,700,400,300,0.5714285714285714,10,4,6,415.1850192759774,0.7582442067736186,0.14682240068333852,0.26356560112556493,134341.68915842872,4355.331360561918,138697.02051899064,1048,20,418.3235294117647,30,4,17,30.066122131466354,0.678125,40.82661290322581,1036.6935483870968,34.556451612903224,0
1057,4,0,0,34,0.0,0.0,1.0,34,1150,1000,150,0.8695652173913043,13,10,3,415.2575442247657,0.7576128936423054,0.12357685009487684,0.2574596774193549,133472.22222222228,4285.069444444454,137757.29166666674,1049,21,419.3235294117647,30,4,17,30.93918010752688,0.6694444444444445,41.66666666666667,1033.333333333334,34.444444444444464,2
1058,4,0,0,34,0.0,0.0,1.0,34,1100,700,400,0.6363636363636364,15,7,8,414.00628385435266,0.756833036244801,0.12618867289405,0.25692448075513463,133506.9467026535,4254.542974621343,137761.48967727486,1050,22,420.3235294117647,30,4,17,30.936511033077547,0.6697916666666666,41.63306451612903,1033.4677419354841,34.44892473118281,0
1059,4,0,1,33,0.0,0.029411764705882353,0.9705882352941176,34,1150,1000,150,0.8695652173913043,13,10,3,413.07537246986317,0.7559789067142009,0.12952488687782826,0.2580379924129924,133750.14452537868,4249.778153543764,137999.92267892245,1051,23,421.3235294117647,30,4,17,30.715631496881493,0.6722222222222223,41.39784946236559,1034.4086021505377,34.48028673835126,0
1060,4,0,0,33,0.0,0.0,1.0,33,1100,900,200,0.8181818181818182,13,9,4,419.99815418222886,0.7568655303030304,0.12816851560307008,0.2626839840892882,133795.33420138888,4638.75868055555,138434.09288194444,1052,24,422.45454545454544,29,4,17,30.491089407974215,0.6756465517241379,41.354166666666664,1034.5833333333333,35.67528735632184,0
1061,4,0,0,33,0.0,0.0,1.0,33,850,700,150,0.8235294117647058,10,7,3,424.888225585344,0.7552872474747475,0.1342671107803306,0.2662609057053322,133867.1899112655,4775.7185570987795,138642.9084683643,1053,25,423.45454545454544,29,4,17,30.292214691540295,0.6763649425287355,41.28472222222223,1034.8611111111118,35.684865900383166,0
1062,4,0,0,33,0.0,0.0,1.0,33,1100,900,200,0.8181818181818182,13,9,4,423.29592550977156,0.7544981060606061,0.1343802835219141,0.26656202876696455,134046.91358024706,4748.302469135826,138795.21604938287,1054,26,424.45454545454544,29,4,17,30.15244992846924,0.6781609195402297,41.11111111111112,1035.5555555555568,35.70881226053644,0
1063,4,0,0,33,0.0,0.0,1.0,33,550,400,150,0.7272727272727273,7,4,3,425.309316527972,0.7559185606060607,0.13668652751885513,0.26914612473411353,134226.75781250003,4817.578125000001,139044.33593750003,1055,27,425.45454545454544,29,4,17,29.919330518697222,0.6799568965517242,40.9375,1036.2500000000002,35.732758620689665,0
1064,4,0,0,33,0.0,0.0,1.0,33,900,600,300,0.6666666666666666,12,6,6,419.9345991317439,0.7559185606060607,0.12510857300570688,0.2670555125313118,134406.72260802472,4688.4066358024775,139095.1292438272,1056,28,426.45454545454544,29,4,18,29.877667648897223,0.6817528735632183,40.76388888888889,1036.9444444444448,35.756704980842926,0
1065,4,0,0,33,0.0,0.0,1.0,33,600,500,100,0.8333333333333334,7,5,2,420.8941197435854,0.7549715909090909,0.12863873771868972,0.2679297861999448,134442.73003472216,4717.230902777773,139159.96093749994,1057,29,427.45454545454544,29,4,18,29.81660974956476,0.6821120689655171,40.729166666666664,1037.083333333333,35.761494252873554,0
1066,4,0,0,33,0.0,0.0,1.0,33,950,700,250,0.7368421052631579,12,7,5,421.06845617537135,0.752761994949495,0.13204187504816578,0.2691020047977931,134586.8079668211,4734.051890432115,139320.8598572532,1058,30,428.45454545454544,29,4,18,29.66735265247848,0.6835488505747127,40.590277777777786,1037.6388888888898,35.7806513409962,0
1067,4,0,0,33,0.0,0.0,1.0,33,1000,800,200,0.8,12,8,4,418.9032895118477,0.7494476010101011,0.13568073404906333,0.2693155542287261,134803.06954089506,4693.889853395058,139496.9593942901,1059,31,429.45454545454544,29,4,16,29.50645869555526,0.6857040229885059,40.38194444444444,1038.4722222222222,35.809386973180075,0
1068,4,0,0,33,0.0,0.0,1.0,33,1450,1000,450,0.6896551724137931,19,10,9,413.0444574568714,0.7485006313131314,0.10225747406955477,0.2585866561389656,133831.2596450616,4458.203124999983,138289.46277006157,1060,32,430.45454545454544,29,4,21,30.634787472035793,0.6760057471264369,41.319444444444436,1034.7222222222213,35.68007662835246,8
1069,4,1,1,33,0.029411764705882353,0.029411764705882353,0.9705882352941176,34,900,700,200,0.7777777777777778,11,7,4,401.3985422266724,0.756833036244801,0.08926567902365345,0.25336433783300244,134132.75965790817,3968.1388383049684,138100.89849621314,1061,0,418.7647058823529,30,4,22,30.63313654253709,0.6760416666666668,41.028225806451594,1035.8870967741914,34.52956989247305,0
1070,4,0,0,33,0.0,0.0,1.0,33,900,600,300,0.6666666666666666,12,6,6,411.8473415948409,0.7471590909090909,0.09682336442899842,0.2590988971805516,134010.95920138882,4438.411458333325,138449.37065972213,1062,34,432.45454545454544,29,4,22,30.484993293091883,0.677801724137931,41.14583333333333,1035.416666666666,35.70402298850573,0
1071,4,0,0,33,0.0,0.0,1.0,33,600,400,200,0.6666666666666666,8,4,4,413.6866305803444,0.7476325757575758,0.10289294988235587,0.26076595133031516,134082.8727816358,4493.658371913575,138576.53115354935,1063,35,433.45454545454544,29,4,22,30.365065263063787,0.6785201149425288,41.076388888888886,1035.6944444444443,35.71360153256705,0
1072,4,0,0,33,0.0,0.0,1.0,33,600,400,200,0.6666666666666666,8,4,4,413.9323936778097,0.7479482323232324,0.09675846941262467,0.26168946244376773,134190.77932098755,4509.1820987654155,138699.96141975297,1064,36,434.45454545454544,29,4,22,30.250223413762274,0.6795977011494254,40.972222222222214,1036.1111111111104,35.72796934865898,0
1073,4,0,0,33,0.0,0.0,1.0,33,800,500,300,0.625,11,5,6,413.9919216435314,0.7471590909090909,0.0994261066637423,0.26198420079579204,134226.75781250003,4513.758680555557,138740.5164930556,1065,37,435.45454545454544,29,4,22,30.212521779922266,0.6799568965517242,40.9375,1036.2500000000002,35.732758620689665,0
1074,4,0,0,33,0.0,0.0,1.0,33,1200,1100,100,0.9166666666666666,13,11,2,413.9956383408435,0.7479482323232324,0.10409251970050537,0.2630611494366775,134376.526549312,4526.259177361537,138902.78572667352,1066,38,436.45454545454544,30,3,22,30.061954455103276,0.6784722222222221,40.79301075268817,1036.8279569892468,34.56093189964156,0
1075,4,0,1,32,0.0,0.030303030303030304,0.9696969696969697,33,700,500,200,0.7142857142857143,9,5,4,414.0757971393625,0.7478693181818182,0.10194359466082248,0.2633945406084569,134415.7240125867,4531.659613715269,138947.38362630198,1067,39,437.45454545454544,31,2,22,30.020508956973057,0.6760752688172043,40.75520833333333,1036.9791666666658,33.45094086021503,0
1076,4,0,0,32,0.0,0.0,1.0,32,1400,1100,300,0.7857142857142857,17,11,6,422.29831998485935,0.7448756720430109,0.09965229812884635,0.26837681740139124,134381.9702996147,4949.856058756506,139331.8263583712,1068,40,442.78125,31,1,22,29.841271087111227,0.675739247311828,40.787760416666664,1036.8489583333328,33.446740591397834,0
1077,4,0,0,32,0.0,0.0,1.0,32,1150,900,250,0.782608695652174,14,9,5,421.1222399638716,0.743153561827957,0.09224397590361466,0.2688703532077026,134550.78125,4932.677205403646,139483.45845540366,1069,41,443.78125,29,3,22,29.702141900937086,0.6831896551724137,40.625,1037.5,35.775862068965516,0
1078,4,0,0,32,0.0,0.0,1.0,32,1150,900,250,0.782608695652174,14,9,5,420.35877554576325,0.7434895833333334,0.09087259100642364,0.2689144495614679,134622.839506173,4917.9783950617475,139540.81790123475,1070,42,444.78125,29,3,22,29.649580656673795,0.6839080459770115,40.555555555555564,1037.777777777779,35.785440613026864,0
1079,4,0,0,32,0.0,0.0,1.0,32,700,400,300,0.5714285714285714,10,4,6,416.6918085921724,0.7427335349462366,0.09151641201605587,0.2670631400628504,134690.26630607588,4824.866133368023,139515.1324394439,1071,43,445.78125,30,2,22,29.677046916137947,0.6815972222222222,40.490591397849464,1038.0376344086023,34.60125448028675,0
1080,4,0,0,32,0.0,0.0,1.0,32,1000,800,200,0.8,12,8,4,418.7960868913716,0.7427335349462366,0.07683507952537227,0.25639123650335754,133001.7174614801,4740.119764539935,137741.83722602003,1072,44,446.78125,31,1,20,31.322582681141117,0.6619623655913978,42.122395833333336,1031.510416666667,33.274529569892486,4
1081,4,0,1,31,0.0,0.03125,0.96875,32,800,400,400,0.5,12,4,8,421.63042594705223,0.7425655241935485,0.07885853104492657,0.25859129219848614,133068.88156467013,4821.17784288194,137890.05940755206,1073,45,447.78125,31,1,20,31.181642268214706,0.6626344086021505,42.057291666666664,1031.7708333333333,33.28293010752688,0
1082,4,0,0,31,0.0,0.0,1.0,31,850,700,150,0.8235294117647058,10,7,3,421.4959675524503,0.7379032258064516,0.054098105852156575,0.25914071535910854,133159.90513715456,5025.27261099549,138185.17774815005,1074,46,437.2903225806452,30,1,20,31.093187046924516,0.6663194444444445,41.969086021505376,1032.1236559139784,34.40412186379928,0
1083,4,0,0,31,0.0,0.0,1.0,31,400,200,200,0.5,6,2,4,420.66379123263914,0.7382616487455197,0.05540154569892519,0.25887002537393167,133194.5889698231,5006.028153543765,138200.61712336686,1075,47,438.2903225806452,30,1,20,31.07964409722223,0.6666666666666666,41.935483870967744,1032.258064516129,34.40860215053763,0
1084,4,0,0,31,0.0,0.0,1.0,31,500,400,100,0.8,6,4,2,420.66379123263914,0.7376344086021506,0.05540154569892519,0.25887002537393167,133194.5889698231,5006.028153543765,138200.61712336686,1076,48,439.2903225806452,30,1,20,31.07964409722223,0.6666666666666666,41.935483870967744,1032.258064516129,34.40860215053763,0
1085,4,0,0,31,0.0,0.0,1.0,31,950,800,150,0.8421052631578947,11,8,3,423.7412949452354,0.7346774193548387,0.0598310691676045,0.2617385940803207,133333.36946467802,5099.770927274836,138433.14039195285,1077,49,440.2903225806452,30,1,20,30.860120596911344,0.6680555555555555,41.80107526881721,1032.7956989247314,34.426523297491045,0
1086,4,0,0,31,0.0,0.0,1.0,31,850,600,250,0.7058823529411765,11,6,5,418.45021106712716,0.7335125448028674,0.06087361569805738,0.2591963555578571,133437.50225820908,4967.390196843571,138404.89245505264,1078,50,441.2903225806452,30,1,20,30.89171111400199,0.6690972222222221,41.700268817204304,1033.198924731183,34.4399641577061,0
1087,4,0,0,31,0.0,0.0,1.0,31,650,400,250,0.6153846153846154,9,4,5,419.11733139292744,0.7324372759856631,0.060085576427032716,0.26010442559589436,133508.10426311733,4991.116592035378,138499.2208551527,1079,51,442.2903225806452,29,2,20,30.803291448282042,0.6727729885057471,41.63194444444445,1033.4722222222226,35.636973180076644,0
1088,4,0,0,31,0.0,0.0,1.0,31,650,200,450,0.3076923076923077,11,2,9,420.6235832471888,0.7318100358422939,0.0650102066024365,0.2615456416131016,133579.8828125,5037.369791666667,138617.25260416666,1080,52,443.2903225806452,29,2,20,30.69200927045546,0.6734913793103449,41.5625,1033.75,35.64655172413793,0
1089,4,1,0,32,0.03125,0.0,1.0,32,550,300,250,0.5454545454545454,8,3,5,406.56012601563765,0.7476478494623656,0.06901484436306582,0.24247727952539494,132017.872369638,4334.640565383268,136352.51293502128,1081,0,430.40625,30,2,19,32.632531170982645,0.6548611111111111,43.077956989247305,1027.68817204301,34.25627240143366,4
1090,4,0,1,31,0.0,0.03125,0.96875,32,1050,800,250,0.7619047619047619,13,8,5,389.23936389013465,0.7476478494623656,0.08986228677696584,0.2138759210888921,128837.60452270505,3629.7334459092876,132467.33796861433,1082,1,431.40625,31,1,17,36.31217669189005,0.6199596774193548,46.19140625,1015.2343749999998,32.74949596774193,5
1091,4,1,0,32,0.03125,0.0,1.0,32,600,500,100,0.8333333333333334,7,5,2,379.3791981801094,0.7565104166666667,0.09589152700186188,0.21089713190757628,129297.68207644623,3410.5701905417727,132708.252266988,1083,0,423.34375,32,0,20,36.09248913718187,0.6220703125,45.73863636363636,1017.0454545454542,31.782670454545443,0
1092,4,1,1,32,0.030303030303030304,0.030303030303030304,0.9696969696969697,33,1250,900,350,0.72,16,9,7,369.7950601546246,0.7746212121212122,0.08756397488791823,0.20686111546831404,129544.24267409154,2980.9642024701816,132525.20687656172,1084,0,411.4848484848485,33,0,17,36.08490329441032,0.622159090909091,45.496323529411754,1018.0147058823517,30.848930481283386,0
1093,4,0,0,32,0.0,0.0,1.0,32,900,500,400,0.5555555555555556,13,5,8,378.7266812999647,0.7549563172043011,0.08779318689501125,0.21104976472442016,129394.01113406791,3400.9928833792396,132795.00401744715,1085,2,425.34375,32,0,20,36.01079672375279,0.623046875,45.64393939393939,1017.424242424242,31.794507575757564,0
1094,4,3,1,34,0.08571428571428572,0.02857142857142857,0.9714285714285714,35,800,500,300,0.625,11,5,6,352.00394596855773,0.7880952380952381,0.07816956183562418,0.19995275693677844,130144.46159122065,2162.2728052126004,132306.73439643325,1086,0,389.8,35,0,19,35.928047489413196,0.6238095238095238,44.9074074074074,1020.3703703703687,29.153439153439106,0
1095,4,2,2,34,0.05555555555555555,0.05555555555555555,0.9444444444444444,36,900,800,100,0.8888888888888888,10,8,2,342.46525503141555,0.795138888888889,0.07714280465851076,0.19628472892609183,130492.6056757771,1737.8366964937898,132230.4423722709,1087,0,379.9166666666667,36,0,16,35.81872956390758,0.6252893518518519,44.56644144144144,1021.734234234234,28.3815065065065,0
1096,4,0,0,34,0.0,0.0,1.0,34,900,600,300,0.6666666666666666,12,6,6,357.7238963350493,0.7773321449792039,0.08886662457796968,0.2033427877575624,130171.45691609973,2513.0881519274344,132684.54506802716,1088,2,403.2647058823529,34,0,21,35.754734406595134,0.6262254901960784,44.88095238095238,1020.4761904761901,30.014005602240886,0
1097,4,4,3,35,0.10526315789473684,0.07894736842105263,0.9210526315789473,38,550,400,150,0.7272727272727273,7,4,3,327.37250188762016,0.8094179706021811,0.07550377038286005,0.19024928354087717,131027.14913662434,978.9371256118093,132006.08626223615,1089,0,361.7105263157895,38,0,17,35.66450137396085,0.6269188596491228,44.04380341880342,1023.8247863247866,26.942757534862807,0
1098,4,0,2,33,0.0,0.05714285714285714,0.9428571428571428,35,950,700,250,0.7368421052631579,12,7,5,347.6012773168744,0.7872549019607843,0.07071866186910425,0.1971530024627371,130085.41907793225,2043.5715663580413,132128.9906442903,1090,1,393.7142857142857,35,0,21,36.10023825731791,0.6232142857142855,44.965277777777786,1020.13888888889,29.14682539682543,1
1099,4,0,0,33,0.0,0.0,1.0,33,950,600,350,0.631578947368421,13,6,7,365.4973287420145,0.7638099747474748,0.0819981493220252,0.20625554820054795,129887.55076172632,2894.7105680507584,132782.26132977707,1091,2,418.3333333333333,33,0,22,35.8449547166787,0.6256313131313131,45.1593137254902,1019.3627450980397,30.88978015448605,0
1100,4,1,0,34,0.029411764705882353,0.0,1.0,34,1200,1000,200,0.8333333333333334,14,10,4,355.20585770221214,0.7734328579916816,0.08024861978920494,0.2027205202002676,130327.04132550262,2459.667014042264,132786.7083395449,1092,0,407.0,32,2,23,35.66114339887063,0.6324869791666665,44.728535353535364,1021.0858585858596,31.90893308080811,0
1101,4,0,0,34,0.0,0.0,1.0,34,1100,800,300,0.7272727272727273,14,8,6,355.45475554829665,0.7742498514557339,0.0710048201705602,0.20353746830440678,130455.99819214873,2474.240989439852,132930.23918158858,1093,1,408.0,32,2,24,35.52403905574095,0.6337890625,44.60227272727273,1021.5909090909089,31.924715909090903,0
1102,4,1,1,34,0.02857142857142857,0.02857142857142857,0.9714285714285714,35,700,400,300,0.5714285714285714,10,4,6,344.9726939853724,0.7782913165266105,0.06683783506213437,0.19911079557412983,130763.47588667824,2021.9657103037362,132785.44159698198,1094,0,397.3142857142857,33,2,19,35.48056953430785,0.634469696969697,44.3014705882353,1022.7941176470591,30.993761140819974,0
1103,4,0,0,34,0.0,0.0,1.0,34,800,600,200,0.75,10,6,4,354.2074676069116,0.7739527629233512,0.07376012789303488,0.20349960612334628,130585.0188277981,2450.837765279045,133035.85659307716,1095,3,410.0,32,2,20,35.42515956351659,0.6350911458333334,44.4760101010101,1022.095959595959,31.94049873737372,0
1104,4,0,0,34,0.0,0.0,1.0,34,700,500,200,0.7142857142857143,9,5,4,353.1902433640498,0.7754382055852644,0.0715406577599551,0.20325383088263763,130649.55305899908,2428.829488062445,133078.3825470615,1096,4,411.0,32,2,21,35.385791033716195,0.6357421875,44.41287878787879,1022.3484848484849,31.948390151515152,0
1105,4,0,0,34,0.0,0.0,1.0,34,950,600,350,0.631578947368421,13,6,7,352.46088793457363,0.774881164587047,0.07605965121175617,0.2036831750389383,130810.95838434852,2421.1493087440062,133232.10769309252,1097,5,412.0,32,2,22,35.24104130667325,0.6373697916666666,44.255050505050505,1022.9797979797979,31.968118686868685,0
1106,4,0,0,34,0.0,0.0,1.0,34,650,500,150,0.7692307692307693,8,5,3,352.6955166249881,0.7741013071895425,0.08063649889320335,0.20433146263370466,130907.84940631059,2434.122315324969,133341.97172163555,1098,6,413.0,32,2,22,35.13700390705326,0.6383463541666666,44.160353535353536,1023.3585858585859,31.97995580808081,0
1107,4,0,0,34,0.0,0.0,1.0,34,600,400,200,0.6666666666666666,8,4,4,352.20416611617566,0.772912953060012,0.07643114717151245,0.2042784163473818,130951.55709342558,2424.3367935409447,133375.8938869665,1099,7,414.0,33,1,22,35.10536398467434,0.6363636363636364,44.11764705882353,1023.5294117647057,31.01604278074866,0
1108,4,0,0,34,0.0,0.0,1.0,34,700,600,100,0.8571428571428571,8,6,2,350.21174748168244,0.7734699940582294,0.07962474038089251,0.2036199826172202,131045.6483834341,2378.745104046502,133424.39348748061,1100,8,415.0,33,1,22,35.06121583881907,0.6373106060606062,44.02573529411764,1023.8970588235281,31.027183600712974,0
1109,4,0,0,34,0.0,0.0,1.0,34,850,500,350,0.5882352941176471,12,5,7,348.191310445608,0.7715389185977422,0.0829222465394821,0.20310754808198409,131171.15600069665,2334.5313401095495,133505.6873408062,1101,9,416.0,33,1,23,34.98611775730749,0.6385732323232324,43.90318627450979,1024.387254901959,31.042038027332094,0
1110,4,1,0,35,0.02857142857142857,0.0,1.0,35,850,700,150,0.8235294117647058,10,7,3,342.3540661268175,0.776750700280112,0.09024022281536515,0.20164490689096265,131541.75347222207,2006.770833333314,133548.5243055554,1102,0,405.0857142857143,34,1,24,34.76171134578933,0.6400122549019609,43.54166666666666,1025.8333333333321,30.171568627450945,0
1111,4,0,1,34,0.0,0.02857142857142857,0.9714285714285714,35,850,400,450,0.47058823529411764,13,4,9,344.97284144680543,0.7756302521008402,0.09158104076897633,0.20367574611448355,131633.36167800432,2081.9869614512254,133715.34863945554,1103,1,406.0857142857143,34,1,18,34.60218484145399,0.6409313725490197,43.45238095238094,1026.1904761904746,30.182072829131606,0
1112,4,1,1,34,0.02857142857142857,0.02857142857142857,0.9714285714285714,35,700,600,100,0.8571428571428571,8,6,2,346.1827605361219,0.7792016806722688,0.08805023110949128,0.20488221991098005,131725.0017715419,2120.184948979583,133845.18672052148,1104,0,407.0285714285714,34,1,19,34.47876802350303,0.6418504901960784,43.363095238095234,1026.5476190476186,30.192577030812313,0
1113,4,0,0,34,0.0,0.0,1.0,34,700,600,100,0.8571428571428571,8,6,2,355.9678029442669,0.7701648841354725,0.09433405469211098,0.20987059480629583,131579.47063629367,2567.611014994224,134147.08165128788,1105,13,420.0,33,1,19,34.374502309284914,0.6426767676767677,43.50490196078431,1025.9803921568623,31.090314913844313,0
1114,4,0,0,34,0.0,0.0,1.0,34,900,600,300,0.6666666666666666,12,6,6,357.55499179444786,0.7686051693404635,0.09403618180796691,0.21150286802756327,131705.23356401385,2618.372741253365,134323.60630526723,1106,14,421.0,33,1,19,34.206860872333664,0.6439393939393939,43.38235294117647,1026.4705882352941,31.10516934046346,0
1115,4,0,0,34,0.0,0.0,1.0,34,950,400,550,0.42105263157894735,15,4,11,355.35294211084295,0.7698677956030898,0.08130166884219703,0.2112459830335521,131893.9905925605,2573.7835207612397,134467.77411332174,1107,15,422.0,33,1,20,34.07301360057266,0.6458333333333334,43.1985294117647,1027.2058823529408,31.127450980392144,0
1116,4,0,0,34,0.0,0.0,1.0,34,1000,800,200,0.8,12,8,4,358.39462594881354,0.7681966726084374,0.08686730506155982,0.21358485704199,131988.41979346873,2660.7880682910322,134649.20786175976,1108,16,423.0,33,1,20,33.89969687934804,0.6467803030303031,43.10661764705882,1027.5735294117637,31.138591800356476,0
1117,4,0,0,34,0.0,0.0,1.0,34,1300,1000,300,0.7692307692307693,16,10,6,361.29670002117433,0.7657828282828283,0.08569786351146802,0.21657156475554945,132208.88600538237,2753.326845444043,134962.2128508264,1109,17,424.0,33,1,21,33.60293533523992,0.6489898989898991,42.89215686274509,1028.4313725490183,31.16458704693995,0
1118,4,1,1,34,0.02857142857142857,0.02857142857142857,0.9714285714285714,35,850,600,250,0.7058823529411765,11,6,5,352.5709321575507,0.772689075630252,0.07888953152111089,0.21240248839735362,132398.00347222213,2336.207828719714,134734.21130094185,1110,0,412.85714285714283,32,3,21,33.6369770580297,0.6533203125,42.70833333333333,1029.1666666666658,32.16145833333331,0
1119,4,1,0,35,0.02857142857142857,0.0,1.0,35,950,600,350,0.631578947368421,13,6,7,350.7261298259231,0.7733893557422968,0.09303580186365923,0.21220491950001658,132560.4848994998,2298.485167329839,134858.97006682964,1111,0,413.8285714285714,32,3,22,33.52107855157759,0.6549479166666667,42.55050505050504,1029.7979797979779,32.18118686868681,0
1120,4,0,0,35,0.0,0.0,1.0,35,850,700,150,0.8235294117647058,10,7,3,350.7261298259231,0.7733893557422968,0.09303580186365923,0.21220491950001658,132560.4848994998,2298.485167329839,134858.97006682964,1112,1,414.8285714285714,32,3,22,33.52107855157759,0.6549479166666667,42.55050505050504,1029.7979797979779,32.18118686868681,0
1121,4,0,0,35,0.0,0.0,1.0,35,1100,800,300,0.7272727272727273,14,8,6,352.40504089344546,0.7727591036414565,0.09966028088116863,0.21358992003036614,132625.50536935005,2347.579328639934,134973.08469798998,1113,2,415.8285714285714,32,3,18,33.41249897850781,0.6555989583333334,42.48737373737374,1030.0505050505049,32.18907828282828,0
1122,4,0,0,35,0.0,0.0,1.0,35,750,500,250,0.6666666666666666,10,5,5,351.24647530812234,0.77296918767507,0.09815323752341332,0.2134417338041389,132723.0659658453,2323.7018225181123,135046.76778836342,1114,3,416.8285714285714,32,3,18,33.34431033778541,0.6565755208333334,42.39267676767677,1030.4292929292928,32.2009154040404,0
1123,4,0,0,35,0.0,0.0,1.0,35,1200,900,300,0.75,15,9,6,356.57173883222146,0.7732492997198879,0.10780047572408002,0.21799984751359192,132950.8468523621,2481.3029282726357,135432.14978063473,1115,4,417.8285714285714,32,3,18,32.9782892588965,0.6588541666666666,42.17171717171718,1031.313131313132,32.22853535353538,0
1124,4,0,0,35,0.0,0.0,1.0,35,1150,800,350,0.6956521739130435,15,8,7,353.29071715912227,0.7724089635854341,0.1032371903630811,0.21681544012243517,133092.5905901577,2404.0753556324576,135496.66594579016,1116,5,418.8285714285714,33,2,19,32.920625494853525,0.6578282828282829,42.0343137254902,1031.8627450980398,31.268568033273933,0
1125,4,0,0,35,0.0,0.0,1.0,35,950,800,150,0.8421052631578947,11,8,3,354.2029282197683,0.7713585434173669,0.11119214395956623,0.21792923772060693,133187.4478115389,2435.0768033929317,135622.52461493184,1117,6,419.8285714285714,33,2,20,32.8019262732993,0.6587752525252526,41.942401960784316,1032.2303921568632,31.27970885323828,0
1126,4,0,0,35,0.0,0.0,1.0,35,800,500,300,0.625,11,5,6,351.75791149998884,0.7730392156862744,0.07824416449907368,0.21280214041284393,132555.70461180783,2325.5035623317813,134881.2081741396,1118,7,420.8285714285714,33,2,21,33.49932067912255,0.6524621212121213,42.55514705882352,1029.779411764705,31.205436720142576,4
1127,4,0,0,35,0.0,0.0,1.0,35,1100,800,300,0.7272727272727273,14,8,6,352.9347315643466,0.7742296918767506,0.08002039602277544,0.21387284922843067,132618.8113496011,2361.1569168108404,134979.96826641195,1119,8,421.8285714285714,33,2,22,33.40558695221097,0.6530934343434345,42.493872549019606,1030.0245098039215,31.21286393345217,0
1128,4,0,0,35,0.0,0.0,1.0,35,600,400,200,0.6666666666666666,8,4,4,352.33423652522487,0.774579831932773,0.08845997009650675,0.21404814022428417,132713.49961553258,2351.9019127258844,135065.40152825846,1120,9,422.8285714285714,33,2,17,33.32589993656836,0.654040404040404,42.40196078431373,1030.3921568627457,31.224004753416533,0
1129,4,0,0,35,0.0,0.0,1.0,35,1000,600,400,0.6,14,6,8,354.2599192385838,0.7733193277310924,0.09134976306537346,0.21576250403444833,132808.221672554,2409.7259767877945,135217.9476493418,1121,10,423.8285714285714,33,2,18,33.18112689731701,0.6549873737373737,42.31004901960785,1030.75980392157,31.23514557338091,0
1130,4,0,0,35,0.0,0.0,1.0,35,700,700,0,1.0,7,7,0,352.3313947556372,0.7735294117647058,0.09443001443001475,0.215313630128445,132934.57031250012,2367.404513888905,135301.97482638902,1122,11,424.8285714285714,33,2,18,33.103956228956235,0.65625,42.18750000000001,1031.250000000001,31.25000000000003,0
1131,4,0,0,35,0.0,0.0,1.0,35,900,600,300,0.6666666666666666,12,6,6,350.3557303332749,0.7707282913165265,0.09539192399049878,0.21501423100628123,133092.5905901578,2325.9503556324735,135418.54094579027,1123,12,425.8285714285714,33,2,19,32.996338083927164,0.6578282828282828,42.03431372549021,1031.8627450980407,31.26856803327396,0
1132,4,0,0,35,0.0,0.0,1.0,35,950,700,250,0.7368421052631579,12,7,5,361.6835809428045,0.7717086834733893,0.0951014741852323,0.217715381174763,132367.37528344648,2575.021258503378,134942.39654194986,1124,13,426.8285714285714,34,1,19,33.433354542650015,0.6482843137254903,42.73809523809523,1029.0476190476172,30.266106442576977,2
1133,4,0,0,35,0.0,0.0,1.0,35,1050,800,250,0.7619047619047619,13,8,5,360.3678494864059,0.7721988795518206,0.09011172139371215,0.21764560054171758,132492.61289227675,2549.2191392488094,135041.83203152556,1125,14,427.8285714285714,33,2,20,33.34114490338452,0.6518308080808082,42.61642156862744,1029.5343137254883,31.19800950683298,0
1134,4,0,0,35,0.0,0.0,1.0,35,900,400,500,0.4444444444444444,14,4,10,360.2078836011323,0.7719887955182072,0.09277214931665245,0.21809704998443158,132587.2561034215,2551.794982698932,135139.05108612042,1126,15,428.8285714285714,33,2,21,33.25003966365223,0.6527777777777779,42.52450980392155,1029.9019607843115,31.20915032679732,0
1135,4,0,0,35,0.0,0.0,1.0,35,800,400,400,0.5,12,4,8,361.37840580203925,0.7704481792717086,0.09535361772250872,0.2197274775408058,132745.06987997383,2594.2403462610328,135339.31022623487,1127,16,429.8285714285714,33,2,15,33.06117949022873,0.6543560606060608,42.371323529411754,1030.5147058823513,31.227718360071254,0
1136,4,0,0,35,0.0,0.0,1.0,35,500,300,200,0.6,7,3,4,363.73734872076585,0.7696778711484593,0.10082035429794356,0.2215347458428933,132808.2216725536,2661.462087898862,135469.68376045246,1128,17,430.8285714285714,33,2,15,32.93690306344867,0.6549873737373739,42.31004901960783,1030.7598039215668,31.235145573380812,0
1137,4,0,0,35,0.0,0.0,1.0,35,1000,700,300,0.7,13,7,6,366.3707784919908,0.7707282913165265,0.10274170274170302,0.22389325352288314,132934.57031249988,2740.6684027777637,135675.23871527764,1129,18,431.8285714285714,33,2,15,32.74200336700336,0.65625,42.18749999999999,1031.249999999999,31.24999999999997,0
1138,4,0,0,35,0.0,0.0,1.0,35,750,400,350,0.5333333333333333,11,4,7,368.8410259764448,0.7694677871148459,0.1039689138513229,0.22616697725387386,133060.97902549498,2815.6696042387503,135876.64862973374,1130,19,432.8285714285714,33,2,16,32.55124816882448,0.6575126262626263,42.064950980392155,1031.7401960784312,31.264854426619127,0
1139,4,0,0,35,0.0,0.0,1.0,35,1150,700,450,0.6086956521739131,16,7,9,366.512465993978,0.7686274509803921,0.10546527801336647,0.2253115320146921,133155.82498317945,2760.653955209527,135916.478938389,1131,20,433.8285714285714,33,2,17,32.516029446687234,0.658459595959596,41.97303921568627,1032.1078431372543,31.275995246583467,0
1140,4,0,0,35,0.0,0.0,1.0,35,950,500,450,0.5263157894736842,14,5,9,367.45776333954933,0.7677871148459383,0.10638009356566558,0.22704794937138745,133345.61827181865,2799.7765282583778,136145.39480007702,1132,21,434.8285714285714,33,2,17,32.30105995886728,0.6603535353535352,41.78921568627452,1032.843137254903,31.298276886512213,0
1141,4,0,0,35,0.0,0.0,1.0,35,1200,1000,200,0.8333333333333334,14,10,4,370.39839235271614,0.7663165266106442,0.1157090329904944,0.22945105407242847,133440.56560277307,2885.2341947808654,136325.79979755395,1133,22,435.8285714285714,33,2,18,32.129813584786305,0.661300505050505,41.69730392156863,1033.2107843137262,31.30941770647655,0
1142,4,0,0,35,0.0,0.0,1.0,35,850,500,350,0.5882352941176471,12,5,7,369.30057917004706,0.7679271708683473,0.10817512067067492,0.22955419198963511,133567.21460796337,2865.2899425701726,136432.50455053354,1134,23,436.8285714285714,33,2,19,32.031095633274056,0.6625631313131313,41.57475490196079,1033.7009803921574,31.32427213309568,0
1143,4,0,0,35,0.0,0.0,1.0,35,1200,1100,100,0.9166666666666666,13,11,2,367.6287594618269,0.7666666666666666,0.11073798239675026,0.22949605990072644,133725.61034217622,2832.2760476739873,136557.8863898502,1135,24,437.8285714285714,33,2,16,31.91548183254345,0.6641414141414141,41.42156862745099,1034.3137254901972,31.342840166369612,0
1144,4,0,0,35,0.0,0.0,1.0,35,1000,700,300,0.7,13,7,6,366.76254786131824,0.7656162464985994,0.10881646190814642,0.2293488465959445,133788.99491782018,2813.7585303729475,136602.75344819314,1136,25,438.8285714285714,33,2,17,31.87435836689568,0.6647727272727272,41.360294117647065,1034.5588235294126,31.35026737967917,0
1145,4,0,0,35,0.0,0.0,1.0,35,850,700,150,0.8235294117647058,10,7,3,367.01198610028797,0.765266106442577,0.11237756914488717,0.23009771511632768,133884.09994052778,2827.4138852845163,136711.5138258123,1137,26,439.8285714285714,33,2,17,31.772621866982426,0.6657196969696969,41.26838235294118,1034.926470588236,31.361408199643517,0
1146,4,0,0,35,0.0,0.0,1.0,35,1000,600,400,0.6,14,6,8,367.3449961163563,0.7638655462184873,0.11321686482098459,0.2307035823193208,133947.52206182736,2840.990394319515,136788.51245614688,1138,27,440.8285714285714,33,2,17,31.700480446706933,0.66635101010101,41.207107843137265,1035.1715686274522,31.368835412953096,0
1147,4,0,0,35,0.0,0.0,1.0,35,1000,800,200,0.8,12,8,4,365.7389665624358,0.7609943977591036,0.1166925833276995,0.23068848846162013,134106.1430699732,2809.5684352172407,136915.71150519044,1139,28,441.8285714285714,33,2,18,31.58325445653889,0.6679292929292928,41.05392156862746,1035.784313725491,31.387403446227,0
1148,4,0,0,35,0.0,0.0,1.0,35,900,600,300,0.6666666666666666,12,6,6,365.6112717097029,0.7619747899159663,0.12028794484436789,0.2310073012730816,134169.61775519053,2810.7849144560078,136980.40266964654,1140,29,442.8285714285714,33,2,19,31.5230462897248,0.668560606060606,40.99264705882354,1036.0294117647077,31.394830659536595,0
1149,4,0,0,35,0.0,0.0,1.0,35,850,700,150,0.8235294117647058,10,7,3,346.65596080170644,0.7619747899159663,0.06882837325315205,0.20270889120446645,131265.32613658212,2100.7815503652478,133366.10768694736,1141,30,443.8285714285714,33,2,19,34.930339631667074,0.639520202020202,43.81127450980392,1024.7549019607845,31.0531788472965,8
1150,4,1,1,35,0.027777777777777776,0.027777777777777776,0.9722222222222222,36,800,700,100,0.875,9,7,2,339.86822900423266,0.7697751322751323,0.08316086235489273,0.2008748354206386,131673.78720023547,1750.3623906670541,133424.14959090253,1142,0,432.47222222222223,33,3,17,34.6924129353234,0.6436237373737373,43.41299019607843,1026.3480392156862,31.101455733808674,0
1151,4,1,1,35,0.027777777777777776,0.027777777777777776,0.9722222222222222,36,1050,700,350,0.6666666666666666,14,7,7,332.8396998559574,0.7792328042328043,0.07737359695190982,0.1984165945550156,132000.11337868485,1586.9756235827667,133587.08900226763,1143,0,419.44444444444446,34,2,17,34.544427710843365,0.6446078431372548,43.095238095238095,1027.619047619048,30.22408963585435,0
1152,4,0,0,35,0.0,0.0,1.0,35,950,600,350,0.631578947368421,13,6,7,343.6561633164963,0.7683473389355742,0.08165505018660202,0.20446200263180914,131925.46323829785,2067.399708044991,133992.86294634282,1144,2,432.42857142857144,33,2,17,34.34169847707662,0.6461489898989898,43.16789215686275,1027.3284313725496,31.131164587046957,0
1153,4,0,0,35,0.0,0.0,1.0,35,500,100,400,0.2,9,1,8,344.9122773331285,0.7672268907563025,0.08205809694181765,0.20555006719532928,131988.4197934689,2104.88529051327,134093.30508398218,1145,3,433.42857142857144,33,2,17,34.24604949314252,0.646780303030303,43.106617647058826,1027.573529411765,31.13859180035652,0
1154,4,0,0,35,0.0,0.0,1.0,35,850,600,250,0.7058823529411765,11,6,5,344.7528913045642,0.7658263305322128,0.07704410011918994,0.20631075307027757,132145.8768862936,2111.5346261053296,134257.41151239895,1146,4,434.42857142857144,33,2,18,34.091676599125954,0.6483585858585859,42.95343137254901,1028.1862745098028,31.157159833630388,0
1155,4,0,0,35,0.0,0.0,1.0,35,1000,700,300,0.7,13,7,6,344.7928411606011,0.7645658263305322,0.08295933722487714,0.20670821337865597,132214.28748582763,2117.3079648526023,134331.59545068024,1147,5,435.42857142857144,34,1,18,34.021829301230845,0.6467524509803921,42.88690476190476,1028.4523809523807,30.248599439775905,0
1156,4,1,0,36,0.027777777777777776,0.0,1.0,36,700,400,300,0.5714285714285714,10,4,6,337.2783816699955,0.7692460317460318,0.08348752939362392,0.2035203186532063,132459.27047902474,1735.2572278911307,134194.52770691586,1148,0,424.30555555555554,34,2,19,33.9689102193439,0.6492034313725491,42.64880952380951,1029.4047619047603,30.27661064425766,0
1157,4,0,0,36,0.0,0.0,1.0,36,400,200,200,0.5,6,2,4,335.00223202732803,0.7684193121693123,0.08548161470823423,0.2024578706599938,132517.1467764059,1678.7079903977965,134195.85476680368,1149,1,425.30555555555554,35,1,20,33.969386990407685,0.6476190476190476,42.59259259259259,1029.6296296296287,29.41798941798939,0
1158,4,0,0,36,0.0,0.0,1.0,36,700,500,200,0.7142857142857143,9,5,4,337.21338291885615,0.7667328042328043,0.08259667128641213,0.2042792304012863,132606.5394188312,1743.3399509173262,134349.87936974852,1150,2,426.30555555555554,35,1,20,33.822737573510125,0.6485119047619048,42.505787037037024,1029.97685185185,29.427910052909997,0
1159,4,0,0,36,0.0,0.0,1.0,36,800,500,300,0.625,11,5,6,338.683266266732,0.7668320105820107,0.08667839936094279,0.2056588292159923,132695.96220207462,1788.3803798010815,134484.3425818757,1151,3,427.30555555555554,35,1,16,33.695143413465146,0.649404761904762,42.418981481481474,1030.324074074073,29.437830687830658,0
1160,4,0,0,36,0.0,0.0,1.0,36,750,700,50,0.9333333333333333,8,7,1,342.3611098153236,0.7662367724867726,0.09825460987598866,0.20855458577395813,132815.239465449,1894.1545567558,134709.3940222048,1152,4,428.30555555555554,35,1,17,33.4807058911595,0.6505952380952382,42.303240740740726,1030.7870370370351,29.451058201058146,0
1161,4,0,1,35,0.0,0.027777777777777776,0.9722222222222222,36,1150,600,550,0.5217391304347826,17,6,11,340.05850152302804,0.7665013227513228,0.09730329790949521,0.20748226928541985,132874.89819101486,1837.047753772269,134711.94594478712,1153,5,429.30555555555554,35,1,17,33.480205059122895,0.6511904761904763,42.24537037037036,1031.0185185185167,29.457671957671906,0
1162,4,0,0,35,0.0,0.0,1.0,35,550,300,250,0.5454545454545454,8,3,5,349.09007161380464,0.7610644257703081,0.0980525481911807,0.21219969521693074,132735.1473922902,2267.3044217687047,135002.4518140589,1154,12,442.42857142857144,34,1,17,33.38772720271102,0.6519607843137255,42.38095238095238,1030.4761904761904,30.308123249299715,0
1163,4,0,0,35,0.0,0.0,1.0,35,950,600,350,0.631578947368421,13,6,7,346.6999170394875,0.7608543417366946,0.09546249546249608,0.21109197480505487,132796.4923469386,2208.1065759637004,135004.5989229023,1155,13,443.42857142857144,34,1,17,33.38771463771463,0.6525735294117647,42.32142857142856,1030.7142857142844,30.31512605042013,0
1164,4,0,0,35,0.0,0.0,1.0,35,850,700,150,0.8235294117647058,10,7,3,344.41409198867973,0.7617647058823529,0.037448830526704446,0.2086413209399085,132606.53941883112,2134.312173139535,134740.85159197066,1156,14,444.42857142857144,35,0,20,33.637323482039164,0.6485119047619049,42.50578703703702,1029.9768518518492,29.42791005290998,3
1165,4,0,0,35,0.0,0.0,1.0,35,650,400,250,0.6153846153846154,9,4,5,344.5279265039807,0.761484593837535,0.033742597139967856,0.20904179098922474,132666.15125868033,2141.438802083301,134807.59006076364,1157,15,445.42857142857144,35,0,18,33.57452814290527,0.649107142857143,42.44791666666665,1030.2083333333314,29.434523809523757,0
1166,4,0,0,35,0.0,0.0,1.0,35,1300,1200,100,0.9230769230769231,14,12,2,346.59004221125997,0.7621848739495798,0.03188294185598761,0.21079492731209382,132755.5941358023,2202.3533950617066,134957.947530864,1158,16,446.42857142857144,35,0,19,33.431603773584904,0.6500000000000001,42.3611111111111,1030.555555555554,29.4444444444444,0
1167,4,0,0,35,0.0,0.0,1.0,35,850,700,150,0.8235294117647058,10,7,3,350.4540353025201,0.7607142857142857,0.039249639249639534,0.21416635490709557,132934.57031249988,2317.4913194444302,135252.06163194432,1159,17,447.42857142857144,35,0,19,33.1523569023569,0.6517857142857144,42.18749999999999,1031.249999999999,29.464285714285687,0
1168,4,0,0,35,0.0,0.0,1.0,35,1050,900,150,0.8571428571428571,12,9,3,350.2985949333404,0.7598039215686274,0.04523729384045794,0.21458497433957813,133024.1036120756,2319.631317515429,135343.734929591,1160,18,448.42857142857144,35,0,19,33.06651800740491,0.6526785714285714,42.10069444444444,1031.597222222222,29.47420634920634,0
1169,4,0,0,35,0.0,0.0,1.0,35,1150,900,250,0.782608695652174,14,9,5,350.1796362371858,0.757422969187675,0.04798000832986293,0.21537255144573925,133173.39275763018,2326.9220464677514,135500.31480409793,1161,19,449.42857142857144,35,0,19,32.91984376168051,0.6541666666666668,41.95601851851851,1032.175925925925,29.490740740740712,0
1170,4,0,0,35,0.0,0.0,1.0,35,900,600,300,0.6666666666666666,12,6,6,350.80501013760033,0.755672268907563,0.040114631530074885,0.2166251284053843,133322.76562767895,2354.0588295181515,135676.8244571971,1162,20,450.42857142857144,35,0,19,32.7539551346707,0.6556547619047619,41.81134259259258,1032.754629629628,29.507275132275083,0
1171,4,0,0,35,0.0,0.0,1.0,35,1150,900,250,0.782608695652174,14,9,5,348.5166301814844,0.7559523809523809,0.04218007202881169,0.2155586226174461,133382.53821855705,2297.2065489969123,135679.74476755396,1163,21,451.42857142857144,35,0,19,32.753151260504204,0.65625,41.75347222222222,1032.9861111111109,29.513888888888882,0
1172,4,0,0,35,0.0,0.0,1.0,35,800,500,300,0.625,11,5,6,349.63655909778544,0.7561624649859944,0.04125348100252868,0.2164255150143434,133412.42953746565,2329.172560871044,135741.6020983367,1164,22,452.42857142857144,35,0,19,32.69428262006123,0.656547619047619,41.72453703703703,1033.1018518518513,29.51719576719575,0
1173,4,0,0,35,0.0,0.0,1.0,35,1050,800,250,0.7619047619047619,13,8,5,353.5603189105494,0.7541316526610644,0.043143449501431785,0.21957158002728072,133533.73724489778,2442.4595410437632,135976.19678594155,1165,23,453.42857142857144,34,1,19,32.471396759579214,0.6599264705882353,41.60714285714285,1033.571428571427,30.399159663865504,0
1174,4,0,0,35,0.0,0.0,1.0,35,700,400,300,0.5714285714285714,10,4,6,352.00503608533256,0.753641456582633,0.03822743919016158,0.21912620120907816,133621.7625412592,2407.1066690243183,136028.86921028353,1166,24,454.42857142857144,35,0,19,32.423434643083695,0.6586309523809525,41.521990740740726,1033.9120370370351,29.54034391534386,0
1175,4,0,0,35,0.0,0.0,1.0,35,1000,400,600,0.4,16,4,12,352.90425411906233,0.7527310924369748,0.032912444458651935,0.22057749813399846,133771.3865847907,2441.698281035654,136213.08486582636,1167,25,455.42857142857144,35,0,16,32.25041023346014,0.6601190476190477,41.37731481481481,1034.49074074074,29.556878306878286,0
1176,4,0,0,35,0.0,0.0,1.0,35,1200,1000,200,0.8333333333333334,14,10,4,355.21220829021183,0.7510504201680672,0.04072411203604598,0.22256148243327126,133861.2011986667,2509.826576431741,136371.02777509845,1168,26,456.42857142857144,35,0,17,32.10083230809381,0.6610119047619047,41.29050925925925,1034.837962962962,29.56679894179891,0
1177,4,0,0,35,0.0,0.0,1.0,35,400,300,100,0.75,5,3,2,356.4616728697105,0.7495798319327731,0.041860465116279055,0.2238899720608631,133951.04595336074,2549.682784636485,136500.7287379972,1169,27,457.42857142857144,35,0,17,31.97860763267739,0.6619047619047619,41.2037037037037,1035.185185185185,29.576719576719572,0
1178,4,0,0,35,0.0,0.0,1.0,35,950,500,450,0.5263157894736842,14,5,9,355.0357632428985,0.7488095238095237,0.04575516134697999,0.2235401107483611,134040.92084887254,2517.864127872079,136558.78497674462,1170,28,458.42857142857144,35,0,18,31.925622182482023,0.662797619047619,41.116898148148145,1035.532407407407,29.586640211640198,0
1179,4,0,0,35,0.0,0.0,1.0,35,1450,1100,350,0.7586206896551724,18,11,7,354.4099835446405,0.7481792717086834,0.04389613291411987,0.22387605947128278,134160.80092860508,2509.58544988854,136670.38637849363,1171,29,459.42857142857144,35,0,20,31.821979853275234,0.6639880952380952,41.001157407407405,1035.99537037037,29.599867724867714,0
1180,4,0,0,35,0.0,0.0,1.0,35,900,700,200,0.7777777777777778,11,7,4,356.143963844398,0.7486694677871147,0.0466435831564842,0.22533971083384424,134220.76106234995,2560.382774991429,136781.14383734137,1172,30,460.42857142857144,35,0,20,31.71713857552405,0.6645833333333333,40.94328703703704,1036.2268518518517,29.606481481481477,0
1181,4,0,1,34,0.0,0.02857142857142857,0.9714285714285714,35,950,700,250,0.7368421052631579,12,7,5,353.96075856670274,0.7485994397759103,0.043187365398420496,0.22432544890055375,134280.734592014,2506.022135416677,136786.75672743068,1173,31,461.42857142857144,35,0,20,31.71377721943049,0.6651785714285714,40.88541666666667,1036.4583333333342,29.613095238095262,0
1182,4,2,0,36,0.05555555555555555,0.0,1.0,36,550,300,250,0.5454545454545454,8,3,5,340.5308278179686,0.7600198412698413,0.045272078501338076,0.21813431884796752,134670.8890603568,1972.1891343021414,136643.07819465894,1174,0,442.94444444444446,35,1,22,31.672799583705032,0.6690476190476189,40.50925925925927,1037.962962962964,29.656084656084683,0
1183,4,1,2,35,0.02702702702702703,0.05405405405405406,0.9459459459459459,37,900,700,200,0.7777777777777778,11,7,4,332.4747385192698,0.76758008008008,0.05043444137603803,0.2150251830269337,135018.52940355908,1578.0500517409369,136596.5794553,1175,0,431.94594594594594,36,1,16,31.53600967963303,0.6704282407407407,40.17454954954955,1039.3018018018026,28.869494494494518,0
1184,4,0,0,35,0.0,0.0,1.0,35,1150,700,450,0.6086956521739131,16,7,9,349.74473581813265,0.7521008403361344,0.06957859926001131,0.22539679207895336,134890.65334467136,2435.459183673491,137326.11252834485,1176,1,457.57142857142856,34,1,17,31.214664985866005,0.673406862745098,40.29761904761906,1038.809523809525,30.55322128851544,0
1185,4,0,0,35,0.0,0.0,1.0,35,800,600,200,0.75,10,6,4,349.03657247443715,0.7515406162464986,0.07143675620815526,0.22513245883107288,134921.57206632663,2418.512613378691,137340.08467970532,1177,2,458.57142857142856,34,1,17,31.202255452427313,0.6737132352941175,40.267857142857146,1038.9285714285722,30.556722689075656,0
1186,4,0,0,35,0.0,0.0,1.0,35,1100,800,300,0.7272727272727273,14,8,6,350.89219478425645,0.7516106442577031,0.07512766793243397,0.2265227127275884,134952.49433106597,2470.7553854875487,137423.24971655352,1178,3,459.57142857142856,34,1,17,31.12325274977085,0.6740196078431371,40.23809523809525,1039.0476190476206,30.560224089635902,0
1187,4,0,0,35,0.0,0.0,1.0,35,1250,1000,250,0.8,15,10,5,349.28391942210374,0.7521708683473389,0.07939415747979961,0.22664530105740371,135138.10232426305,2440.313208616781,137578.41553287982,1179,4,460.57142857142856,34,1,17,30.98022097549805,0.6758578431372548,40.05952380952381,1039.7619047619048,30.581232492997202,0
1188,4,0,0,35,0.0,0.0,1.0,35,550,400,150,0.7272727272727273,7,4,3,351.7239871441172,0.7506302521008403,0.07900717801141344,0.22881701233642227,135230.9541524943,2512.7940759637177,137743.74822845802,1180,5,461.57142857142856,34,1,17,30.824367631910278,0.6767769607843137,39.970238095238095,1040.1190476190473,30.59173669467786,0
1189,4,0,0,35,0.0,0.0,1.0,35,950,500,450,0.5263157894736842,14,5,9,352.91618891157276,0.7479691876750699,0.08253387157402736,0.2303838989750602,135354.8061933106,2553.780470521538,137908.58666383213,1181,6,462.57142857142856,34,1,17,30.670117835487936,0.6780024509803921,39.851190476190474,1040.5952380952376,30.605742296918752,0
1190,4,0,0,35,0.0,0.0,1.0,35,1350,1100,250,0.8148148148148148,16,11,5,351.0721310650112,0.7471988795518206,0.08399901984807667,0.22997196900101288,135478.71492346932,2512.560232426297,137991.27515589562,1182,7,463.57142857142856,34,1,18,30.594863731656176,0.6792279411764706,39.732142857142854,1041.071428571428,30.61974789915965,0
1191,4,0,1,34,0.0,0.02857142857142857,0.9714285714285714,35,950,800,150,0.8421052631578947,11,8,3,353.56182175763547,0.7487394957983192,0.0815766699867746,0.23240513738223503,135602.68034297027,2588.7861394557585,138191.46648242604,1183,8,464.57142857142856,34,1,19,30.40680839715017,0.6804534313725491,39.61309523809523,1041.5476190476172,30.633753501400506,0
1192,4,0,0,34,0.0,0.0,1.0,34,700,500,200,0.7142857142857143,9,5,4,359.43246583747396,0.7494429590017826,0.07520494073335526,0.23562794982678836,135506.05536332168,2941.055123029584,138447.11048635127,1184,9,461.8529411764706,33,1,19,30.35006669805398,0.6818181818181819,39.70588235294117,1041.1764705882342,31.5508021390374,0
1193,4,1,0,35,0.02857142857142857,0.0,1.0,35,950,500,450,0.5263157894736842,14,5,9,352.0334865072486,0.7530112044817927,0.07187887489395028,0.23281006101642504,135819.75623582755,2562.6204648525945,138382.37670068015,1185,0,449.62857142857143,34,1,20,30.230936881376582,0.6825980392156863,39.4047619047619,1042.3809523809516,30.658263305322105,0
1194,4,0,1,34,0.0,0.02857142857142857,0.9714285714285714,35,1150,900,250,0.782608695652174,14,9,5,355.7554898827596,0.7524509803921569,0.07033418687717141,0.23588662648622952,135912.84190759636,2670.3479308390015,138583.18983843536,1186,1,450.62857142857143,34,1,17,30.041481143205083,0.6835171568627451,39.31547619047619,1042.7380952380952,30.668767507002798,0
1195,4,0,0,34,0.0,0.0,1.0,34,650,400,250,0.6153846153846154,9,4,5,365.889152419289,0.7443553178847298,0.07603772671640696,0.2422271610607698,135857.16919273834,3141.732897202995,138998.90208994134,1187,12,464.8529411764706,33,1,19,29.83266231730731,0.6852904040404041,39.368872549019606,1042.5245098039213,31.59165181224004,0
1196,4,0,0,34,0.0,0.0,1.0,34,950,800,150,0.8421052631578947,11,8,3,376.8445112090218,0.7440210932857992,0.05945434474057709,0.23824237742536467,134190.77932098764,3327.782466812976,137518.56178780063,1188,13,465.8529411764706,32,2,19,31.210902591599638,0.6712239583333334,40.97222222222222,1036.111111111111,32.37847222222222,5
1197,4,0,0,34,0.0,0.0,1.0,34,700,400,300,0.5714285714285714,10,4,6,375.8739033027898,0.7443553178847298,0.05906364007769582,0.237840950224055,134223.4868412661,3290.22118278746,137513.70802405357,1189,14,466.8529411764706,32,2,19,31.20329190528411,0.6715494791666667,40.94065656565656,1036.237373737373,32.382417929292906,0
1198,4,0,0,34,0.0,0.0,1.0,34,550,200,350,0.36363636363636365,9,2,7,367.5445076751863,0.7446152703505645,0.03304173070102889,0.23323773371525883,134328.3701731305,3074.3309364186794,137402.70110954918,1190,15,467.8529411764706,33,1,19,31.3141575048272,0.670138888888889,40.83946078431372,1036.6421568627447,31.413398692810446,1
1199,4,0,0,34,0.0,0.0,1.0,34,700,400,300,0.5714285714285714,10,4,6,366.95617723405707,0.7446152703505645,0.035515896466139285,0.23326943768424904,134391.89742226538,3063.1873858611993,137455.0848081266,1191,16,468.8529411764706,33,1,19,31.265881692471343,0.6707702020202021,40.7781862745098,1036.88725490196,31.42082590612,0
1200,4,0,0,34,0.0,0.0,1.0,34,900,700,200,0.7777777777777778,11,7,4,365.03805117085665,0.7437240047534166,0.03940682972941012,0.23245425335281886,134455.43968966271,3016.2703347270326,137471.71002438976,1192,17,469.8529411764706,33,1,19,31.25209244160856,0.6714015151515151,40.716911764705884,1037.132352941177,31.428253119429606,0
1201,4,0,0,34,0.0,0.0,1.0,34,1050,900,150,0.8571428571428571,12,9,3,362.0574386509687,0.7427584670231729,0.043403802999882,0.2313615345703965,134582.5692792436,2945.3240640618983,137527.89334330548,1193,18,470.8529411764706,33,1,20,31.202388685484816,0.6726641414141414,40.59436274509804,1037.622549019608,31.443107546048726,0
1202,4,0,0,34,0.0,0.0,1.0,34,850,500,350,0.5882352941176471,12,5,7,359.4889258043604,0.7422014260249555,0.03800755429650615,0.2307265287435258,134741.5657439446,2887.6201460976486,137629.18589004225,1194,19,471.8529411764706,33,1,20,31.11032420522505,0.6742424242424242,40.44117647058823,1038.2352941176468,31.46167557932263,0
1203,4,0,0,34,0.0,0.0,1.0,34,1100,500,600,0.45454545454545453,17,5,12,361.2180699488289,0.7377079619726679,0.04051185281283165,0.233264890715622,134964.31848627923,2950.310127114557,137914.62861339378,1195,20,472.8529411764706,33,1,19,30.843235247867273,0.6764520202020203,40.2267156862745,1039.0931372549012,31.487670825906097,0
1204,4,0,0,34,0.0,0.0,1.0,34,550,400,150,0.7272727272727273,7,4,3,359.45064969740105,0.7370023767082591,0.03985849056603752,0.23232785895075916,134996.15532487497,2904.8911476355097,137901.04647251047,1196,21,473.8529411764706,33,1,19,30.857409591194966,0.6767676767676768,40.19607843137254,1039.2156862745092,31.491384432560885,0
1205,4,0,0,34,0.0,0.0,1.0,34,1100,900,200,0.8181818181818182,13,9,4,361.16320817988685,0.7365196078431373,0.03860662501473544,0.23405252062566687,135091.68836805545,2958.02951388887,138049.71788194432,1197,22,474.8529411764706,33,1,20,30.71768537074147,0.6777146464646466,40.10416666666666,1039.5833333333323,31.502525252525224,0
1206,4,0,0,34,0.0,0.0,1.0,34,1350,1100,250,0.8148148148148148,16,11,5,357.74298603944743,0.7376336898395722,0.03576057499705443,0.23265630057599926,135219.11832288056,2874.7382316897256,138093.8565545703,1198,23,475.8529411764706,33,1,20,30.67964239425003,0.6789772727272728,39.98161764705882,1040.0735294117642,31.51737967914437,0
1207,4,0,0,34,0.0,0.0,1.0,34,850,600,250,0.7058823529411765,11,6,5,357.3252534333331,0.7362596553773025,0.03521790341578335,0.2330024118009983,135314.73021193765,2870.2740532487383,138185.0042651864,1199,24,476.8529411764706,33,1,20,30.59530820573223,0.6799242424242424,39.889705882352935,1040.4411764705876,31.528520499108716,0
1208,4,0,0,34,0.0,0.0,1.0,34,600,400,200,0.6666666666666666,8,4,4,356.78477363306007,0.7369281045751634,0.028968440885539293,0.2330627921301494,135378.49024413666,2860.196799307929,138238.68704344457,1200,25,477.8529411764706,33,1,20,30.545905950698693,0.6805555555555557,39.828431372549005,1040.6862745098022,31.53594771241825,0
1209,4,0,0,34,0.0,0.0,1.0,34,700,400,300,0.5714285714285714,10,4,6,359.7467055543875,0.735034165181224,0.028428487345497633,0.23562438424707177,135474.15845167715,2947.2764381487855,138421.43488982593,1201,26,478.8529411764706,33,1,21,30.373626643123416,0.6815025252525253,39.736519607843135,1041.053921568627,31.547088532382634,0
1210,4,0,0,34,0.0,0.0,1.0,34,1400,1000,400,0.7142857142857143,18,10,8,361.9532573483967,0.7344771241830066,0.03170961289563512,0.23791498331044272,135601.76862564884,3016.30037125145,138618.06899690029,1202,27,479.8529411764706,33,1,21,30.189213436874923,0.6827651515151516,39.6139705882353,1041.5441176470592,31.561942959001794,0
1211,4,0,0,34,0.0,0.0,1.0,34,750,400,350,0.5333333333333333,11,4,7,362.4641490529496,0.7329545454545455,0.029757704069630853,0.2388891624223393,135697.51567906578,3037.0969098423707,138734.61258890814,1203,28,480.8529411764706,33,1,21,30.08066729397005,0.6837121212121212,39.52205882352941,1041.9117647058824,31.573083778966133,0
1212,4,0,0,34,0.0,0.0,1.0,34,900,400,500,0.4444444444444444,14,4,10,360.1386277716596,0.7337715389185978,0.030269190078758612,0.2384201794905454,135857.16919273834,2985.4828972029964,138842.65208994134,1204,29,481.8529411764706,33,1,21,29.982538889541942,0.6852904040404041,39.368872549019606,1042.5245098039213,31.59165181224004,0
1213,4,0,0,34,0.0,0.0,1.0,34,1050,700,350,0.6666666666666666,14,7,7,361.5359929732674,0.7310234699940583,0.03512428593484662,0.24055732015373882,136037.0057397959,3036.45479024943,139073.46053004533,1205,30,482.8529411764706,34,0,16,29.76744075468828,0.6847426470588236,39.19642857142857,1043.2142857142853,30.682773109243687,0
1214,4,0,1,33,0.0,0.029411764705882353,0.9705882352941176,34,700,500,200,0.7142857142857143,9,5,4,359.7418686375471,0.7300579322638147,0.03934431730478849,0.23978231776487446,136099.10891439905,2992.1095521541897,139091.21846655325,1206,31,483.8529411764706,34,0,17,29.752567027952075,0.6853553921568627,39.13690476190476,1043.4523809523807,30.68977591036414,0
1215,4,0,0,33,0.0,0.0,1.0,33,900,700,200,0.7777777777777778,11,7,4,367.4578961793999,0.7180397727272728,0.05518183953701872,0.244799415342051,136080.84180363332,3400.7959678969655,139481.63777153028,1207,65,498.57575757575756,33,0,20,29.56943465664396,0.6875,39.154411764705884,1043.382352941177,31.617647058823547,0
1216,4,0,0,33,0.0,0.0,1.0,33,1050,500,550,0.47619047619047616,16,5,11,366.3748502731323,0.7200126262626263,0.06898082386363646,0.2287608821217608,133733.2925211714,3210.251317944228,136943.54383911562,1208,66,499.57575757575756,32,1,19,31.940205891927086,0.6666666666666666,41.41414141414142,1034.3434343434349,32.32323232323234,4
1217,4,0,0,33,0.0,0.0,1.0,33,600,400,200,0.6666666666666666,8,4,4,378.6002189302169,0.7200126262626263,0.06709558481912214,0.22847724536921235,132462.9840864453,3432.593931741661,135895.57801818696,1209,67,500.57575757575756,32,1,20,32.901743734412676,0.6539713541666666,42.64520202020202,1029.4191919191921,32.169349747474755,2
1218,4,0,0,33,0.0,0.0,1.0,33,1000,800,200,0.8,12,8,4,379.8947256503858,0.7202493686868687,0.06651214275632045,0.2302512014751744,132625.50536935005,3476.745995306601,136102.25136465667,1210,68,501.57575757575756,32,1,18,32.704604886818665,0.6555989583333334,42.48737373737374,1030.0505050505049,32.18907828282828,0
1219,4,0,0,33,0.0,0.0,1.0,33,500,300,200,0.6,7,3,4,378.3889356584776,0.7187500000000001,0.06949534556445514,0.22993537631487979,132723.0659658453,3444.1879336292222,136167.25389947454,1211,69,502.57575757575756,32,1,18,32.64510068210595,0.6565755208333334,42.39267676767677,1030.4292929292928,32.2009154040404,0
1220,4,0,0,33,0.0,0.0,1.0,33,600,400,200,0.6666666666666666,8,4,4,378.5805076058877,0.7192234848484849,0.06713508449536953,0.2303807575228303,132776.64389898116,3453.3298490964926,136229.97374807764,1212,70,503.57575757575756,33,0,18,32.586206896551694,0.6546717171717171,42.3406862745098,1030.6372549019607,31.23143196672608,0
1221,4,0,0,33,0.0,0.0,1.0,33,1150,900,250,0.782608695652174,14,9,5,368.46469647747773,0.7192234848484849,0.038832986352069776,0.21940397835704376,131956.93963860063,3124.2947424067715,135081.2343810074,1213,71,504.57575757575756,33,0,16,33.67276956106869,0.6464646464646464,43.13725490196079,1027.4509803921576,31.134878193701745,8
1222,4,0,0,33,0.0,0.0,1.0,33,600,500,100,0.8333333333333334,7,5,2,367.27324576889805,0.7199337121212122,0.04128584593700868,0.21887606011174215,131988.41979346893,3095.1630682910472,135083.58286176,1214,72,505.57575757575756,33,0,16,33.67161101172729,0.646780303030303,43.106617647058826,1027.5735294117653,31.138591800356526,0
1223,4,1,1,33,0.029411764705882353,0.029411764705882353,0.9705882352941176,34,900,500,400,0.5555555555555556,13,5,8,353.55439361405706,0.7308749257278669,0.03250773993808065,0.2129949639577367,132398.00347222216,2561.979166666657,134959.98263888882,1215,0,491.6764705882353,34,0,16,33.611673414305,0.6485906862745099,42.70833333333333,1029.166666666666,30.269607843137237,0
1224,4,0,0,33,0.0,0.0,1.0,33,600,300,300,0.5,9,3,6,364.0439048427288,0.7165404040404041,0.038777484227698444,0.21894789577790488,132334.94929834688,3035.14633794695,135370.09563629385,1216,74,507.57575757575756,33,0,16,33.405292202636176,0.6502525252525253,42.76960784313726,1028.9215686274515,31.179441473559137,0
1225,4,0,0,33,0.0,0.0,1.0,33,900,600,300,0.6666666666666666,12,6,6,362.7191513467045,0.7168560606060607,0.039499651834453475,0.21869907768564034,132429.5361910082,3006.945796088031,135436.48198709622,1217,75,508.57575757575756,33,0,16,33.34412330833034,0.651199494949495,42.67769607843137,1029.289215686274,31.190582293523455,0
1226,4,0,0,33,0.0,0.0,1.0,33,800,500,300,0.625,11,5,6,351.4890327554138,0.7171717171717172,0.015482192226378144,0.2094694768766271,131988.41979346875,2678.496401624365,134666.91619509313,1218,76,509.57575757575756,33,0,16,34.077096998608624,0.6467803030303031,43.10661764705882,1027.573529411764,31.138591800356483,2
1227,4,1,1,33,0.029411764705882353,0.029411764705882353,0.9705882352941176,34,1000,700,300,0.7,13,7,6,343.8072895881917,0.732397504456328,0.015247015260628327,0.2066190957316517,132306.12953514734,2297.562358276636,134603.69189342397,1219,0,495.55882352941177,34,0,17,33.954813700532284,0.647671568627451,42.797619047619044,1028.8095238095234,30.25910364145657,0
1228,4,0,0,33,0.0,0.0,1.0,33,1100,900,200,0.8181818181818182,13,9,4,350.46314934283055,0.7163825757575758,0.022098968714792777,0.2100776249489308,132208.8860053824,2666.868512110709,134875.7545174931,1220,78,511.57575757575756,33,0,17,33.88147442008262,0.6489898989898991,42.89215686274509,1028.4313725490185,31.164587046939957,0
1229,4,0,0,33,0.0,0.0,1.0,33,900,700,200,0.7777777777777778,11,7,4,350.9248375040091,0.7156723484848485,0.027733264036265304,0.21105766014925895,132334.9492983465,2687.9241157246847,135022.8734140712,1221,79,512.5757575757576,33,0,19,33.7427544862633,0.6502525252525254,42.76960784313724,1028.9215686274488,31.179441473559052,0
1230,4,0,0,33,0.0,0.0,1.0,33,700,500,200,0.7142857142857143,9,5,4,350.26493906903954,0.7159090909090909,0.03189412881042819,0.2111898939871399,132429.53619100797,2677.0846849768927,135106.62087598487,1222,80,513.5757575757576,33,0,20,33.66459796801205,0.6511994949494951,42.67769607843135,1029.2892156862722,31.1905822935234,0
1231,4,0,0,33,0.0,0.0,1.0,33,950,700,250,0.7368421052631579,12,7,5,350.82668395850703,0.7137784090909092,0.03727828150584589,0.2120608488215375,132524.1568747594,2698.6021001537447,135222.75897491316,1223,81,514.5757575757576,33,0,20,33.55500674442592,0.6521464646464649,42.58578431372547,1029.6568627450956,31.201723113487745,0
1232,4,0,0,33,0.0,0.0,1.0,33,650,400,250,0.6153846153846154,9,4,5,352.1990597450618,0.7115688131313131,0.03873135350651413,0.21360644272849807,132650.37035034568,2743.867142445166,135394.23749279085,1224,82,515.5757575757576,33,0,14,33.392814656197935,0.6534090909090912,42.463235294117624,1030.1470588235265,31.216577540106865,0
1233,4,0,0,33,0.0,0.0,1.0,33,750,600,150,0.8,9,6,3,352.1027710344266,0.711489898989899,0.03626274636976223,0.21426803939215072,132776.64389898095,2750.2048490964794,135526.84874807743,1225,83,516.5757575757576,33,0,14,33.26843043995244,0.6546717171717172,42.34068627450979,1030.637254901959,31.23143196672603,0
1234,4,0,0,33,0.0,0.0,1.0,33,1050,700,350,0.6666666666666666,14,7,7,353.4572026485854,0.7093592171717172,0.030605484502823188,0.21618428906180923,132966.16685890043,2799.5698769703945,135765.73673587083,1226,84,517.5757575757576,33,0,14,33.04321134347275,0.6565656565656566,42.15686274509804,1031.3725490196077,31.25371360665478,0
1235,4,0,0,33,0.0,0.0,1.0,33,500,200,300,0.4,8,2,6,353.4572026485854,0.7093592171717172,0.030605484502823188,0.21618428906180923,132966.16685890043,2799.5698769703945,135765.73673587083,1227,85,518.5757575757576,33,0,14,33.04321134347275,0.6565656565656566,42.15686274509804,1031.3725490196077,31.25371360665478,0
1236,4,0,0,33,0.0,0.0,1.0,33,550,200,350,0.36363636363636365,9,2,7,357.6351369162722,0.7094381313131314,0.03304607010950544,0.21911008606704357,133029.37121539787,2915.1954777008805,135944.56669309875,1228,86,519.5757575757576,33,0,14,32.872020274016,0.6571969696969697,42.095588235294116,1031.6176470588232,31.26114081996434,0
1237,4,0,0,33,0.0,0.0,1.0,33,700,500,200,0.7142857142857143,9,5,4,356.551813632286,0.7089646464646465,0.030590945080256393,0.21881678358482864,133092.59059015766,2890.880911188014,135983.4715013457,1229,87,520.5757575757576,33,0,15,32.83650039588283,0.6578282828282829,42.0343137254902,1031.8627450980396,31.268568033273926,0
1238,4,0,0,33,0.0,0.0,1.0,33,750,500,250,0.6666666666666666,10,5,5,352.25191915453394,0.7092803030303031,0.03705336817841265,0.22237382170375455,134137.8785352988,2850.0650290753415,136987.94356437415,1230,88,521.5757575757576,33,0,15,31.90077980204267,0.6682449494949496,41.02328431372548,1035.906862745097,31.391117052881725,1
1239,4,0,0,33,0.0,0.0,1.0,33,600,400,200,0.6666666666666666,8,4,4,360.1032280320602,0.7092803030303031,0.04240031611726813,0.2100560281311928,131171.15600069697,2847.0313401095927,134018.18734080656,1231,89,522.5757575757576,33,0,18,34.681057343382385,0.6385732323232322,43.903186274509814,1024.3872549019618,31.042038027332175,6
1240,4,0,0,33,0.0,0.0,1.0,33,950,900,50,0.9473684210526315,10,9,1,359.2372459794656,0.7082544191919192,0.04435120063483122,0.2102380047674089,131296.72369100834,2833.3346849769478,134130.0583759853,1232,90,523.5757575757576,33,0,19,34.5762834309857,0.6398358585858585,43.78063725490197,1024.877450980393,31.056892453951303,0
1241,4,2,1,34,0.05714285714285714,0.02857142857142857,0.9714285714285714,35,550,400,150,0.7272727272727273,7,4,3,343.1348236130163,0.7359943977591036,0.039417750869509494,0.2034954649127462,131803.09070644728,2045.2460562414428,133848.33676268873,1233,0,494.6,35,0,13,34.478321310489946,0.6404761904761904,43.287037037037045,1026.8518518518526,29.33862433862436,0
1242,4,0,0,34,0.0,0.0,1.0,34,850,600,250,0.7058823529411765,11,6,5,355.2372277404869,0.7218137254901962,0.06137972065222641,0.19153976838791123,128084.27047902498,2300.060232426305,130384.33071145129,1234,1,510.1470588235294,34,0,20,37.944695989650704,0.6050857843137254,46.93452380952381,1012.261904761905,29.77240896358544,5
1243,4,0,0,34,0.0,0.0,1.0,34,1050,800,250,0.7619047619047619,13,8,5,353.4352825619401,0.7212938205585265,0.061849431130476695,0.1908550525834476,128144.53125,2258.159722222222,130402.69097222222,1235,2,511.1470588235294,34,0,20,37.9286694101509,0.6056985294117647,46.875,1012.5,29.779411764705884,0
1244,4,0,0,34,0.0,0.0,1.0,34,950,800,150,0.8421052631578947,11,8,3,353.0301081158383,0.7198455139631611,0.06388451008047769,0.19106744019399188,128234.94897959186,2254.1595804988647,130489.10856009072,1236,3,512.1470588235294,34,0,20,37.846487619495356,0.6066176470588236,46.785714285714285,1012.857142857143,29.78991596638656,0
1245,4,0,0,34,0.0,0.0,1.0,34,1050,1000,50,0.9523809523809523,11,10,1,354.22708199570786,0.719437017231135,0.06640195732857856,0.1921495662756831,128325.39859693873,2291.266298185938,130616.66489512466,1237,4,513.1470588235294,34,0,20,37.723730074805154,0.6075367647058822,46.69642857142857,1013.2142857142853,29.800420168067216,0
1246,4,1,0,35,0.02857142857142857,0.0,1.0,35,1150,900,250,0.782608695652174,14,9,5,346.8791276597984,0.7364145658263305,0.07320960093858475,0.18994936365980347,128701.7763658479,1928.7919828103568,130630.56834865826,1238,0,499.45714285714286,35,0,18,37.525783240180985,0.6092261904761904,46.32523148148148,1014.6990740740739,28.99140211640211,0
1247,4,0,0,35,0.0,0.0,1.0,35,1250,1000,250,0.8,15,10,5,346.916249488394,0.7336134453781512,0.0759647009020159,0.1909562843796219,128907.38195516137,1944.0130958505065,130851.39505101187,1239,1,500.45714285714286,35,0,18,37.315268596611205,0.6113095238095236,46.1226851851852,1015.5092592592608,29.01455026455031,0
1248,4,2,1,36,0.05405405405405406,0.02702702702702703,0.972972972972973,37,1000,800,200,0.8,12,8,4,329.9678071461194,0.7558183183183184,0.038901701658615506,0.18572930537909685,129787.30384589493,1165.1264090874158,130952.43025498235,1240,0,474.35135135135135,37,0,17,36.851998816313355,0.6162725225225224,45.25767543859649,1018.9692982456144,27.539710763394982,2
1249,4,2,3,35,0.05263157894736842,0.07894736842105263,0.9210526315789473,38,550,100,450,0.18181818181818182,10,1,9,322.6311104930667,0.7682550972024657,0.03913460584207229,0.1826712088236543,130017.30974687696,789.5258053911812,130806.83555226814,1241,0,462.8157894736842,38,0,18,36.80599203855018,0.6167763157894737,45.03205128205128,1019.871794871794,26.83873144399458,0
1250,4,0,0,35,0.0,0.0,1.0,35,500,300,200,0.6,7,3,4,344.818704050547,0.730672268907563,0.043276259787517146,0.19265156819698315,129495.73072059343,1930.5100094307404,131426.24073002418,1242,2,503.4,35,0,18,36.769862027139716,0.6172619047619047,45.54398148148149,1017.8240740740754,29.080687830687868,0
1251,4,1,1,35,0.027777777777777776,0.027777777777777776,0.9722222222222222,36,950,700,250,0.7368421052631579,12,7,5,338.3128179330041,0.7437830687830689,0.03407751252578817,0.1903640781503623,129774.47041636254,1580.8733564645952,131355.34377282712,1243,0,490.3888888888889,36,0,18,36.65243700265252,0.6180555555555556,45.27027027027028,1018.9189189189208,28.303303303303355,0
1252,4,1,0,36,0.027777777777777776,0.0,1.0,36,900,400,500,0.4444444444444444,14,4,10,341.41521203459587,0.7447089947089948,0.043145775028232025,0.19267397128037209,129889.23890106347,1669.2324080837902,131558.47130914725,1244,0,491.3611111111111,36,0,19,36.456952423037286,0.6192129629629628,45.15765765765767,1019.3693693693713,28.315815815815867,0
1253,4,2,2,36,0.05263157894736842,0.05263157894736842,0.9473684210526316,38,800,500,300,0.625,11,5,6,326.36401499375256,0.766269559032717,0.03705692803437133,0.18595158993830108,130262.58680555563,902.6041666666774,131165.1909722223,1245,0,466.44736842105266,38,0,19,36.46258503401361,0.6192434210526315,44.79166666666667,1020.833333333334,26.864035087719316,0
1254,4,0,0,36,0.0,0.0,1.0,36,800,600,200,0.75,10,6,4,340.71910385060187,0.7444113756613757,0.04279096877109034,0.1927052770373018,129975.34855379042,1657.0168563834272,131632.36541017384,1246,2,493.3611111111111,36,0,19,36.38735505245721,0.6200810185185185,45.073198198198206,1019.7072072072084,28.325200200200232,0
1255,4,0,0,36,0.0,0.0,1.0,36,600,200,400,0.3333333333333333,10,2,8,340.2741860177252,0.7455026455026456,0.03630921714383861,0.1928788220868934,130061.4867401186,1651.313306549809,131712.80004666842,1247,3,494.3611111111111,36,0,20,36.311363803635835,0.6209490740740741,44.988738738738746,1020.0450450450459,28.334584584584608,0
1256,4,2,2,36,0.05263157894736842,0.05263157894736842,0.9473684210526316,38,800,600,200,0.75,10,6,4,323.78978947724426,0.7619428639165481,0.02285948584731723,0.18552437128645233,130480.80490037626,849.6704699028458,131330.4753702791,1248,0,469.2894736842105,38,0,20,36.30768761546236,0.6214364035087719,44.577991452991455,1021.6880341880345,26.886527215474594,0
1257,4,0,0,36,0.0,0.0,1.0,36,450,300,150,0.6666666666666666,6,3,3,337.66284310038407,0.7436507936507937,0.02676622771524606,0.1919636564727528,130176.38204082455,1591.1454528853128,131767.52749370987,1249,5,496.3611111111111,36,0,20,36.26154086662253,0.6221064814814815,44.876126126126124,1020.495495495495,28.347097097097084,0
1258,4,1,0,37,0.02702702702702703,0.0,1.0,37,1250,900,350,0.72,16,9,7,328.7148409438377,0.7494994994994995,0.02931214476278865,0.18864669443328616,130542.57079101262,1182.2560787934751,131724.8268698061,1250,0,483.9189189189189,37,0,16,36.11945636623749,0.6238738738738738,44.51754385964912,1021.9298245614035,27.61972498814604,0
1259,4,0,0,37,0.0,0.0,1.0,37,900,400,500,0.4444444444444444,14,4,10,330.07300693981796,0.748561061061061,0.033051717239659384,0.18970040509821098,130598.60365689438,1221.414762234524,131820.0184191289,1251,1,484.9189189189189,37,0,16,36.02812343560037,0.6244369369369369,44.46271929824561,1022.1491228070172,27.62565196775722,0
1260,4,1,1,37,0.02631578947368421,0.02631578947368421,0.9736842105263158,38,1000,600,400,0.6,14,6,8,324.0395667023431,0.7585644855381698,0.02990518070633441,0.18724676229178835,130808.47447083423,877.4242777047214,131685.89874853895,1252,0,473.13157894736844,38,0,16,35.970409051348994,0.6247258771929824,44.25747863247863,1022.9700854700853,26.920265407107507,0
1261,4,0,1,36,0.0,0.02702702702702703,0.972972972972973,37,1200,900,300,0.75,15,9,6,339.70858828361406,0.7490615615615616,0.026730537808188792,0.19189613935972338,129927.0027797016,1427.4637388427357,131354.46651854433,1253,3,486.9189189189189,37,0,16,36.462142396214254,0.6176801801801801,45.120614035087726,1019.5175438596503,27.554528212422984,1
1262,4,0,1,35,0.0,0.027777777777777776,0.9722222222222222,36,300,200,100,0.6666666666666666,4,2,2,349.7192340699909,0.741170634920635,0.031234267752115352,0.1969265307466927,129803.1577819376,1878.9321838730946,131682.08996581068,1254,4,501.0833333333333,36,0,16,36.33274394960769,0.6183449074074073,45.24211711711713,1019.0315315315336,28.306431431431488,0
1263,4,0,0,35,0.0,0.0,1.0,35,1250,1100,150,0.88,14,11,3,358.44214876033084,0.7281512605042016,0.03506493506493524,0.20116651205936933,129672.49657064474,2296.017661179706,131968.51423182443,1255,5,516.1142857142858,35,0,17,36.24337121212122,0.619047619047619,45.370370370370374,1018.5185185185187,29.100529100529105,0
1264,4,2,0,37,0.05405405405405406,0.0,1.0,37,1450,1300,150,0.896551724137931,16,13,3,345.0749970449752,0.7480605605605606,0.03640766128681072,0.19647114051936854,130234.60493853883,1588.1411828639666,131822.7461214028,1256,0,489.1621621621622,37,0,20,36.013423389551335,0.620777027027027,44.819078947368425,1020.7236842105268,27.58712660028451,0
1265,4,1,0,38,0.02631578947368421,0.0,1.0,38,750,500,250,0.6666666666666666,10,5,5,337.1845080464564,0.7580606922712186,0.03948193712380488,0.1936078633836978,130562.68376981534,1204.7428592300596,131767.4266290454,1257,0,477.2631578947368,38,0,16,35.88272701930449,0.6222587719298245,44.49786324786326,1022.0085470085482,26.89496176338285,0
1266,4,0,0,38,0.0,0.0,1.0,38,800,600,200,0.75,10,6,4,336.9786743856333,0.7577050734945472,0.043764302059496885,0.19376273777173927,130617.28395061736,1203.0478395061853,131820.33179012354,1258,1,478.2631578947368,38,0,16,35.832767210144944,0.6228070175438596,44.44444444444445,1022.2222222222229,26.900584795321652,0
1267,4,0,2,36,0.0,0.05263157894736842,0.9473684210526316,38,1000,800,200,0.8,12,8,4,336.6046919262003,0.7580310573731627,0.046002452584287035,0.1939580678161145,130699.2056235846,1198.7931687851558,131897.99879236976,1259,2,479.2631578947368,38,0,16,35.7594991815554,0.6236293859649122,44.36431623931624,1022.5427350427348,26.90901934322986,0
1268,4,0,0,36,0.0,0.0,1.0,36,750,500,250,0.6666666666666666,10,5,5,348.4775528120799,0.7386574074074075,0.04748471594320125,0.19913944086028687,130377.57087746532,1886.7313681925225,132264.30224565783,1260,3,506.72222222222223,36,0,21,35.78169221156321,0.6241319444444444,44.679054054054056,1021.283783783784,28.368993993994,0
1269,4,1,1,36,0.02702702702702703,0.02702702702702703,0.972972972972973,37,650,300,350,0.46153846153846156,10,3,7,337.88189830478655,0.7486861861861862,0.038776521882817994,0.19432899061662715,130626.62459843414,1427.27437769313,132053.89897612727,1261,0,494.0,37,0,16,35.800238657084606,0.6247184684684685,44.435307017543856,1022.2587719298245,27.628615457562827,0
1270,4,0,0,36,0.0,0.0,1.0,36,1050,500,550,0.47619047619047616,16,5,11,348.1700292578548,0.7386243386243386,0.05231746731305975,0.19999944212305643,130578.91506371241,1892.7329356383418,132471.64799935077,1262,5,508.72222222222223,36,0,16,35.58561040105772,0.6261574074074074,44.48198198198198,1022.0720720720725,28.3908908908909,0
1271,4,0,0,36,0.0,0.0,1.0,36,450,200,250,0.4444444444444444,7,2,5,348.8016928566999,0.737202380952381,0.04743241424043321,0.20080980148674527,130665.25298524859,1915.2522877607184,132580.5052730093,1263,6,509.72222222222223,36,0,16,35.482064838271484,0.627025462962963,44.397522522522515,1022.4099099099085,28.400275275275234,0
1272,4,0,0,36,0.0,0.0,1.0,36,950,800,150,0.8421052631578947,11,8,3,353.71727933743875,0.737202380952381,0.04582736981173663,0.20424755551315646,130780.41459956557,2051.858488556103,132832.27308812167,1264,7,510.72222222222223,36,0,16,35.239825314690435,0.6281828703703705,44.2849099099099,1022.8603603603588,28.412787787787742,0
1273,4,0,0,36,0.0,0.0,1.0,36,1150,900,250,0.782608695652174,14,9,5,352.83990207568763,0.7377976190476191,0.04806928090189899,0.20435029892681758,130895.62694028462,2037.040038349134,132932.66697863376,1265,8,511.72222222222223,36,0,16,35.14567514031034,0.6293402777777779,44.172297297297284,1023.3108108108088,28.425300300300243,0
1274,4,0,1,35,0.0,0.027777777777777776,0.9722222222222222,36,800,600,200,0.75,10,6,4,352.47938137712475,0.7389219576719577,0.051891981080189,0.20475335821721646,131010.8900074059,2035.7274926953805,133046.61750010127,1266,9,512.7222222222222,36,0,16,35.03831628350383,0.6304976851851853,44.059684684684676,1023.7612612612601,28.43781281281278,0
1275,4,0,0,35,0.0,0.0,1.0,35,1100,800,300,0.7272727272727273,14,8,6,361.0019441561249,0.7296918767507002,0.048159757003910064,0.20917294824563923,130913.23329260964,2451.9863468792787,133365.21963948893,1267,10,527.9142857142857,35,0,17,34.919041694940816,0.631547619047619,44.15509259259259,1023.3796296296289,29.23941798941797,0
1276,4,0,0,35,0.0,0.0,1.0,35,850,600,250,0.7058823529411765,11,6,5,358.8573884245627,0.7296918767507002,0.06369513439945584,0.204000360653731,130173.98787133483,2342.779465663578,132516.7673369984,1268,11,528.9142857142857,35,0,17,35.72324770330046,0.6241071428571429,44.87847222222222,1020.4861111111107,29.15674603174602,1
1277,4,0,0,35,0.0,0.0,1.0,35,1350,1100,250,0.8148148148148148,16,11,5,361.2191793861125,0.7289915966386554,0.07139859441095164,0.2062941491860235,130353.74858276639,2417.2849594119994,132771.0335421784,1269,12,529.9142857142857,34,1,18,35.480541307220015,0.6280637254901962,44.70238095238095,1021.1904761904758,30.03501400560223,0
1278,4,0,0,35,0.0,0.0,1.0,35,1000,700,300,0.7,13,7,6,362.96939268967253,0.7294117647058823,0.06799866799866794,0.20761849261849263,130414.54081632648,2467.2973356009,132881.83815192737,1270,13,530.9142857142857,34,1,18,35.37417443667443,0.6286764705882353,44.64285714285714,1021.428571428571,30.042016806722675,0
1279,4,2,0,37,0.05405405405405406,0.0,1.0,37,600,500,100,0.8333333333333334,7,5,2,339.2009244894749,0.7541291291291291,0.046282359572796805,0.18620932602607343,128800.98637488838,1402.45543478531,130203.44180967369,1271,0,503.1621621621622,36,1,17,37.61949005251092,0.6082175925925927,46.22747747747748,1015.0900900900899,28.19694694694694,7
1280,4,2,1,38,0.05128205128205128,0.02564102564102564,0.9743589743589743,39,850,600,250,0.7058823529411765,11,6,5,326.08340271909765,0.7721547458389564,0.04766565473919426,0.18108368124652147,129257.13320444741,630.3425626298169,129887.47576707722,1272,0,478.3076923076923,37,2,19,37.488767881532624,0.6109234234234234,45.77850877192982,1016.8859649122797,27.483404457088643,0
1281,4,0,0,38,0.0,0.0,1.0,38,850,700,150,0.8235294117647058,10,7,3,333.9565883485302,0.7631875296348981,0.05118677937427951,0.1850634507220099,129173.52123970844,1027.6696916358917,130201.19093134433,1273,1,491.89473684210526,37,1,20,37.37359777801746,0.6100788288288288,45.86074561403509,1016.5570175438602,27.474513987671898,0
1282,4,2,0,40,0.05,0.0,1.0,40,1050,500,550,0.47619047619047616,16,5,11,319.58124489648947,0.7816773504273504,0.06165023080151055,0.17919108390313734,129636.22708013716,285.8643725233671,129922.09145266053,1274,0,468.25,38,2,14,37.26963561337249,0.6129385964912282,45.405982905982896,1018.376068376067,26.799370220422816,0
1283,4,0,2,38,0.0,0.05,0.95,40,900,300,600,0.3333333333333333,15,3,12,315.8078233704505,0.7826923076923077,0.059311772722507206,0.17793802877322645,129826.69850107734,200.05741379937916,130026.75591487672,1275,1,469.25,38,2,14,37.172834329244864,0.614857456140351,45.21901709401708,1019.1239316239303,26.819050832208692,0
1284,4,1,0,39,0.02564102564102564,0.0,1.0,39,750,700,50,0.9333333333333333,8,7,1,315.92826863262013,0.7832883490778227,0.06002487706263149,0.17833546529917804,129899.05698147476,407.7568338334571,130306.81381530821,1276,0,470.53846153846155,37,2,15,37.09653203542363,0.6173986486486488,45.14802631578946,1019.4078947368396,27.551564722617286,0
1285,4,0,2,37,0.0,0.05128205128205128,0.9487179487179487,39,1150,800,350,0.6956521739130435,15,8,7,315.83331782131717,0.7843004948268106,0.05943492173740483,0.17904919900619778,130066.77685682094,415.8843346029066,130482.66119142385,1277,1,471.53846153846155,37,2,16,36.92928356444157,0.619087837837838,44.983552631578924,1020.0657894736811,27.56934566145084,0
1286,4,1,0,38,0.02631578947368421,0.0,1.0,38,700,500,200,0.7142857142857143,9,5,4,323.80938457864903,0.7747451398767188,0.07037295224816997,0.18381660553148882,130118.92804967133,826.7460027595209,130945.67405243086,1278,0,484.60526315789474,36,2,19,36.67310522442974,0.6215277777777778,44.932432432432435,1020.2702702702707,28.34084084084085,0
1287,4,1,1,38,0.02564102564102564,0.02564102564102564,0.9743589743589743,39,900,700,200,0.7777777777777778,11,7,4,315.6710227618144,0.786493477282951,0.07331984530052127,0.18050801577816442,130402.54122662723,432.86071194980633,130835.40193857704,1279,0,473.15384615384613,37,2,19,36.59409107174806,0.6224662162162162,44.65460526315788,1021.3815789473668,27.604907539118024,0
1288,4,0,0,38,0.0,0.0,1.0,38,850,500,350,0.5882352941176471,12,5,7,323.6542058638853,0.7736782835467046,0.07725837531632385,0.18481714979683306,130348.82010388758,837.5887712036297,131186.4088750912,1280,2,486.60526315789474,36,2,20,36.444548595794764,0.6238425925925927,44.707207207207205,1021.1711711711705,28.365865865865846,0
1289,4,0,0,38,0.0,0.0,1.0,38,1050,700,350,0.6666666666666666,14,7,7,321.5302895769251,0.7731152204836416,0.07385305397768449,0.184012697586895,130435.08193582093,787.7659331628862,131222.8478689838,1281,3,487.60526315789474,36,2,21,36.41159556094513,0.6247106481481481,44.622747747747745,1021.5090090090088,28.375250250250243,0
1290,4,0,0,38,0.0,0.0,1.0,38,900,600,300,0.6666666666666666,12,6,6,320.1805738722677,0.7734708392603129,0.07594830236618799,0.18351221394460415,130492.60567577709,756.239474271567,131248.84515004864,1282,4,488.60526315789474,36,2,16,36.38795510488999,0.6252893518518519,44.56644144144144,1021.7342342342339,28.381506506506497,0
1291,4,0,0,38,0.0,0.0,1.0,38,1000,800,200,0.8,12,8,4,324.32623715164414,0.7726706970128023,0.0797779042618687,0.18438170395659959,130176.38204082455,843.9232306630913,131020.30527148764,1283,5,489.60526315789474,36,2,20,36.60178952401972,0.6221064814814815,44.876126126126124,1020.495495495495,28.347097097097084,3
1292,4,1,1,38,0.02564102564102564,0.02564102564102564,0.9743589743589743,39,1100,1000,100,0.9090909090909091,12,10,2,318.99350424586714,0.7823324336482231,0.09170749902510944,0.18296757632914035,130521.37230135551,527.1225194789469,131048.49482083446,1284,0,478.02564102564105,36,3,13,36.38922562633162,0.6255787037037037,44.53828828828829,1021.8468468468477,28.384634634634658,0
1293,4,3,3,38,0.07317073170731707,0.07317073170731707,0.926829268292683,41,1300,1000,300,0.7692307692307693,16,10,6,306.25797120555603,0.791310975609756,0.10072008322544268,0.17874057735180052,131191.2749858466,-164.325256592863,131026.94972925374,1285,0,455.4390243902439,38,3,14,36.039776479994416,0.628563596491228,43.88354700854702,1024.4658119658143,26.959626630679324,0
1294,4,0,0,38,0.0,0.0,1.0,38,1100,800,300,0.7272727272727273,14,8,6,325.8024317018568,0.7748636794689426,0.11261062868638239,0.18892268219931294,130942.84664619784,932.2995702589254,131875.14621645678,1286,1,487.07894736842104,35,3,15,35.789725394850905,0.631845238095238,44.12615740740741,1023.4953703703715,29.2427248677249,0
1295,4,0,0,38,0.0,0.0,1.0,38,850,500,350,0.5882352941176471,12,5,7,326.23897985828194,0.7743895211000474,0.11466972880992876,0.18961301023826288,131031.70680084014,949.5300711591145,131981.23687199925,1287,2,488.07894736842104,35,3,15,35.68891777828018,0.6327380952380952,44.03935185185185,1023.8425925925922,29.25264550264549,0
1296,4,1,0,39,0.02564102564102564,0.0,1.0,39,850,600,250,0.7058823529411765,11,6,5,317.7009579341939,0.7823886639676114,0.12558869701726816,0.1810156620787851,130262.58680555565,476.9097222222308,130739.49652777788,1288,0,476.53846153846155,37,2,20,36.68367346938775,0.6210585585585585,44.79166666666667,1020.8333333333342,27.59009009009011,2
1297,4,0,0,39,0.0,0.0,1.0,39,1050,800,250,0.7619047619047619,13,8,5,316.1764954281161,0.782051282051282,0.12569141013251395,0.1805365850350732,130346.55044100095,442.5031019159601,130789.05354291691,1289,1,477.53846153846155,37,2,20,36.63774204516984,0.6219031531531531,44.7094298245614,1021.1622807017533,27.598980559506845,0
1298,4,0,0,39,0.0,0.0,1.0,39,1300,1000,300,0.7692307692307693,16,10,6,313.7992368289427,0.780982905982906,0.11885635026130936,0.17969683402183517,130458.54403518383,387.5583112111351,130846.10234639497,1290,2,478.53846153846155,37,2,20,36.58534131158098,0.6230292792792793,44.59978070175438,1021.6008771929819,27.61083451872924,0
1299,4,0,0,39,0.0,0.0,1.0,39,1250,800,450,0.64,17,8,9,315.62008054710776,0.7785087719298246,0.12617265819024914,0.18152535539424336,130626.62459843417,445.67715547091984,131072.30175390508,1291,3,479.53846153846155,37,2,17,36.36917211913191,0.6247184684684683,44.43530701754386,1022.2587719298248,27.62861545756283,0
1300,4,0,0,39,0.0,0.0,1.0,39,950,500,450,0.5263157894736842,14,5,9,316.5412444038983,0.7777215474583896,0.1291645704640234,0.18258380869234148,130738.73842191833,476.8405903739614,131215.5790122923,1292,4,480.53846153846155,37,2,17,36.232510453522025,0.6258445945945945,44.32565789473684,1022.697368421053,27.64046941678522,0
1301,4,0,1,38,0.0,0.02564102564102564,0.9743589743589743,39,1150,900,250,0.782608695652174,14,9,5,317.64907254034574,0.7769343229869546,0.12881242288594108,0.1837559513871028,130850.90033712306,512.9334266312801,131363.83376375434,1293,5,481.53846153846155,37,2,17,36.091054013503374,0.6269707207207207,44.21600877192983,1023.1359649122816,27.652323376007608,0
1302,4,0,0,38,0.0,0.0,1.0,38,1150,900,250,0.782608695652174,14,9,5,322.42275417805615,0.7669511616880038,0.1187158323507338,0.18624655564873605,130794.81336805563,834.2447916666706,131629.0581597223,1294,9,495.07894736842104,37,1,18,36.025543109300735,0.6264076576576576,44.270833333333336,1022.9166666666673,27.646396396396415,0
1303,4,2,1,39,0.05,0.025,0.975,40,1400,1200,200,0.8571428571428571,16,12,4,309.1295711872785,0.777991452991453,0.11642537844153189,0.1814408091351453,131408.2153320315,124.43305121530719,131532.64838324682,1295,0,471.275,39,1,21,35.74801466355108,0.6290064102564101,43.671875000000014,1025.312500000002,26.290064102564155,0
1304,4,0,0,39,0.0,0.0,1.0,39,950,600,350,0.631578947368421,13,6,7,316.5882043042456,0.7721547458389564,0.12762796464338777,0.18569562399165912,131382.8849806415,518.8543264665128,131901.73930710802,1296,1,484.35897435897436,38,1,21,35.58231728497984,0.6304824561403508,43.6965811965812,1025.213675213676,26.979307242465158,0
1305,4,0,0,39,0.0,0.0,1.0,39,700,300,400,0.42857142857142855,11,3,8,318.84268971261076,0.771761133603239,0.12684266487142093,0.18728593242727293,131437.65637555713,581.5871776609085,132019.24355321802,1297,2,485.35897435897436,38,1,21,35.469412030284076,0.6310307017543859,43.6431623931624,1025.4273504273513,26.98493027440398,0
1306,4,0,0,39,0.0,0.0,1.0,39,1050,800,250,0.7619047619047619,13,8,5,318.79049250789416,0.7722109761583446,0.1209485364004319,0.1880628925089567,131602.03904594926,590.6957685002563,132192.73481444953,1298,3,486.35897435897436,38,1,16,35.30538490906568,0.6326754385964912,43.48290598290598,1026.0683760683758,27.001799370220414,0
1307,4,0,0,39,0.0,0.0,1.0,39,850,800,50,0.9411764705882353,9,8,1,316.3854486373763,0.7719860548807917,0.11979867204679917,0.1871817358687137,131711.68456424863,534.332082328875,132246.0166465775,1299,4,487.35897435897436,38,1,16,35.25686060227588,0.6337719298245614,43.376068376068375,1026.495726495726,27.013045434098057,0
1308,4,0,0,39,0.0,0.0,1.0,39,1300,1000,300,0.7692307692307693,16,10,6,321.2548881060401,0.7714237516869096,0.12803708653079293,0.19074881033745308,131848.80566741558,671.4146623201314,132520.22032973572,1300,5,488.35897435897436,38,1,17,34.994061860674805,0.635142543859649,43.24252136752138,1027.0299145299157,27.02710301394515,0
1309,4,1,0,40,0.025,0.0,1.0,40,1150,700,450,0.6086956521739131,16,7,9,316.55761001762573,0.7766292735042735,0.14266612641815213,0.18962722852512168,132183.6805555558,368.75000000002535,132552.43055555582,1301,0,477.125,39,1,18,34.77849810913021,0.6367521367521367,42.91666666666668,1028.3333333333353,26.36752136752142,0
1310,4,0,1,39,0.0,0.025,0.975,40,550,300,250,0.5454545454545454,8,3,5,338.23549830542726,0.7766292735042735,0.1703850183342066,0.19137272266302924,129990.07100820007,793.6248995543964,130783.69590775447,1302,1,478.125,38,2,16,36.43574297188757,0.6165021929824561,45.05876068376069,1019.7649572649577,26.835919928025202,4
1311,4,0,0,39,0.0,0.0,1.0,39,900,700,200,0.7777777777777778,11,7,4,345.10057261591015,0.771536212325686,0.17462589029424147,0.1950814726295045,129954.95158366041,1169.50564115882,131124.45722481923,1303,2,490.6666666666667,37,2,17,36.296353550560994,0.6179617117117117,45.093201754385966,1019.6271929824566,27.557491702228557,0
1312,4,1,1,39,0.025,0.025,0.975,40,750,500,250,0.6666666666666666,10,5,5,352.0192198083841,0.7832264957264957,0.15839298496778875,0.1977252125506139,129704.9167209201,1131.7247178819412,130836.64143880203,1304,0,479.375,39,1,14,36.37396887889015,0.6119123931623932,45.338541666666664,1018.6458333333329,26.11912393162392,8
1313,4,0,0,39,0.0,0.0,1.0,39,1150,1000,150,0.8695652173913043,13,10,3,364.77983738852413,0.7726045883940621,0.1636000731678453,0.20453420058749477,129636.22708013728,1657.7363667908478,131293.96344692813,1305,4,492.6666666666667,38,1,14,36.11890649041825,0.6129385964912281,45.4059829059829,1018.3760683760679,26.79937022042284,0
1314,4,1,2,38,0.025,0.05,0.95,40,1000,900,100,0.9,11,9,2,356.4425652187636,0.7855502136752137,0.1638843481814467,0.2014353249631212,129943.77170138898,1263.4982638888996,131207.26996527787,1306,0,481.325,39,1,14,36.0185941969759,0.6143162393162394,45.10416666666667,1019.583333333334,26.143162393162413,0
1315,4,2,2,38,0.05,0.05,0.95,40,1750,1400,350,0.8,21,14,7,358.1114675748575,0.7873397435897436,0.16429847850505452,0.20306807191433612,130076.56385633702,1316.3818359375196,131392.94569227454,1307,0,482.15,39,1,17,35.84118332822764,0.6156517094017093,44.97395833333334,1020.1041666666683,26.156517094017136,0
1316,4,2,1,39,0.05,0.025,0.975,40,600,500,100,0.8333333333333334,7,5,2,357.56325540773594,0.7826121794871795,0.16389569299857087,0.20344975473199747,130209.42382812501,1311.6210937500007,131521.04492187503,1308,0,483.1,39,1,18,35.72030006123698,0.6169871794871795,44.84375,1020.6250000000001,26.1698717948718,0
1317,4,0,0,39,0.0,0.0,1.0,39,750,400,350,0.5333333333333333,11,4,7,363.58959458348147,0.7780589293747189,0.1633561551886158,0.20643761166898056,130126.29323727098,1662.5132405581303,131788.80647782912,1309,1,496.4871794871795,38,1,18,35.65095986038395,0.6178728070175438,44.92521367521368,1020.2991452991467,26.849977507872282,0
1318,4,0,0,39,0.0,0.0,1.0,39,850,700,150,0.8235294117647058,10,7,3,366.65346203378726,0.7773841655420604,0.16281729158613611,0.20846868269921048,130180.80210387906,1746.2483563445192,131927.05046022357,1310,2,497.4871794871795,38,1,18,35.517430904522634,0.618421052631579,44.871794871794876,1020.5128205128208,26.855600539811075,0
1319,4,0,0,39,0.0,0.0,1.0,39,1500,1300,200,0.8666666666666667,17,13,4,367.1636686101924,0.7774403958614485,0.15914009638515436,0.21008089979545502,130426.23325525982,1777.5548570019848,132203.7881122618,1311,3,498.4871794871795,38,1,19,35.25520343060349,0.6208881578947367,44.63141025641026,1021.47435897436,26.88090418353579,0
1320,4,1,1,39,0.025,0.025,0.975,40,1000,800,200,0.8,12,8,4,359.41519558905867,0.7860844017094017,0.15079462102689511,0.20704340140271152,130688.28125000023,1394.2708333333635,132082.5520833336,1312,0,487.0,39,1,14,35.187449062754716,0.6217948717948717,44.375000000000014,1022.5000000000018,26.217948717948765,0
1321,4,1,1,39,0.025,0.025,0.975,40,800,600,200,0.75,10,6,4,359.3261005627799,0.7802884615384615,0.15470866863603927,0.20713472279652467,130714.91021050367,1393.8557942708533,132108.76600477452,1313,0,487.975,39,1,14,35.16274914264371,0.6220619658119657,44.34895833333334,1022.6041666666682,26.2206196581197,0
1322,4,0,0,39,0.0,0.0,1.0,39,1500,900,600,0.6,21,9,12,366.6316172207426,0.7771592442645074,0.15003617072582642,0.21111098536717873,130671.89554569374,1781.6896778435419,132453.5852235373,1314,6,501.4871794871795,38,1,14,35.01959247648905,0.6233552631578946,44.39102564102565,1022.4358974358984,26.906207827260484,0
1323,4,0,0,39,0.0,0.0,1.0,39,750,700,50,0.9333333333333333,8,7,1,366.3437411212428,0.7777777777777778,0.15096381540175963,0.21124351144653838,130726.51855504428,1778.168374242101,132504.6869292864,1315,7,502.4871794871795,38,1,14,34.97157508009472,0.6239035087719298,44.33760683760684,1022.6495726495733,26.9118308591993,0
1324,4,0,1,38,0.0,0.02564102564102564,0.9743589743589743,39,1150,800,350,0.6956521739130435,15,8,7,367.46231522175754,0.7777215474583896,0.1512973122036505,0.21263967328572642,130863.12601587042,1817.453452589672,132680.57946846008,1316,8,503.4871794871795,38,1,17,34.80452298910584,0.6252741228070176,44.20405982905983,1023.1837606837607,26.925888439046336,0
1325,4,3,0,41,0.07317073170731707,0.0,1.0,41,700,400,300,0.5714285714285714,10,4,6,352.547255221221,0.7902947154471545,0.16536194350633515,0.20727229524206978,131472.44953991155,1073.348969755115,132545.79850966667,1317,0,479.6585365853659,36,5,20,34.570248160755455,0.6351273148148149,43.609234234234236,1025.5630630630633,28.48786286286287,0
1326,4,0,0,41,0.0,0.0,1.0,41,750,400,350,0.5333333333333333,11,4,7,351.9018712408111,0.7907012195121951,0.1641576907428428,0.20767680380481013,131616.85333982622,1063.243395422443,132680.09673524866,1318,1,480.6585365853659,36,5,16,34.44107587064677,0.6365740740740742,43.468468468468465,1026.1261261261254,28.503503503503484,0
1327,4,0,2,39,0.0,0.04878048780487805,0.9512195121951219,41,650,500,150,0.7692307692307693,8,5,3,349.8895234266603,0.7898373983739837,0.16094082388986264,0.20695931252654193,131703.53366457683,1016.3373255011843,132719.87099007802,1319,2,481.6585365853659,36,5,16,34.4052843298592,0.6374421296296295,43.38400900900901,1026.4639639639645,28.512887887887903,0
1328,4,1,1,39,0.025,0.025,0.975,40,1350,900,450,0.6666666666666666,18,9,9,356.95715086510995,0.7825320512820513,0.16034784079377573,0.21119766317696237,131713.96933138318,1403.2486443330258,133117.2179757162,1320,0,493.6,35,5,16,34.21338839403165,0.6395833333333332,43.37384259259261,1026.504629629632,29.328703703703773,0
1329,4,0,0,39,0.0,0.0,1.0,39,1000,700,300,0.7,13,7,6,365.77875049394135,0.7748538011695907,0.1698234464537549,0.21561431407365186,131572.28599773263,1825.269274376441,133397.55527210908,1321,4,507.2564102564103,34,5,16,34.130115262628614,0.6403186274509802,43.51190476190477,1025.9523809523826,30.175070028011252,0
1330,4,0,0,39,0.0,0.0,1.0,39,1000,700,300,0.7,13,7,6,359.90192649614266,0.7751911830859199,0.16529613823253864,0.21277401894451967,131684.26890432113,1678.6844135802637,133362.95331790138,1322,5,508.2564102564103,35,4,16,34.16779431664412,0.6392857142857142,43.402777777777786,1026.38888888889,29.325396825396858,0
1331,4,0,0,39,0.0,0.0,1.0,39,1450,1200,250,0.8275862068965517,17,12,5,357.09441301711377,0.7730544309491678,0.1722612713219036,0.2122627196157564,131890.67790089254,1619.484841489687,133510.16274238224,1323,6,509.2564102564103,37,2,17,34.031632507828064,0.6373873873873874,43.20175438596491,1027.19298245614,27.761972498814597,0
1332,4,0,0,39,0.0,0.0,1.0,39,900,700,200,0.7777777777777778,11,7,4,360.09758683130417,0.7727732793522267,0.18009501415614992,0.2145860340857175,131985.99810979603,1705.5678829717115,133691.56599276775,1324,7,510.2564102564103,38,1,17,33.858390517779156,0.636513157894737,43.10897435897435,1027.5641025641014,27.041160593792142,0
1333,4,0,0,39,0.0,0.0,1.0,39,1000,500,500,0.5,15,5,10,361.1941794556364,0.7732793522267207,0.17126702318430453,0.2160206083841883,132123.26189139095,1744.4306331726248,133867.69252456358,1325,8,511.2564102564103,38,1,17,33.691849388617555,0.6378837719298245,42.97542735042735,1028.098290598291,27.055218173639236,0
1334,4,0,0,39,0.0,0.0,1.0,39,850,500,350,0.5882352941176471,12,5,7,359.09152750022076,0.774685110211426,0.16811691476696167,0.21538779658845,132233.12428090064,1696.7589168310196,133929.88319773166,1326,9,512.2564102564103,38,1,18,33.63521865586372,0.6389802631578948,42.86858974358974,1028.5256410256402,27.066464237516847,0
1335,4,0,0,39,0.0,0.0,1.0,39,1100,700,400,0.6363636363636364,15,7,8,359.1273418675929,0.77361673414305,0.17523097685040945,0.2163523254665746,132398.00347222242,1709.754068047357,134107.75754026978,1327,10,513.2564102564103,36,3,18,33.46828609986504,0.644386574074074,42.70833333333334,1029.1666666666683,28.587962962963008,0
1336,4,0,1,38,0.0,0.02564102564102564,0.9743589743589743,39,750,300,450,0.4,12,3,9,360.1475963709512,0.7729982006297796,0.17655028485353363,0.21730093586976038,132455.9583865963,1740.7390075886938,134196.69739418497,1328,11,514.2564102564103,36,3,18,33.38370163731176,0.6449652777777777,42.65202702702704,1029.3918918918937,28.59421921921927,0
1337,4,1,1,38,0.02564102564102564,0.02564102564102564,0.9743589743589743,39,950,600,350,0.631578947368421,13,6,7,360.5851276210136,0.7837944219523167,0.1713400091364894,0.21891130276076026,132687.90486009675,1769.0570215485902,134456.96188164534,1329,0,501.71794871794873,36,3,13,33.13909534739678,0.6472800925925926,42.42680180180181,1030.292792792794,28.61924424424428,0
1338,4,0,0,38,0.0,0.0,1.0,38,950,800,150,0.8421052631578947,11,8,3,378.9635470613785,0.7743006164058795,0.19461515059324586,0.2292331945511135,132551.1975623582,2541.443972585369,135092.64153494357,1330,13,515.921052631579,34,4,20,32.80346820809247,0.6501225490196079,42.5595238095238,1029.7619047619041,30.28711484593836,5
1339,4,1,1,38,0.02564102564102564,0.02564102564102564,0.9743589743589743,39,850,700,150,0.8235294117647058,10,7,3,374.3760182262858,0.7816576698155646,0.19072294047033012,0.22823868544432094,132845.06715374233,2146.801456404324,134991.86861014666,1331,0,503.6666666666667,35,4,18,32.625673627484,0.6508928571428572,42.27430555555556,1030.902777777778,29.454365079365086,0
1340,4,0,0,38,0.0,0.0,1.0,38,550,400,150,0.7272727272727273,7,4,3,383.14141720573707,0.7733819345661451,0.2009638480951077,0.23270799760811622,132704.48022959183,2568.916524943308,135273.39675453515,1332,15,517.921052631579,34,4,18,32.541401887155786,0.6516544117647058,42.410714285714285,1030.357142857143,30.304621848739497,0
1341,4,0,0,38,0.0,0.0,1.0,38,950,700,250,0.7368421052631579,12,7,5,382.97879947221577,0.772226173541963,0.207790786738155,0.23318076271662763,132796.49234693876,2571.648242630381,135368.14058956914,1333,16,518.921052631579,34,4,18,32.452885577885574,0.6525735294117647,42.32142857142857,1030.7142857142856,30.31512605042016,0
1342,4,0,0,38,0.0,0.0,1.0,38,1050,1000,50,0.9523809523809523,11,10,1,383.93397734385616,0.7721076339497392,0.21447581086171907,0.23453005019411025,132919.2247732427,2606.4413265306193,135525.6660997733,1334,17,519.921052631579,34,4,18,32.30465442930809,0.6537990196078431,42.202380952380956,1031.1904761904766,30.329131652661076,0
1343,4,0,0,38,0.0,0.0,1.0,38,1100,800,300,0.7272727272727273,14,8,6,384.0269091960109,0.7712185870080607,0.21802862419205882,0.234972396982644,132980.612244898,2613.6267006802777,135594.23894557825,1335,18,520.921052631579,34,4,18,32.240448984302866,0.6544117647058822,42.142857142857146,1031.4285714285718,30.336134453781522,0
1344,4,0,0,38,0.0,0.0,1.0,38,1000,700,300,0.7,13,7,6,380.0576311285453,0.7712185870080607,0.20173863743739973,0.23262868191054908,132994.2558299039,2509.096364883394,135503.3521947873,1336,19,521.921052631579,35,3,18,32.32906941950928,0.6523809523809524,42.129629629629626,1031.4814814814808,29.470899470899454,1
1345,4,0,0,38,0.0,0.0,1.0,38,1050,800,250,0.7619047619047619,13,8,5,378.9485902659283,0.771633475580844,0.19987078990438456,0.23293519985159183,133152.40652392263,2491.58334855126,135643.9898724739,1337,20,522.921052631579,36,2,18,32.198581560283685,0.6519097222222222,41.976351351351354,1032.094594594595,28.669294294294307,0
1346,4,0,0,38,0.0,0.0,1.0,38,1200,800,400,0.6666666666666666,16,8,8,378.0280471781316,0.7700331910858227,0.20137362164272066,0.233096110596926,133268.65875588427,2475.8581639071513,135744.51691979144,1338,21,523.921052631579,36,2,18,32.10546406369288,0.6530671296296295,41.86373873873874,1032.545045045045,28.681806806806808,0
1347,4,0,0,38,0.0,0.0,1.0,38,1250,800,450,0.64,17,8,9,381.6375289590858,0.7696479374110953,0.20924093924300502,0.23587462369358034,133355.8812190568,2578.7217961204306,135934.60301517724,1339,22,524.921052631579,36,2,18,31.924607501090257,0.6539351851851853,41.77927927927927,1032.882882882882,28.69119119119117,0
1348,4,0,0,38,0.0,0.0,1.0,38,900,600,300,0.6666666666666666,12,6,6,387.18725382672903,0.7681958274063537,0.21459987782528955,0.2402674505361469,133504.84206012142,2738.4775395742336,136243.31959969565,1340,23,525.921052631579,32,6,18,31.631541437589092,0.6643880208333334,41.63510101010101,1033.459595959596,32.29561237373738,0
1349,4,0,0,38,0.0,0.0,1.0,38,1050,500,550,0.47619047619047616,16,5,11,387.3213452935207,0.7685218112849692,0.2190883447172438,0.24162598166787738,133700.64478433333,2757.022720895831,136457.66750522915,1341,24,526.921052631579,32,6,18,31.43134741382818,0.6663411458333334,41.44570707070707,1034.2171717171723,32.319286616161634,0
1350,4,0,0,38,0.0,0.0,1.0,38,950,600,350,0.631578947368421,13,6,7,383.84527895626513,0.7675142247510669,0.2179386714283882,0.24009375692882712,133798.59995153546,2671.5921844709633,136470.19213600643,1342,25,527.921052631579,32,6,18,31.422890733056708,0.6673177083333334,41.3510101010101,1034.595959595959,32.331123737373716,0
1351,4,0,0,38,0.0,0.0,1.0,38,900,500,400,0.5555555555555556,13,5,8,383.5246276019691,0.7660621147463252,0.21530662694310565,0.24053185711196146,133896.59098880197,2670.52803923067,136567.11902803264,1343,26,528.921052631579,32,6,18,31.332855516245786,0.6682942708333335,41.25631313131312,1034.9747474747458,32.342960858585805,0
1352,4,0,0,38,0.0,0.0,1.0,38,900,500,400,0.5555555555555556,13,5,8,381.6022380035246,0.7651730678046468,0.21871670415532196,0.23965755423165575,133947.52206182707,2622.93483876393,136570.456900591,1344,27,529.921052631579,33,5,18,31.331513160490918,0.6663510101010102,41.20710784313725,1035.1715686274501,31.368835412953036,0
1353,4,0,0,38,0.0,0.0,1.0,38,1050,900,150,0.8571428571428571,12,9,3,378.84793235566156,0.7644914651493598,0.21947973381730246,0.23883891387639522,134088.01020408157,2559.7930839002233,136647.8032879818,1345,28,530.921052631579,34,4,18,31.26197318007663,0.6654411764705883,41.07142857142857,1035.714285714285,30.46218487394956,0
1354,4,0,0,38,0.0,0.0,1.0,38,1050,800,250,0.7619047619047619,13,8,5,380.1397303808931,0.7629504504504505,0.21940305727554144,0.24046048061303,134211.33786848068,2603.8123582766366,136815.1502267573,1346,29,531.921052631579,34,4,18,31.10495174632353,0.6666666666666667,40.95238095238095,1036.190476190476,30.476190476190467,0
1355,4,0,0,38,0.0,0.0,1.0,38,1100,700,400,0.6363636363636364,15,7,8,380.3239538802277,0.7615872451398767,0.21994076302860788,0.24123097244697705,134310.72638031538,2616.3173010973783,136927.04368141276,1347,30,532.921052631579,35,3,18,31.00063272294178,0.6654761904761906,40.856481481481474,1036.574074074073,29.616402116402085,0
1356,4,0,0,38,0.0,0.0,1.0,38,850,600,250,0.7058823529411765,11,6,5,380.3239538802277,0.7615872451398767,0.21994076302860788,0.24123097244697705,134310.72638031538,2616.3173010973783,136927.04368141276,1348,31,533.921052631579,35,3,18,31.00063272294178,0.6654761904761906,40.856481481481474,1036.574074074073,29.616402116402085,0
1357,4,0,0,38,0.0,0.0,1.0,38,1150,800,350,0.6956521739130435,15,8,7,379.34470663265313,0.7593646277856805,0.22384868421052628,0.24140117694805194,134430.7270233196,2599.1169410150887,137029.8439643347,1349,32,534.921052631579,35,3,18,30.90587797619048,0.6666666666666666,40.74074074074074,1037.037037037037,29.629629629629626,0
1358,4,0,0,38,0.0,0.0,1.0,38,600,500,100,0.8333333333333334,7,5,2,379.34470663265313,0.7593646277856805,0.22384868421052628,0.24140117694805194,134430.7270233196,2599.1169410150887,137029.8439643347,1350,33,535.921052631579,35,3,18,30.90587797619048,0.6666666666666666,40.74074074074074,1037.037037037037,29.629629629629626,0
1359,4,0,0,38,0.0,0.0,1.0,38,1200,900,300,0.75,15,9,6,380.8003096724249,0.7582088667614983,0.22141196364404991,0.24312635156008633,134550.78124999977,2647.4494170095727,137198.23066700934,1351,34,536.921052631579,34,4,18,30.747991967871492,0.6700367647058825,40.624999999999986,1037.4999999999982,30.51470588235289,0
1360,4,1,1,38,0.02564102564102564,0.02564102564102564,0.9743589743589743,39,950,700,250,0.7368421052631579,12,7,5,368.8266750550489,0.7616396761133604,0.1981351981351982,0.23782961460446236,134911.26543209865,2151.774691358012,137063.04012345665,1352,0,524.1282051282051,35,4,16,30.69852941176471,0.6714285714285715,40.27777777777777,1038.888888888888,29.68253968253966,0
1361,4,0,0,38,0.0,0.0,1.0,38,700,500,200,0.7142857142857143,9,5,4,379.78363848845885,0.7562233285917497,0.20705736142281395,0.24433867715142435,134828.82653061222,2641.1564625850283,137469.98299319725,1353,36,538.921052631579,34,4,16,30.49633195781751,0.6727941176470589,40.357142857142854,1038.5714285714282,30.54621848739495,0
1362,4,0,0,38,0.0,0.0,1.0,38,1050,900,150,0.8571428571428571,12,9,3,380.4807961313339,0.7562233285917497,0.20983284287712878,0.24562399324218054,134952.49433106568,2669.366496598631,137621.86082766432,1354,37,539.921052631579,34,4,17,30.354653605255113,0.6740196078431373,40.238095238095234,1039.0476190476184,30.560224089635835,0
1363,4,0,0,38,0.0,0.0,1.0,38,650,300,350,0.46153846153846156,10,3,7,380.1332388147038,0.7556602655286866,0.2361000689033761,0.23740396612767367,133741.45507812512,2567.914496527792,136309.3695746529,1355,38,540.921052631579,35,3,14,31.576242027526018,0.6598214285714286,41.40625000000001,1034.375000000001,29.553571428571455,2
1364,4,0,0,38,0.0,0.0,1.0,38,1200,900,300,0.75,15,9,6,374.9906759921049,0.7542674253200569,0.23445216889668563,0.23495386363317503,133861.2011986667,2439.34046532063,136300.54166398733,1356,39,541.921052631579,35,3,14,31.589144577414903,0.6610119047619047,41.29050925925925,1034.837962962962,29.56679894179891,0
1365,4,0,0,38,0.0,0.0,1.0,38,700,500,200,0.7142857142857143,9,5,4,374.2827563915887,0.7534672830725463,0.231734299971754,0.23508321440775057,133951.04595336074,2427.1133401920406,136378.15929355277,1357,40,542.921052631579,35,3,15,31.517404591532497,0.6619047619047619,41.2037037037037,1035.185185185185,29.576719576719572,0
1366,4,0,0,38,0.0,0.0,1.0,38,950,500,450,0.5263157894736842,14,5,9,372.9013922569625,0.7526967757230916,0.23048819231176565,0.2345974581667219,134010.9592013888,2394.574652777768,136405.53385416657,1358,41,543.921052631579,35,3,15,31.493125419181755,0.6625,41.14583333333333,1035.4166666666658,29.58333333333331,0
1367,4,0,0,38,0.0,0.0,1.0,38,1000,600,400,0.6,14,6,8,369.93861276355835,0.7523707918444761,0.21869652905585402,0.2336852874274247,134160.80092860496,2326.2521165551934,136487.05304516017,1359,42,544.921052631579,35,3,16,31.419790153800307,0.6639880952380952,41.0011574074074,1035.995370370369,29.59986772486769,0
1368,4,0,0,38,0.0,0.0,1.0,38,650,500,150,0.7692307692307693,8,5,3,368.7553387161813,0.7531412991939308,0.21216352060761778,0.23331919063787762,134220.76106234983,2298.924441658081,136519.6855040079,1360,43,545.921052631579,35,3,16,31.390432443501247,0.6645833333333333,40.94328703703703,1036.2268518518508,29.606481481481453,0
1369,4,0,0,38,0.0,0.0,1.0,38,800,600,200,0.75,10,6,4,369.6599383896781,0.7526375059269796,0.2141110928280956,0.23446702607775888,134310.72638031546,2329.8589677640593,136640.58534807953,1361,44,546.921052631579,35,3,16,31.276983772517493,0.6654761904761904,40.85648148148148,1036.5740740740737,29.616402116402107,0
1370,4,0,0,38,0.0,0.0,1.0,38,800,500,300,0.625,11,5,6,366.60504020492147,0.7508890469416786,0.21796076864781622,0.2331025234347688,134400.72183909902,2254.396406678679,136655.1182457777,1362,45,547.921052631579,35,3,16,31.266161587974853,0.6663690476190476,40.76967592592593,1036.921296296297,29.62632275132277,0
1371,4,0,0,38,0.0,0.0,1.0,38,900,600,300,0.6666666666666666,12,6,6,365.5114876439306,0.7500889046941679,0.22249550935111606,0.2337500711993924,134610.82845721883,2240.3608324760016,136851.18928969483,1363,46,548.921052631579,35,3,19,31.084560190348736,0.6684523809523808,40.56712962962963,1037.7314814814818,29.649470899470906,0
1372,4,0,0,38,0.0,0.0,1.0,38,650,300,350,0.46153846153846156,10,3,7,366.2397229677099,0.7498221906116643,0.2197619341092778,0.23440910748404403,134640.85708429792,2262.1660397376654,136903.0231240356,1364,47,549.921052631579,35,3,19,31.0356724657076,0.66875,40.53819444444445,1037.8472222222229,29.652777777777796,0
1373,4,0,0,38,0.0,0.0,1.0,38,750,600,150,0.8,9,6,3,367.4008120714533,0.7485478899952585,0.21959162119345166,0.23573571418318576,134730.96305941365,2300.0530478395144,137031.01610725318,1365,48,550.921052631579,35,3,20,30.91555183946488,0.6696428571428571,40.45138888888889,1038.194444444445,29.66269841269843,0
1374,4,0,0,38,0.0,0.0,1.0,38,700,500,200,0.7142857142857143,9,5,4,365.55199522008235,0.7489035087719298,0.2164511814534107,0.23493785824603014,134791.05045438968,2254.6274862825944,137045.67794067226,1366,49,551.921052631579,35,3,15,30.903551790756435,0.6702380952380952,40.393518518518526,1038.4259259259268,29.669312169312192,0
1375,4,0,0,38,0.0,0.0,1.0,38,1050,700,350,0.6666666666666666,14,7,7,364.9653866745291,0.7477477477477478,0.21015980061574524,0.2351446048387581,134881.20666420192,2245.3943490655124,137126.60101326744,1367,50,552.921052631579,35,3,15,30.828806870937786,0.6711309523809523,40.30671296296297,1038.773148148149,29.67923280423283,0
1376,4,0,0,38,0.0,0.0,1.0,38,800,600,200,0.75,10,6,4,365.9312533958649,0.7471846846846847,0.20743034055727527,0.23596256684491979,134911.26543209876,2273.649691358026,137184.9151234568,1368,51,553.921052631579,35,3,15,30.77372994652406,0.6714285714285714,40.27777777777778,1038.888888888889,29.682539682539684,0
1377,4,0,0,38,0.0,0.0,1.0,38,700,500,200,0.7142857142857143,9,5,4,366.5658561867082,0.7476292081555239,0.20828960560027676,0.23656805830252206,134941.32754897565,2292.976653592269,137234.30420256793,1369,52,554.921052631579,35,3,15,30.72725205153911,0.6717261904761904,40.2488425925926,1039.004629629631,29.6858465608466,0
1378,4,0,0,38,0.0,0.0,1.0,38,750,400,350,0.5333333333333333,11,4,7,366.8421550272831,0.7475106685633002,0.20409903810645846,0.23714007991288538,135001.46182966832,2304.845437885815,137306.30726755413,1370,53,555.921052631579,35,3,15,30.6600818576679,0.6723214285714285,40.19097222222223,1039.236111111112,29.69246031746034,0
1379,4,0,0,38,0.0,0.0,1.0,38,750,600,150,0.8,9,6,3,369.59690924936024,0.7479551920341394,0.20372323594557495,0.23951799703302712,135091.68836805565,2385.8940972222317,137477.58246527787,1371,54,556.921052631579,35,3,15,30.498496993987974,0.6732142857142855,40.10416666666667,1039.5833333333342,29.702380952380977,0
1380,4,0,0,38,0.0,0.0,1.0,38,1050,800,250,0.7619047619047619,13,8,5,368.49521341591554,0.7486664295874822,0.20881567230632236,0.23920238420004228,135151.85613854593,2360.56241426612,137512.41855281204,1372,55,557.921052631579,35,3,16,30.467126743840915,0.6738095238095239,40.0462962962963,1039.8148148148148,29.70899470899471,0
1381,4,0,1,37,0.0,0.02631578947368421,0.9736842105263158,38,650,300,350,0.46153846153846156,10,3,7,365.9734065138091,0.7483997155049786,0.20000527077123098,0.2381609706256048,135242.13291162977,2299.0048171724957,137541.13772880228,1373,56,558.921052631579,35,3,16,30.44269964022106,0.6747023809523809,39.95949074074074,1040.162037037037,29.71891534391534,0
1382,4,0,1,36,0.0,0.02702702702702703,0.972972972972973,37,1150,800,350,0.6956521739130435,15,8,7,365.7425610215636,0.7458083083083084,0.19199980211306156,0.23875696235171665,135354.80619331062,2501.0026927437602,137855.80888605438,1374,57,553.1891891891892,34,3,16,30.336441291995577,0.6780024509803921,39.851190476190474,1040.5952380952378,30.60574229691876,0
1383,4,0,0,36,0.0,0.0,1.0,36,1000,800,200,0.8,12,8,4,364.8917092077676,0.7424933862433863,0.1823190726759707,0.23840682525368484,135385.77806122444,2680.229591836731,138066.00765306118,1375,58,540.1388888888889,34,2,16,30.327728208647912,0.6783088235294117,39.82142857142857,1040.7142857142853,30.60924369747898,0
1384,4,0,0,36,0.0,0.0,1.0,36,900,600,300,0.6666666666666666,12,6,6,368.05153054869896,0.740707671957672,0.1878692586239763,0.24109442956167568,135478.71492346932,2772.629676870743,138251.34460034006,1376,59,541.1388888888889,34,2,17,30.152944539736993,0.6792279411764706,39.732142857142854,1041.071428571428,30.61974789915965,0
1385,4,0,0,36,0.0,0.0,1.0,36,1150,700,450,0.6086956521739131,16,7,9,366.3200618695207,0.7412698412698413,0.18163516740334273,0.24058317576836086,135571.68367346935,2732.5255102040733,138304.20918367343,1377,60,542.1388888888889,34,2,18,30.105452674897112,0.6801470588235294,39.64285714285714,1041.428571428571,30.630252100840327,0
1386,4,0,0,36,0.0,0.0,1.0,36,550,300,250,0.5454545454545454,8,3,5,365.7600000000002,0.7412698412698413,0.1824444444444453,0.24063157894736842,135633.68055555542,2721.87499999999,138355.55555555542,1378,61,543.1388888888889,34,2,18,30.058333333333348,0.6807598039215688,39.58333333333333,1041.6666666666656,30.637254901960752,0
1387,4,0,0,36,0.0,0.0,1.0,36,750,500,250,0.6666666666666666,10,5,5,369.00105778903713,0.7400462962962964,0.18525289457647776,0.24318503447060633,135695.69160997725,2814.3707482993095,138510.06235827657,1379,62,544.1388888888889,34,2,18,29.912210542352224,0.6813725490196079,39.52380952380952,1041.9047619047612,30.644257703081212,0
1388,4,0,0,36,0.0,0.0,1.0,36,1250,900,350,0.72,16,9,7,370.5680589500098,0.7388558201058202,0.1864245469773107,0.24506751693098824,135819.75623582755,2866.092687074816,138685.84892290237,1380,63,545.1388888888889,34,2,19,29.747934749505102,0.6825980392156863,39.4047619047619,1042.3809523809516,30.658263305322105,0
1389,4,0,0,36,0.0,0.0,1.0,36,550,400,150,0.7272727272727273,7,4,3,370.5680589500098,0.7384920634920635,0.1864245469773107,0.24506751693098824,135819.75623582755,2866.092687074816,138685.84892290237,1381,64,546.1388888888889,34,2,19,29.747934749505102,0.6825980392156863,39.4047619047619,1042.3809523809516,30.658263305322105,0
1390,4,0,0,36,0.0,0.0,1.0,36,850,600,250,0.7058823529411765,11,6,5,383.5974425774731,0.7383597883597884,0.16833140410490044,0.23763874877786956,133442.324205354,3037.626859353558,136479.95106470757,1382,65,547.1388888888889,35,1,18,31.787111198237547,0.6568452380952381,41.69560185185185,1033.217592592592,29.520502645502628,5
1391,4,0,0,36,0.0,0.0,1.0,36,400,200,200,0.5,6,2,4,386.96670135275747,0.737665343915344,0.17159498207885315,0.23991935483870971,133472.22222222228,3129.8644600908865,136602.08668231315,1383,66,548.1388888888889,34,2,18,31.670026881720432,0.6593137254901961,41.66666666666667,1033.333333333334,30.392156862745114,0
1392,4,0,0,36,0.0,0.0,1.0,36,1000,600,400,0.6,14,6,8,400.66863152246077,0.7373015873015873,0.1554810072906836,0.23567207051824396,131489.9488094327,3354.1406807978774,134844.08949023057,1384,67,549.1388888888889,32,4,18,33.31871435019902,0.6442057291666667,43.592171717171716,1025.6313131313132,32.050978535353536,6
1393,4,2,2,36,0.05263157894736842,0.05263157894736842,0.9473684210526316,38,1150,600,550,0.5217391304347826,17,6,11,384.31120128786927,0.7617650545282124,0.14109567327330264,0.22928532140415864,132030.69905045346,2548.1753117913822,134578.87436224485,1385,0,521.1842105263158,34,4,16,33.19119464071972,0.6449142156862745,43.06547619047619,1027.738095238095,30.22759103641456,0
1394,4,1,0,37,0.02702702702702703,0.0,1.0,37,500,400,100,0.8,6,4,2,390.17059693224394,0.7510635635635635,0.15228200658032565,0.2329082417416889,132051.39136690213,2904.5140390715146,134955.90540597364,1386,0,536.2432432432432,33,4,18,33.019727951989196,0.6474116161616161,43.0453431372549,1027.8186274509803,31.14601901366607,0
1395,4,0,0,37,0.0,0.0,1.0,37,850,700,150,0.8235294117647058,10,7,3,391.98073426904875,0.7516266266266266,0.15457822824612721,0.23437821666308267,132114.37795859764,2957.258175941947,135071.63613453959,1387,1,537.2432432432432,33,4,19,32.90953927762546,0.6480429292929293,42.98406862745098,1028.063725490196,31.153446226975635,0
1396,4,0,1,36,0.0,0.02702702702702703,0.972972972972973,37,1050,800,250,0.7619047619047619,13,8,5,364.02397027404743,0.7516266266266266,0.07678818422711453,0.20468147042071494,129745.78622118726,2046.115245312863,131791.90146650013,1388,2,538.2432432432432,36,1,16,36.026675509376936,0.6177662037037038,45.298423423423415,1018.806306306305,28.30017517517514,5
1397,4,1,1,36,0.02702702702702703,0.02702702702702703,0.972972972972973,37,1000,600,400,0.6,14,6,8,368.4754246593471,0.7565065065065065,0.09114493926158551,0.2080978178066793,129917.93894823876,2174.3135449638794,132092.25249320263,1389,0,539.1621621621622,36,1,16,35.73815309842042,0.6195023148148149,45.1295045045045,1019.4819819819818,28.31894394394394,0
1398,4,0,0,36,0.0,0.0,1.0,36,1000,800,200,0.8,12,8,4,376.5039457011304,0.7395833333333334,0.09537605089752321,0.21162118327339388,129731.44531249988,2568.8802083333185,132300.3255208332,1390,73,555.1388888888889,35,1,16,35.72341513292433,0.6196428571428572,45.31249999999999,1018.7499999999991,29.107142857142833,0
1399,4,0,0,36,0.0,0.0,1.0,36,1050,900,150,0.8571428571428571,12,9,3,375.63704944850906,0.741468253968254,0.08511222133908625,0.21193052495150644,129878.87577428392,2557.4635363082743,132436.3393105922,1391,74,556.1388888888889,35,1,16,35.595383407138264,0.6211309523809525,45.16782407407406,1019.3287037037021,29.123677248677204,0
1400,4,0,0,36,0.0,0.0,1.0,36,850,700,150,0.8235294117647058,10,7,3,377.3106534465869,0.7400793650793651,0.07550221314266281,0.21351857209491798,129996.88042534703,2609.841579861087,132606.7220052081,1392,75,557.1388888888889,35,1,17,35.43262683009874,0.6223214285714287,45.05208333333332,1019.791666666665,29.136904761904717,0
1401,4,1,0,37,0.02702702702702703,0.0,1.0,37,1000,900,100,0.9,11,9,2,372.2728014922934,0.7464964964964965,0.07888175090747462,0.2122847583121781,130294.81207274775,2302.1280114911897,132596.94008423894,1393,0,543.0540540540541,32,5,18,35.25821378514305,0.6321614583333333,44.76010101010102,1020.9595959595965,31.90498737373739,0
1402,4,0,0,37,0.0,0.0,1.0,37,800,600,200,0.75,10,6,4,369.3026372145087,0.7484359359359359,0.07837643258809557,0.21109521114854018,130387.71896626301,2230.505694925034,132618.22466118805,1394,1,544.0540540540541,33,4,18,35.23968082553396,0.6306818181818181,44.669117647058826,1021.3235294117651,30.949197860962578,0
1403,4,0,0,37,0.0,0.0,1.0,37,1200,800,400,0.6666666666666666,16,8,8,372.2960508249417,0.7498748748748749,0.08364339181949254,0.21395809185963507,130597.00255102031,2324.1496598639333,132921.15221088423,1395,2,545.0540540540541,34,3,16,34.950791986955515,0.630514705882353,44.46428571428571,1022.1428571428564,30.063025210084014,0
1404,4,1,0,38,0.02631578947368421,0.0,1.0,38,900,500,400,0.5555555555555556,13,5,8,364.2522008276641,0.7587422949265055,0.07801293916687002,0.2112185056996085,130942.84664619755,1939.2440147033408,132882.0906609009,1396,0,531.6842105263158,35,3,18,34.80589637754909,0.6318452380952382,44.1261574074074,1023.4953703703691,29.24272486772483,0
1405,4,0,0,38,0.0,0.0,1.0,38,800,600,200,0.75,10,6,4,362.43705983426014,0.7591275486012328,0.07352652405462479,0.2104895465682225,131002.08340031283,1896.001987954377,132898.0853882672,1397,1,532.6842105263158,35,3,19,34.79237328057282,0.6324404761904763,44.06828703703703,1023.726851851851,29.249338624338602,0
1406,4,0,0,38,0.0,0.0,1.0,38,1200,900,300,0.75,15,9,6,359.0214580967142,0.7591868183973447,0.06494776179842887,0.20965194003619414,131212.72243527303,1821.6365859102257,133034.35902118325,1398,2,533.6842105263158,36,2,19,34.66673078332234,0.6325231481481481,43.86261261261261,1024.5495495495488,28.45970970970969,0
1407,4,0,0,38,0.0,0.0,1.0,38,950,800,150,0.8421052631578947,11,8,3,358.252363011435,0.7595424371740161,0.0575524176294393,0.20983352690669765,131328.125,1809.7729486243002,133137.8979486243,1399,3,534.6842105263158,35,3,19,34.56978319783198,0.6357142857142857,43.75,1025.0,29.285714285714285,0
1408,4,0,0,38,0.0,0.0,1.0,38,950,600,350,0.631578947368421,13,6,7,356.85005095881945,0.7594535324798483,0.059150386970699076,0.2098240412439351,131476.45968632132,1783.4762677898002,133259.93595411113,1400,4,535.6842105263158,35,3,19,34.45587875710041,0.6372023809523808,43.60532407407408,1025.578703703705,29.302248677248716,0
1409,4,0,0,38,0.0,0.0,1.0,38,400,0,400,0.0,8,0,8,358.66577790529567,0.7596313418681839,0.05491487378041193,0.211219587347152,131535.8170037081,1835.4792256087235,133371.29622931682,1401,5,536.6842105263158,35,3,19,34.349378502388205,0.6377976190476189,43.54745370370371,1025.810185185186,29.308862433862455,0
1410,4,0,0,38,0.0,0.0,1.0,38,750,400,350,0.5333333333333333,11,4,7,359.7238332312423,0.7591275486012328,0.05814174425232754,0.21200745064905152,131565.5006858712,1865.4492455418545,133430.94993141305,1402,6,537.6842105263158,35,3,15,34.292268351383875,0.638095238095238,43.518518518518526,1025.925925925927,29.312169312169342,0
1411,4,0,1,37,0.0,0.02631578947368421,0.9736842105263158,38,1300,900,400,0.6923076923076923,17,9,8,361.5499129313833,0.7595424371740161,0.0629228687415424,0.2137483085250339,131684.268904321,1922.0871913580268,133606.35609567905,1403,7,538.6842105263158,35,3,15,34.125507442489855,0.6392857142857142,43.40277777777778,1026.3888888888891,29.325396825396833,0
1412,4,1,0,38,0.02631578947368421,0.0,1.0,38,850,700,150,0.8235294117647058,10,7,3,353.5707840208678,0.7628319108582267,0.07241745310228631,0.21057309617535258,131963.74584043512,1731.7050158266456,133695.45085626177,1404,0,531.1842105263158,36,2,18,34.048480198743235,0.6400462962962963,43.130630630630634,1027.4774774774783,28.541041041041062,0
1413,4,0,1,37,0.0,0.02631578947368421,0.9736842105263158,38,850,600,250,0.7058823529411765,11,6,5,354.54209647975534,0.7625355618776671,0.07432783141285104,0.21147393284145424,132021.6056428051,1761.4433690447327,133783.04901184983,1405,1,532.1842105263158,36,2,18,33.965227554971136,0.640625,43.07432432432433,1027.7027027027038,28.54729729729733,0
1414,4,0,1,36,0.0,0.02702702702702703,0.972972972972973,37,950,700,250,0.7368421052631579,12,7,5,361.0033351905874,0.7576326326326326,0.07049311081750842,0.21509983958537118,131981.42387902932,2129.1468407064294,134110.57071973576,1406,2,544.2972972972973,35,2,18,33.83973492528347,0.6422619047619048,43.11342592592592,1027.546296296295,29.35846560846557,0
1415,4,0,0,36,0.0,0.0,1.0,36,750,300,450,0.4,12,3,9,369.9329832535465,0.7503968253968254,0.06710521231791722,0.21964293506733246,131847.23816609953,2554.9284297051904,134402.1665958047,1407,3,560.0555555555555,34,2,18,33.74579807580851,0.643075980392157,43.244047619047606,1027.0238095238076,30.206582633053163,0
1416,4,0,1,35,0.0,0.027777777777777776,0.9722222222222222,36,900,500,400,0.5555555555555556,13,5,8,370.66296828914784,0.7492394179894181,0.06575784888087743,0.22050968542456262,131921.96609224955,2579.7175068587003,134501.68359910825,1408,4,561.0555555555555,35,1,18,33.6516073306294,0.6416666666666667,43.17129629629629,1027.314814814814,29.35185185185183,0
1417,4,1,0,36,0.027777777777777776,0.0,1.0,36,500,300,200,0.6,7,3,4,389.6047787391741,0.7480489417989419,0.0664311286979462,0.2262675159519365,131002.08340031281,3007.8075435099317,134009.89094382274,1409,0,561.6944444444445,35,1,18,34.09706519690974,0.6324404761904763,44.06828703703703,1023.7268518518509,29.2493386243386,3
1418,4,3,2,37,0.07692307692307693,0.05128205128205128,0.9487179487179487,39,1050,700,350,0.6666666666666666,14,7,7,368.6851830585043,0.7772154745838956,0.08383226800240595,0.21924030246803652,131905.89871966577,1927.160536294882,133833.05925596066,1410,0,519.4102564102565,36,3,18,33.71861982021486,0.6394675925925926,43.186936936936945,1027.2522522522536,28.534784784784822,0
1419,4,0,0,37,0.0,0.0,1.0,37,1100,800,300,0.7272727272727273,14,8,6,387.8370594473539,0.7628253253253253,0.09349720950649032,0.22898325016686277,131633.36167800473,2810.4591836734908,134443.82086167822,1411,1,548.3243243243244,34,3,18,33.5025135344161,0.6409313725490196,43.45238095238096,1026.1904761904777,30.182072829131698,0
1420,4,0,0,37,0.0,0.0,1.0,37,1000,800,200,0.8,12,8,4,386.59930674703935,0.7628878878878879,0.08982189225761616,0.22855751014884984,131684.26890432113,2781.8094135802626,134466.07831790138,1412,2,549.3243243243244,35,2,18,33.48274695534507,0.6392857142857142,43.402777777777786,1026.38888888889,29.325396825396858,0
1421,4,0,0,37,0.0,0.0,1.0,37,750,400,350,0.5333333333333333,11,4,7,393.1642230638287,0.762012012012012,0.0903500141638316,0.233347568645174,131832.8045294282,2966.3884334276468,134799.19296285583,1413,3,550.3243243243244,35,2,19,33.163928960516934,0.6407738095238094,43.258101851851855,1026.9675925925928,29.341931216931226,0
1422,4,0,0,37,0.0,0.0,1.0,37,750,600,150,0.8,9,6,3,392.3771938892283,0.7606981981981982,0.08408949733870896,0.2334276121287397,131921.9660922499,2952.6341735254073,134874.6002657753,1414,4,551.3243243243244,35,2,19,33.093923689349566,0.6416666666666665,43.17129629629631,1027.3148148148168,29.351851851851908,0
1423,4,0,0,37,0.0,0.0,1.0,37,800,700,100,0.875,9,7,2,394.79447126622205,0.7611986986986987,0.08747637151736698,0.23541840902436467,132011.1577958893,3023.4550486540056,135034.6128445433,1415,5,552.3243243243244,35,2,19,32.94160847693059,0.6425595238095236,43.084490740740755,1027.662037037039,29.361772486772544,0
1424,4,1,1,37,0.02631578947368421,0.02631578947368421,0.9736842105263158,38,1350,1100,250,0.8148148148148148,16,11,5,394.47812010686846,0.7726114272166904,0.09811777063917626,0.23253163058009527,131572.2859977324,2782.1755404515156,134354.4615381839,1416,0,538.7631578947369,34,4,20,33.39401059797322,0.6403186274509804,43.51190476190476,1025.9523809523807,30.1750700280112,1
1425,4,0,0,37,0.0,0.0,1.0,37,550,300,250,0.5454545454545454,8,3,5,403.7878437587585,0.7597597597597597,0.10214517134560142,0.2370872202617215,131422.3514543684,3213.349583093024,134635.70103746143,1417,7,554.3243243243244,33,4,22,33.307313453647254,0.6410984848484849,43.65808823529411,1025.3676470588227,31.071746880570387,0
1426,4,0,0,37,0.0,0.0,1.0,37,1050,800,250,0.7619047619047619,13,8,5,400.4260370961114,0.7592592592592593,0.09585702680747388,0.2358490199355564,131541.75347222213,3134.548611111107,134676.30208333323,1418,8,555.3243243243244,34,3,22,33.272407256972656,0.6400122549019608,43.541666666666664,1025.8333333333328,30.171568627450966,0
1427,4,2,1,38,0.05128205128205128,0.02564102564102564,0.9743589743589743,39,650,400,250,0.6153846153846154,9,4,5,385.21316918356524,0.7735042735042735,0.10871390501222922,0.2306479637911565,132166.31063073222,2382.440675472787,134548.751306205,1419,0,527.7948717948718,36,3,22,33.03102069871865,0.6420717592592593,42.933558558558566,1028.265765765767,28.56293793793797,0
1428,4,0,0,38,0.0,0.0,1.0,38,1050,800,250,0.7619047619047619,13,8,5,395.0974893665671,0.7622392128971076,0.12553090661374866,0.2367121505746423,132189.63162562152,2845.558315114877,135035.1899407364,1420,1,542.6842105263158,35,3,22,32.75335302945037,0.6443452380952381,42.910879629629626,1028.356481481481,29.381613756613746,0
1429,4,0,0,38,0.0,0.0,1.0,38,1000,700,300,0.7,13,7,6,396.76422406634396,0.7625948316737791,0.12753400887162214,0.23808532473177557,132249.14969403707,2894.3462523576677,135143.49594639475,1421,2,543.6842105263158,35,3,22,32.65033663403472,0.6449404761904762,42.85300925925925,1028.587962962962,29.388227513227484,0
1430,4,0,0,38,0.0,0.0,1.0,38,1250,800,450,0.64,17,8,9,384.13793109986216,0.7615872451398767,0.1134736352110346,0.22198367464298016,130810.03578514737,2449.9867517094253,133260.0225368568,1422,3,544.6842105263158,34,4,18,34.43185344660382,0.6326593137254901,44.25595238095238,1022.9761904761903,30.087535014005596,8
1431,4,1,0,39,0.02564102564102564,0.0,1.0,39,850,600,250,0.7058823529411765,11,6,5,374.37992341625005,0.7720985155195682,0.11603375527426185,0.21792852384124856,131090.9636488339,2015.5649862825628,133106.52863511644,1423,0,531.6923076923077,35,4,19,34.39666214587099,0.6333333333333333,43.981481481481474,1024.074074074073,29.259259259259228,0
1432,4,0,0,39,0.0,0.0,1.0,39,950,600,350,0.631578947368421,13,6,7,378.4542039272835,0.7690058479532164,0.11922179168621416,0.2213232180694962,131268.8145683301,2135.8469435871275,133404.66151191722,1424,1,532.6923076923077,35,4,19,34.11217152322866,0.6351190476190476,43.80787037037038,1024.76851851852,29.279100529100575,0
1433,4,1,1,39,0.025,0.025,0.975,40,1050,700,350,0.6666666666666666,14,7,7,367.28770148955334,0.7762820512820513,0.12012676983865678,0.21659276687840273,131587.9662390432,1666.1283327246308,133254.0945717678,1425,0,520.35,36,4,17,34.07556799473165,0.6362847222222221,43.49662162162163,1026.0135135135142,28.500375375375395,0
1434,4,0,0,39,0.0,0.0,1.0,39,800,600,200,0.75,10,6,4,375.0065542862827,0.7680499325236168,0.12397744075884232,0.22049987243070698,131476.45968632132,2060.9068233453554,133537.36650966667,1426,3,534.6923076923077,35,4,19,33.99035567844112,0.6372023809523808,43.60532407407408,1025.578703703705,29.302248677248716,0
1435,4,0,0,39,0.0,0.0,1.0,39,900,800,100,0.8888888888888888,10,8,2,376.9785587239724,0.7658007197480882,0.12850011857456023,0.22252276309232644,131624.87809713665,2123.951367455442,133748.8294645921,1427,4,535.6923076923077,35,4,18,33.78966463643885,0.6386904761904759,43.46064814814816,1026.1574074074088,29.31878306878311,0
1436,4,0,1,38,0.0,0.02564102564102564,0.9743589743589743,39,1150,600,550,0.5217391304347826,17,6,11,353.59616352713397,0.7656320287899235,0.044954421290215096,0.20326740825432507,130607.69120049098,1436.4757071260392,132044.166907617,1428,5,536.6923076923077,36,3,18,35.41781425581139,0.6264467592592593,44.453828828828826,1022.1846846846843,28.39401901901901,5
1437,4,0,0,38,0.0,0.0,1.0,38,1500,1200,300,0.8,18,12,6,357.68171283504574,0.7561344238975818,0.056718961978641236,0.20576898536860236,130636.47050766984,1745.2553059816605,132381.72581365152,1429,10,551.6842105263158,36,2,18,35.284249467577304,0.6267361111111112,44.42567567567568,1022.2972972972974,28.39714714714715,0
1438,4,0,0,38,0.0,0.0,1.0,38,1300,800,500,0.6153846153846154,18,8,10,376.0042035723683,0.7553046467520151,0.02479774885684094,0.20676594792190392,128868.76594387757,2104.6627501743305,130973.42869405191,1430,11,552.6842105263158,34,4,19,36.61625043967639,0.6130514705882353,46.160714285714285,1015.357142857143,29.863445378151265,8
1439,4,1,0,39,0.02564102564102564,0.0,1.0,39,950,600,350,0.631578947368421,13,6,7,373.2331783013619,0.7622019793072425,0.03273348723511482,0.207138172599759,129232.53864198845,1847.6316537644218,131080.17029575288,1431,0,539.4871794871794,33,6,20,36.315209312602946,0.6190025252525254,45.80269607843136,1016.7892156862728,30.811794414735537,0
1440,4,0,1,38,0.0,0.02564102564102564,0.9743589743589743,39,800,400,400,0.5,12,4,8,374.94194383921973,0.7606837606837608,0.02628845024617177,0.20400195858089176,128446.04768990936,1831.9621598639515,130278.00984977331,1432,1,540.4871794871794,34,5,15,37.075504012526906,0.6087622549019608,46.577380952380956,1013.6904761904767,29.814425770308137,2
1441,4,3,3,38,0.07317073170731707,0.07317073170731707,0.926829268292683,41,1050,800,250,0.7619047619047619,13,8,5,358.8647174558322,0.78125,0.02966957446752483,0.1977491896367262,128950.68825263518,1055.1704611033877,130005.85871373858,1433,0,515.0243902439024,37,4,15,36.96775252797869,0.6078265765765767,46.08004385964911,1015.6798245614015,27.450806069227067,0
1442,4,2,1,39,0.05,0.025,0.975,40,900,700,200,0.7777777777777778,11,7,4,364.82450983739767,0.7719017094017094,0.030396561286744728,0.20042004608069094,128829.56594685894,1400.0366498254969,130229.60259668445,1434,0,528.85,36,4,16,36.940053614346475,0.6085069444444444,46.19932432432432,1015.2027027027021,28.20007507507506,0
1443,4,0,0,39,0.0,0.0,1.0,39,600,500,100,0.8333333333333334,7,5,2,374.5324194656619,0.76259559154296,0.03150509047623218,0.20509217498160254,128701.77636584778,1840.5975383658956,130542.37390421367,1435,1,543.4102564102565,35,4,16,36.82428900041823,0.6092261904761905,46.325231481481474,1014.699074074073,28.991402116402085,0
1444,4,0,0,39,0.0,0.0,1.0,39,800,500,300,0.625,11,5,6,372.987549615335,0.7611898335582546,0.03065698551334628,0.20500293140512008,128848.62075617276,1811.7862654320866,130660.40702160486,1436,2,544.4102564102565,35,4,17,36.71340629274964,0.6107142857142858,46.18055555555555,1015.2777777777771,29.00793650793649,0
1445,4,0,0,39,0.0,0.0,1.0,39,900,900,0,1.0,9,9,0,378.71579820327077,0.7629329734592892,0.02968468784330236,0.20876946262763238,128966.15655006873,1968.304183813461,130934.4607338822,1437,3,545.4102564102565,35,4,17,36.447888179884536,0.6119047619047618,46.064814814814824,1015.7407407407419,29.021164021164054,0
1446,4,0,0,39,0.0,0.0,1.0,39,1100,800,300,0.7272727272727273,14,8,6,376.47246806508565,0.7624269005847953,0.03056592530276747,0.20784121538838524,129024.94454089529,1914.8678626543467,130939.81240354963,1438,4,546.4102564102565,35,4,17,36.44480519480519,0.6124999999999998,46.00694444444446,1015.9722222222241,29.027777777777832,0
1447,4,2,2,39,0.04878048780487805,0.04878048780487805,0.9512195121951219,41,800,500,300,0.625,11,5,6,356.6609403877611,0.7814532520325204,0.02422387116094904,0.19956677046124385,129554.63927469165,1041.6570216049734,130596.29629629663,1439,0,520.7073170731708,35,6,16,36.40859481582538,0.6178571428571427,45.48611111111113,1018.055555555558,29.08730158730166,0
1448,4,3,3,39,0.07142857142857142,0.07142857142857142,0.9285714285714286,42,1100,900,200,0.8181818181818182,13,9,4,345.9346977287066,0.7892953929539296,0.027415785591345054,0.1951340382333775,129871.11418898143,585.3849261311412,130456.49911511257,1440,0,509.23809523809524,37,5,17,36.36017283419392,0.617117117117117,45.17543859649124,1019.2982456140368,27.548601232811805,0
1449,4,2,2,39,0.04878048780487805,0.04878048780487805,0.9512195121951219,41,800,500,300,0.625,11,5,6,349.4794773962303,0.7864837398373984,0.04778389719381071,0.19769824451246645,129982.9033933521,885.2714296706998,130868.1748230228,1441,0,521.8780487804878,37,4,18,36.15636200716847,0.6182432432432431,45.06578947368423,1019.7368421052655,27.560455192034205,0
1450,4,2,2,39,0.04878048780487805,0.04878048780487805,0.9512195121951219,41,1200,1000,200,0.8333333333333334,14,10,4,349.1181509489781,0.7878556910569106,0.045793285607974354,0.1986303025081352,130206.6260772547,891.4993074792445,131098.12538473395,1442,0,522.6585365853658,37,4,18,35.93861910901018,0.6204954954954953,44.846491228070185,1020.6140350877206,27.584163110478936,0
1451,4,0,0,39,0.0,0.0,1.0,39,1050,700,350,0.6666666666666666,14,7,7,368.81069875581727,0.7683310841205578,0.05245218322752687,0.20839342176651648,129937.8714018561,1784.4954293124106,131722.3668311685,1443,2,550.4615384615385,35,4,18,35.70933609565975,0.6217261904761904,45.1099537037037,1019.5601851851849,29.130291005290996,0
1452,4,1,0,40,0.025,0.0,1.0,40,1000,800,200,0.8,12,8,4,365.4242379810371,0.7819711538461539,0.05482742537313445,0.20836956548705932,130292.9705215419,1523.2523465275965,131816.22286806948,1444,0,537.675,34,6,19,35.43488611629354,0.6274509803921569,44.76190476190476,1020.9523809523805,30.02801120448178,0
1453,4,2,1,41,0.047619047619047616,0.023809523809523808,0.9761904761904762,42,1050,1000,50,0.9523809523809523,11,10,1,351.5203650379392,0.7958526906697638,0.07453051643192476,0.20373833402198904,130924.4379514648,804.5212442171719,131728.95919568196,1445,0,513.0238095238095,36,6,18,35.150289759389665,0.6296296296296298,44.144144144144136,1023.423423423422,28.42842842842839,0
1454,4,0,1,40,0.0,0.024390243902439025,0.975609756097561,41,1100,900,200,0.8181818181818182,13,9,4,358.1947726678069,0.7854674796747968,0.0716168438135667,0.20675161372079714,130765.21675936617,1167.8834179955136,131933.1001773617,1446,1,526.5121951219512,35,6,18,35.14071988985703,0.6300595238095239,44.299768518518505,1022.8009259259239,29.22288359788354,0
1455,4,0,0,40,0.0,0.0,1.0,40,1300,1100,200,0.8461538461538461,15,11,4,371.09647307987484,0.7856570512820513,0.05295266800625131,0.19577633721139692,127205.59030314103,1442.3181652036528,128647.90846834469,1447,2,523.375,36,4,18,38.44515144749571,0.5920138888888888,47.804054054054056,1008.7837837837842,28.021771771771782,8
1456,4,2,1,41,0.047619047619047616,0.023809523809523808,0.9761904761904762,42,750,500,250,0.6666666666666666,10,5,5,358.9974925020898,0.8041279519938056,0.06718010671499064,0.19165441755472729,127685.20801373353,767.7339013076058,128452.94191504114,1448,0,499.4047619047619,38,4,17,38.25823643410854,0.5932017543859649,47.32905982905982,1010.6837606837596,26.596941070625252,0
1457,4,3,1,43,0.06818181818181818,0.022727272727272728,0.9772727272727273,44,550,300,250,0.5454545454545454,8,3,5,354.63744919976267,0.8143058491895702,0.09721789519596258,0.19234796965890472,128320.37278163574,305.5653432957057,128625.93812493145,1449,0,477.6363636363636,35,9,20,37.71847155586018,0.6053571428571429,46.701388888888886,1013.194444444444,28.948412698412685,0
1458,4,2,3,42,0.044444444444444446,0.06666666666666667,0.9333333333333333,45,1150,900,250,0.782608695652174,14,9,5,347.03742247651417,0.8224747474747475,0.10327772372956678,0.18963043091141374,128616.79945993004,-73.03148564942484,128543.76797428062,1450,0,467.97777777777776,37,8,16,37.6084342233272,0.6044481981981982,46.40899122807018,1014.3640350877199,27.41524419156,0
1459,4,1,1,42,0.023255813953488372,0.023255813953488372,0.9767441860465116,43,1050,500,550,0.47619047619047616,16,5,11,357.69816142464435,0.8126153562200074,0.09198461152895177,0.19454025081469628,128429.74044568212,587.8164059329545,129017.55685161508,1451,0,490.4651162790698,36,7,16,37.52916342628597,0.6044560185185186,46.593468468468465,1013.6261261261258,28.15628128128127,0
1460,4,2,1,43,0.045454545454545456,0.022727272727272728,0.9772727272727273,44,750,500,250,0.6666666666666666,10,5,5,357.2483783912565,0.8182919309372798,0.1058789449910642,0.19616877147961162,128811.5153220221,403.54099338257123,129215.05631540467,1452,0,480.27272727272725,37,7,18,37.15075250234031,0.606418918918919,46.21710526315789,1015.1315789473679,27.435988620199133,0
1461,4,2,2,43,0.044444444444444446,0.044444444444444446,0.9555555555555556,45,850,500,350,0.5882352941176471,12,5,7,351.03563281584604,0.8260101010101011,0.1201050972149238,0.1945313946559566,129174.23575726856,68.95191851120867,129243.18767577977,1453,0,470.55555555555554,38,7,19,36.9388246628131,0.6082785087719298,45.86004273504273,1016.5598290598286,26.751574448942858,0
1462,4,1,1,43,0.022727272727272728,0.022727272727272728,0.9772727272727273,44,1100,800,300,0.7272727272727273,14,8,6,362.24782024509295,0.8173669837914024,0.12490069537755422,0.20045821169264258,129117.79495854478,554.5279557171286,129672.32291426191,1454,0,482.04545454545456,37,7,20,36.71141708922214,0.6095157657657657,45.91557017543859,1016.3377192982442,27.468587008060656,0
1463,4,2,1,44,0.044444444444444446,0.022222222222222223,0.9777777777777777,45,1050,700,350,0.6666666666666666,14,7,7,356.21095707481425,0.8233164983164983,0.1392864604456241,0.1994119667438633,129573.74762854059,231.17183409216182,129804.91946263275,1455,0,472.2888888888889,36,9,15,36.40061018323931,0.6160300925925927,45.467342342342334,1018.1306306306296,28.28140640640638,0
1464,4,1,1,44,0.022222222222222223,0.022222222222222223,0.9777777777777777,45,1300,900,400,0.6923076923076923,17,9,8,354.6151467043615,0.8220538720538721,0.12943033433778162,0.1994602871172473,129759.37307633106,202.92782394581693,129962.30090027688,1456,0,473.26666666666665,37,8,16,36.2525111206773,0.615990990990991,45.28508771929824,1018.8596491228061,27.536747273589356,0
1465,4,1,0,45,0.022222222222222223,0.0,1.0,45,900,600,300,0.6666666666666666,12,6,6,355.02112363867434,0.8228956228956229,0.1354511013110562,0.20040263427254112,129899.05698147492,223.38183383346978,130122.43881530839,1457,0,474.24444444444447,37,8,17,36.10024290989925,0.6173986486486487,45.148026315789465,1019.407894736841,27.55156472261732,0
1466,4,0,0,45,0.0,0.0,1.0,45,1050,700,350,0.6666666666666666,14,7,7,357.1858710326387,0.8234006734006735,0.1311113500340464,0.2022024215748369,130010.85820877571,287.60832660048266,130298.4665353762,1458,1,475.24444444444447,37,8,17,35.93150826076048,0.6185247747747749,45.03837719298245,1019.8464912280697,27.56341868183972,0
1467,4,3,2,46,0.0625,0.041666666666666664,0.9583333333333334,48,1400,1100,300,0.7857142857142857,17,11,6,338.78674201062466,0.8378213652482269,0.14425320378882822,0.19535341533287345,130726.51855504417,-741.8308081986659,129984.6877468455,1459,0,446.4791666666667,38,10,17,35.676103914194165,0.6239035087719298,44.337606837606835,1022.6495726495724,26.911830859199274,0
1468,4,1,1,46,0.02127659574468085,0.02127659574468085,0.9787234042553191,47,1300,1100,200,0.8461538461538461,15,11,4,347.2884327315353,0.8305195806352142,0.13830927947946892,0.20017379008988248,130710.70545744846,-321.1367920898747,130389.56866535859,1460,0,456.72340425531917,37,10,17,35.474748016298506,0.6255630630630631,44.353070175438596,1022.5877192982458,27.637505926979617,0
1469,4,0,0,46,0.0,0.0,1.0,46,1100,800,300,0.7272727272727273,14,8,6,353.53223427584476,0.8251006441223833,0.1453744493392073,0.20368481517923043,130694.03863322786,40.9110969077272,130734.94973013559,1461,2,467.6521739130435,36,10,17,35.33200256975039,0.6273148148148149,44.36936936936937,1022.5225225225228,28.40340340340341,0
1470,4,0,0,46,0.0,0.0,1.0,46,1150,800,350,0.6956521739130435,15,8,7,348.65149762144824,0.8240740740740741,0.1482281199483837,0.2019841357728725,130906.99932912046,-71.81572695444862,130835.18360216601,1462,3,468.6521739130435,37,9,17,35.24132558305654,0.6275337837837838,44.161184210526315,1023.3552631578943,27.658250355618765,0
1471,4,1,3,44,0.02127659574468085,0.06382978723404255,0.9361702127659575,47,1100,800,300,0.7272727272727273,14,8,6,339.251408616565,0.8286308973172988,0.1456937475171387,0.19771448355057808,131136.55495516476,-502.3478020673515,130634.2071530974,1463,0,459.6595744680851,38,9,17,35.24999130767359,0.628015350877193,43.93696581196581,1024.252136752137,26.954003598740446,0
1472,4,0,1,43,0.0,0.022727272727272728,0.9772727272727273,44,950,600,350,0.631578947368421,13,6,7,358.53119298053457,0.8121035940803383,0.13802284303133217,0.2066290339193101,130706.0335889275,572.4380304784029,131278.4716194059,1464,5,491.5681818181818,35,9,17,35.19206281833618,0.6294642857142856,44.35763888888889,1022.5694444444447,29.21626984126985,0
1473,4,0,0,43,0.0,0.0,1.0,43,700,500,200,0.7142857142857143,9,5,4,360.4389754509531,0.8068475452196382,0.14096601073345272,0.20852621354623185,130854.016632373,832.9775377228912,131686.9941700959,1465,6,502.74418604651163,35,8,18,34.993401206636484,0.630952380952381,44.212962962962955,1023.1481481481472,29.232804232804206,0
1474,4,0,0,43,0.0,0.0,1.0,43,1150,900,250,0.782608695652174,14,9,5,361.77862010623505,0.8058324104835732,0.14079361424514514,0.20999793465936617,130982.06948502548,877.3024713902962,131859.37195641577,1466,7,503.74418604651163,36,7,18,34.82948294829482,0.6302083333333335,44.08783783783783,1023.648648648648,28.434684684684665,0
1475,4,0,0,43,0.0,0.0,1.0,43,1150,1000,150,0.8695652173913043,13,10,3,361.3506625797635,0.805140273163529,0.13735585001496164,0.21022146991924415,131068.54056336729,872.3407951870654,131940.88135855435,1467,8,504.74418604651163,36,7,18,34.75292349426299,0.6310763888888891,44.00337837837837,1023.9864864864855,28.444069069069045,0
1476,4,1,0,44,0.022727272727272728,0.0,1.0,44,1100,500,600,0.45454545454545453,17,5,12,335.73197679054425,0.8116851656095843,0.08839622466231889,0.1894736519534179,129890.67382812501,-56.2117729004342,129834.46205522458,1468,0,494.25,39,5,17,36.60033040397847,0.6137820512820513,45.15625,1019.3750000000001,26.137820512820515,6
1477,4,0,0,44,0.0,0.0,1.0,44,1050,600,450,0.5714285714285714,15,6,9,337.70466831030774,0.8114649400986611,0.09288234747887403,0.19110570536172922,129996.88042534734,-19.889322916660717,129976.99110243068,1469,1,495.25,39,5,18,36.442373169901245,0.6148504273504274,45.052083333333336,1019.7916666666675,26.148504273504297,0
1478,4,2,1,45,0.043478260869565216,0.021739130434782608,0.9782608695652174,46,1050,600,450,0.5714285714285714,15,6,9,326.7133337216572,0.8218397745571658,0.11254159620315352,0.18733131437133857,130508.09500328728,-671.4392386793234,129836.65576460796,1470,0,474.67391304347825,38,8,14,36.20543182768716,0.6217105263157894,44.55128205128205,1021.7948717948715,26.889338731443985,0
1479,4,1,1,45,0.021739130434782608,0.021739130434782608,0.9782608695652174,46,1150,700,450,0.6086956521739131,16,7,9,327.77988698018385,0.8265901771336555,0.11577160620066262,0.1883405512756406,130589.98243343183,-639.0460634451154,129950.93636998671,1471,0,475.6521739130435,38,8,14,36.095432214905394,0.6225328947368423,44.47115384615384,1022.1153846153836,26.8977732793522,0
1480,4,1,1,45,0.021739130434782608,0.021739130434782608,0.9782608695652174,46,1200,500,700,0.4166666666666667,19,5,14,329.49040496125974,0.8220008051529791,0.11937898581006179,0.18999290098127564,130726.51855504402,-585.3732924245949,130141.14526261942,1472,0,476.6304347826087,38,8,14,35.91377629196266,0.62390350877193,44.33760683760683,1022.6495726495712,26.91183085919924,0
1481,4,0,0,45,0.0,0.0,1.0,45,950,700,250,0.7368421052631579,12,7,5,337.88189830478666,0.816456228956229,0.12159652949098398,0.19432899061662712,130626.62459843411,-172.7256223068706,130453.89897612724,1473,3,488.22222222222223,37,8,15,35.80023865708462,0.6247184684684686,44.435307017543856,1022.2587719298243,27.62861545756282,0
1482,4,0,0,45,0.0,0.0,1.0,45,950,600,350,0.631578947368421,13,6,7,338.12271793567015,0.815446127946128,0.12296048660444825,0.19497052145061644,130726.51855504402,-159.67884798015086,130566.83970706387,1474,4,489.22222222222223,38,7,15,35.6930805126062,0.62390350877193,44.33760683760683,1022.6495726495712,26.91183085919924,0
1483,4,0,0,45,0.0,0.0,1.0,45,1200,600,600,0.5,18,6,12,336.8030037499765,0.8145622895622896,0.12225006961849072,0.19475999782063846,130835.79881656796,-186.82199211046293,130648.9768244575,1475,5,490.22222222222223,38,7,15,35.616384711779446,0.625,44.230769230769226,1023.0769230769223,26.923076923076902,0
1484,4,0,1,44,0.0,0.022222222222222223,0.9777777777777777,45,1400,1000,400,0.7142857142857143,18,10,8,338.9662611369972,0.8153198653198653,0.12489709787007097,0.19698688177536938,131027.14913662421,-117.24342994376059,130909.90570668045,1476,6,491.22222222222223,38,7,15,35.367751921805976,0.6269188596491229,44.043803418803414,1023.8247863247856,26.94275753486278,0
1485,4,0,0,44,0.0,0.0,1.0,44,1250,900,350,0.72,16,9,7,332.8228904757513,0.8145921423537703,0.0657657532082554,0.18744999064618764,129811.04736328151,-136.57928362014445,129674.46807966137,1477,7,490.3181818181818,39,5,17,36.75519182936387,0.6129807692307692,45.234375000000014,1019.062500000002,26.129807692307743,8
1486,4,2,0,46,0.043478260869565216,0.0,1.0,46,1000,600,400,0.6,14,6,8,322.4205563793669,0.825925925925926,0.08800566046942837,0.1838303591084456,130289.17236328151,-796.8505859374718,129492.32177734404,1478,0,469.95652173913044,39,7,19,36.536344080536004,0.6177884615384615,44.765625000000014,1020.937500000002,26.177884615384666,0
1487,4,2,2,46,0.041666666666666664,0.041666666666666664,0.9583333333333334,48,950,600,350,0.631578947368421,13,6,7,315.6258790303688,0.8333333333333333,0.10360895570643391,0.18220060542010666,130769.4446412825,-1345.1558169564046,129424.2888243261,1479,0,451.3333333333333,41,7,17,36.22494342062724,0.619410569105691,44.295634920634924,1022.8174603174609,24.946767324816122,0
1488,4,1,0,47,0.02127659574468085,0.0,1.0,47,1100,500,600,0.45454545454545453,17,5,12,322.29600982961796,0.8265494912118408,0.11010807428204195,0.1859854955805781,130755.8331680881,-971.5833415955756,129784.24982649252,1480,0,461.8936170212766,40,7,18,36.068122350291475,0.6208333333333332,44.30894308943091,1022.7642276422789,25.569105691056972,0
1489,4,0,0,47,0.0,0.0,1.0,47,1300,900,400,0.6923076923076923,17,9,8,325.5034499609298,0.8266651248843663,0.12179272956815534,0.18839745134102315,130870.93431122463,-880.211876417223,129990.72243480741,1481,1,462.8936170212766,41,6,19,35.86993407019585,0.6204268292682926,44.19642857142858,1023.2142857142868,24.956445993031384,0
1490,4,0,0,47,0.0,0.0,1.0,47,1600,1200,400,0.75,20,12,8,330.44213088155703,0.8267036694418748,0.1258287976249377,0.1920136706473916,131023.24263038574,-740.8801020407961,130282.36252834494,1482,2,463.8936170212766,41,6,20,35.58987403100775,0.621951219512195,44.04761904761906,1023.8095238095258,24.97096399535429,0
1491,4,2,2,47,0.04081632653061224,0.04081632653061224,0.9591836734693877,49,1100,600,500,0.5454545454545454,16,6,10,329.0841418711173,0.8365575396825397,0.0049513704686119375,0.1920506524541967,131188.8956167295,-1158.033919301826,130030.86169742768,1483,0,445.9183673469388,45,4,17,35.45755968169761,0.6180555555555556,43.885869565217384,1024.4565217391291,22.76570048309176,4
1492,4,1,0,48,0.020833333333333332,0.0,1.0,48,1300,1000,300,0.7692307692307693,16,10,6,333.5794745149085,0.8300088652482269,0.016315397126593023,0.19501975934793936,131256.95408950612,-843.0748456790159,130413.8792438271,1484,0,456.125,44,4,18,35.273786934128495,0.6200284090909091,43.81944444444444,1024.722222222222,23.289141414141408,0
1493,4,0,0,48,0.0,0.0,1.0,48,1250,900,350,0.72,16,9,7,331.02013821660336,0.8279218380614657,0.026210977812177738,0.19439909935265978,131429.83119173592,-898.7579522549738,130531.07323948095,1485,1,457.125,41,7,18,35.16511867905058,0.6260162601626016,43.65079365079365,1025.3968253968253,25.00967866821525,0
1494,4,0,0,48,0.0,0.0,1.0,48,1700,1000,700,0.5882352941176471,24,10,14,334.1071334300804,0.8278294917257683,0.021974778008690077,0.1967106848993792,131526.8435265311,-811.1886680487771,130715.65485848232,1486,2,458.125,42,6,19,34.98823131179543,0.6254960317460316,43.556201550387605,1025.7751937984515,24.423218899963132,0
1495,4,0,2,46,0.0,0.041666666666666664,0.9583333333333334,48,1850,1500,350,0.8108108108108109,22,15,7,334.2032006339072,0.8272200059101654,0.022309075816270063,0.19800169952310545,131765.27795712836,-792.7244748622358,130972.55348226613,1487,3,459.125,43,5,17,34.745665006456385,0.6264534883720929,43.32386363636365,1026.7045454545475,23.876849894291805,0
1496,4,0,0,46,0.0,0.0,1.0,46,1100,600,500,0.5454545454545454,16,6,10,343.37508479432597,0.8185587761674719,0.0449045696496615,0.20341091886299237,131760.64819735757,-151.33525053540612,131609.31294682217,1488,4,479.0217391304348,41,5,17,34.5149088478758,0.6293191056910569,43.32837301587301,1026.6865079365073,25.041134339914812,0
1497,4,0,0,46,0.0,0.0,1.0,46,1000,700,300,0.7,13,7,6,345.0116934896287,0.8182165861513688,0.05200423358645234,0.20479134466769697,131837.04963466869,-102.93524817334503,131734.11438649535,1489,5,480.0217391304348,41,5,17,34.39592993302421,0.6300813008130082,43.25396825396825,1026.984126984127,25.048393341076267,0
1498,4,1,0,47,0.02127659574468085,0.0,1.0,47,1700,1300,400,0.7647058823529411,21,13,8,341.166804855153,0.8204209065679925,0.04855834277066773,0.20471936876978203,132248.45754649641,-376.243258367905,131872.2142881285,1490,0,470.78723404255317,42,5,18,34.080703407128254,0.6326884920634921,42.853682170542626,1028.585271317828,24.490125507567335,0
1499,4,0,0,47,0.0,0.0,1.0,47,1250,800,450,0.64,17,8,9,342.3778727024204,0.8198812827628739,0.04887844922958551,0.20558164573579707,132273.37599903843,-342.50458205637517,131930.87141698206,1491,1,471.78723404255317,42,5,18,34.024507033408696,0.6329365079365079,42.82945736434108,1028.6821705426348,24.492432631967496,0
1500,4,0,1,46,0.0,0.02127659574468085,0.9787234042553191,47,1150,800,350,0.6956521739130435,15,8,7,341.82315355909697,0.8199198273203823,0.05020779647567575,0.2055197193935724,132323.219946217,-353.7719337780324,131969.44801243895,1492,2,472.78723404255317,42,5,18,33.98866704338544,0.6334325396825398,42.78100775193798,1028.8759689922467,24.49704688076778,0
1501,4,0,0,46,0.0,0.0,1.0,46,1400,1000,400,0.7142857142857143,18,10,8,337.3920513463096,0.8136070853462158,0.08155325633551103,0.19611037685883378,131034.66932508697,-357.9043186467915,130676.76500644018,1493,3,483.3478260869565,39,7,18,35.400451894055024,0.6252670940170939,44.03645833333334,1023.854166666668,26.252670940170976,4
1502,4,0,1,45,0.0,0.021739130434782608,0.9782608695652174,46,1050,700,350,0.6666666666666666,14,7,7,306.8955800063141,0.8142512077294686,0.022447946332510238,0.17658062266694932,130642.63791454062,-1173.5582416560592,129469.07967288456,1494,4,484.3478260869565,41,5,17,36.57599466278505,0.618140243902439,44.41964285714285,1022.321428571427,24.934668989547,7
1503,4,0,0,45,0.0,0.0,1.0,45,1400,1100,300,0.7857142857142857,17,11,6,308.5927686347169,0.8107744107744108,0.02882463289992887,0.17767357952789864,130667.99433893902,-935.3603710002769,129732.63396793875,1495,11,496.02222222222224,41,4,18,36.50705090885567,0.6183943089430894,44.39484126984126,1022.4206349206329,24.937088656600803,0
1504,4,0,0,45,0.0,0.0,1.0,45,1400,1000,400,0.7142857142857143,18,10,8,312.3016745409217,0.8092592592592593,0.02797012898845863,0.18040014376422675,130794.81336805577,-830.512152777758,129964.30121527801,1496,12,497.02222222222224,41,4,18,36.28436863543787,0.6196646341463413,44.27083333333334,1022.9166666666683,24.949186991869958,0
1505,4,0,0,45,0.0,0.0,1.0,45,800,500,300,0.625,11,5,6,314.8907887447579,0.8089225589225589,0.026914872988170746,0.18225497166742075,130870.93431122467,-757.989654195001,130112.94465702967,1497,13,498.02222222222224,41,4,18,36.14140973434165,0.6204268292682926,44.19642857142858,1023.2142857142871,24.956445993031394,0
1506,4,0,0,45,0.0,0.0,1.0,45,1250,1000,250,0.8,15,10,5,314.69027135201003,0.8074915824915825,0.024423337856173566,0.18261947243026105,130972.46334876557,-756.8479938271471,130215.61535493842,1498,14,499.02222222222224,41,4,19,36.04421076436002,0.6214430894308942,44.09722222222223,1023.6111111111122,24.96612466124664,0
1507,4,1,0,46,0.021739130434782608,0.0,1.0,46,1450,1100,350,0.7586206896551724,18,11,7,308.06653346382456,0.8106884057971014,0.04350256027356725,0.18056478593314476,131354.8190646703,-1105.3484881365548,130249.47057653374,1499,0,489.1521739130435,39,7,20,35.82895115672528,0.6284722222222221,43.72395833333334,1025.104166666668,26.28472222222226,0
1508,4,0,1,45,0.0,0.021739130434782608,0.9782608695652174,46,1100,800,300,0.7272727272727273,14,8,6,309.4975678114893,0.809561191626409,0.04359970852562545,0.181910660006216,131461.62245008702,-1062.5895182291415,130399.03293185787,1500,1,490.1521739130435,39,7,21,35.684886575249685,0.6295405982905982,43.61979166666668,1025.520833333335,26.29540598290603,0
1509,4,1,1,45,0.021739130434782608,0.021739130434782608,0.9782608695652174,46,1050,700,350,0.6666666666666666,14,7,7,304.67140531849344,0.8087157809983897,0.05594243068527116,0.18040976181286184,131745.12215777658,-1172.2056976667175,130572.91646010986,1501,0,489.3695652173913,40,6,18,35.52390615719662,0.6307291666666666,43.34349593495936,1026.6260162601636,25.665650406504092,0
1510,4,0,0,45,0.0,0.0,1.0,45,1150,800,350,0.6956521739130435,15,8,7,308.99038745680963,0.8068181818181819,0.05484130820041866,0.18255314438838918,131658.81406092527,-863.7384062421356,130795.07565468314,1502,3,501.24444444444447,41,4,20,35.49973819880779,0.6283028455284554,43.42757936507936,1026.2896825396822,25.031455671699565,0
1511,4,0,0,45,0.0,0.0,1.0,45,1050,600,450,0.5714285714285714,15,6,9,344.4072706273017,0.8068181818181819,-0.009127498918936938,0.19313403799419085,129640.87106095906,-36.66122342282503,129604.20983753624,1503,4,502.24444444444447,40,5,17,36.63286265509097,0.6096354166666667,45.40142276422764,1018.3943089430893,25.459857723577233,7
1512,4,2,2,45,0.0425531914893617,0.0425531914893617,0.9574468085106383,47,1150,800,350,0.6956521739130435,15,8,7,334.32746850142104,0.8167206290471785,0.0025138270592066636,0.18976463158228887,130114.25212013986,-699.8462945436112,129414.40582559626,1504,0,481.82978723404256,42,5,19,36.409559312375336,0.6113591269841271,44.93701550387596,1020.2519379844948,24.29171280915464,0
1513,4,0,0,45,0.0,0.0,1.0,45,1500,1200,300,0.8,18,12,6,327.3084389589403,0.8077861952861953,0.013146377735288262,0.1779441929059521,128414.47704464881,-593.6870906195476,127820.78995402926,1505,1,503.77777777777777,42,3,15,38.314810388782675,0.5942460317460316,46.60852713178295,1013.5658914728687,24.13252122554449,4
1514,4,2,2,45,0.0425531914893617,0.0425531914893617,0.9574468085106383,47,1050,800,250,0.7619047619047619,13,8,5,315.04918959280354,0.8210761640456367,0.0313764298396253,0.17315861473108216,128848.62075617285,-1281.269290123454,127567.3514660494,1506,0,483.29787234042556,44,3,16,38.18399452804378,0.5958806818181819,46.18055555555556,1015.2777777777778,23.07449494949495,0
1515,4,2,0,47,0.0425531914893617,0.0,1.0,47,1250,700,550,0.56,18,7,11,314.7874648199737,0.8242753623188406,0.044169423619752735,0.17375276601480458,129017.27578239882,-1277.395767695849,127739.88001470297,1507,0,484.21276595744683,45,2,18,38.01934736091299,0.5962962962962963,46.014492753623195,1015.9420289855085,22.5764895330113,0
1516,4,1,0,48,0.020833333333333332,0.0,1.0,48,1400,1100,300,0.7857142857142857,17,11,6,311.8352034400316,0.8301381501182032,0.05132113821138229,0.17356133447423946,129345.84212149915,-1532.6887767572985,127813.15334474186,1508,0,475.1041666666667,43,5,19,37.761046980698815,0.6022286821705427,45.69128787878788,1017.2348484848491,23.656624383368584,0
1517,4,0,1,47,0.0,0.020833333333333332,0.9791666666666666,48,1250,900,350,0.72,16,9,7,308.7570246509409,0.8297133569739953,0.055461842717543064,0.17216368603395754,129418.099003171,-1608.250563160001,127809.84844001099,1509,1,476.1041666666667,43,5,19,37.76611214518382,0.602955426356589,45.620265151515156,1017.5189393939401,23.66323114869628,0
1518,4,1,1,47,0.020833333333333332,0.020833333333333332,0.9791666666666666,48,850,300,550,0.35294117647058826,14,3,11,306.2529195999529,0.8296025413711584,0.05387931034482785,0.17095103297730235,129460.3920181757,-1670.4753943758467,127789.91662379986,1510,0,476.875,44,4,15,37.78697722378919,0.6020359848484848,45.57870370370371,1017.685185185186,23.129208754208772,0
1519,4,1,1,47,0.020833333333333332,0.020833333333333332,0.9791666666666666,48,1200,700,500,0.5833333333333334,17,7,10,308.62180268455285,0.8321328309692672,0.0637615930169122,0.17299809306446046,129625.34722222232,-1598.958333333324,128026.38888888899,1511,0,477.8541666666667,44,4,15,37.55966993998908,0.6036931818181819,45.41666666666667,1018.3333333333342,23.143939393939412,0
1520,4,1,2,46,0.020833333333333332,0.041666666666666664,0.9583333333333334,48,1250,900,350,0.72,16,9,7,315.76446480410436,0.8261857269503546,0.08123297002724827,0.17828547474324052,129908.3719135803,-1395.910493827153,128512.46141975315,1512,0,478.8333333333333,44,4,16,37.09128065395096,0.6065340909090908,45.13888888888889,1019.4444444444448,23.169191919191928,0
1521,4,0,1,45,0.0,0.021739130434782608,0.9782608695652174,46,1500,1300,200,0.8666666666666667,17,13,4,325.224772186238,0.8139694041867955,0.08012376167591584,0.1826863119794967,129707.3282989698,-763.1927406163927,128944.13555835342,1513,1,500.4347826086956,43,3,17,37.0538757708159,0.6058624031007752,45.33617424242424,1018.655303030303,23.689658210007046,0
1522,4,1,1,45,0.021739130434782608,0.021739130434782608,0.9782608695652174,46,1500,1000,500,0.6666666666666666,20,10,10,318.7902271580141,0.8190217391304349,0.07956348165161686,0.18062543591367522,130045.17049938293,-908.5741111398165,129136.59638824311,1514,0,489.45652173913044,43,3,19,36.875734998297894,0.6092538759689923,45.004734848484844,1019.9810606060598,23.720489781536276,0
1523,4,1,0,46,0.021739130434782608,0.0,1.0,46,1650,1000,650,0.6060606060606061,23,10,13,317.77875775106077,0.8185990338164252,0.07814913862300688,0.18094755572100807,130238.42047068692,-922.5993062729624,129315.82116441395,1515,0,490.2608695652174,43,3,21,36.70611451278721,0.6111918604651163,44.81534090909091,1020.7386363636358,23.738107822410136,0
1524,4,0,0,46,0.0,0.0,1.0,46,1100,800,300,0.7272727272727273,14,8,6,321.23776883067825,0.8184178743961353,0.07323622452733036,0.18327517679964928,130314.46358194527,-827.607768876794,129486.85581306847,1516,1,491.2608695652174,40,6,21,36.54096579410106,0.61640625,44.74085365853659,1021.0365853658536,25.52591463414634,0
1525,4,0,0,46,0.0,0.0,1.0,46,1150,500,650,0.43478260869565216,18,5,13,321.6101119377324,0.8188808373590982,0.09904675555851283,0.17420270001021007,128267.1986734571,-805.3918090745544,127461.80686438254,1517,2,492.2608695652174,42,4,16,38.609224539251315,0.5927579365079365,46.75387596899225,1012.9844961240308,24.11867847914359,7
1526,4,2,2,46,0.041666666666666664,0.041666666666666664,0.9583333333333334,48,1300,800,500,0.6153846153846154,18,8,10,309.9342327415227,0.8301381501182032,0.10732559377185802,0.16994442846822544,128754.63070130293,-1618.9064643347265,127135.7242369682,1518,0,472.7083333333333,44,4,15,38.40928443268557,0.5949337121212122,46.27314814814814,1014.9074074074057,23.0660774410774,0
1527,4,1,0,47,0.02127659574468085,0.0,1.0,47,600,400,200,0.6666666666666666,8,4,4,320.04713762301,0.8208063521430773,0.12710829692119274,0.17548957856357245,128754.6307013031,-1158.4897976680443,127596.14090363505,1519,0,483.74468085106383,44,3,16,38.15269288081987,0.5949337121212122,46.273148148148145,1014.907407407407,23.066077441077432,0
1528,4,1,0,48,0.020833333333333332,0.0,1.0,48,850,600,250,0.7058823529411765,11,6,5,317.0577662967082,0.8264997044917257,0.14596329798294883,0.17551579652764493,129132.33109017268,-1411.518309572578,127720.8127806001,1520,0,474.6458333333333,45,3,17,37.844870480943456,0.5974537037037038,45.901268115942024,1016.3949275362313,22.586553945249584,0
1529,4,1,0,49,0.02040816326530612,0.0,1.0,49,1300,700,600,0.5384615384615384,19,7,12,314.2991386050712,0.8325184240362812,0.14559221923688992,0.17544244958904684,129460.3920181754,-1662.1051399650369,127798.28687821036,1521,0,465.9387755102041,44,5,16,37.58226427683256,0.602035984848485,45.578703703703695,1017.6851851851836,23.12920875420872,0
1530,4,1,1,49,0.02,0.02,0.98,50,1750,1400,350,0.8,21,14,7,309.6944849682427,0.8360034013605442,0.15342382319672798,0.1742202014557031,129765.3155415347,-1962.4794873245798,127802.83605421011,1522,0,457.6,46,4,16,37.39069433568258,0.6025815217391305,45.27925531914894,1018.8829787234048,22.14962997224793,0
1531,4,3,2,50,0.057692307692307696,0.038461538461538464,0.9615384615384616,52,1450,900,550,0.6206896551724138,20,9,11,305.6608823264219,0.8449126445449974,0.17545152730955094,0.173864545482546,130197.49077352042,-2440.7440186959025,127756.74675482452,1523,0,440.9423076923077,48,4,17,37.0566711103705,0.6046006944444444,44.85544217687075,1020.578231292518,21.262046485260793,0
1532,4,0,0,50,0.0,0.0,1.0,50,1500,1000,500,0.6666666666666666,20,10,10,313.59439549835804,0.8343027210884354,0.1662390265102136,0.17764172920771074,130036.43652387949,-1844.2604591066893,128192.1760647728,1524,1,459.58,46,4,17,37.017057800956124,0.6052989130434783,45.013297872340424,1019.9468085106375,22.17275670675299,0
1533,4,3,4,49,0.05660377358490566,0.07547169811320754,0.9245283018867925,53,1200,800,400,0.6666666666666666,16,8,8,302.7383994449398,0.8522314949201741,0.18515480205389978,0.17493208992557355,130807.2036404813,-2678.551935845285,128128.65170463601,1525,0,434.50943396226415,42,11,16,36.516450380474254,0.6183035714285714,44.258720930232556,1022.9651162790694,24.356312292358798,0
1534,4,4,1,52,0.07547169811320754,0.018867924528301886,0.9811320754716981,53,1000,700,300,0.7,13,7,6,296.42224859132205,0.8575834542815675,0.1931981239157905,0.17294569603242013,131179.18469442928,-2823.114220900198,128356.07047352908,1526,0,427.4339622641509,42,11,19,36.303837179972255,0.6220238095238095,43.8953488372093,1024.4186046511618,24.390919158360994,0
1535,4,0,0,52,0.0,0.0,1.0,52,1350,900,450,0.6666666666666666,18,9,9,301.92958319460683,0.8547008547008547,0.19628703683486481,0.17581783828009923,131104.74623107092,-2483.1197231236083,128621.62650794731,1527,1,436.65384615384613,42,10,19,36.23766045352762,0.6212797619047619,43.968023255813954,1024.1279069767447,24.383997785160588,0
1536,4,0,0,52,0.0,0.0,1.0,52,1450,1100,350,0.7586206896551724,18,11,7,303.74675988800055,0.8536167672197084,0.19551009274413556,0.17756340441213936,131253.64428407224,-2426.42616504419,128827.21811902805,1528,2,437.65384615384613,42,10,19,36.04137115839245,0.6227678571428572,43.82267441860464,1024.7093023255798,24.39784053156142,0
1537,4,1,0,53,0.018867924528301886,0.0,1.0,53,1100,600,500,0.5454545454545454,16,6,10,296.9522950121704,0.8578858248669569,0.19417191963800362,0.17494902322169467,131551.6939054896,-2787.0633901207716,128764.63051536883,1529,0,430.37735849056605,42,11,21,35.916099933881185,0.6257440476190477,43.53197674418605,1025.872093023257,24.425526024363265,0
1538,4,0,2,51,0.0,0.03773584905660377,0.9622641509433962,53,1450,1100,350,0.7586206896551724,18,11,7,295.9440512276937,0.8561018384131591,0.20022834588167004,0.1750382654748724,131700.84547390504,-2804.7836480680003,128896.06182583704,1530,1,431.37735849056605,42,11,14,35.79230781333587,0.6272321428571428,43.386627906976756,1026.4534883720949,24.439368770764162,0
1539,4,0,0,51,0.0,0.0,1.0,51,1450,1000,450,0.6896551724137931,19,10,9,307.0226692260171,0.8483660130718955,0.2012745680565744,0.1813049657218905,131640.8109012496,-2116.6573716041735,129524.15352964544,1531,5,448.2549019607843,40,11,14,35.56830560507029,0.6296874999999998,43.44512195121953,1026.2195121951247,25.655487804878117,0
1540,4,1,0,52,0.019230769230769232,0.0,1.0,52,1600,1200,400,0.75,20,12,8,301.6378501863117,0.8498617395676218,0.2133917237877636,0.17981278253096336,131999.40212614942,-2436.796823357956,129562.60530279146,1532,0,440.61538461538464,42,10,15,35.3467311016816,0.6302083333333333,43.095930232558146,1027.6162790697686,24.467054263565917,0
1541,4,1,4,49,0.018867924528301886,0.07547169811320754,0.9245283018867925,53,950,600,350,0.631578947368421,13,6,7,297.08290827752796,0.8518384131591679,0.21350189721192314,0.1786278803782705,132324.91933719328,-2737.705625143445,129587.21371204984,1533,0,433.2830188679245,43,10,15,35.137770363552704,0.6320251937984496,42.77935606060608,1028.8825757575783,23.927501761804145,0
1542,4,0,0,49,0.0,0.0,1.0,49,1300,900,400,0.6923076923076923,17,9,8,321.4314394447821,0.8357071995464853,0.21980697330666898,0.1906540992807862,131809.03320312526,-1326.4865451388591,130482.5466579864,1534,2,469.2244897959184,39,10,15,35.029502265503496,0.6330128205128204,43.281250000000014,1026.875000000002,26.330128205128258,0
1543,4,0,0,49,0.0,0.0,1.0,49,1650,1200,450,0.7272727272727273,21,12,9,323.58903301578795,0.8350340136054422,0.22561139645474926,0.1924749724729619,131916.0210503475,-1262.6844618055204,130653.33658854199,1535,3,470.2244897959184,39,10,15,34.86657540728725,0.6340811965811964,43.17708333333335,1027.291666666669,26.340811965812026,0
1544,4,0,0,49,0.0,0.0,1.0,49,1250,900,350,0.72,16,9,7,323.4488915047842,0.8356009070294785,0.22275790575786214,0.19252724302424223,131942.77479383716,-1264.6511501735713,130678.1236436636,1536,4,471.2244897959184,39,10,15,34.843290580959156,0.6343482905982905,43.151041666666686,1027.3958333333362,26.34348290598298,0
1545,4,0,0,49,0.0,0.0,1.0,49,1700,1400,300,0.8235294117647058,20,14,6,325.48621815485757,0.8354591836734694,0.22836421510018923,0.19437249027680006,132066.38681224818,-1202.842242220949,130863.54457002722,1537,5,472.2244897959184,41,8,16,34.66675916095617,0.6323678861788616,43.030753968253975,1027.8769841269852,25.070170344560616,0
1546,4,0,1,48,0.0,0.02040816326530612,0.9795918367346939,49,1450,1100,350,0.7586206896551724,18,11,7,324.8881812288665,0.8356363378684808,0.22318094949427358,0.19506459474013432,132270.40939350295,-1205.3814523494375,131065.02794115352,1538,6,473.2244897959184,41,8,17,34.47726797826857,0.6344004065040649,42.83234126984128,1028.6706349206363,25.08952768099113,0
1547,4,0,0,48,0.0,0.0,1.0,48,800,500,300,0.625,11,5,6,329.19431601788943,0.8323175236406619,0.22333835490137988,0.19777056742131147,132293.43401951567,-889.9506948575391,131403.48332465813,1539,7,482.2291666666667,40,8,18,34.34340939774112,0.6361979166666666,42.809959349593505,1028.7601626016274,25.719004065040686,0
1548,4,1,0,49,0.02040816326530612,0.0,1.0,49,1550,900,650,0.5806451612903226,22,9,13,320.56509779711513,0.8340419501133787,0.22634589471993416,0.19446482192626086,132658.9004545088,-1294.630763484887,131364.26969102392,1540,0,473.3673469387755,36,13,15,34.19895969975222,0.6469907407407407,42.45495495495497,1030.1801801801823,28.616116116116174,0
1549,4,0,0,49,0.0,0.0,1.0,49,1250,800,450,0.64,17,8,9,302.97538085682174,0.8346088435374149,0.2052129591232834,0.18392601264230257,132685.7824790135,-1759.894903827116,130925.88757518638,1541,1,474.3673469387755,40,9,19,34.62509041888606,0.6401041666666668,42.42886178861787,1030.284552845526,25.757113821138148,1
1550,4,0,1,48,0.0,0.02040816326530612,0.9795918367346939,49,1600,1100,500,0.6875,21,11,10,304.20988928615606,0.8336522108843538,0.20059677227886152,0.18532137579756605,132816.69439693599,-1719.1696204309985,131097.524776505,1542,2,475.3673469387755,40,9,20,34.462396069538926,0.6414062500000002,42.301829268292664,1030.7926829268263,25.769817073170657,0
1551,4,0,0,48,0.0,0.0,1.0,48,1500,1400,100,0.9333333333333333,16,14,2,310.56046750391636,0.8350325059101654,0.19939032605766638,0.18924300408982472,132827.17013888873,-1349.8263888889078,131477.34374999983,1543,3,480.6875,39,9,20,34.28826461870118,0.6431623931623933,42.29166666666666,1030.833333333332,26.431623931623896,0
1552,4,0,0,48,0.0,0.0,1.0,48,1200,1000,200,0.8333333333333334,14,10,4,324.2643113850345,0.8356235224586288,0.24043064386464952,0.19282523132035778,131905.89871966577,-1040.837416808683,130865.06130285708,1544,4,481.6875,36,12,18,34.85940583205437,0.6394675925925926,43.186936936936945,1027.2522522522536,28.534784784784822,4
1553,4,0,0,48,0.0,0.0,1.0,48,700,400,300,0.5714285714285714,10,4,6,326.2752186151249,0.835401891252955,0.2416598173515987,0.19446514499431836,131992.6741564199,-986.8122768038306,131005.86187961607,1545,5,482.6875,36,12,18,34.720547945205475,0.6403356481481481,43.10247747747748,1027.59009009009,28.544169169169166,0
1554,4,0,1,47,0.0,0.020833333333333332,0.9791666666666666,48,1150,800,350,0.6956521739130435,15,8,7,325.51712599089205,0.8347924054373522,0.23622727272727295,0.194965920203008,132178.18737900877,-994.7472651398834,131183.44011386888,1546,6,483.6875,38,10,18,34.553679653679644,0.6384320175438596,42.92200854700855,1028.3119658119665,27.060841205578065,0
1555,4,0,1,46,0.0,0.02127659574468085,0.9787234042553191,47,1400,1000,400,0.7142857142857143,18,10,8,331.65666088298224,0.8321769966080789,0.2530021877373354,0.1996534805892743,132369.79316953284,-619.735279124359,131750.0578904085,1547,7,493.3191489361702,37,10,19,34.20340525661517,0.6421734234234234,42.73574561403508,1029.0570175438588,27.812351825509698,0
1556,4,0,0,46,0.0,0.0,1.0,46,1250,700,550,0.56,18,7,11,339.38110473099937,0.8294283413848631,0.25715947590643395,0.20369380316580332,132256.9820161012,-222.89586699752942,132034.08614910365,1548,16,504.89130434782606,37,9,19,34.11805333475465,0.6410472972972973,42.84539473684211,1028.6184210526321,27.800497866287355,0
1557,4,0,0,46,0.0,0.0,1.0,46,850,500,350,0.5882352941176471,12,5,7,339.9130696424014,0.8294887278582931,0.25936839764261044,0.2044707849695062,132341.58587257622,-203.07306094182934,132138.5128116344,1549,17,505.89130434782606,37,9,19,34.019341432225055,0.6418918918918919,42.76315789473684,1028.947368421053,27.809388335704135,0
1558,4,1,0,47,0.02127659574468085,0.0,1.0,47,1150,800,350,0.6956521739130435,15,8,7,330.409718907602,0.8341813135985199,0.25935966220915785,0.2010089203501835,132765.81809807254,-626.5285806150748,132139.28951745748,1550,0,496.1063829787234,34,13,17,33.838223403026454,0.6522671568627452,42.351190476190474,1030.595238095238,30.311624649859944,0
1559,4,0,1,46,0.0,0.02127659574468085,0.9787234042553191,47,1200,900,300,0.75,15,9,6,327.3734914890436,0.832832254085723,0.25618834028608917,0.19967383841320427,132861.99787202754,-700.9007740848845,132161.09709794266,1551,1,497.1063829787234,36,11,18,33.82008920444201,0.6490162037037037,42.25788288288289,1030.9684684684694,28.638013013013037,0
1560,4,0,0,46,0.0,0.0,1.0,46,1300,900,400,0.6923076923076923,17,9,8,329.1434609735413,0.8306561996779388,0.26121847363249207,0.20137775277599645,132978.123287984,-446.22405344533087,132531.89923453867,1552,2,505.82608695652175,36,10,18,33.658150453106224,0.6501736111111112,42.145270270270274,1031.4189189189194,28.650525525525538,0
1561,4,0,0,46,0.0,0.0,1.0,46,1350,800,550,0.5925925925925926,19,8,11,335.8008264674544,0.8306561996779388,0.28670882417030175,0.18836056686014352,129651.86767578128,-492.5591362847219,129159.30853949656,1553,3,506.82608695652175,39,7,16,36.840821144863796,0.6113782051282052,45.390625,1018.4375000000002,26.113782051282058,7
1562,4,0,0,46,0.0,0.0,1.0,46,1250,900,350,0.72,16,9,7,333.8613068326691,0.8300925925925926,0.28905779030684164,0.1877150645539824,129744.3870732533,-536.6738755040038,129207.7131977493,1554,4,507.82608695652175,40,6,18,36.79634247714049,0.6106770833333334,45.29979674796748,1018.8008130081297,25.470020325203244,0
1563,4,0,0,46,0.0,0.0,1.0,46,1600,1200,400,0.75,20,12,8,336.1379470760205,0.8298107890499196,0.29397459794529524,0.18962112537528023,129873.84018276141,-468.8947964174912,129404.94538634393,1555,5,508.82608695652175,40,6,19,36.607053838484546,0.6119791666666667,45.17276422764227,1019.3089430894295,25.48272357723574,0
1564,4,0,0,46,0.0,0.0,1.0,46,1250,1200,50,0.96,13,12,1,337.2561074100362,0.8286634460547504,0.29576225643159293,0.19050412553702029,129925.63950029734,-436.3569138740243,129489.28258642332,1556,6,509.82608695652175,40,6,20,36.52603335991494,0.6125,45.12195121951219,1019.5121951219504,25.48780487804876,0
1565,4,0,0,46,0.0,0.0,1.0,46,1200,800,400,0.6666666666666666,16,8,8,334.0489185127241,0.8274557165861514,0.2931186857746888,0.18919384572199224,130029.26911891082,-512.7726551655674,129516.49646374525,1557,7,510.82608695652175,40,6,20,36.50275674239403,0.6135416666666667,45.020325203252035,1019.9186991869929,25.49796747967482,0
1566,4,0,0,46,0.0,0.0,1.0,46,1350,800,550,0.5925925925925926,19,8,11,336.0498246059584,0.8255434782608696,0.29473843755413087,0.19083372392781814,130132.94004891277,-453.76966422102623,129679.17038469175,1558,8,511.82608695652175,40,6,20,36.346696547144745,0.6145833333333333,44.91869918699187,1020.3252032520332,25.50813008130083,0
1567,4,0,1,45,0.0,0.021739130434782608,0.9782608695652174,46,1600,1100,500,0.6875,21,11,10,340.40938812560745,0.8240740740740741,0.29780678990165144,0.19408681867475752,130289.17236328138,-329.6039622398259,129959.56840104156,1559,9,512.8260869565217,39,7,20,36.07720725776283,0.6177884615384615,44.76562500000001,1020.937500000001,26.17788461538464,0
1568,4,1,1,45,0.021739130434782608,0.021739130434782608,0.9782608695652174,46,1050,900,150,0.8571428571428571,12,9,3,352.5822683229113,0.8289049919484702,0.2812736415824846,0.19684164351513375,129466.28146701373,-70.49696180557294,129395.78450520815,1560,0,512.0652173913044,39,7,14,36.60226885022175,0.6095085470085471,45.57291666666666,1017.708333333332,26.095085470085436,3
1569,4,1,0,46,0.021739130434782608,0.0,1.0,46,1150,800,350,0.6956521739130435,15,8,7,355.03430772954164,0.8305354267310789,0.2841654620260208,0.1988802497453446,129598.82948133658,2.4061414930325213,129601.23562282961,1561,0,513.0434782608696,39,7,15,36.40505115089514,0.6108440170940173,45.44270833333332,1018.2291666666648,26.108440170940124,0
1570,4,0,0,46,0.0,0.0,1.0,46,1300,1000,300,0.7692307692307693,16,10,6,349.34674124277956,0.8311996779388084,0.3328136606659753,0.18928604574080213,128279.78326576091,-233.78430774138164,128045.99895801953,1562,1,514.0434782608696,38,8,21,37.89394818252126,0.5992324561403508,46.741452991452995,1013.0341880341887,26.658794421952333,4
1571,4,1,0,47,0.02127659574468085,0.0,1.0,47,1150,800,350,0.6956521739130435,15,8,7,345.79904856523154,0.8333718778908418,0.34079692746644863,0.18909247242991545,128645.99745008702,-502.8672960069241,128143.13015408009,1563,0,504.0851063829787,39,8,18,37.610060067768764,0.6012286324786325,46.38020833333334,1014.4791666666683,26.012286324786366,0
1572,4,0,0,47,0.0,0.0,1.0,47,1250,900,350,0.72,16,9,7,345.26080531447684,0.8340656799259943,0.33883104316696055,0.1890492132978257,128698.84033203126,-513.0669487847204,128185.77338324655,1564,1,505.0851063829787,39,8,18,37.56982941518667,0.6017628205128205,46.328125,1014.6875000000001,26.017628205128208,0
1573,4,1,1,47,0.020833333333333332,0.020833333333333332,0.9791666666666666,48,1300,900,400,0.6923076923076923,17,9,8,320.8668356461787,0.8387263593380615,0.2269958754967769,0.17529129100079432,128607.98306439628,-1247.9292973010154,127360.05376709526,1565,0,495.5416666666667,40,8,19,38.28106736131984,0.59921875,46.41768292682927,1014.3292682926837,25.358231707317092,7
1574,4,1,2,46,0.020833333333333332,0.041666666666666664,0.9583333333333334,48,1150,900,250,0.782608695652174,14,9,5,318.6379572765957,0.8401854314420804,0.24797297297297272,0.17509313493911952,128840.02267995241,-1389.3356715579384,127450.68700839447,1566,0,496.4375,40,8,21,38.10164330997662,0.6015625,46.1890243902439,1015.2439024390244,25.38109756097561,0
1575,4,0,0,46,0.0,0.0,1.0,46,1300,1000,300,0.7692307692307693,16,10,6,331.24476454293665,0.8309782608695653,0.2576109839816938,0.18168737085207243,128767.28121119132,-669.3024508729741,128097.97876031835,1567,2,516.304347826087,38,8,22,37.85570175438596,0.6041666666666667,46.260683760683754,1014.9572649572638,26.70940170940168,0
1576,4,1,0,47,0.02127659574468085,0.0,1.0,47,1200,900,300,0.75,15,9,6,326.07967473737017,0.8345282146160962,0.2636945592549378,0.18022137263813273,129069.04432508662,-982.6416015625186,128086.40272352411,1568,0,506.29787234042556,39,8,23,37.67992909618998,0.6055021367521368,45.96354166666666,1016.1458333333319,26.05502136752133,0
1577,4,0,1,46,0.0,0.02127659574468085,0.9787234042553191,47,1200,900,300,0.75,15,9,6,324.6925673023175,0.8349522047486895,0.2671457789135383,0.17981555458206658,129148.44292534713,-1013.2921006944487,128135.15082465268,1569,1,507.29787234042556,39,8,23,37.634505021520816,0.6063034188034189,45.885416666666664,1016.4583333333326,26.06303418803417,0
1578,4,0,1,45,0.0,0.021739130434782608,0.9782608695652174,46,1450,1200,250,0.8275862068965517,17,12,5,330.7201050516509,0.8308373590982286,0.27482823092711794,0.18277041947392492,129065.65176647298,-663.0788178464604,128402.57294862652,1570,2,518.9130434782609,38,8,24,37.565494339887124,0.6071820175438598,45.966880341880334,1016.1324786324778,26.740328385065208,0
1579,4,2,1,46,0.0425531914893617,0.02127659574468085,0.9787234042553191,47,600,300,300,0.5,9,3,6,340.2599905988097,0.8413891458526056,0.2955062863685769,0.1884303580068144,129147.08547921678,-600.2337643363439,128546.85171488044,1571,0,488.9574468085106,38,9,24,37.240295003853966,0.6080043859649124,45.88675213675213,1016.4529914529905,26.748762932973435,2
1580,4,1,0,47,0.02127659574468085,0.0,1.0,47,1750,1400,350,0.8,21,14,7,337.49844041978713,0.8399244526672833,0.2960337637864594,0.1883537598037306,129452.33298947733,-661.9964871954692,128790.33650228186,1572,0,489.8723404255319,37,10,21,37.0002110045613,0.6128941441441442,45.586622807017534,1017.6535087719283,27.50414888572779,0
1581,4,1,0,48,0.020833333333333332,0.0,1.0,48,1450,1100,350,0.7586206896551724,18,11,7,328.6758497027198,0.8438977541371159,0.2974073316980097,0.1852398913301506,129837.58680555565,-1065.104166666663,128772.48263888899,1573,0,480.6458333333333,39,9,22,36.83394657944943,0.6132478632478633,45.208333333333336,1019.1666666666674,26.13247863247865,0
1582,4,1,1,48,0.02040816326530612,0.02040816326530612,0.9795918367346939,49,1450,1000,450,0.6896551724137931,19,10,9,319.25160516348535,0.8491354875283447,0.29701151667357495,0.18177795477676,130236.65229030345,-1484.347941040381,128752.30434926307,1574,0,471.81632653061223,40,9,23,36.670317270675696,0.615625,44.81707317073171,1020.7317073170736,25.51829268292684,0
1583,4,0,0,48,0.0,0.0,1.0,48,1100,700,400,0.6363636363636364,15,7,8,326.6638612152799,0.8447473404255319,0.30270779393215186,0.18575076411799754,130184.79100568431,-1094.6666997157959,129090.12430596851,1575,1,482.4583333333333,40,8,23,36.53364203677884,0.6151041666666668,44.86788617886178,1020.5284552845518,25.513211382113795,0
1584,4,1,0,49,0.02040816326530612,0.0,1.0,49,1000,800,200,0.8,12,8,4,335.41217719484195,0.8486394557823129,0.33848296997980065,0.18683606068077713,129377.95380015444,-1069.95347247467,128308.00032767977,1576,0,473.59183673469386,35,14,22,37.12883959044369,0.6160714285714286,45.65972222222223,1017.3611111111121,29.067460317460345,5
1585,4,1,1,49,0.02,0.02,0.98,50,1100,800,300,0.7272727272727273,14,8,6,325.3485686273857,0.8535544217687074,0.33319770013268446,0.18253427138127032,129659.75265806359,-1563.0770128236209,128096.67564523997,1577,0,465.1,36,14,19,37.09895142267433,0.6168981481481481,45.38288288288289,1018.4684684684694,28.290790790790815,0
1586,4,2,1,50,0.0392156862745098,0.0196078431372549,0.9803921568627451,51,1700,1400,300,0.8235294117647058,20,14,6,317.5017983828655,0.85640522875817,0.3362314075366788,0.17999507802290066,130066.77685682144,-1940.7128876192553,128126.06396920218,1578,0,456.94117647058823,37,14,20,36.88673456591063,0.6190878378378377,44.98355263157895,1020.0657894736851,27.56934566145095,0
1587,4,1,2,49,0.0196078431372549,0.0392156862745098,0.9607843137254902,51,1600,1200,400,0.75,20,12,8,315.03540191586825,0.8563071895424837,0.3372549019607838,0.17949691504508786,130262.58680555568,-1992.5347222222135,128270.05208333346,1579,0,457.921568627451,37,14,21,36.7517006802721,0.6210585585585585,44.79166666666667,1020.8333333333344,27.59009009009012,0
1588,4,0,0,49,0.0,0.0,1.0,49,1150,800,350,0.6956521739130435,15,8,7,321.0711015424391,0.8532454648526078,0.32743604008207394,0.18239656746558267,130147.65346004798,-1442.6699080837457,128704.98355196424,1580,1,464.2857142857143,36,13,22,36.713892874222886,0.6218171296296295,44.90427927927929,1020.3828828828836,28.343968968968987,0
1589,4,3,3,49,0.057692307692307696,0.057692307692307696,0.9423076923076923,52,1200,700,500,0.5833333333333334,17,7,10,297.99004089170313,0.8625094268476621,0.31024677077308693,0.17231598016781097,130835.79881656807,-2602.3962657083694,128233.4025508597,1581,0,438.4423076923077,38,14,16,36.60910087719299,0.625,44.23076923076923,1023.0769230769232,26.923076923076927,0
1590,4,0,0,49,0.0,0.0,1.0,49,750,300,450,0.4,12,3,9,320.9247999973698,0.8518282312925171,0.32638259292837724,0.1834093546098957,130380.7656035665,-1431.5157750342978,128949.2498285322,1582,3,466.2857142857143,35,14,22,36.481943185252334,0.6261904761904762,44.675925925925924,1021.2962962962961,29.179894179894173,0
1591,4,0,0,49,0.0,0.0,1.0,49,1300,700,600,0.5384615384615384,19,7,12,318.1849307833885,0.8522534013605443,0.32250431308862093,0.1823684066328291,130492.60567577714,-1495.843859061763,128996.76181671539,1583,4,467.2857142857143,36,13,17,36.438930526470486,0.6252893518518519,44.56644144144144,1021.7342342342343,28.38150650650651,0
1592,4,0,0,49,0.0,0.0,1.0,49,1300,1000,300,0.7692307692307693,16,10,6,316.92561962923713,0.8513321995464853,0.3168571968231977,0.18205170403512386,130578.91506371241,-1523.2392865838817,129055.67577712853,1584,5,468.2857142857143,36,13,17,36.38396136330247,0.6261574074074074,44.48198198198198,1022.0720720720725,28.3908908908909,0
1593,4,1,2,48,0.02,0.04,0.96,50,1750,1400,350,0.8,21,14,7,307.67506797078033,0.853095238095238,0.3106480985538307,0.17850508138640342,130963.11034404801,-1941.1832246460558,129021.92711940195,1585,0,459.9,37,13,17,36.23315033029818,0.6280968468468469,44.1063596491228,1023.5745614035075,27.66417733522993,0
1594,4,0,0,48,0.0,0.0,1.0,48,1450,700,750,0.4827586206896552,22,7,15,327.9810520115649,0.8432328605200945,0.33159368635437936,0.1894572900443271,130794.81336805534,-1020.3559027778037,129774.45746527753,1586,8,479.9375,35,13,19,35.88340122199592,0.6303571428571431,44.27083333333332,1022.9166666666649,29.226190476190425,0
1595,4,0,0,48,0.0,0.0,1.0,48,950,600,350,0.631578947368421,13,6,7,329.29750196458156,0.8430851063829787,0.3332851876306815,0.19071551308809115,130895.62694028477,-979.2794060952976,129916.34753418947,1587,9,480.9375,36,12,19,35.74795495396354,0.6293402777777779,44.17229729729729,1023.3108108108099,28.425300300300275,0
1596,4,0,0,48,0.0,0.0,1.0,48,1400,900,500,0.6428571428571429,19,9,10,332.82783259893546,0.8412935874704491,0.33225661608386536,0.1937731312198922,131097.3705969481,-873.4292569596805,130223.94133998842,1588,10,481.9375,36,12,20,35.454008137233345,0.6313657407407408,43.975225225225216,1024.0990990990977,28.447197197197156,0
1597,4,0,0,48,0.0,0.0,1.0,48,1150,700,450,0.6086956521739131,16,7,9,335.2668829177928,0.8407764479905437,0.33591715712502235,0.1959392758515805,131243.84576263846,-799.6569858033308,130444.18877683513,1589,11,482.9375,37,11,23,35.24378009630819,0.6309121621621622,43.83223684210526,1024.6710526315785,27.693812233285904,0
1598,4,0,0,48,0.0,0.0,1.0,48,1300,1100,200,0.8461538461538461,15,11,4,337.4314230947188,0.8412197104018913,0.3316395663956637,0.19763840495547824,131328.12500000012,-737.1527777777646,130590.97222222235,1590,12,483.9375,37,11,23,35.10331978319783,0.6317567567567567,43.75000000000001,1025.000000000001,27.702702702702727,0
1599,4,0,0,48,0.0,0.0,1.0,48,1500,1100,400,0.7333333333333333,19,11,8,337.69670454932054,0.8393727836879432,0.33112062294447653,0.19858410305067553,131480.69905045352,-719.8802437641743,130760.81880668935,1591,13,484.9375,34,14,23,34.94268717353452,0.6393995098039216,43.601190476190474,1025.595238095238,30.16456582633053,0
1600,4,0,0,48,0.0,0.0,1.0,48,1000,700,300,0.7,13,7,6,338.05059404498047,0.8394097222222222,0.33138927576601684,0.19895108731499664,131511.22448979586,-708.5104875283487,130802.71400226752,1592,14,485.9375,34,14,23,34.90284548127515,0.6397058823529411,43.57142857142857,1025.714285714285,30.168067226890738,0
1601,4,0,0,48,0.0,0.0,1.0,48,1150,800,350,0.6956521739130435,15,8,7,339.38287128781224,0.8394651300236406,0.3337176586610977,0.2002149875174301,131602.82206632654,-667.2512755102115,130935.57079081633,1593,15,486.9375,34,14,19,34.77636616776888,0.640625,43.482142857142854,1026.0714285714284,30.178571428571423,0
1602,4,0,0,48,0.0,0.0,1.0,48,1500,1000,500,0.6666666666666666,20,10,10,338.1834926245324,0.8376182033096926,0.33863264961117956,0.20071586154230614,131832.80452942822,-683.2643443501329,131149.54018507808,1594,16,487.9375,35,13,19,34.57551466997257,0.6407738095238094,43.258101851851855,1026.967592592593,29.34193121693123,0
1603,4,0,0,48,0.0,0.0,1.0,48,2100,1700,400,0.8095238095238095,25,17,8,333.1683310058428,0.8380429964539007,0.33309812196280464,0.1982710165535751,131934.82069485035,-808.6991975083085,131126.12149734204,1595,17,488.9375,36,12,19,34.60164784975701,0.6397569444444444,43.15878378378379,1027.3648648648657,28.537912912912937,0
1604,4,0,0,48,0.0,0.0,1.0,48,1800,1500,300,0.8333333333333334,21,15,6,331.7610667152364,0.838707890070922,0.28569559228650143,0.19043211134982754,130550.14209733397,-911.2172561074404,129638.92484122653,1596,18,489.9375,36,12,17,36.033976124885214,0.6258680555555556,44.510135135135144,1021.9594594594607,28.387762762762797,6
1605,4,0,0,48,0.0,0.0,1.0,48,950,700,250,0.7368421052631579,12,7,5,339.0401704434594,0.8380984042553191,0.3091377255703094,0.19186146061511403,129996.88042534742,-785.1671006944246,129211.713324653,1597,19,490.9375,39,9,21,36.40832482124617,0.6148504273504274,45.05208333333334,1019.7916666666682,26.14850427350431,3
1606,4,1,1,48,0.02040816326530612,0.02040816326530612,0.9795918367346939,49,1150,800,350,0.6956521739130435,15,8,7,333.02790503956663,0.8446357709750567,0.308038317367763,0.1897484575225439,130262.58680555568,-1123.7847222222126,129138.80208333346,1598,0,481.8979591836735,40,9,21,36.292517006802726,0.6158854166666666,44.79166666666667,1020.8333333333344,25.52083333333336,0
1607,4,0,0,48,0.0,0.0,1.0,48,1150,700,450,0.6086956521739131,16,7,9,339.1529481567579,0.8380984042553191,0.3110497261066305,0.1928427993669046,130182.84640842052,-769.6207682291276,129413.22564019139,1599,21,492.9375,39,9,21,36.21697543465688,0.6167200854700854,44.869791666666686,1020.5208333333364,26.167200854700933,0
1608,4,0,0,48,0.0,0.0,1.0,48,1300,1000,300,0.7692307692307693,16,10,6,337.63911700626306,0.8359559692671394,0.3113328922217322,0.1928029920033243,130348.8201038875,-797.7546532755496,129551.06545061195,1600,22,493.9375,36,12,22,36.08752389354508,0.6238425925925927,44.7072072072072,1021.1711711711698,28.36586586586583,0
1609,4,0,0,48,0.0,0.0,1.0,48,1250,1000,250,0.8,15,10,5,336.7551243778561,0.8362145390070922,0.30729446173661046,0.19284250115725154,130458.54403518378,-813.4833554555441,129645.06067972824,1601,23,494.9375,37,11,22,35.99904744016312,0.6230292792792793,44.599780701754376,1021.6008771929814,27.610834518729227,0
1610,4,0,0,48,0.0,0.0,1.0,48,1000,700,300,0.7,13,7,6,340.3516366114682,0.8361776004728132,0.3130990701001428,0.1953249540159411,130542.57079101252,-713.9244767620931,129828.64631425042,1602,24,495.9375,37,11,18,35.822156652360526,0.6238738738738739,44.517543859649116,1021.9298245614027,27.619724988146018,0
1611,4,1,0,49,0.02040816326530612,0.0,1.0,49,1850,1600,250,0.8648648648648649,21,16,5,334.6829903984035,0.8416950113378685,0.31476289889651143,0.19408371961360185,130945.12473518867,-1034.9788151070347,129910.14592008163,1603,0,486.7959183673469,38,11,20,35.56019485038275,0.6260964912280702,44.12393162393162,1023.5042735042722,26.93432298695453,0
1612,4,1,0,50,0.02,0.0,1.0,50,1700,1500,200,0.8823529411764706,19,15,4,327.5076230916476,0.8460204081632653,0.31224804585721744,0.191963081463919,131355.50356353621,-1395.4549501424713,129960.04861339374,1604,0,478.04,38,12,22,35.33003300330033,0.6302083333333335,43.72329059829059,1025.106837606836,26.976495726495685,0
1613,4,0,0,50,0.0,0.0,1.0,50,1350,1000,350,0.7407407407407407,17,10,7,325.4470037234698,0.8461394557823129,0.30785580329235307,0.19116525959228037,131437.65637555686,-1444.8017112280127,129992.85466432886,1605,1,479.04,38,12,22,35.30010592484545,0.631030701754386,43.643162393162385,1025.427350427349,26.984930274403922,0
1614,4,0,0,50,0.0,0.0,1.0,50,1450,1300,150,0.896551724137931,16,13,3,326.28087110453487,0.8455272108843537,0.31354025622330983,0.1920676053632518,131519.8348696945,-1417.5187422383103,130102.31612745617,1606,2,480.04,38,12,22,35.19598652918099,0.6318530701754387,43.56303418803418,1025.747863247862,26.993364822312156,0
1615,4,1,0,51,0.0196078431372549,0.0,1.0,51,1600,1200,400,0.75,20,12,8,321.2172741671046,0.850686274509804,0.32083762564093665,0.1908608459733641,131875.56932257576,-1727.8578185934407,130147.71150398231,1607,0,471.6078431372549,40,11,19,34.96813264734012,0.63203125,43.21646341463414,1027.1341463414626,25.678353658536565,0
1616,4,1,0,52,0.019230769230769232,0.0,1.0,52,1400,1300,100,0.9285714285714286,15,13,2,315.5409385793068,0.8535539215686274,0.31892788739922584,0.18856027713718396,132091.88102324228,-2063.920776644026,130027.96024659826,1608,0,463.5192307692308,41,11,21,34.89673808145147,0.6326219512195124,43.005952380952365,1027.9761904761876,25.072590011614334,0
1617,4,0,1,51,0.0,0.019230769230769232,0.9807692307692307,52,1450,1100,350,0.7586206896551724,18,11,7,317.74390884222095,0.8525012569130215,0.3256986598198255,0.1903892115062693,132193.8824719701,-1999.2398116654238,130194.64266030469,1609,1,464.5192307692308,41,11,21,34.737764486462154,0.633638211382114,42.906746031746025,1028.3730158730145,25.082268679829625,0
1618,4,0,0,51,0.0,0.0,1.0,51,1900,1400,500,0.7368421052631579,24,14,10,320.8019930844102,0.8480065359477125,0.33269057719501216,0.19300221996934439,132346.95845930948,-1708.5663895187906,130638.39206979069,1610,2,472.7843137254902,41,10,22,34.50555984059648,0.6351626016260163,42.7579365079365,1028.9682539682526,25.0967866821525,0
1619,4,0,0,51,0.0,0.0,1.0,51,1350,700,650,0.5185185185185185,20,7,13,321.80938145140374,0.8483660130718955,0.33389747978832696,0.1941689475806787,132455.95838659615,-1674.8367829127078,130781.12160368344,1611,3,473.7843137254902,36,15,22,34.370327827006534,0.6449652777777778,42.65202702702703,1029.3918918918926,28.594219219219237,0
1620,4,1,1,51,0.019230769230769232,0.019230769230769232,0.9807692307692307,52,1300,900,400,0.6923076923076923,17,9,8,308.8169293605249,0.8515585721468073,0.3184852024331417,0.18799647644504447,132790.50684942814,-2198.408685306377,130592.09816412177,1612,0,465.65384615384613,40,12,18,34.36986458949581,0.6411458333333334,42.32723577235772,1030.6910569105682,25.767276422764205,0
1621,4,0,0,51,0.0,0.0,1.0,51,2000,1600,400,0.8,24,16,8,315.97422363504666,0.8465359477124184,0.3176188349736029,0.1924880811009175,132816.69439693625,-1806.6696204309692,131010.02477650528,1613,5,475.7843137254902,40,11,18,34.15923132538039,0.6414062500000001,42.30182926829268,1030.7926829268285,25.769817073170714,0
1622,4,0,1,50,0.0,0.0196078431372549,0.9803921568627451,51,1200,700,500,0.5833333333333334,17,7,10,315.6059058702941,0.8455228758169936,0.3174754128780848,0.19239821569400617,132842.88452640624,-1814.80021812414,131028.0843082821,1614,6,476.7843137254902,40,11,18,34.14251445846477,0.6416666666666667,42.27642276422764,1030.8943089430893,25.772357723577233,0
1623,4,1,1,50,0.0196078431372549,0.0196078431372549,0.9803921568627451,51,1450,1200,250,0.8275862068965517,17,12,5,313.3936263769394,0.8495751633986929,0.30121222278085047,0.18203502127852011,131008.00781249999,-1985.610649456342,129022.39716304364,1615,0,475.94117647058823,39,12,15,36.0415818749152,0.625,44.0625,1023.7499999999999,26.249999999999996,5
1624,4,0,0,50,0.0,0.0,1.0,50,1150,500,650,0.43478260869565216,18,5,13,320.43030670194054,0.8466496598639456,0.3089269311064715,0.18581854347485421,130945.12473518887,-1608.2427039959066,129336.88203119297,1616,1,486.32,38,12,16,35.92488691718858,0.6260964912280702,44.123931623931625,1023.5042735042739,26.934322986954577,0
1625,4,0,0,50,0.0,0.0,1.0,50,1300,800,500,0.6153846153846154,18,8,10,319.5907141685096,0.8470748299319728,0.3031549295774647,0.18599131726200152,131081.84633875746,-1621.491822813929,129460.35451594353,1617,2,487.32,38,12,18,35.80855503390714,0.6274671052631577,43.99038461538462,1024.0384615384621,26.948380566801635,0
1626,4,0,0,50,0.0,0.0,1.0,50,1800,1300,500,0.7222222222222222,23,13,10,318.0717299173851,0.8461394557823129,0.3046558910236863,0.18591037475919892,131248.05908203137,-1650.7405598958178,129597.31852213555,1618,3,488.32,39,11,20,35.68002185625699,0.627403846153846,43.82812500000001,1024.687500000001,26.274038461538485,0
1627,4,0,0,50,0.0,0.0,1.0,50,1200,800,400,0.6666666666666666,16,8,8,319.9153942758941,0.8449829931972789,0.3117073170731708,0.1873790166473093,131328.125,-1597.1733940972233,129730.95160590278,1619,4,489.32,37,13,20,35.552168021680224,0.6317567567567568,43.75,1025.0,27.7027027027027,0
1628,4,0,1,49,0.0,0.02,0.98,50,1350,1000,350,0.7407407407407407,17,10,7,319.1903519161598,0.8446768707482993,0.3140549791421541,0.1870915736717352,131356.22409058549,-1614.472121229621,129741.75196935586,1620,5,490.32,37,13,20,35.54245997789424,0.6320382882882883,43.72258771929824,1025.1096491228063,27.70566619250828,0
1629,4,0,0,49,0.0,0.0,1.0,49,1650,1400,250,0.8484848484848485,19,14,5,326.06935971905676,0.8409509637188208,0.3235443798523474,0.19112745534594813,131356.983567182,-1233.7024947244572,130123.28107245755,1621,6,500.9795918367347,36,13,20,35.36540151598372,0.6339699074074074,43.721846846846844,1025.1126126126123,28.475350350350343,0
1630,4,1,1,49,0.02,0.02,0.98,50,1450,1100,350,0.7586206896551724,18,11,7,320.6693214993614,0.8426020408163265,0.31592422980849344,0.18971618478853824,131711.68456424848,-1552.8206954489174,130158.86386879957,1622,0,491.94,38,12,18,35.146926172633904,0.6337719298245614,43.37606837606837,1026.495726495725,27.013045434098025,0
1631,4,1,0,50,0.02,0.0,1.0,50,1300,1200,100,0.9230769230769231,14,12,2,318.4554322422716,0.8433503401360544,0.3194341344691207,0.1892880661447282,131889.27001953125,-1599.8291015624986,130289.44091796875,1623,0,492.92,39,11,19,35.025289017341045,0.6338141025641026,43.203125,1027.1875,26.338141025641026,0
1632,4,0,0,50,0.0,0.0,1.0,50,1300,1000,300,0.7692307692307693,16,10,6,313.4444286050144,0.8421598639455782,0.31170079059395994,0.18696751708688455,132023.0523003471,-1723.6219618055609,130299.43033854154,1624,1,493.92,39,11,19,35.019680383809735,0.6351495726495726,43.072916666666664,1027.7083333333326,26.351495726495706,0
1633,4,1,0,51,0.0196078431372549,0.0,1.0,51,1950,1500,450,0.7692307692307693,24,15,9,309.52756477157345,0.8448366013071896,0.3156773671348858,0.18634221883929553,132371.85723610266,-2005.4522770837568,130366.40495901891,1625,0,485.2156862745098,40,11,21,34.770639936796385,0.6369791666666667,42.73373983739837,1029.065040650405,25.726626016260127,0
1634,4,0,1,50,0.0,0.0196078431372549,0.9803921568627451,51,1700,1400,300,0.8235294117647058,20,14,6,306.66407462303084,0.8436274509803923,0.3079850042869783,0.18526021109158736,132502.61423631743,-2073.241684017475,130429.37255229996,1626,1,486.2156862745098,40,11,21,34.71337972559469,0.6382812500000001,42.60670731707316,1029.5731707317054,25.739329268292636,0
1635,4,0,0,50,0.0,0.0,1.0,50,1300,700,600,0.5384615384615384,19,7,12,305.255603052232,0.8431972789115646,0.29755351681957154,0.18518109204910066,132659.60784131457,-1900.9822815453936,130758.62555976918,1627,2,484.22,40,10,17,34.59254052809837,0.6398437500000002,42.45426829268292,1030.1829268292672,25.754573170731682,0
1636,4,0,0,50,0.0,0.0,1.0,50,1650,1200,450,0.7272727272727273,21,12,9,307.111117261591,0.8424319727891156,0.29988564668769757,0.18721966186908504,132842.88452640607,-1840.4946625685977,131002.38986383747,1628,3,485.22,40,10,17,34.36144518927445,0.6416666666666668,42.27642276422763,1030.894308943088,25.772357723577198,0
1637,4,0,0,50,0.0,0.0,1.0,50,700,500,200,0.7142857142857143,9,5,4,307.71642625984356,0.8420068027210884,0.29883292262198125,0.18771997260409543,132869.07723783763,-1822.800478385912,131046.27675945172,1629,4,486.22,40,10,17,34.31965664530966,0.6419270833333335,42.25101626016259,1030.9959349593473,25.77489837398368,0
1638,4,0,2,48,0.0,0.04,0.96,50,1250,900,350,0.72,16,9,7,309.29311220385046,0.8420918367346939,0.2989118864577176,0.18881395405657403,132895.27253123117,-1779.2815123273447,131115.99101890382,1630,5,487.22,40,10,17,34.25282541559893,0.6421875000000001,42.22560975609755,1031.0975609756076,25.77743902439019,0
1639,4,1,0,49,0.02040816326530612,0.0,1.0,49,1250,800,450,0.64,17,8,9,309.214323473214,0.8406320861678005,0.28236888292899676,0.18942876267812866,133026.28772762563,-1573.2732872298327,131453.0144403958,1613,0,463.734693877551,40,9,19,34.12389583949036,0.6434895833333334,42.09857723577235,1031.6056910569098,25.790142276422745,0
1640,4,0,0,49,0.0,0.0,1.0,49,1000,700,300,0.7,13,7,6,320.61249858346514,0.840029761904762,0.26553524699223763,0.1968258349828601,133104.92782900395,-1256.293583515101,131848.63424548885,1614,1,464.734693877551,40,9,15,33.75127207668571,0.6442708333333333,42.02235772357724,1031.9105691056914,25.797764227642283,2
1641,4,0,1,48,0.0,0.02040816326530612,0.9795918367346939,49,1000,600,400,0.6,14,6,8,322.96798591701736,0.8392857142857143,0.2669053445359233,0.19883083642091331,133209.8174449736,-1195.4987110846373,132014.31873388897,1615,2,465.734693877551,40,9,15,33.58559755857452,0.6453124999999998,41.92073170731709,1032.3170731707346,25.807926829268364,0
1642,4,0,0,48,0.0,0.0,1.0,48,900,500,400,0.5555555555555556,13,5,8,330.5792828590027,0.8360298463356973,0.2704337841929949,0.2030408527764504,133122.62505425367,-798.4836154513669,132324.1414388023,1616,3,476.2291666666667,39,9,15,33.476435012280874,0.6461004273504273,42.00520833333334,1031.9791666666683,26.461004273504315,0
1643,4,1,1,48,0.02040816326530612,0.02040816326530612,0.9795918367346939,49,1800,1500,300,0.8333333333333334,21,15,6,332.9222057264974,0.8374433106575964,0.30310065666645203,0.20295449849096084,132842.8845264062,-954.7307736796959,131888.1537527265,1617,0,467.48979591836735,40,9,16,33.69623258412198,0.6416666666666667,42.27642276422764,1030.894308943089,25.772357723577226,1
1644,4,0,0,48,0.0,0.0,1.0,48,1200,800,400,0.6666666666666666,16,8,8,341.828502567044,0.8343491430260047,0.31543860092283893,0.20844588354319366,132854.0161132812,-517.3421223958348,132336.67399088535,1618,1,478.0208333333333,39,9,17,33.455529453369714,0.6434294871794872,42.265625,1030.9374999999995,26.43429487179486,0
1645,4,0,0,48,0.0,0.0,1.0,48,1700,1500,200,0.8823529411764706,19,15,4,338.1106334596142,0.8335180260047281,0.31040467535090355,0.2070692395269364,133015.14892578137,-605.2327473958196,132409.91617838555,1619,2,479.0208333333333,39,9,18,33.389818741795416,0.6450320512820513,42.10937500000001,1031.562500000001,26.450320512820536,0
1646,4,0,0,48,0.0,0.0,1.0,48,950,700,250,0.7368421052631579,12,7,5,340.39427055767766,0.8334810874704491,0.31271033148241556,0.2087681269271704,133068.8815646704,-540.8230251735853,132528.0585394968,1620,3,480.0208333333333,39,9,18,33.277069661786975,0.6455662393162392,42.05729166666668,1031.7708333333353,26.455662393162445,0
1647,4,1,0,49,0.02040816326530612,0.0,1.0,49,1350,900,450,0.6666666666666666,18,9,9,309.55969742636074,0.8370181405895691,0.26345537744243597,0.18624444345442076,132348.14544085402,-1597.8637908042315,130750.28165004979,1621,0,471.2040816326531,42,7,20,34.79356970210628,0.6336805555555556,42.75678294573644,1028.972868217055,24.499354005167977,3
1648,4,0,0,49,0.0,0.0,1.0,49,1350,900,450,0.6666666666666666,18,9,9,310.3686108213872,0.8366284013605443,0.23408031294749332,0.18534462113662212,132066.38681224806,-1602.1290188569828,130464.25779339108,1622,1,472.2040816326531,41,8,14,35.05523517678475,0.6323678861788617,43.03075396825397,1027.8769841269843,25.070170344560594,1
1649,4,0,0,49,0.0,0.0,1.0,49,900,600,300,0.6666666666666666,12,6,6,309.7613521614839,0.8367701247165533,0.23157869863499192,0.18535604236729916,132142.87682665666,-1613.448759133278,130529.42806752339,1623,2,473.2040816326531,41,8,15,34.99413032291265,0.6331300813008129,42.95634920634921,1028.1746031746038,25.077429345722045,0
1650,4,0,2,47,0.0,0.04081632653061224,0.9591836734693877,49,1700,1400,300,0.8235294117647058,20,14,6,311.4345758680876,0.8349277210884354,0.2307191176210095,0.1869869784120555,132270.40939350266,-1561.2842301272458,130709.12516337541,1624,3,474.2040816326531,41,8,16,34.823251197479685,0.6344004065040652,42.832341269841265,1028.670634920634,25.089527680991075,0
1651,4,1,1,47,0.020833333333333332,0.020833333333333332,0.9791666666666666,48,900,800,100,0.8888888888888888,10,8,2,313.0286365979784,0.8341090425531915,0.21843297101449255,0.18766882715471217,132215.03404058426,-1322.581631304124,130892.45240928013,1625,0,484.6875,40,8,16,34.83777997364954,0.6354166666666667,42.886178861788615,1028.4552845528451,25.711382113821127,0
1652,4,0,1,46,0.0,0.02127659574468085,0.9787234042553191,47,900,600,300,0.6666666666666666,12,6,6,320.38450504466806,0.8284767190872648,0.2247201667467782,0.1917838356152768,132156.9023980033,-931.795247395858,131225.10715060742,1626,5,496.0,39,8,16,34.706991017458535,0.6364850427350428,42.94270833333332,1028.2291666666652,26.364850427350387,0
1653,4,0,0,46,0.0,0.0,1.0,46,1650,1400,250,0.8484848484848485,19,14,5,322.8350706311935,0.8275161030595813,0.208313522461127,0.19393668841567313,132290.82031249997,-658.3767361111107,131632.44357638885,1627,6,495.7173913043478,39,7,17,34.50958552720402,0.6378205128205128,42.8125,1028.7499999999998,26.37820512820512,0
1654,4,0,0,46,0.0,0.0,1.0,46,1200,700,500,0.5833333333333334,17,7,10,322.8350706311935,0.8276972624798712,0.208313522461127,0.19393668841567313,132290.82031249997,-658.3767361111107,131632.44357638885,1628,7,496.7173913043478,39,7,17,34.50958552720402,0.6378205128205128,42.8125,1028.7499999999998,26.37820512820512,0
1655,4,0,0,46,0.0,0.0,1.0,46,1650,1400,250,0.8484848484848485,19,14,5,323.067088462358,0.8270531400966183,0.20568561872909652,0.19462822158585932,132398.00347222204,-645.3125000000255,131752.69097222202,1629,8,497.7173913043478,39,7,17,34.39608636977057,0.6388888888888891,42.70833333333332,1029.1666666666652,26.38888888888885,0
1656,4,0,0,46,0.0,0.0,1.0,46,1250,800,450,0.64,17,8,9,323.16250695926675,0.8262479871175523,0.20315509855834724,0.19551924992651826,132558.85959201373,-632.3893229166902,131926.47026909704,1630,9,498.7173913043478,39,7,19,34.23233191718927,0.6404914529914532,42.55208333333332,1029.7916666666654,26.404914529914496,0
1657,4,0,2,44,0.0,0.043478260869565216,0.9565217391304348,46,1500,1400,100,0.9333333333333333,16,14,2,323.4240651676526,0.825462962962963,0.20408930432144623,0.1960969086721591,132639.3242730034,-620.2501085069548,132019.07416449644,1631,10,499.7173913043478,39,7,15,34.14494640509657,0.6412927350427351,42.47395833333333,1030.104166666666,26.412927350427335,0
1658,4,1,0,45,0.022222222222222223,0.0,1.0,45,1000,800,200,0.8,12,8,4,321.6703514448406,0.8312710437710438,0.19351477589149413,0.1960129185897869,132827.1701388887,-454.68750000001967,132372.48263888867,1632,0,483.84444444444443,39,6,16,34.00195365130694,0.6431623931623933,42.29166666666666,1030.8333333333317,26.43162393162389,0
1659,4,0,0,45,0.0,0.0,1.0,45,1650,1100,550,0.6666666666666666,22,11,11,324.17100295888184,0.8303030303030303,0.19456790123456824,0.19810450180820557,132934.57031249997,-381.2934027777772,132553.2769097222,1633,1,484.84444444444443,39,6,17,33.82996632996634,0.6442307692307692,42.1875,1031.2499999999998,26.442307692307686,0
1660,4,0,0,45,0.0,0.0,1.0,45,1300,900,400,0.6923076923076923,17,9,8,323.27141854207485,0.8299242424242425,0.18772213247172864,0.19812377037380643,133042.01388888896,-398.26388888888465,132643.7500000001,1634,2,485.84444444444443,39,6,17,33.74562466343565,0.6452991452991453,42.083333333333336,1031.6666666666672,26.452991452991466,0
1661,4,0,0,45,0.0,0.0,1.0,45,1350,900,450,0.6666666666666666,18,9,9,323.0885334431041,0.828493265993266,0.18682860112697686,0.19848542390288704,133131.14636005356,-397.37063338620703,132733.77572666734,1635,3,486.84444444444443,40,5,17,33.66116855407846,0.64453125,41.9969512195122,1032.0121951219514,25.800304878048784,0
1662,4,0,0,45,0.0,0.0,1.0,45,1100,700,400,0.6363636363636364,15,7,8,322.94783496400635,0.8283670033670034,0.18838125246159954,0.19853863268126187,133157.3674730649,-399.4232930134235,132757.94418005148,1636,4,487.84444444444443,40,5,17,33.63857161612182,0.6447916666666667,41.97154471544715,1032.1138211382108,25.802845528455272,0
1663,4,1,1,45,0.021739130434782608,0.021739130434782608,0.9782608695652174,46,1450,1200,250,0.8275862068965517,17,12,5,321.27991675338166,0.8305152979066023,0.20248948106591858,0.19919354838709682,133472.2222222223,-623.6111111111013,132848.6111111112,1637,0,478.2173913043478,42,4,18,33.36693548387097,0.6448412698412698,41.66666666666667,1033.3333333333342,24.603174603174622,0
1664,4,1,0,46,0.021739130434782608,0.0,1.0,46,950,600,350,0.631578947368421,13,6,7,325.08526452539354,0.8235909822866345,0.23335084723499255,0.20302494822246311,133741.45507812526,-504.52473958330415,133236.93033854195,1638,0,478.32608695652175,39,7,17,32.99974823766366,0.6522435897435896,41.406250000000014,1034.375000000002,26.52243589743595,0
1665,4,0,0,46,0.0,0.0,1.0,46,1100,900,200,0.8181818181818182,13,9,4,323.92110194783453,0.8240338164251207,0.237011892724734,0.20274154414920248,133822.27783203137,-530.4280598958202,133291.84977213555,1639,1,479.32608695652175,39,7,17,32.949197120708746,0.6530448717948718,41.32812500000001,1034.687500000001,26.53044871794874,0
1666,4,0,0,46,0.0,0.0,1.0,46,900,500,400,0.5555555555555556,13,5,8,323.6559390728681,0.8246175523349437,0.2397955611566196,0.20302054360025373,133903.12500000015,-532.2916666666516,133370.8333333335,1640,2,480.32608695652175,39,7,17,32.875402576489535,0.6538461538461537,41.25000000000001,1035.0000000000011,26.53846153846157,0
1667,4,0,0,46,0.0,0.0,1.0,46,1300,1100,200,0.8461538461538461,15,11,4,322.9028600217597,0.8244162640901772,0.2356476235063505,0.20269650789868798,133930.079481337,-550.7188585069256,133379.36062283005,1641,3,481.32608695652175,39,7,17,32.868005937405655,0.6541132478632479,41.22395833333334,1035.104166666668,26.541132478632516,0
1668,4,0,0,46,0.0,0.0,1.0,46,1200,800,400,0.6666666666666666,16,8,8,322.07719944615195,0.8235305958132045,0.23428445218091065,0.20277197211489523,134037.9245334201,-565.888129340282,133472.03640407982,1642,4,482.32608695652175,39,7,17,32.781850417463026,0.6551816239316239,41.119791666666664,1035.520833333333,26.55181623931623,0
1669,4,0,1,45,0.0,0.021739130434782608,0.9782608695652174,46,950,800,150,0.8421052631578947,11,8,3,320.50598375323653,0.8227657004830918,0.23297531554050255,0.20228591284190367,134129.36377363026,-602.1472627073695,133527.21651092288,1643,5,483.32608695652175,40,6,17,32.731408809967625,0.6544270833333332,41.03150406504066,1035.8739837398386,25.896849593495965,0
1670,4,0,0,45,0.0,0.0,1.0,45,1150,1000,150,0.8695652173913043,13,10,3,326.93434468271766,0.8158249158249159,0.23135164135063557,0.20582991263400238,134037.9245334202,-235.67979600693445,133802.24473741328,1644,6,494.8222222222222,39,6,17,32.65610854038829,0.6551816239316239,41.11979166666667,1035.520833333334,26.551816239316256,0
1671,4,0,0,45,0.0,0.0,1.0,45,1350,900,450,0.6666666666666666,18,9,9,323.7922844145404,0.8130471380471381,0.22908457311352337,0.2049036670073695,134226.75781250006,-307.68229166666606,133919.0755208334,1645,7,495.8222222222222,39,6,17,32.5492561318858,0.657051282051282,40.9375,1036.2500000000005,26.570512820512832,0
1672,4,0,0,45,0.0,0.0,1.0,45,1450,1000,450,0.6896551724137931,19,10,9,328.75014939462613,0.8130892255892256,0.2269097733695593,0.2060100166944908,133866.31350593222,-197.89526220339394,133668.41824372884,1646,8,496.8222222222222,40,5,15,32.78032832498609,0.6518229166666667,41.28556910569105,1034.857723577235,25.871443089430876,1
1673,4,0,1,44,0.0,0.022222222222222223,0.9777777777777777,45,1400,1200,200,0.8571428571428571,16,12,4,330.7941243518943,0.8126683501683503,0.2264760097291758,0.20788400646346417,133971.50262947023,-136.60281991535817,133834.89980955486,1647,9,497.8222222222222,40,5,15,32.622459998036724,0.6528645833333332,41.18394308943091,1035.264227642279,25.881605691056972,0
1674,4,1,0,45,0.022222222222222223,0.0,1.0,45,1500,900,600,0.6,21,9,12,327.04995846199415,0.813425925925926,0.23532539910447414,0.2071977511250732,134267.8819936541,-217.53895423908457,134050.34303941502,1648,0,495.4,41,4,17,32.42388165661595,0.6542174796747966,40.89781746031747,1036.4087301587315,25.278261711188573,0
1675,4,0,0,45,0.0,0.0,1.0,45,1250,1000,250,0.8,15,10,5,326.85239310575935,0.8118265993265994,0.23930936965096383,0.20765558421570182,134370.7200038582,-216.1217206789908,134154.59828317922,1649,1,496.4,41,4,17,32.326551685644134,0.6552337398373982,40.79861111111112,1036.805555555557,25.287940379403828,0
1676,4,0,1,44,0.0,0.022222222222222223,0.9777777777777777,45,1200,900,300,0.75,15,9,6,321.51709305370764,0.8116582491582492,0.23117205354227877,0.20542487610002225,134577.1417889484,-346.10915283652673,134231.03263611186,1650,2,497.4,40,5,17,32.25942703232126,0.6588541666666666,40.59959349593496,1037.6016260162603,25.94004065040651,0
1677,4,0,0,44,0.0,0.0,1.0,44,1450,1000,450,0.6896551724137931,19,10,9,327.27164099812575,0.8115089852008457,0.22637604840696857,0.20910537626570444,134577.80083550356,8.69954427083917,134586.5003797744,1651,3,478.5681818181818,39,5,18,32.109497875046,0.6605235042735043,40.598958333333336,1037.6041666666672,26.605235042735057,0
1678,4,0,1,43,0.0,0.022727272727272728,0.9772727272727273,44,950,600,350,0.631578947368421,13,6,7,338.35336719592044,0.8110685341789994,0.26822389354931975,0.20342392876457344,132321.43964356577,154.28093112244989,132475.72057468822,1652,4,479.5681818181818,41,3,18,34.07970542859897,0.634908536585366,42.782738095238095,1028.8690476190477,25.094367015098726,8
1679,4,0,1,42,0.0,0.023255813953488372,0.9767441860465116,43,1050,900,150,0.8571428571428571,12,9,3,343.08288323045264,0.8075396825396826,0.27462855297157596,0.20584972993827158,132244.89795918364,474.1921768707435,132719.09013605438,1653,15,491.6279069767442,41,2,18,34.035011574074055,0.6341463414634146,42.857142857142854,1028.5714285714282,25.087108013937275,0
1680,4,0,1,41,0.0,0.023809523809523808,0.9761904761904762,42,1100,800,300,0.7272727272727273,14,8,6,350.0445043886565,0.8050474254742548,0.27575632278960827,0.2096020385897413,132168.3784190759,852.9629039115541,133021.34132298746,1654,16,501.95238095238096,41,1,18,33.933007718282674,0.6333841463414634,42.93154761904761,1028.2738095238087,25.079849012775824,0
1681,4,1,1,41,0.023809523809523808,0.023809523809523808,0.9761904761904762,42,950,500,450,0.5263157894736842,14,5,9,346.3818530681777,0.8085559427022841,0.25900317705176956,0.20839168097582011,132346.95845930962,768.5169438145605,133115.47540312418,1655,0,499.3095238095238,41,1,20,33.847538243990236,0.6351626016260162,42.757936507936506,1028.9682539682537,25.09678668215253,0
1682,4,0,0,41,0.0,0.0,1.0,41,1250,900,350,0.72,16,9,7,352.0365119929278,0.8033028455284553,0.2678734078389984,0.21134718709326292,132267.29811124317,1112.5836555621515,133379.88176680534,1656,18,512.4878048780488,40,1,21,33.782231772376996,0.6359375000000002,42.83536585365853,1028.6585365853648,25.71646341463412,0
1683,4,0,0,41,0.0,0.0,1.0,41,800,600,200,0.75,10,6,4,352.7098430117359,0.8027947154471544,0.26581391147244804,0.21219175047497488,132345.71358194528,1135.927172152817,133481.6407540981,1657,19,513.4878048780488,40,1,21,33.68600823045268,0.63671875,42.75914634146341,1028.9634146341464,25.72408536585366,0
1684,4,2,2,41,0.046511627906976744,0.046511627906976744,0.9534883720930233,43,800,600,200,0.75,10,6,4,340.19467439309165,0.8166297526762643,0.2527642362178004,0.20709810250268523,132790.50684942826,434.9453037213324,133225.45215314958,1658,0,490.5581395348837,40,3,15,33.56134555971868,0.6411458333333333,42.327235772357724,1030.6910569105692,25.76727642276423,0
1685,4,0,0,41,0.0,0.0,1.0,41,900,500,400,0.5555555555555556,13,5,8,354.99030455508733,0.802439024390244,0.2657418045440054,0.2146421929298575,132535.4812714587,1209.7621721820283,133745.24344364073,1659,21,515.4878048780488,38,3,22,33.43644082451408,0.6419956140350878,42.57478632478632,1029.7008547008536,27.09739091318036,0
1686,4,0,0,41,0.0,0.0,1.0,41,1300,1100,200,0.8461538461538461,15,11,4,352.2822741378787,0.8019817073170732,0.25875461284945755,0.21378590116498178,132673.0304099092,1147.671373913337,133820.70178382253,1660,22,516.4878048780488,38,3,17,33.36790072245843,0.6433662280701755,42.441239316239304,1030.2350427350411,27.1114484930274,0
1687,4,0,0,41,0.0,0.0,1.0,41,1300,1000,300,0.7692307692307693,16,10,6,354.56961783667924,0.8008638211382114,0.27112921629367825,0.21621537324273649,132854.01611328116,1221.1995442708198,134075.21565755198,1661,23,517.4878048780488,39,2,17,33.12714711528745,0.6434294871794872,42.26562499999999,1030.9374999999993,26.434294871794854,0
1688,4,0,0,41,0.0,0.0,1.0,41,1050,800,250,0.7619047619047619,13,8,5,353.7453880988702,0.8017784552845528,0.2693839745184645,0.21633311226478766,132961.42713758672,1206.898328993047,134168.32546657976,1662,24,518.4878048780488,39,2,17,33.04053883446116,0.6444978632478633,42.16145833333333,1031.354166666666,26.444978632478616,0
1689,4,0,0,41,0.0,0.0,1.0,41,1050,700,350,0.6666666666666666,14,7,7,355.1769171927804,0.8006605691056911,0.2749222942298353,0.21804512800335527,133104.927829004,1255.159585894643,134360.08741489865,1663,25,519.4878048780488,40,1,20,32.85958735473704,0.6442708333333333,42.02235772357724,1031.9105691056918,25.797764227642297,0
1690,4,0,0,41,0.0,0.0,1.0,41,1100,800,300,0.7272727272727273,14,8,6,350.9887351416817,0.8001016260162601,0.2637162107002047,0.21608142857995197,133209.81744497342,1151.0290666931235,134360.84651166655,1664,26,520.4878048780488,40,1,20,32.862440112883114,0.6453125,41.92073170731708,1032.3170731707332,25.807926829268332,0
1691,4,0,0,41,0.0,0.0,1.0,41,950,800,150,0.8421052631578947,11,8,3,349.98818122636214,0.7994918699186991,0.25683695025926623,0.21576941269780614,133262.2777447289,1128.0444427920145,134390.3221875209,1665,27,521.4878048780488,40,1,21,32.83567093175854,0.6458333333333333,41.869918699187004,1032.5203252032538,25.813008130081347,0
1692,4,0,0,41,0.0,0.0,1.0,41,900,800,100,0.8888888888888888,10,8,2,355.1416085202051,0.7987804878048781,0.2621627200330261,0.21925571238045735,133314.74837233144,1269.1228352832477,134583.8712076147,1666,28,522.4878048780488,40,1,21,32.6500278816506,0.6463541666666666,41.81910569105692,1032.7235772357735,25.81808943089434,0
1693,4,0,0,41,0.0,0.0,1.0,41,1050,800,250,0.7619047619047619,13,8,5,357.61986007085795,0.7986788617886179,0.2630749411654638,0.22156740507863598,133445.97012566944,1344.5858326723726,134790.5559583418,1667,29,523.4878048780488,40,1,22,32.45446870594408,0.6476562499999998,41.69207317073172,1033.2317073170746,25.830792682926862,0
1694,4,0,0,41,0.0,0.0,1.0,41,1250,900,350,0.72,16,9,7,359.00104058272586,0.7987804878048781,0.2669158143194328,0.2225806451612904,133472.22222222248,1383.3333333333585,134855.55555555585,1668,30,524.4878048780488,40,1,22,32.39247311827958,0.6479166666666666,41.66666666666668,1033.3333333333353,25.833333333333382,0
1695,4,0,0,41,0.0,0.0,1.0,41,1100,700,400,0.6363636363636364,15,7,8,361.4773150652006,0.7991361788617887,0.26294573643410857,0.22461740676016795,133555.03420857983,1455.4230358316877,135010.45724441152,1669,31,525.4878048780488,38,3,22,32.245478036175705,0.6521381578947368,41.58653846153846,1033.6538461538457,27.201417004048572,0
1696,4,0,0,41,0.0,0.0,1.0,41,1050,700,350,0.6666666666666666,14,7,7,362.97542374402605,0.7986280487804878,0.26423226307286307,0.22588509167658782,133610.25646732782,1499.447891555267,135109.7043588831,1670,32,526.4878048780488,38,3,22,32.15140711653061,0.6526864035087719,41.53311965811966,1033.8675213675217,27.207040035987415,0
1697,4,0,0,41,0.0,0.0,1.0,41,1050,600,450,0.5714285714285714,15,6,9,360.23783969136093,0.7971544715447154,0.2648918536283069,0.22502082347688768,133748.36205164742,1436.2442015486986,135184.6062531961,1671,33,527.4878048780488,38,3,15,32.08380672037458,0.6540570175438596,41.399572649572654,1034.4017094017101,27.221097615834477,0
1698,4,0,0,41,0.0,0.0,1.0,41,650,200,450,0.3076923076923077,11,2,9,357.12003193908356,0.796239837398374,0.260783731108011,0.22374286089016598,133858.89788333708,1360.7387774855797,135219.63666082267,1672,34,528.4878048780488,38,3,15,32.05378037029388,0.6551535087719298,41.292735042735046,1034.8290598290605,27.23234367971212,0
1699,4,0,0,41,0.0,0.0,1.0,41,1350,1100,250,0.8148148148148148,16,11,5,353.17380678031293,0.7944105691056911,0.25456811140574387,0.22267642110441693,134091.86333550367,1271.5467664930754,135363.41010199673,1673,35,529.4878048780488,39,2,16,31.922898018706633,0.655715811965812,41.06770833333334,1035.7291666666683,26.557158119658162,0
1700,4,0,0,41,0.0,0.0,1.0,41,1250,700,550,0.56,18,7,11,353.7428374405661,0.7933943089430894,0.24746277220488055,0.22369230794795383,134199.77349175356,1294.4417317708426,135494.2152235244,1674,36,530.4878048780488,39,2,18,31.800312489527816,0.656784188034188,40.96354166666667,1036.1458333333342,26.567841880341902,0
1701,4,0,0,41,0.0,0.0,1.0,41,1200,900,300,0.75,15,9,6,353.0073936933624,0.7930894308943089,0.24822693296789233,0.22355636918238464,134253.74484592018,1278.5129123263941,135532.2577582466,1675,37,531.4878048780488,39,2,18,31.765441250376924,0.6573183760683761,40.911458333333336,1036.354166666667,26.57318376068377,0
1702,4,0,0,41,0.0,0.0,1.0,41,1050,600,450,0.5714285714285714,15,6,9,334.36594814884035,0.7915142276422764,0.19610279212711745,0.2113872858635887,134190.77932098752,780.8210961612502,134971.6004171488,1676,38,532.4878048780488,38,3,17,32.31121537086683,0.6584429824561404,40.972222222222214,1036.1111111111102,27.266081871345005,2
1703,4,0,0,41,0.0,0.0,1.0,41,900,600,300,0.6666666666666666,12,6,6,335.97813498857226,0.7925813008130081,0.19696177588321628,0.21337250143515052,134356.87413251487,828.194398787321,135185.06853130218,1677,39,533.4878048780488,38,3,18,32.1038145781808,0.6600877192982457,40.8119658119658,1036.7521367521347,27.28295096716144,0
1704,4,0,0,41,0.0,0.0,1.0,41,900,700,200,0.7777777777777778,11,7,4,336.9883923291891,0.7928353658536585,0.1957701468238413,0.2146642593656015,134467.66107823787,862.8081854043236,135330.46926364218,1678,40,534.4878048780488,38,3,18,31.967192006592494,0.6611842105263158,40.7051282051282,1037.1794871794862,27.294197031039108,0
1705,4,0,0,41,0.0,0.0,1.0,41,600,400,200,0.6666666666666666,8,4,4,336.9579812502849,0.7938516260162601,0.1960563663309134,0.21497122194088472,134523.0716725107,865.724532471317,135388.79620498203,1679,41,535.4878048780488,38,3,18,31.912761757638155,0.6617324561403508,40.6517094017094,1037.393162393162,27.299820062977943,0
1706,4,0,0,41,0.0,0.0,1.0,41,1100,600,500,0.5454545454545454,16,6,10,337.27115971233303,0.7921747967479674,0.19622485923749866,0.21583985981590456,134636.11549948042,881.7786163032245,135517.89411578365,1680,42,536.4878048780488,37,4,19,31.792018841345293,0.664695945945946,40.542763157894726,1037.8289473684197,28.04943100995729,0
1707,4,0,0,41,0.0,0.0,1.0,41,1250,900,350,0.72,16,9,7,334.57579205433933,0.7908536585365854,0.19406816020634254,0.2152489261787048,134828.0339711628,822.0392514062246,135650.07322256902,1681,43,537.4878048780488,38,3,18,31.67091005726434,0.6647478070175439,40.357905982905976,1038.5683760683748,27.330746738641444,0
1708,4,0,0,41,0.0,0.0,1.0,41,850,600,250,0.7058823529411765,11,6,5,332.43481076651636,0.7907520325203252,0.18895228540974407,0.2145274409226522,134939.01495954764,771.6851806194584,135710.7001401671,1682,44,538.4878048780488,38,3,18,31.616109682947716,0.6658442982456141,40.25106837606837,1038.9957264957252,27.341992802519083,0
1709,4,0,1,40,0.0,0.024390243902439025,0.975609756097561,41,750,400,350,0.5333333333333333,11,4,7,330.83259337474493,0.7902439024390244,0.1879605924670329,0.21382117181103916,134994.52257515138,732.1175989845606,135726.64017413594,1683,45,539.4878048780488,38,3,19,31.602541036976092,0.6663925438596492,40.19764957264956,1039.2094017094,27.347615834457894,0
1710,4,0,0,40,0.0,0.0,1.0,40,800,500,300,0.625,11,5,6,336.0169310990596,0.7882211538461539,0.1922453825857522,0.21672977686613928,134920.7583703638,1067.1318338334713,135987.89020419726,1684,46,549.75,37,3,19,31.541226912928753,0.6675112612612613,40.268640350877185,1038.92543859649,28.079065908013245,0
1711,4,0,0,40,0.0,0.0,1.0,40,1250,1100,150,0.88,14,11,3,335.0988374618968,0.7870726495726496,0.18361541706211182,0.2175046047673623,135148.68907981287,1057.6337190289173,136206.32279884178,1685,47,550.75,37,3,20,31.338425779465005,0.6697635135135136,40.04934210526315,1039.8026315789461,28.102773826458005,0
1712,4,0,0,40,0.0,0.0,1.0,40,1300,800,500,0.6153846153846154,18,8,10,338.1228720957593,0.7855235042735043,0.18521397702118714,0.22016277883132926,135262.7265721183,1147.0843192135985,136409.8108913319,1686,48,551.75,37,3,20,31.146459189768454,0.6708896396396395,39.93969298245614,1040.2412280701749,28.1146277856804,0
1713,4,0,1,39,0.0,0.025,0.975,40,800,500,300,0.625,11,5,6,338.1228720957593,0.7855235042735043,0.18521397702118714,0.22016277883132926,135262.7265721183,1147.0843192135985,136409.8108913319,1687,49,552.75,37,3,20,31.146459189768454,0.6708896396396395,39.93969298245614,1040.2412280701749,28.1146277856804,0
1714,4,0,0,39,0.0,0.0,1.0,39,700,400,300,0.5714285714285714,10,4,6,334.3167487071152,0.7869995501574449,0.17595029362298864,0.2076021055232685,133530.41174620585,1128.2906217027985,134658.70236790864,1688,50,528.974358974359,36,3,20,32.9719619379676,0.6556712962962963,41.61036036036037,1033.55855855856,28.70995995996,2
1715,4,0,0,39,0.0,0.0,1.0,39,1200,900,300,0.75,15,9,6,337.19031406375393,0.7861560953666217,0.17900686404280353,0.2100462322749925,133646.82883897412,1212.8832379676926,134859.71207694183,1689,51,529.974358974359,36,3,20,32.78130218543526,0.6568287037037037,41.497747747747745,1034.009009009009,28.722472472472475,0
1716,4,0,1,38,0.0,0.02564102564102564,0.9743589743589743,39,650,400,250,0.6153846153846154,9,4,5,335.4872585560101,0.785987404408457,0.17629880282319332,0.2093148765338585,133705.0564077591,1171.2685658631603,134876.32497362228,1690,52,530.974358974359,36,3,15,32.767131242741,0.6574074074074074,41.44144144144144,1034.2342342342342,28.72872872872873,0
1717,4,0,0,38,0.0,0.0,1.0,38,1200,900,300,0.75,15,9,6,342.0065932351009,0.7852358937885254,0.16975363189707005,0.2130744005552574,133651.68065200606,1541.9511959876438,135193.6318479937,1691,53,541.078947368421,35,3,20,32.651947615849565,0.6589285714285715,41.49305555555555,1034.027777777777,29.54365079365077,0
1718,4,0,0,38,0.0,0.0,1.0,38,1550,1200,350,0.7741935483870968,19,12,7,338.0208098734292,0.784228307254623,0.1633698339809253,0.21161807004681063,133831.25964506168,1447.5501543209848,135278.80979938267,1692,54,542.078947368421,35,3,16,32.575503355704704,0.6607142857142857,41.31944444444444,1034.722222222222,29.563492063492056,0
1719,4,0,0,38,0.0,0.0,1.0,38,600,500,100,0.8333333333333334,7,5,2,343.9125813509281,0.7834874348032242,0.1547349013233703,0.2128725664025217,133410.72137188207,1578.2541257243602,134988.97549760644,1693,55,543.078947368421,34,4,22,32.843829223323354,0.6587009803921569,41.726190476190474,1033.095238095238,30.38515406162465,2
1720,4,0,0,38,0.0,0.0,1.0,38,650,500,150,0.7692307692307693,8,5,3,345.34339229968805,0.7835467045993362,0.15959252971137516,0.21411290322580645,133472.22222222213,1618.7499999999952,135090.97222222213,1694,56,544.078947368421,34,4,22,32.745295698924735,0.6593137254901962,41.666666666666664,1033.3333333333328,30.392156862745082,0
1721,4,0,0,38,0.0,0.0,1.0,38,1000,500,500,0.5,15,5,10,346.44057339522504,0.7842875770507349,0.16241961000624294,0.2153288116528804,133564.50007086163,1654.432397959177,135218.9324688208,1695,57,545.078947368421,34,4,22,32.624572920265635,0.6602328431372548,41.57738095238095,1033.690476190476,30.40266106442576,0
1722,4,1,1,38,0.02564102564102564,0.02564102564102564,0.9743589743589743,39,800,300,500,0.375,13,3,10,337.3304203828558,0.7878992352676564,0.15119541456529606,0.2108433075092282,133771.3865847907,1225.0316143689874,134996.4181991597,1696,0,532.0769230769231,35,4,15,32.653184903408665,0.6601190476190477,41.37731481481481,1034.49074074074,29.556878306878286,0
1723,4,0,0,38,0.0,0.0,1.0,38,900,600,300,0.6666666666666666,12,6,6,345.49937375069175,0.7820945945945946,0.15666757567493872,0.21510122301252727,133626.03635204074,1633.5423752834379,135259.57872732417,1697,59,547.078947368421,34,4,22,32.587315294569194,0.6608455882352942,41.51785714285714,1033.9285714285706,30.409663865546197,0
1724,4,0,0,38,0.0,0.0,1.0,38,800,400,400,0.5,12,4,8,345.49937375069175,0.7823613086770982,0.15666757567493872,0.21510122301252727,133626.03635204074,1633.5423752834379,135259.57872732417,1698,60,548.078947368421,34,4,22,32.587315294569194,0.6608455882352942,41.51785714285714,1033.9285714285706,30.409663865546197,0
1725,4,0,0,38,0.0,0.0,1.0,38,1050,500,550,0.47619047619047616,16,5,11,347.07462130384977,0.7806721194879089,0.14962354095619967,0.2168031189438642,133749.1514314059,1684.187216553291,135433.33864795917,1699,61,549.078947368421,34,4,18,32.42341849848468,0.6620710784313726,41.398809523809526,1034.404761904762,30.423669467787114,0
1726,4,0,0,38,0.0,0.0,1.0,38,1000,600,400,0.6,14,6,8,339.572393231513,0.7801979611190137,0.1121069812725497,0.21286973354690347,133879.81520371724,1492.3778508237942,135372.19305454104,1700,62,550.078947368421,36,2,17,32.48685165034456,0.6591435185185186,41.27252252252252,1034.90990990991,28.747497497497502,3
1727,4,1,0,39,0.02564102564102564,0.0,1.0,39,850,600,250,0.7058823529411765,11,6,5,331.8113282490693,0.7829509671614935,0.11140059488916387,0.20955571051451904,134152.9124345951,1102.6912126808104,135255.60364727592,1701,0,536.9487179487179,37,2,18,32.4151495907423,0.6599099099099099,41.008771929824555,1035.9649122807007,27.99905168326218,0
1728,4,0,0,39,0.0,0.0,1.0,39,1050,600,450,0.5714285714285714,15,6,9,331.88156601750535,0.7823324336482231,0.10984515554976837,0.2102509760051917,134266.5291243459,1112.1171899045796,135378.64631425048,1702,1,537.9487179487179,37,2,19,32.30004231908592,0.6610360360360361,40.89912280701754,1036.4035087719294,28.01090564248458,0
1729,4,0,0,39,0.0,0.0,1.0,39,850,500,350,0.5882352941176471,12,5,7,335.741693190311,0.7835132703553757,0.11061387663884004,0.21302697767927486,134323.35550361633,1219.5901623576317,135542.94566597397,1703,2,538.9487179487179,37,2,19,32.14336083491997,0.6615990990990992,40.84429824561403,1036.6228070175425,28.016832622095745,0
1730,4,0,0,39,0.0,0.0,1.0,39,750,700,50,0.9333333333333333,8,7,1,337.9487074876674,0.7830071974808818,0.11220660332335441,0.21476095282280802,134380.1939058172,1282.7225684826121,135662.91647429983,1704,3,539.9487179487179,37,2,20,32.02948745064862,0.6621621621621622,40.78947368421053,1036.8421052631581,28.022759601706976,0
1731,4,0,0,39,0.0,0.0,1.0,39,1600,1400,200,0.875,18,14,4,338.5429267269881,0.7829509671614935,0.11698074348676779,0.21614663783338495,134550.78125000012,1310.2430555555693,135861.02430555568,1705,4,540.9487179487179,37,2,20,31.844042838018733,0.6638513513513513,40.62500000000001,1037.500000000001,28.040540540540565,0
1732,4,1,1,39,0.025,0.025,0.975,40,1200,1000,200,0.8333333333333334,14,10,4,331.23341838365764,0.7883814102564103,0.11098764093668678,0.21335873262366353,134872.2709195685,934.8406683711058,135807.11158793958,1706,0,528.4,36,4,14,31.713690734316284,0.6689814814814813,40.31531531531533,1038.738738738741,28.853853853853916,0
1733,4,0,1,38,0.0,0.02564102564102564,0.9743589743589743,39,800,600,200,0.75,10,6,4,339.24167681939383,0.7808704453441296,0.11301722363274558,0.21730852555116614,134670.8890603568,1337.1956447188074,136008.0847050756,1707,6,542.9487179487179,35,4,22,31.706251858459712,0.6690476190476189,40.50925925925927,1037.962962962964,29.656084656084683,0
1734,4,0,0,38,0.0,0.0,1.0,38,1150,900,250,0.782608695652174,14,9,5,339.57895185890527,0.7777382645803699,0.09484001761827487,0.21828645520009057,134797.91843820855,1554.9071712018083,136352.82560941036,1708,7,529.078947368421,34,4,16,31.57099048492492,0.6724877450980392,40.38690476190476,1038.4523809523805,30.54271708683472,0
1735,4,0,0,38,0.0,0.0,1.0,38,900,600,300,0.6666666666666666,12,6,6,337.9194800381399,0.777678994784258,0.09223722332351936,0.21753869539901502,134851.1512452847,1513.766182270242,136364.91742755496,1709,8,530.078947368421,35,3,17,31.5610838719263,0.6708333333333333,40.33564814814815,1038.657407407408,29.675925925925945,0
1736,4,0,0,38,0.0,0.0,1.0,38,1250,1000,250,0.8,15,10,5,338.54649603954994,0.7769973921289711,0.09123833641320434,0.21877500458354132,134989.2713659607,1540.0289647755992,136529.3003307363,1710,9,531.078947368421,36,2,18,31.407356234648176,0.6701388888888888,40.20270270270271,1039.1891891891903,28.866366366366396,0
1737,4,0,1,37,0.0,0.02631578947368421,0.9736842105263158,38,800,500,300,0.625,11,5,6,340.21637953397516,0.7768195827406353,0.09301476877459058,0.22021018114295868,135047.79061155755,1589.094077185296,136636.88468874284,1711,10,532.078947368421,36,2,18,31.30575117370892,0.6707175925925926,40.1463963963964,1039.4144144144148,28.872622622622632,0
1738,4,0,0,37,0.0,0.0,1.0,37,1250,900,350,0.72,16,9,7,345.1202104277791,0.7767142142142142,0.09396728354760242,0.22384222745651525,135121.77057881074,1926.6507791066374,137048.42135791737,1712,11,539.972972972973,35,2,19,31.104702400831194,0.6735119047619048,40.075231481481474,1039.699074074073,29.7056878306878,0
1739,4,0,0,37,0.0,0.0,1.0,37,1250,900,350,0.72,16,9,7,340.92261702225085,0.7762762762762763,0.09918528094278933,0.22241613403701235,135332.43982553127,1827.577910665262,137160.01773619652,1713,12,540.972972972973,35,2,20,31.00435669262142,0.6755952380952381,39.87268518518517,1040.509259259257,29.728835978835917,0
1740,4,0,0,37,0.0,0.0,1.0,37,1500,1100,400,0.7333333333333333,19,11,8,345.0595155842341,0.7726476476476476,0.10411923370358567,0.22663105994357205,135573.4056177125,1956.178733710545,137529.58435142305,1714,13,541.972972972973,35,2,21,30.657275690894267,0.6779761904761905,39.641203703703695,1041.4351851851843,29.75529100529098,0
1741,4,0,0,37,0.0,0.0,1.0,37,900,600,300,0.6666666666666666,12,6,6,345.0595155842341,0.7726476476476476,0.10411923370358567,0.22663105994357205,135573.4056177125,1956.178733710545,137529.58435142305,1715,14,542.972972972973,35,2,21,30.657275690894267,0.6779761904761905,39.641203703703695,1041.4351851851843,29.75529100529098,0
1742,4,0,0,37,0.0,0.0,1.0,37,700,500,200,0.7142857142857143,9,5,4,342.93385761114985,0.7725225225225225,0.10405961022696197,0.22542452773139046,135603.5414121441,1900.6091124399732,137504.15052458408,1716,15,543.972972972973,35,2,21,30.68269159536245,0.6782738095238096,39.61226851851851,1041.5509259259252,29.75859788359786,0
1743,4,0,0,37,0.0,0.0,1.0,37,850,400,450,0.47058823529411764,13,4,9,343.22472268005754,0.7711461461461462,0.10128680113128063,0.22618659982180614,135693.96888931727,1914.704968278432,137608.6738575957,1717,16,544.972972972973,35,2,21,30.585332888987637,0.6791666666666668,39.52546296296295,1041.8981481481458,29.76851851851845,0
1744,4,0,0,37,0.0,0.0,1.0,37,1100,600,500,0.5454545454545454,16,6,10,344.09892063670355,0.7710835835835835,-0.018513351991565452,0.21794510437849826,134258.8508060423,1839.6651296566627,136098.51593569896,1718,17,545.972972972973,36,1,20,31.991153247129574,0.6629050925925927,40.90653153153152,1036.373873873872,28.788163163163112,7
1745,4,0,0,37,0.0,0.0,1.0,37,700,300,400,0.42857142857142855,11,3,8,340.9731131058725,0.7710835835835835,-0.017039416126967355,0.21648265374156284,134346.39665002836,1761.7018200632992,136108.09847009165,1719,18,546.972972972973,36,1,20,31.984801578680564,0.6637731481481481,40.82207207207207,1036.7117117117111,28.79754754754753,0
1746,4,0,0,37,0.0,0.0,1.0,37,800,600,200,0.75,10,6,4,341.20515278087225,0.7702702702702703,-0.013193649675734775,0.21732361390814897,134463.16882761143,1775.9052126450795,136239.0740402565,1720,19,547.972972972973,36,1,21,31.862332609482436,0.6649305555555556,40.70945945945946,1037.1621621621625,28.81006006006007,0
1747,4,0,1,36,0.0,0.02702702702702703,0.972972972972973,37,700,400,300,0.5714285714285714,10,4,6,340.0034083334743,0.7688938938938938,-0.020421332989164487,0.2172532180571867,134579.9917315964,1751.531176446713,136331.52290804312,1721,20,548.972972972973,36,1,21,31.77705122639462,0.666087962962963,40.596846846846844,1037.6126126126123,28.822572572572565,0
1748,4,0,0,36,0.0,0.0,1.0,36,850,700,150,0.8235294117647058,10,7,3,347.5750391122721,0.7658399470899472,-0.02219991075412775,0.22191329420245087,134550.78125000017,2153.2986111111272,136704.0798611113,1722,84,564.6666666666666,35,1,21,31.609772423025426,0.6678571428571427,40.62500000000001,1037.5000000000014,29.64285714285718,0
1749,4,0,0,36,0.0,0.0,1.0,36,1200,1100,100,0.9166666666666666,13,11,2,344.8758685810806,0.7653769841269842,-0.019995290851860137,0.22055328371597493,134610.82845721877,2084.8052769204323,136695.6337341392,1723,85,565.6666666666666,35,1,21,31.619915978883178,0.668452380952381,40.567129629629626,1037.7314814814813,29.649470899470895,0
1750,4,0,0,36,0.0,0.0,1.0,36,1150,900,250,0.782608695652174,14,9,5,346.9083277918007,0.76494708994709,-0.013066978713919264,0.22314038890866156,134821.09917534728,2154.11241319445,136975.21158854172,1724,86,566.6666666666666,35,1,18,31.357614510197255,0.6705357142857142,40.364583333333336,1038.541666666667,29.672619047619055,0
1751,4,0,0,36,0.0,0.0,1.0,36,600,300,300,0.5,9,3,6,347.25333105781806,0.7645833333333334,-0.013415298516702423,0.22354744568958834,134851.15124528468,2165.502293381354,137016.65353866603,1725,87,567.6666666666666,35,1,18,31.31871703439567,0.6708333333333333,40.33564814814815,1038.6574074074078,29.675925925925938,0
1752,4,0,0,36,0.0,0.0,1.0,36,950,700,250,0.7368421052631579,12,7,5,347.9152964053876,0.7637896825396826,-0.006981580510992513,0.22434538078554306,134911.2654320988,2187.538580246916,137098.8040123457,1726,88,568.6666666666666,35,1,19,31.241644385026735,0.6714285714285714,40.27777777777778,1038.8888888888891,29.68253968253969,0
1753,4,0,0,36,0.0,0.0,1.0,36,1050,900,150,0.8571428571428571,12,9,3,345.17933662917005,0.7610119047619048,-0.0017256735693607084,0.22369414152981293,135091.68836805565,2126.17187500001,137217.86024305565,1727,89,569.6666666666666,35,1,19,31.133099532398127,0.6732142857142855,40.10416666666667,1039.5833333333342,29.702380952380977,0
1754,4,0,0,36,0.0,0.0,1.0,36,750,500,250,0.6666666666666666,10,5,5,345.17933662917005,0.7610119047619048,-0.0017256735693607084,0.22369414152981293,135091.68836805565,2126.17187500001,137217.86024305565,1728,90,570.6666666666666,35,1,19,31.133099532398127,0.6732142857142855,40.10416666666667,1039.5833333333342,29.702380952380977,0
1755,4,0,0,36,0.0,0.0,1.0,36,1100,900,200,0.8181818181818182,13,9,4,345.52994843377047,0.7593584656084656,-6.1824566608414955e-06,0.2246694729830582,135212.0373049555,2143.9616555212724,137355.99896047678,1729,91,571.6666666666666,35,1,19,31.004247347726096,0.6744047619047618,39.98842592592593,1040.046296296297,29.715608465608486,0
1756,4,1,0,37,0.02702702702702703,0.0,1.0,37,700,500,200,0.7142857142857143,9,5,4,340.9596716448782,0.7605730730730731,0.006900641859024725,0.2244994962552861,135663.00834195683,1851.1229557259974,137514.13129768282,1730,0,557.1891891891892,36,1,21,30.675062155442646,0.6767939814814815,39.55518018018018,1041.7792792792793,28.938313313313316,0
1757,4,0,0,37,0.0,0.0,1.0,37,1050,700,350,0.6666666666666666,14,7,7,337.8680188250537,0.7599474474474475,0.01073604401894901,0.2230121716267508,135751.0107235614,1773.1850093336582,137524.19573289505,1731,1,558.1891891891892,36,1,21,30.6682695771198,0.6776620370370371,39.47072072072072,1042.117117117117,28.947697697697695,0
1758,4,0,0,37,0.0,0.0,1.0,37,800,300,500,0.375,13,3,10,341.3042272470232,0.7587587587587588,0.01653273844285108,0.2256508519570317,135809.69482996498,1870.484589319039,137680.17941928402,1732,2,559.1891891891892,36,1,21,30.520518222414292,0.6782407407407408,39.41441441441441,1042.3423423423415,28.953953953953928,0
1759,4,0,0,37,0.0,0.0,1.0,37,550,400,150,0.7272727272727273,7,4,3,341.0908052857976,0.7591341341341341,0.018241856418371505,0.2256953241265636,135839.041638767,1866.6896203635922,137705.73125913058,1733,3,560.1891891891892,36,1,22,30.49696625976739,0.6785300925925927,39.386261261261254,1042.4549549549538,28.95708208208205,0
1760,4,0,0,37,0.0,0.0,1.0,37,1000,600,400,0.6,14,6,8,338.93455336831613,0.7573198198198198,0.016848850578067065,0.22519453610454404,135985.82323877935,1818.0588527716945,137803.88209155106,1734,4,561.1891891891892,36,1,19,30.407624343194406,0.6799768518518519,39.2454954954955,1043.0180180180182,28.97272272272273,0
1761,4,0,0,37,0.0,0.0,1.0,37,350,100,250,0.2857142857142857,6,1,5,338.93455336831613,0.7573198198198198,0.016848850578067065,0.22519453610454404,135985.82323877935,1818.0588527716945,137803.88209155106,1735,5,562.1891891891892,36,1,19,30.407624343194406,0.6799768518518519,39.2454954954955,1043.0180180180182,28.97272272272273,0
1762,4,0,0,37,0.0,0.0,1.0,37,850,700,150,0.8235294117647058,10,7,3,339.9451365252023,0.7565065065065065,0.01769317628110678,0.22605253407271703,136015.18906998212,1847.5404035792542,137862.72947356137,1736,6,563.1891891891892,36,1,19,30.352162726258598,0.6802662037037037,39.21734234234234,1043.1306306306305,28.975850850850847,0
1763,4,0,0,37,0.0,0.0,1.0,37,850,700,150,0.8235294117647058,10,7,3,342.22255407303993,0.7562562562562563,0.020048545955281716,0.22775501012447139,136044.55807158505,1911.5032261991664,137956.0612977842,1737,7,564.1891891891892,36,1,19,30.263655008635588,0.6805555555555556,39.189189189189186,1043.243243243243,28.97897897897897,0
1764,4,0,0,37,0.0,0.0,1.0,37,750,500,250,0.6666666666666666,10,5,5,341.66274158933925,0.7556306306306306,0.02257939389697272,0.22794734530658076,136132.68409879468,1902.2932138219235,138034.9773126166,1738,8,565.1891891891892,36,1,20,30.190910398906517,0.6814236111111112,39.104729729729726,1043.5810810810806,28.988363363363348,0
1765,4,0,0,37,0.0,0.0,1.0,37,1600,1400,200,0.875,18,14,4,344.52881259680527,0.7562562562562563,0.026834601591883,0.23043160842513585,136220.8386596055,1986.4007588669676,138207.23941847248,1739,9,566.1891891891892,36,1,20,30.028766630708375,0.6822916666666667,39.02027027027027,1043.9189189189185,28.997747747747738,0
1766,4,0,1,36,0.0,0.02702702702702703,0.972972972972973,37,900,700,200,0.7777777777777778,11,7,4,344.52881259680527,0.7562562562562563,0.026834601591883,0.23043160842513585,136220.8386596055,1986.4007588669676,138207.23941847248,1740,10,567.1891891891892,36,1,20,30.028766630708375,0.6822916666666667,39.02027027027027,1043.9189189189185,28.997747747747738,0
1767,4,0,0,36,0.0,0.0,1.0,36,1150,900,250,0.782608695652174,14,9,5,345.504301818168,0.7552910052910053,0.025105594345314897,0.23178329481824025,136327.80517243233,2220.3686289008965,138548.17380133324,1741,11,569.3611111111111,35,1,21,29.89732258302855,0.6854166666666666,38.917824074074076,1044.3287037037042,29.837962962962976,0
1768,4,0,1,35,0.0,0.027777777777777776,0.9722222222222222,36,750,500,250,0.6666666666666666,10,5,5,344.9504531119314,0.7547619047619049,0.027937827023699624,0.23180773189390763,136388.24755926352,2209.437558942042,138597.68511820555,1742,12,570.3611111111111,35,1,21,29.851915974145886,0.6860119047619047,38.8599537037037,1044.560185185185,29.844576719576715,0
1769,4,0,0,35,0.0,0.0,1.0,35,950,800,150,0.8421052631578947,11,8,3,350.7477409710155,0.7509803921568627,0.038509883096160547,0.23564017452371275,136378.7485827664,2566.90759637187,138945.65617913826,1743,13,583.2857142857143,34,1,21,29.70993845452473,0.6881127450980393,38.86904761904761,1044.523809523809,30.721288515406144,0
1770,4,0,0,35,0.0,0.0,1.0,35,600,300,300,0.5,9,3,6,351.8250663549807,0.749859943977591,0.035067155067154854,0.23657202737662508,136409.83737244902,2598.480017006805,139008.31738945583,1744,14,584.2857142857143,34,1,21,29.650997150997142,0.6884191176470589,38.839285714285715,1044.6428571428576,30.724789915966397,0
1771,4,0,1,34,0.0,0.02857142857142857,0.9714285714285714,35,1150,900,250,0.782608695652174,14,9,5,351.18243629953525,0.7490896358543417,0.028616997038049874,0.23676493286000933,136503.12500000012,2587.5000000000155,139090.62500000015,1745,15,585.2857142857143,34,1,21,29.575358851674636,0.6893382352941175,38.75000000000001,1045.000000000001,30.735294117647086,0
1772,4,0,0,34,0.0,0.0,1.0,34,600,400,200,0.6666666666666666,8,4,4,357.9600450632521,0.7449866310160428,0.03816111781956222,0.2408531479214069,136432.69903702915,2967.491019079222,139400.19005610837,1746,16,599.8529411764706,33,1,21,29.468108504398852,0.6909722222222221,38.81740196078432,1044.7303921568637,31.658496732026173,0
1773,4,0,0,34,0.0,0.0,1.0,34,1050,800,250,0.7619047619047619,13,8,5,358.9968530806614,0.7452094474153298,0.04182615712482707,0.2424294663440193,136560.75975886692,3004.976601547499,139565.73636041442,1747,17,600.8529411764706,33,1,21,29.314080392386746,0.6922348484848484,38.69485294117648,1045.220588235295,31.673351158645303,0
1774,4,0,0,34,0.0,0.0,1.0,34,650,500,150,0.7692307692307693,8,5,3,357.7223481292836,0.7450237670825907,0.03863871457140888,0.24178856018564118,136592.7843257402,2972.458309304129,139565.24263504433,1748,18,601.8529411764706,33,1,21,29.31565064478313,0.692550505050505,38.66421568627452,1045.343137254903,31.67706476530009,0
1775,4,0,0,34,0.0,0.0,1.0,34,1050,900,150,0.8571428571428571,12,9,3,361.7402898366691,0.7435383244206774,0.037379892195922526,0.2453967912135245,136720.92013888908,3091.49305555558,139812.41319444467,1749,19,602.8529411764706,33,1,22,29.083665338645424,0.6938131313131313,38.54166666666668,1045.8333333333348,31.691919191919236,0
1776,4,0,0,34,0.0,0.0,1.0,34,1150,700,450,0.6086956521739131,16,7,9,364.45326854203114,0.7427584670231729,0.0445102631216423,0.24859671831860608,136913.23649557875,3179.695309496366,140092.93180507512,1750,20,603.8529411764706,33,1,22,28.822209211553478,0.6957070707070707,38.35784313725491,1046.5686274509815,31.714200831847922,0
1777,4,0,0,34,0.0,0.0,1.0,34,700,400,300,0.5714285714285714,10,4,6,370.3007438628149,0.7423128342245989,0.03627843229548855,0.24318514075318384,135569.8604503075,3240.324034025368,138810.18448433286,1751,21,604.8529411764706,33,1,17,30.003628304699145,0.682449494949495,39.64460784313725,1041.4215686274504,31.55822935234698,2
1778,4,0,0,34,0.0,0.0,1.0,34,800,700,100,0.875,9,7,2,371.7206426104872,0.7422756981580512,0.04145308590046115,0.244777894826746,135666.5634405927,3286.0274468409043,138952.59088743362,1752,22,605.8529411764706,32,2,17,29.87036924817193,0.6858723958333334,39.55176767676767,1041.7929292929284,32.55602904040401,0
1779,4,0,0,34,0.0,0.0,1.0,34,800,600,200,0.75,10,6,4,372.9014147321219,0.7417186571598336,0.04886757222879434,0.2462342621759145,135765.23600908063,3325.4097158453046,139090.64572492594,1753,23,606.8529411764706,32,2,19,29.74138801389224,0.6868489583333334,39.4570707070707,1042.1717171717164,32.56786616161614,0
1780,4,0,0,34,0.0,0.0,1.0,34,650,400,250,0.6153846153846154,9,4,5,374.1702651771231,0.7412730243612597,0.04706737346101275,0.24752802157871204,135831.0376492194,3364.787075298433,139195.82472451782,1754,24,607.8529411764706,32,2,19,29.642835513565895,0.6875,39.39393939393939,1042.4242424242418,32.57575757575756,0
1781,4,0,0,34,0.0,0.0,1.0,34,1050,700,350,0.6666666666666666,14,7,7,373.9588098467799,0.7407159833630422,0.04579580098580749,0.24801367988980885,135921.05688016614,3365.7753328046692,139286.83221297082,1755,25,608.8529411764706,33,1,14,29.55877600188035,0.6859217171717173,39.30759803921568,1042.769607843136,31.599079025549578,0
1782,4,0,0,34,0.0,0.0,1.0,34,750,500,250,0.6666666666666666,10,5,5,386.3156190167461,0.7411244800950684,0.0175224357367445,0.24576376289578142,134419.81565975427,3588.041462412807,138007.85712216707,1756,26,609.8529411764706,32,2,19,30.73607898047811,0.6735026041666665,40.75126262626264,1036.9949494949508,32.40609217171721,5
1783,4,0,0,34,0.0,0.0,1.0,34,1000,700,300,0.7,13,7,6,386.06510534933614,0.7419786096256685,0.016517269030299486,0.2462663746545145,134518.03387409454,3586.5437837975815,138104.57765789214,1757,27,610.8529411764706,32,2,19,30.64422062642,0.6744791666666666,40.65656565656566,1037.3737373737379,32.41792929292931,0
1784,4,0,0,34,0.0,0.0,1.0,34,950,700,250,0.7368421052631579,12,7,5,383.18880315507937,0.7409016636957814,0.0177120164165554,0.2448782335479414,134584.55615573467,3514.262984857413,138098.81914059207,1758,28,611.8529411764706,31,3,19,30.652240975446524,0.677755376344086,40.59244791666667,1037.630208333334,33.471942204301094,0
1785,4,0,0,34,0.0,0.0,1.0,34,700,500,200,0.7142857142857143,9,5,4,384.92086856452,0.7407902554961379,0.01735183408369645,0.24621342876879795,134618.3353000216,3563.4813096788107,138181.8166097004,1759,29,612.8529411764706,31,3,19,30.573504809703067,0.6780913978494624,40.55989583333333,1037.7604166666658,33.47614247311825,0
1786,4,0,0,34,0.0,0.0,1.0,34,900,500,400,0.5555555555555556,13,5,8,385.7731865845562,0.7387477718360071,0.016867861043062593,0.24721735075981358,134685.90630425344,3591.6422526041624,138277.5485568576,1760,30,613.8529411764706,31,3,19,30.48377655126274,0.6787634408602151,40.494791666666664,1038.0208333333333,33.48454301075269,0
1787,4,0,0,34,0.0,0.0,1.0,34,750,500,250,0.6666666666666666,10,5,5,386.9051719316774,0.7391934046345812,0.011898965756355295,0.24840433502280154,134753.4942626953,3627.364773220487,138380.8590359158,1761,31,614.8529411764706,31,3,19,30.386777861382832,0.6794354838709677,40.4296875,1038.28125,33.492943548387096,0
1788,4,0,0,34,0.0,0.0,1.0,34,1300,1000,300,0.7692307692307693,16,10,6,387.47244049974563,0.7391934046345812,0.009273182957393544,0.2501642455653697,134956.35986328125,3658.3740234375,138614.73388671875,1762,32,615.8529411764706,31,3,16,30.169172932330827,0.6814516129032258,40.234375,1039.0625,33.51814516129032,0
1789,4,0,0,34,0.0,0.0,1.0,34,1000,800,200,0.8,12,8,4,391.9538778139799,0.7388591800356507,0.006547000611593745,0.25376867855547464,135057.8498840332,3787.28959825304,138845.13948228623,1763,33,616.8529411764706,31,3,16,29.951276671259766,0.6824596774193548,40.13671875,1039.453125,33.530745967741936,0
1790,4,0,0,34,0.0,0.0,1.0,34,900,800,100,0.8888888888888888,10,8,2,392.5304529587215,0.7388591800356507,0.008659619138826402,0.25461865693545016,135125.53109063048,3808.1771850585983,138933.70827568907,1764,34,617.8529411764706,31,3,16,29.86863389689,0.6831317204301075,40.071614583333336,1039.713541666667,33.53914650537635,0
1791,4,0,0,34,0.0,0.0,1.0,34,1050,800,250,0.7619047619047619,13,8,5,393.55763317132084,0.7390819964349377,-0.0024334931118523695,0.2562454711822073,135260.94436645508,3846.5954250759537,139107.53979153105,1765,35,618.8529411764706,31,3,17,29.706601785788788,0.684475806451613,39.94140625,1040.234375,33.55594758064516,0
1792,4,0,0,34,0.0,0.0,1.0,34,1150,900,250,0.782608695652174,14,9,5,391.3322732141549,0.7378565062388592,-0.0072719778602132745,0.25551695486335996,135362.54882812503,3794.346788194445,139156.89561631947,1766,36,619.8529411764706,31,3,17,29.662996329663,0.685483870967742,39.84375,1040.6250000000002,33.56854838709678,0
1793,4,0,0,34,0.0,0.0,1.0,34,1000,800,200,0.8,12,8,4,390.29881480803544,0.7375965537730244,-0.008575212448957092,0.25556421166177257,135464.1914367676,3774.3026733398438,139238.49411010745,1767,37,620.8529411764706,31,3,18,29.58841463414634,0.686491935483871,39.74609375,1041.0156250000002,33.58114919354839,0
1794,4,0,0,34,0.0,0.0,1.0,34,1200,1000,200,0.8333333333333334,14,10,4,390.2724057534317,0.7364081996434938,-0.010468220292242592,0.2565151169779542,135599.77425469304,3784.17002360027,139383.94427829332,1768,38,621.8529411764706,31,3,19,29.453811934825175,0.6878360215053763,39.61588541666667,1041.5364583333342,33.59795026881723,0
1795,4,0,0,34,0.0,0.0,1.0,34,650,200,450,0.3076923076923077,11,2,9,389.6645183867744,0.7355912061794415,-0.008946292838555081,0.25684476739134815,135701.50587293832,3775.6123860677035,139477.118259006,1769,39,622.8529411764706,31,3,19,29.368178788636175,0.6888440860215054,39.518229166666664,1041.927083333333,33.61055107526881,0
1796,4,0,0,34,0.0,0.0,1.0,34,850,500,350,0.5882352941176471,12,5,7,387.44048791748315,0.7351827094474154,-0.009697008574421906,0.2555992283599512,135732.3411673554,3717.640897612495,139449.9820649679,1770,40,623.8529411764706,32,2,19,29.395371380104205,0.6865234375,39.48863636363637,1042.0454545454547,32.56392045454546,0
1797,4,0,0,34,0.0,0.0,1.0,34,700,600,100,0.8571428571428571,8,6,2,388.36620273484203,0.7348113487819371,-0.018070229181657016,0.2571563541284354,135863.94444763282,3752.9928387409273,139616.93728637375,1771,41,624.8529411764706,32,2,17,29.24008921722982,0.6878255208333334,39.36237373737373,1042.5505050505044,32.57970328282826,0
1798,4,0,0,34,0.0,0.0,1.0,34,650,400,250,0.6153846153846154,9,4,5,389.2474596612828,0.7330288175876412,-0.012852289480994372,0.25821644733674975,135929.77000114782,3782.0635330578466,139711.83353420565,1772,42,625.8529411764706,32,2,17,29.151531662428855,0.6884765625,39.29924242424242,1042.8030303030303,32.587594696969695,0
1799,4,0,0,34,0.0,0.0,1.0,34,950,700,250,0.7368421052631579,12,7,5,391.2067590265789,0.7311720142602496,-0.009706629838187153,0.26047876308111384,136061.4689349301,3845.633258085912,139907.102193016,1773,43,626.8529411764706,32,2,17,28.96925047400056,0.6897786458333334,39.1729797979798,1043.3080808080808,32.603377525252526,0
1800,4,0,0,34,0.0,0.0,1.0,34,1050,700,350,0.6666666666666666,14,7,7,391.0550063287068,0.7297237076648841,-0.002476480551087956,0.26110344768280225,136160.28498367514,3849.2322212019226,140009.51720487708,1774,44,627.8529411764706,32,2,17,28.874808452294538,0.6907552083333334,39.07828282828283,1043.6868686868688,32.61521464646465,0
1801,4,0,0,34,0.0,0.0,1.0,34,1200,1000,200,0.8333333333333334,14,10,4,388.272174450857,0.7292038027332145,-0.005206629205490865,0.2602115788256552,136292.09551321287,3783.6856570758046,140075.78117028868,1775,45,628.8529411764706,32,2,19,28.816253526803706,0.6920572916666667,38.9520202020202,1044.1919191919187,32.63099747474746,0
1802,4,0,0,34,0.0,0.0,1.0,34,900,600,300,0.6666666666666666,12,6,6,383.9688200298967,0.7301693404634582,-0.003198476103829506,0.2587724718703113,136489.93087440045,3681.5755407611323,140171.5064151616,1776,46,629.8529411764706,32,2,19,28.731925648461413,0.6940104166666667,38.762626262626256,1044.949494949494,32.65467171717169,0
1803,4,0,0,34,0.0,0.0,1.0,34,1000,800,200,0.8,12,8,4,388.8465869339777,0.7292409387997624,0.0034944670937682165,0.2635374331413421,136687.90971584522,3830.1254336292086,140518.03514947442,1777,47,630.8529411764706,32,2,19,28.40774168880303,0.6959635416666667,38.57323232323232,1045.70707070707,32.67834595959594,0
1804,4,0,0,34,0.0,0.0,1.0,34,800,700,100,0.875,9,7,2,389.9938096220697,0.7287581699346406,0.006913522381064352,0.2645633681490256,136720.92013888882,3864.0624999999945,140584.98263888882,1778,48,631.8529411764706,32,2,19,28.344953519256304,0.6962890625,38.541666666666664,1045.8333333333328,32.68229166666665,0
1805,4,1,1,34,0.02857142857142857,0.02857142857142857,0.9714285714285714,35,850,600,250,0.7058823529411765,11,6,5,379.29911450839654,0.7336834733893557,0.006033343924014778,0.25943573540794473,137009.4453605583,3393.512260909249,140402.95762146756,1779,0,614.7714285714286,33,2,17,28.33838132584182,0.6966540404040404,38.26593137254901,1046.9362745098028,31.725341651812208,0
1806,4,0,0,34,0.0,0.0,1.0,34,850,600,250,0.7058823529411765,11,6,5,387.6461502698231,0.7277554961378492,0.009709289121053954,0.2642114550523268,136886.03203754712,3812.6686690133574,140698.70070656048,1780,50,633.8529411764706,32,2,20,28.242388593951087,0.6979166666666667,38.38383838383838,1046.464646464646,32.702020202020186,0
1807,4,0,0,34,0.0,0.0,1.0,34,950,700,250,0.7368421052631579,12,7,5,386.8305771066896,0.728015448603684,0.006567882310361428,0.2639044159372303,136919.06637396684,3792.896292470138,140711.96266643697,1781,51,634.8529411764706,32,2,20,28.23093859331643,0.6982421875,38.35227272727272,1046.5909090909083,32.705965909090885,0
1808,4,0,0,34,0.0,0.0,1.0,34,800,500,300,0.625,11,5,6,386.8305771066896,0.7279783125371361,0.006567882310361428,0.2639044159372303,136919.06637396684,3792.896292470138,140711.96266643697,1782,52,635.8529411764706,32,2,20,28.23093859331643,0.6982421875,38.35227272727272,1046.5909090909083,32.705965909090885,0
1809,4,0,0,34,0.0,0.0,1.0,34,700,400,300,0.5714285714285714,10,4,6,385.804586370042,0.7289438502673797,0.0061406060434063825,0.2637020466277013,136985.1470034945,3769.8995957045145,140755.046599199,1783,53,636.8529411764706,32,2,19,28.192216459614837,0.6988932291666667,38.28914141414141,1046.843434343434,32.71385732323231,0
1810,4,0,0,34,0.0,0.0,1.0,34,550,300,250,0.5454545454545454,8,3,5,385.804586370042,0.7289438502673797,0.0061406060434063825,0.2637020466277013,136985.1470034945,3769.8995957045145,140755.046599199,1784,54,637.8529411764706,32,2,19,28.192216459614837,0.6988932291666667,38.28914141414141,1046.843434343434,32.71385732323231,0
1811,4,0,0,34,0.0,0.0,1.0,34,550,400,150,0.7272727272727273,7,4,3,388.4447758130689,0.7290552584670232,0.008853324253000672,0.2657577624622085,137018.19329660232,3844.8002754820795,140862.9935720844,1785,55,638.8529411764706,32,2,19,28.090328027013975,0.69921875,38.25757575757575,1046.9696969696963,32.71780303030301,0
1812,4,0,0,34,0.0,0.0,1.0,34,800,500,300,0.625,11,5,6,394.71754263516584,0.729092394533571,0.0011867582760773931,0.260917748042486,135803.27563815666,3933.7361415446435,139737.0117797013,1786,56,639.8529411764706,31,3,18,29.135045804705392,0.6898521505376343,39.42057291666668,1042.3177083333348,33.62315188172048,3
1813,4,0,0,34,0.0,0.0,1.0,34,550,500,50,0.9090909090909091,6,5,1,412.56688578360917,0.7298722519310755,0.026200775988940217,0.2507722222804519,132733.2305908203,4187.366570366753,136920.59716118706,1787,57,640.8529411764706,31,3,18,31.75438042287929,0.6592741935483871,42.3828125,1030.46875,33.24092741935484,6
1814,4,0,0,34,0.0,0.0,1.0,34,400,200,200,0.5,6,2,4,413.2910466415808,0.7297237076648841,0.025844900870909182,0.2516624557857504,132800.32687717018,4177.037217881949,136977.36409505212,1788,58,641.8529411764706,31,3,18,31.66792993094155,0.6599462365591398,42.317708333333336,1030.729166666667,33.249327956989255,0
1815,4,0,0,34,0.0,0.0,1.0,34,600,400,200,0.6666666666666666,8,4,4,415.9242516248175,0.729983660130719,0.025548150294600447,0.2534928637500908,132833.88137817383,4249.766540527344,137083.64791870117,1789,59,642.8529411764706,31,3,18,31.566170898067455,0.6602822580645162,42.28515625,1030.859375,33.25352822580645,0
1816,4,0,0,34,0.0,0.0,1.0,34,500,500,0,1.0,5,5,0,416.90952182679405,0.7304664289958408,0.019250053854096283,0.25454946055099326,132901.0030958388,4281.538730197488,137182.5418260363,1790,60,643.8529411764706,31,3,18,31.47296060108599,0.6609543010752688,42.220052083333336,1031.119791666667,33.26192876344087,0
1817,4,0,0,34,0.0,0.0,1.0,34,1000,800,200,0.8,12,8,4,417.19883738293635,0.7286838978015449,0.021272566595126996,0.25518393752202617,132968.1417677137,4294.830830891921,137262.97259860561,1791,61,644.8529411764706,31,3,18,31.397682321255733,0.6616263440860215,42.154947916666664,1031.380208333333,33.27032930107526,0
1818,4,0,0,34,0.0,0.0,1.0,34,1400,1200,200,0.8571428571428571,16,12,4,421.6823362719667,0.726678550207962,0.014392838123749918,0.2591602568937637,133146.24304917877,4429.083766962569,137575.32681614134,1792,62,645.8529411764706,32,2,19,31.10217355843733,0.6608072916666666,41.98232323232324,1032.0707070707078,32.25220959595962,0
1819,4,0,0,34,0.0,0.0,1.0,34,700,600,100,0.8571428571428571,8,6,2,420.36730914906167,0.7268642305407012,0.014257960064760322,0.258578085198915,133178.82303145088,4396.804694674018,137575.6277261249,1793,63,646.8529411764706,32,2,19,31.10321100917431,0.6611328125,41.95075757575758,1032.1969696969697,32.256155303030305,0
1820,4,0,0,34,0.0,0.0,1.0,34,600,400,200,0.6666666666666666,8,4,4,419.4712289445186,0.7254901960784315,0.015196369348926542,0.2585256111088198,133250.70473195394,4378.96737432717,137629.6721062811,1794,64,647.8529411764706,33,1,19,31.053783382789323,0.6594065656565657,41.88112745098039,1032.4754901960775,31.287136066547806,0
1821,4,0,1,33,0.0,0.029411764705882353,0.9705882352941176,34,1050,600,450,0.5714285714285714,15,6,9,420.1352757544223,0.7261586452762924,0.02585388994307425,0.26048387096774206,133472.22222222228,4415.277777777787,137887.50000000006,1795,65,648.8529411764706,33,1,19,30.81317204301075,0.6616161616161615,41.66666666666667,1033.333333333334,31.313131313131333,0
1822,4,0,0,33,0.0,0.0,1.0,33,950,700,250,0.7368421052631579,12,7,5,420.17686154319307,0.727114898989899,0.037352998431219975,0.2612203683470171,133573.15275404183,4624.86962212456,138198.0223761664,1796,66,662.2424242424242,31,2,19,30.710338203803992,0.6676747311827957,41.569010416666664,1033.723958333333,33.34593413978494,0
1823,4,0,0,33,0.0,0.0,1.0,33,1050,900,150,0.8571428571428571,12,9,3,420.3686674807873,0.7273516414141414,0.03366494564076761,0.2618154971345042,133640.46096801743,4635.652499728719,138276.11346774615,1797,67,663.2424242424242,31,2,19,30.637540402132398,0.6683467741935485,41.50390624999999,1033.9843749999989,33.35433467741932,0
1824,4,0,1,32,0.0,0.030303030303030304,0.9696969696969697,33,550,500,50,0.9090909090909091,6,5,1,418.3819877190968,0.7281407828282829,0.034654349087338776,0.25139944217811194,132300.5624426078,4470.434458218538,136770.99690082634,1798,68,664.2424242424242,32,1,18,32.04237236131565,0.65234375,42.8030303030303,1028.787878787878,32.14962121212119,2
1825,4,0,0,32,0.0,0.0,1.0,32,800,700,100,0.875,9,7,2,383.76098260104317,0.7252604166666667,0.057691690213203195,0.20894846227494593,128474.33302137602,3465.852545115597,131940.18556649162,1799,69,670.40625,31,1,16,36.82303707509205,0.6162634408602149,46.54947916666668,1013.8020833333346,32.70329301075273,7
1826,4,2,0,34,0.058823529411764705,0.0,1.0,34,550,300,250,0.5454545454545454,8,3,5,363.64797761586317,0.7520424836601307,0.05827019664595223,0.20102460202604935,129076.8274221455,2587.7054498270136,131664.5328719725,1800,0,631.9117647058823,33,1,18,36.717619392185235,0.6174242424242422,45.95588235294119,1016.1764705882367,30.793226381461718,0
1827,4,0,0,34,0.0,0.0,1.0,34,500,300,200,0.6,7,3,4,364.4233334994416,0.7517453951277481,0.05951148243237503,0.20177083631804887,129139.10064638617,2612.2603085352,131751.36095492137,1801,1,632.9117647058823,33,1,19,36.63441443613857,0.6180555555555554,45.894607843137265,1016.4215686274523,30.800653594771283,0
1828,4,1,1,34,0.02857142857142857,0.02857142857142857,0.9714285714285714,35,900,500,400,0.5555555555555556,13,5,8,355.4257511975613,0.7634453781512605,0.052667814113597444,0.19772344067960854,129326.01042868129,2193.1738994617453,131519.18432814302,1802,0,615.8,33,2,19,36.6726907630522,0.619949494949495,45.71078431372549,1017.1568627450981,30.822935234699944,0
1829,4,0,0,34,0.0,0.0,1.0,34,950,700,250,0.7368421052631579,12,7,5,364.4233334994416,0.7517453951277481,0.05951148243237503,0.20177083631804887,129139.10064638617,2612.2603085352,131751.36095492137,1803,3,634.9117647058823,33,1,19,36.63441443613857,0.6180555555555554,45.894607843137265,1016.4215686274523,30.800653594771283,0
1830,4,2,0,36,0.05555555555555555,0.0,1.0,36,600,500,100,0.8333333333333334,7,5,2,357.04006090751034,0.7729828042328043,0.06753681392235666,0.18823981432601025,127179.55789448282,1881.6394193672613,129061.19731385008,1804,0,600.5833333333334,35,1,19,38.826376936316706,0.59375,47.8298611111111,1008.6805555555538,28.819444444444397,5
1831,4,2,0,38,0.05263157894736842,0.0,1.0,38,700,200,500,0.2857142857142857,12,2,10,353.9686160427299,0.7900663821716454,0.10784491348853997,0.18662047724212893,127179.557894483,1410.8084972993747,128590.36639178239,1805,0,569.921052631579,35,3,20,38.90382960413078,0.59375,47.82986111111111,1008.6805555555554,28.81944444444444,1
1832,4,3,3,38,0.07317073170731707,0.07317073170731707,0.926829268292683,41,1150,800,350,0.6956521739130435,15,8,7,332.2183739743472,0.8157012195121951,0.09100537281125587,0.17795398470102972,127820.21747616694,292.844962195918,128113.06243836286,1806,0,529.1463414634146,38,3,18,38.79688325409405,0.5945723684210527,47.19551282051282,1011.2179487179483,26.61099865047232,0
1833,4,1,0,39,0.02564102564102564,0.0,1.0,39,900,500,400,0.5555555555555556,13,5,8,349.06570613341654,0.8004385964912281,0.10093389305714351,0.1862963875756631,127673.13169677218,1113.2623739997007,128786.39407077189,1807,0,557.2307692307693,37,2,19,38.52154985353152,0.5948761261261261,47.34100877192983,1010.6359649122815,27.31448553816977,0
1834,4,2,0,41,0.04878048780487805,0.0,1.0,41,1150,900,250,0.782608695652174,14,9,5,344.1211401981118,0.8211382113821138,0.12759759791453362,0.1871209305877262,128422.23087873185,640.2982167589945,129062.52909549084,1808,0,531.0,37,4,16,37.880877686427226,0.6024774774774775,46.60087719298245,1013.5964912280697,27.394499762920802,0
1835,4,2,1,42,0.046511627906976744,0.023255813953488372,0.9767441860465116,43,950,800,150,0.8421052631578947,11,8,3,332.31646011821596,0.8355020302694721,0.13167900740444272,0.1830854852492534,128943.2185289843,-30.009212439658228,128913.20931654464,1809,0,507.25581395348837,40,3,18,37.6494646788073,0.6026041666666665,46.08739837398375,1015.650406504067,25.391260162601675,0
1836,4,0,1,41,0.0,0.023809523809523808,0.9761904761904762,42,750,500,250,0.6666666666666666,10,5,5,338.22537211425043,0.8293408826945412,0.134445160912128,0.18606212908406983,128883.8758680558,318.3593750000213,129202.23524305581,1810,1,520.3333333333334,39,3,20,37.55984133497468,0.6036324786324785,46.14583333333334,1015.4166666666686,26.036324786324833,0
1837,4,0,1,40,0.0,0.024390243902439025,0.975609756097561,41,1000,900,100,0.9,11,9,2,347.4991625511595,0.8239837398373984,0.14060258249641344,0.19099390062022367,128848.62075617284,754.9575617283997,129603.57831790124,1811,2,533.9512195121952,38,3,20,37.36035111719109,0.6049890350877192,46.18055555555556,1015.2777777777777,26.71783625730994,0
1838,4,0,0,40,0.0,0.0,1.0,40,1550,1000,550,0.6451612903225806,21,10,11,353.4597474731875,0.8170673076923077,0.1417440855568759,0.19395239373795453,128783.68975309693,1103.9700917589785,129887.65984485591,1812,3,548.175,37,3,20,37.275282668971215,0.6061373873873874,46.24451754385964,1015.02192982456,27.433025130393514,0
1839,4,0,0,40,0.0,0.0,1.0,40,1300,900,400,0.6923076923076923,17,9,8,352.6704864299565,0.8169070512820513,0.143166035353536,0.1939687675364757,128875.73964497016,1090.133957922391,129965.87360289255,1813,4,549.175,38,2,20,37.201441498316484,0.605263157894737,46.15384615384614,1015.3846153846133,26.720647773279296,0
1840,4,1,0,41,0.024390243902439025,0.0,1.0,41,1000,600,400,0.6,14,6,8,349.3013472205513,0.825,0.15186981872892802,0.1935736426760569,129174.91455078126,824.1943359375011,129999.10888671876,1814,0,536.7560975609756,39,2,21,36.982208730402704,0.6065705128205128,45.859375,1016.5625000000001,26.06570512820513,0
1841,4,1,1,41,0.023809523809523808,0.023809523809523808,0.9761904761904762,42,950,600,350,0.631578947368421,13,6,7,347.92146981973406,0.8286875725900116,0.1502221755711839,0.1944074981215603,129500.2616722367,611.1897019561644,130111.45137419285,1815,0,524.952380952381,38,4,17,36.6863038382142,0.6115679824561404,45.53952991452991,1017.8418803418792,26.785312640575768,0
1842,4,0,0,41,0.0,0.0,1.0,41,450,200,250,0.4444444444444444,7,2,5,354.05395362663523,0.8241361788617886,0.15621320437342323,0.19745316644562327,129424.43828870401,964.6468144044097,130389.08510310842,1816,2,538.7560975609756,37,4,21,36.60739942528735,0.6126126126126127,45.61403508771929,1017.5438596491211,27.501185395922192,0
1843,4,0,0,41,0.0,0.0,1.0,41,1600,700,900,0.4375,25,7,18,349.9453480388128,0.8210365853658537,0.156680778134473,0.19662515577784775,129717.84056770017,878.8309728614015,130596.67154056157,1817,3,539.7560975609756,38,3,17,36.413651459535046,0.6137609649122808,45.32585470085469,1018.6965811965797,26.807804768331046,0
1844,4,1,0,42,0.023809523809523808,0.0,1.0,42,1150,700,450,0.6086956521739131,16,7,9,349.4883045284414,0.8267518389469609,0.17046277529078369,0.198719496196468,130182.84640842026,699.4764539930652,130882.32286241332,1818,0,527.8809523809524,39,3,18,35.95328927222618,0.6167200854700854,44.86979166666667,1020.5208333333343,26.16720085470088,0
1845,4,0,2,40,0.0,0.047619047619047616,0.9523809523809523,42,1250,900,350,0.72,16,9,7,351.0991158318012,0.8268728222996515,0.1742976886353973,0.20034082336355818,130320.07250071003,751.1256882145943,131071.19818892462,1819,1,528.8809523809524,36,6,18,35.773041432300296,0.6235532407407408,44.73536036036035,1021.0585585585574,28.362737737737703,0
1846,4,0,0,40,0.0,0.0,1.0,40,700,400,300,0.5714285714285714,10,4,6,369.89208801549285,0.8090277777777778,0.1868295173599921,0.20969567914735687,130066.77685682115,1622.1343346029362,131688.9111914241,1820,2,555.6,37,3,18,35.550696012039126,0.6190878378378379,44.98355263157894,1020.0657894736827,27.569345661450882,0
1847,4,0,0,40,0.0,0.0,1.0,40,1000,800,200,0.8,12,8,4,371.491543507339,0.8092948717948718,0.18875846137316032,0.2112078066843492,130178.6502217025,1672.053540512426,131850.70376221492,1821,3,556.6,37,3,19,35.39618477131907,0.6202139639639641,44.87390350877191,1020.5043859649096,27.58119962067323,0
1848,4,1,0,41,0.024390243902439025,0.0,1.0,41,550,500,50,0.9090909090909091,6,5,1,363.15898896617193,0.8151422764227643,0.1845114905210461,0.20802105098016835,130469.43486636209,1276.310766189552,131745.74563255164,1822,0,544.0,35,6,20,35.313644688644686,0.6270833333333334,44.58912037037036,1021.6435185185168,29.189814814814763,0
1849,4,0,0,41,0.0,0.0,1.0,41,950,600,350,0.631578947368421,13,6,7,368.1031427221176,0.81255081300813,0.19253711558854736,0.21165930706521732,130617.28395061713,1416.1265432098603,132033.410493827,1823,1,545.0,35,6,19,35.03736413043479,0.6285714285714286,44.444444444444436,1022.2222222222209,29.20634920634917,0
1850,4,1,1,41,0.023809523809523808,0.023809523809523808,0.9761904761904762,42,1150,900,250,0.782608695652174,14,9,5,360.1347302791285,0.8143631436314364,0.19535757518590136,0.20857516214445115,130895.6269402848,1028.0122605713718,131923.63920085618,1824,0,533.0,36,6,19,34.95905322622062,0.6293402777777779,44.17229729729729,1023.3108108108102,28.425300300300282,0
1851,4,1,1,41,0.023809523809523808,0.023809523809523808,0.9761904761904762,42,1450,1100,350,0.7586206896551724,18,11,7,359.313659175102,0.8197831978319783,0.18854399028139923,0.20919324049541446,131097.37059694817,1021.015187484766,132118.38578443293,1825,0,533.9761904761905,36,6,19,34.77590535884466,0.6313657407407408,43.975225225225216,1024.099099099098,28.44719719719717,0
1852,4,0,1,40,0.0,0.024390243902439025,0.975609756097561,41,1150,600,550,0.5217391304347826,17,6,11,370.7400346273032,0.8114837398373984,0.20291596362097697,0.21556478476648513,131047.29940943338,1516.8960641735584,132564.19547360693,1826,4,548.0,37,4,19,34.53407224958948,0.6289414414414416,44.02412280701753,1023.9035087719276,27.673067804646692,0
1853,4,0,0,40,0.0,0.0,1.0,40,1100,800,300,0.7272727272727273,14,8,6,369.43207405491125,0.8108440170940171,0.20256128894122694,0.2152754213192089,131131.51552641162,1688.837550977181,132820.3530773888,1827,5,554.45,37,3,19,34.482277950255124,0.6297860360360361,43.94188596491226,1024.2324561403482,27.681958274063465,0
1854,4,0,0,40,0.0,0.0,1.0,40,1050,700,350,0.6666666666666666,14,7,7,368.37608779789866,0.8109241452991452,0.20163741438356197,0.21513163527397236,131215.75869498277,1667.349569098148,132883.10826408092,1828,6,555.45,37,3,19,34.42405108447488,0.6306306306306307,43.859649122807,1024.5614035087694,27.690848743480256,0
1855,4,2,1,41,0.047619047619047616,0.023809523809523808,0.9761904761904762,42,1150,600,550,0.5217391304347826,17,6,11,350.37029553852153,0.8249370886566009,0.19491321811163842,0.2075585434973813,131761.3363997442,833.1959501473675,132594.53234989158,1829,0,529.952380952381,36,6,20,34.33466783664218,0.6380208333333335,43.327702702702695,1026.6891891891883,28.519144144144118,0
1856,4,0,0,41,0.0,0.0,1.0,41,1200,900,300,0.75,15,9,6,361.91270000202456,0.816920731707317,0.2068015539810455,0.21446409897915525,131773.38023244572,1338.0919656635501,133111.47219810926,1830,1,543.8780487804878,35,6,20,34.02625126817719,0.6401785714285715,43.31597222222221,1026.736111111109,29.335317460317402,0
1857,4,0,0,41,0.0,0.0,1.0,41,1000,900,100,0.9,11,9,2,327.9439263513914,0.8172256097560976,0.16125498287754336,0.18632911603701013,130153.54624379074,336.61299674922805,130490.15924053997,1831,2,544.8780487804878,38,3,20,36.53260566083833,0.6181469298245613,44.89850427350428,1020.4059829059837,26.852789023841677,7
1858,4,0,0,41,0.0,0.0,1.0,41,650,400,250,0.6153846153846154,9,4,5,327.3378536218499,0.8173780487804878,0.15837701347807998,0.18624529575041926,130208.06081753626,324.40543045514363,130532.4662479914,1832,3,545.8780487804878,38,3,20,36.4928992637566,0.6186951754385963,44.845085470085486,1020.6196581196604,26.858412055780537,0
1859,4,1,1,41,0.023809523809523808,0.023809523809523808,0.9761904761904762,42,850,600,250,0.7058823529411765,11,6,5,320.98195169977623,0.8240176151761518,0.1614492320712908,0.18417470713907394,130535.38795976715,-20.087867083049133,130515.3000926841,1833,0,533.8571428571429,38,4,15,36.32427252134515,0.6219846491228069,44.524572649572654,1021.9017094017108,26.892150247413444,0
1860,4,0,0,41,0.0,0.0,1.0,41,1300,900,400,0.6923076923076923,17,9,8,329.6479023744326,0.8135670731707317,0.1645281359445918,0.18890892708025595,130486.54994806091,402.9234956909786,130889.4734437519,1834,5,547.8780487804878,37,4,20,36.1522501252057,0.6233108108108107,44.57236842105263,1021.7105263157893,27.613798008534843,0
1861,4,1,1,41,0.023809523809523808,0.023809523809523808,0.9761904761904762,42,1150,900,250,0.782608695652174,14,9,5,324.5369952366902,0.8192992644212156,0.16952659484516608,0.18740151944487768,130781.15297866901,88.66448425743252,130869.81746292644,1835,0,535.8095238095239,38,4,17,35.98526390919853,0.6244517543859649,44.284188034188034,1022.8632478632479,26.917453891138102,0
1862,4,0,0,41,0.0,0.0,1.0,41,1100,900,200,0.8181818181818182,13,9,4,331.54255403258884,0.8134146341463414,0.17671352906558568,0.19095950070129003,130682.67549871096,465.3736005309149,131148.04909924188,1836,1,549.560975609756,37,4,17,35.905607685433424,0.6252815315315317,44.38048245614034,1022.4780701754371,27.634542437173977,0
1863,4,1,0,42,0.023809523809523808,0.0,1.0,42,1050,800,250,0.7619047619047619,13,8,5,326.94559970577285,0.8205574912891986,0.17962250648537426,0.189866226447316,130999.80481591051,165.96194937540383,131165.76676528592,1837,0,537.452380952381,38,4,19,35.70301085368399,0.6266447368421053,44.07051282051282,1023.7179487179482,26.939946018893373,0
1864,4,0,0,42,0.0,0.0,1.0,42,1100,600,500,0.5454545454545454,16,6,10,328.26881855184763,0.8201945412311266,0.1875701668107257,0.19117769712260108,131109.19922017684,207.81238585726416,131317.0116060341,1838,1,538.452380952381,38,4,20,35.5588010292788,0.6277412280701754,43.96367521367522,1024.1452991452998,26.951192082771048,0
1865,4,0,0,42,0.0,0.0,1.0,42,650,200,450,0.3076923076923077,11,2,9,329.3221914445986,0.8195896244676733,0.18650503906579852,0.19192777199874575,131136.55495516476,237.23553126598046,131373.79048643075,1839,2,539.452380952381,38,4,20,35.50424185529014,0.628015350877193,43.93696581196581,1024.252136752137,26.954003598740446,0
1866,4,0,0,42,0.0,0.0,1.0,42,1450,1000,450,0.6896551724137931,19,10,9,355.8626422016739,0.8198557878435927,0.17246499557524508,0.19544591325929145,128819.24518014846,885.1080524343992,129704.35323258286,1840,3,540.452380952381,35,7,19,37.17803462166987,0.6104166666666666,46.20949074074075,1015.1620370370382,29.00462962962966,8
1867,4,5,4,43,0.10638297872340426,0.0851063829787234,0.9148936170212766,47,600,300,300,0.5,9,3,6,319.3586987988905,0.8438174529756398,0.17256088811197956,0.18023323105224578,129890.673828125,-1103.0907064471883,128787.58312167782,1841,0,483.8510638297872,39,8,18,37.017593160297004,0.6137820512820513,45.15625,1019.375,26.137820512820515,0
1868,4,1,2,42,0.022727272727272728,0.045454545454545456,0.9545454545454546,44,900,700,200,0.7777777777777778,11,7,4,338.68059362518596,0.8307346723044398,0.1820394207562348,0.18945993603785183,129545.08562616695,-25.11869978082902,129519.96692638613,1842,0,517.8181818181819,36,8,19,36.87592182890857,0.6157407407407407,45.49549549549551,1018.01801801802,28.278278278278336,0
1869,4,0,0,42,0.0,0.0,1.0,42,1050,800,250,0.7619047619047619,13,8,5,357.8450015796455,0.817000580720093,0.18686868686868707,0.1995108433464598,129413.28124999997,861.9791666666654,130275.26041666664,1843,2,543.3095238095239,34,8,20,36.522317772317784,0.6185661764705883,45.625,1017.4999999999998,29.926470588235286,0
1870,4,0,0,42,0.0,0.0,1.0,42,700,500,200,0.7142857142857143,9,5,4,330.23978176110563,0.8169763840495547,0.07022826292374651,0.18993371285371924,130626.62459843415,227.62159991535316,130854.2461983495,1844,3,544.3095238095239,37,5,13,35.99554417390681,0.6247184684684685,44.435307017543856,1022.2587719298247,27.62861545756283,7
1871,4,0,0,42,0.0,0.0,1.0,42,900,500,400,0.5555555555555556,13,5,8,331.39408943784713,0.8167102206736353,0.06701599558742344,0.19073570925422761,130654.64854570641,259.6356571252656,130914.28420283168,1845,4,545.3095238095239,37,5,13,35.93772343772342,0.625,44.4078947368421,1022.3684210526319,27.63157894736843,0
1872,4,0,0,42,0.0,0.0,1.0,42,1100,900,200,0.8181818181818182,13,9,4,329.8204846051334,0.8162504839334107,0.07329208085078087,0.19024339269709842,130738.73842191837,224.06281259618635,130962.80123451455,1846,5,546.3095238095239,37,5,15,35.892994353311146,0.6258445945945945,44.32565789473684,1022.6973684210534,27.640469416785226,0
1873,4,0,0,42,0.0,0.0,1.0,42,1250,700,550,0.56,18,7,11,331.41067431932527,0.8137824235385211,0.0815666886062254,0.19199601635147523,130906.99932912066,276.7953841566776,131183.79471327734,1847,6,547.3095238095239,37,5,16,35.68241276474159,0.6275337837837838,44.16118421052632,1023.355263157896,27.65825035561881,0
1874,4,0,0,42,0.0,0.0,1.0,42,1550,1200,350,0.7741935483870968,19,12,7,331.351398803338,0.8141937669376694,0.08435905669128418,0.19336765265581415,131187.6746330601,293.84389908432377,131481.5185321444,1848,7,548.3095238095239,37,5,17,35.4007233579507,0.6303490990990992,43.88706140350877,1024.4517543859643,27.68788525367471,0
1875,4,0,0,42,0.0,0.0,1.0,42,1150,900,250,0.782608695652174,14,9,5,329.7039632444291,0.812306426635695,0.09756856713903805,0.19325789938274546,131356.98356718203,261.8587596999795,131618.842326882,1849,8,549.3095238095239,36,6,18,35.27225456809108,0.6339699074074074,43.721846846846844,1025.1126126126126,28.47535035035035,0
1876,4,1,1,42,0.023255813953488372,0.023255813953488372,0.9767441860465116,43,1200,900,300,0.75,15,9,6,318.8112069435855,0.8155223329641934,0.10019570249247467,0.18894608492529988,131778.07113727316,-197.53481840564487,131580.53631886753,1850,0,537.5116279069767,37,6,15,35.12788338316959,0.6362612612612611,43.31140350877194,1026.7543859649136,27.750118539592258,0
1877,4,0,0,42,0.0,0.0,1.0,42,950,700,250,0.7368421052631579,12,7,5,323.43034122339566,0.8096689895470384,0.10113169691839907,0.19116369195266086,131674.63705259323,117.51455847740948,131792.15161107064,1851,10,551.3095238095239,36,6,15,35.113332967595646,0.6371527777777777,43.41216216216217,1026.3513513513522,28.50975975975978,0
1878,4,0,0,42,0.0,0.0,1.0,42,1050,600,450,0.5714285714285714,15,6,9,322.10955856920344,0.8080478126209834,0.10231984875547018,0.19096196066540957,131790.24252292843,90.17936855775451,131880.42189148618,1852,11,552.3095238095239,36,6,15,35.03098267163851,0.6383101851851851,43.29954954954955,1026.8018018018026,28.522272272272296,0
1879,4,0,0,42,0.0,0.0,1.0,42,950,500,450,0.5263157894736842,14,5,9,321.654333304389,0.8062814556716996,0.10023070940532275,0.19141894864552797,131934.82069485038,87.4813580472487,132022.30205289763,1853,12,553.3095238095239,36,6,16,34.89737476707222,0.6397569444444444,43.15878378378379,1027.364864864866,28.537912912912944,0
1880,4,0,0,42,0.0,0.0,1.0,42,1400,1200,200,0.8571428571428571,16,12,4,321.2266770957175,0.8047086720867209,0.09835184895425897,0.19218869999239185,132137.36329234645,89.20922611801649,132226.57251846447,1854,13,554.3095238095239,36,6,18,34.704956188389936,0.6417824074074073,42.961711711711715,1028.1531531531534,28.559809809809817,0
1881,4,1,1,42,0.023255813953488372,0.023255813953488372,0.9767441860465116,43,950,500,450,0.5263157894736842,14,5,9,316.1703078411423,0.8116002214839424,0.09603487133764244,0.19104499296192584,132510.87474030486,-220.7991882117455,132290.07555209313,1855,0,542.3953488372093,37,6,18,34.460418885339,0.643581081081081,42.59868421052632,1029.605263157896,27.827169274537727,0
1882,4,0,0,42,0.0,0.0,1.0,42,950,900,50,0.9473684210526315,10,9,1,325.26235590329304,0.8026519550909795,0.10364513339792292,0.1964034648393598,132484.94059938332,218.47278021266345,132703.413379596,1856,15,556.3095238095239,36,6,18,34.252397360169184,0.6452546296296295,42.62387387387388,1029.5045045045058,28.597347347347384,0
1883,4,0,0,42,0.0,0.0,1.0,42,850,700,150,0.8235294117647058,10,7,3,324.89351138268694,0.8016356949283778,0.10020513781720841,0.1967864937156331,132600.90115453317,216.23447772099195,132817.13563225415,1857,16,557.3095238095239,36,6,18,34.14561921422845,0.6464120370370369,42.511261261261275,1029.954954954957,28.609859859859917,0
1884,4,0,0,42,0.0,0.0,1.0,42,900,600,300,0.6666666666666666,12,6,6,326.7814374091001,0.8016114982578397,0.10310866804089325,0.1982358481046721,132658.9004545089,270.0932351270518,132928.99368963594,1858,17,558.3095238095239,36,6,17,34.0388609532138,0.6469907407407407,42.45495495495497,1030.1801801801828,28.61611611611619,0
1885,4,0,0,42,0.0,0.0,1.0,42,1050,800,250,0.7619047619047619,13,8,5,336.15528779244033,0.8016840882694541,0.10849401502252354,0.19194446322568942,130346.55044100096,376.7313757979515,130723.28181679892,1859,18,559.3095238095239,37,5,18,36.12770231575933,0.6219031531531531,44.7094298245614,1021.1622807017534,27.59898055950685,4
1886,4,0,0,42,0.0,0.0,1.0,42,1550,1200,350,0.7741935483870968,19,12,7,346.55977725070574,0.8013695315524584,0.07991628418942587,0.18147724926437564,126903.5599409197,395.93389308933934,127299.49383400904,1860,19,560.3095238095239,38,4,19,39.373917576785765,0.5852521929824561,48.10363247863248,1007.58547008547,26.515407107512367,8
1887,4,4,2,44,0.08695652173913043,0.043478260869565216,0.9565217391304348,46,1100,700,400,0.6363636363636364,15,7,8,330.65301805496574,0.8272342995169082,0.1291533654062318,0.1728332261941362,126829.56271701395,-794.4301837355674,126035.13253327837,1861,0,512.5,39,7,16,39.850482592209566,0.5827991452991453,48.177083333333336,1007.2916666666672,25.827991452991466,2
1888,4,1,1,44,0.022222222222222223,0.022222222222222223,0.9777777777777777,45,700,400,300,0.5714285714285714,10,4,6,340.5063702460442,0.8236952861952862,0.1315033220681887,0.17752613672051026,126724.65820312487,-369.88932291668254,126354.76888020818,1862,0,524.8666666666667,39,6,16,39.710066211462845,0.5817307692307694,48.28124999999999,1006.874999999999,25.817307692307665,0
1889,4,3,2,45,0.06382978723404255,0.0425531914893617,0.9574468085106383,47,1250,700,550,0.56,18,7,11,328.9043645984682,0.8366481652790625,0.13235007235114438,0.17336037273711086,127168.88018251366,-1034.1883693465443,126134.69181316711,1863,0,503.468085106383,40,7,17,39.5468094038623,0.5846354166666667,47.84044715447154,1008.6382113821134,25.215955284552834,0
1890,4,1,1,45,0.021739130434782608,0.021739130434782608,0.9782608695652174,46,1450,1000,450,0.6896551724137931,19,10,9,332.0832471796432,0.8271135265700483,0.12873086930240318,0.17514656277923163,127194.5074443123,-752.1669888954885,126442.34045541681,1864,0,515.3913043478261,40,6,17,39.440400631338605,0.5848958333333333,47.81504065040651,1008.7398373983744,25.21849593495936,0
1891,4,3,3,45,0.0625,0.0625,0.9375,48,850,600,250,0.7058823529411765,11,6,5,316.956321733847,0.841404403073286,0.12239033825692269,0.1687735756076141,127581.01695360837,-1512.4780286641546,126068.53892494421,1865,0,494.8541666666667,42,6,12,39.4268735213249,0.5858134920634921,47.43217054263565,1010.2713178294558,24.054078995939424,0
1892,4,2,2,45,0.0425531914893617,0.0425531914893617,0.9574468085106383,47,1450,1000,450,0.6896551724137931,19,10,9,325.51812094802864,0.8344511255010791,0.12862469839877155,0.1734904270986744,127617.73003472213,-1091.623263888899,126526.10677083323,1866,0,506.3404255319149,41,6,13,39.17310996563573,0.5876524390243902,47.39583333333333,1010.4166666666658,24.64430894308941,0
1893,4,3,3,45,0.0625,0.0625,0.9375,48,1050,600,450,0.5714285714285714,15,6,9,316.9507811286848,0.8458000886524822,0.1252954516417537,0.16979971005436084,127825.87059070948,-1497.0980935641048,126328.77249714539,1867,0,496.6666666666667,42,6,13,39.17708732592309,0.5882936507936508,47.18992248062015,1011.2403100775176,24.077150239940895,0
1894,4,3,1,47,0.0625,0.020833333333333332,0.9791666666666666,48,1300,1000,300,0.7692307692307693,16,10,6,330.2084704457347,0.846982121749409,0.14861027215678368,0.17493123930333224,127373.97057183216,-1187.213791224663,126186.7567806075,1868,0,497.6041666666667,40,8,13,39.30396154233363,0.5867187500000001,47.637195121951216,1009.4512195121945,25.236280487804862,1
1895,4,1,1,47,0.020833333333333332,0.020833333333333332,0.9791666666666666,48,1300,1200,100,0.9230769230769231,14,12,2,329.9599724873653,0.8467420212765957,0.14527140365002666,0.1751326007817553,127450.92207019619,-1189.2594520457517,126261.66261815044,1869,0,498.5833333333333,40,8,13,39.231498255501876,0.5875000000000001,47.56097560975609,1009.7560975609747,25.243902439024367,0
1896,4,3,0,50,0.06,0.0,1.0,50,950,500,450,0.5263157894736842,14,5,9,331.5746447297327,0.8551020408163265,0.19037907728474868,0.17938768140147554,128219.87714356581,-1495.225707617712,126724.6514359481,1870,0,479.58,41,9,16,38.405144970124375,0.59375,46.80059523809524,1012.7976190476195,24.702380952380963,0
1897,4,1,2,49,0.0196078431372549,0.0392156862745098,0.9607843137254902,51,1100,500,600,0.45454545454545453,17,5,12,345.94696765705777,0.8574183006535948,0.22552576501289878,0.1897093476041897,128758.45520852116,-1291.2805720809974,127467.17463644016,1871,0,471.15686274509807,42,9,13,37.49164598052322,0.597718253968254,46.26937984496124,1014.9224806201553,24.164820967146554,0
1898,4,1,1,49,0.02,0.02,0.98,50,1150,700,450,0.6086956521739131,16,7,9,356.1340924943196,0.8542006802721088,0.24353401094605154,0.19549163274688183,128798.26467624081,-826.1093789367657,127972.15529730405,1872,0,481.44,41,9,14,37.192549517852484,0.5995934959349594,46.23015873015873,1015.0793650793646,24.75803329461865,0
1899,4,3,0,52,0.057692307692307696,0.0,1.0,52,1000,600,400,0.6,14,6,8,346.55840515279067,0.8587543991955756,0.24468780270299395,0.19243415105209913,129253.05394441151,-1439.3639080326313,127813.69003637889,1873,0,463.78846153846155,40,12,19,36.9723998933973,0.6057291666666667,45.78252032520326,1016.8699186991879,25.421747967479696,0
1900,4,1,1,52,0.018867924528301886,0.018867924528301886,0.9811320754716981,53,1450,1000,450,0.6896551724137931,19,10,9,399.35774571114564,0.8635099177552007,0.2505894196733023,0.21055068081504127,127179.55789448298,-249.03201463364854,126930.52587984933,1874,0,456.0188679245283,35,18,18,37.75925129087779,0.59375,47.82986111111111,1008.6805555555552,28.819444444444436,8
1901,4,0,1,51,0.0,0.019230769230769232,0.9807692307692307,52,1650,1000,650,0.6060606060606061,23,10,13,406.10506347838987,0.8595242584213172,0.26617880644429337,0.21443865501428971,127242.10778061206,-65.26714852609877,127176.84063208596,1875,1,465.7692307692308,34,18,19,37.52458210422811,0.5965073529411765,47.76785714285713,1008.92857142857,29.674369747899117,0
1902,4,2,3,50,0.03773584905660377,0.05660377358490566,0.9433962264150944,53,1500,900,600,0.6,21,9,12,406.2093776346502,0.8615142718916303,0.2938973989125788,0.217758131397029,127851.72994898827,-213.085669581626,127638.64427940664,1876,0,457.811320754717,35,18,16,36.89393072404058,0.6005952380952382,47.16435185185185,1011.342592592592,28.89550264550263,0
1903,4,2,2,50,0.038461538461538464,0.038461538461538464,0.9615384615384616,52,1250,1100,150,0.88,14,11,3,410.4904836579003,0.8675999245852186,0.29654967673835597,0.22117925320938608,128056.65569540886,113.20770640431189,128169.86340181317,1877,0,458.88461538461536,35,17,17,36.57482847341337,0.6026785714285714,46.96180555555555,1012.152777777777,28.918650793650773,0
1904,4,3,2,51,0.05660377358490566,0.03773584905660377,0.9622641509433962,53,650,200,450,0.3076923076923077,11,2,9,393.02485107150085,0.8751511852926946,0.29559389489870447,0.21426824643667808,128525.6736137902,-497.1829721793637,128028.49064161084,1878,0,449.811320754717,35,18,17,36.53561712894266,0.6074404761904761,46.49884259259259,1014.0046296296289,28.971560846560823,0
1905,4,2,3,50,0.03773584905660377,0.05660377358490566,0.9433962264150944,53,1350,700,650,0.5185185185185185,20,7,13,393.4195013947684,0.8737300435413643,0.30115042018435134,0.21479969412600347,128584.36113522375,-482.4809510030874,128101.88018422066,1879,0,450.77358490566036,35,18,17,36.46546559397467,0.6080357142857142,46.44097222222222,1014.236111111111,28.978174603174597,0
1906,4,2,2,50,0.038461538461538464,0.038461538461538464,0.9615384615384616,52,1700,1300,400,0.7647058823529411,21,13,8,401.87321626181784,0.8667043740573152,0.30040768598697887,0.21931825300028368,128566.7534722223,-66.49305555554895,128500.26041666676,1880,0,460.36538461538464,34,18,17,36.2691728293618,0.6099877450980392,46.458333333333336,1014.1666666666673,29.828431372549037,0
1907,4,1,0,51,0.0196078431372549,0.0,1.0,51,1450,1000,450,0.6896551724137931,19,10,9,411.51325402635933,0.8616013071895425,0.3135501875028137,0.22482476591261868,128610.25694744798,384.9650675220908,128995.22201497007,1881,0,470.37254901960785,33,18,18,35.98010047923966,0.612689393939394,46.41544117647058,1014.3382352941167,30.737522281639897,0
1908,4,4,4,51,0.07272727272727272,0.07272727272727272,0.9272727272727272,55,1600,1100,500,0.6875,21,11,10,377.9682824035102,0.8757014590347924,0.3034924144969753,0.21138043053187827,129534.44054705226,-1203.9518043736975,128330.48874267856,1882,0,437.09090909090907,34,21,15,35.886884574903526,0.6197916666666666,45.50595238095239,1017.9761904761913,29.940476190476215,0
1909,4,0,0,51,0.0,0.0,1.0,51,1450,1000,450,0.6896551724137931,19,10,9,410.37800288568985,0.8602287581699347,0.31495936267804026,0.22555362414243552,128848.62075617285,375.3279320987697,129223.94868827162,1883,2,472.37254901960785,35,16,18,35.764363885088926,0.6107142857142855,46.18055555555556,1015.2777777777778,29.00793650793651,0
1910,4,0,0,51,0.0,0.0,1.0,51,1450,900,550,0.6206896551724138,20,9,11,413.9190281250905,0.8597712418300655,0.3205459982032475,0.2278372366856678,128907.3819551612,471.4436514060329,129378.82560656723,1884,3,473.37254901960785,35,16,18,35.61422004406958,0.6113095238095239,46.12268518518518,1015.5092592592594,29.014550264550266,0
1911,4,0,0,51,0.0,0.0,1.0,51,1650,1200,450,0.7272727272727273,21,12,9,413.08735642150356,0.8594444444444446,0.3241007459930567,0.2287439557705824,129144.1504849445,469.5631442253216,129613.71362916983,1885,4,474.37254901960785,36,15,18,35.392661939581956,0.6116898148148147,45.88963963963965,1016.4414414414423,28.234484484484508,0
1912,4,0,0,51,0.0,0.0,1.0,51,850,500,350,0.5882352941176471,12,5,7,410.69009662799436,0.8583660130718955,0.31509857481606973,0.22811710608564595,129265.58036169781,417.6694642859691,129683.24982598377,1886,5,475.37254901960785,32,19,18,35.32923599039814,0.6217447916666666,45.77020202020202,1016.9191919191921,31.778724747474755,0
1913,4,0,1,50,0.0,0.0196078431372549,0.9803921568627451,51,1800,1100,700,0.6111111111111112,25,11,14,411.4975548031872,0.8592156862745098,0.3177158582731341,0.22995451591942823,129504.14540816324,458.127834467118,129962.27324263036,1887,6,476.37254901960785,34,17,15,35.06457115009746,0.619485294117647,45.535714285714285,1017.8571428571427,29.93697478991596,0
1914,4,0,0,50,0.0,0.0,1.0,50,1800,1400,400,0.7777777777777778,22,14,8,409.67424816712656,0.8578061224489796,0.31937806873977026,0.22964308773405,129625.34722222232,620.8333333333436,130246.18055555566,1888,7,485.98,34,16,16,34.98704309874523,0.6207107843137254,45.41666666666667,1018.3333333333342,29.950980392156886,0
1915,4,0,0,50,0.0,0.0,1.0,50,1250,800,450,0.64,17,8,9,410.12957687218824,0.8578061224489796,0.3151314713100388,0.23043196252759773,129716.28578514732,640.0970804988573,130356.38286564618,1889,8,486.98,34,16,16,34.88250360328775,0.6216299019607843,45.32738095238095,1018.6904761904757,29.961484593837522,0
1916,4,0,0,50,0.0,0.0,1.0,50,1400,900,500,0.6428571428571429,19,9,10,412.91843203027474,0.8585374149659863,0.32021490306003253,0.23289905237438832,129867.92091836738,724.971655328803,130592.89257369618,1890,9,487.98,34,16,16,34.65652495522851,0.6231617647058822,45.17857142857143,1019.2857142857147,29.978991596638668,0
1917,4,1,0,51,0.0196078431372549,0.0,1.0,51,950,700,250,0.7368421052631579,12,7,5,407.2393121870349,0.8619607843137256,0.3328595258030389,0.23168925840245436,130205.11379200152,404.9281967778645,130610.04198877938,1891,0,479.3921568627451,36,15,17,34.45717937401155,0.6223958333333334,44.847972972972975,1020.6081081081086,28.350225225225238,0
1918,4,1,0,52,0.019230769230769232,0.0,1.0,52,2000,1300,700,0.65,27,13,14,395.1893937457275,0.8653217697335344,0.3363738567243868,0.22729345774243553,130627.42524092972,-75.44735769276974,130551.97788323695,1892,0,471.15384615384613,34,18,15,34.33484724971857,0.6308210784313726,44.43452380952381,1022.2619047619048,30.06652661064426,0
1919,4,0,0,52,0.0,0.0,1.0,52,1500,900,600,0.6,21,9,12,394.9809060328554,0.8662016088486676,0.34435473765238744,0.22842973798427713,130840.48327664394,-64.10147392290685,130776.38180272102,1893,1,472.15384615384613,34,18,17,34.123613373671546,0.6329656862745099,44.226190476190474,1023.0952380952377,30.091036414565817,0
1920,4,0,0,52,0.0,0.0,1.0,52,1100,700,400,0.6363636363636364,15,7,8,393.82425624733906,0.8659502262443438,0.339276703843544,0.22819096158184626,130913.23329260977,-88.63865312070823,130824.59463948906,1894,2,473.15384615384613,35,17,17,34.07929955515343,0.631547619047619,44.155092592592595,1023.37962962963,29.239417989418,0
1921,4,0,2,50,0.0,0.038461538461538464,0.9615384615384616,52,1550,1400,150,0.9032258064516129,17,14,3,393.58308617470396,0.8643162393162392,0.3413548476839616,0.22910678595222236,131090.963648834,-80.96279149519842,131010.0008573388,1895,3,474.15384615384613,35,17,17,33.90502561784208,0.6333333333333333,43.98148148148148,1024.074074074074,29.259259259259256,0
1922,4,0,0,50,0.0,0.0,1.0,50,1500,1100,400,0.7333333333333333,19,11,8,397.8243003891597,0.8609183673469387,0.34206723292259844,0.2320595482870191,131171.1560006968,436.6146734428971,131607.7706741397,1896,4,491.06,33,17,18,33.71503269928619,0.6385732323232323,43.9031862745098,1024.3872549019602,31.042038027332126,0
1923,4,0,0,50,0.0,0.0,1.0,50,1650,1300,350,0.7878787878787878,20,13,7,398.5506546682666,0.8608163265306122,0.3433871546465732,0.2328638730734715,131233.9323367215,460.6739294982737,131694.60626621978,1897,5,492.06,33,17,18,33.63271438823107,0.6392045454545454,43.841911764705884,1024.6323529411768,31.049465240641723,0
1924,4,1,1,50,0.0196078431372549,0.0196078431372549,0.9803921568627451,51,1500,900,600,0.6,21,9,12,395.5789552204105,0.864640522875817,0.35265651536205067,0.23366756889763796,131651.87225793293,215.8095983007454,131867.68185623368,1898,0,483.3921568627451,32,19,16,33.285145997375324,0.6458333333333333,43.43434343434344,1026.2626262626268,32.07070707070709,0
1925,4,2,1,51,0.038461538461538464,0.019230769230769232,0.9807692307692307,52,1350,1000,350,0.7407407407407407,17,10,7,389.9153066548756,0.8669871794871794,0.31131592530228547,0.22649968388495034,131010.89000740601,-183.3697295268281,130827.52027787919,1899,0,475.0576923076923,36,16,17,34.08018003153302,0.6304976851851851,44.05968468468468,1023.7612612612609,28.4378128128128,3
1926,4,0,0,51,0.0,0.0,1.0,51,1500,1300,200,0.8666666666666667,17,13,4,395.40977236064566,0.8620915032679739,0.31527318605832066,0.22928581094984815,130942.84664619753,155.216236925563,131098.0628831231,1900,1,485.37254901960785,35,16,17,34.00865562214934,0.6318452380952382,44.1261574074074,1023.495370370369,29.242724867724828,0
1927,4,0,0,51,0.0,0.0,1.0,51,1050,600,450,0.5714285714285714,15,6,9,397.75785906154084,0.8616339869281047,0.3257751512855118,0.23171555594704232,131120.59709630048,230.84959597906845,131351.44669227954,1901,2,486.37254901960785,35,16,17,33.76805759596188,0.6336309523809525,43.95254629629629,1024.189814814814,29.262566137566118,0
1928,4,0,1,50,0.0,0.0196078431372549,0.9803921568627451,51,750,300,450,0.4,12,3,9,344.0750890736047,0.8616993464052288,0.15172615222851826,0.19935766093044896,130911.78882444325,-1191.3029198889408,129720.48590455431,1902,3,487.37254901960785,40,11,14,35.35356669976829,0.6223958333333333,44.15650406504066,1023.3739837398384,25.58434959349596,6
1929,4,0,1,49,0.0,0.02,0.98,50,1700,1300,400,0.7647058823529411,21,13,8,340.35082026003914,0.8588945578231292,0.11181980551696769,0.1982691078948364,131119.87428944395,-1074.6486466389213,130045.22564280503,1903,11,498.06,40,10,15,35.23867996295562,0.6244791666666667,43.95325203252032,1024.1869918699174,25.604674796747936,2
1930,4,1,1,49,0.02,0.02,0.98,50,1350,1000,350,0.7407407407407407,17,10,7,339.12638448537325,0.8535374149659863,0.12808251193984366,0.19876966942945543,131354.81906467004,-1090.6577796187269,130264.1612850513,1904,0,498.54,39,11,16,35.03296158926939,0.6284722222222223,43.72395833333333,1025.1041666666658,26.2847222222222,0
1931,4,0,0,49,0.0,0.0,1.0,49,1300,900,400,0.6923076923076923,17,9,8,353.625487474387,0.85328089569161,0.1363862618218019,0.20712349980642655,131328.12499999988,-511.80555555557066,130816.3194444443,1905,13,509.7142857142857,38,11,16,34.68834688346883,0.6299342105263158,43.74999999999999,1024.999999999999,26.97368421052629,0
1932,4,3,5,47,0.057692307692307696,0.09615384615384616,0.9038461538461539,52,800,400,400,0.5,12,4,8,333.8183722757993,0.8606711915535444,0.14390381643086436,0.19814723565361644,131837.04963466854,-1598.0741370622486,130238.9754976063,1906,0,481.25,41,11,11,34.68331401339514,0.6300813008130082,43.253968253968246,1026.9841269841259,25.048393341076242,0
1933,4,1,1,47,0.020833333333333332,0.020833333333333332,0.9791666666666666,48,1800,1400,400,0.7777777777777778,22,14,8,350.107421875,0.8499187352245863,0.14218750000000013,0.20594554227941184,131492.4391847469,-392.7042241946058,131099.7349605523,1907,0,519.6875,38,10,16,34.61263020833333,0.631578947368421,43.58974358974359,1025.6410256410259,26.990553306342786,0
1934,4,0,0,47,0.0,0.0,1.0,47,1450,1200,250,0.8275862068965517,17,12,5,358.0146389861832,0.8467082947887757,0.14066118033472996,0.21062068761489053,131496.7646295015,15.553343336420909,131512.31797283792,1908,16,531.7446808510638,37,10,18,34.405512793101,0.6334459459459458,43.58552631578948,1025.657894736843,27.720483641536298,0
1935,4,1,1,47,0.020833333333333332,0.020833333333333332,0.9791666666666666,48,1150,700,450,0.6086956521739131,16,7,9,352.02426366049,0.8523936170212766,0.14480142212972535,0.2085667801342364,131766.5244448099,-322.9972514427484,131443.52719336716,1909,0,521.6458333333334,38,10,12,34.286984044398174,0.6343201754385963,43.32264957264958,1026.7094017094034,27.01866846603693,0
1936,4,0,1,46,0.0,0.02127659574468085,0.9787234042553191,47,1300,900,400,0.6923076923076923,17,9,8,365.3735447482581,0.8470551958063521,0.120951497606266,0.21113570486597805,130809.21292914524,251.78589068704116,131060.99881983228,1910,18,533.7446808510638,36,11,12,34.91257522383679,0.6284722222222223,44.25675675675675,1022.972972972972,28.41591591591589,8
1937,4,1,1,46,0.02127659574468085,0.02127659574468085,0.9787234042553191,47,1400,1200,200,0.8571428571428571,16,12,4,359.8169489082881,0.8468239284613012,0.15536708119191545,0.2098494468450526,131163.9135437212,38.99983563444749,131202.91337935565,1911,0,534.3404255319149,38,9,13,34.69571339173967,0.6282894736842106,43.91025641025641,1024.3589743589741,26.956815114709844,0
1938,4,0,1,45,0.0,0.021739130434782608,0.9782608695652174,46,750,300,450,0.4,12,3,9,344.57528754822187,0.8414251207729468,0.10525016994608305,0.20035143431664337,131047.2994094335,-168.86782471531546,130878.43158471819,1912,21,546.9565217391304,37,9,15,35.203826658099516,0.6289414414414416,44.024122807017534,1023.9035087719285,27.673067804646717,1
1939,4,0,0,45,0.0,0.0,1.0,45,1500,1100,400,0.7333333333333333,19,11,8,349.1911885438171,0.8393939393939395,0.11448820395738246,0.2039276541095889,131215.75869498288,163.87734687593957,131379.63604185882,1913,22,557.6222222222223,37,8,15,34.91545376712328,0.6306306306306307,43.85964912280701,1024.5614035087704,27.69084874348028,0
1940,4,0,1,44,0.0,0.022222222222222223,0.9777777777777777,45,900,700,200,0.7777777777777778,11,7,4,347.85781692356096,0.8390993265993266,0.10743672014260253,0.20404457893571468,131384.32618690346,140.61297706984317,131524.9391639733,1914,23,558.6222222222223,37,8,15,34.77941176470588,0.6323198198198199,43.69517543859648,1025.2192982456124,27.70862968231385,0
1941,4,0,0,44,0.0,0.0,1.0,44,900,500,400,0.5555555555555556,13,5,8,354.19152276295137,0.8379140239605356,0.10627872127872129,0.2071428571428571,131270.4173768363,498.97380488596355,131769.39118172225,1915,24,566.0454545454545,36,8,15,34.73214285714285,0.6331018518518519,43.806306306306304,1024.7747747747746,28.465965965965964,0
1942,4,0,0,44,0.0,0.0,1.0,44,800,400,400,0.5,12,4,8,354.1549324151158,0.8367027836504581,0.10225649885652088,0.20758997744847385,131356.983567182,504.14472749776405,131861.12829467977,1916,25,567.0454545454545,36,8,16,34.64562964590427,0.6339699074074074,43.721846846846844,1025.1126126126123,28.475350350350343,0
1943,4,0,1,43,0.0,0.022727272727272728,0.9772727272727273,44,1550,1200,350,0.7741935483870968,19,12,7,355.15429246945814,0.8357778365045807,0.10751354803940183,0.20912090821617926,131530.20154867697,542.703133877115,132072.90468255407,1917,26,568.0454545454545,36,8,17,34.445100084165844,0.6357060185185186,43.552927927927925,1025.7882882882877,28.494119119119105,0
1944,4,1,0,44,0.022727272727272728,0.0,1.0,44,1350,1000,350,0.7407407407407407,17,10,7,349.9045546666664,0.8380461592670896,0.04790060606060598,0.20907298916507333,132087.8554579295,443.62844817637415,132531.48390610586,1918,0,566.5454545454545,37,7,15,34.017666666666656,0.6393581081081081,43.00986842105264,1027.9605263157905,27.782716927453798,2
1945,4,0,0,44,0.0,0.0,1.0,44,950,500,450,0.5263157894736842,14,5,9,347.63482922260204,0.837737843551797,0.04950173520231105,0.20818131727008712,132172.40521121898,389.546302708544,132561.95151392752,1919,1,567.5454545454545,37,7,15,33.990900689557115,0.6402027027027026,42.92763157894738,1028.2894736842118,27.79160739687059,0
1946,4,1,0,45,0.022222222222222223,0.0,1.0,45,900,500,400,0.5555555555555556,13,5,8,340.1137537084692,0.8405303030303031,0.05308142150247441,0.20489779796583413,132398.00347222236,6.2687557710263775,132404.27222799338,1920,0,555.9111111111112,38,7,16,33.957489878542525,0.6406249999999998,42.70833333333334,1029.1666666666679,27.083333333333364,0
1947,4,0,0,45,0.0,0.0,1.0,45,1350,1000,350,0.7407407407407407,17,10,7,340.839456292293,0.8409511784511785,0.05393545638513153,0.20579689100503806,132482.65241468544,31.06304343645334,132513.71545812188,1921,1,556.9111111111112,37,8,16,33.85377835765257,0.6432995495495495,42.626096491228076,1029.4956140350887,27.824205784732126,0
1948,4,1,0,46,0.021739130434782608,0.0,1.0,46,1000,600,400,0.6,14,6,8,335.8175622769403,0.84176731078905,0.06994867681715156,0.20469385081555272,132838.18354381263,-278.1210050040095,132560.06253880862,1922,0,545.7826086956521,38,8,16,33.626325698690714,0.6450109649122806,42.28098290598291,1030.876068376069,27.128317588843924,0
1949,4,1,0,47,0.02127659574468085,0.0,1.0,47,1600,1400,200,0.875,18,14,4,345.6173602513096,0.846168670983657,0.04745573199445219,0.21045438644225908,132800.3268771702,-191.2710639730068,132609.0558131972,1923,0,535.1489361702128,39,8,18,33.41176099039917,0.6428952991452992,42.317708333333336,1030.7291666666672,26.428952991453006,8
1950,4,0,0,47,0.0,0.0,1.0,47,700,600,100,0.8571428571428571,8,6,2,344.4046983115326,0.8456290471785384,0.0468156426924764,0.20980761891734973,132816.69439693625,-251.4612870976364,132565.23310983862,1924,1,536.1489361702128,40,7,18,33.42658319366393,0.6414062500000001,42.30182926829268,1030.7926829268285,25.769817073170714,0
1951,4,0,0,47,0.0,0.0,1.0,47,1650,1400,250,0.8484848484848485,19,14,5,345.54502878125265,0.8448196114708603,0.044432141793643076,0.2109446367036453,132895.27253123128,-215.73984566066497,132679.53268557062,1925,2,537.1489361702128,40,7,18,33.318343846507666,0.6421875000000001,42.225609756097555,1031.0975609756088,25.77743902439022,0
1952,4,0,0,47,0.0,0.0,1.0,47,1700,1300,400,0.7647058823529411,21,13,8,345.75680837713236,0.8448196114708603,0.04619186454746105,0.21181516969440395,133026.2877276258,-201.05106500759564,132825.2366626182,1926,3,538.1489361702128,40,7,18,33.18145995468426,0.6434895833333333,42.09857723577236,1031.6056910569112,25.790142276422777,0
1953,4,0,0,47,0.0,0.0,1.0,47,1300,900,400,0.6923076923076923,17,9,8,346.2356128942793,0.8437018193031144,0.033510376399845,0.2127055444005692,133131.1463600536,-181.05118894176144,132950.09517111184,1927,4,539.1489361702128,40,7,18,33.06396684720171,0.64453125,41.9969512195122,1032.0121951219517,25.80030487804879,0
1954,4,0,0,47,0.0,0.0,1.0,47,1650,1100,550,0.6666666666666666,22,11,11,348.03401481802945,0.8421985815602836,0.03201122466074735,0.2145646596208242,133262.27774472878,-124.0388905413343,133138.23885418745,1928,5,540.1489361702128,40,7,18,32.88611384514436,0.6458333333333333,41.869918699187,1032.520325203253,25.81300813008132,0
1955,4,0,0,47,0.0,0.0,1.0,47,1200,900,300,0.75,15,9,6,348.54265682321903,0.8422756706753006,0.03513862024500303,0.21548586155420923,133367.2293277812,-103.16631138871304,133264.0630163925,1929,6,541.1489361702128,40,7,18,32.76781614849795,0.646875,41.768292682926834,1032.9268292682937,25.823170731707343,0
1956,4,0,0,47,0.0,0.0,1.0,47,1300,900,400,0.6923076923076923,17,9,8,346.13732555946666,0.8427382053654023,0.040332082831101124,0.21493349346004806,133528.88028047077,-156.0101647873687,133372.87011568338,1930,7,542.1489361702128,37,10,19,32.668063512271026,0.6537162162162162,41.61184210526315,1033.5526315789461,27.933854907539086,0
1957,4,0,1,46,0.0,0.02127659574468085,0.9787234042553191,47,1450,1200,250,0.8275862068965517,17,12,5,345.20566316056744,0.8412735121800801,0.042584775874944025,0.2151774361710053,133670.5780264118,-171.23189346723984,133499.34613294454,1931,8,543.1489361702128,37,10,19,32.550343724596175,0.6551238738738739,41.474780701754376,1034.100877192981,27.948672356567055,0
1958,4,0,0,46,0.0,0.0,1.0,46,850,800,50,0.9411764705882353,9,8,1,328.60030395846235,0.8369565217391305,0.14073550212164077,0.19588567866663795,131999.40212614913,-524.9912678024295,131474.4108583467,1932,9,554.7173913043479,42,4,18,34.6540546911834,0.6302083333333334,43.09593023255813,1027.6162790697663,24.467054263565863,6
1959,4,0,0,46,0.0,0.0,1.0,46,1600,1100,500,0.6875,21,11,10,331.42654831817805,0.8367954911433173,0.13558012679964082,0.1980903803440872,132098.99612590877,-443.77713553874383,131655.21899037002,1933,10,555.7173913043479,42,4,18,34.48133660099916,0.631200396825397,42.99903100775193,1028.0038759689912,24.47628276116646,0
1960,4,0,0,46,0.0,0.0,1.0,46,1050,700,350,0.6666666666666666,14,7,7,336.749953738053,0.8367954911433173,0.1464590186768484,0.20180278142416447,132198.62768350745,-296.42364866896435,131902.20403483848,1934,11,556.7173913043479,42,4,18,34.244362260121235,0.6321924603174605,42.90213178294573,1028.391472868216,24.485511258767048,0
1961,4,0,0,46,0.0,0.0,1.0,46,650,400,250,0.6153846153846154,9,4,5,333.61840763821067,0.836755233494364,0.14625939503164087,0.20018990373542128,132248.45754649641,-375.8960361456837,131872.56151035073,1935,12,557.7173913043479,42,4,18,34.274807662113346,0.6326884920634921,42.853682170542626,1028.585271317828,24.490125507567335,0
1962,4,0,0,46,0.0,0.0,1.0,46,1000,600,400,0.6,14,6,8,331.72903344788824,0.836292270531401,0.1453205600589531,0.19971441809617754,132373.07328285553,-417.6016690703746,131955.47161378516,1936,13,558.7173913043479,42,4,19,34.1982501569366,0.6339285714285714,42.73255813953488,1029.06976744186,24.501661129568095,0
1963,4,0,2,44,0.0,0.043478260869565216,0.9565217391304348,46,1450,900,550,0.6206896551724138,20,9,11,307.0667245815093,0.8353864734299518,0.04408142749434507,0.18574315857552853,132551.19756235846,-1055.043086506265,131496.1544758522,1937,14,559.7173913043479,41,5,15,34.65438342967246,0.6371951219512194,42.55952380952382,1029.7619047619062,25.11614401858308,3
1964,4,0,0,44,0.0,0.0,1.0,44,1550,1000,550,0.6451612903225806,21,10,11,311.6349383557491,0.8324304087385483,0.04149319886587999,0.18839410473869056,132528.77338224617,-539.8807753321207,131988.89260691404,1938,15,564.7045454545455,40,4,15,34.55923476773261,0.6385416666666666,42.58130081300814,1029.674796747969,25.741869918699223,0
1965,4,0,0,44,0.0,0.0,1.0,44,1750,1300,450,0.7428571428571429,22,13,9,331.41715807446315,0.8320340028188866,0.05083536623788176,0.19584446339344647,131666.8848424382,-57.358591116409315,131609.52625132177,1939,16,565.7045454545455,40,4,15,34.91620457471037,0.6299479166666667,43.419715447154466,1026.321138211381,25.658028455284523,3
1966,4,0,2,42,0.0,0.045454545454545456,0.9545454545454546,44,1300,900,400,0.6923076923076923,17,9,8,328.8888888888893,0.8311090556730092,0.054822134387352284,0.19495990836197027,131786.1128826529,-131.40235260771948,131654.71053004518,1940,17,566.7045454545455,41,3,16,34.86111111111113,0.6295731707317074,43.30357142857142,1026.785714285713,25.043554006968613,0
1967,4,2,0,44,0.045454545454545456,0.0,1.0,44,1050,800,250,0.7619047619047619,13,8,5,330.5587600479887,0.8334654686398872,0.0686028966690937,0.19766765322431054,132117.37769471196,-65.48868968885841,132051.8890050231,1941,0,561.7045454545455,41,3,18,34.485167583389625,0.6328760162601628,42.981150793650784,1028.0753968253953,25.075009678668177,0
1968,4,0,1,43,0.0,0.022727272727272728,0.9772727272727273,44,1050,600,450,0.5714285714285714,15,6,9,340.84468319749203,0.8334654686398872,0.08329273683545813,0.19842240742814127,131093.85456945267,143.44014005300642,131237.2947095057,1942,1,562.7045454545455,40,4,16,35.252307234295934,0.62421875,43.978658536585364,1024.0853658536582,25.602134146341456,3
1969,4,0,0,43,0.0,0.0,1.0,43,750,400,350,0.5333333333333333,11,4,7,344.81402561759455,0.8294573643410852,0.09245546381508873,0.20056342436810387,131061.33355034734,438.35720486112217,131499.69075520846,1943,2,576.2325581395348,39,4,17,35.18353679213293,0.625534188034188,44.01041666666667,1023.9583333333343,26.255341880341906,0
1970,4,0,0,43,0.0,0.0,1.0,43,1150,800,350,0.6956521739130435,15,8,7,343.8435810714617,0.8295035068290882,0.09050681260775884,0.20041576364408323,131141.34250217024,418.4217664930661,131559.7642686633,1944,3,577.2325581395348,39,4,18,35.12756788365707,0.62633547008547,43.93229166666667,1024.2708333333342,26.263354700854723,0
1971,4,0,0,43,0.0,0.0,1.0,43,1450,1200,250,0.8275862068965517,17,12,5,342.9025708484656,0.8285806570690292,0.09642581768436753,0.20113795717899344,131384.32618690372,410.67048575042855,131794.99667265415,1945,4,578.2325581395348,37,6,18,34.906417112299465,0.6323198198198199,43.69517543859649,1025.2192982456145,27.708629682313905,0
1972,4,1,0,44,0.022727272727272728,0.0,1.0,44,1000,800,200,0.8,12,8,4,340.4200669751846,0.8301620859760395,0.1197498363285967,0.2020590873153731,131835.77609592024,175.90874565972825,132011.68484157996,1946,0,566.0681818181819,39,5,17,34.515100415863664,0.6332799145299146,43.255208333333336,1026.9791666666674,26.332799145299166,0
1973,4,0,1,43,0.0,0.022727272727272728,0.9772727272727273,44,1800,1400,400,0.7777777777777778,22,14,8,337.9227588704378,0.8300960183227626,0.11631856433133958,0.2011425570753848,131942.77479383672,117.29329427082973,132060.06808810757,1947,1,567.0681818181819,39,5,17,34.47153080536686,0.6343482905982907,43.151041666666664,1027.3958333333328,26.343482905982892,0
1974,4,0,0,43,0.0,0.0,1.0,43,1500,1300,200,0.8666666666666667,17,13,4,343.59326720126415,0.8276116648209672,0.11745837067786224,0.2040861213617145,131862.52170138873,461.41493055553735,132323.93663194426,1948,2,581.1162790697674,39,4,17,34.406693711967534,0.6335470085470087,43.22916666666666,1027.083333333332,26.33547008547005,0
1975,4,1,1,43,0.022727272727272728,0.022727272727272728,0.9772727272727273,44,1100,900,200,0.8181818181818182,13,9,4,338.1200896677132,0.828884778012685,0.1161109663974993,0.20285201111600026,132241.16478493286,142.67889896886723,132383.84368390174,1949,0,568.8863636363636,40,4,18,34.16637848697428,0.6356770833333334,42.860772357723576,1028.5569105691054,25.713922764227636,0
1976,4,0,0,43,0.0,0.0,1.0,43,650,600,50,0.9230769230769231,7,6,1,343.37380329028394,0.8250738279808046,0.11653115892690158,0.2055453494407757,132156.90239800338,475.8436414930477,132632.74603949644,1950,4,583.1162790697674,39,4,18,34.11603434302502,0.6364850427350428,42.94270833333333,1028.2291666666658,26.364850427350405,0
1977,4,1,1,43,0.022727272727272728,0.022727272727272728,0.9772727272727273,44,1500,1100,400,0.7333333333333333,19,11,8,336.56773485108516,0.827849718111346,0.11576143953193174,0.20305020487169845,132451.61132812485,116.00748697915282,132567.618815104,1951,0,570.8409090909091,39,5,18,33.994889698441604,0.639423076923077,42.65624999999999,1029.3749999999989,26.39423076923074,0
1978,4,1,0,44,0.022727272727272728,0.0,1.0,44,900,700,200,0.7777777777777778,11,7,4,336.92164601076274,0.8315935517970402,0.11696589529450763,0.20355339542606204,132505.23003472204,128.77604166664827,132634.0060763887,1952,0,571.8181818181819,39,5,19,33.93194388236881,0.6399572649572651,42.60416666666666,1029.583333333332,26.39957264957261,0
1979,4,0,0,44,0.0,0.0,1.0,44,1050,800,250,0.7619047619047619,13,8,5,338.22395048648707,0.8309989429175476,0.11890552296176482,0.20463169978637746,132558.85959201376,166.91623263888042,132725.77582465264,1953,1,572.8181818181819,39,5,19,33.844578191381764,0.6404914529914532,42.55208333333333,1029.7916666666656,26.404914529914503,0
1980,4,0,0,44,0.0,0.0,1.0,44,1350,1100,250,0.8148148148148148,16,11,5,340.3470285928572,0.8291490486257929,0.11630637586051606,0.20665269857654703,132692.98095703125,232.33235677083422,132925.3133138021,1954,2,573.8181818181819,39,5,15,33.65528005257306,0.6418269230769231,42.421875,1030.3125,26.41826923076923,0
1981,4,0,2,42,0.0,0.045454545454545456,0.9545454545454546,44,950,600,350,0.631578947368421,13,6,7,333.56801092797434,0.8288627554615927,0.08227920830307323,0.2022473366074029,132639.32427300364,51.128472222240646,132690.4527452259,1955,3,574.8181818181819,39,5,16,33.88371338524287,0.6412927350427349,42.47395833333334,1030.104166666668,26.41292735042739,1
1982,4,0,1,41,0.0,0.023809523809523808,0.9761904761904762,42,850,800,50,0.9411764705882353,9,8,1,342.47751142580285,0.8230013550135501,0.08711562162408892,0.20678593921394656,132482.65241468555,674.4658212142449,133157.1182358998,1956,10,593.3571428571429,37,5,19,33.811619093265165,0.6432995495495495,42.62609649122808,1029.4956140350896,27.82420578473215,0
1983,4,1,1,41,0.023809523809523808,0.023809523809523808,0.9761904761904762,42,900,500,400,0.5555555555555556,13,5,8,339.43173491725713,0.8291957026713124,0.08288349932841688,0.2058722498094018,132652.03145439003,605.2618353724451,133257.29328976249,1957,0,583.2380952380952,37,5,17,33.719952989178644,0.6449887387387386,42.461622807017555,1030.1535087719315,27.841986723565714,0
1984,4,0,1,40,0.0,0.024390243902439025,0.975609756097561,41,750,400,350,0.5333333333333333,11,4,7,341.4845792860062,0.823119918699187,0.0777828561931273,0.20665097736173807,132567.32840874133,853.9396737457843,133421.2680824871,1958,12,598.4634146341464,37,4,19,33.75212947189097,0.644144144144144,42.543859649122815,1029.8245614035102,27.833096254148924,0
1985,4,0,0,40,0.0,0.0,1.0,40,750,500,250,0.6666666666666666,10,5,5,350.47435835612384,0.8198985042735043,0.08166557305336841,0.21195354052965612,132542.91453615797,1290.5785853421226,133833.4931215001,1959,13,613.55,36,4,21,33.54522090988627,0.6458333333333333,42.56756756756758,1029.7297297297314,28.60360360360365,0
1986,4,0,0,40,0.0,0.0,1.0,40,1300,1100,200,0.8461538461538461,15,11,4,348.375038166523,0.8194978632478632,0.08687144731088758,0.21133520219810056,132658.90045450872,1243.0099017937052,133901.91035630243,1960,14,614.55,36,4,17,33.482728465238296,0.6469907407407407,42.454954954954964,1030.1801801801817,28.616116116116157,0
1987,4,0,0,40,0.0,0.0,1.0,40,650,400,250,0.6153846153846154,9,4,5,344.09188419394235,0.8193643162393163,0.08071522238006756,0.20922158353878878,132745.9231824732,1135.3589653843221,133881.2821478575,1961,15,615.55,36,4,17,33.505673332604815,0.6478587962962963,42.370495495495504,1030.5180180180196,28.625500500500543,0
1988,4,0,0,40,0.0,0.0,1.0,40,700,400,300,0.5714285714285714,10,4,6,344.09188419394235,0.8193643162393163,0.08071522238006756,0.20922158353878878,132745.9231824732,1135.3589653843221,133881.2821478575,1962,16,616.55,36,4,17,33.505673332604815,0.6478587962962963,42.370495495495504,1030.5180180180196,28.625500500500543,0
1989,4,0,0,40,0.0,0.0,1.0,40,1100,800,300,0.7272727272727273,14,8,6,338.59020444949283,0.8184294871794872,0.07948261193236195,0.20660374383118657,132878.03849501783,998.2404441751423,133876.27893919297,1963,17,617.55,37,3,17,33.514902158885455,0.6472409909909909,42.242324561403514,1031.0307017543869,27.865694642010457,0
1990,4,0,0,40,0.0,0.0,1.0,40,1050,700,350,0.6666666666666666,14,7,7,339.91693385666247,0.8169871794871795,0.08082013394280829,0.20804154826217466,132991.1141529125,1041.1863506078846,134032.30050352038,1964,18,618.55,37,3,17,33.367328407923175,0.648367117117117,42.13267543859649,1031.4692982456145,27.877548601232824,0
1991,4,0,0,40,0.0,0.0,1.0,40,950,900,50,0.9473684210526315,10,9,1,340.6340746332551,0.8166399572649573,0.08115433673469452,0.20863837071286856,133019.39058171734,1062.1874038165522,134081.5779855339,1965,19,619.55,37,3,17,33.320489654195036,0.6486486486486487,42.10526315789473,1031.5789473684201,27.880512091038383,0
1992,4,1,0,41,0.024390243902439025,0.0,1.0,41,800,500,300,0.625,11,5,6,332.99447798725606,0.8189532520325203,0.08624261064168537,0.205690582664716,133334.25931633063,679.9144157717918,134014.1737321024,1966,0,605.4146341463414,38,3,18,33.20230336884936,0.6499451754385964,41.800213675213676,1032.7991452991453,27.178924876293298,0
1993,4,0,0,41,0.0,0.0,1.0,41,1000,400,600,0.4,16,4,12,333.65569229512187,0.8184959349593496,0.08672142765270108,0.2067126329395339,133444.62393390678,704.9116763459724,134149.53561025276,1967,1,606.4146341463414,38,3,18,33.0748285251439,0.6510416666666666,41.69337606837607,1033.2264957264958,27.190170940170944,0
1994,4,0,0,41,0.0,0.0,1.0,41,1100,800,300,0.7272727272727273,14,8,6,335.6883469152735,0.8184451219512195,0.09274694586358878,0.2089039313890096,133610.2564673277,770.2812248885857,134380.53769221628,1968,2,607.4146341463414,38,3,19,32.85668767868829,0.652686403508772,41.53311965811965,1033.8675213675208,27.20704003598739,0
1995,4,0,0,41,0.0,0.0,1.0,41,1550,1100,450,0.7096774193548387,20,11,9,333.8396624616583,0.8167682926829268,0.09601438780059635,0.2086875049461739,133775.99172921665,731.9463848710411,134507.93811408768,1969,3,608.4146341463414,38,3,17,32.73886364418742,0.6543311403508772,41.372863247863236,1034.508547008545,27.22390913180382,0
1996,4,0,0,41,0.0,0.0,1.0,41,1300,1000,300,0.7692307692307693,16,10,6,336.04425288990706,0.8166666666666667,0.10334251597729716,0.21053846270967888,133858.8978833368,796.5026663744401,134655.40054971122,1970,4,609.4146341463414,38,3,17,32.59902608575951,0.65515350877193,41.29273504273503,1034.8290598290582,27.23234367971206,0
1997,4,0,0,41,0.0,0.0,1.0,41,1100,800,300,0.7272727272727273,14,8,6,336.9766948297282,0.8155487804878049,0.10581520590278148,0.21207650170712472,134024.78723792807,832.6459657388955,134857.43320366697,1971,5,610.4146341463414,38,3,18,32.4092464575595,0.6567982456140352,41.13247863247862,1035.470085470084,27.24921277552853,0
1998,4,1,1,41,0.023809523809523808,0.023809523809523808,0.9761904761904762,42,1250,900,350,0.72,16,9,7,333.99527765426666,0.8183797909407665,0.11773669580361035,0.21214135280746116,134361.72010633675,575.2360026041622,134936.9561089409,1972,0,596.8571428571429,39,3,19,32.15037760809136,0.6583867521367521,40.807291666666664,1036.770833333333,26.583867521367512,0
1999,4,0,0,41,0.0,0.0,1.0,41,1250,700,550,0.56,18,7,11,337.1523764903759,0.8152439024390243,0.11824013991872362,0.2147809477104718,134469.73876953125,867.3583984375005,135337.09716796875,1973,1,600.9268292682926,39,2,19,31.960869237722193,0.6594551282051282,40.703125,1037.1875,26.59455128205128,0
2000,4,0,0,41,0.0,0.0,1.0,41,950,700,250,0.7368421052631579,12,7,5,340.286851955932,0.8158028455284553,0.09665263235420496,0.21329652203042182,133876.17323133687,911.260308159732,134787.4335394966,1974,2,601.9268292682926,39,2,17,32.472005535983904,0.6535790598290598,41.27604166666667,1034.895833333334,26.535790598290614,3
2001,4,0,0,41,0.0,0.0,1.0,41,1000,600,400,0.6,14,6,8,337.81009957175183,0.8152439024390243,0.09952947471509499,0.21205426149365136,133930.079481337,848.5866970486306,134778.6661783856,1975,3,602.9268292682926,39,2,17,32.48224229311328,0.6541132478632479,41.22395833333334,1035.104166666668,26.541132478632516,0
2002,4,0,0,41,0.0,0.0,1.0,41,1000,700,300,0.7,13,7,6,335.20469821322524,0.8138719512195122,0.10171188012423249,0.21119170530011971,134064.89257812515,787.8363715277916,134852.72894965293,1976,4,603.9268292682926,39,2,18,32.41509086032321,0.6554487179487178,41.09375000000001,1035.6250000000011,26.554487179487207,0
2003,4,0,0,41,0.0,0.0,1.0,41,1100,800,300,0.7272727272727273,14,8,6,332.2631532616769,0.8128556910569106,0.10176906514691542,0.20995484894159086,134172.7918836806,716.1349826388932,134888.9268663195,1977,5,604.9268292682926,39,2,18,32.38362155640458,0.656517094017094,40.989583333333336,1036.041666666667,26.565170940170947,0
2004,4,0,0,41,0.0,0.0,1.0,41,600,300,300,0.5,9,3,6,333.16955446164854,0.8120426829268292,0.10601469102748906,0.21083783255626454,134226.7578125,744.0538194444437,134970.81163194444,1978,6,605.9268292682926,39,2,18,32.30632622972792,0.657051282051282,40.9375,1036.25,26.57051282051282,0
2005,4,0,0,41,0.0,0.0,1.0,41,1100,700,400,0.6363636363636364,15,7,8,331.97289109914084,0.8108739837398374,0.10920712101011687,0.21070116149353635,134334.72222222228,719.0972222222273,135053.8194444445,1979,7,606.9268292682926,39,2,19,32.229702572347264,0.6581196581196581,40.833333333333336,1036.666666666667,26.58119658119659,0
2006,4,0,0,41,0.0,0.0,1.0,41,550,500,50,0.9090909090909091,6,5,1,332.1329956255676,0.8101626016260163,0.11050833835643914,0.21111442135740108,134388.72070312503,726.9856770833337,135115.70638020837,1980,8,607.9268292682926,39,2,19,32.17174000401848,0.6586538461538461,40.78125,1036.8750000000002,26.586538461538467,0
2007,4,0,0,41,0.0,0.0,1.0,41,1200,900,300,0.75,15,9,6,330.12941170053375,0.8084857723577236,0.1105263286792928,0.21061875791964216,134523.76437717007,682.0502387152726,135205.81461588535,1981,9,608.9268292682926,39,2,20,32.0891697626937,0.6599893162393162,40.651041666666664,1037.3958333333328,26.599893162393148,0
2008,4,0,0,41,0.0,0.0,1.0,41,1100,900,200,0.8181818181818182,13,9,4,329.3202018736839,0.8072662601626016,0.1085293693173619,0.210586918279226,134607.66774392122,665.8102883820056,135273.47803230322,1982,10,609.9268292682926,37,4,20,32.026627218934905,0.6644144144144144,40.57017543859649,1037.7192982456143,28.046467520151737,0
2009,4,0,0,41,0.0,0.0,1.0,41,1100,800,300,0.7272727272727273,14,8,6,330.1505671776264,0.8045223577235773,0.10225873747649783,0.21211166018806787,134778.39936326552,699.4329986149456,135477.83236188046,1983,11,610.9268292682926,37,4,21,31.835181274199222,0.6661036036036037,40.40570175438596,1038.3771929824554,28.064248458985283,0
2010,4,0,0,41,0.0,0.0,1.0,41,1050,700,350,0.6666666666666666,14,7,7,332.0740504017532,0.8044715447154471,0.10636741924851667,0.21368243243243232,134835.3339489073,755.0630963373255,135590.3970452446,1984,12,611.9268292682926,37,4,17,31.728603603603585,0.6666666666666667,40.35087719298245,1038.5964912280697,28.07017543859648,0
2011,4,0,1,40,0.0,0.024390243902439025,0.975609756097561,41,1500,1100,400,0.7333333333333333,19,11,8,354.34612607921997,0.8045731707317073,0.02369674053416926,0.22506745327801359,134361.7201063366,1322.1110026041474,135683.83110894077,1985,13,612.9268292682926,39,2,16,31.622898456076904,0.6583867521367522,40.80729166666666,1036.7708333333317,26.583867521367477,6
2012,4,0,0,40,0.0,0.0,1.0,40,1350,1200,150,0.8888888888888888,15,12,3,353.0900756331133,0.8008814102564102,0.027533470648815728,0.22526311658328022,134523.07167251056,1499.7523102490807,136022.82398275964,1986,20,628.925,38,2,17,31.494378647442485,0.661732456140351,40.65170940170939,1037.3931623931608,27.299820062977915,0
2013,4,0,0,40,0.0,0.0,1.0,40,700,500,200,0.7142857142857143,9,5,4,353.0900756331133,0.8008814102564102,0.027533470648815728,0.22526311658328022,134523.07167251056,1499.7523102490807,136022.82398275964,1987,21,629.925,38,2,17,31.494378647442485,0.661732456140351,40.65170940170939,1037.3931623931608,27.299820062977915,0
2014,4,0,0,40,0.0,0.0,1.0,40,1000,600,400,0.6,14,6,8,351.6811200702413,0.7986912393162393,0.02555595593534421,0.2248768083767117,134606.20896568394,1467.6924674921233,136073.90143317607,1988,22,630.925,38,2,18,31.447973506297387,0.6625548245614037,40.571581196581185,1037.7136752136737,27.30825461088615,0
2015,4,0,0,40,0.0,0.0,1.0,40,1000,600,400,0.6,14,6,8,351.55985737629516,0.7981570512820513,0.02249871332990261,0.2251419917212066,134661.64809564233,1468.3259597121605,136129.97405535448,1989,23,631.925,38,2,18,31.395822611082515,0.6631030701754387,40.518162393162385,1037.927350427349,27.313877642824973,0
2016,4,0,0,40,0.0,0.0,1.0,40,950,700,250,0.7368421052631579,12,7,5,354.758401376022,0.7978632478632479,0.02180522687519293,0.227884792000896,134772.56059838188,1562.339629446995,136334.90022782888,1990,24,632.925,38,2,18,31.202198442912504,0.6641995614035088,40.41132478632478,1038.3547008547005,27.325123706702644,0
2017,4,0,0,40,0.0,0.0,1.0,40,1200,500,700,0.4166666666666667,19,5,14,351.8830964568617,0.7970352564102564,0.021791443850267322,0.22690392771528672,134911.2654320988,1494.5987654321004,136405.8641975309,1991,25,633.925,38,2,15,31.138591800356497,0.6655701754385964,40.27777777777778,1038.8888888888891,27.339181286549714,0
2018,4,0,0,40,0.0,0.0,1.0,40,1200,900,300,0.75,15,9,6,350.12349953145133,0.7957264957264957,0.019217127583016635,0.226289121590859,134994.52257515173,1452.950932317937,136447.47350746967,1992,26,634.925,38,2,15,31.101358760837535,0.666392543859649,40.19764957264958,1039.209401709403,27.347615834457972,0
2019,4,0,0,40,0.0,0.0,1.0,40,900,500,400,0.5555555555555556,13,5,8,349.9491260982945,0.7953792735042735,0.015285773026316063,0.22635007305081192,135022.28066330642,1450.1858243845547,136472.46648769098,1993,27,635.925,38,2,15,31.078244928728076,0.6666666666666665,40.17094017094018,1039.3162393162402,27.350427350427374,0
2020,4,0,1,39,0.0,0.025,0.975,40,850,400,450,0.47058823529411764,13,4,9,351.3732797099261,0.794818376068376,0.014361702127659859,0.22744581758468885,135050.04160502966,1490.5952087442554,136540.63681377392,1994,28,636.925,38,2,15,31.013593380614665,0.6669407894736842,40.144230769230774,1039.4230769230776,27.35323886639678,0
2021,4,0,0,39,0.0,0.0,1.0,39,700,400,300,0.5714285714285714,10,4,6,355.7157196844512,0.7900922177237967,0.02131026479586473,0.23015899705726367,135034.69967922827,1806.7930757540832,136841.49275498235,1995,29,650.8461538461538,37,2,15,30.916038084186095,0.6686373873873873,40.15899122807018,1039.3640350877197,28.090919867235666,0
2022,4,0,0,39,0.0,0.0,1.0,39,700,300,400,0.42857142857142855,11,3,8,358.8638149649989,0.7903171390013496,0.014866008538896747,0.23292988071958162,135148.68907981314,1899.994830140057,137048.6839099532,1996,30,651.8461538461538,37,2,16,30.720653625786486,0.6697635135135135,40.049342105263165,1039.8026315789484,28.102773826458066,0
2023,4,0,0,39,0.0,0.0,1.0,39,1250,900,350,0.72,16,9,7,354.1667516173791,0.7900359874044085,0.0162327395383155,0.2306094696358323,135262.7265721184,1781.1120969913884,137043.8386691098,1997,31,652.8461538461538,37,2,16,30.72922156635396,0.6708896396396395,39.939692982456144,1040.241228070176,28.114627785680433,0
2024,4,0,0,39,0.0,0.0,1.0,39,800,500,300,0.625,11,5,6,355.77844482855795,0.7890800719748089,0.020920309886481192,0.23202623113252124,135319.76335266617,1828.7709920360078,137148.53434470217,1998,32,653.8461538461538,37,2,17,30.630532722099268,0.6714527027027027,39.88486842105263,1040.4605263157891,28.120554765291597,0
2025,4,0,0,39,0.0,0.0,1.0,39,1050,900,150,0.8571428571428571,12,9,3,356.71289763713304,0.7886864597390914,0.017187673072195153,0.23300496293695985,135376.8121561441,1858.1309874191918,137234.9431435633,1999,33,654.8461538461538,37,2,18,30.54944596635409,0.6720157657657657,39.830043859649116,1040.6798245614025,28.12648174490277,0
2026,4,0,0,39,0.0,0.0,1.0,39,800,500,300,0.625,11,5,6,354.72766091131143,0.7873369320737742,0.020641390282178484,0.23207647725920574,135433.87298255207,1808.4281942520538,137242.30117680412,2000,34,655.8461538461538,37,2,19,30.544326521296398,0.6725788288288289,39.7752192982456,1040.8991228070156,28.132408724513937,0
2027,4,0,0,39,0.0,0.0,1.0,39,1550,1300,250,0.8387096774193549,18,13,5,353.7821862376543,0.7860998650472335,0.01972884979833811,0.2323805812507081,135576.57764889195,1792.915608648816,137369.49325754077,2001,35,656.8461538461538,37,2,19,30.427019723450545,0.6739864864864864,39.63815789473684,1041.4473684210525,28.14722617354196,0
2028,4,0,0,39,0.0,0.0,1.0,39,850,500,350,0.5882352941176471,12,5,7,351.9829784197595,0.7835695006747638,0.028250188199678172,0.23212312587945683,135719.35745854487,1754.180733494918,137473.5381920398,2002,36,657.8461538461538,37,2,20,30.331978498018174,0.6753941441441441,39.50109649122807,1041.995614035087,28.16204362256992,0
2029,4,0,0,39,0.0,0.0,1.0,39,900,600,300,0.6666666666666666,12,6,6,348.47176991693283,0.7809266756635178,0.027687239336908087,0.23128506655128744,135947.96145208142,1674.805348761156,137622.76680084257,2003,37,658.8461538461538,37,2,15,30.196504924122944,0.6776463963963963,39.281798245614034,1042.872807017544,28.1857515410147,0
2030,4,0,0,39,0.0,0.0,1.0,39,1250,800,450,0.64,17,8,9,345.56380082432486,0.779408457040036,0.023068032104493374,0.23046465959671317,136119.54068799998,1607.5971693213114,137727.1378573213,2004,38,659.8461538461538,37,2,15,30.1021636720255,0.6793355855855856,39.1173245614035,1043.5307017543846,28.20353247984823,0
2031,4,0,0,39,0.0,0.0,1.0,39,1250,1000,250,0.8,15,10,5,350.2159687556578,0.779408457040036,0.07956059493705325,0.21813319586300223,133642.23246575875,1571.1917368805857,135213.42420263932,2005,39,660.8461538461538,37,2,17,32.449186991869915,0.6548423423423423,41.502192982456144,1033.991228070176,27.945708866761514,6
2032,4,0,0,39,0.0,0.0,1.0,39,750,700,50,0.9333333333333333,8,7,1,351.06863630928893,0.7785650022492128,0.08253077711362433,0.21916813013272815,133727.27816491612,1589.4906365420118,135316.76880145812,2006,40,661.8461538461538,37,2,15,32.34202180289056,0.6556869369369369,41.41995614035088,1034.3201754385966,27.954599336178287,0
2033,4,0,0,39,0.0,0.0,1.0,39,900,400,500,0.4444444444444444,14,4,10,361.25809531413574,0.7786774628879892,0.0867933762949673,0.22501082158601726,133642.23246575875,1855.867670821799,135498.10013658056,2007,41,662.8461538461538,37,2,17,32.163750441852244,0.6548423423423423,41.502192982456144,1033.991228070176,27.945708866761514,2
2034,4,0,0,39,0.0,0.0,1.0,39,850,700,150,0.8235294117647058,10,7,3,360.4809310394884,0.7780026990553307,0.0876954064699218,0.22504411796793483,133727.2781649161,1841.2267476531233,135568.50491256922,2008,42,663.8461538461538,37,2,15,32.098638644475066,0.6556869369369369,41.41995614035088,1034.3201754385964,27.95459933617828,0
2035,4,0,0,39,0.0,0.0,1.0,39,900,600,300,0.6666666666666666,12,6,6,363.767757283333,0.7777215474583896,0.09146874881140699,0.22797078972377774,133869.08111149565,1939.4510811018577,135808.53219259751,2009,43,664.8461538461538,37,2,15,31.871600621600635,0.6570945945945947,41.282894736842096,1034.8684210526299,27.969416785206214,0
2036,4,0,0,39,0.0,0.0,1.0,39,1150,700,450,0.6086956521739131,16,7,9,365.3354056431586,0.7747975708502025,0.09975702786713936,0.23019298907936148,134067.73147747354,1995.93781259615,136063.6692900697,2010,44,665.8461538461538,37,2,16,31.632146638433028,0.6590653153153154,41.09100877192981,1035.6359649122783,27.990161213845358,0
2037,4,0,0,39,0.0,0.0,1.0,39,1500,1000,500,0.6666666666666666,20,10,10,363.1939450558201,0.7734480431848854,0.09549707983238931,0.22937542733204425,134152.91243459497,1944.7051015696866,136097.61753616465,2011,45,666.8461538461538,37,2,16,31.6023673440587,0.6599099099099102,41.00877192982455,1035.9649122806995,27.99905168326215,0
2038,4,0,0,39,0.0,0.0,1.0,39,950,600,350,0.631578947368421,13,6,7,358.3788437518516,0.7735605038236617,0.0916328285417467,0.2272136291070586,134294.94081111453,1825.6931219220833,136120.63393303662,2012,46,667.8461538461538,37,2,16,31.585100849818396,0.6613175675675678,40.871710526315766,1036.5131578947335,28.013869132290093,0
2039,4,0,0,39,0.0,0.0,1.0,39,650,400,250,0.6153846153846154,9,4,5,358.61974312945796,0.7718735942420153,0.09417979088029882,0.22789706256936465,134380.1939058168,1838.2781240381253,136218.47202985492,2013,47,668.8461538461538,37,2,16,31.49367244782853,0.6621621621621623,40.789473684210506,1036.842105263155,28.02275960170689,0
2040,4,0,1,38,0.0,0.02564102564102564,0.9743589743589743,39,800,700,100,0.875,9,7,2,357.81346487203206,0.773110661268556,0.09610708564086279,0.22791633429121513,134465.4740521119,1822.7114352492733,136288.1854873612,2014,48,669.8461538461538,37,2,16,31.42939264192831,0.6630067567567569,40.707236842105246,1037.1710526315767,28.031650071123693,0
2041,4,0,0,38,0.0,0.0,1.0,38,850,600,250,0.7058823529411765,11,6,5,359.6580306719188,0.7693515884305359,0.11362182050871827,0.22944389048128225,134521.57393880366,2076.3528731434058,136597.92681194708,2015,49,685.2368421052631,36,2,16,31.32553553336227,0.6655092592592593,40.65315315315315,1037.3873873873872,28.81631631631631,0
2042,4,0,1,37,0.0,0.02631578947368421,0.9736842105263158,38,1050,900,150,0.8571428571428571,12,9,3,356.75731706030604,0.7705369843527738,0.11252741228070207,0.22832468291859565,134638.42220598966,2006.6484558883076,136645.07066187795,2016,50,686.2368421052631,36,2,16,31.284134476273156,0.6666666666666667,40.54054054054053,1037.8378378378368,28.8288288288288,0
2043,4,0,0,37,0.0,0.0,1.0,37,900,600,300,0.6666666666666666,12,6,6,358.22765750208225,0.7677052052052052,0.10654276836489451,0.2300041087861558,134755.3211995779,2254.6166098530916,137009.937809431,2017,51,690.081081081081,36,1,19,31.129338394793926,0.6678240740740742,40.427927927927925,1038.288288288288,28.841341341341334,0
2044,4,0,0,37,0.0,0.0,1.0,37,1000,700,300,0.7,13,7,6,355.0471017572468,0.7667042042042042,0.10636178242422822,0.22869793761234958,134872.27091956825,2177.2017794821895,137049.47269905044,2018,52,691.081081081081,36,1,16,31.09528584851113,0.6689814814814814,40.31531531531532,1038.7387387387391,28.853853853853863,0
2045,4,0,0,37,0.0,0.0,1.0,37,350,200,150,0.5714285714285714,5,2,3,355.4369900338571,0.766453953953954,0.10691276642496184,0.22913390866962483,134901.51627556607,2189.797779198116,137091.3140547642,2019,53,692.081081081081,36,1,16,31.05600722673893,0.6692708333333334,40.28716216216216,1038.8513513513512,28.856981981981978,0
2046,4,0,0,37,0.0,0.0,1.0,37,550,300,250,0.5454545454545454,8,3,5,354.2598705207898,0.7652652652652653,0.11191596929106384,0.2287442844853274,134960.01649876233,2162.1835940670435,137122.2000928294,2020,54,693.081081081081,36,1,16,31.028277518875754,0.669849537037037,40.23085585585586,1039.076576576577,28.863238238238253,0
2047,4,0,0,37,0.0,0.0,1.0,37,550,100,450,0.18181818181818182,10,1,9,352.37218326312797,0.7648273273273273,0.11181597722560022,0.2277094192683576,134989.27136596065,2113.292853664488,137102.56421962514,2021,55,694.081081081081,36,1,16,31.048168617251847,0.6701388888888888,40.20270270270271,1039.18918918919,28.866366366366393,0
2048,4,0,0,37,0.0,0.0,1.0,37,1050,700,350,0.6666666666666666,14,7,7,350.1992866977071,0.7636386386386387,0.09247089611001669,0.22722347252845612,135135.5932579539,2064.8776732813913,137200.4709312353,2022,56,695.081081081081,36,1,14,30.95892450991011,0.6715856481481481,40.06193693693694,1039.7522522522524,28.88200700700701,1
2049,4,0,0,37,0.0,0.0,1.0,37,700,500,200,0.7142857142857143,9,5,4,349.8669516640224,0.7637012012012012,0.09388921084827473,0.22719208380208047,135164.86714755304,2057.944008197398,137222.81115575045,2023,57,696.081081081081,36,1,14,30.938425023464006,0.671875,40.03378378378379,1039.8648648648657,28.885135135135158,0
2050,4,0,0,37,0.0,0.0,1.0,37,750,400,350,0.5333333333333333,11,4,7,349.17596067584225,0.7627627627627628,0.0945594793580935,0.2271119135776112,135223.42443795147,2043.3538267997735,137266.77826475125,2024,58,697.081081081081,36,1,14,30.89811606756171,0.6724537037037037,39.97747747747748,1040.0900900900901,28.891391391391394,0
2051,4,0,0,37,0.0,0.0,1.0,37,850,600,250,0.7058823529411765,11,6,5,348.44991326758674,0.7623248248248248,0.08938403655874994,0.22700848369294543,135281.99440995054,2027.7998437626868,137309.79425371322,2025,59,698.081081081081,36,1,14,30.858726636357073,0.6730324074074073,39.921171171171174,1040.3153153153157,28.89764764764766,0
2052,4,0,0,37,0.0,0.0,1.0,37,1650,1500,150,0.9090909090909091,18,15,3,349.5864603299816,0.7621371371371372,0.08858339083349898,0.22886524357580387,135457.78041555072,2070.8411959256605,137528.62161147638,2026,60,699.081081081081,36,1,14,30.65434335785373,0.6747685185185185,39.752252252252255,1040.9909909909913,28.916416416416425,0
2053,4,0,0,37,0.0,0.0,1.0,37,550,500,50,0.9090909090909091,6,5,1,349.5864603299816,0.7621371371371372,0.08858339083349898,0.22886524357580387,135457.78041555072,2070.8411959256605,137528.62161147638,2027,61,700.081081081081,36,1,14,30.65434335785373,0.6747685185185185,39.752252252252255,1040.9909909909913,28.916416416416425,0
2054,4,0,0,37,0.0,0.0,1.0,37,950,700,250,0.7368421052631579,12,7,5,348.45722744878515,0.762575075075075,0.08841064247638664,0.22887304257431587,135575.03449395354,2048.4201262073034,137623.45462016083,2028,62,701.081081081081,36,1,15,30.567194708765854,0.6759259259259258,39.63963963963965,1041.4414414414425,28.928928928928958,0
2055,4,0,1,36,0.0,0.02702702702702703,0.972972972972973,37,950,700,250,0.7368421052631579,12,7,5,360.48281861679015,0.762575075075075,0.09567026791907174,0.22705479452054791,134054.6881340799,2264.882365473565,136319.57049955346,2029,63,702.081081081081,36,1,18,31.770833333333325,0.6608796296296298,41.103603603603595,1035.5855855855843,28.766266266266232,4
2056,4,0,0,36,0.0,0.0,1.0,36,1150,1000,150,0.8695652173913043,13,10,3,359.8175785399336,0.7598544973544974,0.07374791621367005,0.22699602794309373,134113.00447406853,2451.2433041149143,136564.24777818343,2030,64,672.8888888888889,36,0,18,31.729723853011517,0.6614583333333335,41.04729729729729,1035.8108108108097,28.772522522522493,0
2057,4,0,0,36,0.0,0.0,1.0,36,850,600,250,0.7058823529411765,11,6,5,358.1065746800486,0.759623015873016,0.0727185450856791,0.22645626073066163,134200.5027620525,2411.616472891798,136612.1192349443,2031,65,673.8888888888889,36,0,20,31.68654675216461,0.662326388888889,40.96283783783783,1036.1486486486478,28.781906906906883,0
2058,4,0,0,36,0.0,0.0,1.0,36,1250,1000,250,0.8,15,10,5,360.0340179960845,0.7603174603174604,0.07613995703285337,0.2285843565291002,134346.39665002836,2473.854597841076,136820.25124786943,2032,66,674.8888888888889,36,0,20,31.49078499529292,0.6637731481481481,40.82207207207207,1036.7117117117111,28.79754754754753,0
2059,4,0,0,36,0.0,0.0,1.0,36,950,700,250,0.7368421052631579,12,7,5,359.07912820132896,0.7609457671957672,0.06908398788624681,0.22852520328998177,134433.9710276154,2454.486623447763,136888.45765106316,2033,67,675.8888888888889,36,0,20,31.42804140876678,0.6646412037037037,40.73761261261261,1037.049549549549,28.806931931931917,0
2060,4,0,0,36,0.0,0.0,1.0,36,750,500,250,0.6666666666666666,10,5,5,359.2811476926958,0.7603835978835979,0.07052720472915941,0.22883674759679995,134463.16882761128,2462.016323756175,136925.18515136745,2034,68,676.8888888888889,36,0,20,31.39363916033297,0.6649305555555556,40.70945945945945,1037.1621621621614,28.81006006006004,0
2061,4,0,0,36,0.0,0.0,1.0,36,1450,1300,150,0.896551724137931,16,13,3,361.47953154480894,0.7609457671957672,0.062320348894836286,0.2315534599209887,134670.88906035645,2536.182511653268,137207.0715720097,2035,69,677.8888888888889,35,1,20,31.12920011894141,0.6690476190476191,40.509259259259245,1037.9629629629612,29.656084656084605,0
2062,4,0,0,36,0.0,0.0,1.0,36,1000,700,300,0.7,13,7,6,362.6159328015175,0.7615740740740741,0.05916905089238189,0.23285809113546238,134761.00508241155,2573.297512645732,137334.3025950573,2036,70,678.8888888888889,35,1,20,31.009758295247643,0.6699404761904763,40.422453703703695,1038.310185185184,29.66600529100526,0
2063,4,0,0,36,0.0,0.0,1.0,36,1350,1200,150,0.8888888888888888,15,12,3,363.98989150689596,0.7606150793650794,0.05869425253200622,0.23432175655544335,134851.15124528436,2616.8911822701994,137468.04242755455,2037,71,679.8888888888889,35,1,20,30.884128222271748,0.6708333333333335,40.33564814814813,1038.6574074074053,29.675925925925867,0
2064,4,0,1,35,0.0,0.027777777777777776,0.9722222222222222,36,700,400,300,0.5714285714285714,10,4,6,361.4272641482457,0.760218253968254,0.05533273915626857,0.2330582703300755,134911.26543209868,2552.1219135802357,137463.3873456789,2038,72,680.8888888888889,35,1,20,30.890708556149722,0.6714285714285715,40.27777777777777,1038.8888888888882,29.682539682539662,0
2065,4,0,0,35,0.0,0.0,1.0,35,850,600,250,0.7058823529411765,11,6,5,363.91287741628304,0.7572829131652661,0.08178173719376436,0.2354421930258083,135031.5339934841,2827.9428155006744,137859.47680898476,2039,93,699.2857142857143,35,0,20,30.70619896065331,0.6726190476190477,40.16203703703703,1039.3518518518508,29.695767195767168,0
2066,4,0,0,35,0.0,0.0,1.0,35,1200,900,300,0.75,15,9,6,363.91760335116146,0.7561624649859944,0.08104936799427631,0.2364280308105699,135181.9450472606,2839.0178915894844,138020.9629388501,2040,94,700.2857142857143,35,0,20,30.556135225375627,0.6741071428571429,40.0173611111111,1039.930555555554,29.712301587301546,0
2067,4,0,0,35,0.0,0.0,1.0,35,1100,800,300,0.7272727272727273,14,8,6,362.5373893341242,0.7542717086834734,0.07460547017783647,0.23631969490387514,135302.33417191767,2810.431000300047,138112.7651722177,2041,95,701.2857142857143,35,0,20,30.47208161827418,0.6752976190476192,39.90162037037036,1040.393518518517,29.72552910052906,0
2068,4,0,0,35,0.0,0.0,1.0,35,850,600,250,0.7058823529411765,11,6,5,362.29507935233966,0.7519607843137255,0.06656605931597581,0.23695415626295177,135422.77688025107,2812.601139188937,138235.37801944002,2042,96,702.2857142857143,35,0,20,30.358450090811353,0.6764880952380954,39.78587962962962,1040.8564814814804,29.738756613756582,0
2069,4,0,0,35,0.0,0.0,1.0,35,800,500,300,0.625,11,5,6,362.45199712861745,0.7511204481792717,0.06815972553130689,0.23725569593702933,135452.8959297838,2819.034529320971,138271.93045910477,2043,97,703.2857142857143,35,0,20,30.324382921947965,0.6767857142857143,39.756944444444436,1040.972222222221,29.74206349206346,0
2070,4,0,0,35,0.0,0.0,1.0,35,900,600,300,0.6666666666666666,12,6,6,362.5996902114419,0.751750700280112,0.06906694195187857,0.23755165429365735,135483.01832829622,2825.220094950246,138308.23842324648,2044,98,704.2857142857143,35,0,20,30.29055493792848,0.6770833333333335,39.728009259259245,1041.087962962961,29.745370370370313,0
2071,4,0,0,35,0.0,0.0,1.0,35,850,800,50,0.9411764705882353,9,8,1,363.82806717499795,0.7507002801120448,0.07225265564712036,0.2387571933168093,135543.2731722608,2862.8894193672777,138406.16259162806,2045,99,705.2857142857143,35,0,20,30.198607869289756,0.6776785714285715,39.670138888888886,1041.3194444444443,29.751984126984123,0
2072,4,0,0,35,0.0,0.0,1.0,35,1000,900,100,0.9,11,9,2,362.97254482988274,0.7494397759103641,0.07519164537273637,0.23899896678959592,135663.82304794676,2848.448618612835,138512.2716665596,2046,100,706.2857142857143,35,0,20,30.10093785875643,0.6788690476190475,39.55439814814815,1041.782407407408,29.76521164021166,0
2073,4,0,0,35,0.0,0.0,1.0,35,1100,800,300,0.7272727272727273,14,8,6,367.1692430134245,0.7480392156862744,0.08130818886897462,0.24298996119191146,135844.74833086855,2975.602682398836,138820.35101326738,2047,101,707.2857142857143,35,0,20,29.811651123200456,0.6806547619047618,39.38078703703704,1042.4768518518524,29.785052910052926,0
2074,4,0,0,35,0.0,0.0,1.0,35,650,400,250,0.6153846153846154,9,4,5,364.35165784193475,0.7469187675070027,0.07921746436894606,0.2419434626981336,135965.432165745,2907.8461237568613,138873.27828950188,2048,102,708.2857142857143,35,0,16,29.765125032367855,0.681845238095238,39.2650462962963,1042.9398148148148,29.79828042328042,0
2075,4,0,0,35,0.0,0.0,1.0,35,1100,800,300,0.7272727272727273,14,8,6,360.11749690615477,0.743767507002801,0.07530306631804162,0.2399452501558746,136086.16958429775,2801.402150848754,138887.5717351465,2049,103,709.2857142857143,35,0,16,29.755615640598997,0.6830357142857142,39.14930555555555,1043.4027777777771,29.81150793650792,0
2076,4,0,0,35,0.0,0.0,1.0,35,450,300,150,0.6666666666666666,6,3,3,359.4359313109141,0.7432072829131652,0.07506654835847426,0.23969484886828418,136116.36231138548,2785.0222908093347,138901.38460219483,2050,104,710.2857142857143,35,0,16,29.743419106773153,0.6833333333333333,39.120370370370374,1043.5185185185187,29.81481481481482,0
2077,4,0,0,35,0.0,0.0,1.0,35,1000,500,500,0.5,15,5,10,356.53312650705607,0.7438375350140055,0.07798945318067396,0.23877396690572775,136267.37618152003,2716.766734182095,138984.14291570213,2051,105,711.2857142857143,35,0,16,29.66931326903892,0.6848214285714286,38.97569444444444,1044.097222222222,29.8313492063492,0
2078,4,0,0,35,0.0,0.0,1.0,35,700,500,200,0.7142857142857143,9,5,4,360.09079121403687,0.74390756302521,0.0811370326991867,0.24218923111012627,136418.4737761487,2824.6072316529358,139243.08100780164,2052,106,712.2857142857143,35,0,17,29.426564000295446,0.6863095238095238,38.83101851851851,1044.675925925925,29.84788359788357,0
2079,4,0,0,35,0.0,0.0,1.0,35,1100,800,300,0.7272727272727273,14,8,6,366.5194850145946,0.7439775910364145,0.08858945770270976,0.24799779087167279,136630.1510657793,3015.522521219135,139645.67358699843,2053,107,713.2857142857143,35,0,17,29.048696446363337,0.6883928571428571,38.62847222222222,1045.4861111111109,29.87103174603174,0
2080,4,0,0,35,0.0,0.0,1.0,35,900,500,400,0.5555555555555556,13,5,8,368.1117219926511,0.7425770308123248,0.09264985611861687,0.25016223520103825,136783.17920918364,3070.3284684822947,139853.50767766594,2054,108,714.2857142857143,34,1,18,28.855363984674334,0.6920955882352942,38.482142857142854,1046.0714285714282,30.766806722689065,0
2081,4,0,0,35,0.0,0.0,1.0,35,950,600,350,0.631578947368421,13,6,7,368.3923063880897,0.742016806722689,0.08945229969120772,0.25102080412025646,136876.59438775506,3084.8568594104227,139961.45124716547,2055,109,715.2857142857143,34,1,19,28.755451270383023,0.6930147058823529,38.39285714285714,1046.4285714285709,30.777310924369733,0
2082,4,0,0,35,0.0,0.0,1.0,35,850,400,450,0.47058823529411764,13,4,9,367.321099699756,0.7403361344537814,0.09057854462153303,0.2509599401445188,136970.04145408171,3062.3972505668985,140032.4387046486,2056,110,716.2857142857143,34,1,17,28.690909435535833,0.6939338235294118,38.30357142857143,1046.785714285715,30.78781512605044,0
2083,4,0,0,35,0.0,0.0,1.0,35,1000,800,200,0.8,12,8,4,365.591854302018,0.7377450980392156,0.08956948676254717,0.2508143055025745,137114.60108292598,3025.5962523576673,140140.19733528365,2057,111,717.2857142857143,35,0,17,28.593053560246073,0.693154761904762,38.16550925925925,1047.337962962962,29.92394179894177,0
2084,4,0,0,35,0.0,0.0,1.0,35,1250,1000,250,0.8,15,10,5,366.1905387683893,0.7374649859943977,0.09200915042991253,0.2525403905976972,137296.4908720207,3055.335192686894,140351.8260647076,2058,112,718.2857142857143,35,0,18,28.397409350266887,0.6949404761904763,37.991898148148145,1048.032407407407,29.943783068783056,0
2085,4,0,0,35,0.0,0.0,1.0,35,850,600,250,0.7058823529411765,11,6,5,365.26170420295256,0.7373949579831932,0.08766362804781891,0.2525603447839959,137387.480977795,3036.4770876200337,140423.95806541503,2059,113,719.2857142857143,35,0,19,28.331769338338123,0.6958333333333333,37.905092592592595,1048.3796296296302,29.95370370370372,0
2086,4,0,0,35,0.0,0.0,1.0,35,750,600,150,0.8,9,6,3,367.2295074777423,0.7361344537815125,0.086736045411542,0.2543653927942159,137448.15779320986,3095.00385802469,140543.16165123455,2060,114,720.2857142857143,35,0,19,28.220198675496693,0.6964285714285714,37.84722222222222,1048.611111111111,29.96031746031746,0
2087,4,0,0,35,0.0,0.0,1.0,35,1250,900,350,0.72,16,9,7,363.4797836547639,0.734593837535014,0.08624385323414452,0.25265189869990623,137569.55161179687,3000.750171467748,140570.30178326461,2061,115,721.2857142857143,35,0,19,28.198551044424818,0.6976190476190476,37.731481481481474,1049.0740740740732,29.97354497354495,0
2088,4,0,0,35,0.0,0.0,1.0,35,950,800,150,0.8421052631578947,11,8,3,362.18404543605027,0.7354341736694677,0.08509029025243509,0.2521935910847333,137630.26861496893,2969.4974922839274,140599.76610725286,2062,116,722.2857142857143,35,0,19,28.172567835870275,0.6982142857142858,37.6736111111111,1049.3055555555538,29.98015873015868,0
2089,4,0,0,35,0.0,0.0,1.0,35,750,500,250,0.6666666666666666,10,5,5,362.114292463413,0.7350140056022408,0.08416409351565979,0.2525886464660174,137690.9990140602,2971.9757373113703,140662.97475137157,2063,117,723.2857142857143,35,0,19,28.11443170122041,0.6988095238095239,37.61574074074073,1049.5370370370358,29.986772486772452,0
2090,4,0,0,35,0.0,0.0,1.0,35,550,100,450,0.18181818181818182,10,1,9,363.6748184841639,0.7342436974789915,0.08209521709687095,0.25434805539474553,137782.1197300454,3021.5774766375134,140803.69720668293,2064,118,724.2857142857143,35,0,19,27.983523499797897,0.6997023809523809,37.52893518518518,1049.884259259259,29.996693121693113,0
2091,4,0,0,35,0.0,0.0,1.0,35,800,600,200,0.75,10,6,4,363.51450337988064,0.7336134453781512,0.08207712049881155,0.25468471731008924,137842.88361893425,3021.5774766375052,140864.46109557175,2065,119,725.2857142857143,35,0,20,27.927757265145665,0.7002976190476191,37.47106481481481,1050.11574074074,30.003306878306855,0
2092,4,0,0,35,0.0,0.0,1.0,35,1250,800,450,0.64,17,8,9,367.17613444880027,0.7310924369747899,0.08022789153118537,0.2581609428653569,137964.4515844692,3131.4508048268062,141095.902389296,2066,120,726.2857142857143,35,0,20,27.711638390070135,0.7014880952380953,37.35532407407407,1050.578703703703,30.01653439153437,0
2093,4,0,0,35,0.0,0.0,1.0,35,600,200,400,0.3333333333333333,10,2,8,368.1644741151279,0.7294117647058823,0.0779443928689445,0.25931460515835864,138025.25566111522,3163.1991330161004,141188.45479413134,2067,121,727.2857142857143,35,0,20,27.625679223115625,0.7020833333333334,37.297453703703695,1050.8101851851839,30.02314814814811,0
2094,4,0,0,35,0.0,0.0,1.0,35,1250,1000,250,0.8,15,10,5,364.58380019157084,0.7284313725490196,0.07131851199647832,0.25839379161783227,138238.1754222392,3079.879865397784,141318.055287637,2068,122,728.2857142857143,35,0,19,27.50981363269498,0.7041666666666667,37.0949074074074,1051.620370370369,30.04629629629626,0
2095,4,0,0,35,0.0,0.0,1.0,35,750,600,150,0.8,9,6,3,367.53480933544455,0.728781512605042,0.06345824614799334,0.2442642847884236,135995.6114969135,2996.6242283950546,138992.23572530856,2069,123,729.2857142857143,35,0,15,29.65213049267644,0.6821428571428572,39.23611111111111,1043.055555555555,29.801587301587286,7
2096,4,0,0,35,0.0,0.0,1.0,35,1000,600,400,0.6,14,6,8,369.6396192827658,0.726890756302521,0.05590062111801286,0.2464993200779154,136116.3623113854,3062.8000685870984,139179.1623799725,2070,124,730.2857142857143,35,0,15,29.477225672877847,0.6833333333333333,39.12037037037037,1043.518518518518,29.8148148148148,0
2097,4,0,0,35,0.0,0.0,1.0,35,800,600,200,0.75,10,6,4,367.99059910359483,0.726610644257703,0.05247231420016174,0.24560852939430874,136146.55838745268,3020.1307173782398,139166.6891048309,2071,125,731.2857142857143,35,0,15,29.49024527743891,0.6836309523809524,39.091435185185176,1043.634259259258,29.818121693121658,0
2098,4,0,0,35,0.0,0.0,1.0,35,1000,500,500,0.5,15,5,10,366.1791239964405,0.7265406162464986,0.04926195755464047,0.2450249034456893,136237.16670953357,2977.4412722908028,139214.60798182437,2072,126,732.2857142857143,35,0,16,29.447524020694747,0.6845238095238095,39.004629629629626,1043.981481481481,29.828042328042315,0
2099,4,0,0,35,0.0,0.0,1.0,35,1250,1000,250,0.8,15,10,5,366.3072228033833,0.7252801120448179,0.045146784051683486,0.2455292543931739,136297.58900248614,2985.3582604595213,139282.94726294567,2073,127,733.2857142857143,35,0,16,29.384190497302903,0.6851190476190476,38.94675925925925,1044.212962962962,29.834656084656054,0
2100,4,0,0,35,0.0,0.0,1.0,35,1050,800,250,0.7619047619047619,13,8,5,366.77213215052143,0.7271008403361344,0.03942895128359325,0.24668295564758597,136418.47377614872,3006.8988983196023,139425.37267446832,2074,128,734.2857142857143,35,0,17,29.25206809956422,0.6863095238095238,38.83101851851851,1044.6759259259252,29.847883597883577,0
2101,4,0,0,35,0.0,0.0,1.0,35,600,300,300,0.5,9,3,6,366.6274338991697,0.726750700280112,0.041466386089268115,0.24722024650303215,136509.17252068315,3009.6015249914094,139518.77404567457,2075,129,735.2857142857143,35,0,18,29.165859083693274,0.6872023809523811,38.744212962962955,1045.023148148147,29.8578042328042,0
2102,4,0,0,35,0.0,0.0,1.0,35,650,300,350,0.46153846153846156,10,3,7,366.8371511917833,0.7261904761904762,0.043042178678180276,0.2482127330872941,136630.1510657793,3024.20307677469,139654.354142554,2076,130,736.2857142857143,35,0,18,29.04039355695783,0.6883928571428571,38.62847222222222,1045.4861111111109,29.87103174603174,0
2103,4,0,0,35,0.0,0.0,1.0,35,700,600,100,0.8571428571428571,8,6,2,384.57412169843593,0.7279411764705882,0.009340294257237591,0.2595444184556709,136539.4121334877,3501.904899691361,140041.31703317905,2077,131,737.2857142857143,35,0,19,28.666943521594682,0.6875,38.71527777777778,1045.1388888888891,29.861111111111118,3
2104,4,0,0,35,0.0,0.0,1.0,35,1550,1300,250,0.8387096774193549,18,13,5,386.7327729064459,0.728781512605042,0.01980868052810547,0.26212532657237364,136690.660432206,3572.5516278720916,140263.2120600781,2078,132,738.2857142857143,35,0,20,28.460270245342187,0.6889880952380951,38.570601851851855,1045.717592592593,29.877645502645517,0
2105,4,0,0,35,0.0,0.0,1.0,35,700,200,500,0.2857142857142857,12,2,10,385.8811258740925,0.7281512605042016,0.011491001316880745,0.26223800874366987,136783.1792091837,3556.4127877552864,140339.59199693898,2079,133,739.2857142857143,34,1,20,28.39066234209629,0.692095588235294,38.48214285714286,1046.071428571429,30.766806722689086,0
2106,4,0,0,35,0.0,0.0,1.0,35,1000,800,200,0.8,12,8,4,387.02127875370184,0.7280812324929972,0.00959963603275682,0.2641840902797009,136938.88888888893,3599.6527777777824,140538.54166666672,2080,134,740.2857142857143,34,1,21,28.206276539278136,0.6936274509803921,38.333333333333336,1046.666666666667,30.784313725490204,0
2107,4,0,0,35,0.0,0.0,1.0,35,600,300,300,0.5,9,3,6,383.6128740573999,0.7271708683473389,0.005041455147280827,0.24756957371770513,134941.32754897542,3353.0460980366856,138294.3736470121,2081,135,741.2857142857143,35,0,20,30.284453789313417,0.6717261904761905,40.24884259259259,1039.004629629629,29.685846560846546,5
2108,4,0,0,35,0.0,0.0,1.0,35,1200,1000,200,0.8333333333333334,14,10,4,380.52056015839287,0.7271008403361344,0.0034354423131974787,0.246597090284465,135091.68836805553,3281.0329861111068,138372.72135416663,2082,136,742.2857142857143,35,0,20,30.214595858383426,0.6732142857142858,40.104166666666664,1039.5833333333333,29.70238095238095,0
2109,4,0,0,35,0.0,0.0,1.0,35,750,600,150,0.8,9,6,3,381.0569497235905,0.7260504201680672,0.004120237167972718,0.24797674201056522,135242.13291162965,3306.9909282835933,138549.12383991326,2083,137,743.2857142857143,35,0,21,30.050466414450504,0.674702380952381,39.95949074074073,1040.162037037036,29.718915343915317,0
2110,4,0,0,35,0.0,0.0,1.0,35,1050,900,150,0.8571428571428571,12,9,3,380.0495173849079,0.7259103641456582,0.0036612108692197776,0.24794231939697545,135332.43982553153,3286.60568844307,138619.0455139746,2084,138,744.2857142857143,35,0,21,29.986559139784937,0.6755952380952381,39.87268518518518,1040.5092592592591,29.728835978835974,0
2111,4,0,0,35,0.0,0.0,1.0,35,1000,700,300,0.7,13,7,6,379.7602613948658,0.7247899159663865,0.0013726487036096469,0.24816891500455193,135392.66117969825,3283.3504801097442,138676.011659808,2085,139,745.2857142857143,35,0,21,29.93401542111506,0.6761904761904761,39.81481481481482,1040.740740740741,29.735449735449745,0
2112,4,0,0,35,0.0,0.0,1.0,35,1300,900,400,0.6923076923076923,17,9,8,376.8613966454099,0.7219887955182073,0.002971758766847188,0.24772649440555491,135603.54141214435,3220.748001328891,138824.28941347325,2086,140,746.2857142857143,35,0,21,29.799260102974408,0.6782738095238094,39.612268518518526,1041.550925925927,29.758597883597915,0
2113,4,0,1,34,0.0,0.02857142857142857,0.9714285714285714,35,700,200,500,0.2857142857142857,12,2,10,380.6155362963874,0.7217787114845938,0.03475874685570557,0.24953999103809632,135509.70096371887,3315.4228501135613,138825.12381383244,2087,141,747.2857142857143,34,1,18,29.79504916533272,0.6795343137254901,39.702380952380956,1041.1904761904766,30.6232492997199,3
2114,4,0,0,34,0.0,0.0,1.0,34,700,400,300,0.5714285714285714,10,4,6,388.87345170870844,0.7187314319667262,0.04978148094278323,0.25424959394627106,135410.3758920848,3731.5000540657416,139141.87594615054,2088,147,766.1176470588235,33,1,18,29.67922112327799,0.6808712121212122,39.79779411764706,1040.808823529412,31.53966131907309,0
2115,4,0,0,34,0.0,0.0,1.0,34,850,500,350,0.5882352941176471,12,5,7,389.5097823468608,0.7175059417706477,0.04164993839380937,0.25580016463551936,135569.86045030746,3761.157367358701,139331.01781766617,2089,148,767.1176470588235,33,1,20,29.50351062995216,0.682449494949495,39.64460784313725,1041.4215686274501,31.558229352346974,0
2116,4,0,0,34,0.0,0.0,1.0,34,800,500,300,0.625,11,5,6,388.1994325557649,0.7176173499702911,0.0420014811431102,0.25516681958943893,135601.76862564884,3728.1059268070035,139329.87455245585,2090,149,768.1176470588235,33,1,20,29.505799701925714,0.6827651515151516,39.6139705882353,1041.5441176470592,31.561942959001794,0
2117,4,0,0,34,0.0,0.0,1.0,34,650,400,250,0.6153846153846154,9,4,5,385.7452390463875,0.7173945335710042,0.03729133662167694,0.25446018367815604,135729.43887266915,3671.3969687139565,139400.83584138312,2091,150,769.1176470588235,33,1,20,29.442427182563023,0.6840277777777778,39.49142156862745,1042.0343137254902,31.576797385620914,0
2118,4,1,1,34,0.02857142857142857,0.02857142857142857,0.9714285714285714,35,1050,800,250,0.7619047619047619,13,8,5,377.15145269463443,0.7282913165266106,0.03059710012558514,0.25007339698352,135912.84190759622,3251.945153061208,139164.78706065743,2092,0,748.1142857142858,34,1,18,29.483721505499105,0.6835171568627452,39.31547619047618,1042.738095238094,30.668767507002766,0
2119,4,0,0,34,0.0,0.0,1.0,34,1350,1000,350,0.7407407407407407,17,10,7,372.79515390049835,0.7173945335710042,0.07039324770241939,0.2215204261607095,131877.80612244908,3032.681405895707,134910.4875283448,2093,152,771.1176470588235,34,0,19,33.6414387266265,0.6433823529411763,43.21428571428572,1027.142857142858,30.21008403361347,7
2120,4,0,0,34,0.0,0.0,1.0,34,750,600,150,0.8,9,6,3,372.56518464114345,0.716131907308378,0.0682298411832869,0.22174052023814297,131938.95266439934,3031.172052154224,134970.12471655358,2094,153,772.1176470588235,34,0,19,33.58560254924682,0.6439950980392155,43.15476190476192,1027.3809523809543,30.21708683473395,0
2121,4,0,0,34,0.0,0.0,1.0,34,750,500,250,0.6666666666666666,10,5,5,374.73796100609786,0.7163918597742127,0.07168074042268957,0.2232134811210238,131969.53125000023,3090.798611111139,135060.3298611114,2095,154,773.1176470588235,34,0,19,33.498918626655865,0.6443014705882352,43.125000000000014,1027.5000000000018,30.220588235294173,0
2122,4,0,0,34,0.0,0.0,1.0,34,600,300,300,0.5,9,3,6,374.7792561279365,0.7150549613784908,0.07331652985455861,0.22395978385223098,132091.88102324287,3101.0593820861927,135192.94040532905,2096,155,774.1176470588235,34,0,20,33.374348581354944,0.6455269607843136,43.005952380952394,1027.9761904761924,30.234593837535073,0
2123,4,0,1,33,0.0,0.029411764705882353,0.9705882352941176,34,650,500,150,0.7692307692307693,8,5,3,376.0556163549609,0.7146836007130125,0.07735188552670125,0.22508609552722092,132153.07716836745,3139.38137755103,135292.4585459185,2097,156,775.1176470588235,34,0,20,33.27978464744703,0.6461397058823529,42.94642857142858,1028.2142857142865,30.241596638655484,0
2124,4,0,1,32,0.0,0.030303030303030304,0.9696969696969697,33,800,600,200,0.75,10,6,4,378.6444212911152,0.7145675505050506,0.07440872796611098,0.22678125189534237,132177.37956855536,3409.645478902343,135587.02504745772,2098,157,783.3333333333334,33,0,20,33.188709132801016,0.6486742424242424,42.92279411764706,1028.3088235294117,31.160873440285204,0
2125,4,0,0,32,0.0,0.0,1.0,32,750,600,150,0.8,9,6,3,382.06277059186664,0.7127016129032259,0.06760219739749562,0.2291813939058429,132235.6216840119,3704.461598306302,135940.0832823182,2099,158,791.78125,32,0,21,33.04203494557657,0.6516927083333333,42.86616161616162,1028.5353535353538,32.14172979797981,0
2126,4,0,0,32,0.0,0.0,1.0,32,800,700,100,0.875,9,7,2,385.2477328480546,0.7134576612903226,0.07087628865979356,0.23148956690604366,132300.56244260803,3793.6983471074554,136094.26078971548,2100,159,792.78125,32,0,21,32.894575355915556,0.65234375,42.80303030303031,1028.78787878788,32.14962121212125,0
2127,4,0,0,32,0.0,0.0,1.0,32,350,200,150,0.5714285714285714,5,2,3,385.83971999843794,0.7134156586021506,0.06770385936924761,0.23204486186474335,132333.03880025004,3811.8685274461873,136144.90732769622,2101,160,793.78125,32,0,21,32.846566040823,0.6526692708333333,42.77146464646465,1028.914141414142,32.15356691919194,0
2128,4,0,0,32,0.0,0.0,1.0,32,800,600,200,0.75,10,6,4,383.53982959407676,0.7127016129032259,0.06592741935483848,0.23126486292457488,132431.5071105957,3758.567476267717,136190.07458686343,2102,161,794.78125,31,1,22,32.806372549019606,0.65625,42.67578125,1029.296875,33.203125,0
2129,4,0,0,32,0.0,0.0,1.0,32,550,400,150,0.7272727272727273,7,4,3,378.72253468748795,0.7116515456989247,0.06956997763697337,0.20950774444670722,129105.1315713958,3379.0045339761277,132484.13610537193,2103,162,795.78125,32,0,20,36.305752267362415,0.6201171875,45.928030303030305,1016.287878787879,31.758996212121218,7
2130,4,1,0,33,0.030303030303030304,0.0,1.0,33,1150,1000,150,0.8695652173913043,13,10,3,369.79088310516016,0.727667297979798,0.08243044253274423,0.20714646890274732,129598.82948133686,2984.9648607882846,132583.79434212513,2104,0,772.6363636363636,31,2,18,36.029411764705884,0.6276881720430108,45.442708333333336,1018.2291666666671,32.84610215053765,0
2131,4,1,0,34,0.029411764705882353,0.0,1.0,34,1300,800,500,0.6153846153846154,18,8,10,348.306838730207,0.7378936423054071,0.08158356766632902,0.1852093525686688,127524.87775134569,2113.464632367968,129638.34238371365,2105,0,750.8823529411765,33,1,20,38.6925705734854,0.6016414141414141,47.48774509803922,1010.0490196078435,30.607546048722533,7
2132,4,1,0,35,0.02857142857142857,0.0,1.0,35,450,400,50,0.8888888888888888,5,4,1,341.35303077910635,0.7497198879551821,0.08848902715883256,0.18295230261631001,127843.36911848094,1727.9443027211105,129571.31342120205,2106,0,730.4,34,1,21,38.54227977241512,0.6026348039215685,47.17261904761906,1011.3095238095256,29.74439775910369,0
2133,4,2,1,36,0.05405405405405406,0.02702702702702703,0.972972972972973,37,1100,800,300,0.7272727272727273,14,8,6,323.5856076216243,0.7681431431431431,0.09314548463342764,0.17573608225630657,128372.67324334488,907.9098946920084,129280.58313803689,2107,0,691.8648648648649,36,1,16,38.45172611771677,0.6038773148148147,46.649774774774784,1013.4009009009023,28.150025025025066,0
2134,4,2,1,37,0.05263157894736842,0.02631578947368421,0.9736842105263158,38,1150,900,250,0.782608695652174,14,9,5,319.0970543453685,0.7856804172593647,0.09785242228111923,0.1747292391072212,128700.23108071709,613.5729262850085,129313.8040070021,2108,0,674.6052631578947,37,1,18,38.232115841798155,0.6052927927927928,46.32675438596491,1014.6929824561398,27.42413466097675,0
2135,4,0,0,37,0.0,0.0,1.0,37,950,600,350,0.631578947368421,13,6,7,325.97926715252703,0.7727102102102102,0.10085849144359194,0.1780530781833118,128601.01814229778,984.2531298190163,129585.27127211679,2109,1,693.8378378378378,36,1,18,38.15851559897859,0.6061921296296295,46.42454954954955,1014.3018018018024,28.175050050050068,0
2136,4,0,0,37,0.0,0.0,1.0,37,800,600,200,0.75,10,6,4,327.9596827123622,0.7705205205205206,0.10393303080019334,0.17965013379459555,128715.26668137734,1042.6836042123234,129757.95028558966,2110,2,694.8378378378378,36,1,18,37.991991269929336,0.607349537037037,46.31193693693694,1014.7522522522524,28.18756256256257,0
2137,4,1,2,36,0.02631578947368421,0.05263157894736842,0.9473684210526316,38,1000,700,300,0.7,13,7,6,317.21506718732104,0.7755452821242295,0.09537805342102379,0.17529111673374503,129062.08070031164,588.0873201369602,129650.16802044859,2111,0,677.5263157894736,37,1,19,37.91219290672997,0.6089527027027027,45.9703947368421,1016.1184210526316,27.462660028449502,0
2138,4,2,1,37,0.05263157894736842,0.02631578947368421,0.9736842105263158,38,900,400,500,0.4444444444444444,14,4,10,318.29550787919305,0.7828947368421053,0.10545325578096199,0.17688381279685514,129285.00987082548,630.1675756001663,129915.17744642565,2112,0,678.3157894736842,37,1,21,37.65846810422281,0.611204954954955,45.75109649122806,1016.9956140350864,27.486367946894227,0
2139,4,4,4,37,0.0975609756097561,0.0975609756097561,0.9024390243902439,41,900,500,400,0.5555555555555556,13,5,8,298.30690674549874,0.8032012195121951,0.0721711315473812,0.1654247391952309,129201.38888888879,-491.6666666666762,128709.72222222212,2113,0,629.5853658536586,41,0,20,38.25136612021858,0.603658536585366,45.83333333333333,1016.6666666666658,24.796747967479654,6
2140,4,1,3,35,0.02631578947368421,0.07894736842105263,0.9210526315789473,38,1150,700,450,0.6086956521739131,16,7,9,322.8432548755735,0.7789532954006638,0.06641183451549648,0.18139719712661126,129717.84056770032,775.7059728614164,130493.54654056173,2114,0,680.1052631578947,38,0,15,37.10387170075161,0.6137609649122808,45.3258547008547,1018.6965811965811,26.80780476833108,4
2141,4,2,2,35,0.05405405405405406,0.05405405405405406,0.9459459459459459,37,800,500,300,0.625,11,5,6,326.85939834989813,0.774024024024024,0.06723725987212625,0.18319512567745944,129619.76431450051,1073.487635618643,130693.25195011916,2115,0,699.3783783783783,37,0,15,37.101032805714084,0.6145833333333333,45.422149122807014,1018.3114035087711,27.521929824561383,0
2142,4,1,0,36,0.027777777777777776,0.0,1.0,36,1250,800,450,0.64,17,8,9,334.2994451050336,0.7615079365079366,0.09450830140485333,0.18810580717104142,129774.47041636235,1476.7066897979125,131251.17710616026,2116,0,719.7777777777778,36,0,16,36.7546695402299,0.6180555555555556,45.270270270270274,1018.9189189189192,28.30330330330331,0
2143,4,0,0,36,0.0,0.0,1.0,36,1000,700,300,0.7,13,7,6,336.05844761807816,0.7598214285714286,0.10049534121459858,0.18951183859135393,129860.54202428798,1528.1464319048987,131388.68845619287,2117,1,720.7777777777778,36,0,16,36.62256472581299,0.618923611111111,45.18581081081082,1019.2567567567583,28.312687687687728,0
2144,4,2,0,38,0.05263157894736842,0.0,1.0,38,1250,800,450,0.64,17,8,9,320.574966803581,0.7798423423423424,0.09070566280778847,0.18342413271149233,130426.23325525966,762.2770792241928,131188.51033448384,2118,0,683.7894736842105,38,0,18,36.44493253843739,0.6208881578947368,44.631410256410255,1021.4743589743587,26.880904183535755,0
2145,4,0,2,36,0.0,0.05263157894736842,0.9473684210526316,38,1100,900,200,0.8181818181818182,13,9,4,320.56307513600166,0.780049786628734,0.09076554023570327,0.18406400820834296,130562.68376981524,770.7150814522661,131333.3988512675,2119,1,684.7894736842105,38,0,14,36.307408181754816,0.6222587719298245,44.49786324786325,1022.0085470085475,26.894961763382828,0
2146,4,1,0,37,0.02702702702702703,0.0,1.0,37,1200,800,400,0.6666666666666666,16,8,8,325.6564309657653,0.7682682682682682,0.09677288363701786,0.1866215635755844,130486.549948061,1098.7568290243262,131585.30677708532,2120,0,704.2162162162163,37,0,19,36.254203334048796,0.6233108108108107,44.57236842105264,1021.7105263157899,27.613798008534864,0
2147,4,0,0,37,0.0,0.0,1.0,37,700,400,300,0.5714285714285714,10,4,6,327.05244156274756,0.7677677677677678,0.10314348683447405,0.18769265735004984,130542.57079101274,1138.8533010157128,131681.42409202846,2121,1,705.2162162162163,37,0,15,36.1619277539342,0.6238738738738738,44.51754385964913,1021.9298245614044,27.619724988146064,0
2148,4,0,0,37,0.0,0.0,1.0,37,800,400,400,0.5,12,4,8,324.4180013806783,0.7666416416416416,0.09538882511855484,0.1867205830168794,130654.64854570646,1077.3439904586114,131731.99253616505,2122,2,706.2162162162163,37,0,15,36.11602674102675,0.625,44.40789473684211,1022.3684210526322,27.63157894736844,0
2149,4,0,0,37,0.0,0.0,1.0,37,650,400,250,0.6153846153846154,9,4,5,325.5047315397321,0.7659534534534534,0.09711995688193786,0.18775402789555243,130738.73842191834,1111.215590373962,131849.9540122923,2123,3,707.2162162162163,37,0,15,36.00333708587967,0.6258445945945945,44.32565789473684,1022.6973684210532,27.64046941678522,0
2150,4,0,0,37,0.0,0.0,1.0,37,850,500,350,0.5882352941176471,12,5,7,325.94148353368934,0.7654529529529529,0.09905951391322687,0.1885530057565317,130850.90033712305,1129.9473155201683,131980.84765264322,2124,4,708.2162162162163,37,0,17,35.87894741542529,0.6269707207207207,44.21600877192983,1023.1359649122815,27.652323376007608,0
2151,4,0,0,37,0.0,0.0,1.0,37,950,700,250,0.7368421052631579,12,7,5,324.959486419231,0.7650775775775776,0.1080270501864331,0.18867050778668767,130991.17036011073,1113.3646891351073,132104.53504924584,2125,5,709.2162162162163,37,0,19,35.76254998571836,0.6283783783783784,44.07894736842105,1023.6842105263152,27.667140825035546,0
2152,4,0,0,37,0.0,0.0,1.0,37,850,700,150,0.8235294117647058,10,7,3,326.066880952272,0.7649524524524525,0.11083974767058336,0.18986687456946494,131103.4404816865,1149.6979839950586,132253.13846568155,2126,6,710.2162162162163,37,0,19,35.620985010706626,0.6295045045045045,43.96929824561403,1024.1228070175425,27.678994784257906,0
2153,4,1,0,38,0.02631578947368421,0.0,1.0,38,800,600,200,0.75,10,6,4,324.08303027450347,0.7707147937411095,0.1264852150169149,0.190500490361602,131465.0463533677,921.1181194754986,132386.1644728432,2127,0,692.5,38,0,20,35.30749730874745,0.6313048245614035,43.616452991452995,1025.5341880341884,26.98774179037338,0
2154,4,1,0,39,0.02564102564102564,0.0,1.0,39,950,400,550,0.42105263157894735,15,4,11,320.63005987518943,0.7742352676563203,0.1336163836163835,0.189911650849151,131755.55555555574,648.9583333333542,132404.51388888908,2128,0,675.7179487179487,39,0,15,35.10382846320344,0.6324786324786323,43.33333333333334,1026.6666666666683,26.324786324786366,0
2155,4,1,1,39,0.025,0.025,0.975,40,700,500,200,0.7142857142857143,9,5,4,310.8926072294102,0.780448717948718,0.1224485759493672,0.18536238468772412,132006.0810364203,207.94294070991845,132214.02397713021,2129,0,659.8,40,0,16,35.10227122890297,0.6333333333333332,43.089430894308954,1027.642276422766,25.69105691056915,0
2156,4,0,0,39,0.0,0.0,1.0,39,1100,800,300,0.7272727272727273,14,8,6,314.2653906809334,0.7713675213675214,0.12767229391659174,0.1873249594602666,131996.290418837,496.3731553819648,132492.66357421895,2130,2,677.7179487179487,39,0,16,35.02544771076195,0.6348824786324785,43.09895833333334,1027.6041666666683,26.34882478632483,0
2157,4,0,2,37,0.0,0.05128205128205128,0.9487179487179487,39,900,500,400,0.5555555555555556,13,5,8,313.2727400708945,0.7702991452991453,0.12120172655289685,0.186997103828162,132049.81689453142,473.5215928819603,132523.3384874134,2131,3,678.7179487179487,39,0,16,34.997234046147064,0.6354166666666666,43.04687500000001,1027.8125000000014,26.354166666666703,0
2158,4,1,0,38,0.02631578947368421,0.0,1.0,38,500,500,0,1.0,5,5,0,319.19847406365693,0.7707147937411095,0.12518128533353834,0.19007626780620374,131958.5539141829,824.1938098108003,132782.7477239937,2132,0,690.4473684210526,38,0,18,34.93661398218433,0.6362390350877192,43.13568376068376,1027.457264957265,27.03834907782276,0
2159,4,0,0,38,0.0,0.0,1.0,38,950,600,350,0.631578947368421,13,6,7,320.1972242512785,0.771040777619725,0.1229018492176388,0.19108544027898874,132040.8950617284,855.8256172839556,132896.72067901236,2133,1,691.4473684210526,38,0,19,34.82826576576578,0.6370614035087719,43.05555555555556,1027.7777777777778,27.046783625730995,0
2160,4,0,0,38,0.0,0.0,1.0,38,1150,900,250,0.782608695652174,14,9,5,320.6221112239954,0.7709518729255571,0.12448919304810135,0.1914776742449448,132068.3478180474,868.8065006574624,132937.15431870485,2134,2,692.4473684210526,38,0,19,34.789782766864136,0.6373355263157894,43.02884615384615,1027.8846153846157,27.04959514170041,0
2161,4,0,1,37,0.0,0.02631578947368421,0.9736842105263158,38,950,600,350,0.631578947368421,13,6,7,321.38057552330145,0.770448079658606,0.1279163842302058,0.19290849009590685,132260.59701219955,901.1973573672278,133161.79436956678,2135,3,693.4473684210526,38,0,19,34.577317892258705,0.6392543859649124,42.84188034188034,1028.6324786324785,27.069275753486277,0
2162,4,1,0,38,0.02631578947368421,0.0,1.0,38,1250,900,350,0.72,16,9,7,321.3529122577384,0.7713371266002845,0.13739594940027522,0.19401984100974726,132480.48159105846,914.5977153188617,133395.07930637733,2136,0,693.6578947368421,38,0,20,34.35748754669987,0.6414473684210527,42.628205128205124,1029.487179487179,27.09176788124155,0
2163,4,0,0,38,0.0,0.0,1.0,38,800,600,200,0.75,10,6,4,319.23590060570365,0.7721372688477952,0.13362655003521873,0.19316477375633226,132562.98539201164,863.7728057199,133426.75819773154,2137,1,694.6578947368421,38,0,20,34.32928727046373,0.6422697368421053,42.54807692307691,1029.8076923076908,27.100202429149757,0
2164,4,0,0,38,0.0,0.0,1.0,38,1100,500,600,0.45454545454545453,17,5,12,321.1014737685234,0.7729374110953059,0.1364306140714706,0.1950064617773074,132700.54879830524,922.0683578055389,133622.6171561108,2138,2,695.6578947368421,38,0,16,34.14342250794968,0.643640350877193,42.414529914529915,1030.3418803418806,27.114260008996858,0
2165,4,0,0,38,0.0,0.0,1.0,38,800,300,500,0.375,13,3,10,320.6634917486801,0.7725521574205785,0.13631005975280353,0.1948833886525532,132728.07004026952,912.2092784352374,133640.27931870476,2139,3,696.6578947368421,38,0,16,34.12713841368585,0.6439144736842106,42.38782051282051,1030.4487179487176,27.117071524966253,0
2166,4,0,1,37,0.0,0.02631578947368421,0.9736842105263158,38,600,400,200,0.6666666666666666,8,4,4,318.3186214450139,0.7721076339497392,0.13254451427075153,0.1938849785165084,132810.65088757392,855.2206607495045,133665.87154832343,2140,4,697.6578947368421,38,0,16,34.10486629353234,0.6447368421052632,42.30769230769231,1030.7692307692305,27.125506072874487,0
2167,4,0,0,37,0.0,0.0,1.0,37,1000,800,200,0.8,12,8,4,326.00473701959277,0.7673923923923924,0.14139514554452282,0.1983248235111426,132765.01092884355,1256.404494652204,134021.41542349575,2141,9,717.4054054054054,37,0,16,33.95252597794091,0.6461148648648649,42.35197368421053,1030.5921052631584,27.853840682788064,0
2168,4,1,1,37,0.02631578947368421,0.02631578947368421,0.9736842105263158,38,900,700,200,0.7777777777777778,11,7,4,316.8756109066332,0.7751896633475581,0.12175632513103318,0.1942333956365155,133047.67001625508,833.7909260541794,133881.46094230926,2142,0,699.5,37,1,17,33.904927020228854,0.6489301801801801,42.077850877192986,1031.6885964912287,27.88347558084402,1
2169,4,0,0,37,0.0,0.0,1.0,37,950,700,250,0.7368421052631579,12,7,5,323.21574517568763,0.7648273273273273,0.12695058277672722,0.19744406795021818,132920.05423920538,1192.3708759435135,134112.4251151489,2143,1,719.1351351351351,36,1,17,33.86912562338467,0.6495949074074074,42.20157657657658,1031.1936936936934,28.64426926926926,0
2170,4,0,0,37,0.0,0.0,1.0,37,750,500,250,0.6666666666666666,10,5,5,321.3232489845731,0.7638888888888888,0.12790038947244176,0.1967460535226397,133007.1625679734,1147.6587229121033,134154.8212908855,2144,2,720.1351351351351,36,1,18,33.830740538573515,0.650462962962963,42.11711711711712,1031.5315315315318,28.65365365365366,0
2171,4,0,0,37,0.0,0.0,1.0,37,1100,900,200,0.8181818181818182,13,9,4,322.5893800747276,0.7632007007007007,0.1265468873500304,0.19813733773490627,133123.35139193243,1188.8358797987144,134312.18727173115,2145,3,721.1351351351351,36,1,18,33.68184380910811,0.6516203703703705,42.0045045045045,1031.9819819819816,28.666166166166153,0
2172,4,0,0,37,0.0,0.0,1.0,37,1100,900,200,0.8181818181818182,13,9,4,324.094128262944,0.7626376376376376,0.12749610087888685,0.19952792973716638,133210.52629910313,1234.54987927116,134445.0761783743,2146,4,722.1351351351351,36,1,18,33.55582524271844,0.6524884259259259,41.92004504504504,1032.3198198198197,28.675550550550547,0
2173,4,0,0,37,0.0,0.0,1.0,37,900,400,500,0.4444444444444444,14,4,10,323.80053936140905,0.7609484484484484,0.12527149327934484,0.19997136339956098,133326.80389426576,1234.2582024592066,134561.06209672496,2147,5,723.1351351351351,36,1,20,33.4471431686839,0.6536458333333335,41.80743243243243,1032.7702702702693,28.688063063063037,0
2174,4,1,1,37,0.02631578947368421,0.02631578947368421,0.9736842105263158,38,800,400,400,0.5,12,4,8,318.1881645140401,0.7686699857752489,0.12197810785315166,0.19803275268665887,133613.88991083778,902.8716768620875,134516.76158769988,2148,0,705.078947368421,37,1,20,33.30538321490436,0.6545608108108109,41.52960526315788,1033.881578947367,27.942745376955862,0
2175,4,0,0,37,0.0,0.0,1.0,37,850,700,150,0.8235294117647058,10,7,3,324.73136807764513,0.7605730730730731,0.1254037565182573,0.2018083430998445,133559.51126379753,1274.1925624949222,134833.70382629245,2149,7,725.1351351351351,36,1,21,33.19057086828631,0.6559606481481481,41.582207207207205,1033.6711711711707,28.713088088088075,0
2176,4,0,0,37,0.0,0.0,1.0,37,450,100,350,0.2222222222222222,8,1,7,328.0971108180415,0.7588838838838838,0.12613397540428695,0.2043817958976429,133646.82883897406,1369.8276824121363,135016.6565213862,2150,8,726.1351351351351,36,1,21,33.0163635373557,0.6568287037037037,41.497747747747745,1034.0090090090087,28.72247247247246,0
2177,4,0,0,37,0.0,0.0,1.0,37,750,500,250,0.6666666666666666,10,5,5,326.5091334626733,0.75757007007007,0.1229442834233252,0.2038739898609554,133734.17494775177,1333.0859153071935,135067.26086305897,2151,9,727.1351351351351,36,1,15,32.970195971692974,0.6576967592592593,41.413288288288285,1034.3468468468466,28.73185685685685,0
2178,4,0,0,37,0.0,0.0,1.0,37,850,400,450,0.47058823529411764,13,4,9,327.0335350450426,0.7583208208208209,0.11492955096088298,0.20533417036434617,133938.09349890417,1360.4496388280054,135298.54313773217,2152,10,728.1351351351351,36,1,16,32.75311865390196,0.6597222222222223,41.21621621621621,1035.135135135134,28.753753753753724,0
2179,4,0,1,36,0.0,0.02702702702702703,0.972972972972973,37,650,400,250,0.6153846153846154,9,4,5,327.39629726688827,0.7587587587587588,0.11829212003257505,0.20572482301944647,133967.23740209802,1372.0754961042107,135339.31289820222,2153,11,729.1351351351351,36,1,16,32.71465607890062,0.6600115740740742,41.18806306306306,1035.2477477477476,28.756881881881878,0
2180,4,0,0,36,0.0,0.0,1.0,36,950,700,250,0.7368421052631579,12,7,5,335.744856640418,0.7478174603174603,0.12148235118714856,0.21070640371475483,133921.09435281626,1792.663724922833,135713.7580777391,2154,26,750.0833333333334,35,1,17,32.54465783294196,0.6616071428571428,41.232638888888886,1035.069444444444,29.57341269841268,0
2181,4,0,0,36,0.0,0.0,1.0,36,900,700,200,0.7777777777777778,11,7,4,336.6274103372754,0.746660052910053,0.11563827408897898,0.2117769910602858,134010.95920138876,1822.3524305555457,135833.3116319443,2155,27,751.0833333333334,35,1,18,32.432092555332,0.6625,41.14583333333333,1035.4166666666656,29.583333333333304,0
2182,4,0,0,36,0.0,0.0,1.0,36,1000,500,500,0.5,15,5,10,337.9964420586122,0.7442791005291006,0.11649286157666006,0.2133334383938351,134130.82588520242,1867.148383916329,135997.97426911874,2156,28,752.0833333333334,35,1,18,32.27700186219737,0.663690476190476,41.030092592592595,1035.8796296296302,29.596560846560863,0
2183,4,0,0,36,0.0,0.0,1.0,36,700,500,200,0.7142857142857143,9,5,4,335.8753387144303,0.7432208994708995,0.11334524873398855,0.21234152769573325,134190.7793209878,1814.2746913580381,136005.05401234582,2157,29,753.0833333333334,35,1,18,32.272117962466474,0.6642857142857143,40.97222222222223,1036.1111111111122,29.603174603174637,0
2184,4,0,0,36,0.0,0.0,1.0,36,1050,600,450,0.5714285714285714,15,6,9,332.0347028124858,0.7425264550264551,0.11731668589433442,0.21077497045297225,134340.72151759703,1721.1563089420615,136061.8778265391,2158,30,754.0833333333334,35,1,18,32.22212143202708,0.6657738095238095,40.827546296296305,1036.6898148148161,29.619708994709033,0
2185,4,0,0,36,0.0,0.0,1.0,36,950,600,350,0.631578947368421,13,6,7,330.91517857142844,0.7418981481481483,0.11617063492063484,0.2105823863636364,134430.72702331975,1697.0336076817703,136127.76063100153,2159,31,755.0833333333334,35,1,18,32.161458333333336,0.6666666666666665,40.74074074074075,1037.037037037038,29.629629629629658,0
2186,4,0,0,36,0.0,0.0,1.0,36,900,700,200,0.7777777777777778,11,7,4,332.41399332268816,0.7405092592592593,0.1192547969656399,0.21223354958294727,134550.78125000015,1745.312500000015,136296.09375000017,2160,32,756.0833333333334,35,1,19,32.003012048192765,0.6678571428571427,40.62500000000001,1037.5000000000011,29.642857142857174,0
2187,4,0,0,36,0.0,0.0,1.0,36,700,500,200,0.7142857142857143,9,5,4,332.41399332268816,0.7405092592592593,0.1192547969656399,0.21223354958294727,134550.78125000015,1745.312500000015,136296.09375000017,2161,33,757.0833333333334,35,1,19,32.003012048192765,0.6678571428571427,40.62500000000001,1037.5000000000011,29.642857142857174,0
2188,4,0,0,36,0.0,0.0,1.0,36,850,600,250,0.7058823529411765,11,6,5,364.2347692211019,0.7414021164021165,0.11403272204243109,0.22068341899866736,132612.49999999985,2529.861111111096,135142.36111111095,2162,34,758.0833333333334,34,2,19,33.12095469255664,0.6507352941176471,42.49999999999999,1029.9999999999989,30.29411764705879,8
2189,4,1,1,36,0.02702702702702703,0.02702702702702703,0.972972972972973,37,600,400,200,0.6666666666666666,8,4,4,355.3857898021052,0.7484359359359359,0.11503702602591392,0.2170069911821077,132904.73257726748,2046.4906710819428,134951.22324834942,2163,0,738.5675675675676,35,2,15,33.05517360721368,0.6514880952380953,42.216435185185176,1031.1342592592578,29.460978835978793,0
2190,4,0,0,36,0.0,0.0,1.0,36,600,400,200,0.6666666666666666,8,4,4,353.0229187820893,0.7460978835978836,0.08698674547064167,0.21590852637386382,132964.41139671206,2187.8969210819505,135152.30831779403,2159,1,700.0,35,1,15,33.05617121161112,0.6520833333333333,42.15856481481481,1031.3657407407402,29.467592592592577,0
2191,4,0,0,36,0.0,0.0,1.0,36,900,600,300,0.6666666666666666,12,6,6,353.54708341687865,0.7466931216931217,0.08646094227007106,0.21726942404054475,133143.5282305597,2214.501216349434,135358.02944690912,2160,2,701.0,35,1,16,32.86290699413106,0.6538690476190477,41.984953703703695,1032.060185185184,29.487433862433832,0
2192,4,0,0,36,0.0,0.0,1.0,36,1050,900,150,0.8571428571428571,12,9,3,360.78971954393023,0.746362433862434,0.09135303681056017,0.22056824109367923,132949.08717839463,2393.332775342909,135342.41995373755,2161,3,702.0,36,0,15,32.87130559801993,0.6498842592592593,42.17342342342342,1031.3063063063064,28.6473973973974,3
2193,4,0,1,35,0.0,0.027777777777777776,0.9722222222222222,36,650,400,250,0.6153846153846154,9,4,5,362.0715100203766,0.7456018518518519,0.08917203244934369,0.22221441703393896,133094.2994303424,2437.9307939696328,135532.23022431202,2162,4,703.0,36,0,15,32.69239513987414,0.6513310185185186,42.03265765765765,1031.8693693693683,28.66303803803801,0
2194,4,0,0,35,0.0,0.0,1.0,35,1300,900,400,0.6923076923076923,17,9,8,371.57933444313846,0.7371848739495798,0.09321284368390725,0.22816813676962938,133113.66705246895,2892.4575617283745,136006.12461419732,2163,40,723.9714285714285,35,0,17,32.42765814266487,0.6535714285714287,42.01388888888888,1031.944444444443,29.48412698412694,0
2195,4,0,0,35,0.0,0.0,1.0,35,800,600,200,0.75,10,6,4,372.99346099250914,0.7378151260504201,0.09134655432031535,0.22940384035387543,133173.3927576302,2934.5609353566397,136107.95369298686,2164,41,724.9714285714285,35,0,17,32.331146744412045,0.6541666666666668,41.95601851851851,1032.1759259259252,29.49074074074072,0
2196,4,0,0,35,0.0,0.0,1.0,35,600,400,200,0.6666666666666666,8,4,4,374.5006776426791,0.7377450980392156,0.08764595646533047,0.23051563449931362,133203.2606336805,2976.942274305545,136180.20290798604,2165,42,725.9714285714285,35,0,17,32.2622351160444,0.6544642857142857,41.92708333333333,1032.2916666666663,29.49404761904761,0
2197,4,0,0,35,0.0,0.0,1.0,35,1450,1000,450,0.6896551724137931,19,10,9,372.4095080274897,0.7354341736694677,0.0845811593739001,0.23052200198705775,133412.42953746568,2936.811449759947,136349.24098722564,2166,43,726.9714285714285,35,0,18,32.106113227276126,0.6565476190476189,41.72453703703704,1033.1018518518517,29.517195767195762,0
2198,4,0,0,35,0.0,0.0,1.0,35,850,600,250,0.7058823529411765,11,6,5,370.75210469417476,0.7347338935574229,0.08612569322164987,0.23005711371337617,133502.97796201822,2899.315408390731,136402.29337040897,2167,44,727.9714285714285,34,1,18,32.05803862842222,0.6596200980392156,41.636904761904766,1033.4523809523816,30.395658263305343,0
2199,4,0,0,35,0.0,0.0,1.0,35,1350,1100,250,0.8148148148148148,16,11,5,368.5607269596101,0.7346638655462184,0.07924993831729599,0.22945877517162835,133626.03635204086,2849.8618197278965,136475.89817176876,2168,45,728.9714285714285,34,1,18,31.991220495106507,0.660845588235294,41.517857142857146,1033.9285714285718,30.40966386554623,0
2200,4,0,0,35,0.0,0.0,1.0,35,1250,1100,150,0.88,14,11,3,371.25928831204374,0.7369747899159663,0.07983038590493718,0.23249176757984744,133841.52494331056,2937.981859410417,136779.50680272098,2169,46,729.9714285714285,34,1,17,31.70539960116581,0.6629901960784315,41.3095238095238,1034.761904761904,30.43417366946776,0
2201,4,0,0,35,0.0,0.0,1.0,35,900,800,100,0.8888888888888888,10,8,2,355.92879686908236,0.7371848739495798,0.014561797752809191,0.2157878945595933,132636.3436642659,2441.818844307248,135078.16250857315,2170,47,730.9714285714285,35,0,18,33.31086142322098,0.648809523809524,42.47685185185184,1030.092592592591,29.431216931216888,6
2202,4,1,0,36,0.027777777777777776,0.0,1.0,36,800,500,300,0.625,11,5,6,350.64032509628754,0.7508267195767196,0.04917661961635922,0.20310675434822711,130901.38888888908,1996.2041323731387,132897.5930212622,2171,0,711.6388888888889,34,2,17,35.19611834961998,0.6335784313725489,44.16666666666668,1023.3333333333348,30.09803921568632,6
2203,4,0,0,36,0.0,0.0,1.0,36,1050,900,150,0.8571428571428571,12,9,3,349.087344510546,0.7508267195767196,0.04583333333333317,0.20284805153991212,131023.24263038569,1947.7111678004758,132970.95379818618,2172,1,712.6388888888889,34,2,18,35.112645348837205,0.6348039215686274,44.04761904761906,1023.8095238095254,30.11204481792722,0
2204,4,1,0,37,0.02702702702702703,0.0,1.0,37,1000,600,400,0.6,14,6,8,340.43055405386855,0.7645770770770771,0.04470112760151146,0.19908666615541315,131268.81456833007,1537.583054698238,132806.39762302832,2173,0,694.3513513513514,35,2,20,35.08630750696486,0.6351190476190476,43.80787037037038,1024.7685185185198,29.279100529100567,0
2205,4,0,0,37,0.0,0.0,1.0,37,1150,900,250,0.782608695652174,14,9,5,343.38026307092343,0.7649524524524525,0.04460558119094715,0.2011227255129695,131328.12500000012,1619.097222222237,132947.22222222236,2174,1,695.3513513513514,35,2,20,34.950880758807585,0.6357142857142856,43.75000000000001,1025.000000000001,29.285714285714313,0
2206,4,1,0,38,0.02631578947368421,0.0,1.0,38,1400,1000,400,0.7142857142857143,18,10,8,337.25884230643015,0.7745080606922712,0.05372253841447172,0.19994318102405934,131790.24252292843,1289.4849241133093,133079.72744704175,2175,0,678.0263157894736,36,2,14,34.642099875703735,0.6383101851851851,43.29954954954955,1026.8018018018026,28.522272272272296,0
2207,4,0,1,37,0.0,0.02631578947368421,0.9736842105263158,38,850,500,350,0.5882352941176471,12,5,7,335.0941821885423,0.774033902323376,0.058370215638866796,0.1991136179636284,131876.97991488117,1238.2417468143892,133115.22166169557,2176,1,679.0263157894736,36,2,15,34.610377151628114,0.6391782407407407,43.215090090090094,1027.13963963964,28.53165665665667,0
2208,4,0,0,37,0.0,0.0,1.0,37,600,500,100,0.8333333333333334,7,5,2,343.1324823423396,0.7608233233233234,0.06061123129894286,0.20317657666065095,131743.6731074245,1641.1067172496514,133384.77982467413,2177,2,698.2972972972973,35,2,15,34.538237504697484,0.6398809523809523,43.344907407407405,1026.6203703703698,29.332010582010565,0
2209,4,1,0,38,0.02631578947368421,0.0,1.0,38,1250,700,550,0.56,18,7,11,333.7526226279595,0.7681661925082978,0.059656617719125116,0.19953030071844424,132108.41912436084,1218.3062707978218,133326.72539515866,2178,0,680.8947368421053,36,2,18,34.4120842005331,0.6414930555555556,42.98986486486486,1028.0405405405404,28.556681681681678,0
2210,4,0,0,38,0.0,0.0,1.0,38,1250,1000,250,0.8,15,10,5,333.0944845318867,0.7665955429113324,0.06152827363814373,0.20082345571381569,132426.97934420916,1222.1392845548403,133649.118628764,2179,1,681.8947368421053,36,2,18,34.108998905908095,0.6446759259259258,42.68018018018019,1029.27927927928,28.591091091091112,0
2211,4,0,0,38,0.0,0.0,1.0,38,1100,900,200,0.8181818181818182,13,9,4,333.5933046378421,0.7663880986249407,0.06413916146297893,0.20190011720139428,132571.90626014533,1245.0200622920265,133816.92632243736,2180,2,682.8947368421053,36,2,19,33.950701658465455,0.6461226851851851,42.539414414414416,1029.8423423423428,28.606731731731745,0
2212,4,1,0,39,0.02564102564102564,0.0,1.0,39,1000,800,200,0.8,12,8,4,327.587145826613,0.777046783625731,0.0735093631733359,0.20004087788009503,132906.30290089245,907.6792859341169,133813.98218682656,2181,0,666.3589743589744,37,2,16,33.77020416843896,0.6475225225225225,42.214912280701746,1031.1403508771918,27.868658131815994,0
2213,4,0,0,39,0.0,0.0,1.0,39,850,600,250,0.7058823529411765,11,6,5,328.8207455598438,0.7759221772379667,0.07768900954826341,0.20125027673919652,132991.11415291246,946.0474617189943,133937.16161463145,2182,1,667.3589743589744,37,2,17,33.6534628468162,0.648367117117117,42.13267543859649,1031.4692982456143,27.877548601232817,0
2214,4,0,1,38,0.0,0.02564102564102564,0.9743589743589743,39,950,700,250,0.7368421052631579,12,7,5,327.03807309247736,0.7740103463787674,0.0739965666639415,0.20061461980444656,133075.95245652494,904.1806132656008,133980.13306979055,2183,2,668.3589743589744,37,2,18,33.61450584484591,0.6492117117117118,42.05043859649122,1031.798245614034,27.886439070649566,0
2215,4,0,0,38,0.0,0.0,1.0,38,1450,1100,350,0.7586206896551724,18,11,7,333.3669413157408,0.767425320056899,0.07737842093768976,0.20380336772827473,132949.08717839463,1264.1661086762408,134213.25328707087,2184,3,686.8157894736842,36,2,18,33.578337701099194,0.6498842592592593,42.17342342342342,1031.3063063063064,28.6473973973974,0
2216,4,0,0,38,0.0,0.0,1.0,38,950,600,350,0.631578947368421,13,6,7,333.71292603940776,0.7677513039355145,0.07998172634337242,0.20417345955877983,132978.12328798382,1275.3037243324322,134253.42701231624,2185,4,687.8157894736842,36,2,18,33.54032463514941,0.6501736111111112,42.14527027027027,1031.418918918918,28.650525525525502,0
2217,4,0,0,38,0.0,0.0,1.0,38,1050,800,250,0.7619047619047619,13,8,5,333.0647200711004,0.7683736367946894,0.08204942611932564,0.20425294279059034,133065.2506391526,1263.868091064028,134329.11873021664,2186,5,688.8157894736842,36,2,18,33.469766426544425,0.6510416666666667,42.06081081081081,1031.7567567567562,28.659909909909896,0
2218,4,0,0,38,0.0,0.0,1.0,38,950,600,350,0.631578947368421,13,6,7,334.29163880116266,0.7680180180180181,0.08220346283056212,0.2054851019190246,133152.40652392263,1302.347237440148,134454.75376136278,2187,6,689.8157894736842,36,2,18,33.35083651573014,0.6519097222222222,41.976351351351354,1032.094594594595,28.669294294294307,0
2219,4,0,0,38,0.0,0.0,1.0,38,950,700,250,0.7368421052631579,12,7,5,334.89940839051275,0.767454954954955,0.08437934242107548,0.2060193273360698,133181.46482631282,1320.4787557828108,134501.94358209564,2188,7,690.8157894736842,36,2,18,33.30605862244526,0.6521990740740742,41.9481981981982,1032.2072072072074,28.67242242242243,0
2220,4,0,0,38,0.0,0.0,1.0,38,1000,600,400,0.6,14,6,8,334.632513922765,0.7649656235182551,0.0875566779544279,0.20649933732649764,133297.72973987498,1321.150880610335,134618.88062048532,2189,8,691.8157894736842,36,2,18,33.19656488549619,0.6533564814814815,41.835585585585584,1032.6576576576574,28.68493493493493,0
2221,4,0,0,38,0.0,0.0,1.0,38,1300,1300,0,1.0,13,13,0,335.74685199213576,0.7641951161688004,0.09169210641081538,0.20751146404796966,133355.8812190569,1354.7634627871112,134710.64468184402,2190,9,692.8157894736842,36,2,18,33.10959986916704,0.6539351851851851,41.77927927927928,1032.882882882883,28.691191191191194,0
2222,4,0,0,38,0.0,0.0,1.0,38,1150,900,250,0.782608695652174,14,9,5,336.8240659271145,0.7630393551446183,0.0873349167555908,0.20850364243018543,133414.04537983934,1387.4122433244102,134801.45762316376,2191,10,693.8157894736842,36,2,18,33.02358113509192,0.6545138888888888,41.722972972972975,1033.1081081081084,28.697447447447455,0
2223,4,0,0,38,0.0,0.0,1.0,38,1000,600,400,0.6,14,6,8,334.46904971303474,0.7631578947368421,0.08154539667245908,0.20753363551159706,133501.3153990139,1330.4116193896639,134831.72701840356,2192,11,694.8157894736842,36,2,18,32.99712142675528,0.6553819444444444,41.638513513513516,1033.4459459459463,28.706831831831842,0
2224,4,0,0,38,0.0,0.0,1.0,38,850,700,150,0.8235294117647058,10,7,3,329.6580875051872,0.7630097202465623,0.015816224169063586,0.20755273189326548,134039.34383656486,1237.4307479224158,135276.77458448728,2193,12,695.8157894736842,37,1,16,32.58418043202033,0.6587837837837839,41.11842105263157,1035.5263157894717,27.987197724039778,2
2225,4,0,1,37,0.0,0.02631578947368421,0.9736842105263158,38,1250,1100,150,0.88,14,11,3,331.55830765921746,0.7629504504504505,0.010824776711138684,0.21004618793531635,134266.52912434578,1303.436634349011,135569.9657586948,2194,13,696.8157894736842,37,1,16,32.30841797150516,0.6610360360360361,40.899122807017534,1036.4035087719285,28.010905642484556,0
2226,4,0,0,37,0.0,0.0,1.0,37,950,700,250,0.7368421052631579,12,7,5,334.7238921153143,0.7581956956956957,0.02510932099109886,0.21200715616911472,134258.85080604246,1587.9290185455648,135846.77982458804,2195,14,714.7027027027027,36,1,17,32.23405411278931,0.6629050925925927,40.90653153153153,1036.3738738738734,28.78816316316315,0
2227,4,0,0,37,0.0,0.0,1.0,37,1500,1200,300,0.8,18,12,6,338.41636151710145,0.7535035035035035,0.041310938476754266,0.21537500160407658,134433.97102761542,1698.9310678922075,136132.90209550763,2196,15,715.7027027027027,36,1,18,31.963749230824906,0.6646412037037037,40.73761261261261,1037.0495495495493,28.806931931931924,0
2228,4,0,0,37,0.0,0.0,1.0,37,800,700,100,0.875,9,7,2,339.78846526731564,0.7537537537537538,0.03954144134363413,0.21659457118181621,134492.36979800745,1739.791184765843,136232.1609827733,2197,16,716.7027027027027,36,1,18,31.86995621177578,0.6652199074074074,40.681306306306304,1037.2747747747746,28.813188188188185,0
2229,4,0,0,37,0.0,0.0,1.0,37,1000,400,600,0.4,16,4,12,341.19679458696686,0.7534409409409409,0.04096995929048197,0.2182107452982091,134612.5442885488,1785.8990876908344,136398.44337623962,2198,17,717.7027027027027,34,3,18,31.713653397575605,0.6706495098039216,40.56547619047619,1037.7380952380956,30.521708683473403,0
2230,4,0,0,37,0.0,0.0,1.0,37,1100,1000,100,0.9090909090909091,12,10,2,340.5744712574117,0.7538788788788788,0.043761586776039696,0.21799766816608773,134643.43112244896,1771.2230725623563,136414.65419501133,2199,18,718.7027027027027,34,3,18,31.699023093981808,0.6709558823529411,40.535714285714285,1037.8571428571427,30.525210084033606,0
2231,4,0,0,37,0.0,0.0,1.0,37,650,400,250,0.6153846153846154,9,4,5,342.5211896492599,0.7533158158158159,0.04351478442543932,0.21942999651373257,134674.3214994332,1825.761763038561,136500.08326247174,2200,19,719.7027027027027,34,3,18,31.617731391214583,0.6712622549019608,40.50595238095239,1037.9761904761913,30.52871148459386,0
2232,4,0,0,37,0.0,0.0,1.0,37,600,400,200,0.6666666666666666,8,4,4,341.5515450023097,0.7533783783783784,0.045841507141816784,0.21918109079949533,134736.11288265302,1803.8655045351427,136539.97838718817,2201,20,720.7027027027027,34,3,19,31.58133623819899,0.671875,40.44642857142857,1038.2142857142853,30.535714285714274,0
2233,4,0,0,37,0.0,0.0,1.0,37,1250,1000,250,0.8,15,10,5,340.02928209702975,0.7538788788788788,0.05238170449583346,0.21932265667854967,134921.57206632645,1775.457057823121,136697.02912414956,2202,21,721.7027027027027,34,3,16,31.436203735533415,0.6737132352941178,40.26785714285714,1038.9285714285706,30.556722689075606,0
2234,4,0,0,37,0.0,0.0,1.0,37,1000,700,300,0.7,13,7,6,361.58757702525634,0.7538788788788788,0.05858950514880212,0.2156169305847719,132011.1577958892,2146.7189375428807,134157.87673343206,2203,22,722.7027027027027,35,2,16,33.79474509141419,0.6425595238095237,43.08449074074075,1027.662037037038,29.361772486772516,7
2235,4,0,0,37,0.0,0.0,1.0,37,1100,900,200,0.8181818181818182,13,9,4,361.5286464668861,0.7555680680680681,0.05695665270133321,0.2162598630683738,132130.12695312512,2153.765190972236,134283.89214409736,2204,23,723.7027027027027,35,2,16,33.67633400878082,0.6437499999999999,42.96875000000001,1028.125000000001,29.375000000000025,0
2236,4,0,0,37,0.0,0.0,1.0,37,1050,700,350,0.6666666666666666,14,7,7,356.72510925056304,0.7545045045045045,0.056420097378800715,0.21405915232341352,132249.14969403725,2035.3184745799035,134284.46816861714,2205,24,724.7027027027027,35,2,17,33.679930422714804,0.6449404761904761,42.85300925925926,1028.5879629629633,29.388227513227523,0
2237,4,1,0,38,0.02631578947368421,0.0,1.0,38,1100,700,400,0.6363636363636364,15,7,8,348.3567431612595,0.7630689900426743,0.04985982949279566,0.21051062146222038,132513.92598257042,1632.423935760084,134146.3499183305,2206,0,706.6052631578947,36,2,20,33.62886908017063,0.6455439814814815,42.59572072072072,1029.617117117117,28.600475475475474,0
2238,4,0,0,38,0.0,0.0,1.0,38,950,700,250,0.7368421052631579,12,7,5,348.0478623974713,0.7615872451398767,0.04637194209835882,0.21113672713607876,132658.9004545086,1634.3293462381343,134293.22980074675,2207,1,707.6052631578947,36,2,15,33.491154715056105,0.6469907407407407,42.45495495495496,1030.1801801801805,28.616116116116125,0
2239,4,1,3,36,0.02564102564102564,0.07692307692307693,0.9230769230769231,39,950,800,150,0.8421052631578947,11,8,3,339.34354838913964,0.7687809266756636,0.04815190480864673,0.20721991747087437,132906.30290089245,1220.1792859341176,134126.48218682656,2208,0,690.4358974358975,37,2,15,33.46714164185452,0.6475225225225225,42.214912280701746,1031.1403508771918,27.868658131815994,0
2240,4,0,0,36,0.0,0.0,1.0,36,1050,600,450,0.5714285714285714,15,6,9,361.9185516258421,0.7519179894179895,0.04274418365642774,0.21874448308958133,132520.55165816328,2392.3292233560114,134912.8808815193,2209,28,729.3055555555555,34,2,22,33.2731144255598,0.6498161764705883,42.589285714285715,1029.6428571428573,30.28361344537816,0
2241,4,0,0,36,0.0,0.0,1.0,36,750,700,50,0.9333333333333333,8,7,1,359.6527057739236,0.7527777777777779,0.03856526429341933,0.21790722761596554,132612.5,2338.888888888889,134951.38888888888,2210,29,730.3055555555555,34,2,22,33.23894282632146,0.650735294117647,42.5,1030.0,30.294117647058822,0
2242,4,0,0,36,0.0,0.0,1.0,36,550,400,150,0.7272727272727273,7,4,3,361.91239095122376,0.7519841269841271,0.039076342346506365,0.2196346305253777,132673.8166099771,2403.259637188178,135077.07624716527,2211,30,731.3055555555555,34,2,16,33.119077883059845,0.6513480392156864,42.440476190476176,1030.2380952380934,30.301120448179216,0
2243,4,0,0,36,0.0,0.0,1.0,36,1000,600,400,0.6,14,6,8,365.3893340581801,0.7517857142857144,0.03400266964434673,0.2222892104667368,132765.81809807254,2502.24277210884,135268.0608701814,2212,31,732.3055555555555,34,2,16,32.936977782911704,0.6522671568627452,42.351190476190474,1030.595238095238,30.311624649859944,0
2244,4,1,0,37,0.02702702702702703,0.0,1.0,37,700,600,100,0.8571428571428571,8,6,2,355.04045341291163,0.7613863863863863,0.039878128268481694,0.2178379657382043,133083.80922335823,2050.02719371571,135133.83641707394,2213,0,713.4864864864865,35,2,18,32.884300803888586,0.6532738095238095,42.042824074074076,1031.828703703704,29.48082010582011,0
2245,4,1,1,37,0.02631578947368421,0.02631578947368421,0.9736842105263158,38,600,400,200,0.6666666666666666,8,4,4,347.2391871705788,0.7660621147463252,0.03596864257470633,0.2144465040768607,133326.80389426596,1659.2582024592225,134986.0620967252,2214,0,695.6842105263158,36,2,18,32.84197470286774,0.6536458333333334,41.807432432432435,1032.7702702702709,28.68806306306308,0
2246,4,0,0,37,0.0,0.0,1.0,37,1100,700,400,0.6363636363636364,15,7,8,354.49737577670976,0.7623248248248248,0.03989819415828344,0.21837821767460294,133233.13185871052,2046.159122085043,135279.29098079557,2215,2,715.4864864864865,35,2,18,32.74850523168908,0.6547619047619049,41.898148148148145,1032.4074074074072,29.49735449735449,0
2247,4,1,1,37,0.02631578947368421,0.02631578947368421,0.9736842105263158,38,1350,900,450,0.6666666666666666,18,9,9,348.8177927365889,0.7725817923186344,0.037113219779571605,0.2166163344323878,133532.0283028977,1715.8838091563673,135247.91211205407,2216,0,697.6315789473684,35,3,20,32.59565136244867,0.6577380952380952,41.60879629629629,1033.564814814814,29.53042328042326,0
2248,4,1,1,37,0.02631578947368421,0.02631578947368421,0.9736842105263158,38,750,500,250,0.6666666666666666,10,5,5,346.4039087987079,0.766269559032717,0.03708723218705057,0.2154651610995862,133591.84777949244,1655.3476508916292,135247.19543038408,2217,0,698.6052631578947,35,3,20,32.59814897745932,0.6583333333333334,41.550925925925924,1033.796296296296,29.53703703703703,0
2249,4,0,0,37,0.0,0.0,1.0,37,550,400,150,0.7272727272727273,7,4,3,351.5855182566472,0.7603853853853854,0.0527621251603152,0.20741379752594402,131602.82206632654,1853.9292800453459,133456.7513463719,2218,5,718.4864864864865,34,3,18,34.463346482577236,0.640625,43.482142857142854,1026.0714285714284,30.178571428571423,4
2250,4,1,0,38,0.02631578947368421,0.0,1.0,38,1050,800,250,0.7619047619047619,13,8,5,347.8592594462577,0.7665066382171646,0.07057510933920441,0.20202331909403445,131002.08340031272,1514.0575435099186,132516.14094382265,2219,0,700.5526315789474,35,3,19,35.165465423026184,0.6324404761904763,44.068287037037024,1023.7268518518501,29.249338624338577,1
2251,4,0,0,38,0.0,0.0,1.0,38,900,600,300,0.6666666666666666,12,6,6,349.3261332789674,0.7667140825035562,0.07739465652942101,0.2031879224930323,131061.33355034707,1556.6297743055366,132617.9633246526,2220,1,701.5526315789474,35,3,19,35.06803153611393,0.6330357142857144,44.01041666666666,1023.9583333333321,29.255952380952348,0
2252,4,0,1,37,0.0,0.02631578947368421,0.9736842105263158,38,750,500,250,0.6666666666666666,10,5,5,351.41587295522305,0.7676920341394026,0.07714520225300503,0.2047188321119661,131120.59709630033,1615.5718182012774,132736.1689145016,2221,2,702.5526315789474,35,3,19,34.954632350171394,0.6336309523809525,43.95254629629628,1024.189814814813,29.262566137566086,0
2253,4,0,0,37,0.0,0.0,1.0,37,1050,800,250,0.7619047619047619,13,8,5,355.7033853533035,0.758008008008008,0.07150442700314841,0.20702033293701705,131084.190759637,1925.4180839002038,133009.6088435372,2222,3,721.1891891891892,34,3,19,34.88166511663954,0.6354166666666667,43.98809523809523,1024.0476190476174,30.11904761904757,0
2254,4,0,0,37,0.0,0.0,1.0,37,650,600,50,0.9230769230769231,7,6,1,354.0005286590023,0.7572572572572572,0.06510485380778275,0.2063564057304915,131145.15306122438,1885.0907029478358,133030.24376417222,2223,4,722.1891891891892,34,3,20,34.86362931969627,0.636029411764706,43.92857142857142,1024.2857142857135,30.126050420168045,0
2255,4,0,0,37,0.0,0.0,1.0,37,400,100,300,0.25,7,1,6,355.01418194698044,0.7576326326326326,0.060127049321890835,0.20744107698694217,131236.6230867346,1918.172477324251,133154.79556405885,2224,5,723.1891891891892,34,3,20,34.74521707137601,0.6369485294117647,43.83928571428571,1024.6428571428564,30.136554621848717,0
2256,4,0,0,37,0.0,0.0,1.0,37,1000,600,400,0.6,14,6,8,354.085940873955,0.7555055055055055,0.06187259815020063,0.1992519111071781,129776.92920918361,1809.3183106575889,131586.24751984118,2225,6,724.1891891891892,34,3,20,36.24815009541613,0.6222426470588236,45.26785714285714,1018.9285714285709,29.968487394957968,6
2257,4,0,0,37,0.0,0.0,1.0,37,700,300,400,0.42857142857142855,11,3,8,356.3098676523137,0.753566066066066,0.068642273009901,0.20112599846451937,129898.25857426284,1856.8062641723104,131755.06483843515,2226,7,725.1891891891892,34,3,20,36.06821012884892,0.623468137254902,45.14880952380951,1019.4047619047603,29.982492997198833,0
2258,4,0,0,37,0.0,0.0,1.0,37,1050,800,250,0.7619047619047619,13,8,5,355.0621355615007,0.7539414414414415,0.07671713469966024,0.20123232158864982,130055.90284475728,1835.5853212877068,131891.488166045,2227,8,726.1891891891892,35,2,21,35.939923030371794,0.6229166666666668,44.994212962962955,1020.0231481481474,29.143518518518494,0
2259,4,0,0,37,0.0,0.0,1.0,37,1050,600,450,0.5714285714285714,15,6,9,357.69790045218224,0.7537537537537538,0.07912562142546253,0.2034954894314414,130203.51750042861,1914.7049682784518,132118.22246870707,2228,9,727.1891891891892,35,2,21,35.72285854691161,0.6244047619047619,44.84953703703703,1020.6018518518514,29.160052910052897,0
2260,4,1,0,38,0.02631578947368421,0.0,1.0,38,850,500,350,0.5882352941176471,12,5,7,350.65357785713894,0.7631578947368421,0.09025621607976775,0.20140846000885232,130575.52984429052,1557.39553185561,132132.92537614613,2229,0,709.0263157894736,33,5,18,35.5255795363709,0.6325757575757576,44.48529411764705,1022.0588235294106,30.97147950089123,0
2261,4,1,0,39,0.02564102564102564,0.0,1.0,39,900,700,200,0.7777777777777778,11,7,4,344.5652284570054,0.7705240665766981,0.06718500627299018,0.18901804041892833,128772.40997331798,1074.0989722831014,129846.50894560108,2230,0,691.8205128205128,36,3,20,37.51248197048707,0.6079282407407407,46.255630630630634,1014.977477477478,28.193818818818833,8
2262,4,2,1,40,0.04878048780487805,0.024390243902439025,0.975609756097561,41,600,300,300,0.5,9,3,6,331.4045876446779,0.7907520325203252,0.08324331914709737,0.1843131918477051,129315.90374157943,372.603431133837,129688.50717271326,2231,0,659.0243902439024,36,5,22,37.29378875110717,0.6134259259259259,45.72072072072072,1017.1171171171172,28.253253253253256,0
2263,4,1,0,41,0.024390243902439025,0.0,1.0,41,1150,900,250,0.782608695652174,14,9,5,333.5323822825214,0.7957825203252032,0.09440932112606903,0.18644398289744643,129516.42679419277,439.5844746773739,129956.01126887015,2232,0,659.7073170731708,36,5,18,37.03603827857064,0.615451388888889,45.523648648648646,1017.9054054054048,28.275150150150136,0
2264,4,0,1,40,0.0,0.024390243902439025,0.975609756097561,41,1250,800,450,0.64,17,8,9,323.8470229341014,0.7961382113821138,0.0236752204655597,0.1797114937180082,129228.5448740776,170.05590711518755,129398.6007811928,2233,1,660.7073170731708,38,3,17,37.57464712269272,0.6088267543859649,45.806623931623925,1016.7735042735034,26.75719748088167,7
2265,4,0,1,39,0.0,0.025,0.975,40,950,800,150,0.8421052631578947,11,8,3,327.1969900564364,0.7892628205128205,0.027254098360655954,0.18144560357675096,129201.38888888882,454.8611111111012,129656.24999999991,2234,2,678.15,38,2,18,37.51707650273224,0.6085526315789473,45.83333333333333,1016.6666666666661,26.754385964912263,0
2266,4,1,1,39,0.025,0.025,0.975,40,1150,900,250,0.782608695652174,14,9,5,327.0719836241211,0.786832264957265,0.03378399663971443,0.18225315974561154,129391.54071015028,464.06957684999895,129855.61028700028,2235,0,679.075,38,2,19,37.32717280968881,0.6104714912280704,45.64636752136751,1017.4145299145282,26.77406657669811,0
2267,4,3,2,40,0.07142857142857142,0.047619047619047616,0.9523809523809523,42,1150,800,350,0.6956521739130435,15,8,7,310.1572001730866,0.8060394889663183,0.034899281087622525,0.17554582649390416,130003.35784131453,-335.70450376761113,129667.65333754692,2236,0,617.547619047619,40,2,18,37.13814150473345,0.61328125,45.04573170731707,1019.8170731707304,25.49542682926826,0
2268,4,0,0,40,0.0,0.0,1.0,40,1000,800,200,0.8,12,8,4,324.1912436333873,0.7926816239316239,0.033713431896823076,0.18240778115230755,129772.2638272518,414.2063198553594,130186.47014710716,2237,1,649.425,38,2,18,37.01439131802454,0.6143092105263158,45.2724358974359,1018.9102564102564,26.813427800269903,0
2269,4,0,2,38,0.0,0.05,0.95,40,1200,800,400,0.6666666666666666,16,8,8,312.2840374237571,0.7927083333333333,0.017537313432836266,0.16807974645827098,128012.72922091975,-4.733615451428506,128007.99560546831,2238,2,650.425,39,1,15,39.10458483444845,0.5948183760683763,47.005208333333314,1011.9791666666634,25.94818376068368,6
2270,4,1,0,39,0.02564102564102564,0.0,1.0,39,900,600,300,0.6666666666666666,12,6,6,336.0561032688699,0.7816576698155646,0.023346740038930003,0.17048972786259747,125603.7975627115,647.5455338421307,126251.34309655362,2239,0,667.7179487179487,37,2,17,40.97526070152409,0.5737612612612613,49.3969298245614,1002.4122807017535,27.092223802750095,4
2271,4,3,2,40,0.07142857142857142,0.047619047619047616,0.9523809523809523,42,1150,800,350,0.6956521739130435,15,8,7,327.307307521767,0.8060636856368564,0.04906137664758381,0.16966219370572755,126488.78173828125,-119.09001597847464,126369.69172230277,2240,0,620.952380952381,39,3,16,40.28435763349555,0.5793269230769231,48.515625,1005.9375,25.79326923076923,0
2272,4,3,4,39,0.06976744186046512,0.09302325581395349,0.9069767441860466,43,1150,800,350,0.6956521739130435,15,8,7,320.7818237571337,0.8143226282761166,0.056008201586359,0.1678052885965419,126861.55443395145,-461.0238408024263,126400.53059314901,2241,0,607.4418604651163,40,3,17,40.066285012945954,0.5815104166666667,48.145325203252035,1007.4186991869926,25.185467479674816,0
2273,4,3,2,40,0.07142857142857142,0.047619047619047616,0.9523809523809523,42,1450,1200,250,0.8275862068965517,17,12,5,326.2903902007527,0.81431475029036,0.07564038221198777,0.1714353092487994,127039.501953125,-109.64626736111092,126929.85568576389,2242,0,622.047619047619,39,3,18,39.74521250947166,0.5849358974358975,47.96875,1008.125,25.849358974358974,0
2274,4,4,3,41,0.09090909090909091,0.06818181818181818,0.9318181818181819,44,950,800,150,0.8421052631578947,11,8,3,318.4299123749358,0.8218155391120507,0.09859756710566003,0.17020001818342217,127733.27637525613,-646.9299312371937,127086.34644401894,2243,0,594.6818181818181,40,4,15,39.23419121343119,0.5903645833333333,47.28150406504065,1010.8739837398374,25.271849593495936,2
2275,4,2,3,40,0.046511627906976744,0.06976744186046512,0.9302325581395349,43,1250,1000,250,0.8,15,10,5,322.9713280625049,0.8200442967884828,0.09309994440077407,0.17258335724221088,127723.00347222234,-349.8263888888792,127373.17708333346,2244,0,606.1162790697674,39,4,15,39.12991206375377,0.5918803418803419,47.29166666666667,1010.8333333333343,25.918803418803442,0
2276,4,3,1,42,0.06976744186046512,0.023255813953488372,0.9767441860465116,43,900,500,400,0.5555555555555556,13,5,8,324.48985484136267,0.8136304909560723,0.1147111276017665,0.1746492487414871,128012.72922092032,-292.23361545136925,127720.49560546894,2245,0,606.9767441860465,39,4,19,38.795784010979595,0.594818376068376,47.00520833333334,1011.9791666666681,25.948183760683797,0
2277,4,3,1,44,0.06666666666666667,0.022222222222222223,0.9777777777777777,45,900,600,300,0.6666666666666666,12,6,6,314.30251659420856,0.8288299663299664,0.13760613530539567,0.17152742721755695,128566.7534722223,-918.093532986106,127648.6599392362,2246,0,580.9333333333333,39,6,17,38.489454943850994,0.6004273504273505,46.458333333333336,1014.1666666666673,26.00427350427352,0
2278,4,2,0,46,0.043478260869565216,0.0,1.0,46,800,600,200,0.75,10,6,4,330.638931201962,0.8347020933977456,0.19389165645131867,0.18311465060254828,129149.7341612134,-659.6139863837839,128490.12017482962,2247,0,569.2608695652174,40,6,19,37.48208691595013,0.6046875000000002,45.884146341463406,1016.463414634145,25.411585365853625,0
2279,4,3,0,49,0.061224489795918366,0.0,1.0,49,800,500,300,0.625,11,5,6,322.14271233111975,0.8490646258503401,0.17423235773125767,0.17109204342246567,127476.5777335744,-1513.9966083350077,125962.5811252394,2248,0,535.3469387755102,40,9,16,39.4026114521485,0.5877604166666668,47.535569105691046,1009.8577235772343,25.24644308943086,8
2280,4,2,4,47,0.0392156862745098,0.0784313725490196,0.9215686274509804,51,1150,800,350,0.6956521739130435,15,8,7,310.48957252918626,0.8592810457516341,0.18214609787577052,0.1664396337178792,127850.36886492666,-2260.7587246860476,125589.6101402406,2249,0,515.3137254901961,42,9,17,39.31545622944013,0.5885416666666669,47.16569767441859,1011.3372093023229,24.07945736434102,0
2281,4,3,3,47,0.06,0.06,0.94,50,1100,700,400,0.6363636363636364,15,7,8,310.20245811881534,0.8580612244897959,0.17291662486204507,0.1679406789826306,128247.44824715763,-2043.1272407015872,126204.32100645604,2250,0,499.92,40,10,20,38.918221798602055,0.5955729166666668,46.77337398373983,1012.9065040650395,25.322662601625986,0
2282,4,2,1,48,0.04081632653061224,0.02040816326530612,0.9795918367346939,49,1700,1100,600,0.6470588235294118,23,11,12,313.6099424947506,0.8506590136054422,0.17135132184945578,0.16957262852802915,128197.27105034715,-1759.2122395833383,126438.0588107638,2251,0,511.0,39,10,21,38.88303161215114,0.5966880341880343,46.822916666666664,1012.7083333333327,25.966880341880326,0
2283,4,4,6,46,0.07692307692307693,0.11538461538461539,0.8846153846153846,52,950,500,450,0.5263157894736842,14,5,9,298.7958366919801,0.8660444947209652,0.18214159837871136,0.1640558273157851,128807.63250405614,-2702.563134727498,126105.06936932863,2252,0,482.4423076923077,42,10,12,38.63811728395059,0.5982142857142858,46.22093023255813,1015.1162790697666,24.169435215946823,0
2284,4,1,0,47,0.02127659574468085,0.0,1.0,47,1350,1000,350,0.7407407407407407,17,10,7,333.3721826561271,0.8457832254085722,0.18436797411519024,0.17990251211742944,128118.165418837,-857.7935112846992,127260.3719075523,2253,0,534.3617021276596,39,8,22,38.46342644990912,0.5958867521367521,46.90104166666668,1012.395833333335,25.958867521367562,0
2285,4,3,2,48,0.06,0.04,0.96,50,1650,1200,450,0.7272727272727273,21,12,9,315.3946295547243,0.8602551020408163,0.1913490792634105,0.17353651643782012,128891.61544054496,-1869.6499137366236,127021.96552680834,2254,0,503.24,40,10,14,38.131546904190024,0.6020833333333332,46.13821138211384,1015.4471544715473,25.386178861788682,0
2286,4,1,1,48,0.02040816326530612,0.02040816326530612,0.9795918367346939,49,1100,700,400,0.6363636363636364,15,7,8,322.6800703383196,0.8573200113378685,0.20200565870318554,0.1779850704716796,128989.67013888899,-1475.5208333333233,127514.14930555566,2255,0,514.4897959183673,39,10,17,37.84693738036641,0.6047008547008547,46.04166666666667,1015.8333333333343,26.04700854700857,0
2287,4,2,5,45,0.04,0.1,0.9,50,1050,500,550,0.47619047619047616,16,5,11,312.97871287221676,0.8569897959183673,0.19720567659404398,0.17378829084347408,129253.05394441148,-1909.309108334974,127343.74483607651,2256,0,505.04,40,10,17,37.82605436737958,0.6057291666666667,45.78252032520326,1016.8699186991877,25.421747967479693,0
2288,4,0,0,45,0.0,0.0,1.0,45,1100,700,400,0.6363636363636364,15,7,8,350.9655662322559,0.8405303030303031,0.2006152166902333,0.18515603900521535,127205.59030314138,-37.994483290984064,127167.5958198504,2257,2,561.4666666666667,36,9,22,38.95284475701424,0.5920138888888887,47.80405405405408,1008.7837837837869,28.02177177177186,8
2289,4,2,1,46,0.0425531914893617,0.02127659574468085,0.9787234042553191,47,800,700,100,0.875,9,7,2,340.98172342432105,0.8474791859389453,0.2141604066393772,0.182036518261517,127685.20801373382,-692.3355431368097,126992.87247059701,2258,0,538.531914893617,38,9,17,38.71344256518673,0.5932017543859648,47.32905982905984,1010.6837606837621,26.59694107062532,0
2290,4,3,2,47,0.061224489795918366,0.04081632653061224,0.9591836734693877,49,1600,1100,500,0.6875,21,11,10,328.4829893045213,0.8633786848072562,0.23112615975029271,0.17858556558922595,128415.10662073559,-1361.9150184454684,127053.19160229013,2259,0,517.4897959183673,38,11,15,38.28440673201927,0.6006030701754386,46.60790598290598,1013.5683760683758,26.672852001799363,0
2291,4,0,1,46,0.0,0.02127659574468085,0.9787234042553191,47,1050,700,350,0.6666666666666666,14,7,7,346.86319773106004,0.8500616712920135,0.24629758849479066,0.18784072628482149,128258.57688347138,-502.36397715281896,127756.21290631856,2260,1,540.4255319148937,36,11,20,37.97850657772838,0.6027199074074073,46.76238738738739,1012.950450450451,28.137512512512526,0
2292,4,4,1,49,0.08,0.02,0.98,50,1400,1200,200,0.8571428571428571,16,12,4,328.2033230336403,0.8614115646258503,0.25386633866338637,0.1815165317186053,129095.50781250015,-1526.0850694444314,127569.42274305571,2261,0,508.76,39,11,19,37.599084324176566,0.6057692307692307,45.93750000000001,1016.2500000000011,26.05769230769234,0
2293,4,0,0,49,0.0,0.0,1.0,49,1700,1400,300,0.8235294117647058,20,14,6,332.1601143125262,0.8553358843537415,0.25894104093860837,0.18381845069546607,129119.93805473375,-1222.3013231426655,127897.63673159109,2262,1,520.1428571428571,38,11,20,37.47372017239568,0.6077302631578947,45.91346153846154,1016.346153846154,26.745951417004054,0
2294,4,0,0,49,0.0,0.0,1.0,49,1000,600,400,0.6,14,6,8,331.17870873218476,0.8561507936507937,0.25722692829962823,0.18378337319410815,129229.25954380185,-1240.378456656448,127988.8810871454,2263,2,521.1428571428571,37,12,20,37.38755436931595,0.6106418918918919,45.805921052631575,1016.7763157894728,27.48044096728305,0
2295,4,0,1,48,0.0,0.02040816326530612,0.9795918367346939,49,1200,1000,200,0.8333333333333334,14,10,4,333.40263438946204,0.8562216553287982,0.2606391990758561,0.18527917519246645,129285.00987082579,-1179.207424399805,128105.80244642598,2264,3,522.1428571428571,37,12,20,37.27437106918238,0.611204954954955,45.751096491228076,1016.9956140350889,27.486367946894294,0
2296,4,0,2,46,0.0,0.041666666666666664,0.9583333333333334,48,1150,700,450,0.6086956521739131,16,7,9,332.04728759429815,0.8525229018912529,0.23214379808198915,0.18076860080219698,128469.2559377054,-1064.744382972421,127404.51155473298,2265,4,533.7291666666666,38,10,17,38.138897670987454,0.6011513157894738,46.554487179487175,1013.7820512820508,26.67847503373818,2
2297,4,0,1,45,0.0,0.021739130434782608,0.9782608695652174,46,1350,800,550,0.5925925925925926,19,8,11,346.86319773106,0.8480877616747182,0.2361142663798732,0.18784072628482137,128258.57688347127,-302.3639771528347,127956.21290631843,2266,5,557.3695652173913,36,10,21,37.97850657772836,0.6027199074074074,46.762387387387385,1012.95045045045,28.1375125125125,0
2298,4,1,1,45,0.021739130434782608,0.021739130434782608,0.9782608695652174,46,1450,900,550,0.6206896551724138,20,9,11,343.8967152364882,0.8496175523349436,0.24023622351418683,0.1874361999993545,128515.36502718917,-360.7976219462927,128154.56740524288,2267,0,558.195652173913,36,10,18,37.791537094624594,0.6053240740740742,46.509009009009,1013.9639639639624,28.165665665665625,0
2299,4,2,3,44,0.0425531914893617,0.06382978723404255,0.9361702127659575,47,1500,1100,400,0.7333333333333333,19,11,8,323.32184611875675,0.8572309589885907,0.2315661373057396,0.17868181745703032,129065.65176647295,-1054.0510400686849,128011.60072640426,2268,0,545.4468085106383,38,9,18,37.75343461956329,0.6071820175438598,45.966880341880334,1016.1324786324776,26.7403283850652,0
2300,4,1,0,45,0.022222222222222223,0.0,1.0,45,850,500,350,0.5882352941176471,12,5,7,335.7071700409918,0.8480639730639731,0.23746552509772934,0.1853791798331243,129034.22807979358,-336.4568905817397,128697.77118921184,2269,0,548.3111111111111,37,8,20,37.47077127850923,0.6086711711711712,45.99780701754385,1016.0087719298228,27.45969653864386,0
2301,4,1,1,45,0.021739130434782608,0.021739130434782608,0.9782608695652174,46,1450,1100,350,0.7586206896551724,18,11,7,325.8535096940002,0.8540660225442834,0.22745584346181857,0.18107411318022074,129282.86540516079,-774.5449128862823,128508.3204922745,2270,0,537.3695652173913,38,8,20,37.468484084462666,0.6093750000000002,45.75320512820512,1016.9871794871772,26.76282051282045,0
2302,4,0,0,45,0.0,0.0,1.0,45,1350,800,550,0.5925925925925926,19,8,11,334.04626147915894,0.8461700336700337,0.2310976997042311,0.1861630786946013,129396.54659366321,-355.11347241461374,129041.4331212486,2271,2,550.3111111111111,37,8,21,37.14469501023818,0.6123310810810811,45.64144736842104,1017.434210526314,27.498221906116594,0
2303,4,0,0,45,0.0,0.0,1.0,45,1050,800,250,0.7619047619047619,13,8,5,333.13980046266107,0.8450757575757576,0.2296016952196247,0.18592125604894488,129452.33298947733,-374.85512369192634,129077.4778657854,2272,3,551.3111111111111,37,8,17,37.111100635707366,0.6128941441441442,45.586622807017534,1017.6535087719283,27.50414888572779,0
2304,4,1,1,45,0.021739130434782608,0.021739130434782608,0.9782608695652174,46,900,700,200,0.7777777777777778,11,7,4,326.47990650419604,0.8471417069243157,0.2309392088808213,0.18318616531515583,129663.42872242289,-733.4991827379902,128929.9295396849,2273,0,540.304347826087,38,8,17,37.06641840623798,0.6132127192982457,45.37927350427349,1018.4829059829042,26.802181736392214,0
2305,4,0,1,44,0.0,0.022222222222222223,0.9777777777777777,45,1400,1200,200,0.8571428571428571,16,12,4,333.7679768488676,0.8427609427609428,0.2336655824852243,0.1870160251232541,129609.02829141992,-348.1313691650418,129260.89692225488,2274,5,553.3111111111111,38,7,18,36.93605078165985,0.6126644736842106,45.4326923076923,1018.2692307692291,26.7965587044534,0
2306,4,1,1,44,0.022222222222222223,0.022222222222222223,0.9777777777777777,45,1100,500,600,0.45454545454545453,17,5,12,321.5890628392592,0.8470117845117846,0.14646305072845345,0.17579091258829987,128631.77237426047,-713.7163050624487,127918.05606919802,2275,0,550.4666666666667,38,7,18,38.23854660347551,0.602796052631579,46.394230769230774,1014.4230769230778,26.69534412955468,7
2307,4,1,0,45,0.022222222222222223,0.0,1.0,45,850,500,350,0.5882352941176471,12,5,7,325.9407030078918,0.8494949494949495,0.16361149110807105,0.17914485255546522,128848.62075617275,-600.597993827171,128248.02276234557,2276,0,551.3111111111111,38,7,19,37.90754673962607,0.6049890350877194,46.18055555555555,1015.277777777777,26.717836257309923,0
2308,4,1,1,45,0.021739130434782608,0.021739130434782608,0.9782608695652174,46,1050,700,350,0.6666666666666666,14,7,7,317.7909164203169,0.8502415458937198,0.16339985744832464,0.17622950819672129,129201.38888888896,-988.1944444444398,128213.19444444453,2277,0,540.304347826087,39,7,20,37.7561475409836,0.6068376068376069,45.833333333333336,1016.6666666666673,26.068376068376086,0
2309,4,0,0,45,0.0,0.0,1.0,45,1250,1000,250,0.8,15,10,5,325.83592260433574,0.8463383838383839,0.16584033613445381,0.18118913453231777,129310.02995105574,-573.2294177806825,128736.80053327506,2278,1,553.0888888888888,38,7,20,37.44135154061627,0.6096491228070174,45.726495726495735,1017.0940170940182,26.765632028789952,0
2310,4,1,0,46,0.021739130434782608,0.0,1.0,46,1250,800,450,0.64,17,8,9,321.6004810832445,0.851328502415459,0.1755811781033978,0.18002996002907423,129572.31445312513,-865.8962673610963,128706.41818576404,2279,0,542.0434782608696,39,7,18,37.28301275492806,0.610576923076923,45.46875000000001,1018.125000000001,26.10576923076926,0
2311,4,1,1,46,0.02127659574468085,0.02127659574468085,0.9787234042553191,47,1200,800,400,0.6666666666666666,16,8,8,315.65142773780485,0.8552266419981498,0.1794734196331793,0.1781823000358988,129899.73855054867,-1199.3924127503437,128700.34613779833,2280,0,531.4893617021277,40,7,19,37.10289768384674,0.6122395833333334,45.14735772357724,1019.4105691056916,25.48526422764229,0
2312,4,0,0,46,0.0,0.0,1.0,46,1250,1100,150,0.88,14,11,3,322.5166318567646,0.8543478260869566,0.1817888960476326,0.18189194482527088,129864.12896050386,-823.3317057291266,129040.79725477473,2281,1,543.9782608695652,39,7,19,36.963996763754054,0.6135149572649572,45.182291666666686,1019.2708333333364,26.135149572649652,0
2313,4,2,1,47,0.041666666666666664,0.020833333333333332,0.9791666666666666,48,1200,900,300,0.75,15,9,6,312.0871526910911,0.8609633569739953,0.193221962384317,0.17829242736741205,130366.3506861824,-1462.2570099617005,128904.0936762207,2282,0,522.2708333333334,40,8,21,36.72214482369722,0.6169270833333333,44.690040650406516,1021.2398373983758,25.530995934959396,0
2314,4,1,1,47,0.020833333333333332,0.020833333333333332,0.9791666666666666,48,1000,800,200,0.8,12,8,4,313.33514586953527,0.8609633569739953,0.19010287144799198,0.17948479894167751,130470.1558781976,-1423.8229352567807,129046.33294294082,2283,0,523.1041666666666,40,8,21,36.58547199840844,0.61796875,44.588414634146346,1021.6463414634155,25.54115853658539,0
2315,4,0,0,47,0.0,0.0,1.0,47,1900,1300,600,0.6842105263157895,25,13,12,318.99044088513307,0.8540703052728954,0.18846073258538265,0.18272426793266347,130470.15587819759,-1076.2534908123384,129393.90238738526,2284,2,535.2340425531914,40,7,21,36.44102921184391,0.61796875,44.588414634146346,1021.6463414634154,25.541158536585385,0
2316,4,0,1,46,0.0,0.02127659574468085,0.9787234042553191,47,1500,1100,400,0.7333333333333333,19,11,8,326.40637289582565,0.8519888991674375,0.1983122541347655,0.18785172261624772,130651.91436975366,-870.8765037345288,129781.03786601913,2285,3,536.2340425531914,40,7,16,36.06796719681908,0.6197916666666665,44.41056910569107,1022.3577235772375,25.558943089430937,0
2317,4,0,0,46,0.0,0.0,1.0,46,1050,600,450,0.5714285714285714,15,6,9,332.4726018103379,0.8485507246376812,0.2043026239402972,0.19086534209252365,130555.177137587,-518.796115451368,130036.38102213564,2286,4,548.3695652173913,39,7,16,36.010706519892636,0.6204594017094016,44.50520833333334,1021.9791666666682,26.204594017094056,0
2318,4,1,0,47,0.02127659574468085,0.0,1.0,47,1250,800,450,0.64,17,8,9,324.6929619153915,0.8536463151403021,0.2111387247567602,0.1878740655496647,130859.79327781106,-902.1492249983256,129957.64405281273,2287,0,537.6808510638298,40,7,17,35.90190868759105,0.6218749999999998,44.20731707317074,1023.1707317073189,25.579268292682972,0
2319,4,0,1,46,0.0,0.02127659574468085,0.9787234042553191,47,1300,800,500,0.6153846153846154,18,8,10,305.0857404479464,0.8539932161578785,0.1312514854349871,0.17439520810169942,130389.2089966773,-1443.1857697436817,128946.02322693363,2288,1,538.6808510638298,41,6,16,36.87783309049699,0.6155995934959348,44.66765873015873,1021.3293650793646,24.910472319008893,5
2320,4,1,1,46,0.02127659574468085,0.02127659574468085,0.9787234042553191,47,1500,1000,500,0.6666666666666666,20,10,10,306.5065861925627,0.8535306814677767,0.13245656983842635,0.17566562777947692,130490.55103812345,-1400.7573341836896,129089.79370393977,2289,0,539.4893617021277,41,6,15,36.73930721429263,0.6166158536585367,44.56845238095237,1021.7261904761895,24.920150987224133,0
2321,4,0,0,46,0.0,0.0,1.0,46,800,500,300,0.625,11,5,6,315.4908046830526,0.8482286634460547,0.13662556781310875,0.18035737127785423,130392.29811124328,-972.4857888822786,129419.812322361,2290,3,552.2173913043479,40,6,17,36.60903814262025,0.6171875,44.66463414634146,1021.3414634146338,25.533536585365844,0
2322,4,0,1,45,0.0,0.021739130434782608,0.9782608695652174,46,1000,700,300,0.7,13,7,6,320.76377139120757,0.8476046698872786,0.13555127079991824,0.18423308103263136,130574.00238160155,-823.3181100865934,129750.68427151495,2291,4,553.2173913043479,40,6,16,36.290850485565585,0.6190104166666668,44.48678861788618,1022.0528455284552,25.55132113821138,0
2323,4,0,1,44,0.0,0.022222222222222223,0.9777777777777777,45,1250,1000,250,0.8,15,10,5,318.9449095498332,0.8441077441077441,0.14394654596400502,0.18411657432579942,130769.44464128233,-658.3502614008628,130111.09437988147,2292,5,563.9333333333333,41,4,16,36.14007436146137,0.619410569105691,44.29563492063492,1022.8174603174594,24.946767324816083,0
2324,4,0,0,44,0.0,0.0,1.0,44,750,500,250,0.6666666666666666,10,5,5,323.7028416265978,0.8401823467230445,0.13827903362787053,0.18654627677244165,130703.86860499719,-338.15726419457883,130365.7113408026,2293,6,577.5227272727273,40,4,16,36.08460875902737,0.6203124999999999,44.35975609756098,1022.5609756097574,25.564024390243937,0
2325,4,0,0,44,0.0,0.0,1.0,44,1200,400,800,0.3333333333333333,20,4,16,324.1065234440127,0.8400942565186752,0.13624398349241895,0.18740840732400213,130833.79937743742,-319.18242696146143,130514.61695047596,2294,7,578.5227272727273,40,4,16,35.94313930002317,0.6216145833333333,44.232723577235774,1023.0691056910573,25.57672764227643,0
2326,4,0,0,44,0.0,0.0,1.0,44,1400,800,600,0.5714285714285714,20,8,12,326.04507860809554,0.8391032417195208,0.126775497680798,0.18942203701833646,131015.8109012493,-256.5879271597588,130759.22297408953,2295,8,579.5227272727273,40,4,16,35.70991330818608,0.6234375,44.05487804878049,1023.7804878048784,25.594512195121958,0
2327,4,1,2,43,0.022222222222222223,0.044444444444444446,0.9555555555555556,45,1150,600,550,0.5217391304347826,17,6,11,321.053147735803,0.84246632996633,0.13800875297052628,0.18817028789302612,131353.5478572215,-565.7059988347216,130787.84185838679,2296,0,567.6222222222223,41,4,18,35.49741523920126,0.6252540650406504,43.72519841269841,1025.0992063492058,25.0024196670538,0
2328,4,0,0,43,0.0,0.0,1.0,43,1100,600,500,0.5454545454545454,16,6,10,334.2050485870209,0.8305647840531561,0.16048921801675853,0.19602181693643966,131381.5158420138,181.6731770833286,131563.18901909713,2297,1,592.7441860465116,39,4,18,35.13217164532956,0.6287393162393162,43.697916666666664,1025.2083333333326,26.287393162393144,0
2329,4,0,0,43,0.0,0.0,1.0,43,1250,1000,250,0.8,15,10,5,335.2430606065015,0.831626061277224,0.16456434612359794,0.19731849478734126,131515.04041883672,217.90093315971217,131732.94135199644,2298,2,593.7441860465116,39,4,18,34.97099370366607,0.6300747863247864,43.56770833333333,1025.729166666666,26.300747863247846,0
2330,4,0,0,43,0.0,0.0,1.0,43,1650,1200,450,0.7272727272727273,21,12,9,336.1591383441986,0.8325950535252861,0.1639475858812416,0.1982735037539134,131595.18771701382,247.38498263887914,131842.5726996527,2299,3,594.7441860465116,39,4,17,34.86675126903553,0.6308760683760685,43.48958333333333,1026.041666666666,26.308760683760667,0
2331,4,1,0,44,0.022727272727272728,0.0,1.0,44,1150,800,350,0.6956521739130435,15,8,7,331.0908492350416,0.8361081747709656,0.16539617007114815,0.19672752576240796,131875.5693225756,-67.4411519267868,131808.12817064882,2300,0,582.2045454545455,40,4,18,34.714595494871546,0.6320312500000002,43.216463414634134,1027.1341463414615,25.678353658536537,0
2332,4,0,1,43,0.0,0.022727272727272728,0.9772727272727273,44,1300,1000,300,0.7692307692307693,16,10,6,329.91111364146724,0.8352272727272727,0.1582281040758553,0.19710873682713767,132084.41904826826,-84.77644341991777,131999.64260484834,2301,1,583.2045454545455,40,4,18,34.53493161970671,0.6341145833333333,43.01321138211382,1027.947154471545,25.698678861788625,0
2333,4,0,0,43,0.0,0.0,1.0,43,1450,1100,350,0.7586206896551724,18,11,7,333.40583313479755,0.8363325950535252,0.15565118870115557,0.1998613109010234,132210.46142578125,215.94780815972194,132426.40923394097,2302,2,596.3488372093024,39,4,18,34.3184484621358,0.6370192307692308,42.890625,1028.4375,26.370192307692307,0
2334,4,0,0,43,0.0,0.0,1.0,43,750,600,150,0.8,9,6,3,332.349567197034,0.8353636028054633,0.15108272815469936,0.19965233124318194,132290.82031250015,193.35937500001364,132484.17968750015,2303,3,597.3488372093024,39,4,18,34.26488456865128,0.6378205128205128,42.81250000000001,1028.7500000000011,26.378205128205156,0
2335,4,0,2,41,0.0,0.046511627906976744,0.9534883720930233,43,1150,800,350,0.6956521739130435,15,8,7,334.49777227009827,0.8337486157253599,0.15103684818866414,0.20137132798636814,132371.20361328125,255.57454427083235,132626.7781575521,2304,4,598.3488372093024,39,4,18,34.12889715558255,0.6386217948717949,42.734375,1029.0625,26.38621794871795,0
2336,4,0,0,41,0.0,0.0,1.0,41,750,500,250,0.6666666666666666,10,5,5,343.71765347222316,0.8328252032520325,0.1383523857047686,0.20646645572576658,132288.07259706705,893.9491790854047,133182.02177615245,2305,5,585.170731707317,38,3,18,33.97527434486102,0.6395285087719298,42.815170940170944,1028.7393162393168,27.072087269455707,0
2337,4,0,0,41,0.0,0.0,1.0,41,750,400,350,0.5333333333333333,11,4,7,344.7198510080639,0.8316056910569106,0.13691560028465033,0.207370198941828,132343.0323275076,924.2540771787694,133267.28640468637,2306,6,586.170731707317,38,3,18,33.89423908905271,0.6400767543859648,42.76175213675214,1028.9529914529924,27.077710301394536,0
2338,4,0,1,40,0.0,0.024390243902439025,0.975609756097561,41,1450,1100,350,0.7586206896551724,18,11,7,345.6937008394473,0.8315040650406504,0.07892127701764817,0.20247773906310498,131328.12500000015,879.8611111111269,132207.98611111127,2307,7,587.170731707317,39,2,16,34.89159891598916,0.6282051282051282,43.75000000000001,1025.0000000000011,26.28205128205131,5
2339,4,0,0,40,0.0,0.0,1.0,40,1350,1100,250,0.8148148148148148,16,11,5,354.2864696939653,0.8272168803418803,0.07560975609756104,0.2075106465350368,131328.125,1305.5555555555557,132633.68055555556,2308,12,602.675,38,2,17,34.67140921409214,0.6299342105263158,43.75,1025.0,26.973684210526315,0
2340,4,1,0,41,0.024390243902439025,0.0,1.0,41,900,600,300,0.6666666666666666,12,6,6,350.18271683779454,0.8277439024390244,0.08173465928633084,0.20756169812809042,131782.29302300356,1029.5762803819541,132811.86930338552,2309,0,588.9512195121952,39,2,15,34.31835666700482,0.6327457264957265,43.30729166666667,1026.7708333333342,26.327457264957285,0
2341,4,0,0,41,0.0,0.0,1.0,41,1350,1000,350,0.7407407407407407,17,10,7,349.25245615204665,0.8266768292682927,0.08278140781813415,0.20773991089092209,131916.0210503474,1014.3988715277968,132930.4199218752,2310,1,589.9512195121952,39,2,16,34.207479889136756,0.6340811965811965,43.17708333333334,1027.291666666668,26.340811965812,0
2342,4,2,2,41,0.046511627906976744,0.046511627906976744,0.9534883720930233,43,750,500,250,0.6666666666666666,10,5,5,336.21549845924443,0.8383167220376523,0.07339079274253568,0.20227535672965669,132346.95845930962,299.41972159233694,132646.37818090196,2311,0,563.4651162790698,41,2,17,34.10905964776964,0.6351626016260162,42.757936507936506,1028.9682539682537,25.09678668215253,0
2343,4,0,1,40,0.0,0.024390243902439025,0.975609756097561,41,850,500,350,0.5882352941176471,12,5,7,348.58346632788283,0.8253556910569105,0.07664092854953619,0.20822164925687345,132076.584201389,1007.9427083333384,133084.52690972234,2312,3,591.9512195121952,39,2,17,34.06296446426157,0.6356837606837606,43.020833333333336,1027.9166666666674,26.356837606837626,0
2344,4,0,0,40,0.0,0.0,1.0,40,1200,1000,200,0.8333333333333334,14,10,4,353.39663988312634,0.8197382478632479,0.07959459459459484,0.21089799476896248,132040.89506172843,1332.5617283950655,133373.45679012348,2313,4,607.35,38,2,17,33.97522522522524,0.6370614035087719,43.05555555555556,1027.777777777778,27.046783625731003,0
2345,4,1,1,40,0.024390243902439025,0.024390243902439025,0.975609756097561,41,1200,900,300,0.75,15,9,6,348.8192814546941,0.823119918699187,0.07998873954518615,0.20969495087815057,132317.6120334202,1030.9868706597272,133348.59890407993,2314,0,593.5121951219512,39,2,17,33.814354054874954,0.6380876068376069,42.786458333333336,1028.8541666666672,26.380876068376082,0
2346,4,0,0,40,0.0,0.0,1.0,40,1400,1000,400,0.7142857142857143,18,10,8,349.8594918851302,0.8200053418803419,0.0038586180380093538,0.20507217995044041,131356.98356718203,1196.3376528449844,132553.32122002702,2315,6,609.35,36,4,20,34.755712402504656,0.6339699074074074,43.721846846846844,1025.1126126126126,28.47535035035035,3
2347,4,1,1,40,0.024390243902439025,0.024390243902439025,0.975609756097561,41,700,400,300,0.5714285714285714,10,4,6,343.75676051322637,0.8249491869918699,0.002976772313410425,0.2026800257165885,131581.1250216412,846.3802564250421,132427.50527806624,2316,0,595.4634146341464,37,4,16,34.686041644401676,0.6342905405405406,43.503289473684205,1025.9868421052627,27.729374110953046,0
2348,4,1,1,40,0.024390243902439025,0.024390243902439025,0.975609756097561,41,1300,900,400,0.6923076923076923,17,9,8,342.9435934095893,0.8234247967479674,0.007553893834286063,0.2030403566896328,131739.10307774474,835.8162804076035,132574.91935815234,2317,0,596.439024390244,38,3,16,34.54768966593817,0.634046052631579,43.349358974358964,1026.6025641025628,27.015856950067445,0
2349,4,0,0,40,0.0,0.0,1.0,40,1650,1300,350,0.7878787878787878,20,13,7,349.0087881248002,0.8177617521367522,0.009752289758534038,0.20648253918122406,131711.68456424854,1193.7070823288582,132905.3916465774,2318,9,612.35,38,2,16,34.41966763807936,0.6337719298245614,43.37606837606837,1026.4957264957254,27.013045434098036,0
2350,4,0,0,40,0.0,0.0,1.0,40,1450,1200,250,0.8275862068965517,17,12,5,354.98167696206497,0.8153846153846154,0.012242562929061451,0.21092668988339267,131876.23844875448,1362.7296551976026,133238.96810395207,2319,10,613.35,38,2,16,34.10044379724013,0.6354166666666666,43.215811965811966,1027.1367521367522,27.02991452991453,0
2351,4,0,0,40,0.0,0.0,1.0,40,650,200,450,0.3076923076923077,11,2,9,356.2420923530116,0.815758547008547,0.0165869384359405,0.2119816806971879,131931.11257213808,1399.883117831826,133330.99568996992,2320,11,614.35,38,2,16,34.01275651691625,0.6359649122807018,43.16239316239316,1027.3504273504263,27.035537561853324,0
2352,4,0,1,39,0.0,0.025,0.975,40,900,600,300,0.6666666666666666,12,6,6,355.7864583135833,0.8144497863247864,0.007070470845026655,0.21247805806548634,132068.34781804736,1397.6259451019048,133465.97376314926,2321,12,615.35,38,2,17,33.88616048227833,0.6373355263157894,43.02884615384615,1027.8846153846155,27.049595141700408,0
2353,4,0,0,39,0.0,0.0,1.0,39,1200,900,300,0.75,15,9,6,360.4357287213596,0.8089293747188484,0.02507219742714617,0.21552585411297634,132116.0357032934,1723.8679208987517,133839.90362419214,2322,13,630.5897435897435,37,2,17,33.71862556882821,0.6396396396396395,42.982456140350884,1028.0701754385973,27.785680417259385,0
2354,4,0,0,39,0.0,0.0,1.0,39,850,400,450,0.47058823529411764,13,4,9,362.4119303646959,0.8079734592892488,0.02932121550163802,0.2170305927816169,132172.40521121898,1780.1713027085432,133952.57651392752,2323,14,631.5897435897435,37,2,18,33.61102225065756,0.6402027027027026,42.92763157894738,1028.2894736842118,27.79160739687059,0
2355,4,0,0,39,0.0,0.0,1.0,39,1250,1000,250,0.8,15,10,5,357.9508826400196,0.805668016194332,0.037281133189061455,0.21532122324961203,132341.5858725763,1674.3574946137437,134015.94336719005,2324,15,632.5897435897435,37,2,18,33.55534242682581,0.6418918918918918,42.76315789473685,1028.9473684210539,27.80938833570416,0
2356,4,0,0,39,0.0,0.0,1.0,39,1100,800,300,0.7272727272727273,14,8,6,359.9067889214359,0.8048807917228971,0.03845721353873843,0.21699329314429364,132427.78427479864,1732.3557663249524,134160.1400411236,2325,16,633.5897435897435,35,4,19,33.41825499456501,0.6467261904761905,42.67939814814815,1029.2824074074083,29.40806878306881,0
2357,4,1,1,39,0.025,0.025,0.975,40,800,500,300,0.625,11,5,6,351.31962008798985,0.8118055555555556,0.04023283777874975,0.2131214777562954,132658.9004545087,1321.134901793705,133980.0353563024,2326,0,618.725,36,4,16,33.406892216878006,0.6469907407407407,42.454954954954964,1030.1801801801814,28.61611611611615,0
2358,4,0,0,39,0.0,0.0,1.0,39,1550,1200,350,0.7741935483870968,19,12,7,357.92903447026555,0.8038686459739092,0.044618151632539904,0.21631363387550828,132517.14677640595,1686.3468792866856,134203.49365569264,2327,18,635.5897435897435,35,4,19,33.37923411270984,0.6476190476190476,42.59259259259259,1029.629629629629,29.417989417989403,0
2359,4,0,1,38,0.0,0.02564102564102564,0.9743589743589743,39,1000,600,400,0.6,14,6,8,360.4520349169231,0.8033625730994153,0.04102448849049578,0.21835688623047642,132606.53941883147,1759.6593953618008,134366.19881419328,2328,19,636.5897435897435,35,4,19,33.22435573285388,0.6485119047619048,42.50578703703704,1029.9768518518522,29.42791005291006,0
2360,4,0,0,38,0.0,0.0,1.0,38,1150,800,350,0.6956521739130435,15,8,7,366.8482074242375,0.7977121858700806,0.05631274718588375,0.22190468491046522,132551.19756235817,2125.233843537403,134676.43140589556,2329,20,652.3947368421053,34,4,19,33.11536608863197,0.6501225490196079,42.5595238095238,1029.761904761904,30.28711484593835,0
2361,4,0,0,38,0.0,0.0,1.0,38,1050,800,250,0.7619047619047619,13,8,5,372.1487118437464,0.7977121858700806,0.10713478206255456,0.22086446212822922,131831.05656478286,2227.1211057952696,134058.17767057812,2330,21,653.3947368421053,33,5,16,33.705250596658715,0.6452020202020201,43.25980392156863,1026.9607843137262,31.120023767082614,3
2362,4,0,0,38,0.0,0.0,1.0,38,850,600,250,0.7058823529411765,11,6,5,371.94970724096663,0.797504741583689,0.09986689854781239,0.22129555683470725,131925.46323829787,2213.9274858227677,134139.39072412063,2331,22,654.3947368421053,33,5,16,33.615029424629206,0.6461489898989898,43.16789215686275,1027.3284313725499,31.131164587046964,0
2363,4,0,0,38,0.0,0.0,1.0,38,1500,1100,400,0.7333333333333333,19,11,8,374.9477704732904,0.7983048838311996,0.1060129475878715,0.2238796023697364,132061.2882653061,2303.2171201814035,134364.5053854875,2332,23,655.3947368421053,34,4,17,33.40089568373099,0.6452205882352942,43.035714285714285,1027.8571428571427,30.231092436974784,0
2364,4,0,1,37,0.0,0.02631578947368421,0.9736842105263158,38,1100,900,200,0.8181818181818182,13,9,4,374.8729277704374,0.7974158368895211,0.10261878358781873,0.2245598023634561,132183.6805555555,2310.4166666666624,134494.09722222216,2333,24,656.3947368421053,34,4,17,33.27930848190167,0.6464460784313726,42.916666666666664,1028.333333333333,30.245098039215677,0
2365,4,0,1,36,0.0,0.02702702702702703,0.972972972972973,37,800,500,300,0.625,11,5,6,383.8254039858034,0.7928553553553553,0.1022166932016686,0.2289302871852736,132019.90370290275,2734.518574586701,134754.42227748944,2334,25,673.5945945945946,33,4,17,33.21458383019319,0.6470959595959596,43.075980392156865,1027.6960784313726,31.142305407011293,0
2366,4,0,0,36,0.0,0.0,1.0,36,850,600,250,0.7058823529411765,11,6,5,391.28065454327066,0.7864087301587303,0.11177663103575375,0.2333064650056911,132008.45457415067,3130.4709022038696,135138.92547635455,2335,26,691.8611111111111,32,4,18,33.03461727484949,0.6494140625,43.08712121212122,1027.651515151516,32.11410984848487,0
2367,4,0,0,36,0.0,0.0,1.0,36,1150,600,550,0.5217391304347826,17,6,11,386.52524530250645,0.7858134920634922,0.10698963174830145,0.23150130858910295,132177.3795685554,3017.9788122356763,135195.35838079106,2336,27,692.8611111111111,33,3,18,32.9861111111111,0.6486742424242424,42.92279411764706,1028.308823529412,31.16087344028521,0
2368,4,0,1,35,0.0,0.027777777777777776,0.9722222222222222,36,1050,800,250,0.7619047619047619,13,8,5,383.98906318546625,0.7857473544973546,0.10791069277307797,0.2303659905157699,132240.39619677537,2955.773170174943,135196.16936695031,2337,28,693.8611111111111,33,3,19,32.987683188371264,0.6493055555555556,42.86151960784314,1028.5539215686283,31.168300653594798,0
2369,4,0,1,34,0.0,0.02857142857142857,0.9714285714285714,35,550,100,450,0.18181818181818182,10,1,9,393.6257052249855,0.7792016806722688,0.11504359572639089,0.23551022172278172,132138.24043783802,3402.6016159065452,135540.84205374456,2338,29,712.4285714285714,32,3,19,32.84313725490195,0.6507161458333333,42.96085858585859,1028.156565656566,32.12989267676769,0
2370,4,0,0,34,0.0,0.0,1.0,34,1050,700,350,0.6666666666666666,14,7,7,392.9541460971666,0.7764408793820559,0.11888940251935765,0.23531018866289155,132170.69686766661,3587.4046653402816,135758.1015330069,2339,30,720.5588235294117,32,2,19,32.82759291093648,0.6510416666666666,42.929292929292934,1028.2828282828289,32.1338383838384,0
2371,4,0,0,34,0.0,0.0,1.0,34,800,400,400,0.5,12,4,8,390.6311366156914,0.7766636957813429,0.11780955476113086,0.2341199858524509,132203.15728305798,3528.5339187327986,135731.6912017908,2340,31,721.5588235294117,32,2,19,32.85451197053408,0.6513671875,42.89772727272728,1028.409090909092,32.13778409090912,0
2372,4,0,0,34,0.0,0.0,1.0,34,900,700,200,0.7777777777777778,11,7,4,411.38536924688935,0.7761066547831255,0.10113021469715489,0.23497774480712175,130359.27456382012,3946.240817263556,134305.51538108368,2341,32,722.5588235294117,32,2,17,34.1941765578635,0.6328125,44.6969696969697,1021.2121212121219,31.91287878787881,6
2373,4,2,2,34,0.05555555555555555,0.05555555555555555,0.9444444444444444,36,900,700,200,0.7777777777777778,11,7,4,394.0919329126281,0.7940476190476191,0.0878395851920819,0.22773584260378027,130810.03578514737,3110.2359693877524,133920.27175453512,2342,0,683.3611111111111,34,2,17,34.17728577524342,0.6326593137254901,44.25595238095238,1022.9761904761903,30.087535014005596,0
2374,4,1,0,35,0.02857142857142857,0.0,1.0,35,1050,800,250,0.7619047619047619,13,8,5,414.85521799335294,0.7870448179271708,0.14529088181363603,0.23545094160284985,130110.72137188198,3795.4223356008924,133906.14370748287,2343,0,703.8571428571429,34,1,18,34.35919875534812,0.6256127450980392,44.94047619047618,1020.2380952380944,30.00700280112042,4
2375,4,0,0,35,0.0,0.0,1.0,35,900,600,300,0.6666666666666666,12,6,6,412.8343607474601,0.7868347338935574,0.15010581393411226,0.23485261942189606,130201.83000283434,3750.357851473907,133952.18785430826,2344,1,704.8571428571429,34,1,18,34.31777090866674,0.6265318627450981,44.85119047619047,1020.595238095237,30.01750700280109,0
2376,4,1,0,36,0.027777777777777776,0.0,1.0,36,1000,800,200,0.8,12,8,4,404.06323762638044,0.7971230158730159,0.15896987166289245,0.23214278982154335,130585.01882779799,3352.9636156191673,133937.98244341716,2345,0,686.25,32,4,17,34.15122503603047,0.6350911458333335,44.47601010101009,1022.0959595959581,31.94049873737369,0
2377,4,1,0,37,0.02702702702702703,0.0,1.0,37,900,500,400,0.5555555555555556,13,5,8,395.2915584034293,0.799049049049049,0.1665501708605157,0.22926910387398883,130951.5570934255,2952.809015763154,133904.36610918865,2346,0,668.6756756756756,33,4,18,34.00283365261813,0.6363636363636365,44.11764705882352,1023.5294117647051,31.016042780748638,0
2378,4,2,1,38,0.05128205128205128,0.02564102564102564,0.9743589743589743,39,800,500,300,0.625,11,5,6,379.7107441615491,0.8089856050382367,0.1581862055795702,0.22343935024964456,131506.13667052463,2186.858603395056,133692.9952739197,2347,0,635.3333333333334,35,4,20,33.83970886932972,0.6375,43.576388888888886,1025.6944444444441,29.305555555555546,0
2379,4,0,0,38,0.0,0.0,1.0,38,1250,800,450,0.64,17,8,9,391.5156121624682,0.8002607871028924,0.16926281581390756,0.23041656519069872,131511.22448979606,2697.739512471666,134208.96400226772,2348,1,653.0526315789474,34,4,21,33.531849659548115,0.6397058823529411,43.57142857142858,1025.7142857142867,30.168067226890784,0
2380,4,0,1,37,0.0,0.02631578947368421,0.9736842105263158,38,1450,1100,350,0.7586206896551724,18,11,7,390.4379614007713,0.8013869132290184,0.17580388158657834,0.23070360968033268,131663.90483276662,2681.3173185941255,134345.22215136074,2349,2,654.0526315789474,34,4,16,33.40486409155937,0.6412377450980391,43.42261904761906,1026.3095238095252,30.18557422969192,0
2381,4,0,0,37,0.0,0.0,1.0,37,900,700,200,0.7777777777777778,11,7,4,399.45147498071503,0.7973598598598598,0.17959020205674125,0.2347338442864203,131453.7677816225,3101.8802864283066,134555.64806805082,2350,4,672.6756756756756,33,4,20,33.38661169534736,0.6414141414141414,43.62745098039216,1025.4901960784318,31.075460487225207,0
2382,4,1,1,37,0.02631578947368421,0.02631578947368421,0.9736842105263158,38,1100,900,200,0.8181818181818182,13,9,4,391.09725793056674,0.8065730203888098,0.17088932166863025,0.2310931775613036,131663.90483276662,2698.678429705237,134362.58326247186,2351,0,655.9473684210526,34,4,16,33.38794803387078,0.6412377450980391,43.42261904761906,1026.3095238095252,30.18557422969192,0
2383,4,0,0,37,0.0,0.0,1.0,37,1000,700,300,0.7,13,7,6,401.62126805426414,0.7975475475475475,0.18232753890742903,0.2371774681725255,131642.34459102285,3174.0730728566105,134816.41766387946,2352,6,674.6756756756756,33,4,16,33.139777883926435,0.6433080808080807,43.4436274509804,1026.2254901960796,31.09774212715393,0
2384,4,0,0,37,0.0,0.0,1.0,37,900,500,400,0.5555555555555556,13,5,8,400.7326191976474,0.7975475475475475,0.17457109283196215,0.23754768663778075,131786.1128826531,3162.1988378684846,134948.3117205216,2353,7,675.6756756756756,34,3,17,33.016908212560374,0.6424632352941178,43.30357142857143,1026.7857142857147,30.199579831932784,0
2385,4,1,0,38,0.02631578947368421,0.0,1.0,38,900,500,400,0.5555555555555556,13,5,8,392.3040729161711,0.8010312944523471,0.1718660179330207,0.23430077145719685,132070.63567654756,2762.369657707482,134833.00533425505,2354,0,658.8684210526316,35,3,18,32.94545002439664,0.6431547619047618,43.026620370370374,1027.8935185185192,29.36838624338626,0
2386,4,0,0,38,0.0,0.0,1.0,38,800,600,200,0.75,10,6,4,393.5926578618692,0.8009423897581792,0.16577407047560389,0.23562514639116205,132159.87761488333,2803.431498628246,134963.30911351158,2355,1,659.8684210526316,35,3,18,32.82211466306469,0.644047619047619,42.93981481481481,1028.24074074074,29.378306878306855,0
2387,4,0,0,38,0.0,0.0,1.0,38,600,200,400,0.3333333333333333,10,2,8,393.96615513816477,0.8002904220009484,0.16633497992110624,0.23622019261523153,132219.38898533946,2817.992862654317,135037.3818479938,2356,2,660.8684210526316,35,3,19,32.75236326806212,0.6446428571428571,42.88194444444444,1028.472222222222,29.384920634920626,0
2388,4,0,0,38,0.0,0.0,1.0,38,950,600,350,0.631578947368421,13,6,7,393.16189519551756,0.7991346609767662,0.16642281527392933,0.23649244479272194,132340.06123944902,2806.213857438535,135146.27509688755,2357,3,661.8684210526316,36,2,19,32.651125460581525,0.6438078703703705,42.76463963963965,1028.9414414414423,28.58170670670673,0
2389,4,0,0,38,0.0,0.0,1.0,38,1150,700,450,0.6086956521739131,16,7,9,393.92553502241975,0.7989568515884305,0.169399905036707,0.23750907781058853,132428.63520408154,2833.4295582123673,135262.0647622939,2358,4,662.8684210526316,34,4,20,32.5420232862981,0.6488970588235294,42.67857142857142,1029.2857142857135,30.27310924369746,0
2390,4,0,0,38,0.0,0.0,1.0,38,650,400,250,0.6153846153846154,9,4,5,395.30536916772013,0.7988383119962067,0.1693972442670042,0.2387291084191649,132489.90929705207,2874.7945011337747,135364.70379818586,2359,5,663.8684210526316,34,4,21,32.44464037927845,0.6495098039215687,42.61904761904761,1029.5238095238087,30.280112044817905,0
2391,4,0,0,38,0.0,0.0,1.0,38,950,600,350,0.631578947368421,13,6,7,397.3004952271322,0.7979788999525842,0.1712032074174572,0.24052110456332512,132581.847009637,2934.9666950113105,135516.8137046483,2360,6,664.8684210526316,34,4,21,32.30045659461333,0.6504289215686276,42.52976190476189,1029.8809523809507,30.29061624649855,0
2392,4,0,0,38,0.0,0.0,1.0,38,1150,900,250,0.782608695652174,14,9,5,397.25303765322565,0.7966453295400664,0.17375278587347864,0.2414159586502842,132725.7764944485,2945.143577460537,135670.92007190906,2361,7,665.8684210526316,35,3,16,32.15641263244598,0.6497023809523811,42.39004629629628,1030.4398148148132,29.44113756613752,0
2393,4,0,0,38,0.0,0.0,1.0,38,1050,800,250,0.7619047619047619,13,8,5,393.34594593060933,0.7962897107633949,0.17111912290552356,0.23942212224962886,132785.4151261357,2846.120943715674,135631.53606985137,2362,8,666.8684210526316,35,3,16,32.19691652629608,0.6502976190476192,42.33217592592591,1030.671296296294,29.44775132275126,0
2394,4,0,0,38,0.0,0.0,1.0,38,750,400,350,0.5333333333333333,11,4,7,395.2859235565539,0.7962304409672831,0.17337930545461044,0.2409864285501862,132845.06715374207,2902.3570119598517,135747.42416570193,2363,9,667.8684210526316,35,3,17,32.086771640282926,0.6508928571428573,42.27430555555554,1030.902777777776,29.45436507936503,0
2395,4,0,0,38,0.0,0.0,1.0,38,1150,1000,150,0.8695652173913043,13,10,3,398.33327424101327,0.795104314841157,0.17636775961447637,0.24381498214532316,132994.2558299038,2995.2074759944912,135989.46330589827,2364,10,668.8684210526316,35,3,17,31.857794733692398,0.6523809523809525,42.12962962962962,1031.48148148148,29.470899470899425,0
2396,4,0,0,38,0.0,0.0,1.0,38,500,300,200,0.6,7,3,4,399.8927815738384,0.7954302987197724,0.17951602331307948,0.24496524825894292,133024.10361207544,3039.075761959859,136063.1793740353,2365,11,669.8684210526316,35,3,17,31.787487377987205,0.6526785714285714,42.100694444444436,1031.597222222221,29.474206349206316,0
2397,4,1,0,39,0.02564102564102564,0.0,1.0,39,700,400,300,0.5714285714285714,10,4,6,388.6674684168065,0.8017881241565452,0.12510844022943024,0.23307288174988167,132224.214818704,2486.960863770604,134711.1756824746,2366,0,653.6666666666666,36,3,18,32.883727508303245,0.6426504629629629,42.87725225225226,1028.4909909909923,28.56919419419423,6
2398,4,1,0,40,0.025,0.0,1.0,40,1050,600,450,0.5714285714285714,15,6,9,379.9501016845302,0.8069978632478633,0.12231822910646173,0.23001737786374185,132581.84700963716,2075.23965378092,134657.08666341807,2367,0,638.3,34,6,20,32.74717759025931,0.6504289215686274,42.529761904761905,1029.8809523809523,30.290616246498598,0
2399,4,0,1,39,0.0,0.025,0.975,40,850,500,350,0.5882352941176471,12,5,7,380.91132044861945,0.8067307692307693,0.12230151392580613,0.23097586936523504,132643.15653344675,2105.055980725624,134748.21251417237,2368,1,639.3,34,6,15,32.66063792904196,0.6510416666666667,42.470238095238095,1030.1190476190477,30.29761904761905,0
2400,4,1,1,39,0.025,0.025,0.975,40,1100,700,400,0.6363636363636364,15,7,8,377.0237143740332,0.8060096153846154,0.12285772029102682,0.22974302201018673,132827.17013888885,2015.7986111111072,134842.96874999994,2369,0,639.7,34,6,15,32.57545136081918,0.6528799019607843,42.291666666666664,1030.833333333333,30.318627450980383,0
2401,4,0,1,38,0.0,0.02564102564102564,0.9743589743589743,39,1050,700,350,0.6666666666666666,14,7,7,389.04084797979914,0.7985267656320288,0.13774810207628319,0.23674627579667923,132776.64389898095,2531.1076268742563,135307.75152585522,2370,3,657.1025641025641,33,6,15,32.31668648434404,0.6546717171717172,42.34068627450979,1030.637254901959,31.23143196672603,0
2402,4,0,0,38,0.0,0.0,1.0,38,850,600,250,0.7058823529411765,11,6,5,385.1278647013871,0.7922000948316738,0.13778197658523572,0.23545255412195584,132949.91673752826,2640.543509070288,135590.46024659855,2371,4,672.1578947368421,34,4,16,32.2429681788449,0.6541053921568627,42.172619047619044,1031.3095238095232,30.33263305322127,0
2403,4,1,1,38,0.02564102564102564,0.02564102564102564,0.9743589743589743,39,1250,900,350,0.72,16,9,7,375.80403245760806,0.7984705353126406,0.1296281921912601,0.23131788581707402,133203.26063368036,2211.6644965277533,135414.9251302081,2372,0,655.8974358974359,35,4,16,32.22859905819038,0.6544642857142858,41.92708333333332,1032.2916666666652,29.494047619047574,0
2404,4,0,1,37,0.0,0.02631578947368421,0.9736842105263158,38,900,500,400,0.5555555555555556,13,5,8,384.7338325142697,0.791459222380275,0.129708358132812,0.23579231913498283,133042.0138888887,2637.152777777754,135679.16666666645,2373,6,674.1578947368421,34,4,16,32.16040656973613,0.6550245098039217,42.08333333333332,1031.6666666666652,30.343137254901915,0
2405,4,0,0,37,0.0,0.0,1.0,37,550,400,150,0.7272727272727273,7,4,3,390.2050811141721,0.7894144144144144,0.12699972699972717,0.23845866068088287,132934.57031249988,2974.34895833332,135908.9192708332,2374,7,653.2432432432432,33,4,16,32.127525252525245,0.65625,42.18749999999999,1031.249999999999,31.24999999999997,0
2406,4,0,0,37,0.0,0.0,1.0,37,800,400,400,0.5,12,4,8,387.85948469077744,0.7891641641641641,0.12297506012606418,0.23742642055580146,132997.76715986626,2916.889087129934,135914.6562469962,2375,8,654.2432432432432,33,4,16,32.12434656053226,0.6568813131313131,42.12622549019607,1031.4950980392146,31.257427213309533,0
2407,4,0,0,37,0.0,0.0,1.0,37,850,700,150,0.8235294117647058,10,7,3,376.6998494651159,0.7897897897897898,0.08462592561616633,0.22770015361193552,132524.15687475973,2585.2107662918106,135109.36764105153,2376,9,655.2432432432432,33,4,18,32.88899468380544,0.6521464646464646,42.58578431372549,1029.6568627450981,31.201723113487823,4
2408,4,0,0,37,0.0,0.0,1.0,37,850,600,250,0.7058823529411765,11,6,5,364.7166196999674,0.7892892892892893,0.07069151245236882,0.22101248655935302,132618.8113496011,2273.6569168108404,134892.46826641195,2377,10,656.2432432432432,33,4,18,33.10219611342454,0.6530934343434345,42.493872549019606,1030.0245098039215,31.21286393345217,2
2409,4,0,0,37,0.0,0.0,1.0,37,1100,600,500,0.5454545454545454,16,6,10,364.9750030691711,0.7886636636636637,0.06975794917286193,0.22191430229997527,132745.06987997395,2289.7264573721577,135034.7963373461,2378,11,657.2432432432432,33,4,16,32.96852083085584,0.6543560606060608,42.37132352941176,1030.5147058823522,31.22771836007128,0
2410,4,0,0,37,0.0,0.0,1.0,37,800,200,600,0.25,14,2,12,365.0445803734802,0.7879754754754754,0.0710395331724547,0.22233091712681682,132808.22167255374,2296.184310121098,135104.40598267486,2379,12,658.2432432432432,33,4,16,32.903217017397836,0.6549873737373737,42.31004901960784,1030.759803921568,31.235145573380848,0
2411,4,0,0,37,0.0,0.0,1.0,37,1050,600,450,0.5714285714285714,15,6,9,366.54417470876206,0.7876001001001001,0.07023043961479902,0.22381006429604683,132902.97752066512,2342.9624423298746,135245.939962995,2380,13,659.2432432432432,33,4,17,32.76929324142303,0.6559343434343434,42.21813725490196,1031.1274509803923,31.24628639334522,0
2412,4,0,1,36,0.0,0.02702702702702703,0.972972972972973,37,700,500,200,0.7142857142857143,9,5,4,369.726254581192,0.7869744744744744,0.025804084627614188,0.2138992205823126,130854.0166323731,2330.098837223098,133184.1154695962,2381,14,660.2432432432432,35,2,16,34.755844645550525,0.6309523809523809,44.21296296296296,1023.148148148148,29.23280423280423,8
2413,4,1,0,37,0.02702702702702703,0.0,1.0,37,1550,1300,250,0.8387096774193549,18,13,5,378.62634024317447,0.7880380380380381,0.05801056902378532,0.2212527386252688,131239.16437596452,2538.120900848769,133777.2852768133,2382,0,660.8108108108108,35,2,17,34.13779227380549,0.6348214285714285,43.83680555555556,1024.6527777777778,29.275793650793652,0
2414,4,1,1,37,0.02631578947368421,0.02631578947368421,0.9736842105263158,38,900,600,300,0.6666666666666666,12,6,6,373.6333605993434,0.793859649122807,0.05279625124948706,0.22000169888166884,131530.201548677,2228.8142449882275,133759.01579366522,2383,0,644.3947368421053,36,2,17,33.9712097925129,0.6357060185185186,43.552927927927925,1025.788288288288,28.49411911911911,0
2415,4,0,0,37,0.0,0.0,1.0,37,1200,900,300,0.75,15,9,6,379.2980914364106,0.7872872872872873,0.06693771979857077,0.2230232507112167,131476.45968632118,2573.7540455675626,134050.21373188874,2384,2,662.8108108108108,35,2,19,33.88032295075801,0.637202380952381,43.605324074074076,1025.578703703704,29.302248677248684,0
2416,4,1,1,37,0.02631578947368421,0.02631578947368421,0.9736842105263158,38,800,500,300,0.625,11,5,6,375.5105219050391,0.7924668089141773,0.06072785650762835,0.22194571314153894,131674.63705259323,2289.042336255187,133963.67938884842,2385,0,646.3421052631579,36,2,14,33.77701887206498,0.6371527777777777,43.41216216216217,1026.3513513513522,28.50975975975978,0
2417,4,1,1,37,0.02631578947368421,0.02631578947368421,0.9736842105263158,38,800,400,400,0.5,12,4,8,379.4596770767231,0.7917852062588905,0.065447504054577,0.22513290795462854,131819.15181651257,2404.0105561642904,134223.16237267686,2386,0,647.3157894736842,36,2,15,33.529581094418255,0.638599537037037,43.271396396396405,1026.9144144144154,28.52540040040043,0
2418,4,0,0,37,0.0,0.0,1.0,37,650,400,250,0.6153846153846154,9,4,5,388.2669500196371,0.7839089089089089,0.07591943691154501,0.22990172541216175,131743.67310742466,2830.342828360777,134574.01593578543,2387,5,665.8108108108108,35,2,15,33.37983840661405,0.6398809523809523,43.34490740740741,1026.6203703703711,29.332010582010604,0
2419,4,1,0,38,0.02631578947368421,0.0,1.0,38,850,800,50,0.9411764705882353,9,8,1,378.3168706564774,0.7911332385016595,0.08524171561309313,0.22651877678454416,132166.31063073222,2400.1490088061187,134566.45963953834,2388,0,649.2631578947369,36,2,16,33.20830139086628,0.6420717592592592,42.933558558558566,1028.265765765767,28.56293793793797,0
2420,4,0,0,38,0.0,0.0,1.0,38,1200,1000,200,0.8333333333333334,14,10,4,378.04319408626975,0.78849573257468,0.08967015018995639,0.22810828820917803,132457.56842635464,2415.139355368268,134872.70778172291,2389,1,650.2631578947369,35,3,17,32.92153886515255,0.6470238095238094,42.65046296296297,1029.3981481481487,29.41137566137568,0
2421,4,0,0,38,0.0,0.0,1.0,38,1250,1200,50,0.96,13,12,1,378.5077641711906,0.7887920815552395,0.09328208160851581,0.22947677800569452,132636.34366426614,2440.7771776406094,135077.12084190676,2390,2,651.2631578947369,35,3,15,32.72940074906367,0.6488095238095237,42.476851851851855,1030.0925925925928,29.431216931216937,0
2422,4,0,1,37,0.0,0.02631578947368421,0.9736842105263158,38,1000,700,300,0.7,13,7,6,378.3403505628712,0.7882882882882883,0.08723037100949105,0.22986814127823868,132716.9124360849,2442.4326353380634,135159.34507142298,2391,3,652.2631578947369,36,2,15,32.65255009107469,0.6475694444444443,42.39864864864866,1030.4054054054068,28.62237237237241,0
2423,4,0,0,37,0.0,0.0,1.0,37,550,300,250,0.5454545454545454,8,3,5,377.44193538344535,0.7877877877877878,0.0728734416855934,0.22949974423215383,132745.92318247329,2620.7756320510025,135366.69881452428,2392,4,635.1621621621622,36,1,15,32.64647761628967,0.6478587962962962,42.37049549549551,1030.5180180180203,28.625500500500564,0
2424,4,0,0,37,0.0,0.0,1.0,37,1150,800,350,0.6956521739130435,15,8,7,376.9263143480596,0.7876626626626626,0.07229057966521069,0.2295413543065733,132803.95418645028,2611.460996469479,135415.41518291977,2393,5,636.1621621621622,36,1,15,32.60133289631815,0.6484374999999998,42.31418918918921,1030.7432432432458,28.63175675675683,0
2425,4,0,0,37,0.0,0.0,1.0,37,1000,700,300,0.7,13,7,6,378.72634712702063,0.7874124124124124,0.07068879516187554,0.23135404674063595,132920.0542392057,2668.0653203879865,135588.11955959367,2394,6,637.1621621621622,36,1,15,32.438071056750765,0.6495949074074073,42.20157657657659,1031.1936936936959,28.64426926926933,0
2426,4,0,0,37,0.0,0.0,1.0,37,850,500,350,0.5882352941176471,12,5,7,380.0341577716221,0.7872247247247247,0.074909880410863,0.23305709193464536,133065.2506391527,2713.8680910640446,135779.11873021675,2395,7,638.1621621621622,36,1,15,32.25824055882996,0.6510416666666666,42.060810810810814,1031.756756756757,28.65990990990992,0
2427,4,0,0,37,0.0,0.0,1.0,37,1550,1200,350,0.7741935483870968,19,12,7,374.2705517294338,0.7859734734734735,0.06974488396982115,0.23041894880481661,133210.52629910313,2571.3554348267157,135781.88173392985,2396,8,639.1621621621622,36,1,15,32.260872331915195,0.6524884259259259,41.92004504504504,1032.3198198198197,28.675550550550547,0
2428,4,0,0,37,0.0,0.0,1.0,37,850,600,250,0.7058823529411765,11,6,5,372.49150746121455,0.7859109109109109,0.06458306927278468,0.22968222137941338,133268.65875588427,2528.2887194627065,135796.94747534697,2397,9,640.1621621621622,36,1,15,32.24838222997783,0.6530671296296295,41.86373873873874,1032.545045045045,28.681806806806808,0
2429,4,1,1,37,0.02631578947368421,0.02631578947368421,0.9736842105263158,38,850,400,450,0.47058823529411764,13,4,9,362.9203034666402,0.7907776197249882,0.05844639928432982,0.2253641776195415,133530.41174620565,2092.3348601980356,135622.74660640367,2398,0,624.2894736842105,36,2,17,32.23287571729499,0.6556712962962963,41.61036036036036,1033.5585585585584,28.709959959959956,0
2430,4,0,0,37,0.0,0.0,1.0,37,1000,800,200,0.8,12,8,4,380.0967278288443,0.7845970970970971,0.056282470016164154,0.22414121990835922,131587.0909218448,2627.367371373323,134214.4582932181,2399,11,642.1621621621622,32,5,15,33.74789769464271,0.6451822916666665,43.497474747474755,1026.0101010101018,32.06281565656568,4
2431,4,0,0,37,0.0,0.0,1.0,37,850,500,350,0.5882352941176471,12,5,7,379.7543923212845,0.7839089089089089,0.060405139391359386,0.22432003639443332,131651.87225793296,2599.0753494541477,134250.94760738712,2400,12,643.1621621621622,32,5,15,33.6911499343832,0.6458333333333333,43.43434343434344,1026.262626262627,32.070707070707094,0
2432,4,0,1,36,0.0,0.02702702702702703,0.972972972972973,37,1100,700,400,0.6363636363636364,15,7,8,384.4352563932012,0.7836586586586587,0.055835690566966134,0.22766519080357772,131749.0741537855,2729.7978203754983,134478.871974161,2401,13,644.1621621621622,32,5,15,33.47271758291313,0.6468098958333333,43.33964646464648,1026.6414141414157,32.08254419191924,0
2433,4,0,0,36,0.0,0.0,1.0,36,1000,600,400,0.6,14,6,8,384.5576526483408,0.7802910052910054,0.050557194362504054,0.22871060394348708,131911.15702479347,2945.488980716264,134856.64600550974,2402,14,646.7222222222222,32,4,16,33.30567846607669,0.6484375,43.18181818181819,1027.272727272728,32.10227272727275,0
2434,4,0,1,35,0.0,0.027777777777777776,0.9722222222222222,36,1100,600,500,0.5454545454545454,16,6,10,384.00838183265427,0.7785052910052911,0.05666147838671809,0.22877453963061065,131976.01807213554,2935.9794281195873,134911.99750025512,2403,15,647.7222222222222,32,4,16,33.25422913082658,0.6490885416666666,43.11868686868687,1027.5252525252529,32.11016414141415,0
2435,4,0,0,35,0.0,0.0,1.0,35,750,500,250,0.6666666666666666,10,5,5,390.661965282721,0.7763305322128851,0.06259055346276488,0.232043793836604,131862.52170138882,3302.7343749999945,135165.25607638882,2404,16,665.8285714285714,31,4,16,33.19810682893848,0.6505376344086022,43.229166666666664,1027.0833333333328,33.13172043010751,0
2436,4,0,0,35,0.0,0.0,1.0,35,950,600,350,0.631578947368421,13,6,7,392.51182840060346,0.7759803921568627,0.06302779192050423,0.2336407277026856,131943.58555568318,3357.8836024385423,135301.46915812173,2405,17,666.8285714285714,32,3,16,33.06859612469789,0.6487630208333333,43.15025252525253,1027.3989898989907,32.10621843434346,0
2437,4,0,0,35,0.0,0.0,1.0,35,650,300,350,0.46153846153846156,10,3,7,392.5589673004277,0.7753501400560223,0.05903170312116024,0.23386858535072355,131976.01807213566,3361.673872564045,135337.6919446997,2406,18,667.8285714285714,32,3,16,33.03458056852626,0.6490885416666665,43.11868686868688,1027.5252525252538,32.11016414141418,0
2438,4,0,0,35,0.0,0.0,1.0,35,950,800,150,0.8421052631578947,11,8,3,388.68515058996974,0.7757703081232492,0.0686500140331181,0.23275381370622916,132170.69686766673,3274.5574431180735,135445.2543107848,2407,19,668.8285714285714,32,3,16,32.93733628028815,0.6510416666666665,42.92929292929294,1028.2828282828298,32.13383838383843,0
2439,4,0,0,35,0.0,0.0,1.0,35,1250,1000,250,0.8,15,10,5,394.03925546049504,0.776610644257703,0.07414757288361407,0.23697608064557762,132333.03880025004,3428.882416335076,135761.92121658512,2408,20,669.8285714285714,32,3,16,32.635650591074565,0.6526692708333333,42.77146464646465,1028.914141414142,32.15356691919194,0
2440,4,1,1,35,0.027777777777777776,0.027777777777777776,0.9722222222222222,36,750,500,250,0.6666666666666666,10,5,5,385.2867612854986,0.782936507936508,0.0644947080217404,0.23331730599894668,132592.99314164376,3017.280921589641,135610.2740632334,2409,0,652.1944444444445,32,4,17,32.598535000612976,0.6552734375,42.5189393939394,1029.9242424242427,32.185132575757585,0
2441,4,0,0,35,0.0,0.0,1.0,35,850,600,250,0.7058823529411765,11,6,5,397.3048067240607,0.7754901960784313,0.07486039577121173,0.23956479764711675,132431.5071105957,3523.1348673502603,135954.64197794595,2410,22,671.8285714285714,31,4,17,32.452166350411126,0.65625,42.67578125,1029.296875,33.203125,0
2442,4,0,0,35,0.0,0.0,1.0,35,950,600,350,0.631578947368421,13,6,7,397.69181704932964,0.7750700280112044,0.07595924561023182,0.24043936461973245,132532.04345703125,3541.381835937499,136073.42529296875,2411,23,672.8285714285714,31,4,17,32.340667678300456,0.657258064516129,42.578125,1029.6875,33.215725806451616,0
2443,4,0,0,35,0.0,0.0,1.0,35,950,800,150,0.8421052631578947,11,8,3,395.10691318404065,0.7752100840336134,0.0771502127883148,0.23926407504396602,132592.9931416439,3477.681646005532,136070.67478764945,2412,24,673.8285714285714,32,3,18,32.345684687998045,0.6552734375,42.518939393939405,1029.9242424242439,32.18513257575762,0
2444,4,0,0,35,0.0,0.0,1.0,35,950,500,450,0.5263157894736842,14,5,9,392.81707128547777,0.7746498599439775,0.0811934235638121,0.23828955275971844,132658.02158261914,3422.067104122032,136080.08868674116,2413,25,674.8285714285714,32,3,15,32.33903256117988,0.6559244791666666,42.45580808080808,1030.176767676768,32.193023989899,0
2445,4,0,0,35,0.0,0.0,1.0,35,850,500,350,0.5882352941176471,12,5,7,390.0826611484498,0.7724089635854341,0.07772352601459565,0.2374530024574792,132788.1262913223,3359.6691345270865,136147.79542584938,2414,26,675.8285714285714,32,3,15,32.27826779370329,0.6572265625,42.32954545454545,1030.681818181818,32.20880681818181,0
2446,4,0,0,35,0.0,0.0,1.0,35,500,300,200,0.6,7,3,4,388.00280047654576,0.7719887955182072,0.07368034292712822,0.2365976748238236,132853.20255905017,3309.4829290378625,136162.68548808803,2415,27,676.8285714285714,32,3,15,32.26627883241477,0.6578776041666666,42.266414141414145,1030.934343434344,32.21669823232325,0
2447,4,0,0,35,0.0,0.0,1.0,35,750,500,250,0.6666666666666666,10,5,5,386.53722497199345,0.7714985994397758,0.07448792177578745,0.23611439912836735,132918.2947690287,3275.5737616059637,136193.86853063467,2416,28,677.8285714285714,32,3,16,32.23848006203828,0.6585286458333333,42.20328282828283,1031.186868686869,32.22458964646466,0
2448,4,0,0,35,0.0,0.0,1.0,35,550,300,250,0.5454545454545454,8,3,5,385.68503312798083,0.7708683473389355,0.07714180787996439,0.2360045719567397,132983.40292125804,3257.9416322314064,136241.34455348944,2417,29,678.8285714285714,32,3,16,32.19488309462603,0.6591796875,42.140151515151516,1031.439393939394,32.23248106060606,0
2449,4,0,0,35,0.0,0.0,1.0,35,750,400,350,0.5333333333333333,11,4,7,384.49492303147525,0.7695378151260504,0.07996643591357278,0.23589283115714846,133081.0950413224,3233.8010789715518,136314.89612029397,2418,30,679.8285714285714,32,3,16,32.1272332354381,0.66015625,42.045454545454554,1031.8181818181827,32.24431818181821,0
2450,4,0,0,35,0.0,0.0,1.0,35,350,200,150,0.5714285714285714,5,2,3,384.49492303147525,0.7695378151260504,0.07996643591357278,0.23589283115714846,133081.0950413224,3233.8010789715518,136314.89612029397,2419,31,680.8285714285714,32,3,16,32.1272332354381,0.66015625,42.045454545454554,1031.8181818181827,32.24431818181821,0
2451,4,0,0,35,0.0,0.0,1.0,35,900,600,300,0.6666666666666666,12,6,6,386.1432590222968,0.76890756302521,0.08383003268602196,0.2371111086393113,133113.6670524692,3280.1890432098853,136393.85609567908,2420,32,681.8285714285714,32,3,16,32.051929116195595,0.6604817708333333,42.01388888888889,1031.944444444445,32.24826388888891,0
2452,4,0,0,35,0.0,0.0,1.0,35,850,800,50,0.9411764705882353,9,8,1,387.70697540975203,0.7701680672268907,0.08768472906403946,0.2391152070061052,133276.58689164388,3334.4524793388637,136611.03937098273,2421,33,682.8285714285714,32,3,18,31.847640009782353,0.662109375,41.856060606060616,1032.5757575757589,32.267992424242465,0
2453,4,0,0,35,0.0,0.0,1.0,35,1150,900,250,0.782608695652174,14,9,5,390.0735175275797,0.7700980392156862,0.08882913713028606,0.24142068989490595,133406.99450311193,3407.707121722272,136814.7016248342,2422,34,683.8285714285714,32,3,19,31.65536136234009,0.6634114583333334,41.72979797979798,1033.080808080808,32.28377525252525,0
2454,4,0,0,35,0.0,0.0,1.0,35,1200,1000,200,0.8333333333333334,14,10,4,390.84700368891816,0.7686974789915966,0.0896822488614355,0.24296616698566229,133570.0936926079,3441.094180440768,137011.18787304865,2423,35,684.8285714285714,32,3,19,31.47138756565287,0.6650390625,41.571969696969695,1033.712121212121,32.30350378787878,0
2455,4,0,0,35,0.0,0.0,1.0,35,850,800,50,0.9411764705882353,9,8,1,391.864290637296,0.7682773109243697,0.08887183155103506,0.24402864456492912,133635.36126734517,3473.3852094174,137108.74647676258,2424,36,685.8285714285714,32,3,19,31.379492815565587,0.6656901041666667,41.50883838383838,1033.9646464646464,32.3113952020202,0
2456,4,0,0,35,0.0,0.0,1.0,35,500,300,200,0.6,7,3,4,389.759690858592,0.7677170868347338,0.08766091051805347,0.2429324100556977,133668.00103305784,3419.679752066114,137087.68078512396,2425,37,686.8285714285714,32,3,19,31.40109890109891,0.666015625,41.47727272727273,1034.090909090909,32.31534090909091,0
2457,4,0,0,35,0.0,0.0,1.0,35,1000,600,400,0.6,14,6,8,391.0995000225212,0.7674369747899159,0.09334611697027784,0.24484800631662043,133831.25964506174,3468.2677469135774,137299.5273919753,2426,38,687.8285714285714,32,3,17,31.20246085011184,0.6676432291666667,41.31944444444444,1034.7222222222224,32.33506944444445,0
2458,4,0,0,35,0.0,0.0,1.0,35,800,600,200,0.75,10,6,4,391.06730284449907,0.7669467787114845,0.09684592060781427,0.2454800726431241,133929.26263901635,3475.0711024385246,137404.33374145487,2427,39,688.8285714285714,32,3,17,31.10489346995203,0.6686197916666667,41.224747474747474,1035.1010101010095,32.346906565656546,0
2459,4,0,0,35,0.0,0.0,1.0,35,900,500,400,0.5555555555555556,13,5,8,393.29292754801133,0.7657563025210083,0.09792236289859102,0.24797708567842727,134092.68067352832,3547.5405889705244,137640.22126249885,2428,40,689.8285714285714,32,3,18,30.883264252915595,0.6702473958333333,41.0669191919192,1035.732323232324,32.366635101010125,0
2460,4,1,1,35,0.027777777777777776,0.027777777777777776,0.9722222222222222,36,600,400,200,0.6666666666666666,8,4,4,381.8238684621002,0.7732473544973546,0.08609699738732002,0.2431433708649176,134455.43968966266,3067.6592236159204,137523.09891327858,2429,0,671.6388888888889,33,3,18,30.816864587025872,0.6714015151515151,40.716911764705884,1037.1323529411766,31.428253119429595,0
2461,4,0,0,35,0.0,0.0,1.0,35,750,400,350,0.5333333333333333,11,4,7,391.2235406159566,0.7631652661064425,0.09714703221766041,0.24866313587757255,134387.0842260995,3515.0781807978956,137902.1624068974,2430,42,691.8285714285714,32,3,18,30.64164231206364,0.6731770833333333,40.78282828282829,1036.868686868688,32.4021464646465,0
2462,4,0,0,35,0.0,0.0,1.0,35,850,600,250,0.7058823529411765,11,6,5,395.4220705034185,0.7637254901960784,0.10493809987480884,0.25223507230249115,134518.03387409443,3638.2798949086778,138156.3137690031,2431,43,692.8285714285714,32,3,18,30.401553878610837,0.6744791666666667,40.656565656565654,1037.373737373737,32.41792929292928,0
2463,4,0,0,35,0.0,0.0,1.0,35,700,500,200,0.7142857142857143,9,5,4,395.4220705034185,0.7637254901960784,0.10493809987480884,0.25223507230249115,134518.03387409443,3638.2798949086778,138156.3137690031,2432,44,693.8285714285714,32,3,18,30.401553878610837,0.6744791666666667,40.656565656565654,1037.373737373737,32.41792929292928,0
2464,4,0,0,35,0.0,0.0,1.0,35,900,500,400,0.5555555555555556,13,5,8,395.9613554620088,0.7628151260504201,0.10808950086058533,0.2528060961795902,134550.78125,3655.381944444445,138206.16319444444,2433,45,694.8285714285714,32,3,18,30.354752342704145,0.6748046875,40.625,1037.5,32.421875,0
2465,4,0,0,35,0.0,0.0,1.0,35,900,600,300,0.6666666666666666,12,6,6,399.2658333042324,0.7626050420168067,0.11071906557975408,0.25537477695933736,134616.28795849907,3749.536877614526,138365.8248361136,2434,46,695.8285714285714,32,3,18,30.20339051790567,0.6754557291666667,40.561868686868685,1037.752525252525,32.429766414141405,0
2466,4,0,1,34,0.0,0.02857142857142857,0.9714285714285714,35,600,200,400,0.3333333333333333,10,2,8,399.626448777175,0.7611344537815126,0.11013606269657883,0.25606617579089275,134681.810609249,3764.4827377308366,138446.29334697983,2435,47,696.8285714285714,32,3,18,30.128380570084744,0.6761067708333334,40.49873737373737,1038.00505050505,32.43765782828281,0
2467,4,0,0,34,0.0,0.0,1.0,34,600,300,300,0.5,9,3,6,404.2250081797296,0.7631833036244802,0.1097417017728961,0.25928286325156735,134719.69816419802,4091.4142184787233,138811.11238267674,2436,48,700.5882352941177,31,3,19,29.97107425059577,0.6790994623655915,40.46223958333333,1038.1510416666658,33.48874327956987,0
2468,4,0,0,34,0.0,0.0,1.0,34,450,300,150,0.6666666666666666,6,3,3,403.6538615058761,0.7628490790255497,0.11097094970418575,0.25915747919870014,134753.4942626953,4078.7536621093755,138832.2479248047,2437,49,701.5882352941177,31,3,20,29.95203160270881,0.6794354838709677,40.4296875,1038.28125,33.492943548387096,0
2469,4,0,0,34,0.0,0.0,1.0,34,1100,700,400,0.6363636363636364,15,7,8,403.6538615058761,0.7628490790255497,0.11097094970418575,0.25915747919870014,134753.4942626953,4078.7536621093755,138832.2479248047,2438,50,702.5882352941177,31,3,20,29.95203160270881,0.6794354838709677,40.4296875,1038.28125,33.492943548387096,0
2470,4,0,0,34,0.0,0.0,1.0,34,1300,700,600,0.5384615384615384,19,7,12,403.76897995893376,0.7631833036244802,0.1136645229807065,0.2597146277542304,134821.0991753473,4087.31553819445,138908.41471354174,2439,51,703.5882352941177,31,3,17,29.881310598462047,0.6801075268817204,40.364583333333336,1038.5416666666672,33.501344086021525,0
2471,4,0,0,34,0.0,0.0,1.0,34,1050,800,250,0.7619047619047619,13,8,5,404.18528138808273,0.76232917409388,0.11687665415834192,0.26071094261887734,134922.53833346904,4106.740824381517,139029.27915785057,2440,52,704.5882352941177,31,3,18,29.7688985670719,0.6811155913978495,40.266927083333336,1038.9322916666672,33.513944892473134,0
2472,4,0,0,34,0.0,0.0,1.0,34,750,400,350,0.5333333333333333,11,4,7,405.80387316003794,0.7620320855614974,0.11815193437354865,0.2622445920396976,134990.18563164613,4155.908033582909,139146.09366522904,2441,53,705.5882352941177,31,3,18,29.659112266633247,0.6817876344086021,40.20182291666667,1039.1927083333342,33.522345430107556,0
2473,4,0,0,34,0.0,0.0,1.0,34,750,400,350,0.5333333333333333,11,4,7,402.849787751856,0.7622920380273321,0.11947424260285255,0.26106758972490446,135091.68836805565,4084.331597222232,139176.01996527787,2442,54,706.5882352941177,31,3,18,29.634268537074153,0.6827956989247311,40.10416666666667,1039.5833333333342,33.534946236559165,0
2474,4,0,0,34,0.0,0.0,1.0,34,900,700,200,0.7777777777777778,11,7,4,402.4877578458982,0.7624777183600714,0.12070057829017644,0.2610775586027214,135125.53109063057,4077.2744072808364,139202.8054979114,2443,55,707.5882352941177,31,3,19,29.609815278647467,0.6831317204301075,40.07161458333334,1039.7135416666679,33.53914650537639,0
2475,4,0,0,34,0.0,0.0,1.0,34,750,500,250,0.6666666666666666,10,5,5,406.2277612789741,0.7615121806298277,0.12338800550895157,0.26399846455127496,135193.22925143785,4183.848571777355,139377.0778232152,2444,56,708.5882352941177,31,3,19,29.44485309461206,0.6838037634408602,40.00651041666667,1039.9739583333344,33.54754704301079,0
2476,4,0,0,34,0.0,0.0,1.0,34,1000,700,300,0.7,13,7,6,407.7598621266901,0.7621434937611409,0.12602727620843002,0.26524314158534223,135227.0846896702,4228.035481770839,139455.12017144106,2445,57,709.5882352941177,31,3,19,29.371140043398427,0.6841397849462365,39.973958333333336,1040.1041666666672,33.551747311827974,0
2477,4,0,0,34,0.0,0.0,1.0,34,600,400,200,0.6666666666666666,8,4,4,408.12009744224696,0.7609180035650625,0.13064329723880586,0.2662275672376321,135328.6764356824,4246.070522732194,139574.7469584146,2446,58,710.5882352941177,31,3,19,29.26013118925458,0.6851478494623656,39.87630208333333,1040.4947916666658,33.56434811827954,0
2478,4,0,0,34,0.0,0.0,1.0,34,950,800,150,0.8421052631578947,11,8,3,416.083241118753,0.7605837789661319,0.13487189329239047,0.26589954679032396,134584.5561557345,4400.018988715259,138984.57514444974,2447,59,711.5882352941177,31,3,20,29.798934412515152,0.677755376344086,40.59244791666666,1037.6302083333323,33.471942204301044,1
2479,4,0,1,33,0.0,0.029411764705882353,0.9705882352941176,34,1000,500,500,0.5,15,5,10,416.06485720594094,0.7595811051693405,0.1342197691921727,0.2666293441837426,134685.90630425335,4407.61447482637,139093.52077907973,2448,60,712.5882352941177,31,3,20,29.69769192172603,0.6787634408602152,40.49479166666666,1038.0208333333323,33.48454301075266,0
2480,4,0,0,33,0.0,0.0,1.0,33,800,700,100,0.875,9,7,2,396.1755445016739,0.7549715909090909,0.1278738532624546,0.22971380284195783,130940.15438475672,3775.057392102855,134715.21177685956,2449,61,729.1212121212121,32,1,15,33.99179620034543,0.638671875,44.12878787878788,1023.484848484849,31.98390151515153,8
2481,4,0,0,33,0.0,0.0,1.0,33,700,400,300,0.5714285714285714,10,4,6,399.2330188818772,0.7535511363636365,0.1353493011734903,0.2324608051795338,131101.73906042747,3868.028613151711,134969.7676735792,2450,62,730.1212121212121,32,1,16,33.749434923766074,0.6402994791666667,43.97095959595959,1024.1161616161612,32.00363005050504,0
2482,4,0,0,33,0.0,0.0,1.0,33,750,600,150,0.8,9,6,3,402.16834902065636,0.753314393939394,0.13296280940802085,0.23456447272498815,131166.40082963475,3950.1949737271734,135116.5958033619,2451,63,731.1212121212121,32,1,16,33.60861169316734,0.6409505208333334,43.907828282828284,1024.368686868687,32.01152146464647,0
2483,4,0,0,33,0.0,0.0,1.0,33,850,500,350,0.5882352941176471,12,5,7,403.93647693452385,0.7531565656565657,0.14254148629148622,0.22620442708333327,129586.77685950411,3868.9652203856717,133455.74207988978,2452,64,732.1212121212121,32,1,15,35.17252604166667,0.625,45.45454545454545,1018.181818181818,31.818181818181813,2
2484,4,0,0,33,0.0,0.0,1.0,33,600,500,100,0.8333333333333334,7,5,2,406.6662231885315,0.7518150252525253,0.15071503431488598,0.22829341840374948,129683.21352731853,3947.5565312212893,133630.7700585398,2453,65,733.1212121212121,32,1,15,35.00449361596628,0.6259765625,45.35984848484848,1018.5606060606051,31.83001893939391,0
2485,4,0,0,33,0.0,0.0,1.0,33,750,500,250,0.6666666666666666,10,5,5,406.87043637645013,0.7529987373737375,0.14979889363332166,0.22878310460777534,129747.52456700846,3958.0863878685805,133705.61095487705,2454,66,734.1212121212121,32,1,15,34.93359358863138,0.6266276041666667,45.29671717171717,1018.8131313131312,31.83791035353535,0
2486,4,0,0,33,0.0,0.0,1.0,33,850,500,350,0.5882352941176471,12,5,7,406.36393882621564,0.7524463383838385,0.15334362081977027,0.22887392535006176,129811.85154894902,3950.1710603509755,133762.0226093,2455,67,735.1212121212121,32,1,17,34.880797505472266,0.6272786458333334,45.233585858585855,1019.065656565656,31.84580176767675,0
2487,4,1,1,33,0.029411764705882353,0.029411764705882353,0.9705882352941176,34,800,500,300,0.625,11,5,6,400.07215579542617,0.762106357694593,0.14777264985052074,0.22667124252452886,130043.75007509121,3605.376688052661,133649.12676314387,2456,0,714.4705882352941,33,1,17,34.80453262044936,0.627209595959596,45.00612745098039,1019.9754901960777,30.90834818775993,0
2488,4,2,1,34,0.05714285714285714,0.02857142857142857,0.9714285714285714,35,800,700,100,0.875,9,7,2,390.6587608025926,0.7758403361344537,0.14273369453398277,0.22294306815117812,130325.1453767781,3182.715932574002,133507.8613093521,2457,0,695.0,33,2,19,34.75806128980637,0.630050505050505,44.73039215686274,1021.0784313725485,30.941770647652984,0
2489,4,1,1,34,0.02857142857142857,0.02857142857142857,0.9714285714285714,35,800,500,300,0.625,11,5,6,389.56705359587954,0.7736694677871148,0.14237381095209534,0.22285802276744374,130419.01139285363,3161.3900002402816,133580.40139309393,2458,0,695.9714285714285,33,2,19,34.69043691261747,0.6309974747474747,44.63848039215686,1021.4460784313719,30.95291146761733,0
2490,4,4,3,35,0.10526315789473684,0.07894736842105263,0.9210526315789473,38,750,400,350,0.5333333333333333,11,4,7,370.5454025668015,0.8011201991465149,0.14167007927436748,0.2172067026210163,131358.63272392293,2141.1826679201085,133499.81539184303,2459,0,641.921052631579,34,4,18,34.22390934076567,0.6381740196078431,43.720238095238095,1025.1190476190477,30.150560224089638,0
2491,4,0,0,35,0.0,0.0,1.0,35,900,500,400,0.5555555555555556,13,5,8,394.96011692429647,0.7754901960784313,0.16267104542966604,0.2290768678160918,130951.55709342551,3344.1284602075966,134295.6855536331,2460,1,697.8857142857142,33,2,18,34.0113146551724,0.6363636363636365,44.11764705882352,1023.5294117647052,31.01604278074864,0
2492,4,0,0,35,0.0,0.0,1.0,35,950,700,250,0.7368421052631579,12,7,5,394.138723634397,0.7757002801120447,0.16043189368770783,0.2290265556253929,131023.24263038552,3328.266723356015,134351.50935374154,2461,2,698.8857142857142,34,1,18,33.95954457364341,0.6348039215686274,44.04761904761905,1023.809523809524,30.112044817927174,0
2493,4,0,0,35,0.0,0.0,1.0,35,1500,1100,400,0.7333333333333333,19,11,8,395.7811679461315,0.7760504201680671,0.16184280403611306,0.2314459438641505,131267.12018140568,3390.6108276643718,134657.73100907006,2462,3,699.8857142857142,34,1,19,33.66998722118957,0.6372549019607844,43.809523809523796,1024.761904761903,30.140056022408913,0
2494,4,0,0,35,0.0,0.0,1.0,35,1250,800,450,0.64,17,8,9,391.79982011834323,0.7747899159663865,0.16037274725274742,0.23084652200591285,131554.70623214464,3308.6503921663502,134863.35662431098,2463,4,700.8857142857142,32,3,17,33.480512820512814,0.6448567708333334,43.5290404040404,1025.883838383838,32.05886994949494,0
2495,4,1,1,35,0.027777777777777776,0.027777777777777776,0.9722222222222222,36,750,400,350,0.5333333333333333,11,4,7,379.3752858396443,0.7832671957671958,0.1504745618918848,0.22552649970977998,131893.9905925605,2807.464076316795,134701.4546688773,2464,0,682.3888888888889,33,3,17,33.45611628091943,0.6458333333333334,43.1985294117647,1027.2058823529408,31.127450980392144,0
2496,4,0,0,35,0.0,0.0,1.0,35,900,800,100,0.8888888888888888,10,8,2,387.93956776230726,0.7713585434173669,0.1544185066132686,0.23013220310801205,131813.89534550055,3227.1651170799,135041.06046258044,2465,6,702.8857142857142,32,3,17,33.31719537685972,0.6474609375,43.276515151515156,1026.89393939394,32.09043560606062,0
2497,4,0,0,35,0.0,0.0,1.0,35,900,800,100,0.8888888888888888,10,8,2,391.46729057352456,0.7705882352941176,0.14624947324062365,0.2328200201832013,131911.15702479336,3327.780647382917,135238.93767217628,2466,7,703.8857142857142,32,3,17,33.128226401179944,0.6484375,43.18181818181818,1027.272727272727,32.10227272727272,0
2498,4,0,0,35,0.0,0.0,1.0,35,900,700,200,0.7777777777777778,11,7,4,390.0718316429056,0.7710084033613445,0.1502913018295804,0.232655930309915,132019.90370290267,3299.449130142243,135319.35283304492,2467,8,704.8857142857142,33,2,17,33.05409810000794,0.6470959595959596,43.07598039215686,1027.696078431372,31.14230540701127,0
2499,4,0,0,35,0.0,0.0,1.0,35,650,300,350,0.46153846153846156,10,3,7,390.0718316429056,0.7710084033613445,0.1502913018295804,0.232655930309915,132019.90370290267,3299.449130142243,135319.35283304492,2468,9,705.8857142857142,33,2,17,33.05409810000794,0.6470959595959596,43.07598039215686,1027.696078431372,31.14230540701127,0
2500,4,0,0,35,0.0,0.0,1.0,35,1000,700,300,0.7,13,7,6,390.2593549974541,0.7698179271708683,0.1446692553988691,0.23315494798565856,132082.88278546714,3309.316128412151,135392.19891387929,2469,10,706.8857142857142,33,2,17,32.98561436973455,0.6477272727272727,43.01470588235294,1027.9411764705883,31.149732620320858,0
2501,4,0,0,35,0.0,0.0,1.0,35,950,600,350,0.631578947368421,13,6,7,389.5295896677667,0.7683473389355742,0.13551681873893529,0.23349516546370686,132208.8860053824,3299.8546232218205,135508.74062860422,2470,11,707.8857142857142,33,2,17,32.87704559898315,0.6489898989898991,42.89215686274509,1028.4313725490185,31.164587046939957,0
2502,4,1,1,35,0.027777777777777776,0.027777777777777776,0.9722222222222222,36,800,600,200,0.75,10,6,4,378.42290249433125,0.7794973544973546,0.12535714285714294,0.22835864805692388,132461.07266435976,2825.3958813917593,135286.46854575153,2471,0,689.1944444444445,33,3,17,32.908234126984134,0.6515151515151516,42.647058823529406,1029.4117647058815,31.19429590017823,0
2503,4,0,0,35,0.0,0.0,1.0,35,1150,900,250,0.782608695652174,14,9,5,380.74498490648296,0.7662464985994397,0.12987260388141442,0.2295676330387329,132429.5361910082,3084.3763516435874,135513.9125426518,2472,13,709.8857142857142,33,2,17,32.88027840615944,0.651199494949495,42.67769607843137,1029.289215686274,31.190582293523455,0
2504,4,1,1,35,0.027777777777777776,0.027777777777777776,0.9722222222222222,36,1050,700,350,0.6666666666666666,14,7,7,370.08336765279756,0.7754298941798943,0.11673406725080504,0.2247259303441474,132695.96220207462,2621.7137131344134,135317.67591520902,2473,0,691.1388888888889,35,1,16,32.886336403804385,0.6494047619047618,42.418981481481474,1030.324074074073,29.437830687830658,0
2505,4,0,0,35,0.0,0.0,1.0,35,700,500,200,0.7142857142857143,9,5,4,378.64063802093773,0.7666666666666666,0.13184272668725328,0.22922464377320703,132581.847009637,3040.175028344643,135622.02203798163,2474,15,711.8857142857142,34,1,18,32.78089238238352,0.6504289215686276,42.52976190476189,1029.8809523809507,30.29061624649855,0
2506,4,0,0,35,0.0,0.0,1.0,35,700,400,300,0.5714285714285714,10,4,6,379.27524743467455,0.7666666666666666,0.1312179095606809,0.22998379229518115,132643.1565334466,3061.653202947831,135704.80973639444,2475,16,712.8857142857142,34,1,16,32.702771678415964,0.6510416666666667,42.47023809523809,1030.1190476190466,30.297619047619015,0
2507,4,0,0,35,0.0,0.0,1.0,35,850,500,350,0.5882352941176471,12,5,7,379.11965028551003,0.7670868347338935,0.13020016831960968,0.23064222154052408,132765.8180980724,3066.826105442159,135832.64420351456,2476,17,713.8857142857142,34,1,16,32.583217819876005,0.6522671568627452,42.35119047619047,1030.595238095237,30.31162464985991,0
2508,4,1,1,35,0.027777777777777776,0.027777777777777776,0.9722222222222222,36,950,700,250,0.7368421052631579,12,7,5,369.73434317032,0.7701388888888889,0.11278687299095469,0.22739937050985592,133173.3927576302,2647.755379801084,135821.1481374313,2477,0,695.0277777777778,35,1,16,32.41524631830754,0.6541666666666668,41.95601851851851,1032.1759259259252,29.49074074074072,0
2509,4,0,0,35,0.0,0.0,1.0,35,1150,900,250,0.782608695652174,14,9,5,376.9045442995707,0.7626050420168067,0.11253913330037912,0.23175619851611903,133164.85969387754,3038.08815192744,136202.94784580497,2478,19,715.8857142857142,34,1,16,32.238802383698584,0.65625,41.964285714285715,1032.142857142857,30.357142857142858,0
2510,4,0,0,35,0.0,0.0,1.0,35,800,600,200,0.75,10,6,4,376.06601452518413,0.7623249299719888,0.11269090729360576,0.23143139900268778,133195.58000283438,3018.0661848072436,136213.64618764163,2479,20,716.8857142857142,34,1,16,32.229558297774176,0.6565563725490196,41.9345238095238,1032.2619047619041,30.36064425770306,0
2511,4,0,0,35,0.0,0.0,1.0,35,1100,800,300,0.7272727272727273,14,8,6,375.22444335556327,0.7612745098039215,0.10983944009880586,0.23167772570174444,133318.496669501,3004.871740362796,136323.3684098638,2480,21,717.8857142857142,34,1,17,32.12776176753121,0.6577818627450981,41.81547619047618,1032.7380952380943,30.37464985994395,0
2512,4,0,0,35,0.0,0.0,1.0,35,1000,500,500,0.5,15,5,10,384.2086033913301,0.7616946778711484,0.09735130111524204,0.22467850937449485,131267.12018140565,3092.4603174602908,134359.58049886595,2481,22,718.8857142857142,34,1,15,33.966465303593566,0.6372549019607844,43.809523809523796,1024.7619047619028,30.140056022408906,5
2513,4,0,0,35,0.0,0.0,1.0,35,700,600,100,0.8571428571428571,8,6,2,385.3526340141453,0.7620448179271708,0.09965156794425112,0.22570654277971341,131328.12499999988,3121.5277777777637,134449.65277777764,2482,23,719.8857142857142,34,1,15,33.87533875338753,0.6378676470588236,43.74999999999999,1024.999999999999,30.147058823529385,0
2514,4,0,0,35,0.0,0.0,1.0,35,800,500,300,0.625,11,5,6,384.186600171259,0.7621848739495798,0.09799140833623654,0.22556231678766525,131419.65880102024,3097.9343820861523,134517.5931831064,2483,24,720.8857142857142,34,1,15,33.81250241882426,0.6387867647058825,43.66071428571428,1025.3571428571415,30.157563025210045,0
2515,4,1,1,35,0.027777777777777776,0.027777777777777776,0.9722222222222222,36,650,600,50,0.9230769230769231,7,6,1,376.0254749684922,0.775628306878307,0.09345826597997609,0.22213310370057412,131654.57182623874,2701.0945805469664,134355.6664067857,2484,0,701.8333333333334,35,1,14,33.78409176346753,0.6389880952380953,43.431712962962955,1026.2731481481471,29.322089947089918,0
2516,4,0,0,35,0.0,0.0,1.0,35,1000,800,200,0.8,12,8,4,380.9378312357368,0.7616246498599439,0.0953706926557607,0.22472985403290974,131602.8220663264,3026.4987244897757,134629.32079081616,2485,26,722.8857142857142,34,1,14,33.710407239819006,0.640625,43.48214285714285,1026.0714285714273,30.17857142857139,0
2517,4,0,0,35,0.0,0.0,1.0,35,900,500,400,0.5555555555555556,13,5,8,382.8645774003819,0.7600140056022409,0.09390215627173704,0.22713822865582475,131816.67375283435,3093.58701814058,134910.26077097494,2486,27,723.8857142857142,34,1,15,33.44467308138188,0.6427696078431373,43.27380952380952,1026.904761904761,30.20308123249297,0
2518,4,0,0,35,0.0,0.0,1.0,35,550,300,250,0.5454545454545454,8,3,5,385.3946659971078,0.7589635854341736,0.0945538818076479,0.2293762736244856,131938.9526643991,3169.7137188208626,135108.66638321997,2487,28,724.8857142857142,34,1,15,33.25608342989571,0.6439950980392157,43.154761904761905,1027.3809523809525,30.217086834733898,0
2519,4,0,0,35,0.0,0.0,1.0,35,1050,700,350,0.6666666666666666,14,7,7,385.77029576204455,0.7582633053221288,0.09888837424733676,0.23071414641281296,132122.47732426316,3193.785430839014,135316.2627551022,2488,29,725.8857142857142,34,1,15,33.060975374401735,0.6458333333333333,42.97619047619048,1028.095238095239,30.238095238095266,0
2520,4,0,0,35,0.0,0.0,1.0,35,1050,900,150,0.8571428571428571,12,9,3,382.7533761154117,0.7571428571428571,0.09330863625839325,0.22928042044971764,132183.68055555562,3118.7500000000095,135302.43055555562,2489,30,726.8857142857142,34,1,15,33.07671528903296,0.6464460784313726,42.91666666666667,1028.333333333334,30.245098039215705,0
2521,4,0,0,35,0.0,0.0,1.0,35,1300,1100,200,0.8461538461538461,15,11,4,381.0134280692729,0.757563025210084,0.0972222222222221,0.22860805684156382,132244.89795918373,3077.416383219963,135322.3143424037,2490,31,727.8857142857142,34,1,15,33.05965470679013,0.6470588235294117,42.85714285714286,1028.5714285714291,30.25210084033615,0
2522,4,0,0,35,0.0,0.0,1.0,35,600,400,200,0.6666666666666666,8,4,4,382.5169683897109,0.7585434173669467,0.09905114556815575,0.2298825897652215,132306.12953514757,3121.8679138322213,135427.9974489798,2491,32,728.8857142857142,34,1,16,32.959191545167016,0.6476715686274509,42.79761904761906,1028.8095238095252,30.259103641456623,0
2523,4,0,0,35,0.0,0.0,1.0,35,900,600,300,0.6666666666666666,12,6,6,383.05823730924914,0.7578431372549019,0.08860613071139367,0.23076923076923087,132398.0034722224,3143.229166666685,135541.23263888908,2492,33,729.8857142857142,34,1,16,32.852564102564095,0.6485906862745097,42.70833333333334,1029.166666666668,30.269607843137297,0
2524,4,0,0,35,0.0,0.0,1.0,35,350,100,250,0.2857142857142857,6,1,5,383.05823730924914,0.7578431372549019,0.08860613071139367,0.23076923076923087,132398.0034722224,3143.229166666685,135541.23263888908,2493,34,730.8857142857142,34,1,16,32.852564102564095,0.6485906862745097,42.70833333333334,1029.166666666668,30.269607843137297,0
2525,4,0,0,35,0.0,0.0,1.0,35,1050,800,250,0.7619047619047619,13,8,5,383.8784926753077,0.7576330532212885,0.0857704311640275,0.2323955801353458,132581.8470096374,3179.0639172335896,135760.91092687097,2494,35,731.8857142857142,34,1,16,32.64603321388665,0.6504289215686272,42.52976190476192,1029.880952380954,30.29061624649865,0
2526,4,0,0,35,0.0,0.0,1.0,35,400,200,200,0.5,6,2,4,384.8540547334022,0.7570728291316526,0.08668515950069344,0.23317628022082637,132612.50000000023,3207.291666666695,135819.79166666692,2495,36,732.8857142857142,34,1,16,32.5900080906149,0.650735294117647,42.500000000000014,1030.0000000000018,30.294117647058876,0
2527,4,0,0,35,0.0,0.0,1.0,35,650,400,250,0.6153846153846154,9,4,5,389.6365625032029,0.7560224089635854,0.08179297597042501,0.23684649473509317,132735.14739229032,3343.693310657607,136078.84070294793,2496,37,733.8857142857142,34,1,15,32.34317236598892,0.6519607843137254,42.38095238095239,1030.4761904761913,30.308123249299744,0
2528,4,0,0,35,0.0,0.0,1.0,35,850,600,250,0.7058823529411765,11,6,5,386.8265531454368,0.7552521008403361,0.08499826769834895,0.23571647598074172,132827.17013888905,3276.2152777778024,136103.38541666686,2497,38,734.8857142857142,34,1,15,32.32282403664781,0.6528799019607842,42.29166666666668,1030.8333333333346,30.31862745098043,0
2529,4,0,0,35,0.0,0.0,1.0,35,250,200,50,0.8,3,2,1,390.8951899100154,0.7558823529411764,0.08728784205057116,0.2385865567167474,132888.5363520409,3389.09793083901,136277.6342828799,2498,39,735.8857142857142,34,1,15,32.15612131008735,0.6534926470588235,42.23214285714286,1031.0714285714294,30.325630252100865,0
2530,4,0,0,35,0.0,0.0,1.0,35,950,600,350,0.631578947368421,13,6,7,388.59628873661524,0.7546918767507003,0.08056325023084021,0.23776823768460703,132980.612244898,3335.1544784580556,136315.76672335604,2499,40,736.8857142857142,34,1,15,32.122624269005854,0.6544117647058822,42.142857142857146,1031.4285714285718,30.336134453781522,0
2531,4,0,0,35,0.0,0.0,1.0,35,800,500,300,0.625,11,5,6,388.322402332179,0.7544117647058823,0.07731363951073189,0.23799165053823645,133042.0138888889,3332.6388888888937,136374.6527777778,2500,41,737.8857142857142,34,1,15,32.06785137318257,0.6550245098039216,42.083333333333336,1031.6666666666667,30.34313725490196,0
2532,4,0,0,35,0.0,0.0,1.0,35,1000,600,400,0.6,14,6,8,390.1281108699803,0.7550420168067227,0.07545863620629989,0.23929514061642745,133072.7200255102,3383.081774376421,136455.80179988663,2501,42,738.8857142857142,34,1,15,31.99035614014846,0.6553308823529411,42.05357142857143,1031.7857142857144,30.34663865546219,0
2533,4,0,0,35,0.0,0.0,1.0,35,950,600,350,0.631578947368421,13,6,7,390.2677836179588,0.7545518207282913,0.07750865051903122,0.2399731690757238,133164.8596938777,3393.9909297052313,136558.85062358293,2502,43,739.8857142857142,34,1,16,31.893983083429458,0.65625,41.96428571428572,1032.1428571428582,30.35714285714289,0
2534,4,0,0,35,0.0,0.0,1.0,35,1350,1100,250,0.8148148148148148,16,11,5,390.81943546502714,0.7514005602240896,0.07420209701578528,0.24210720059964075,133441.47002551003,3430.303996598621,136871.77402210864,2503,44,740.8857142857142,34,1,16,31.601422974997114,0.6590073529411765,41.69642857142856,1033.2142857142844,30.388655462184836,0
2535,4,0,0,35,0.0,0.0,1.0,35,850,400,450,0.47058823529411764,13,4,9,391.9346147435259,0.7499299719887955,0.07370724404007811,0.24360545882734663,133564.5000708615,3469.7101757369405,137034.21024659846,2504,45,741.8857142857142,34,1,17,31.448903988636783,0.660232843137255,41.57738095238094,1033.690476190475,30.402661064425736,0
2536,4,0,0,35,0.0,0.0,1.0,35,600,400,200,0.6666666666666666,8,4,4,390.6476567935043,0.7499299719887955,0.07392055267702946,0.24320967019724596,133626.03635204065,3440.1395975056475,137066.1759495463,2505,46,742.8857142857142,34,1,17,31.42031279984647,0.6608455882352943,41.51785714285713,1033.92857142857,30.409663865546175,0
2537,4,1,1,35,0.027777777777777776,0.027777777777777776,0.9722222222222222,36,550,400,150,0.7272727272727273,7,4,3,382.44813102724504,0.7548280423280423,0.07053337310020025,0.23962640080690908,133861.20119866662,3038.9932430983945,136900.19444176502,2506,0,723.2222222222222,35,1,15,31.396213137978595,0.6610119047619047,41.290509259259245,1034.8379629629612,29.566798941798893,0
2538,4,0,0,35,0.0,0.0,1.0,35,700,600,100,0.8571428571428571,8,6,2,388.86186148833394,0.7488095238095237,0.09517209517209513,0.23676272832390982,132796.49234693887,3327.898242630396,136124.39058956926,2507,48,744.8857142857142,34,1,16,32.30129167629168,0.6525735294117647,42.32142857142858,1030.7142857142865,30.31512605042019,2
2539,4,0,0,35,0.0,0.0,1.0,35,900,700,200,0.7777777777777778,11,7,4,389.3561755622996,0.7502100840336134,0.091916859122402,0.23745242819503637,132857.85147392296,3345.80498866214,136203.6564625851,2508,49,745.8857142857142,34,1,16,32.22671285604311,0.6531862745098038,42.261904761904766,1030.9523809523814,30.32212885154063,0
2540,4,0,0,35,0.0,0.0,1.0,35,800,400,400,0.5,12,4,8,391.0041376556781,0.7488095238095237,0.09280849590211271,0.2390450842985985,132949.91673752837,3396.7935090703013,136346.71024659867,2509,50,746.8857142857142,34,1,16,32.09146177228829,0.6541053921568627,42.17261904761905,1031.309523809524,30.332633053221297,0
2541,4,0,0,35,0.0,0.0,1.0,35,1000,700,300,0.7,13,7,6,394.69432766311706,0.7478991596638654,0.09461174570208808,0.24209594747744065,133072.72002551024,3504.6095521541984,136577.32957766444,2510,51,747.8857142857142,34,1,18,31.8725722087612,0.6553308823529411,42.05357142857143,1031.7857142857147,30.346638655462197,0
2542,4,0,0,35,0.0,0.0,1.0,35,700,600,100,0.8571428571428571,8,6,2,380.2988198851629,0.7478991596638654,0.03620749680863433,0.2239941853007824,131541.75347222213,3005.0347222222176,134546.78819444435,2511,52,748.8857142857142,34,1,16,33.78858651502844,0.6400122549019608,43.541666666666664,1025.8333333333328,30.171568627450966,3
2543,4,0,0,35,0.0,0.0,1.0,35,1000,800,200,0.8,12,8,4,381.49294788982866,0.7466386554621848,0.03224309904894507,0.22559891609781207,131694.45153061216,3048.10090702947,134742.55243764163,2512,53,749.8857142857142,34,1,14,33.603475605041375,0.6415441176470589,43.39285714285714,1026.4285714285706,30.189075630252077,0
2544,4,0,0,35,0.0,0.0,1.0,35,1100,900,200,0.8181818181818182,13,9,4,379.6546943919343,0.7462184873949579,0.0394202898550724,0.22505304049006428,131786.1128826531,3006.64328231293,134792.75616496603,2513,54,750.8857142857142,34,1,15,33.55797101449274,0.6424632352941178,43.30357142857143,1026.7857142857147,30.199579831932784,0
2545,4,0,0,35,0.0,0.0,1.0,35,900,600,300,0.6666666666666666,12,6,6,380.69387998106026,0.745798319327731,0.03732035234121467,0.22621396669948954,131877.806122449,3041.0147392290273,134918.82086167802,2514,55,751.8857142857142,34,1,15,33.43861072477206,0.6433823529411764,43.214285714285715,1027.1428571428573,30.21008403361345,0
2546,4,1,1,35,0.027777777777777776,0.027777777777777776,0.9722222222222222,36,850,600,250,0.7058823529411765,11,6,5,375.29438249691617,0.7569775132275133,0.06254832946697597,0.21452012234083007,130387.71896626313,2605.9166926574753,132993.6356589206,2515,0,731.9722222222222,33,3,18,35.08669306455484,0.6306818181818181,44.66911764705883,1021.323529411766,30.949197860962606,5
2547,4,1,1,35,0.027777777777777776,0.027777777777777776,0.9722222222222222,36,1150,900,250,0.782608695652174,14,9,5,373.49141966467926,0.7658068783068783,0.057683597756730265,0.21469965068387947,130606.8447982748,2556.1071763264245,133162.95197460122,2516,0,726.6111111111111,33,3,17,34.910257563042,0.6328914141414141,44.454656862745104,1022.1813725490205,30.975193107546076,0
2548,4,1,0,36,0.027777777777777776,0.0,1.0,36,600,500,100,0.8333333333333334,7,5,2,372.4747184581683,0.7636574074074075,0.06366517524235649,0.21463598417230367,130700.8121876202,2536.5496443675593,133237.36183198777,2517,0,727.5833333333334,33,3,18,34.84090364333653,0.6338383838383839,44.36274509803922,1022.5490196078437,30.986333927510415,0
2549,4,0,0,36,0.0,0.0,1.0,36,1150,1000,150,0.8695652173913043,13,10,3,372.4955358743591,0.763425925925926,0.06339986693280153,0.21569609740297493,130888.84833958092,2551.1023404459847,133439.9506800269,2518,1,728.5833333333334,33,3,18,34.6497005988024,0.6357323232323233,44.17892156862745,1023.2843137254902,31.008615567439097,0
2550,4,1,0,37,0.02702702702702703,0.0,1.0,37,650,500,150,0.7692307692307693,8,5,3,365.0466044598612,0.7705205205205206,0.058388429103130246,0.2129644767035325,131175.6395266439,2177.044359410421,133352.68388605432,2519,0,709.8648648648649,34,3,19,34.54992252566337,0.6363357843137255,43.89880952380952,1024.4047619047612,30.12955182072827,0
2551,4,0,2,35,0.0,0.05405405405405406,0.9459459459459459,37,1300,1000,300,0.7692307692307693,16,10,6,361.08516183961507,0.7707707707707707,0.03574019042255938,0.20746539129509692,130587.70743580667,2073.5280099372494,132661.23544574392,2520,1,710.8648648648649,35,2,17,35.246692522553126,0.6282738095238096,44.473379629629626,1022.1064814814808,29.20304232804231,4
2552,4,1,1,35,0.027777777777777776,0.027777777777777776,0.9722222222222222,36,900,600,300,0.6666666666666666,12,6,6,366.6680347845673,0.7632275132275133,0.04515304471623649,0.21055819923916455,130566.58340419501,2374.9185090702977,132941.50191326533,2521,0,731.4722222222222,34,2,18,35.12546107551933,0.6302083333333333,44.49404761904762,1022.0238095238095,30.05952380952381,0
2553,4,0,0,35,0.0,0.0,1.0,35,250,0,250,0.0,5,0,5,373.59289989632555,0.7541316526610644,0.05419487531065226,0.2137197543332789,130419.01139285372,2744.723333573628,133163.73472642736,2522,7,753.3714285714286,33,2,21,35.098355328934225,0.6309974747474747,44.638480392156865,1021.4460784313726,30.95291146761735,0
2554,4,1,1,35,0.027777777777777776,0.027777777777777776,0.9722222222222222,36,450,300,150,0.6666666666666666,6,3,3,366.24120397196396,0.766005291005291,0.05463696113439953,0.21080961526214637,130657.85147392277,2370.457766439895,133028.30924036267,2523,0,733.4166666666666,34,2,18,35.043811131811836,0.6311274509803921,44.4047619047619,1022.3809523809513,30.07002801120445,0
2555,4,2,1,36,0.05405405405405406,0.02702702702702703,0.972972972972973,37,850,500,350,0.5882352941176471,12,5,7,357.3550205904346,0.7762137137137137,0.05444530710307727,0.2070598356527274,130913.23329260961,1956.5002357681662,132869.73352837778,2524,0,714.5405405405405,35,2,19,35.01234637713943,0.631547619047619,44.15509259259259,1023.3796296296287,29.239417989417962,0
2556,4,2,1,37,0.05263157894736842,0.02631578947368421,0.9736842105263158,38,1000,800,200,0.8,12,8,4,351.7046236843729,0.7804646752015173,0.06494906893852792,0.20584740874000185,131300.02891514683,1635.7654518697886,132935.7943670166,2525,0,696.6842105263158,37,1,21,34.76594540137654,0.6314752252252254,43.777412280701746,1024.8903508771918,27.69973921289708,0
2557,4,0,0,37,0.0,0.0,1.0,37,1200,900,300,0.75,15,9,6,358.0291127591832,0.771458958958959,0.05673952695276063,0.20907245621842444,131212.7224352733,1995.5949192435876,133208.31735451688,2526,1,716.5135135135135,36,1,21,34.69214845753645,0.6325231481481481,43.86261261261262,1024.5495495495509,28.459709709709745,0
2558,4,0,0,37,0.0,0.0,1.0,37,750,500,250,0.6666666666666666,10,5,5,358.5121992760926,0.77002002002002,0.056800082991096845,0.21031132855547213,131387.4488275892,2020.851373692895,133408.30020128208,2527,2,717.5135135135135,35,2,23,34.50317979980433,0.6363095238095238,43.69212962962963,1025.2314814814818,29.29232804232805,0
2559,4,0,0,37,0.0,0.0,1.0,37,850,600,250,0.7058823529411765,11,6,5,357.26514819975785,0.7706456456456456,0.044472076948395944,0.21121515561569693,131684.268904321,2013.1113897462303,133697.38029406723,2528,3,718.5135135135135,35,2,20,34.23545331529094,0.6392857142857142,43.40277777777778,1026.3888888888891,29.325396825396833,1
2560,4,0,0,37,0.0,0.0,1.0,37,1450,1100,350,0.7586206896551724,18,11,7,353.01382816711526,0.7707082082082082,0.03653157214924585,0.20935419007343897,131803.09070644723,1905.6627229080962,133708.75342935533,2529,4,719.5135135135135,35,2,20,34.2247144574692,0.6404761904761904,43.28703703703704,1026.8518518518522,29.33862433862435,0
2561,4,0,0,37,0.0,0.0,1.0,37,1100,800,300,0.7272727272727273,14,8,6,352.6296566837108,0.769019019019019,0.03535427319211126,0.2104402789886661,132040.89506172843,1912.3070987654364,133953.20216049388,2530,5,720.5135135135135,35,2,21,33.994932432432435,0.6428571428571428,43.05555555555556,1027.777777777778,29.365079365079374,0
2562,4,0,0,37,0.0,0.0,1.0,37,1100,700,400,0.6363636363636364,15,7,8,355.36868426644605,0.7681431431431431,0.03223775266543982,0.21290969384405736,132189.63162562152,1995.211092892655,134184.84271851418,2531,6,721.5135135135135,35,2,21,33.77473738510597,0.6443452380952381,42.910879629629626,1028.356481481481,29.381613756613746,0
2563,4,0,0,37,0.0,0.0,1.0,37,900,600,300,0.6666666666666666,12,6,6,357.22474137602785,0.7687687687687688,0.041404140414041724,0.21452793928041464,132278.91375171472,2050.6601508916374,134329.57390260635,2532,7,722.5135135135135,35,2,21,33.63711371137115,0.6452380952380952,42.824074074074076,1028.703703703704,29.391534391534396,0
2564,4,0,0,37,0.0,0.0,1.0,37,850,600,250,0.7058823529411765,11,6,5,358.47170089658925,0.7693318318318318,0.04989604989605034,0.21595734175965245,132398.00347222213,2092.1874999999905,134490.19097222213,2533,8,723.5135135135135,35,2,21,33.48515519568153,0.6464285714285715,42.70833333333333,1029.1666666666658,29.40476190476188,0
2565,4,0,0,37,0.0,0.0,1.0,37,850,700,150,0.8235294117647058,10,7,3,355.5067602173767,0.7688313313313313,0.014971912857308034,0.21221126229587975,132050.5402995903,1988.9719533723123,134039.51225296262,2534,9,724.5135135135135,36,1,16,33.91128884993245,0.6409143518518517,43.04617117117118,1027.8153153153166,28.550425425425463,3
2566,4,1,1,37,0.02631578947368421,0.02631578947368421,0.9736842105263158,38,1100,700,400,0.6363636363636364,15,7,8,347.06750732090717,0.7706555239449976,0.01577825757788176,0.20893063221338765,132369.79316953296,1588.2508319867682,133958.04400151974,2535,0,706.421052631579,37,1,17,33.80693926478423,0.6421734234234234,42.73574561403509,1029.0570175438597,27.812351825509722,0
2567,4,1,2,36,0.02631578947368421,0.05263157894736842,0.9473684210526316,38,900,500,400,0.5555555555555556,13,5,8,348.19215158648325,0.7765232337600759,0.005794383677525605,0.21059589209143056,132546.94097490152,1630.3669243165843,134177.3078992181,2536,0,707.3947368421053,35,3,17,33.59992600502043,0.6479166666666666,42.56365740740741,1029.7453703703711,29.42129629629632,0
2568,4,2,0,38,0.05263157894736842,0.0,1.0,38,700,500,200,0.7142857142857143,9,5,4,355.49185771255236,0.7774419155998104,-0.01264832404654026,0.21027308780336904,131703.53366457688,1763.9067699456302,133467.44043452252,2537,0,708.0263157894736,36,2,16,34.261519473395495,0.6374421296296295,43.38400900900901,1026.463963963965,28.512887887887914,5
2569,4,0,1,37,0.0,0.02631578947368421,0.9736842105263158,38,850,600,250,0.7058823529411765,11,6,5,354.9819586067026,0.7768492176386913,-0.020358151053843976,0.210290481911456,131761.33639974432,1754.579452763573,133515.9158525079,2538,1,709.0263157894736,36,2,17,34.21629922123505,0.6380208333333334,43.3277027027027,1026.6891891891892,28.519144144144143,0
2570,4,0,0,37,0.0,0.0,1.0,37,900,600,300,0.6666666666666666,12,6,6,363.19789936662374,0.7782157157157157,-0.023479501152031457,0.2147225981055481,131684.268904321,2165.489969135806,133849.75887345683,2539,2,699.4054054054054,35,2,17,34.0832205683356,0.6392857142857142,43.40277777777778,1026.3888888888891,29.325396825396833,0
2571,4,0,0,37,0.0,0.0,1.0,37,500,300,200,0.6,7,3,4,363.8889463896276,0.7788413413413413,-0.029887852004862436,0.21563519328138853,131773.38023244598,2190.1752989969136,133963.5555314429,2540,3,700.4054054054054,35,2,17,33.975524179912085,0.6401785714285715,43.31597222222222,1026.736111111111,29.33531746031746,0
2572,4,0,0,37,0.0,0.0,1.0,37,1200,1100,100,0.9166666666666666,13,11,2,368.2381496292181,0.7778403403403403,-0.02911539608993985,0.21941062365155697,131981.4238790295,2320.1190629286666,134301.54294195815,2541,4,701.4054054054054,35,2,17,33.65388225576331,0.6422619047619048,43.113425925925924,1027.5462962962963,29.358465608465607,0
2573,4,0,0,37,0.0,0.0,1.0,37,950,600,350,0.631578947368421,13,6,7,376.5152779098293,0.7757757757757757,-0.026138700609659837,0.22540173375680062,132159.87761488324,2552.0426097393442,134711.9202246226,2542,5,702.4054054054054,35,2,17,33.26110610835959,0.6440476190476192,42.9398148148148,1028.2407407407393,29.378306878306837,0
2574,4,0,0,37,0.0,0.0,1.0,37,750,400,350,0.5333333333333333,11,4,7,378.7094493920921,0.7751501501501501,-0.028185458492579363,0.2276097562979246,132308.68115837182,2621.309558256167,134929.990716628,2543,6,703.4054054054054,35,2,17,33.05454775565306,0.6455357142857143,42.795138888888886,1028.819444444444,29.394841269841255,0
2575,4,0,0,37,0.0,0.0,1.0,37,1350,1100,250,0.8148148148148148,16,11,5,376.1740071137048,0.7746496496496497,-0.027355290513185082,0.22662190184654885,132398.00347222213,2560.937499999991,134958.94097222213,2544,7,704.4054054054054,35,2,17,33.02968960863699,0.6464285714285715,42.70833333333333,1029.1666666666658,29.40476190476188,0
2576,4,0,0,37,0.0,0.0,1.0,37,750,500,250,0.6666666666666666,10,5,5,377.932860948921,0.7748998998998999,-0.030433897295473633,0.22786148694364458,132427.7842747986,2609.762276020242,135037.54655081886,2545,8,705.4054054054054,35,2,17,32.95440702425129,0.6467261904761905,42.67939814814815,1029.282407407408,29.408068783068803,0
2577,4,0,0,37,0.0,0.0,1.0,37,1150,900,250,0.782608695652174,14,9,5,378.89068241809395,0.7738363363363363,-0.026759673342407364,0.2289817602439788,132517.1467764062,2641.9024348422695,135159.0492112485,2546,9,706.4054054054054,35,2,17,32.83966576738608,0.6476190476190475,42.5925925925926,1029.6296296296312,29.41798941798946,0
2578,4,0,0,37,0.0,0.0,1.0,37,650,500,150,0.7692307692307693,8,5,3,381.45284686276995,0.773460960960961,-0.02507136349832928,0.23126228454214254,132636.34366426614,2718.902177640609,135355.24584190676,2547,10,707.4054054054054,35,2,16,32.65355805243446,0.6488095238095237,42.476851851851855,1030.0925925925928,29.431216931216937,0
2579,4,0,0,37,0.0,0.0,1.0,37,1100,800,300,0.7272727272727273,14,8,6,377.656471816646,0.7710835835835835,-0.02012231209311488,0.2298722407058942,132785.41512613604,2629.454277049051,135414.8694031851,2548,11,708.4054054054054,35,2,16,32.601183791877226,0.650297619047619,42.33217592592593,1030.6712962962968,29.447751322751337,0
2580,4,0,0,37,0.0,0.0,1.0,37,850,800,50,0.9411764705882353,9,8,1,377.6431909341405,0.771021021021021,-0.02124657496836657,0.23023052030461244,132845.0671537422,2633.607011959865,135478.67416570205,2549,12,709.4054054054054,35,2,16,32.54147019198383,0.6508928571428572,42.27430555555555,1030.902777777777,29.454365079365054,0
2581,4,0,0,37,0.0,0.0,1.0,37,750,600,150,0.8,9,6,3,377.2660197587056,0.7708958958958959,-0.02630197826067171,0.23036757848048695,132904.7325772675,2628.087893304165,135532.82047057166,2550,13,710.4054054054054,35,2,17,32.49113723949564,0.6514880952380953,42.216435185185176,1031.134259259258,29.4609788359788,0
2582,4,0,0,37,0.0,0.0,1.0,37,800,500,300,0.625,11,5,6,383.2526268457762,0.7706456456456456,-0.018939841895076137,0.23477186687810347,133024.10361207573,2796.367428626554,135820.47104070228,2551,14,711.4054054054054,35,2,17,32.216635812857625,0.6526785714285714,42.10069444444445,1031.597222222223,29.474206349206373,0
2583,4,0,0,37,0.0,0.0,1.0,37,800,600,200,0.75,10,6,4,382.9724839397156,0.7708958958958959,-0.010745356860392352,0.2357302680647566,133203.26063368062,2802.6367187500055,136005.89735243062,2552,15,712.4054054054054,35,2,18,32.043600739993266,0.6544642857142856,41.927083333333336,1032.2916666666672,29.494047619047635,0
2584,4,1,0,38,0.02631578947368421,0.0,1.0,38,1150,900,250,0.782608695652174,14,9,5,371.74540023652867,0.7764046941678521,0.0030758714969241208,0.23122770995213612,133591.84777949253,2332.7022515860854,135924.5500310786,2553,0,694.6315789473684,35,3,19,31.943200477683245,0.6583333333333332,41.55092592592593,1033.7962962962968,29.53703703703705,0
2585,4,0,1,37,0.0,0.02631578947368421,0.9736842105263158,38,1100,800,300,0.7272727272727273,14,8,6,372.632923749428,0.7761676149834045,0.010389671582716531,0.2325312714123524,133711.52692043895,2365.063443072698,136076.59036351164,2554,1,695.6315789473684,35,3,17,31.80020889286778,0.6595238095238095,41.43518518518518,1034.2592592592591,29.550264550264547,0
2586,4,0,0,37,0.0,0.0,1.0,37,950,600,350,0.631578947368421,13,6,7,377.9751706756922,0.7764014014014013,0.007374401802216601,0.23551594924598723,133656.80980725618,2703.791099773234,136360.6009070294,2555,2,708.0,34,3,19,31.716987105687316,0.6611519607843137,41.488095238095234,1034.0476190476186,30.41316526610643,0
2587,4,0,0,37,0.0,0.0,1.0,37,1250,1000,250,0.8,15,10,5,380.1308595120776,0.7765265265265265,0.01184959412807518,0.23765015605467296,133779.93905895695,2770.7766439909333,136550.7157029479,2556,3,709.0,34,3,17,31.537686996547762,0.6623774509803921,41.36904761904762,1034.5238095238096,30.427170868347343,0
2588,4,0,0,37,0.0,0.0,1.0,37,800,400,400,0.5,12,4,8,378.6459310443994,0.7759009009009009,0.010850606732350832,0.2373157230403002,133872.32320011334,2738.042091836735,136610.3652919501,2557,4,710.0,34,3,17,31.483425361401903,0.663296568627451,41.279761904761905,1034.8809523809523,30.437675070028007,0
2589,4,0,0,37,0.0,0.0,1.0,37,1200,900,300,0.75,15,9,6,377.1724678714765,0.7753378378378378,0.014262365377564201,0.23738394540854574,134026.36763038547,2710.2111678004508,136736.57879818592,2558,5,711.0,34,3,17,31.367124626350893,0.664828431372549,41.13095238095238,1035.4761904761904,30.45518207282913,0
2590,4,0,0,37,0.0,0.0,1.0,37,850,600,250,0.7058823529411765,11,6,5,375.1012866598837,0.7746496496496497,0.01276940810220517,0.23627850055425983,134057.1871456916,2657.0046768707452,136714.19182256234,2559,6,712.0,34,3,17,31.389862819481166,0.6651348039215685,41.101190476190474,1035.595238095238,30.458683473389357,0
2591,4,0,0,37,0.0,0.0,1.0,37,800,500,300,0.625,11,5,6,374.98360510777957,0.7748998998998999,0.01851081143197919,0.23680024177415818,134149.66695011343,2660.7851473922983,136810.45209750574,2560,7,713.0,34,3,17,31.300275798666974,0.6660539215686274,41.011904761904766,1035.9523809523814,30.469187675070042,0
2592,4,0,0,37,0.0,0.0,1.0,37,650,400,250,0.6153846153846154,9,4,5,374.7804826067004,0.7733358358358359,0.014250896502476573,0.23727011644300572,134242.1786422903,2662.269699546494,136904.4483418368,2561,8,714.0,34,3,18,31.212904461037734,0.6669730392156863,40.92261904761905,1036.309523809524,30.479691876750707,0
2593,4,0,0,37,0.0,0.0,1.0,37,700,400,300,0.5714285714285714,10,4,6,380.67509817457676,0.7726476476476476,0.011411272992282617,0.23562756790006978,133410.72137188213,2757.582199546497,136168.30357142864,2562,9,715.0,34,3,20,31.89434969655067,0.6587009803921567,41.72619047619048,1033.0952380952385,30.38515406162466,4
2594,4,0,0,37,0.0,0.0,1.0,37,650,200,450,0.3076923076923077,11,2,9,380.13787721123794,0.7730855855855856,0.011769834350479513,0.23568548387096788,133472.22222222245,2747.5694444444684,136219.79166666692,2563,10,716.0,34,3,20,31.846438172043015,0.659313725490196,41.66666666666668,1033.333333333335,30.39215686274515,0
2595,4,0,0,37,0.0,0.0,1.0,37,500,400,100,0.8,6,4,2,376.0678399444587,0.7718343343343343,0.012033370497097184,0.23396078892119898,133598.8862456749,2648.448913879298,136247.33515955418,2564,11,717.0,33,4,20,31.824423107317855,0.6628787878787877,41.54411764705883,1033.823529411766,31.327985739750485,0
2596,4,0,0,37,0.0,0.0,1.0,37,1300,1200,100,0.9230769230769231,14,12,2,380.06344671314065,0.7708333333333334,0.02168052914321561,0.23766634201128387,133788.99491782006,2769.661308150709,136558.65622597077,2565,12,718.0,33,4,17,31.53034431019505,0.6647727272727273,41.36029411764706,1034.5588235294117,31.350267379679142,0
2597,4,0,0,37,0.0,0.0,1.0,37,1100,900,200,0.8181818181818182,13,9,4,379.8068128013087,0.7698948948948949,0.0236998361998364,0.23873571090367962,133979.23875432528,2777.245530565172,136756.48428489047,2566,13,719.0,33,4,19,31.3461766098485,0.6666666666666665,41.1764705882353,1035.294117647059,31.37254901960785,0
2598,4,1,1,37,0.02631578947368421,0.02631578947368421,0.9736842105263158,38,700,300,400,0.42857142857142855,11,3,8,368.43197012972513,0.7743302513039355,0.023341191132640215,0.2331145885916205,134220.76106234995,2290.2438861025385,136511.0049484525,2567,0,701.0526315789474,35,3,19,31.398809523809533,0.6645833333333333,40.94328703703704,1036.2268518518517,29.606481481481477,0
2599,4,0,0,37,0.0,0.0,1.0,37,950,700,250,0.7368421052631579,12,7,5,374.8165915773542,0.7699574574574575,0.017264247352742457,0.23649595092926484,134118.83680555565,2653.993055555565,136772.8298611112,2568,15,721.0,34,3,19,31.33547868061142,0.6657475490196079,41.04166666666667,1035.8333333333342,30.465686274509828,0
2600,4,0,0,37,0.0,0.0,1.0,37,800,400,400,0.5,12,4,8,373.02512198583474,0.7677052052052052,0.021493690381557906,0.23596007716313264,134211.33786848068,2612.840136054414,136824.1780045351,2569,16,722.0,34,3,20,31.28925398284314,0.6666666666666667,40.95238095238095,1036.190476190476,30.476190476190467,0
2601,4,0,0,37,0.0,0.0,1.0,37,750,500,250,0.6666666666666666,10,5,5,370.7161556614455,0.7646396396396397,0.019557276877290253,0.23548993432936016,134365.57716836728,2562.2980442176763,136927.87521258494,2570,17,723.0,34,3,20,31.194741072453766,0.6681985294117647,40.80357142857142,1036.7857142857138,30.49369747899158,0
2602,4,0,0,37,0.0,0.0,1.0,37,800,400,400,0.5,12,4,8,371.53564699895793,0.7632007007007007,0.01991269193656997,0.23640957056303286,134427.29768990917,2588.9066043083767,137016.20429421755,2571,18,724.0,34,3,21,31.11176481842882,0.6688112745098039,40.74404761904761,1037.0238095238085,30.500700280112014,0
2603,4,0,0,37,0.0,0.0,1.0,37,750,300,450,0.4,12,3,9,374.19044986976365,0.762575075075075,0.020307497580224876,0.23830023386442836,134458.16326530604,2662.592120181393,137120.75538548743,2572,19,725.0,34,3,21,31.01206190694827,0.6691176470588236,40.71428571428571,1037.1428571428564,30.50420168067225,0
2604,4,0,0,37,0.0,0.0,1.0,37,900,500,400,0.5555555555555556,13,5,8,357.25431889260756,0.762575075075075,0.0037758576033599667,0.21805353459681995,132888.53635204083,2095.0325963718765,134983.5689484127,2573,20,726.0,34,3,21,33.02327483354499,0.6534926470588236,42.232142857142854,1031.0714285714287,30.325630252100844,5
2605,4,0,0,37,0.0,0.0,1.0,37,1050,700,350,0.6666666666666666,14,7,7,356.3994191470747,0.7633883883883884,0.0077683593786561644,0.2178890732583702,132949.91673752826,2076.654620181398,135026.57135770965,2574,21,727.0,34,3,22,32.98366616645504,0.6541053921568627,42.172619047619044,1031.3095238095232,30.33263305322127,0
2606,4,0,0,37,0.0,0.0,1.0,37,1150,700,450,0.6086956521739131,16,7,9,353.7416386323246,0.7633258258258259,0.006549360345806887,0.21679809337961264,133042.01388888876,2012.4999999999911,135054.51388888876,2575,22,728.0,34,3,22,32.95974690360798,0.6550245098039216,42.08333333333333,1031.6666666666656,30.34313725490193,0
2607,4,0,1,36,0.0,0.02702702702702703,0.972972972972973,37,650,500,150,0.7692307692307693,8,5,3,364.52156708647055,0.7632007007007007,-0.07092881227897574,0.21634781704068595,131832.80452942822,2211.180100094312,134043.98462952254,2576,23,729.0,35,2,17,33.89930594688004,0.6407738095238094,43.258101851851855,1026.967592592593,29.34193121693123,7
2608,4,0,0,36,0.0,0.0,1.0,36,900,600,300,0.6666666666666666,12,6,6,371.34025973271946,0.7555886243386244,-0.06805652162712239,0.2203013122733452,131816.67375283453,2589.7675736961487,134406.44132653068,2577,40,749.6111111111111,34,2,19,33.74053249864749,0.6427696078431373,43.273809523809526,1026.9047619047624,30.203081232493012,0
2609,4,0,0,36,0.0,0.0,1.0,36,700,500,200,0.7142857142857143,9,5,4,348.750791086033,0.757010582010582,-0.07974190173639029,0.22153688107718908,134365.5771683674,2172.020266439914,136537.5974348073,2578,41,750.6111111111111,34,2,20,31.764075477475394,0.6681985294117647,40.80357142857143,1036.7857142857147,30.493697478991606,6
2610,4,0,0,36,0.0,0.0,1.0,36,1200,1000,200,0.8333333333333334,14,10,4,348.43486784780225,0.757010582010582,-0.08265745947944947,0.2220858085997003,134489.03238378698,2172.133645124731,136661.1660289117,2579,42,751.6111111111111,34,2,21,31.649068441791968,0.669424019607843,40.68452380952382,1037.2619047619057,30.50770308123252,0
2611,4,0,1,35,0.0,0.027777777777777776,0.9722222222222222,36,750,600,150,0.8,9,6,3,348.9049483776572,0.7560515873015874,-0.0812171740349803,0.22295128519498977,134581.66099773254,2191.2414965986545,136772.9024943312,2580,43,752.6111111111111,34,2,22,31.544477589108148,0.6703431372549018,40.5952380952381,1037.6190476190484,30.51820728291319,0
2612,4,0,0,35,0.0,0.0,1.0,35,1050,800,250,0.7619047619047619,13,8,5,356.96498190043616,0.7487394957983192,-0.07642452065892524,0.22751141617509738,134487.21645520956,2601.4453575547877,137088.66181276436,2581,44,773.2571428571429,33,2,22,31.429682577189656,0.6717171717171717,40.68627450980392,1037.2549019607845,31.43196672608438,0
2613,4,0,0,35,0.0,0.0,1.0,35,1000,700,300,0.7,13,7,6,357.25230238221945,0.7476190476190475,-0.07366609294320126,0.22809185459787878,134550.78125000012,2613.7152777777906,137164.4965277779,2582,45,774.2571428571429,33,2,22,31.35876840696117,0.6723484848484848,40.62500000000001,1037.500000000001,31.439393939393966,0
2614,4,0,0,35,0.0,0.0,1.0,35,900,600,300,0.6666666666666666,12,6,6,356.21057150551945,0.7474789915966386,-0.07435049598488397,0.22782410268192882,134614.36106305264,2590.2116974240635,137204.5727604767,2583,46,775.2571428571429,33,2,22,31.32233112895607,0.6729797979797979,40.56372549019608,1037.7450980392155,31.4468211527035,0
2615,4,0,0,35,0.0,0.0,1.0,35,700,600,100,0.8571428571428571,8,6,2,356.21057150551945,0.7473389355742296,-0.07435049598488397,0.22782410268192882,134614.36106305264,2590.2116974240635,137204.5727604767,2584,47,776.2571428571429,33,2,22,31.32233112895607,0.6729797979797979,40.56372549019608,1037.7450980392155,31.4468211527035,0
2616,4,0,0,35,0.0,0.0,1.0,35,700,500,200,0.7142857142857143,9,5,4,356.21057150551945,0.7473389355742296,-0.07435049598488397,0.22782410268192882,134614.36106305264,2590.2116974240635,137204.5727604767,2585,48,777.2571428571429,33,2,22,31.32233112895607,0.6729797979797979,40.56372549019608,1037.7450980392155,31.4468211527035,0
2617,4,0,0,35,0.0,0.0,1.0,35,900,600,300,0.6666666666666666,12,6,6,355.7752969366149,0.7469887955182072,-0.06861190757294622,0.22794377950477526,134677.95589436765,2583.017949826999,137260.97384419464,2586,49,778.2571428571429,33,2,22,31.270169224714685,0.673611111111111,40.50245098039216,1037.990196078432,31.454248366013093,0
2618,4,0,0,35,0.0,0.0,1.0,35,1100,1000,100,0.9090909090909091,12,10,2,357.87833231236186,0.7465686274509803,-0.07044381491973595,0.22969282055684315,134741.5657439446,2644.21736831987,137385.78311226447,2587,50,779.2571428571429,33,2,22,31.152128580421774,0.6742424242424242,40.44117647058823,1038.2352941176468,31.46167557932263,0
2619,4,0,0,35,0.0,0.0,1.0,35,1050,800,250,0.7619047619047619,13,8,5,360.2533087823686,0.7462885154061624,-0.06447525820093325,0.23264187396540012,134964.31848627928,2724.268460447903,137688.58694672718,2588,51,780.2571428571429,33,2,17,30.868297165546252,0.6764520202020202,40.22671568627451,1039.0931372549019,31.487670825906118,0
2620,4,0,0,35,0.0,0.0,1.0,35,700,600,100,0.8571428571428571,8,6,2,357.8172476816934,0.7469187675070027,-0.06241115639842365,0.23167983930046737,135059.84026576302,2665.3480632448864,137725.1883290079,2589,52,781.2571428571429,33,2,18,30.83637899866383,0.67739898989899,40.13480392156862,1039.4607843137244,31.498811645870436,0
2621,4,0,0,35,0.0,0.0,1.0,35,1150,800,350,0.6956521739130435,15,8,7,357.82733910089627,0.7427871148459383,-0.0605762757506394,0.2329170593779452,135250.98519800056,2679.3000288350386,137930.2852268356,2590,53,782.2571428571429,33,2,19,30.64571551994973,0.6792929292929294,39.95098039215685,1040.196078431371,31.52109328579912,0
2622,4,0,0,35,0.0,0.0,1.0,35,600,400,200,0.6666666666666666,8,4,4,360.53279615316865,0.7435574229691876,-0.06103314824162842,0.2350939661551766,135314.73021193763,2757.079608804294,138071.8098207419,2591,54,783.2571428571429,33,2,19,30.51187671770711,0.6799242424242424,39.889705882352935,1040.4411764705874,31.52852049910871,0
2623,4,0,0,35,0.0,0.0,1.0,35,1050,800,250,0.7619047619047619,13,8,5,363.23123485976214,0.7432773109243697,-0.05828665623791007,0.23748444015888812,135410.37589208462,2837.0556096212836,138247.4315017059,2592,55,784.2571428571429,33,2,20,30.346437262058956,0.6808712121212122,39.79779411764705,1040.8088235294106,31.539661319073048,0
2624,4,0,0,35,0.0,0.0,1.0,35,800,600,200,0.75,10,6,4,360.05592333799063,0.7417366946778711,-0.06057223548397894,0.23645712801593832,135569.86045030746,2762.54625624759,138332.40670655505,2593,56,785.2571428571429,33,2,20,30.270357731230888,0.682449494949495,39.64460784313725,1041.4215686274501,31.558229352346974,0
2625,4,0,0,35,0.0,0.0,1.0,35,1150,1000,150,0.8695652173913043,13,10,3,359.6375889460254,0.742016806722689,-0.05759994622481379,0.2368148058582618,135665.59624002778,2758.0895869377055,138423.6858269655,2594,57,786.2571428571429,33,2,20,30.186032035446807,0.6833964646464648,39.55269607843137,1041.7892156862738,31.569370172311327,0
2626,4,0,0,35,0.0,0.0,1.0,35,800,700,100,0.875,9,7,2,357.4535296006327,0.7408263305322128,-0.05371630133534888,0.2362192905402781,135793.29652357253,2707.9586276912564,138501.2551512638,2595,58,787.2571428571429,33,2,20,30.115985694689385,0.684659090909091,39.43014705882352,1042.279411764705,31.584224598930454,0
2627,4,0,0,35,0.0,0.0,1.0,35,400,200,200,0.5,6,2,4,355.66599749017007,0.740126050420168,-0.05668609044652284,0.23545919382481528,135857.16919273837,2663.955119425217,138521.1243121636,2596,59,788.2571428571429,33,2,20,30.099109556835536,0.6852904040404041,39.368872549019606,1042.5245098039215,31.59165181224005,0
2628,4,0,0,35,0.0,0.0,1.0,35,850,400,450,0.47058823529411764,13,4,9,352.4712126886765,0.7387254901960784,-0.05029538131041922,0.23439335643796994,136016.91657054974,2588.4095059592382,138605.326076509,2597,60,789.2571428571429,33,2,16,30.02378994360901,0.6868686868686869,39.2156862745098,1043.1372549019604,31.610219845513953,0
2629,4,0,0,35,0.0,0.0,1.0,35,600,400,200,0.6666666666666666,8,4,4,352.3145873361033,0.738375350140056,-0.04641640516185319,0.23449992822456975,136048.87730980874,2586.400813389086,138635.27812319782,2598,61,790.2571428571429,33,2,17,29.996157837033557,0.6871843434343434,39.185049019607845,1043.2598039215688,31.61393345216875,0
2630,4,0,0,35,0.0,0.0,1.0,35,500,300,200,0.6,7,3,4,352.3145873361033,0.738375350140056,-0.04641640516185319,0.23449992822456975,136048.87730980874,2586.400813389086,138635.27812319782,2599,62,791.2571428571429,33,2,17,29.996157837033557,0.6871843434343434,39.185049019607845,1043.2598039215688,31.61393345216875,0
2631,4,0,0,35,0.0,0.0,1.0,35,900,500,400,0.5555555555555556,13,5,8,352.14836909446615,0.738095238095238,-0.04573307829121753,0.2346002515234965,136080.84180363326,2584.1293012302995,138664.97110486357,2600,63,792.2571428571429,33,2,18,29.968776916451343,0.6875,39.154411764705884,1043.3823529411766,31.617647058823533,0
2632,4,0,0,35,0.0,0.0,1.0,35,1100,800,300,0.7272727272727273,14,8,6,352.98094760148007,0.7379551820728291,-0.0493878509375103,0.2360040590007385,136208.73732458675,2615.8178344867483,138824.5551590735,2601,64,793.2571428571429,33,2,19,29.820184706895198,0.6887626262626263,39.031862745098046,1043.8725490196084,31.632501485442678,0
2633,4,0,0,35,0.0,0.0,1.0,35,900,700,200,0.7777777777777778,11,7,4,352.98094760148007,0.7369047619047618,-0.0493878509375103,0.2360040590007385,136208.73732458675,2615.8178344867483,138824.5551590735,2602,65,794.2571428571429,33,2,19,29.820184706895198,0.6887626262626263,39.031862745098046,1043.8725490196084,31.632501485442678,0
2634,4,0,0,35,0.0,0.0,1.0,35,600,300,300,0.5,9,3,6,353.0850665714656,0.7360644257703081,-0.046880083175422804,0.236286856411808,136240.72059123905,2620.912779940419,138861.63337117946,2603,66,795.2571428571429,33,2,19,29.78574852290959,0.6890782828282827,39.001225490196084,1043.9950980392164,31.636215092097466,0
2635,4,0,0,35,0.0,0.0,1.0,35,1600,1300,300,0.8125,19,13,6,352.29742088572505,0.7343837535014005,-0.044839082578029044,0.2374735263156189,136496.7218888168,2617.4886161572517,139114.21050497406,2604,67,796.2571428571429,33,2,20,29.552573198858543,0.6916035353535352,38.756127450980394,1044.9754901960785,31.66592394533571,0
2636,4,0,0,35,0.0,0.0,1.0,35,900,700,200,0.7777777777777778,11,7,4,352.0046460015771,0.734313725490196,-0.050081235448804495,0.23770765049465173,136560.7597588669,2614.0043793252757,139174.76413819217,2605,68,797.2571428571429,33,2,21,29.49679036229336,0.6922348484848484,38.69485294117648,1045.2205882352948,31.673351158645296,0
2637,4,0,0,35,0.0,0.0,1.0,35,900,500,400,0.5555555555555556,13,5,8,384.147307091553,0.734313725490196,-0.05982339185368746,0.23859103610405574,133537.46588358335,3279.619662826807,136817.08554641015,2606,69,798.2571428571429,32,3,21,31.677304747943637,0.6647135416666666,41.60353535353536,1033.585858585859,32.29955808080809,5
2638,4,0,0,35,0.0,0.0,1.0,35,550,200,350,0.36363636363636365,9,2,7,384.21383038411665,0.7338935574229691,-0.05306022751064288,0.23905340753686533,133602.72548719522,3266.4029818385898,136869.1284690338,2607,70,799.2571428571429,32,3,21,31.61002890408728,0.6653645833333334,41.54040404040404,1033.838383838384,32.3074494949495,0
2639,4,2,2,35,0.05405405405405406,0.05405405405405406,0.9459459459459459,37,1200,1000,200,0.8333333333333334,14,10,4,365.2530056810675,0.7505630630630631,-0.059770114942528485,0.23026819923371644,134088.01020408174,2395.2097505669044,136483.21995464864,2608,0,757.0,34,3,18,31.6139846743295,0.6654411764705882,41.07142857142858,1035.7142857142865,30.462184873949603,0
2640,4,0,0,35,0.0,0.0,1.0,35,750,500,250,0.6666666666666666,10,5,5,381.57971873801995,0.7338235294117647,-0.04532668746405466,0.23931208527127373,133896.5909888021,3218.44470589735,137115.03569469947,2609,72,801.2571428571429,32,3,18,31.383178805253962,0.6682942708333334,41.25631313131313,1034.974747474747,32.34296085858584,0
2641,4,0,0,35,0.0,0.0,1.0,35,350,200,150,0.5714285714285714,5,2,3,381.6692032002997,0.7329131652661064,-0.04137594535252476,0.23958071422940716,133929.2626390164,3223.3349913274137,137152.5976303438,2610,73,802.2571428571429,32,3,18,31.34809303082053,0.6686197916666667,41.224747474747474,1035.10101010101,32.34690656565656,0
2642,4,0,0,35,0.0,0.0,1.0,35,1050,700,350,0.6666666666666666,14,7,7,379.9793449560325,0.7314425770308123,-0.039091339327969266,0.2396705539976408,134106.14306997307,3191.5128796616723,137297.65594963473,2611,74,803.2571428571429,33,2,18,31.214505442498808,0.6679292929292929,41.05392156862745,1035.7843137254902,31.387403446226976,0
2643,4,0,0,35,0.0,0.0,1.0,35,1100,800,300,0.7272727272727273,14,8,6,382.8354865795579,0.7302521008403361,-0.031852665371293165,0.24209977853628706,134201.3607296471,3275.4086469146305,137476.76937656174,2612,75,804.2571428571429,33,2,18,31.045116301990937,0.6688762626262628,40.96200980392156,1036.1519607843125,31.398544266191287,0
2644,4,0,0,35,0.0,0.0,1.0,35,800,600,200,0.75,10,6,4,381.53188046602736,0.7309523809523809,-0.054103833314147476,0.2379301827428845,133687.5868055556,3224.6475213860112,136912.2343269416,2613,76,805.2571428571429,34,1,19,31.594144507117903,0.6614583333333333,41.458333333333336,1034.166666666667,30.416666666666675,3
2645,4,0,0,35,0.0,0.0,1.0,35,900,600,300,0.6666666666666666,12,6,6,376.2650047233719,0.7296218487394958,-0.05339641338746304,0.23517878407115375,133771.38658479083,3066.698281035672,136838.0848658265,2614,77,806.2571428571429,35,0,18,31.64624822853732,0.6601190476190476,41.37731481481482,1034.490740740741,29.556878306878318,0
2646,4,0,0,35,0.0,0.0,1.0,35,550,200,350,0.36363636363636365,9,2,7,356.6013699881642,0.7294117647058823,-0.09101172383847134,0.21331245586564745,132130.12695312512,2423.5568576389032,134553.68381076402,2615,78,807.2571428571429,35,0,19,33.802980412022976,0.6437499999999999,42.96875000000001,1028.125000000001,29.375000000000025,6
2647,4,0,0,35,0.0,0.0,1.0,35,800,600,200,0.75,10,6,4,357.0532987162663,0.7292717086834734,-0.09490588178559345,0.21425608816282646,132249.14969403722,2443.99903013546,134693.14872417267,2616,79,808.2571428571429,35,0,21,33.67149112936498,0.6449404761904761,42.85300925925926,1028.587962962963,29.388227513227516,0
2648,4,0,0,35,0.0,0.0,1.0,35,600,500,100,0.8333333333333334,7,5,2,357.7147742622506,0.7298319327731092,-0.09974446747987031,0.21499165844605453,132308.6811583719,2465.7540027006253,134774.43516107253,2617,80,809.2571428571429,35,0,21,33.59454100573744,0.6455357142857142,42.79513888888889,1028.8194444444446,29.394841269841272,0
2649,4,0,0,35,0.0,0.0,1.0,35,1000,800,200,0.8,12,8,4,358.71350606686764,0.7279411764705882,-0.08654540500034058,0.21430832541943645,132082.8827854673,2476.043076714635,134558.92586218196,2618,81,810.2571428571429,33,2,21,33.79629629629627,0.6477272727272727,43.01470588235295,1027.9411764705897,31.149732620320897,1
2650,4,0,0,35,0.0,0.0,1.0,35,550,300,250,0.5454545454545454,8,3,5,369.2230236554568,0.7279411764705882,-0.05608133723935871,0.2037855436820068,129014.56921616707,2550.2481016916836,131564.81731785875,2619,82,811.2571428571429,33,2,18,36.639525532770406,0.6167929292929293,46.01715686274511,1015.9313725490214,30.785799168152163,6
2651,4,2,1,36,0.05405405405405406,0.02702702702702703,0.972972972972973,37,850,600,250,0.7058823529411765,11,6,5,356.84990383040474,0.7555680680680681,-0.039210980085016,0.20065187102369286,129746.60572562362,1860.147919461909,131606.75364508553,2620,0,768.3513513513514,34,3,17,36.20856703279584,0.6219362745098038,45.29761904761905,1018.8095238095241,29.964985994397768,0
2652,4,1,0,37,0.02702702702702703,0.0,1.0,37,450,200,250,0.4444444444444444,7,2,5,357.193237755125,0.7541291291291291,-0.020251859488916724,0.20167679731712426,129908.37191358018,1880.478395061722,131788.8503086419,2621,0,769.3243243243244,35,2,18,36.03542234332425,0.6214285714285714,45.138888888888886,1019.4444444444439,29.126984126984112,0
2653,4,0,0,37,0.0,0.0,1.0,37,950,500,450,0.5263157894736842,14,5,9,359.0668237143717,0.7534409409409409,-0.014382929394843647,0.20350198825689758,130055.90284475737,1939.7519879543877,131995.65483271176,2622,1,770.3243243243244,35,2,18,35.83780116494572,0.6229166666666666,44.99421296296296,1020.023148148148,29.143518518518515,0
2654,4,0,0,37,0.0,0.0,1.0,37,1000,700,300,0.7,13,7,6,358.9453192156856,0.7525025025025025,-0.018067080013982606,0.2035871327906726,130085.4190779321,1938.7104552469154,132024.12953317902,2623,2,771.3243243243244,35,2,19,35.81092579986386,0.6232142857142857,44.96527777777778,1020.1388888888889,29.1468253968254,0
2655,4,1,1,37,0.02631578947368421,0.02631578947368421,0.9736842105263158,38,600,300,300,0.5,9,3,6,351.0204081632651,0.7664770033191086,-0.01901181525241702,0.20000000000000004,130262.58680555566,1544.9652777777878,131807.55208333346,2624,0,752.0,36,2,19,35.83333333333333,0.622974537037037,44.79166666666667,1020.8333333333343,28.35648148148151,0
2656,4,1,0,38,0.02631578947368421,0.0,1.0,38,550,200,350,0.36363636363636365,9,2,7,350.21933916319875,0.7603129445234709,-0.008517440473350124,0.20015125963575542,130380.76560356648,1532.3731138545913,131913.13871742107,2625,0,752.9736842105264,35,3,20,35.733983076458145,0.6261904761904762,44.675925925925924,1021.296296296296,29.17989417989417,0
2657,4,0,0,38,0.0,0.0,1.0,38,700,500,200,0.7142857142857143,9,5,4,351.4260058849057,0.7611723565670934,-0.009714122151061044,0.20114694733723584,130439.8750964505,1567.9928626543094,132007.8679591048,2626,1,753.9736842105264,35,3,20,35.64326988443236,0.6267857142857144,44.61805555555555,1021.5277777777768,29.18650793650791,0
2658,4,0,0,38,0.0,0.0,1.0,38,1350,900,450,0.6666666666666666,18,9,9,355.10259261207875,0.7622688477951636,-0.004872190668041565,0.20402804133749267,130587.70743580654,1674.4066947444908,132262.11413055102,2627,2,754.9736842105264,35,3,18,35.39956309213754,0.6282738095238096,44.47337962962962,1022.1064814814798,29.20304232804228,0
2659,4,1,1,38,0.02564102564102564,0.02564102564102564,0.9743589743589743,39,1550,1300,250,0.8387096774193549,18,13,5,349.5889926970716,0.772829509671615,-0.0016631711882373335,0.20383727420336886,131155.04017531007,1370.0716764060926,132525.11185171618,2628,0,736.5897435897435,36,3,19,34.96660620052771,0.6319444444444446,43.9189189189189,1024.3243243243214,28.453453453453374,0
2660,4,0,0,38,0.0,0.0,1.0,38,1200,900,300,0.75,15,9,6,356.9569701609169,0.7630097202465623,0.006885152329535682,0.20842896437100486,131209.51753257867,1767.2303669409857,132976.74789951966,2629,4,756.9736842105264,35,3,21,34.72284982678113,0.6345238095238097,43.865740740740726,1024.5370370370354,29.272486772486726,0
2661,4,0,0,38,0.0,0.0,1.0,38,750,600,150,0.8,9,6,3,355.30937356955286,0.7622984826932195,0.010182730374615145,0.20778792560005416,131268.81456832984,1728.208054698209,132997.02262302805,2630,5,757.9736842105264,35,3,21,34.70512386115503,0.6351190476190476,43.80787037037037,1024.768518518518,29.279100529100514,0
2662,4,0,0,38,0.0,0.0,1.0,38,1100,800,300,0.7272727272727273,14,8,6,376.57887664606244,0.7631578947368421,0.0006471095772213609,0.20883010432190752,129201.38888888898,2176.2613597393733,131377.65024862834,2631,6,758.9736842105264,34,4,19,36.26195355191254,0.616421568627451,45.833333333333336,1016.6666666666674,29.901960784313747,7
2663,4,0,0,38,0.0,0.0,1.0,38,1350,1200,150,0.8888888888888888,15,12,3,369.33119796083764,0.7635727833096254,0.0018530604633819614,0.20540636576245613,129315.90374157949,1952.0795288531913,131267.98327043268,2632,7,759.9736842105264,36,2,19,36.32939363743727,0.6134259259259258,45.72072072072073,1017.1171171171177,28.25325325325327,0
2664,4,1,1,38,0.02564102564102564,0.02564102564102564,0.9743589743589743,39,1200,800,400,0.6666666666666666,16,8,8,358.61370066943226,0.774403958614485,-0.009495653806128379,0.20127871090745347,129675.59880203518,1500.6892745844825,131176.28807661968,2633,0,741.4615384615385,37,2,17,36.235847956364175,0.6151463963963963,45.36732456140351,1018.5307017543855,27.527856804172583,0
2665,4,2,2,38,0.05,0.05,0.95,40,1400,1000,400,0.7142857142857143,18,10,8,355.62223907909714,0.7834134615384616,-0.016121348549890113,0.20205520555886117,130153.54624379062,1257.0991078603233,131410.64535165095,2634,0,723.875,38,2,17,35.826527763235966,0.6181469298245614,44.89850427350427,1020.4059829059828,26.852789023841652,0
2666,4,0,1,37,0.0,0.02631578947368421,0.9736842105263158,38,550,100,450,0.18181818181818182,10,1,9,370.1523031167294,0.7638691322901849,-0.01041933158127284,0.20889143689604994,129889.2389010635,2015.7601858615683,131904.99908692506,2635,10,762.9736842105264,36,2,17,35.72460966268966,0.6192129629629628,45.15765765765767,1019.3693693693715,28.315815815815874,0
2667,4,1,0,38,0.02631578947368421,0.0,1.0,38,1100,800,300,0.7272727272727273,14,8,6,369.4635149167748,0.7721076339497392,0.003942723091931111,0.21035284542749055,130233.84871357858,2023.3311013716575,132257.17981495024,2636,0,756.3421052631579,36,2,18,35.39184318917329,0.6226851851851851,44.81981981981983,1020.7207207207218,28.353353353353384,0
2668,4,0,0,38,0.0,0.0,1.0,38,900,600,300,0.6666666666666666,12,6,6,371.3263615147989,0.7715149359886202,-0.0021379802560526073,0.21208105349573822,130356.43029423786,2080.965303443765,132437.39559768164,2637,1,757.3421052631579,33,5,18,35.21978379135166,0.6303661616161615,44.69975490196079,1021.2009803921574,30.9454842543078,0
2669,4,1,1,38,0.02564102564102564,0.02564102564102564,0.9743589743589743,39,550,300,250,0.5454545454545454,8,3,5,369.8501788108316,0.7791835357624831,0.03958440239912164,0.20832651890108322,129815.23762119132,1802.4377693136557,131617.67539050497,2638,0,738.8974358974359,37,2,16,35.80759988523063,0.616554054054054,45.23026315789475,1019.0789473684225,27.54267425320061,5
2670,4,1,0,39,0.02564102564102564,0.0,1.0,39,550,300,250,0.5454545454545454,8,3,5,366.1750491386284,0.7774966261808367,0.052043010752688135,0.20714281976820245,129982.90339335198,1719.299207448464,131702.20260080043,2639,0,739.8205128205128,37,2,17,35.73073476702508,0.6182432432432431,45.06578947368422,1019.7368421052646,27.56045519203418,0
2671,4,2,0,41,0.04878048780487805,0.0,1.0,41,1100,500,600,0.45454545454545453,17,5,12,346.57714395226014,0.8008130081300813,0.03320584362655943,0.18776951113848098,128276.40109592023,714.0647167277536,128990.46581264798,2640,0,704.6829268292682,39,2,16,37.96754498714651,0.5974893162393162,46.74479166666667,1013.0208333333342,25.974893162393183,5
2672,4,2,2,41,0.046511627906976744,0.046511627906976744,0.9534883720930233,43,950,500,450,0.5263157894736842,14,5,9,333.9530963786003,0.8157069029162052,0.03813680692900534,0.1830836107155992,128747.9184382086,-0.846797052152624,128747.07164115644,2641,0,672.8604651162791,41,2,14,37.80669599217986,0.5990853658536586,46.279761904761905,1014.8809523809522,24.75319396051103,0
2673,4,0,0,41,0.0,0.0,1.0,41,1150,700,450,0.6086956521739131,16,7,9,351.9514784318499,0.7996443089430895,0.05213703558543603,0.18856208347772618,127828.3203125,797.8732638888891,128626.19357638889,2642,2,706.6829268292682,39,2,14,38.289726685894784,0.592948717948718,47.1875,1011.25,25.92948717948718,1
2674,4,0,1,40,0.0,0.024390243902439025,0.975609756097561,41,850,500,350,0.5882352941176471,12,5,7,351.7619453466641,0.7993394308943089,0.056521269568580834,0.188831412452264,127907.33642578126,798.5866970486117,128705.92312282987,2643,3,707.6829268292682,39,2,14,38.213645179006605,0.59375,47.109375,1011.5625000000001,25.937500000000004,0
2675,4,2,1,41,0.047619047619047616,0.023809523809523808,0.9761904761904762,42,700,500,200,0.7142857142857143,9,5,4,350.85761059642067,0.8060152922957801,0.0898165717900059,0.19062057812815833,128388.0362426035,609.6233781743003,128997.6596207778,2644,0,691.6904761904761,38,4,14,37.74509803921566,0.600328947368421,46.63461538461538,1013.4615384615381,26.67004048582995,0
2676,4,2,1,42,0.046511627906976744,0.023255813953488372,0.9767441860465116,43,1350,1000,350,0.7407407407407407,17,10,7,355.22436838878866,0.810077519379845,0.12324698776499465,0.19554389426438729,128910.32036675343,558.417426215273,129468.73779296869,2645,0,676.5581395348837,39,4,15,37.10134800150443,0.6038995726495726,46.119791666666664,1015.5208333333329,26.038995726495717,0
2677,4,0,0,42,0.0,0.0,1.0,42,900,600,300,0.6666666666666666,12,6,6,356.5941376709755,0.8054103755323267,0.1221093088398153,0.19599271777254348,128848.62075617272,789.3325617283838,129637.9533179011,2646,1,693.6666666666666,38,4,15,37.12950296397628,0.6049890350877194,46.18055555555555,1015.2777777777768,26.717836257309916,0
2678,4,2,1,43,0.045454545454545456,0.022727272727272728,0.9772727272727273,44,1350,1000,350,0.7407407407407407,17,10,7,343.7217434434869,0.8175651867512334,0.1313743736578381,0.19179552468068028,129445.8954840565,99.63828164949479,129545.53376570599,2647,0,663.0909090909091,38,6,15,36.848425196850386,0.6110197368421053,45.592948717948715,1017.6282051282049,26.77968960863697,0
2679,4,3,2,44,0.06521739130434782,0.043478260869565216,0.9565217391304348,46,1500,1100,400,0.7333333333333333,19,11,8,333.22725899324337,0.8317632850241546,0.15736237369909545,0.189105056700575,130107.01844346964,-528.9589736598416,129578.0594698098,2648,0,635.195652173913,40,6,17,36.44494803599299,0.6143229166666666,44.94410569105692,1020.2235772357735,25.50558943089434,0
2680,4,0,0,44,0.0,0.0,1.0,44,1100,600,500,0.5454545454545454,16,6,10,340.70954810989895,0.8242820648343905,0.15676943077351613,0.192806154681845,129996.88042534752,58.235677083368074,130055.1161024309,2649,1,655.9090909090909,39,5,17,36.365764385427305,0.6148504273504272,45.05208333333335,1019.7916666666691,26.148504273504336,0
2681,4,1,0,45,0.022222222222222223,0.0,1.0,45,1300,1200,100,0.9230769230769231,14,12,2,336.4902264293405,0.8296717171717172,0.1706915116687635,0.1921149498943992,130342.35161675385,-227.94325086801757,130114.40836588583,2650,0,642.3111111111111,39,6,18,36.12340184977387,0.6183226495726494,44.713541666666686,1021.1458333333363,26.183226495726572,0
2682,4,0,0,45,0.0,0.0,1.0,45,1350,1000,350,0.7407407407407407,17,10,7,336.544352604637,0.82996632996633,0.17049499790399159,0.19267311535281267,130448.74267578151,-219.64246961802672,130229.10020616348,2651,1,643.3111111111111,39,6,18,36.014347744808134,0.6193910256410255,44.609375000000014,1021.562500000002,26.19391025641031,0
2683,4,0,1,44,0.0,0.022222222222222223,0.9777777777777777,45,1150,800,350,0.6956521739130435,15,8,7,341.7874613955012,0.8305555555555556,0.14260571240586017,0.18210050830519758,127604.23657909651,-196.38346746530783,127407.85311163121,2652,2,644.3111111111111,38,7,16,38.7759507948257,0.5923793859649122,47.40918803418804,1010.3632478632492,26.588506522717083,8
2684,4,1,0,45,0.022222222222222223,0.0,1.0,45,1050,800,250,0.7619047619047619,13,8,5,346.0128401643874,0.8342592592592593,0.17271946990764575,0.1855018589263413,127854.65630425366,-152.12944878470262,127702.52685546895,2653,0,645.1777777777778,39,6,17,38.41292014282281,0.593215811965812,47.16145833333334,1011.3541666666682,25.93215811965816,0
2685,4,2,1,46,0.0425531914893617,0.02127659574468085,0.9787234042553191,47,1550,1200,350,0.7741935483870968,19,12,7,338.8486425971561,0.8430080172679617,0.1831068772238298,0.1840680314811689,128381.94580078135,-698.9339192708173,127683.01188151054,2654,0,618.6808510638298,39,8,17,38.05557696919863,0.5985576923076923,46.64062500000001,1013.4375000000008,25.985576923076945,0
2686,4,2,2,46,0.041666666666666664,0.041666666666666664,0.9583333333333334,48,1400,1200,200,0.8571428571428571,16,12,4,331.10227344461583,0.8454491725768322,0.18626126126126175,0.18194233837798204,128840.0226799525,-1068.155116002368,127771.86756395013,2655,0,606.75,40,8,19,37.78528528528529,0.6015625,46.18902439024391,1015.2439024390251,25.381097560975626,0
2687,4,1,0,47,0.02127659574468085,0.0,1.0,47,1050,700,350,0.6666666666666666,14,7,7,344.6237890785425,0.8377274128893,0.20625289202804353,0.18958198058338765,128883.87586805543,-516.7100694444531,128367.16579861098,2656,0,620.531914893617,39,8,20,37.39741485432911,0.6036324786324787,46.14583333333333,1015.4166666666656,26.03632478632476,0
2688,4,0,0,47,0.0,0.0,1.0,47,1150,800,350,0.6956521739130435,15,8,7,341.9886977859959,0.8389608387295713,0.19689740854423365,0.1887615036506405,129016.12548828128,-575.5886501736106,128440.53683810767,2657,1,621.531914893617,39,8,20,37.32964643357598,0.6049679487179487,46.015625,1015.9375000000002,26.049679487179493,0
2689,4,0,0,47,0.0,0.0,1.0,47,1150,700,450,0.6086956521739131,16,7,9,341.7290946929591,0.839577551649707,0.19640752700523723,0.1892566115791237,129149.73416121342,-573.1556530504502,128576.57850816297,2658,2,622.531914893617,40,7,20,37.200268279677374,0.6046875000000002,45.884146341463406,1016.4634146341451,25.41158536585363,0
2690,4,4,3,48,0.0784313725490196,0.058823529411764705,0.9411764705882353,51,1100,600,500,0.5454545454545454,16,6,10,316.7019645056966,0.8523202614379086,0.1893231482154607,0.1786267005166446,129867.2154336427,-1974.1388937618115,127893.07653988089,2659,0,574.6274509803922,42,9,17,37.10904078334441,0.6088789682539684,45.17926356589147,1019.2829457364332,24.26864156515317,0
2691,4,0,0,48,0.0,0.0,1.0,48,1550,1100,450,0.7096774193548387,20,11,9,333.2657426364299,0.8433067375886525,0.19340366581415225,0.18668611084648123,129598.82948133656,-961.8299696180788,128636.99951171849,2660,1,611.5416666666666,39,9,17,36.95918584825234,0.6108440170940173,45.44270833333332,1018.2291666666647,26.10844017094012,0
2692,4,0,0,48,0.0,0.0,1.0,48,1000,700,300,0.7,13,7,6,346.9260334212555,0.8431220449172576,0.22631284571750698,0.185334116442603,127712.2041990832,-648.3302842953312,127063.87391478787,2661,2,612.5416666666666,38,10,16,38.53561110523904,0.5934758771929824,47.302350427350426,1010.7905982905983,26.59975258659469,6
2693,4,1,1,48,0.02040816326530612,0.02040816326530612,0.9795918367346939,49,1200,900,300,0.75,15,9,6,345.3902043153142,0.8475765306122449,0.23788934968675535,0.185776325842689,127986.37695312513,-958.9518229166504,127027.42513020847,2662,0,601.0204081632653,39,10,17,38.29395717521104,0.5945512820512819,47.03125000000001,1011.875000000001,25.945512820512846,0
2694,4,2,2,48,0.04,0.04,0.96,50,1400,900,500,0.6428571428571429,19,9,10,340.5390196009883,0.8531292517006802,0.24251824442388736,0.18498627145159233,128381.94580078138,-1256.0899522569298,127125.85584852446,2663,0,589.9,39,11,13,38.0127496830781,0.5985576923076923,46.64062500000001,1013.437500000001,25.985576923076948,0
2695,4,2,2,48,0.04,0.04,0.96,50,1450,1200,250,0.8275862068965517,17,12,5,341.1628942971259,0.8564455782312925,0.23576654336210412,0.18569336058722777,128461.13281250013,-1234.7656249999854,127226.36718750015,2664,0,590.86,39,11,15,37.91615289765722,0.5993589743589742,46.56250000000001,1013.750000000001,25.99358974358977,0
2696,4,2,2,48,0.04,0.04,0.96,50,1350,1000,350,0.7407407407407407,17,10,7,340.764206783421,0.8544727891156463,0.23102853623485897,0.18671118686637184,128725.26584201408,-1227.007378472203,127498.25846354188,2665,0,591.82,39,11,16,37.65696639978102,0.6020299145299145,46.30208333333334,1014.7916666666682,26.020299145299184,0
2697,4,1,1,48,0.02040816326530612,0.02040816326530612,0.9795918367346939,49,1000,700,300,0.7,13,7,6,346.5580537524115,0.8491000566893424,0.23687655156849474,0.18943976513409022,128631.77237426031,-884.3246630506303,127747.44771120968,2666,0,604.8775510204082,38,11,16,37.605318588730896,0.602796052631579,46.39423076923077,1014.4230769230766,26.695344129554645,0
2698,4,3,0,51,0.058823529411764705,0.0,1.0,51,850,400,450,0.47058823529411764,13,4,9,336.01598016729383,0.860326797385621,0.25177709556128014,0.1860925710760395,129149.73416121355,-1520.725097494878,127629.00906371867,2667,0,582.0980392156863,40,11,19,37.34544757715122,0.6046875,45.88414634146341,1016.4634146341461,25.411585365853654,0
2699,4,2,4,49,0.03773584905660377,0.07547169811320754,0.9245283018867925,53,1500,1200,300,0.8,18,12,6,300.43151268527964,0.8682571359458151,0.13454599882020468,0.16449277764040734,128696.43814745462,-2867.096554183356,125829.34159327127,2668,0,561.0943396226415,43,10,13,38.70946103593094,0.595687984496124,46.33049242424242,1014.67803030303,23.597163495419302,7
2700,4,0,2,47,0.0,0.04081632653061224,0.9591836734693877,49,1050,600,450,0.5714285714285714,15,6,9,320.5293544358868,0.8534580498866213,0.16600111640688753,0.17510692318689589,128607.98306439626,-1555.4732426135154,127052.50982178275,2669,1,606.8571428571429,40,9,13,38.28962528804728,0.5992187499999999,46.41768292682927,1014.3292682926835,25.35823170731709,0
2701,4,2,1,48,0.04081632653061224,0.02040816326530612,0.9795918367346939,49,750,400,350,0.5333333333333333,11,4,7,313.55040762103187,0.8497023809523809,0.1757004462116909,0.17319762295000452,129046.45568940471,-1707.4862433075289,127338.96944609718,2670,0,601.1224489795918,40,9,16,38.021145895845834,0.6036458333333332,45.98577235772359,1016.0569105691078,25.401422764227696,0
2702,4,1,0,49,0.02040816326530612,0.0,1.0,49,1350,800,550,0.5925925925925926,19,8,11,308.8550006423997,0.8549461451247166,0.18790428094545164,0.17240100203082462,129459.81744497339,-1803.0446493489217,127656.77279562448,2671,0,599.3877551020408,40,9,12,37.721356767192596,0.6078124999999999,45.57926829268293,1017.6829268292696,25.44207317073174,0
2703,4,1,0,50,0.02,0.0,1.0,50,950,600,350,0.631578947368421,13,6,7,314.2671960907624,0.8613775510204081,0.1734916584887145,0.16801588290476732,127743.06047650521,-1968.4280475140024,125774.63242899122,2672,0,588.38,41,9,15,39.32940791625777,0.5889227642276424,47.271825396825385,1010.9126984126967,24.656407278358458,7
2704,4,1,0,51,0.0196078431372549,0.0,1.0,51,1350,900,450,0.6666666666666666,18,9,9,310.9209815496384,0.865686274509804,0.18462080313461393,0.1675962870289497,128072.63082709146,-2235.9063827192826,125836.72444437217,2673,0,577.8235294117648,43,8,16,39.07804362740513,0.589389534883721,46.946022727272705,1012.2159090909051,23.53990486257919,0
2705,4,2,4,49,0.03773584905660377,0.07547169811320754,0.9245283018867925,53,1100,700,400,0.6363636363636364,15,7,8,298.5584483450753,0.8743347847121432,0.1848055878155197,0.16254495384327733,128471.19005298842,-2928.687460502299,125542.50259248611,2674,0,556.9811320754717,41,12,12,38.98569250089702,0.5962906504065042,46.552579365079346,1013.7896825396795,24.72657762291901,0
2706,4,1,0,50,0.02,0.0,1.0,50,1050,700,350,0.6666666666666666,14,7,7,318.91193441679945,0.865,0.1996139647716484,0.17267870075417874,128252.72715547128,-1819.7349377237524,126432.99221774752,2675,0,590.62,38,12,18,38.692296874450626,0.5989583333333335,46.76816239316238,1012.9273504273483,26.65598290598285,0
2707,4,4,4,50,0.07407407407407407,0.07407407407407407,0.9259259259259259,54,1300,900,400,0.6923076923076923,17,9,8,298.096952201081,0.8762665967854647,0.20959015658102675,0.1651069496866047,129153.25574638405,-3099.9616190312454,126053.2941273528,2676,0,547.7962962962963,43,11,15,38.30546239364015,0.6002906976744187,45.880681818181806,1016.4772727272707,23.639006342494667,0
2708,4,2,1,51,0.038461538461538464,0.019230769230769232,0.9807692307692307,52,1350,1000,350,0.7407407407407407,17,10,7,301.75723226080555,0.8665158371040723,0.23274051121998074,0.16787395020998566,129327.494380275,-2594.8896806006114,126732.6046996744,2677,0,569.0769230769231,41,11,17,38.03592038102668,0.6049288617886179,45.709325396825385,1017.1626984126964,24.80884630274869,0
2709,4,0,2,49,0.0,0.0392156862745098,0.9607843137254902,51,1200,500,700,0.4166666666666667,19,5,14,308.8081093877897,0.8634640522875818,0.24044685819971545,0.17169730881961098,129304.72932778094,-2213.930200277624,127090.79912750331,2678,1,581.0588235294117,40,11,17,37.8796962430056,0.6062500000000001,45.731707317073166,1017.0731707317061,25.426829268292654,0
2710,4,1,0,50,0.02,0.0,1.0,50,1150,800,350,0.6956521739130435,15,8,7,313.6666082010714,0.8586904761904761,0.24084997439836164,0.17452731789649348,129333.80126953108,-1886.4610460069596,127447.34022352412,2679,0,592.58,39,11,18,37.72668117426182,0.608173076923077,45.70312499999999,1017.1874999999986,26.081730769230735,0
2711,4,0,0,50,0.0,0.0,1.0,50,1200,800,400,0.6666666666666666,16,8,8,315.37019828627547,0.8571598639455782,0.24284544524053264,0.17606667641468038,129466.28146701366,-1834.0386284722408,127632.24283854142,2680,1,593.58,39,11,16,37.54904469464347,0.6095085470085471,45.57291666666666,1017.7083333333314,26.095085470085422,0
2712,4,0,0,50,0.0,0.0,1.0,50,950,600,350,0.631578947368421,13,6,7,312.2838156023282,0.8574659863945578,0.23877045908183603,0.17500468860935842,129614.99851278994,-1904.6667410271768,127710.33177176277,2681,2,594.58,40,10,16,37.476921157684615,0.609375,45.42682926829268,1018.2926829268288,25.45731707317072,0
2713,4,2,0,52,0.038461538461538464,0.0,1.0,52,1850,1400,450,0.7567567567567568,23,14,9,300.1605296711339,0.8652117898441427,0.2496640913671484,0.17091302808409314,130237.85848957393,-2581.547082507065,127656.31140706687,2682,0,572.6730769230769,42,10,19,37.156271754952215,0.6125992063492064,44.815891472868216,1020.736434108527,24.303248431155403,0
2714,4,0,0,52,0.0,0.0,1.0,52,1000,700,300,0.7,13,7,6,301.11250215699386,0.8650860985419808,0.25286901103072723,0.17178248160412815,130312.05047961374,-2552.2824837749963,127759.76799583875,2683,1,573.6730769230769,42,10,19,37.057116193730046,0.6133432539682538,44.743217054263575,1021.0271317829468,24.310169804355876,0
2715,4,2,3,51,0.037037037037037035,0.05555555555555555,0.9444444444444444,54,1900,1500,400,0.7894736842105263,23,15,8,288.50416811958803,0.8707197763801537,0.2527288117242936,0.16625439274640258,130702.1742822542,-3258.375587455376,127443.79869479882,2684,0,553.3888888888889,45,9,16,36.98613325656243,0.6131944444444444,44.36141304347826,1022.5543478260865,22.72342995169081,0
2716,4,0,0,51,0.0,0.0,1.0,51,900,600,300,0.6666666666666666,12,6,6,303.6337579501977,0.8586274509803923,0.24860914189171623,0.17333112357958724,130336.78583769001,-2285.070383390421,128051.71545429958,2685,3,586.3333333333334,42,9,19,36.96779907635858,0.6135912698412698,44.718992248062015,1021.1240310077517,24.31247692875599,0
2717,4,1,1,51,0.019230769230769232,0.019230769230769232,0.9807692307692307,52,1800,1300,500,0.7222222222222222,23,13,10,298.1895973679128,0.8635935143288084,0.2435719274240673,0.1713875673050721,130601.15089101257,-2611.2190800045732,127989.93181100799,2686,0,576.0384615384615,43,9,16,36.84029707862391,0.6148255813953488,44.46022727272728,1022.1590909090922,23.77114164904866,0
2718,4,0,0,51,0.0,0.0,1.0,51,1200,800,400,0.6666666666666666,16,8,8,302.43329193132536,0.8565359477124184,0.24439165123766649,0.1737508912468202,130584.26852352616,-2301.3939591971675,128282.87456432899,2687,5,588.3333333333334,42,9,16,36.7488702439641,0.6160714285714286,44.47674418604651,1022.0930232558135,24.335548172757463,0
2719,4,0,1,50,0.0,0.0196078431372549,0.9803921568627451,51,1050,600,450,0.5714285714285714,15,6,9,300.4708692745727,0.8560784313725491,0.2429945442923187,0.1730659723026906,130683.32732407907,-2346.693407848089,128336.63391623099,2688,6,589.3333333333334,42,9,16,36.699203942380606,0.6170634920634921,44.37984496124031,1022.4806201550387,24.344776670358062,0
2720,4,1,0,51,0.0196078431372549,0.0,1.0,51,1550,1200,350,0.7741935483870968,19,12,7,321.9061697371345,0.8581699346405229,0.21316278818195222,0.18087651322536047,129719.10609526165,-1688.9265406225652,128030.1795546391,2689,0,590.1960784313726,42,9,14,37.12645454833698,0.607390873015873,45.32461240310077,1018.7015503875965,24.2547988187523,7
2721,4,0,0,51,0.0,0.0,1.0,51,1050,600,450,0.5714285714285714,15,6,9,319.641373427668,0.8577124183006537,0.21639859139790896,0.18021477748569878,129852.06400833618,-1898.781583591595,127953.28242474458,2690,1,591.1960784313726,43,8,16,37.0494789247112,0.6073158914728682,45.19412878787879,1019.2234848484846,23.702871740662435,0
2722,4,2,1,52,0.03773584905660377,0.018867924528301886,0.9811320754716981,53,1600,1200,400,0.75,20,12,8,316.9796555398042,0.8663824383164005,0.21997648507922318,0.1810544812151084,130359.27456381997,-2334.456604396239,128024.81795942373,2691,0,569.8490566037735,43,10,18,36.60438303659743,0.6124031007751938,44.696969696969695,1021.2121212121208,23.749119097956296,0
2723,4,1,0,53,0.018867924528301886,0.0,1.0,53,1600,1500,100,0.9375,17,15,2,324.6308150920094,0.8653846153846153,0.23489018913376758,0.18646835483172203,130576.9531698376,-2122.1394520488966,128454.8137177887,2692,0,570.8301886792453,43,10,11,36.18906158312487,0.6145833333333333,44.483901515151516,1022.064393939394,23.768939393939394,0
2724,4,0,1,52,0.0,0.018867924528301886,0.9811320754716981,53,1650,1400,250,0.8484848484848485,19,14,5,323.1604938271604,0.8656265118529269,0.23378057302585598,0.1864387464387464,130746.38429752072,-2149.5867768595,128596.79752066122,2693,1,571.8301886792453,43,10,13,36.05555555555555,0.6162790697674418,44.31818181818182,1022.7272727272732,23.78435517970403,0
2725,4,0,0,52,0.0,0.0,1.0,52,1050,800,250,0.7619047619047619,13,8,5,334.4689065634959,0.8606711915535444,0.23514598912552254,0.19289534644104583,130732.87080854525,-1654.7839297518126,129078.08687879345,2694,2,583.7884615384615,42,10,14,35.78007548480828,0.6175595238095237,44.33139534883721,1022.6744186046519,24.349390919158377,0
2726,4,0,2,50,0.0,0.038461538461538464,0.9615384615384616,52,1350,900,450,0.6666666666666666,18,9,9,332.6267934843471,0.8602626948215183,0.23793670687764346,0.19214088894213488,130794.8133680558,-1698.8281249999804,129095.98524305581,2695,3,584.7884615384615,43,9,14,35.764596062457564,0.6167635658914727,44.27083333333334,1022.9166666666686,23.788759689922525,0
2727,4,1,2,49,0.0196078431372549,0.0392156862745098,0.9607843137254902,51,950,500,450,0.5263157894736842,14,5,9,337.837153113521,0.8600326797385621,0.2352123795989265,0.19496288415053134,130757.64607182577,-1365.0418206537897,129392.60425117199,2696,0,596.0980392156863,42,9,14,35.66891678509395,0.6178075396825395,44.30717054263567,1022.7713178294587,24.35169804355854,0
2728,4,0,0,49,0.0,0.0,1.0,49,1250,900,350,0.72,16,9,7,348.3305667454766,0.8607568027210885,0.2381044863080206,0.1995054603083939,130465.21183704982,-710.9957640463424,129754.21607300348,2697,5,605.530612244898,41,8,18,35.696656308668345,0.616361788617886,44.593253968253975,1021.6269841269856,24.91773132017038,0
2729,4,0,0,49,0.0,0.0,1.0,49,1000,900,100,0.9,11,9,2,346.2343032059539,0.8601190476190477,0.232376884352421,0.19869412575624135,130541.23682169632,-760.4291658793094,129780.80765581701,2698,6,606.530612244898,41,8,14,35.67321538361971,0.6171239837398372,44.51884920634921,1021.9246031746036,24.924990321331794,0
2730,4,0,0,49,0.0,0.0,1.0,49,1300,1100,200,0.8461538461538461,15,11,4,345.9630967721801,0.859906462585034,0.22980281221399435,0.19866844052101462,130566.58340419517,-765.7560941042898,129800.82731009088,2699,7,607.530612244898,41,8,14,35.65448456610367,0.6173780487804876,44.49404761904763,1022.0238095238108,24.92740998838563,0
2731,4,0,1,48,0.0,0.02040816326530612,0.9795918367346939,49,1550,1100,450,0.7096774193548387,20,11,9,348.15641060236663,0.8594812925170068,0.2304227928439786,0.20084747828202568,130744.07837498431,-696.1221930901874,130047.95618189413,2700,8,608.530612244898,41,8,14,35.41878859895884,0.6191565040650406,44.32043650793651,1022.7182539682544,24.944347657762304,0
2732,4,0,2,46,0.0,0.041666666666666664,0.9583333333333334,48,1350,900,450,0.6666666666666666,18,9,9,354.9173814459273,0.8548500295508275,0.22927847346451946,0.2045348620910037,130703.86860499722,-322.18504197235745,130381.68356302485,2701,9,621.6041666666666,40,8,14,35.28663950175578,0.6203124999999999,44.35975609756098,1022.5609756097576,25.56402439024394,0
2733,4,0,1,45,0.0,0.021739130434782608,0.9782608695652174,46,1300,900,400,0.6923076923076923,17,9,8,369.3610944680093,0.8434782608695652,0.22438610768860046,0.21163571877756598,130480.80490037636,438.9065810139722,130919.71148139033,2702,10,648.8260869565217,38,8,18,35.14369619017742,0.6214364035087718,44.57799145299146,1021.6880341880353,26.886527215474615,0
2734,4,0,0,45,0.0,0.0,1.0,45,1650,1300,350,0.7878787878787878,20,13,7,368.1003732599019,0.8432239057239058,0.21598717680674628,0.21135943400985752,130562.68376981535,612.0345258967261,131174.71829571208,2703,11,647.2222222222222,38,7,15,35.092820057146845,0.6222587719298245,44.49786324786326,1022.0085470085484,26.894961763382852,0
2735,4,0,0,45,0.0,0.0,1.0,45,1000,600,400,0.6,14,6,8,365.47499084567227,0.8429713804713805,0.20958849833021986,0.21038926892377027,130661.65500217052,550.71343315976,131212.36843533028,2704,12,648.2222222222222,39,6,16,35.05953897096282,0.6215277777777777,44.401041666666686,1022.3958333333363,26.215277777777853,0
2736,4,1,2,44,0.021739130434782608,0.043478260869565216,0.9565217391304348,46,1700,1200,500,0.7058823529411765,22,12,10,356.6557203002806,0.8486111111111111,0.20911476655199568,0.2070658830308203,130989.80150910528,143.6524018441653,131133.45391094944,2705,0,635.1086956521739,40,6,16,34.95276150766075,0.6231770833333332,44.08028455284554,1023.6788617886199,25.5919715447155,0
2737,4,0,0,44,0.0,0.0,1.0,44,1200,600,600,0.5,18,6,12,361.0848543277363,0.8437059548978154,0.2009865330410272,0.2092457241140586,130917.78897518087,654.4861522025058,131572.2751273834,2706,14,645.6818181818181,38,6,16,34.91230817413092,0.6258223684210527,44.15064102564103,1023.3974358974364,26.931511470985168,0
2738,4,0,0,44,0.0,0.0,1.0,44,1300,1000,300,0.7692307692307693,16,10,6,359.87378018749905,0.8432434813248767,0.2007306889352818,0.2086919379053415,130945.12473518886,624.7434071152054,131569.86814230407,2707,15,646.6818181818181,38,6,16,34.91562282533056,0.6260964912280702,44.123931623931625,1023.5042735042738,26.934322986954573,0
2739,4,0,0,44,0.0,0.0,1.0,44,650,400,250,0.6153846153846154,9,4,5,363.62531735058514,0.8433095489781537,0.20306525225114114,0.21101721172234744,130972.46334876544,724.980709876542,131697.44405864197,2708,16,647.6818181818181,38,6,16,34.79194934418815,0.6263706140350876,44.09722222222222,1023.6111111111112,26.93713450292398,0
2740,4,0,0,44,0.0,0.0,1.0,44,1200,1000,200,0.8333333333333334,14,10,4,358.77886905476566,0.8435077519379846,0.20559801625306995,0.20909501626918156,131136.55495516464,609.8049757104124,131746.35993087504,2709,17,648.6818181818181,38,6,16,34.749965230694336,0.6280153508771931,43.936965811965806,1024.252136752136,26.95400359874042,0
2741,4,2,4,42,0.043478260869565216,0.08695652173913043,0.9130434782608696,46,1100,500,600,0.45454545454545453,17,5,12,340.68319945588536,0.8499798711755234,0.19845893131388004,0.20122367392322435,131648.6328125,-229.76468902951277,131418.86812347049,2710,0,621.4347826086956,39,7,14,34.696846663959946,0.6314102564102565,43.4375,1026.25,26.314102564102566,0
2742,4,0,0,42,0.0,0.0,1.0,42,1000,500,500,0.5,15,5,10,362.2826022298801,0.8389227642276422,0.18795182564306367,0.21203853995257896,131300.02891514683,1113.543229647568,132413.5721447944,2711,19,644.3333333333334,37,5,17,34.494913697799646,0.6314752252252254,43.777412280701746,1024.8903508771918,27.69973921289708,0
2743,4,1,1,42,0.023255813953488372,0.023255813953488372,0.9767441860465116,43,1150,500,650,0.43478260869565216,18,5,13,356.7644277809897,0.843484680693983,0.18026984300585602,0.21019445757675928,131553.00188519535,786.6892938211631,132339.69117901652,2712,0,630.3255813953489,37,6,18,34.3807895111871,0.6340090090090091,43.53070175438596,1025.8771929824554,27.726410621147444,0
2744,4,1,1,42,0.023255813953488372,0.023255813953488372,0.9767441860465116,43,1500,1100,400,0.7333333333333333,19,11,8,350.37730598437946,0.8400239940937615,0.17468238027248728,0.20759099324968458,131766.52444480962,633.5999707794472,132400.12441558906,2713,0,631.3023255813954,38,5,15,34.3292577176552,0.6343201754385965,43.32264957264957,1026.709401709401,27.018668466036868,0
2745,4,0,0,42,0.0,0.0,1.0,42,750,400,350,0.5333333333333333,11,4,7,348.4995350084219,0.8368176538908246,0.2287595889419598,0.1966312278838175,129881.14458917742,652.7036991379905,130533.8482883154,2714,22,647.3333333333334,38,4,18,36.2846312406107,0.6154057017543859,45.16559829059829,1019.3376068376067,26.824673864147545,6
2746,4,1,1,42,0.023255813953488372,0.023255813953488372,0.9767441860465116,43,750,500,250,0.6666666666666666,10,5,5,341.9747498554466,0.842515688445921,0.22683618837328035,0.19418218404835355,130129.69970703124,300.21430121527646,130429.91400824652,2715,0,633.2558139534884,39,4,19,36.19884720095286,0.6161858974358975,44.921875,1020.3124999999999,26.16185897435897,0
2747,4,1,1,42,0.023255813953488372,0.023255813953488372,0.9767441860465116,43,850,500,350,0.5882352941176471,12,5,7,339.58051717009096,0.8399778516057586,0.2248571402109789,0.19335298834786796,130236.65229030327,245.16594784849246,130481.81823815177,2716,0,634.2325581395348,40,3,19,36.15155814416567,0.6156250000000001,44.8170731707317,1020.7317073170723,25.518292682926806,0
2748,4,1,0,43,0.023255813953488372,0.0,1.0,43,1200,700,500,0.5833333333333334,17,7,10,342.2979748868335,0.840531561461794,0.23434570397832966,0.19573392486622776,130402.54122662722,327.3129022796357,130729.85412890685,2717,0,635.2093023255813,37,6,20,35.91418411164789,0.6224662162162162,44.65460526315788,1021.3815789473667,27.60490753911802,0
2749,4,0,0,43,0.0,0.0,1.0,43,1200,800,400,0.6666666666666666,16,8,8,342.92683100113686,0.8403008490217793,0.23166340461226076,0.1967663550405444,130535.38795976709,352.81738530938173,130888.20534507647,2718,1,636.2093023255813,38,5,16,35.76363477957833,0.6219846491228069,44.524572649572654,1021.9017094017104,26.89215024741343,0
2750,4,1,1,43,0.022727272727272728,0.022727272727272728,0.9772727272727273,44,1700,1400,300,0.8235294117647058,20,14,6,334.44049492065346,0.8432875264270614,0.22138561184362704,0.19385710103807788,130928.03955078124,-42.47233072916623,130885.56722005206,2719,0,622.7272727272727,39,5,17,35.583651399491096,0.624198717948718,44.140625,1023.4374999999999,26.241987179487175,0
2751,4,0,0,43,0.0,0.0,1.0,43,800,500,300,0.625,11,5,6,345.5723954212331,0.8403469915097822,0.22513725956810315,0.19997261818423867,130863.1260158704,444.536785923005,131307.6628017934,2720,3,638.2093023255813,38,5,17,35.364458250670026,0.6252741228070176,44.20405982905983,1023.1837606837605,26.92588843904633,0
2752,4,0,0,43,0.0,0.0,1.0,43,850,500,350,0.5882352941176471,12,5,7,347.0342807682793,0.8406699889258028,0.2281925148232138,0.20096096379677034,130890.45606874142,484.69505624955525,131375.15112499098,2721,4,639.2093023255813,38,5,17,35.299427507482434,0.625548245614035,44.17735042735043,1023.2905982905991,26.928699955015766,0
2753,4,0,0,43,0.0,0.0,1.0,43,1350,900,450,0.6666666666666666,18,9,9,346.92694493402746,0.8399317091177556,0.22470921361710605,0.20193243313477943,131088.00048828125,495.59190538194446,131583.5923936632,2722,5,640.2093023255813,39,4,17,35.10250313633744,0.625801282051282,43.984375,1024.0625,26.25801282051282,0
2754,4,0,0,43,0.0,0.0,1.0,43,1550,1200,350,0.7741935483870968,19,12,7,350.6024182136543,0.8390550018456995,0.2328843212937597,0.20520982705557106,131301.43364800367,606.9200303819689,131908.35367838564,2723,6,641.2093023255813,39,4,18,34.79276772707255,0.6279380341880341,43.77604166666668,1024.895833333335,26.279380341880387,0
2755,4,0,0,43,0.0,0.0,1.0,43,900,600,300,0.6666666666666666,12,6,6,349.922769121055,0.8380398671096345,0.22771651024666095,0.20539503457215708,131410.26925131507,596.6917741463428,132006.9610254614,2724,7,642.2093023255813,38,5,19,34.70029696780243,0.6307565789473684,43.6698717948718,1025.320512820514,26.98211875843458,0
2756,4,0,0,43,0.0,0.0,1.0,43,1200,900,300,0.75,15,9,6,351.427734375,0.8380398671096345,0.22363372093023237,0.20672219669117647,131492.4391847469,642.017998027616,132134.45718277452,2725,8,643.2093023255813,38,5,19,34.57877604166667,0.631578947368421,43.58974358974359,1025.6410256410259,26.990553306342786,0
2757,4,0,0,43,0.0,0.0,1.0,43,1100,1000,100,0.9090909090909091,12,10,2,351.6915925535089,0.8379475821336286,0.22441460797445978,0.207025811165312,131519.83486969466,650.8840355394841,132170.71890523416,2726,9,644.2093023255813,38,5,19,34.54436169843419,0.6318530701754386,43.56303418803419,1025.7478632478633,26.99336482231219,0
2758,4,0,0,43,0.0,0.0,1.0,43,1150,800,350,0.6956521739130435,15,8,7,353.8680735533419,0.8367017349575488,0.2209520212657785,0.20905637850881933,131656.85609796183,717.8316074950601,132374.6877054569,2727,10,645.2093023255813,38,5,16,34.35027586924837,0.6332236842105263,43.429487179487175,1026.282051282051,27.00742240215924,0
2759,4,0,0,43,0.0,0.0,1.0,43,1050,800,250,0.7619047619047619,13,8,5,351.92486085343273,0.8362864525655223,0.2239504681365152,0.20844780219780226,131755.55555555542,673.6111111111027,132429.1666666665,2728,11,646.2093023255813,39,4,16,34.30059523809524,0.6324786324786326,43.33333333333333,1026.6666666666656,26.3247863247863,0
2760,4,0,0,43,0.0,0.0,1.0,43,1250,900,350,0.72,16,9,7,349.5179984283008,0.8355481727574751,0.2245388933440262,0.20760526894596634,131862.5217013887,617.6649305555363,132480.18663194423,2729,12,647.2093023255813,39,4,16,34.25456389452333,0.6335470085470087,43.22916666666666,1027.0833333333317,26.335470085470043,0
2761,4,0,0,43,0.0,0.0,1.0,43,800,500,300,0.625,11,5,6,348.92343790671043,0.8352251753414544,0.22370102767022138,0.20754420655223016,131916.02105034713,605.7183159722125,132521.73936631935,2730,13,648.2093023255813,39,4,16,34.21592983167715,0.6340811965811967,43.17708333333333,1027.2916666666658,26.340811965811945,0
2762,4,0,0,43,0.0,0.0,1.0,43,1250,800,450,0.64,17,8,9,350.35918552081864,0.8323643410852712,0.22425871945745124,0.20943033324681734,132103.35422091995,656.7247178819248,132760.0789388019,2731,14,649.2093023255813,39,4,17,33.99037812003918,0.6359508547008548,42.99479166666666,1028.0208333333317,26.359508547008506,0
2763,4,0,1,42,0.0,0.023255813953488372,0.9767441860465116,43,1000,700,300,0.7,13,7,6,346.7659953400285,0.8324104835732742,0.22479363763145077,0.20772293118912363,132183.68055555536,567.3611111110921,132751.04166666645,2732,15,650.2093023255813,39,4,17,34.00189086980011,0.6367521367521368,42.91666666666666,1028.3333333333317,26.367521367521324,0
2764,4,1,0,43,0.023255813953488372,0.0,1.0,43,950,800,150,0.8421052631578947,11,8,3,351.5648013106994,0.8290420819490587,0.22066711404859696,0.21195089460746416,132425.49332493235,711.4020609613412,133136.8953858937,2733,0,650.8372093023256,38,5,18,33.63521555601685,0.6408991228070176,42.681623931623925,1029.2735042735035,27.086144849302723,0
2765,4,0,0,43,0.0,0.0,1.0,43,950,700,250,0.7368421052631579,12,7,5,348.11321530631113,0.8288575119970468,0.21171042916363092,0.21048401311933645,132535.48127145867,627.4705055153605,133162.95177697402,2734,1,651.8372093023256,38,5,19,33.61347444144705,0.6419956140350878,42.57478632478632,1029.7008547008534,27.09739091318035,0
2766,4,0,0,43,0.0,0.0,1.0,43,1050,700,350,0.6666666666666666,14,7,7,347.7023011998104,0.828719084533038,0.21007165096262148,0.21100650034422713,132673.03040990932,626.143596135573,133299.1740060449,2735,2,652.8372093023256,38,5,14,33.485861937847844,0.6433662280701755,42.44123931623931,1030.235042735042,27.11144849302742,0
2767,4,0,0,43,0.0,0.0,1.0,43,1150,800,350,0.6956521739130435,15,8,7,348.7859445784124,0.8278885197489848,0.20889001410539287,0.2119748226502071,132728.07004026952,658.7370562130133,133386.80709648255,2736,3,653.8372093023256,38,5,15,33.40266977708658,0.6439144736842106,42.38782051282051,1030.4487179487176,27.117071524966253,0
2768,4,0,1,42,0.0,0.023255813953488372,0.9767441860465116,43,1350,1000,350,0.7407407407407407,17,10,7,344.13761348298306,0.826734957548911,0.20720130301949702,0.21022887628719963,132920.79863393973,548.6092848272435,133469.40791876698,2737,4,654.8372093023256,38,5,15,33.329016438734634,0.6458333333333333,42.200854700854705,1031.196581196582,27.136752136752158,0
2769,4,0,0,42,0.0,0.0,1.0,42,800,400,400,0.5,12,4,8,352.4062179030577,0.8214043747580333,0.21699985821636192,0.21519662812729612,132906.30290089283,967.4015081563819,133873.7044090492,2738,46,671.3333333333334,37,5,15,33.130405501205175,0.6475225225225224,42.21491228070177,1031.1403508771948,27.868658131816076,0
2770,4,0,0,42,0.0,0.0,1.0,42,600,500,100,0.8333333333333334,7,5,2,355.3170843167195,0.8205332946186604,0.22172619047619024,0.217631714143991,133019.39058171766,1052.8124038165793,134072.20298553424,2739,47,672.3333333333334,37,5,15,32.94182256235827,0.6486486486486486,42.10526315789475,1031.5789473684226,27.88051209103845,0
2771,4,0,0,42,0.0,0.0,1.0,42,950,700,250,0.7368421052631579,12,7,5,353.20943776612637,0.8194202477739063,0.2234473094453968,0.21716266738684212,133160.81781173073,1006.7315183518172,134167.54933008255,2740,48,673.3333333333334,37,5,15,32.85427511597436,0.6500563063063062,41.96820175438597,1032.1271929824577,27.895329540066424,0
2772,4,0,0,42,0.0,0.0,1.0,42,1050,900,150,0.8571428571428571,12,9,3,355.8246648253695,0.8194928377855207,0.22917077611713865,0.2191032844559095,133217.40974386354,1080.4080342028394,134297.81777806638,2741,49,674.3333333333334,37,5,15,32.730018587360604,0.6506193693693694,41.91337719298246,1032.3464912280706,27.901256519677585,0
2773,4,1,0,43,0.023255813953488372,0.0,1.0,43,1200,700,500,0.5833333333333334,17,7,10,348.5568181208951,0.8227667035806571,0.23228966684058272,0.21712677774667966,133646.8288389741,717.189611082498,134364.01845005658,2742,0,659.6279069767442,36,7,19,32.48747549553473,0.6568287037037037,41.497747747747745,1034.0090090090089,28.722472472472468,0
2774,4,0,0,43,0.0,0.0,1.0,43,1450,1000,450,0.6896551724137931,19,10,9,345.3959238325125,0.8230435585086747,0.23296158612143714,0.216073263978944,133803.62426035517,643.0452827087606,134446.66954306394,2743,1,660.6279069767442,38,5,13,32.41235543163983,0.6546052631578947,41.346153846153854,1034.6153846153857,27.226720647773305,0
2775,4,0,0,43,0.0,0.0,1.0,43,850,700,150,0.8235294117647058,10,7,3,346.7609311424791,0.8216592838685861,0.23733988823382535,0.21757900912618788,133914.18292059333,687.2413525458524,134601.4242731392,2744,2,661.6279069767442,38,5,15,32.2665066749243,0.6557017543859648,41.239316239316246,1035.0427350427362,27.237966711650955,0
2776,4,0,0,43,0.0,0.0,1.0,43,1200,900,300,0.75,15,9,6,346.4194998514316,0.8210132890365448,0.23934048527611784,0.2176916312295962,133969.4793721236,681.9280078895488,134651.40738001314,2745,3,662.6279069767442,38,5,16,32.22007223942209,0.65625,41.18589743589744,1035.2564102564104,27.243589743589748,0
2777,4,0,0,43,0.0,0.0,1.0,43,1150,800,350,0.6956521739130435,15,8,7,345.7204132429467,0.8205518641565153,0.2329180623674283,0.21757936656822344,134024.78723792834,667.0209657389241,134691.80820366726,2746,4,663.6279069767442,38,5,17,32.18289998624295,0.656798245614035,41.13247863247864,1035.4700854700861,27.249212775528584,0
2778,4,0,0,43,0.0,0.0,1.0,43,1050,700,350,0.6666666666666666,14,7,7,348.0072058538384,0.8199981543004798,0.23488971778787882,0.21951397922921068,134107.77043839963,734.0940947111078,134841.86453311073,2747,5,664.6279069767442,38,5,18,32.04078562833076,0.6576206140350875,41.05235042735044,1035.7905982906,27.257647323436842,0
2779,4,0,0,43,0.0,0.0,1.0,43,1100,900,200,0.8181818181818182,13,9,4,346.7288361429729,0.8193521594684385,0.2364568871880819,0.21936875288654262,134218.45465565438,707.4817143326977,134925.9363699871,2748,6,665.6279069767442,38,5,19,31.963346736776995,0.6587171052631577,40.94551282051283,1036.2179487179503,27.26889338731448,0
2780,4,0,0,43,0.0,0.0,1.0,43,350,200,150,0.5714285714285714,5,2,3,346.46912530555807,0.8193983019564415,0.237175737233277,0.21937013808511227,134246.13284388953,702.4280444152558,134948.56088830478,2749,7,666.6279069767442,38,5,19,31.94243986254296,0.6589912280701753,40.918803418803435,1036.3247863247886,27.27170490328391,0
2781,4,0,0,43,0.0,0.0,1.0,43,1000,700,300,0.7,13,7,6,344.7216853913793,0.8185215946843853,0.2360950361237908,0.21909128727723248,134384.56658859327,665.0548570019981,135049.62144559526,2750,8,667.6279069767442,38,5,20,31.849562081401345,0.660361842105263,40.78525641025642,1036.8589743589762,27.285762483130952,0
2782,4,0,0,43,0.0,0.0,1.0,43,1100,700,400,0.6363636363636364,15,7,8,343.73346089107264,0.8190291620524178,0.23613632553349473,0.2192938176906911,134523.07167251094,648.0161991380136,135171.08787164895,2751,9,668.6279069767442,38,5,20,31.73704085135598,0.6617324561403508,40.65170940170941,1037.3931623931637,27.299820062977993,0
2783,4,0,0,43,0.0,0.0,1.0,43,1000,900,100,0.9,11,9,2,342.00784167291783,0.8178294573643411,0.2265245092288204,0.21869138684457223,134606.2089656842,607.2758008254856,135213.48476650967,2752,10,669.6279069767442,38,5,20,31.698925838223676,0.6625548245614035,40.5715811965812,1037.7136752136757,27.308254610886205,0
2784,4,0,0,43,0.0,0.0,1.0,43,750,400,350,0.5333333333333333,11,4,7,342.7059891883813,0.816906607604282,0.22715882737278958,0.2198068710853797,134717.0986398751,633.6713099934306,135350.76994986853,2753,11,670.6279069767442,38,5,20,31.570314912009874,0.6636513157894737,40.46474358974359,1038.1410256410259,27.319500674763837,0
2785,4,0,0,43,0.0,0.0,1.0,43,1400,1100,300,0.7857142857142857,17,11,6,343.05936595031244,0.8162144702842377,0.23062015503875966,0.22053816382520075,134800.2958579881,648.9008053911804,135449.19666337926,2754,12,671.6279069767442,38,5,16,31.478266460905342,0.6644736842105263,40.38461538461538,1038.4615384615379,27.32793522267205,0
2786,4,0,1,42,0.0,0.023255813953488372,0.9767441860465116,43,1200,800,400,0.6666666666666666,16,8,8,344.7542991184554,0.8147840531561461,0.23373504351195762,0.22196697324699502,134855.77493790642,698.4216341588248,135554.19657206524,2755,13,672.6279069767442,38,5,16,31.37900294863882,0.6650219298245613,40.331196581196586,1038.6752136752143,27.333558254610903,0
2787,4,0,0,42,0.0,0.0,1.0,42,1150,800,350,0.6956521739130435,15,8,7,346.74700173426965,0.8141937669376694,0.2310498703491528,0.22382660684154893,134949.2391889812,958.6488150200045,135907.88800400123,2756,14,677.5714285714286,37,5,17,31.234170536091177,0.6677927927927928,40.24122807017544,1039.0350877192982,28.08202939781887,0
2788,4,0,0,42,0.0,0.0,1.0,42,800,600,200,0.75,10,6,4,345.4657618753855,0.81431475029036,0.23097147557357323,0.22310756972111542,134966.7673405654,925.2794214332594,135892.04676199864,2757,15,678.5714285714286,38,4,17,31.25,0.6661184210526316,40.22435897435897,1039.1025641025637,27.34480431848852,0
2789,4,0,0,42,0.0,0.0,1.0,42,1250,900,350,0.72,16,9,7,344.99240559446946,0.8125483933410763,0.23385297398860927,0.22383107274969175,135133.34155161073,923.9953155818499,136057.3368671926,2758,16,679.5714285714286,38,4,17,31.096511508425827,0.6677631578947368,40.06410256410256,1039.7435897435894,27.361673414304985,0
2790,4,0,1,41,0.0,0.023809523809523808,0.9761904761904762,42,950,600,350,0.631578947368421,13,6,7,346.327094455499,0.8116289198606271,0.23392808232578188,0.22539041387825756,135244.448097012,967.763350135124,136212.21144714713,2759,17,680.5714285714286,38,4,19,30.951280471103797,0.6688596491228072,39.95726495726495,1040.1709401709386,27.372919478182595,0
2791,4,0,0,41,0.0,0.0,1.0,41,750,500,250,0.6666666666666666,10,5,5,355.2194569499722,0.8063008130081301,0.2412630138325429,0.23020066106238443,135091.68836805542,1397.4392361110922,136489.1276041665,2760,68,697.7560975609756,37,4,19,30.872160988643945,0.6692004504504505,40.10416666666666,1039.5833333333321,28.096846846846812,0
2792,4,0,0,41,0.0,0.0,1.0,41,900,600,300,0.6666666666666666,12,6,6,355.72911644471526,0.8047256097560975,0.24780590663049518,0.23126049825072822,135205.70181450062,1419.3209689519904,136625.02278345262,2761,69,698.7560975609756,37,4,19,30.745365489369185,0.6703265765765766,39.99451754385965,1040.0219298245615,28.10870080606923,0
2793,4,0,0,41,0.0,0.0,1.0,41,1500,1300,200,0.8666666666666667,17,13,4,350.8819957031659,0.8007621951219512,0.2423248966504199,0.22956049519022434,135433.87298255242,1304.2615275854164,136738.13451013784,2762,70,699.7560975609756,37,4,19,30.64440025984058,0.6725788288288288,39.77521929824562,1040.899122807018,28.132408724514004,0
2794,4,0,0,41,0.0,0.0,1.0,41,1150,700,450,0.6086956521739131,16,7,9,348.47999999999985,0.7998475609756097,0.23317073170731661,0.22926315789473684,135633.68055555562,1253.1250000000039,136886.80555555562,2763,71,700.7560975609756,37,4,20,30.508333333333336,0.6745495495495495,39.583333333333336,1041.6666666666672,28.153153153153166,0
2795,4,0,0,41,0.0,0.0,1.0,41,1250,1000,250,0.8,15,10,5,349.1580194924955,0.7992378048780487,0.23753351894381658,0.23062869876832318,135776.49042253388,1281.4900979147426,137057.98052044862,2764,72,701.7560975609756,37,4,20,30.34882956338768,0.6759572072072071,39.44627192982456,1042.2149122807018,28.16797060218113,0
2796,4,0,0,41,0.0,0.0,1.0,41,1250,1100,150,0.88,14,11,3,346.45757645533394,0.7974085365853658,0.23238966929004579,0.2293954482546878,135862.2124115113,1214.0985687904035,137076.31098030173,2765,73,702.7560975609756,37,4,20,30.33410461365867,0.6768018018018017,39.3640350877193,1042.5438596491233,28.176861071597926,0
2797,4,0,0,41,0.0,0.0,1.0,41,1050,600,450,0.5714285714285714,15,6,9,347.5139892195063,0.7958333333333333,0.23485001961784957,0.23064937553850132,135947.9614520814,1248.7636820944892,137196.72513417588,2766,74,703.7560975609756,37,4,15,30.221476010233754,0.6776463963963963,39.281798245614034,1042.8728070175437,28.185751541014692,0
2798,4,0,0,41,0.0,0.0,1.0,41,1000,900,100,0.9,11,9,2,346.4723852300838,0.7958841463414634,0.23070868362420582,0.23032786867182303,136005.1425077909,1224.4052256463547,137229.54773343727,2767,75,704.7560975609756,37,4,16,30.191908441080635,0.6782094594594594,39.22697368421053,1043.0921052631581,28.191678520625896,0
2799,4,0,1,40,0.0,0.024390243902439025,0.975609756097561,41,950,600,350,0.631578947368421,13,6,7,346.2580332032512,0.7951219512195122,0.23009992975691818,0.23037055439830303,136033.73754424442,1220.5548822714736,137254.2924265159,2768,76,705.7560975609756,37,4,16,30.169136710812143,0.6784909909909909,39.199561403508774,1043.2017543859652,28.19464201043149,0
2800,4,0,0,40,0.0,0.0,1.0,40,1150,1000,150,0.8695652173913043,13,10,3,348.6032249933629,0.7961538461538461,0.23132556131260795,0.23200145663351404,136044.5580715852,1485.1143373102907,137529.67240889548,2769,77,718.325,36,4,17,30.09724021301094,0.6805555555555556,39.18918918918919,1043.2432432432438,28.978978978978994,0
2801,4,0,0,40,0.0,0.0,1.0,40,600,400,200,0.6666666666666666,8,4,4,347.38565278071326,0.7960202991452991,0.2332829699978416,0.23157377400475485,136103.3055859915,1456.0671313205216,137559.372717312,2770,78,719.325,36,4,17,30.070733506007635,0.6811342592592593,39.13288288288289,1043.4684684684694,28.985235235235262,0
2802,4,0,0,40,0.0,0.0,1.0,40,900,500,400,0.5555555555555556,13,5,8,348.0443740948034,0.7952457264957264,0.23392221383104972,0.23259000025124266,136191.45063560194,1480.1336387062859,137671.58427430823,2771,79,720.325,36,4,19,29.966150609558746,0.6820023148148149,39.04842342342343,1043.806306306307,28.99461961961964,0
2803,4,0,0,40,0.0,0.0,1.0,40,1150,800,350,0.6956521739130435,15,8,7,351.03017269563566,0.7927350427350427,0.24537196765498615,0.2357570493665476,136367.82633562628,1573.8443257446756,137941.67066137094,2772,80,721.325,36,4,20,29.713387241689123,0.6837384259259259,38.87950450450451,1044.4819819819827,29.013388388388407,0
2804,4,0,0,40,0.0,0.0,1.0,40,1500,1200,300,0.8,18,12,6,350.2562648228362,0.7915865384615385,0.24732402716395363,0.2356292508166392,136426.64359883548,1556.8573218488934,137983.50092068437,2773,81,722.325,36,4,20,29.675317092450868,0.6843171296296295,38.823198198198206,1044.7072072072085,29.019644644644682,0
2805,4,0,0,40,0.0,0.0,1.0,40,1200,900,300,0.75,15,9,6,349.8759376941564,0.790357905982906,0.25282027798728546,0.23615989656287042,136544.3161700553,1554.7141313611025,138099.0303014164,2774,82,723.325,36,4,20,29.568697697805558,0.685474537037037,38.71058558558559,1045.1576576576585,29.032157157157183,0
2806,4,0,0,40,0.0,0.0,1.0,40,950,700,250,0.7368421052631579,12,7,5,348.12926380226884,0.7894764957264957,0.25236521921543886,0.2353946383752364,136606.26947714685,1511.3280047707012,138117.59748191756,2775,83,724.325,37,3,21,29.55300328648346,0.6841216216216216,38.651315789473685,1045.3947368421057,28.253911806543396,0
2807,4,0,0,40,0.0,0.0,1.0,40,1150,800,350,0.6956521739130435,15,8,7,346.78221626557837,0.7891559829059829,0.2510513896171995,0.23467483549271057,136634.92763398358,1476.5126048399552,138111.44023882353,2776,84,725.325,37,3,21,29.55984530676455,0.6844031531531531,38.62390350877193,1045.5043859649127,28.25687529634899,0
2808,4,0,0,40,0.0,0.0,1.0,40,950,700,250,0.7368421052631579,12,7,5,337.2384819032218,0.7888087606837607,0.17415983196639306,0.2215315599256514,135579.43250868065,1144.5203993055657,136723.9529079862,2777,85,726.325,39,1,18,30.854920984196845,0.670405982905983,39.63541666666667,1041.4583333333342,26.70405982905985,3
2809,4,0,0,40,0.0,0.0,1.0,40,1000,700,300,0.7,13,7,6,340.7546082249571,0.7881944444444444,0.17882012101322942,0.22435504286303584,135661.50427578727,1245.467398835302,136906.97167462256,2778,86,727.325,38,2,18,30.681895873927456,0.67297149122807,39.55662393162394,1041.7735042735055,27.415092217723828,0
2810,4,0,0,40,0.0,0.0,1.0,40,1050,700,350,0.6666666666666666,14,7,7,339.6088371015349,0.7887019230769231,0.17608160754562197,0.22412345041193327,135744.99255789325,1220.0398129885325,136965.0323708818,2779,87,728.325,38,2,19,30.628887294101553,0.6737938596491228,39.47649572649573,1042.0940170940175,27.42352676563204,0
2811,4,0,1,39,0.0,0.025,0.975,40,1400,900,500,0.6428571428571429,19,9,10,359.3369426043202,0.788301282051282,0.1771914827479022,0.21935236135827277,132893.2574169954,1550.6913625904012,134443.9487795858,2780,88,729.325,38,2,16,32.964848202258835,0.6455592105263158,42.2275641025641,1031.0897435897434,27.13394062078272,7
2812,4,0,0,39,0.0,0.0,1.0,39,1300,1000,300,0.7692307692307693,16,10,6,368.24274515174363,0.785706252811516,0.18899011542005395,0.22520749420658648,132962.84072983995,1992.520294706065,134955.36102454603,2781,89,745.5384615384615,37,2,18,32.66532000850521,0.6480855855855856,42.16008771929825,1031.359649122807,27.874585111427216,0
2813,4,0,0,39,0.0,0.0,1.0,39,550,300,250,0.5454545454545454,8,3,5,371.751999823952,0.7845254161043635,0.19252429644524027,0.22821644294476306,133104.23790252794,2096.353325061584,135200.59122758952,2782,90,746.5384615384615,37,2,18,32.43268072822584,0.6494932432432431,42.02302631578949,1031.907894736844,27.889402560455242,0
2814,4,0,0,39,0.0,0.0,1.0,39,1150,800,350,0.6956521739130435,15,8,7,371.61533367113714,0.7828947368421053,0.19678551811429768,0.22886672844258787,133223.94035585166,2101.611809664714,135325.5521655164,2783,91,747.5384615384615,38,1,18,32.31592155645244,0.6488486842105262,41.90705128205129,1032.3717948717967,27.167678812415705,0
2815,4,1,0,40,0.025,0.0,1.0,40,700,400,300,0.5714285714285714,10,4,6,365.5046826222681,0.7870192307692307,0.19677419354838688,0.22661290322580657,133472.22222222245,1756.9444444444682,135229.16666666692,2784,0,729.825,39,1,19,32.22446236559141,0.6495726495726495,41.66666666666668,1033.333333333335,26.49572649572654,0
2816,4,0,0,40,0.0,0.0,1.0,40,850,600,250,0.7058823529411765,11,6,5,359.1176667061351,0.7850160256410257,0.18753579382755303,0.22350630226878884,133613.88991083813,1596.6216768621323,135210.51158770025,2785,1,730.825,37,3,19,32.247476756107055,0.6545608108108107,41.529605263157904,1033.88157894737,27.942745376955944,0
2817,4,0,0,40,0.0,0.0,1.0,40,950,700,250,0.7368421052631579,12,7,5,357.84849628930556,0.7831463675213676,0.18952545698647083,0.2236957385131924,133775.99172921706,1574.3074959821965,135350.29922519924,2786,2,731.825,38,2,16,32.11793004922716,0.6543311403508771,41.37286324786326,1034.5085470085485,27.223909131803907,0
2818,4,0,0,40,0.0,0.0,1.0,40,1100,800,300,0.7272727272727273,14,8,6,361.34583139280005,0.7832799145299145,0.18962118084227964,0.22673046726252877,133914.18292059313,1677.8663525458387,135592.04927313895,2787,3,732.825,38,2,16,31.8891067987889,0.6557017543859649,41.23931623931624,1035.0427350427346,27.237966711650913,0
2819,4,0,1,39,0.0,0.025,0.975,40,750,400,350,0.5333333333333333,11,4,7,362.7965446300578,0.7831463675213676,0.1910491278769737,0.2278117771173449,133941.82971957422,1718.7266007378273,135660.55632031205,2788,4,733.825,38,2,16,31.823889634293174,0.6559758771929824,41.21260683760684,1035.1495726495734,27.240778227620353,0
2820,4,0,0,39,0.0,0.0,1.0,39,450,300,150,0.6666666666666666,6,3,3,369.80879059560175,0.7767656320287899,0.19622163714565977,0.23157833821172483,133840.7145107148,2099.0945531317257,135939.80906384654,2789,97,753.5384615384615,37,2,16,31.74373476740488,0.6568130630630631,41.310307017543856,1034.7587719298242,27.966453295400655,0
2821,4,0,0,39,0.0,0.0,1.0,39,800,400,400,0.5,12,4,8,369.02048969211535,0.7774403958614485,0.19478706705989102,0.2319767951846172,133982.5775719451,2088.463277162192,136071.0408491073,2790,98,754.5384615384615,37,2,17,31.622008049142142,0.6582207207207207,41.17324561403508,1035.3070175438586,27.98127074442861,0
2822,4,1,0,40,0.025,0.0,1.0,40,750,200,550,0.26666666666666666,13,2,11,364.10015073732336,0.778926282051282,0.20782843894899572,0.2314074631896343,134384.56658859274,1785.8881903352735,136170.45477892802,2791,0,736.65,38,2,18,31.34724368882019,0.6603618421052633,40.785256410256395,1036.858974358972,27.285762483130846,0
2823,4,0,0,40,0.0,0.0,1.0,40,750,500,250,0.6666666666666666,10,5,5,364.7470285615626,0.7789529914529915,0.20888442521631667,0.23234672921756216,134467.66107823787,1809.3359631821004,136276.99704141996,2792,1,737.65,38,2,18,31.247424804285114,0.6611842105263158,40.7051282051282,1037.1794871794862,27.294197031039108,0
2824,4,0,0,40,0.0,0.0,1.0,40,1300,900,400,0.6923076923076923,17,9,8,364.89564650809,0.7794070512820512,0.20809732642925116,0.23315378142512175,134579.22299409425,1821.5001983143072,136400.72319240856,2793,2,738.65,37,3,18,31.13210662580577,0.664132882882883,40.59758771929824,1037.6096491228063,28.043504030346117,0
2825,4,0,0,40,0.0,0.0,1.0,40,700,400,300,0.5714285714285714,10,4,6,375.349454137333,0.7794070512820512,0.22469696969696984,0.22938022197281446,132934.57031249988,1979.3836805555409,134913.95399305542,2794,3,739.65,37,3,16,32.51052188552188,0.6478040540540542,42.18749999999999,1031.249999999999,27.871621621621596,2
2826,4,0,1,39,0.0,0.025,0.975,40,700,300,400,0.42857142857142855,11,3,8,374.1153030981344,0.7794337606837607,0.22411435674331948,0.22887890596383936,132975.88962853368,1949.6630506245747,134925.55267915825,2795,4,740.65,38,2,16,32.50077688004973,0.6463815789473685,42.14743589743589,1031.410256410255,27.142375168690922,0
2827,4,0,0,39,0.0,0.0,1.0,39,900,500,400,0.5555555555555556,13,5,8,379.4624780184183,0.7801394511920828,0.22247296354439228,0.23242076778628115,133019.3905817174,2295.1735149276633,135314.56409664504,2796,5,743.1025641025641,37,2,16,32.31912556689341,0.6486486486486487,42.10526315789473,1031.5789473684206,27.880512091038394,0
2828,4,0,0,39,0.0,0.0,1.0,39,1200,700,500,0.5833333333333334,17,7,10,378.3104858676369,0.7789586144849303,0.21779891378361738,0.23277221659855774,133189.11227493067,2277.36755540165,135466.4798303323,2797,6,744.1025641025641,37,2,18,32.17813894200126,0.6503378378378378,41.940789473684205,1032.2368421052627,27.898293029871965,0
2829,4,0,0,39,0.0,0.0,1.0,39,650,500,150,0.7692307692307693,8,5,3,380.5857761354706,0.7781713900134953,0.21915927938232782,0.23435023429139656,133217.40974386342,2340.1302564250454,135557.54000028846,2798,7,745.1025641025641,37,2,18,32.09096742786334,0.6506193693693694,41.91337719298245,1032.3464912280697,27.90125651967756,0
2830,4,0,0,39,0.0,0.0,1.0,39,1100,900,200,0.8181818181818182,13,9,4,380.0407685220523,0.775472334682861,0.21345657138035845,0.23508628235366116,133387.25767784333,2338.519183787337,135725.77686163067,2799,8,746.1025641025641,37,2,18,31.93430899055303,0.6523085585585584,41.74890350877194,1033.0043859649136,27.919037458511177,0
2831,4,1,0,40,0.025,0.0,1.0,40,1000,700,300,0.7,13,7,6,371.34548091021065,0.783573717948718,0.2137004451982185,0.23200485211304192,133755.6327427673,1933.9370046553083,135689.56974742262,2800,0,728.425,37,3,15,31.789272842908616,0.6559684684684683,41.39254385964914,1034.429824561406,27.957562825983942,0
2832,4,0,0,40,0.0,0.0,1.0,40,1250,800,450,0.64,17,8,9,371.18385815883505,0.7820245726495727,0.2125276827058591,0.23249309249368671,133849.22417534736,1936.5342881944644,135785.75846354183,2801,1,729.425,39,1,15,31.699634252734736,0.6533119658119657,41.30208333333334,1034.7916666666679,26.533119658119688,0
2833,4,0,0,40,0.0,0.0,1.0,40,950,600,350,0.631578947368421,13,6,7,370.8652829217343,0.7812767094017093,0.21096658951393743,0.23280406294335307,133930.079481337,1934.003363715297,135864.0828450523,2802,2,730.425,39,1,15,31.626853342725852,0.6541132478632479,41.22395833333334,1035.104166666668,26.541132478632516,0
2834,4,0,0,40,0.0,0.0,1.0,40,1050,900,150,0.8571428571428571,12,9,3,377.7724648254392,0.7812232905982905,0.20761241323810475,0.23783635673398965,134037.92453342036,2127.167426215302,136165.09195963567,2803,3,731.425,39,1,16,31.340010227006015,0.6551816239316238,41.11979166666668,1035.520833333335,26.551816239316285,0
2835,4,0,0,40,0.0,0.0,1.0,40,1150,900,250,0.782608695652174,14,9,5,373.53508651530126,0.7794871794871795,0.20788084464555046,0.2358607260568046,134145.81298828137,2021.6335720486263,136167.44656033,2804,4,732.425,39,1,16,31.34164990782638,0.65625,41.01562500000001,1035.937500000001,26.562500000000025,0
2836,4,0,0,40,0.0,0.0,1.0,40,950,600,350,0.631578947368421,13,6,7,372.4047421223047,0.778258547008547,0.2095562368077193,0.23584053337840946,134253.74484592027,1999.3462456597422,136253.09109158002,2805,5,733.425,39,1,17,31.262878178711432,0.6573183760683761,40.91145833333334,1036.3541666666679,26.573183760683794,0
2837,4,0,1,39,0.0,0.025,0.975,40,1250,900,350,0.72,16,9,7,371.85762161155264,0.7769497863247863,0.20783102270443998,0.23636467212780327,134388.72070312515,1994.6940104166813,136383.41471354183,2806,6,734.425,39,1,17,31.142003214788033,0.658653846153846,40.78125000000001,1036.8750000000011,26.586538461538492,0
2838,4,0,0,39,0.0,0.0,1.0,39,800,600,200,0.75,10,6,4,374.7650532071922,0.7767094017094017,0.20060549382618142,0.2383662913780481,134412.2618982397,2274.6036963985903,136686.86559463828,2807,7,726.5384615384615,38,1,17,31.043083316161812,0.6606359649122806,40.75854700854702,1036.9658119658138,27.288573999100365,0
2839,4,0,0,39,0.0,0.0,1.0,39,750,200,550,0.26666666666666666,13,2,11,376.3775054974562,0.7767656320287899,0.19846106299181399,0.23957353743369245,134439.9600614546,2320.035361421597,136759.99542287618,2808,8,727.5384615384615,38,1,17,30.973567185192817,0.6609100877192982,40.731837606837615,1037.0726495726508,27.29138551506976,0
2840,4,1,1,39,0.025,0.025,0.975,40,1250,900,350,0.72,16,9,7,369.2504091803426,0.7821848290598291,0.19019703673217458,0.23719396740408116,134772.56059838185,1953.0102865439355,136725.57088492578,2809,0,710.325,38,2,18,30.82600233220153,0.6641995614035088,40.41132478632478,1038.3547008547002,27.325123706702637,0
2841,4,0,0,39,0.0,0.0,1.0,39,750,500,250,0.6666666666666666,10,5,5,374.0821287455432,0.7753036437246964,0.19711115264088774,0.23977220804563676,134693.02002779683,2277.250331832853,136970.27035962968,2810,10,729.5384615384615,37,2,19,30.780056159994366,0.6652590090090091,40.48793859649122,1038.0482456140337,28.055357989568478,0
2842,4,0,0,39,0.0,0.0,1.0,39,850,700,150,0.8235294117647058,10,7,3,377.0068111715738,0.7748538011695907,0.1982284973097097,0.24202559288024605,134749.93657904342,2360.3287790473846,137110.2653580908,2811,11,730.5384615384615,37,2,19,30.647265638751016,0.6658220720720722,40.43311403508771,1038.2675438596482,28.06128496917968,0
2843,4,0,0,39,0.0,0.0,1.0,39,1250,800,450,0.64,17,8,9,378.48012754018714,0.7737854251012146,0.19643596509031935,0.24411839403970542,134920.7583703639,2412.965167166819,137333.72353753072,2812,12,731.5384615384615,37,2,14,30.438324538258588,0.6675112612612613,40.26864035087719,1038.925438596491,28.07906590801327,0
2844,4,0,0,39,0.0,0.0,1.0,39,950,700,250,0.7368421052631579,12,7,5,350.65440957912364,0.7739541160593792,0.11360047194313672,0.20297455894494604,130874.74093967021,1378.361002604171,132253.10194227437,2813,13,732.5384615384615,39,0,12,35.22271285079235,0.62366452991453,44.192708333333336,1023.2291666666673,26.236645299145316,8
2845,4,1,1,39,0.025,0.025,0.975,40,850,600,250,0.7058823529411765,11,6,5,343.97964118983936,0.7797008547008547,0.11128920206431148,0.20011194368526672,131067.83743142303,1016.9335382378123,132084.77096966084,2814,0,715.2,40,0,12,35.198326055312954,0.6239583333333334,44.0040650406504,1023.9837398373978,25.599593495934947,0
2846,4,0,0,39,0.0,0.0,1.0,39,1050,700,350,0.6666666666666666,14,7,7,353.99332228979915,0.7732793522267207,0.11710280154362862,0.20547503710229498,130981.34901258672,1473.3045789930502,132454.6535915798,2815,15,734.5384615384615,39,0,12,35.02944693192226,0.6247329059829061,44.088541666666664,1023.6458333333327,26.247329059829042,0
2847,4,0,1,38,0.0,0.02564102564102564,0.9743589743589743,39,700,500,200,0.7142857142857143,9,5,4,353.9959521755568,0.7734480431848854,0.1091151864138038,0.20619005934775314,131114.6701388888,1482.8124999999905,132597.4826388888,2816,16,735.5384615384615,39,0,12,34.894561974505024,0.6260683760683762,43.95833333333333,1024.1666666666658,26.26068376068374,0
2848,4,1,1,38,0.02564102564102564,0.02564102564102564,0.9743589743589743,39,1300,900,400,0.6923076923076923,17,9,8,353.47351229870196,0.7749100314889789,0.05866932565657179,0.2029608414555451,130562.68376981512,1430.2636925633626,131992.94746237848,2817,0,736.1025641025641,38,1,14,35.46653948010313,0.6222587719298246,44.49786324786324,1022.0085470085465,26.894961763382803,8
2849,4,1,1,38,0.02564102564102564,0.02564102564102564,0.9743589743589743,39,650,400,250,0.6153846153846154,9,4,5,354.25773865784504,0.7746288798920378,0.05581103678929766,0.2036981997282609,130617.28395061726,1454.436728395059,132071.72067901233,2818,0,737.0769230769231,38,1,14,35.39119112318841,0.6228070175438596,44.44444444444444,1022.2222222222221,26.900584795321635,0
2850,4,0,0,38,0.0,0.0,1.0,38,1000,800,200,0.8,12,8,4,370.14428594998367,0.7634838786154575,0.09224219489120133,0.20483901060164023,129119.93805473376,1958.601454635113,131078.5395093689,2819,28,757.4736842105264,38,0,16,36.50859350362662,0.6077302631578947,45.91346153846154,1016.3461538461542,26.745951417004058,5
2851,4,1,0,39,0.02564102564102564,0.0,1.0,39,700,300,400,0.42857142857142855,11,3,8,362.1630603261206,0.7692869995501574,0.09639410458308095,0.20208571468109543,129445.8954840565,1576.130013149239,131022.02549720573,2820,0,739.025641025641,38,1,11,36.3792650918635,0.6110197368421053,45.592948717948715,1017.6282051282049,26.77968960863697,0
2852,4,1,0,40,0.025,0.0,1.0,40,800,400,400,0.5,12,4,8,362.8381919836254,0.7763087606837606,0.11450005111951733,0.20407822632500527,129757.97661675354,1416.2299262152833,131174.20654296884,2821,0,721.525,39,1,12,36.04447824012541,0.6124465811965811,45.286458333333336,1018.8541666666672,26.124465811965827,0
2853,4,1,1,40,0.024390243902439025,0.024390243902439025,0.975609756097561,41,1050,700,350,0.6666666666666666,14,7,7,360.08472329426735,0.7873983739837398,0.118621742215828,0.20393963222241915,130029.26911891076,1164.310678167764,131193.57979707854,2822,0,704.9024390243902,40,1,12,35.838896638767096,0.6135416666666667,45.020325203252035,1019.9186991869924,25.49796747967481,0
2854,4,3,2,41,0.06976744186046512,0.046511627906976744,0.9534883720930233,43,900,500,400,0.5555555555555556,13,5,8,344.86232809590973,0.7971114802510151,0.11642372202105267,0.19743519274002244,130448.74267578113,397.99883598705924,130846.7415117682,2823,0,673.046511627907,39,4,14,35.801914448863045,0.6193910256410258,44.60937499999999,1021.5624999999991,26.193910256410234,0
2855,4,1,1,41,0.023809523809523808,0.023809523809523808,0.9761904761904762,42,800,300,500,0.375,13,3,10,354.4596563096774,0.7892228029423152,0.11515323552554269,0.20295468464869018,130453.51765103324,848.1018061947057,131301.61945722793,2824,0,690.047619047619,38,4,15,35.55196785888586,0.6211622807017546,44.60470085470083,1021.5811965811931,26.883715699505082,0
2856,4,2,3,40,0.046511627906976744,0.06976744186046512,0.9302325581395349,43,1000,900,100,0.9,11,9,2,349.5637229072072,0.8011720191952749,0.10601119921240376,0.20158508559399557,130729.8495955614,539.6825839447317,131269.53217950615,2825,0,674.953488372093,40,3,11,35.39720593593694,0.6205729166666667,44.33434959349593,1022.6626016260154,25.566565040650385,0
2857,4,1,1,40,0.024390243902439025,0.024390243902439025,0.975609756097561,41,1550,1200,350,0.7741935483870968,19,12,7,362.55813189519006,0.785619918699187,0.10922176880215884,0.20856655957909737,130635.03146701411,1272.55859375002,131907.59006076414,2826,0,708.8048780487804,39,2,12,35.16107941036614,0.6212606837606838,44.42708333333334,1022.2916666666684,26.212606837606884,0
2858,4,1,1,40,0.024390243902439025,0.024390243902439025,0.975609756097561,41,850,500,350,0.5882352941176471,12,5,7,364.97080644242266,0.7785569105691057,0.11516607577199278,0.2103886322281426,130714.9102105037,1341.4252387152976,132056.335449219,2827,0,709.780487804878,39,2,12,35.01844164884045,0.6220619658119657,44.34895833333334,1022.6041666666684,26.220619658119706,0
2859,4,0,1,39,0.0,0.025,0.975,40,1250,700,550,0.56,18,7,11,374.1534111382089,0.7741452991452992,0.1127311187715454,0.2158993734072378,130753.83434007234,1784.398627547671,132538.23296762002,2828,7,728.525,38,2,12,34.74420244437482,0.6241776315789473,44.31089743589744,1022.7564102564104,26.914642375168693,0
2860,4,1,1,39,0.025,0.025,0.975,40,1050,600,450,0.5714285714285714,15,6,9,372.43729699460425,0.7749732905982906,0.10783909366189892,0.21551854944515553,130863.1260158704,1747.6617859230055,132610.7878017934,2829,0,729.3,38,2,13,34.67726497511399,0.6252741228070176,44.20405982905983,1023.1837606837605,26.92588843904633,0
2861,4,0,0,39,0.0,0.0,1.0,39,1400,1200,200,0.8571428571428571,16,12,4,379.59216026853846,0.7655757984705354,0.11249072470937382,0.2194296688541181,130822.85534972308,2131.8660549399888,132954.72140466305,2830,9,749.0,37,2,13,34.535101822079305,0.6266891891891891,44.24342105263158,1023.0263157894743,27.64935988620201,0
2862,4,0,0,39,0.0,0.0,1.0,39,900,600,300,0.6666666666666666,12,6,6,381.24858528686906,0.76417004048583,0.10792028895938954,0.22119052477643997,130963.11034404804,2185.9001086872763,133149.01045273533,2831,10,750.0,37,2,13,34.35045081235494,0.6280968468468469,44.1063596491228,1023.5745614035077,27.664177335229937,0
2863,4,0,0,39,0.0,0.0,1.0,39,950,700,250,0.7368421052631579,12,7,5,383.4953382265423,0.7638326585695007,0.10587055094097364,0.22318171323020086,131081.84633875746,2253.855399408293,133335.70173816575,2832,11,751.0,38,1,14,34.17253521126761,0.6274671052631577,43.99038461538462,1024.0384615384621,26.948380566801635,0
2864,4,1,0,40,0.025,0.0,1.0,40,850,500,350,0.5882352941176471,12,5,7,377.67476496817346,0.7707799145299146,0.11402021606588897,0.2213718732092446,131356.22409058549,1922.4484902102197,133278.6725807957,2833,0,733.2,37,3,16,34.04363657432166,0.6320382882882883,43.72258771929824,1025.1096491228063,27.70566619250828,0
2865,4,0,0,40,0.0,0.0,1.0,40,1000,600,400,0.6,14,6,8,375.3546772050229,0.7711004273504274,0.11429352922788394,0.22032286465667317,131410.26925131504,1865.0918392505075,133275.36109056554,2834,1,734.2,38,2,16,34.048400541836,0.6307565789473684,43.6698717948718,1025.3205128205138,26.982118758434574,0
2866,4,0,1,39,0.0,0.025,0.975,40,950,500,450,0.5263157894736842,14,5,9,371.5220333636666,0.7698985042735043,0.11224614134849675,0.2188247000338155,131541.75347222245,1774.1319444444682,133315.88541666692,2835,2,735.2,39,1,17,34.013674519360954,0.6303418803418803,43.54166666666668,1025.8333333333353,26.303418803418854,0
2867,4,0,0,39,0.0,0.0,1.0,39,800,500,300,0.625,11,5,6,376.03232264194094,0.7681623931623932,0.12971656545911925,0.22151302834404385,131547.23340821092,2093.2023431222083,133640.43575133313,2836,3,753.9230769230769,38,1,17,33.89246163993612,0.6321271929824561,43.53632478632478,1025.8547008547002,26.996176338281586,0
2868,4,0,0,39,0.0,0.0,1.0,39,1550,1300,250,0.8387096774193549,18,13,5,374.38249661501914,0.7673751686909582,0.12569653493883348,0.22149427509095462,131711.68456424863,2062.1098601066515,133773.7944243553,2837,4,754.9230769230769,38,1,14,33.768517554815425,0.6337719298245614,43.376068376068375,1026.495726495726,27.013045434098057,0
2869,4,0,0,39,0.0,0.0,1.0,39,1100,800,300,0.7272727272727273,14,8,6,377.8879594024647,0.7667566351776879,0.13055553332319558,0.22405189252418775,131793.94866544288,2160.669264555467,133954.61792999835,2838,5,755.9230769230769,38,1,15,33.595402837027024,0.6345942982456141,43.29594017094016,1026.816239316238,27.02147998200626,0
2870,4,0,0,39,0.0,0.0,1.0,39,1350,1000,350,0.7407407407407407,17,10,7,375.77137181329965,0.7653508771929824,0.13277769334751777,0.22376428995222933,131958.5539141829,2117.249365366354,134075.80327954926,2839,6,756.9230769230769,38,1,16,33.48345811237046,0.6362390350877192,43.13568376068376,1027.457264957265,27.03834907782276,0
2871,4,0,0,39,0.0,0.0,1.0,39,1050,800,250,0.7619047619047619,13,8,5,375.17614502653373,0.7646761133603239,0.1294763857906982,0.2240577089571869,132068.34781804733,2109.7787228796833,134178.126540927,2840,7,757.9230769230769,38,1,16,33.38790146554411,0.6373355263157894,43.02884615384615,1027.8846153846152,27.0495951417004,0
2872,4,0,0,39,0.0,0.0,1.0,39,600,400,200,0.6666666666666666,8,4,4,374.33426611606336,0.7645074224021593,0.1275150081135743,0.2238793438679226,132123.26189139075,2091.6528553948324,134214.9147467856,2841,8,758.9230769230769,38,1,16,33.354116872770106,0.6378837719298246,42.975427350427346,1028.0982905982896,27.0552181736392,0
2873,4,0,0,39,0.0,0.0,1.0,39,900,800,100,0.8888888888888888,10,8,2,373.1720944672968,0.7654071075123707,0.13091147373299927,0.22367089547585306,132205.65440317048,2067.092190810145,134272.74659398064,2842,9,759.9230769230769,38,1,16,33.3008691737655,0.6387061403508771,42.89529914529915,1028.4188034188037,27.063652721547466,0
2874,4,0,0,39,0.0,0.0,1.0,39,1450,1000,450,0.6896551724137931,19,10,9,372.0334191944714,0.7663067926225822,0.12923445983155846,0.22430462351840244,132427.7842747986,2053.931750598371,134481.71602539698,2843,10,760.9230769230769,35,4,18,33.10621181453578,0.6467261904761905,42.67939814814815,1029.282407407408,29.408068783068803,0
2875,4,0,1,38,0.0,0.02564102564102564,0.9743589743589743,39,900,600,300,0.6666666666666666,12,6,6,373.2301243569582,0.7658007197480882,0.12444329139101495,0.22538234597115706,132487.35592689045,2089.6544656635815,134577.01039255405,2844,11,761.9230769230769,35,4,18,33.01538785834739,0.6473214285714286,42.62152777777778,1029.513888888889,29.41468253968254,0
2876,4,0,0,38,0.0,0.0,1.0,38,1100,800,300,0.7272727272727273,14,8,6,383.80735938635996,0.7667437174016122,0.13156677399523975,0.23159680646293457,132459.27047902488,2567.768565759627,135027.0390447845,2845,12,772.8421052631579,34,4,18,32.77148143864923,0.649203431372549,42.64880952380952,1029.4047619047615,30.27661064425769,0
2877,4,1,1,38,0.02564102564102564,0.02564102564102564,0.9743589743589743,39,1100,800,300,0.7272727272727273,14,8,6,375.97088666268485,0.7740103463787674,0.12179343161145018,0.22830101180567677,132695.96220207473,2177.96371313443,134873.92591520917,2846,0,754.0,35,4,15,32.734685089493006,0.6494047619047618,42.41898148148148,1030.324074074074,29.437830687830683,0
2878,4,0,0,38,0.0,0.0,1.0,38,1300,1100,200,0.8461538461538461,15,11,4,385.5350712174144,0.76558795637743,0.12321541558815063,0.2342394356998237,132716.91243608494,2633.4048575602856,135350.31729364523,2847,14,774.8421052631579,36,2,16,32.467213114754095,0.6475694444444444,42.39864864864866,1030.405405405407,28.622372372372418,0
2879,4,1,0,39,0.02564102564102564,0.0,1.0,39,1000,900,100,0.9,11,9,2,377.60669602683595,0.7713675213675214,0.12830603530686413,0.23135598076365033,133030.99203740235,2246.6786744831684,135277.67071188553,2848,0,755.9487179487179,38,1,17,32.35531448494891,0.6469298245614035,42.0940170940171,1031.623931623932,27.147998200629793,0
2880,4,0,0,39,0.0,0.0,1.0,39,950,800,150,0.8421052631578947,11,8,3,378.6100073299639,0.771255060728745,0.1254339863035514,0.23265729458062676,133141.23109796192,2281.720496383961,135422.95159434588,2849,1,756.9487179487179,38,1,17,32.218555900621126,0.6480263157894737,41.98717948717949,1032.0512820512824,27.159244264507432,0
2881,4,0,0,39,0.0,0.0,1.0,39,1250,800,450,0.64,17,8,9,381.6094728360032,0.7718735942420153,0.12642424338936076,0.2346740367325669,133168.79799702315,2363.6949603696403,135532.4929573928,2850,2,757.9487179487179,38,1,17,32.113437187316705,0.6483004385964912,41.960470085470085,1032.1581196581196,27.162055780476834,0
2882,4,0,0,39,0.0,0.0,1.0,39,850,600,250,0.7058823529411765,11,6,5,380.45163520788526,0.7710301394511921,0.11966696383087139,0.23448243639343153,133251.5158156185,2339.1514171963045,135590.6672328148,2851,3,758.9487179487179,38,1,17,32.06013727924945,0.6491228070175438,41.88034188034189,1032.4786324786337,27.170490328385096,0
2883,4,0,0,39,0.0,0.0,1.0,39,700,500,200,0.7142857142857143,9,5,4,380.84570816656407,0.7703553756185335,0.11477588305973518,0.23524827225854172,133334.2593163308,2355.956082438472,135690.21539876927,2852,4,759.9487179487179,38,1,17,31.966785628081794,0.6499451754385963,41.80021367521368,1032.7991452991466,27.178924876293333,0
2884,4,0,0,39,0.0,0.0,1.0,39,1150,600,550,0.5217391304347826,17,6,11,377.7014090042282,0.7677687809266757,0.11948120151628161,0.23472723312456376,133559.51126379744,2289.265796478399,135848.77706027584,2853,5,760.9487179487179,36,3,18,31.82173076224716,0.6559606481481483,41.5822072072072,1033.67117117117,28.713088088088057,0
2885,4,0,0,39,0.0,0.0,1.0,39,1000,600,400,0.6,14,6,8,375.8121080762331,0.7672627080521818,0.11706536992917971,0.23371745085374165,133585.55036164966,2240.6134579870622,135826.1638196367,2854,6,761.9487179487179,37,2,18,31.844417338424552,0.6542792792792793,41.557017543859644,1033.7719298245606,27.939781887150286,0
2886,4,0,0,39,0.0,0.0,1.0,39,1450,1100,350,0.7586206896551724,18,11,7,377.845869294503,0.7670377867746289,0.11729844935951794,0.23570385179799933,133698.92659279768,2303.5174284395025,136002.44402123717,2855,7,762.9487179487179,37,2,20,31.678064037319743,0.6554054054054055,41.44736842105262,1034.2105263157885,27.95163584637266,0
2887,4,0,0,39,0.0,0.0,1.0,39,900,500,400,0.5555555555555556,13,5,8,379.16853925206897,0.7646198830409358,0.11704442573738505,0.2375566928328293,133858.89788333705,2351.016555263357,136209.91443860042,2856,8,763.9487179487179,38,1,14,31.483369467960635,0.6551535087719298,41.292735042735046,1034.8290598290603,27.232343679712113,0
2888,4,0,0,39,0.0,0.0,1.0,39,1350,1000,350,0.7407407407407407,17,10,7,368.3202119418982,0.7648448043184886,0.0866478515795921,0.22024045326321642,132116.0357032932,1935.7682149304276,134051.80391822362,2857,9,764.9487179487179,37,2,14,33.515980517633665,0.6396396396396395,42.98245614035087,1028.0701754385955,27.785680417259336,8
2889,4,0,0,39,0.0,0.0,1.0,39,850,700,150,0.8235294117647058,10,7,3,365.8290782047835,0.7648448043184886,0.03720050441361922,0.20286885245901648,129201.38888888904,1660.050207756251,130861.43909664529,2858,10,765.9487179487179,36,3,15,36.53517759562842,0.6122685185185185,45.83333333333334,1016.6666666666679,28.240740740740776,8
2890,4,0,0,39,0.0,0.0,1.0,39,1150,800,350,0.6956521739130435,15,8,7,363.9610584470449,0.7660256410256411,0.04296404805705123,0.2024197216683321,129315.90374157965,1613.1906399643167,130929.09438154397,2859,11,766.9487179487179,36,3,15,36.4659451579569,0.6134259259259258,45.720720720720735,1017.117117117119,28.253253253253305,0
2891,4,1,0,40,0.025,0.0,1.0,40,1250,900,350,0.72,16,9,7,350.4043847515162,0.7767094017094017,0.04323385118560963,0.19748597352585429,129837.58680555533,1099.1319444444205,130936.71874999975,2860,0,748.75,39,1,15,36.280321613518666,0.6132478632478634,45.20833333333332,1019.1666666666648,26.132478632478584,3
2892,4,1,0,41,0.024390243902439025,0.0,1.0,41,1100,900,200,0.8181818181818182,13,9,4,337.5768057685054,0.7811483739837398,0.11666683768225994,0.18617634972430105,128984.24373584641,517.6191878515697,129501.86292369798,2861,0,731.4634146341464,38,3,16,37.47414458000281,0.6063596491228069,46.04700854700855,1015.8119658119666,26.731893837157017,4
2893,4,0,0,41,0.0,0.0,1.0,41,1000,600,400,0.6,14,6,8,340.13607096624355,0.7808434959349594,0.1187995414808527,0.18797409476815458,129065.65176647303,579.9767377091064,129645.62850418214,2862,1,732.4634146341464,38,3,16,37.3262976202993,0.6071820175438596,45.96688034188034,1016.1324786324783,26.74032838506522,0
2894,4,0,0,41,0.0,0.0,1.0,41,1200,900,300,0.75,15,9,6,339.25177324066965,0.78125,0.12013105205678953,0.1878720239005664,129147.08547921687,562.675551537729,129709.7610307546,2863,2,733.4634146341464,38,3,17,37.26591514259687,0.6080043859649124,45.886752136752136,1016.4529914529913,26.748762932973456,0
2895,4,0,0,41,0.0,0.0,1.0,41,900,700,200,0.7777777777777778,11,7,4,339.20339503800557,0.7831808943089431,0.11914251140690735,0.18866578706291065,129319.08543381325,573.1288072945601,129892.21424110781,2864,3,734.4634146341464,35,6,18,37.09224700348959,0.6154761904761905,45.71759259259258,1017.1296296296281,29.060846560846517,0
2896,4,0,0,41,0.0,0.0,1.0,41,950,600,350,0.631578947368421,13,6,7,338.0930389507342,0.783130081300813,0.11691557057194868,0.1888556789886732,129487.77113261896,555.7828098368489,130043.55394245581,2865,4,735.4634146341464,36,5,12,36.94908534336506,0.6151620370370372,45.551801801801794,1017.7927927927916,28.27202202202199,0
2897,4,0,0,41,0.0,0.0,1.0,41,1000,600,400,0.6,14,6,8,338.45776814323517,0.7827743902439024,0.11804219800853044,0.18947347874817255,129573.74762854059,571.0482864621224,130144.7959150027,2866,5,736.4634146341464,36,5,12,36.85248681930463,0.6160300925925927,45.467342342342334,1018.1306306306296,28.28140640640638,0
2898,4,1,0,42,0.023809523809523808,0.0,1.0,42,1250,800,450,0.64,17,8,9,328.73539310413196,0.7923199767711963,0.11870452019930466,0.18583042069758757,129954.95158366,144.1584189365547,130099.11000259656,2867,0,719.9047619047619,37,5,14,36.71351310176721,0.6179617117117119,45.093201754385944,1019.6271929824533,27.557491702228468,0
2899,4,3,1,44,0.06666666666666667,0.022222222222222223,0.9777777777777777,45,1200,1000,200,0.8333333333333334,14,10,4,304.6171810705744,0.8068602693602694,0.11891696097075166,0.17547665782797828,130688.28124999953,-1037.6571396968732,129650.62411030266,2868,0,672.8444444444444,39,6,12,36.58822330888345,0.621794871794872,44.37499999999998,1022.4999999999962,26.217948717948623,0
2900,4,1,2,43,0.022222222222222223,0.044444444444444446,0.9555555555555556,45,950,700,250,0.7368421052631579,12,7,5,307.2530754599616,0.8115740740740741,0.12036558712497492,0.17754359687600274,130807.80805902542,-961.7797359376343,129846.0283230878,2869,0,673.8222222222222,40,5,13,36.40038247566064,0.6213541666666669,44.2581300813008,1022.9674796747945,25.574186991869862,0
2901,4,0,0,43,0.0,0.0,1.0,43,1150,800,350,0.6956521739130435,15,8,7,319.80109050558167,0.8045404208194905,0.11685738393424261,0.18371711358552484,130581.79253472204,-247.96006944446395,130333.83246527758,2870,2,702.046511627907,39,4,13,36.307582551977156,0.620726495726496,44.47916666666666,1022.0833333333319,26.207264957264922,0
2902,4,1,1,43,0.022727272727272728,0.022727272727272728,0.9772727272727273,44,1050,700,350,0.6666666666666666,14,7,7,313.14209673329117,0.8087561663143059,0.10705129941054903,0.18155751618888716,130937.7904707017,-599.5731500760384,130338.21732062566,2871,0,687.0681818181819,40,4,14,36.11876510111541,0.6226562500000001,44.1310975609756,1023.4756097560955,25.58689024390239,0
2903,4,2,0,45,0.044444444444444446,0.0,1.0,45,1100,800,300,0.7272727272727273,14,8,6,306.1999119471847,0.814520202020202,0.11712008261529028,0.1789891845219279,131251.87119118462,-962.1377196712226,130289.73347151339,2872,0,672.7555555555556,41,4,16,35.980310291412515,0.6242378048780489,43.82440476190475,1024.7023809523794,24.99274099883852,0
2904,4,0,0,45,0.0,0.0,1.0,45,1150,800,350,0.6956521739130435,15,8,7,306.36525877453926,0.8131734006734007,0.11978319783197877,0.17944250871080134,131328.12499999983,-953.1250000000143,130374.99999999981,2873,1,673.7555555555556,41,4,16,35.89939024390244,0.625,43.74999999999999,1024.9999999999986,24.999999999999968,0
2905,4,1,0,46,0.021739130434782608,0.0,1.0,46,1050,600,450,0.5714285714285714,15,6,9,304.00382079653343,0.8185185185185185,0.13714064033038698,0.17957080123012192,131651.11889497328,-1195.5113687578853,130455.60752621539,2874,0,660.0869565217391,42,4,13,35.63540584773235,0.626736111111111,43.435077519379846,1026.2596899224807,24.434754521963825,0
2906,4,0,0,46,0.0,0.0,1.0,46,1300,900,400,0.6923076923076923,17,9,8,305.7100331029424,0.8179347826086957,0.13482938598650862,0.18116910015429402,131775.4529475392,-1142.9843834505136,130632.46856408867,2875,1,661.0869565217391,42,4,13,35.46680351075878,0.6279761904761905,43.31395348837209,1026.7441860465115,24.446290143964557,0
2907,4,0,1,45,0.0,0.021739130434782608,0.9782608695652174,46,1350,700,650,0.5185185185185185,20,7,13,306.79767705870955,0.817975040257649,0.13496393905330795,0.1820516115043785,131825.20300012006,-1111.2667883540737,130713.93621176599,2876,2,662.0869565217391,42,4,13,35.38894917279991,0.6284722222222223,43.26550387596899,1026.9379844961231,24.450904392764837,0
2908,4,0,1,44,0.0,0.022222222222222223,0.9777777777777777,45,900,400,500,0.4444444444444444,14,4,10,313.6831842291953,0.8122053872053873,0.1328952031184567,0.18557346524982765,131709.7262081917,-736.974737811779,130972.75147037994,2877,3,677.7111111111111,41,4,13,35.328174833285026,0.628810975609756,43.3779761904762,1026.488095238096,25.036295005807222,0
2909,4,0,0,44,0.0,0.0,1.0,44,950,500,450,0.5263157894736842,14,5,9,324.58377880456237,0.8086900986610289,0.13099634336193522,0.18481402915606732,130236.65229030354,-345.45905215147627,129891.19323815206,2878,4,692.8409090909091,40,4,17,36.53424930306653,0.6156249999999999,44.81707317073172,1020.7317073170743,25.51829268292686,3
2910,4,1,1,44,0.022222222222222223,0.022222222222222223,0.9777777777777777,45,700,300,400,0.42857142857142855,11,3,8,318.9102445631398,0.8151515151515152,0.12979391137849383,0.18257751129192715,130448.74267578128,-679.7067501389082,129769.03592564237,2879,0,678.4222222222222,39,6,18,36.464706332211684,0.6193910256410255,44.609375,1021.5625000000002,26.193910256410263,0
2911,4,0,1,43,0.0,0.022727272727272728,0.9772727272727273,44,1250,1000,250,0.8,15,10,5,325.78561305348205,0.8098132487667372,0.1319693325601512,0.18666793395029663,130480.80490037627,-298.24619676382116,130182.55870361245,2880,6,694.8409090909091,38,6,18,36.25670988880755,0.6214364035087719,44.577991452991455,1021.6880341880346,26.886527215474597,0
2912,4,1,1,43,0.022727272727272728,0.022727272727272728,0.9772727272727273,44,1550,1200,350,0.7741935483870968,19,12,7,323.45921780941643,0.811597075405215,0.12565209954673695,0.1858579181250866,130589.98243343213,-351.89328566730865,130238.08914776483,2881,0,695.5454545454545,38,6,17,36.20583777568724,0.622532894736842,44.471153846153854,1022.1153846153861,26.897773279352265,0
2913,4,0,0,43,0.0,0.0,1.0,43,1500,1200,300,0.8,18,12,6,329.51831738378985,0.804171280915467,0.13370034213671955,0.1889711507507406,130514.55886667041,1.3875663665587012,130515.94643303697,2882,8,712.7209302325581,37,6,17,36.12724451836748,0.6235923423423424,44.54495614035087,1021.8201754385957,27.616761498340423,0
2914,4,0,0,43,0.0,0.0,1.0,43,1100,800,300,0.7272727272727273,14,8,6,330.39750542968096,0.803110003691399,0.1413107459619094,0.19016211979174935,130654.64854570614,33.59399045858282,130688.24253616472,2883,9,713.7209302325581,37,6,18,35.96319533819535,0.625,44.407894736842096,1022.3684210526296,27.631578947368368,0
2915,4,0,0,43,0.0,0.0,1.0,43,1050,700,350,0.6666666666666666,14,7,7,328.0294049242794,0.8033868586194167,0.14037275134782035,0.1890730673871337,130710.70545744813,-24.609014312126078,130686.096443136,2884,10,714.7209302325581,37,6,18,35.96709914933163,0.6255630630630632,44.35307017543858,1022.5877192982431,27.637505926979543,0
2916,4,1,1,43,0.022727272727272728,0.022727272727272728,0.9772727272727273,44,900,600,300,0.6666666666666666,12,6,6,320.31921154606977,0.8067521141649049,0.14252575852450566,0.18601810212329914,130999.80481591042,-407.6491617357208,130592.1556541747,2885,0,699.4545454545455,38,6,19,35.872599666040486,0.6266447368421053,44.07051282051281,1023.7179487179475,26.939946018893355,0
2917,4,1,0,44,0.022727272727272728,0.0,1.0,44,1000,700,300,0.7,13,7,6,319.11564988150093,0.8109804439746301,0.14545170098987348,0.1861119739089918,131163.91354372096,-428.7084976989134,130735.20504602205,2886,0,699.25,38,6,20,35.73803191489361,0.6282894736842106,43.910256410256395,1024.3589743589723,26.956815114709798,0
2918,4,0,0,44,0.0,0.0,1.0,44,1350,1200,150,0.8888888888888888,15,12,3,316.9409742877917,0.8101876321353065,0.14209164818920916,0.1856368563685634,131328.12499999977,-475.34722222225145,130852.77777777752,2887,1,700.25,38,6,20,35.628387533875326,0.6299342105263159,43.749999999999986,1024.9999999999982,26.97368421052627,0
2919,4,0,0,44,0.0,0.0,1.0,44,1200,700,500,0.5833333333333334,17,7,10,313.55923850392355,0.8092847075405215,0.13726818087101456,0.18418247069526641,131437.6563755568,-557.3017112280254,130880.35466432878,2888,2,701.25,38,6,20,35.60485691463497,0.6310307017543861,43.64316239316238,1025.4273504273485,26.984930274403908,0
2920,4,0,0,44,0.0,0.0,1.0,44,1100,900,200,0.8181818181818182,13,9,4,314.104563238236,0.8092847075405215,0.10582697291034648,0.17769294471798727,129984.23450688148,-597.8345415459087,129386.39996533557,2889,3,702.25,41,3,16,37.056843240263326,0.6115345528455285,45.06448412698413,1019.7420634920636,24.87175764614789,7
2921,4,1,0,45,0.022222222222222223,0.0,1.0,45,1400,1100,300,0.7857142857142857,17,11,6,312.3112818610948,0.8141835016835017,0.112080961416825,0.17851197997917262,130386.26359593793,-855.7797758547913,129530.48382008313,2890,0,687.6222222222223,42,3,17,36.69631562302343,0.6140873015873015,44.670542635658926,1021.3178294573659,24.31709117755633,0
2922,4,1,0,46,0.021739130434782608,0.0,1.0,46,950,500,450,0.5263157894736842,14,5,9,306.9886723052938,0.8161835748792271,0.11612652612680718,0.17721991713359103,130770.59771184898,-1170.9815663739323,129599.61614547505,2891,0,673.6521739130435,43,3,15,36.444638613708605,0.6165213178294573,44.29450757575759,1022.8219696969728,23.78655743481332,0
2923,4,0,0,46,0.0,0.0,1.0,46,1350,1100,250,0.8148148148148148,16,11,5,306.95671297223214,0.8154589371980676,0.12075931030320075,0.17764688182458344,130867.47378795072,-1165.870082214167,129701.60370573655,2892,1,674.6521739130435,43,3,15,36.3478520746568,0.6174903100775193,44.199810606060616,1023.2007575757591,23.79536645525021,0
2924,4,1,0,47,0.02127659574468085,0.0,1.0,47,1350,900,450,0.6666666666666666,18,9,9,305.503632582192,0.8206907184705519,0.13232104121475086,0.17827490458277287,131185.80246913584,-1384.4521604938182,129801.35030864202,2893,0,661.2765957446809,44,3,16,36.06460140997833,0.6193181818181819,43.88888888888889,1024.4444444444448,23.28282828282829,0
2925,4,0,1,46,0.0,0.02127659574468085,0.9787234042553191,47,1200,900,300,0.75,15,9,6,306.4645090453391,0.8208063521430773,0.1405443440245,0.17916760283173663,131256.95408950644,-1354.8804012345413,129902.0736882719,2894,1,662.2765957446809,44,3,16,35.96841962591489,0.620028409090909,43.81944444444446,1024.7222222222244,23.289141414141465,0
2926,4,1,2,45,0.02127659574468085,0.0425531914893617,0.9574468085106383,47,1200,900,300,0.75,15,9,6,306.03476766474955,0.8250077089115017,0.14097906936516202,0.17924893534649652,131328.1250000003,-1361.8055555555247,129966.31944444477,2895,0,663.063829787234,44,3,16,35.90785907859079,0.6207386363636362,43.750000000000014,1025.0000000000023,23.295454545454596,0
2927,4,1,1,45,0.021739130434782608,0.021739130434782608,0.9782608695652174,46,850,600,250,0.7058823529411765,11,6,5,311.4123874865447,0.8238123993558777,0.14172398561241883,0.18276246590990589,131404.40095308973,-1015.8083545918159,130388.59259849791,2896,0,667.4347826086956,41,5,17,35.69333575229804,0.6257621951219511,43.67559523809525,1025.2976190476204,25.007259001161472,0
2928,4,0,0,45,0.0,0.0,1.0,45,1150,900,250,0.782608695652174,14,9,5,315.2885187388461,0.8189814814814815,0.1414634146341467,0.18466898954703848,131328.12500000012,-718.749999999985,130609.37500000013,2897,4,683.2666666666667,42,3,18,35.670731707317096,0.6235119047619047,43.75000000000001,1025.000000000001,24.404761904761926,0
2929,4,0,0,45,0.0,0.0,1.0,45,1200,1000,200,0.8333333333333334,14,10,4,314.8987589598179,0.8191077441077441,0.13993237959934346,0.18481754387118127,131406.2616188282,-724.0662593363616,130682.19535949183,2898,5,684.2666666666667,40,5,19,35.602099646479644,0.6273437499999999,43.67378048780488,1025.3048780487816,25.63262195121954,0
2930,4,0,0,45,0.0,0.0,1.0,45,1150,1000,150,0.8695652173913043,13,10,3,312.9082041556179,0.8195707070707071,0.14282978372131394,0.18440212031237405,131562.60456945293,-766.596334027344,130796.00823542559,2899,6,685.2666666666667,40,5,17,35.49591381872213,0.62890625,43.52134146341464,1025.9146341463431,25.64786585365858,0
2931,4,0,0,45,0.0,0.0,1.0,45,900,400,500,0.4444444444444444,14,4,10,313.88450751234103,0.8191498316498317,0.14374838875998952,0.18532085306550564,131633.3616780046,-736.4654195011242,130896.89625850349,2900,7,686.2666666666667,41,4,17,35.39974864655841,0.6280487804878048,43.452380952380956,1026.1904761904768,25.029036004645775,0
2932,4,0,0,45,0.0,0.0,1.0,45,1050,500,550,0.47619047619047616,16,5,11,316.3738710354971,0.8193602693602694,0.13578099838969426,0.18754121221176356,131786.1128826529,-661.2634637188314,131124.84941893406,2901,8,687.2666666666667,41,4,17,35.18236714975846,0.6295731707317074,43.30357142857142,1026.785714285713,25.043554006968613,0
2933,4,0,0,45,0.0,0.0,1.0,45,750,400,350,0.5333333333333333,11,4,7,315.645851834944,0.8184343434343435,0.13515746552926688,0.18773766776282844,131913.473216254,-672.411875629891,131241.06134062412,2902,9,688.2666666666667,41,4,18,35.07313294704651,0.6308434959349594,43.17956349206349,1027.2817460317453,25.055652342237693,0
2934,4,1,2,44,0.021739130434782608,0.043478260869565216,0.9565217391304348,46,1250,800,450,0.64,17,8,9,307.27327724205895,0.8243357487922706,0.13404431406611095,0.1840171567772418,132173.71627306036,-1077.309807102948,131096.4064659574,2903,0,674.2826086956521,42,4,19,35.027170498806406,0.6319444444444444,42.92635658914728,1028.2945736434096,24.483204134366897,0
2935,4,0,1,43,0.0,0.022727272727272728,0.9772727272727273,44,1650,1300,350,0.7878787878787878,20,13,7,312.92060387844805,0.817543164200141,0.08580503936737993,0.18727583348867555,132148.80720997852,-529.5830892073701,131619.22412077116,2904,1,705.0,42,2,17,34.90697546571165,0.6316964285714286,42.95058139534884,1028.1976744186059,24.480897009966807,4
2936,4,0,0,43,0.0,0.0,1.0,43,1150,900,250,0.782608695652174,14,9,5,317.34103675818557,0.8096160944998154,0.08874843843567692,0.19053324899511448,132270.40939350284,-205.03423012722953,132065.3751633756,2905,2,721.9767441860465,41,2,18,34.67135612563089,0.634400406504065,42.83234126984127,1028.6706349206354,25.089527680991107,0
2937,4,0,1,42,0.0,0.023255813953488372,0.9767441860465116,43,1200,900,300,0.75,15,9,6,320.19740919568227,0.810908084163898,-0.012494291045375583,0.19370509536596095,132554.93511013602,-111.18912845327354,132443.74598168276,2906,3,722.9767441860465,40,3,19,34.31260074344551,0.6388020833333334,42.55589430894308,1029.7764227642265,25.74441056910566,8
2938,4,0,1,41,0.0,0.023809523809523808,0.9761904761904762,42,750,600,150,0.8,9,6,3,328.0738472398823,0.8022406116918313,-0.0051588104390041245,0.19849070096777682,132558.85959201376,297.8190104166572,132856.67860243042,2907,14,741.1190476190476,39,3,19,34.10589048486076,0.6404914529914532,42.55208333333333,1029.7916666666656,26.404914529914503,0
2939,4,0,0,41,0.0,0.0,1.0,41,1050,900,150,0.8571428571428571,12,9,3,333.7575060080959,0.7959857723577236,0.0008351956509085046,0.2016564943824463,132507.98000447432,645.1065864927918,133153.0865909671,2908,15,759.219512195122,38,3,19,34.01062744284183,0.6417214912280702,42.60149572649572,1029.5940170940164,27.094579397210957,0
2940,4,0,0,41,0.0,0.0,1.0,41,900,500,400,0.5555555555555556,13,5,8,333.3600244747221,0.7949186991869919,0.003051487840975975,0.20194882534676076,132607.26631180188,641.1923086456534,133248.45862044755,2909,16,760.219512195122,40,1,20,33.92123006084525,0.6393229166666667,42.50508130081301,1029.9796747967482,25.749491869918707,0
2941,4,0,0,41,0.0,0.0,1.0,41,900,600,300,0.6666666666666666,12,6,6,337.3037825472965,0.7941056910569105,0.00510415163323219,0.20505158003774496,132738.13950029737,754.6153083481997,133492.75480864558,2910,17,761.219512195122,40,1,15,33.688362919132146,0.640625,42.3780487804878,1030.4878048780483,25.76219512195121,0
2942,4,0,1,40,0.0,0.024390243902439025,0.975609756097561,41,1450,1300,150,0.896551724137931,16,13,3,338.1957440718401,0.7944613821138211,0.005703801492318306,0.20602519111835874,132816.69439693628,783.6081573468075,133600.3025542831,2911,18,762.219512195122,40,1,16,33.58658680863648,0.6414062500000001,42.30182926829268,1030.7926829268288,25.76981707317072,0
2943,4,1,0,41,0.024390243902439025,0.0,1.0,41,800,400,400,0.5,12,4,8,332.477654090776,0.7931910569105691,0.03600041319038216,0.20396650283889123,133078.71187991608,649.139587051357,133727.85146696743,2912,0,762.7560975609756,40,1,17,33.471428805935844,0.6440104166666667,42.047764227642276,1031.808943089431,25.795223577235777,0
2944,4,0,0,41,0.0,0.0,1.0,41,1100,800,300,0.7272727272727273,14,8,6,340.5430435860873,0.7929878048780488,0.04301901286729404,0.2099464394923935,133262.2777447286,876.3083316808734,134138.58607640947,2913,1,763.7560975609756,40,1,17,33.07947834645669,0.6458333333333334,41.86991869918699,1032.5203252032516,25.81300813008129,0
2945,4,0,0,41,0.0,0.0,1.0,41,1150,1000,150,0.8695652173913043,13,10,3,341.9177376295652,0.7929369918699187,0.042228744633210136,0.21124072750937817,133340.98755907535,918.329759898215,134259.31731897357,2914,2,764.7560975609756,40,1,18,32.965167765423594,0.6466145833333332,41.79369918699187,1032.8252032520331,25.820630081300827,0
2946,4,1,2,40,0.023809523809523808,0.047619047619047616,0.9523809523809523,42,900,400,500,0.4444444444444444,14,4,10,333.08957769348757,0.7966995741385985,0.040934075397235814,0.2072866780282881,133610.2564673279,501.03042757881207,134111.28689490672,2915,0,747.5238095238095,38,4,19,32.92385725603666,0.6526864035087718,41.533119658119666,1033.8675213675224,27.207040035987433,0
2947,4,1,2,39,0.024390243902439025,0.04878048780487805,0.9512195121951219,41,1150,900,250,0.782608695652174,14,9,5,335.03051655207383,0.8007113821138211,0.04497116554679659,0.20911866091171033,133720.73522764628,760.1053994082852,134480.84062705457,2916,0,759.560975609756,38,3,15,32.76327342216715,0.6537828947368421,41.42628205128205,1034.2948717948716,27.218286099865043,0
2948,4,0,1,38,0.0,0.02564102564102564,0.9743589743589743,39,1350,900,450,0.6666666666666666,18,9,9,342.9545891280826,0.790148448043185,0.05543550057490476,0.21410262337823963,133727.27816491603,1372.4767476531092,135099.75491256913,2917,5,792.6410256410256,37,2,15,32.55183487049011,0.655686936936937,41.41995614035087,1034.3201754385957,27.954599336178262,0
2949,4,0,0,38,0.0,0.0,1.0,38,950,600,350,0.631578947368421,13,6,7,349.9799454481564,0.7843764817449028,0.05775832917805812,0.21818505356757772,133675.94103816655,1756.7797104537021,135432.72074862025,2918,6,813.2105263157895,36,2,22,32.42154887654725,0.6571180555555556,41.4695945945946,1034.1216216216217,28.7256006006006,0
2950,4,0,0,38,0.0,0.0,1.0,38,1050,600,450,0.5714285714285714,15,6,9,351.11312876347426,0.7831021811284969,0.05511765918933231,0.219756636721989,133821.54959013057,1797.300594513427,135618.850184644,2919,7,814.2105263157895,36,2,15,32.24654440574663,0.6585648148148149,41.328828828828826,1034.6846846846838,28.741241241241216,0
2951,4,0,0,38,0.0,0.0,1.0,38,700,500,200,0.7142857142857143,9,5,4,351.18273739292397,0.7828947368421053,0.05433556139778051,0.21997397231789897,133850.68081172387,1801.2096978735385,135651.8905095974,2920,8,815.2105263157895,36,2,16,32.21560198788403,0.6588541666666667,41.30067567567567,1034.797297297297,28.744369369369362,0
2952,4,0,0,38,0.0,0.0,1.0,38,1050,700,350,0.6666666666666666,14,7,7,348.4550322999015,0.781235182550972,0.06476609777462317,0.21895742391886483,133967.23740209796,1736.3116072153223,135703.54900931328,2921,9,816.2105263157895,36,2,16,32.169630878567034,0.6600115740740742,41.18806306306306,1035.247747747747,28.756881881881863,0
2953,4,0,0,38,0.0,0.0,1.0,38,850,500,350,0.5882352941176471,12,5,7,346.2369742617448,0.7811462778568041,0.06093610494265245,0.2180818640623976,134054.68813408003,1682.9379210291359,135737.62605510917,2922,10,817.2105263157895,36,2,17,32.13965311004786,0.6608796296296295,41.1036036036036,1035.5855855855855,28.766266266266264,0
2954,4,0,0,38,0.0,0.0,1.0,38,1250,900,350,0.72,16,9,7,347.33168909235485,0.7802275960170697,0.06096696157431514,0.21999267272656156,134258.85080604244,1726.4706852122308,135985.32149125467,2923,11,818.2105263157895,36,2,19,31.90739432793655,0.6629050925925927,40.90653153153153,1036.3738738738732,28.788163163163144,0
2955,4,0,1,37,0.0,0.02631578947368421,0.9736842105263158,38,800,500,300,0.625,11,5,6,347.5168922258145,0.7802275960170697,0.05707710340490024,0.22046126760431556,134317.21153163278,1735.4999847820613,136052.71151641486,2924,12,819.2105263157895,36,2,20,31.84433279015029,0.6634837962962964,40.850225225225216,1036.5990990990977,28.79441941941938,0
2956,4,0,0,37,0.0,0.0,1.0,37,900,600,300,0.6666666666666666,12,6,6,357.67654815043943,0.772022022022022,0.06258241290296085,0.22654489144036424,134258.8508060424,2204.248462990008,136463.09926903242,2925,35,842.027027027027,36,1,21,31.6393657865189,0.6629050925925927,40.90653153153153,1036.373873873873,28.788163163163137,0
2957,4,0,0,37,0.0,0.0,1.0,37,700,600,100,0.8571428571428571,8,6,2,355.7409396935424,0.7705830830830831,0.05664902439095987,0.22603911882390915,134375.58493882386,2160.5793716013177,136536.16431042517,2926,36,843.027027027027,36,1,21,31.572897433112473,0.6640625,40.79391891891891,1036.8243243243235,28.800675675675652,0
2958,4,0,0,37,0.0,0.0,1.0,37,950,700,250,0.7368421052631579,12,7,5,356.37607708186744,0.7695195195195195,0.05079085600258315,0.22698642253969542,134463.16882761123,2183.891323756174,136647.0601513674,2927,37,844.027027027027,36,1,22,31.46896489323199,0.6649305555555556,40.70945945945945,1037.162162162161,28.810060060060025,0
2959,4,0,0,37,0.0,0.0,1.0,37,600,300,300,0.5,9,3,6,354.4957029938297,0.7696446446446447,0.05130206194035991,0.22615058282404132,134521.5739388036,2137.4639842545153,136659.03792305812,2928,38,845.027027027027,36,1,22,31.459418873932552,0.6655092592592593,40.65315315315315,1037.3873873873868,28.8163163163163,0
2960,4,0,0,37,0.0,0.0,1.0,37,1150,700,450,0.6086956521739131,16,7,9,354.7717939012133,0.7685185185185185,0.047410178675095116,0.227419081792864,134696.8653619835,2157.3297114682146,136854.19507345173,2929,39,846.027027027027,36,1,23,31.277346857597447,0.6672453703703705,40.48423423423423,1038.0630630630624,28.835085085085066,0
2961,4,0,0,37,0.0,0.0,1.0,37,1100,800,300,0.7272727272727273,14,8,6,354.79351649885035,0.7667042042042042,0.046489416245513615,0.22871909082473085,134901.51627556622,2172.436668087019,137073.95294365325,2930,40,847.027027027027,36,1,18,31.072719060523937,0.6692708333333333,40.28716216216217,1038.8513513513524,28.85698198198201,0
2962,4,0,0,37,0.0,0.0,1.0,37,950,700,250,0.7368421052631579,12,7,5,355.2246624399917,0.7660785785785785,0.05046880629410189,0.22936724704925165,134960.0164987624,2188.2252607337246,137148.2417594961,2931,41,848.027027027027,36,1,19,31.003215201762956,0.669849537037037,40.230855855855864,1039.0765765765775,28.863238238238264,0
2963,4,0,0,37,0.0,0.0,1.0,37,950,600,350,0.631578947368421,13,6,7,353.3932992068586,0.7651401401401401,0.048525665427073816,0.22873914107148022,135047.79061155766,2144.996854963088,137192.78746652076,2932,42,849.027027027027,36,1,19,30.963344167569527,0.6707175925925926,40.146396396396405,1039.4144144144157,28.872622622622657,0
2964,4,0,0,37,0.0,0.0,1.0,37,1000,800,200,0.8,12,8,4,355.32582006520795,0.7643893893893894,0.04478162372899219,0.23073689328285044,135164.86714755304,2205.5134526418424,137370.38060019488,2933,43,850.027027027027,36,1,19,30.796512887156158,0.671875,40.03378378378379,1039.8648648648657,28.885135135135158,0
2965,4,0,0,37,0.0,0.0,1.0,37,1050,800,250,0.7619047619047619,13,8,5,355.4512938341995,0.7623873873873874,0.05244512831914072,0.23175825714426046,135311.28415155032,2219.314204407126,137530.59835595745,2934,44,851.027027027027,36,1,20,30.647481689937592,0.6733217592592593,39.893018018018026,1040.427927927929,28.900775775775806,0
2966,4,0,0,37,0.0,0.0,1.0,37,1050,700,350,0.6666666666666666,14,7,7,357.36659646776405,0.7604479479479479,0.05909348673787318,0.2343412447475849,135516.40111395178,2285.807006330651,137802.20812028242,2935,45,852.027027027027,36,1,21,30.39354856154013,0.6753472222222223,39.695945945945944,1041.216216216216,28.922672672672668,0
2967,4,0,0,37,0.0,0.0,1.0,37,800,600,200,0.75,10,6,4,356.780826453826,0.7605730730730731,0.06241232582063061,0.23434013373899024,135575.0344939534,2274.114570651733,137849.14906460512,2936,46,853.027027027027,36,1,21,30.35048118512111,0.6759259259259259,39.63963963963964,1041.4414414414414,28.928928928928926,0
2968,4,0,0,37,0.0,0.0,1.0,37,950,500,450,0.5263157894736842,14,5,9,358.0800000000001,0.7608233233233234,0.06529729729729761,0.2355789473684211,135633.6805555556,2313.5416666666715,137947.22222222225,2937,47,854.027027027027,36,1,21,30.25833333333334,0.6765046296296295,39.583333333333336,1041.666666666667,28.935185185185194,0
2969,4,0,0,37,0.0,0.0,1.0,37,600,200,400,0.3333333333333333,10,2,8,356.9562127463313,0.7602602602602603,0.06803647231709054,0.23503216541753114,135663.00834195694,2285.1507335037895,137948.15907546075,2938,48,855.027027027027,36,1,21,30.258440528951823,0.6767939814814814,39.55518018018019,1041.7792792792802,28.93831331331334,0
2970,4,0,0,37,0.0,0.0,1.0,37,1000,500,500,0.5,15,5,10,371.84014984745966,0.7602602602602603,0.08377818324377406,0.22928058735382364,133268.65875588427,2510.927608351595,135779.58636423587,2939,49,856.027027027027,36,1,16,32.2651961318937,0.6530671296296295,41.86373873873874,1032.545045045045,28.681806806806808,7
2971,4,0,0,37,0.0,0.0,1.0,37,800,600,200,0.75,10,6,4,367.9679656072285,0.7608858858858859,0.07941325538359978,0.2274260229480794,133355.88121905687,2414.138462787111,135770.019681844,2940,50,857.027027027027,36,1,17,32.277583951155705,0.6539351851851851,41.77927927927928,1032.8828828828828,28.691191191191187,0
2972,4,0,0,37,0.0,0.0,1.0,37,700,500,200,0.7142857142857143,9,5,4,367.72983658379206,0.7610735735735735,0.07643222031711261,0.22763519033871177,133414.04537983934,2412.065021102188,135826.11040094154,2941,51,858.027027027027,36,1,17,32.22535607877335,0.6545138888888888,41.722972972972975,1033.1081081081084,28.697447447447455,0
2973,4,0,0,37,0.0,0.0,1.0,37,800,600,200,0.75,10,6,4,366.49574781158077,0.7605730730730731,0.07199943460566716,0.2275844366315756,133530.41174620565,2387.6656217027835,135918.07736790844,2942,52,859.027027027027,36,1,18,32.1404899397109,0.6556712962962963,41.61036036036036,1033.5585585585584,28.709959959959956,0
2974,4,0,0,37,0.0,0.0,1.0,37,850,700,150,0.8235294117647058,10,7,3,365.9640704869185,0.7625125125125125,0.07156377595327634,0.22779092414511182,133617.7198101818,2379.856926182939,135997.57673636472,2943,53,860.027027027027,36,1,18,32.06667755872636,0.6565393518518519,41.5259009009009,1033.8963963963963,28.719344344344343,0
2975,4,0,1,36,0.0,0.02702702702702703,0.972972972972973,37,550,300,250,0.5454545454545454,8,3,5,365.9640704869185,0.7625125125125125,0.07156377595327634,0.22779092414511182,133617.7198101818,2379.856926182939,135997.57673636472,2944,54,861.027027027027,36,1,18,32.06667755872636,0.6565393518518519,41.5259009009009,1033.8963963963963,28.719344344344343,0
2976,4,0,0,36,0.0,0.0,1.0,36,700,400,300,0.5714285714285714,10,4,6,366.03775797532023,0.759623015873016,0.0795276471905082,0.22804611783483333,133651.6806520061,2584.3123070987544,136235.99295910486,2945,55,878.5277777777778,35,1,18,32.03072531900603,0.6589285714285715,41.49305555555555,1034.0277777777771,29.543650793650777,0
2977,4,0,0,36,0.0,0.0,1.0,36,1300,900,400,0.6923076923076923,17,9,8,365.5871357146077,0.7604166666666667,0.07035794183445221,0.2288759799221701,133831.25964506157,2585.3973765431924,136416.65702160477,2946,56,879.5277777777778,35,1,16,31.862416107382543,0.6607142857142858,41.319444444444436,1034.722222222221,29.56349206349203,0
2978,4,0,0,36,0.0,0.0,1.0,36,1100,900,200,0.8181818181818182,13,9,4,363.5901062784618,0.759292328042328,0.07118366129994058,0.2283672689996181,133951.04595336062,2540.6550068586935,136491.7009602193,2947,57,880.5277777777778,35,1,16,31.794126416219438,0.661904761904762,41.203703703703695,1035.185185185184,29.576719576719544,0
2979,4,0,1,35,0.0,0.027777777777777776,0.9722222222222222,36,650,600,50,0.9230769230769231,7,6,1,362.5823420624332,0.7593915343915344,0.07166946152412912,0.22791982078344766,133981.00090288473,2515.829019847366,136496.82992273208,2948,58,881.5277777777778,35,1,16,31.790222656977818,0.6622023809523812,41.174768518518505,1035.300925925924,29.580026455026402,0
2980,4,0,0,35,0.0,0.0,1.0,35,650,500,150,0.7692307692307693,8,5,3,368.1921787361823,0.7567927170868347,0.08488612836438936,0.23095691211633237,133903.12499999988,2860.416666666652,136763.54166666654,2949,59,905.2285714285714,34,1,16,31.723027375201276,0.6636029411764707,41.24999999999999,1034.999999999999,30.441176470588207,0
2981,4,0,0,35,0.0,0.0,1.0,35,1150,900,250,0.782608695652174,14,9,5,367.45733974889566,0.7564425770308123,0.08757349801267966,0.23126946028479686,134026.36763038536,2849.7945011337706,136876.16213151912,2950,60,906.2285714285714,34,1,16,31.61861922280984,0.6648284313725491,41.13095238095237,1035.4761904761895,30.455182072829103,0
2982,4,0,0,35,0.0,0.0,1.0,35,1000,600,400,0.6,14,6,8,371.90636993436544,0.7543417366946779,0.09316984291131192,0.2350545488408699,134180.5006377549,2980.5165816326335,137161.01721938755,2951,61,907.2285714285714,34,1,16,31.349103757325054,0.6663602941176471,40.98214285714285,1036.071428571427,30.472689075630207,0
2983,4,0,0,35,0.0,0.0,1.0,35,500,200,300,0.4,8,2,6,374.1312221016569,0.7521708683473389,0.08753310571492379,0.23691449524032773,134250.74615269198,3045.4791452331892,137296.22529792518,2952,62,908.2285714285714,35,0,16,31.22114883478519,0.6648809523809525,40.91435185185185,1036.3425925925922,29.609788359788347,0
2984,4,0,0,35,0.0,0.0,1.0,35,1250,1100,150,0.88,14,11,3,372.74276168117115,0.7515406162464986,0.0895708065519385,0.23661636544140677,134340.72151759692,3014.906308942047,137355.62782653896,2953,63,909.2285714285714,35,0,16,31.167080681775882,0.6657738095238095,40.8275462962963,1036.6898148148152,29.619708994709008,0
2985,4,0,0,35,0.0,0.0,1.0,35,1300,1000,300,0.7692307692307693,16,10,6,371.27311862244886,0.7514005602240896,0.08471938775510202,0.2362647118506494,134430.72702331975,2982.103052126215,137412.83007544596,2954,64,910.2285714285714,35,0,17,31.11514136904763,0.6666666666666665,40.74074074074075,1037.037037037038,29.629629629629658,0
2986,4,0,0,35,0.0,0.0,1.0,35,1150,900,250,0.782608695652174,14,9,5,371.7681972871405,0.749859943977591,0.07641996557659225,0.23735969519102065,134550.78125000012,3004.3402777777924,137555.1215277779,2955,65,911.2285714285714,35,0,17,30.982262382864782,0.6678571428571427,40.62500000000001,1037.500000000001,29.642857142857167,0
2987,4,0,0,35,0.0,0.0,1.0,35,700,400,300,0.5714285714285714,10,4,6,371.7681972871405,0.749859943977591,0.07641996557659225,0.23735969519102065,134550.78125000012,3004.3402777777924,137555.1215277779,2956,66,912.2285714285714,35,0,17,30.982262382864782,0.6678571428571427,40.62500000000001,1037.500000000001,29.642857142857167,0
2988,4,0,0,35,0.0,0.0,1.0,35,1050,800,250,0.7619047619047619,13,8,5,368.3035524899507,0.75,0.06969999836154228,0.23594700030564897,134674.3214994332,2920.2062074830055,137594.5277069162,2957,67,913.2285714285714,34,1,17,30.948694422143213,0.6712622549019608,40.50595238095239,1037.9761904761913,30.52871148459386,0
2989,4,0,0,35,0.0,0.0,1.0,35,1400,1100,300,0.7857142857142857,17,11,6,367.8729601928709,0.7514705882352941,0.08239994759939817,0.2366757894338204,134828.82653061228,2919.975907029487,137748.80243764177,2958,68,914.2285714285714,34,1,14,30.805584212135123,0.6727941176470588,40.35714285714286,1038.571428571429,30.546218487394967,0
2990,4,0,0,35,0.0,0.0,1.0,35,1100,900,200,0.8181818181818182,13,9,4,364.7993306349014,0.7524509803921569,0.07896675342533022,0.2352996125979886,134921.57206632657,2843.8598356009134,137765.43190192748,2959,69,915.2285714285714,34,1,14,30.792845956991712,0.6737132352941175,40.267857142857146,1038.9285714285718,30.55672268907564,0
2991,4,0,0,35,0.0,0.0,1.0,35,750,500,250,0.6666666666666666,10,5,5,364.7216497616949,0.7518207282913165,0.08072541573916481,0.23545048514201733,134952.4943310658,2844.0192743764233,137796.51360544222,2960,70,916.2285714285714,34,1,15,30.764016193095017,0.6740196078431373,40.23809523809524,1039.0476190476193,30.56022408963586,0
2992,4,0,0,35,0.0,0.0,1.0,35,350,300,50,0.8571428571428571,4,3,1,361.86118848462684,0.7518207282913165,0.07047232686177951,0.21493682641315762,131862.52170138873,2543.1857638888696,134405.7074652776,2961,71,917.2285714285714,35,0,17,33.93762677484787,0.6410714285714286,43.22916666666666,1027.083333333332,29.345238095238056,5
2993,4,0,0,35,0.0,0.0,1.0,35,1100,900,200,0.8181818181818182,13,9,4,365.93616321692684,0.7504201680672269,0.0683551636468962,0.21803901053958877,131981.42387902932,2659.3551740397625,134640.77905306907,2962,72,918.2285714285714,35,0,18,33.713017196065174,0.6422619047619048,43.11342592592592,1027.546296296295,29.35846560846557,0
2994,4,0,0,35,0.0,0.0,1.0,35,900,700,200,0.7777777777777778,11,7,4,365.02752853443457,0.7490896358543417,0.07088004890054211,0.2180100525160934,132070.6356765473,2641.8835465963434,134712.51922314364,2963,73,919.2285714285714,35,0,19,33.6463846038359,0.643154761904762,43.02662037037036,1027.893518518517,29.368386243386205,0
2995,4,0,0,35,0.0,0.0,1.0,35,1000,900,100,0.9,11,9,2,374.1100919064732,0.7496498599439776,0.034768957750324514,0.22056687953809825,131579.47063629376,2932.8987057521254,134512.3693420459,2964,74,920.2285714285714,33,2,16,33.90916149068323,0.6426767676767677,43.504901960784316,1025.980392156863,31.090314913844335,7
2996,4,0,0,35,0.0,0.0,1.0,35,1100,900,200,0.8181818181818182,13,9,4,374.69132254889337,0.751750700280112,0.03855914858780185,0.2216394433382439,131705.23356401396,2869.7616301422663,134574.99519415622,2965,75,921.2285714285714,33,2,16,33.76711238459091,0.6439393939393938,43.38235294117648,1026.470588235295,31.105169340463487,0
2997,4,0,0,35,0.0,0.0,1.0,35,1250,900,350,0.72,16,9,7,375.08631462740925,0.7515406162464986,0.034771339903829634,0.2222399677474141,131768.13755526723,2884.8850201845426,134653.02257545176,2966,76,922.2285714285714,33,2,17,33.6934033580011,0.6445707070707071,43.32107843137255,1026.7156862745098,31.112596553773024,0
2998,4,0,0,35,0.0,0.0,1.0,35,750,600,150,0.8,9,6,3,376.4287056920385,0.7514005602240896,0.03909989771564959,0.2234045717917339,131831.05656478275,2924.9987985390194,134756.05536332176,2967,77,923.2285714285714,33,2,17,33.595365950676204,0.6452020202020202,43.259803921568626,1026.9607843137253,31.120023767082586,0
2999,4,0,0,35,0.0,0.0,1.0,35,650,500,150,0.7692307692307693,8,5,3,377.40084662905787,0.7507703081232493,0.03809523809523796,0.2243527586131037,131893.9905925605,2955.3807429834606,134849.37133554395,2968,78,924.2285714285714,33,2,17,33.50682017020599,0.6458333333333334,43.1985294117647,1027.2058823529408,31.127450980392144,0
3000,4,0,0,35,0.0,0.0,1.0,35,1200,1100,100,0.9166666666666666,13,11,2,375.27766087608455,0.7502801120448179,0.046049538346223384,0.2238320386989221,132019.90370290278,2908.8241301422563,134928.72783304504,2969,79,925.2285714285714,33,2,17,33.434195882025605,0.6470959595959596,43.075980392156865,1027.6960784313728,31.142305407011296,0
3001,4,0,0,35,0.0,0.0,1.0,35,1250,800,450,0.64,17,8,9,372.07706794828897,0.747829131652661,0.045041455981749134,0.22284787131720868,132177.37956855536,2836.034367791232,135013.4139363466,2970,80,926.2285714285714,33,2,18,33.3575408175426,0.6486742424242424,42.92279411764706,1028.3088235294117,31.160873440285204,0
3002,4,0,0,35,0.0,0.0,1.0,35,1000,800,200,0.8,12,8,4,376.18149322030695,0.7468487394957982,0.05012674594668165,0.22643698914486873,132366.4745080018,2958.763606545565,135325.23811454736,2971,81,927.2285714285714,33,2,18,33.0612867690842,0.6505681818181819,42.7389705882353,1029.0441176470592,31.183155080213915,0
3003,4,0,0,35,0.0,0.0,1.0,35,1400,1100,300,0.7857142857142857,17,11,6,384.35309992600236,0.7483193277310923,0.058822129684711566,0.23291188211089028,132618.81134960108,3194.4902501441725,135813.30159974526,2972,82,928.2285714285714,33,2,19,32.596544715447145,0.6530934343434345,42.493872549019606,1030.0245098039213,31.212863933452162,0
3004,4,0,0,35,0.0,0.0,1.0,35,550,400,150,0.7272727272727273,7,4,3,384.35309992600236,0.7483193277310923,0.058822129684711566,0.23291188211089028,132618.81134960108,3194.4902501441725,135813.30159974526,2973,83,929.2285714285714,33,2,19,32.596544715447145,0.6530934343434345,42.493872549019606,1030.0245098039213,31.212863933452162,0
3005,4,0,0,35,0.0,0.0,1.0,35,800,500,300,0.625,11,5,6,382.85724529405337,0.7490896358543417,0.05712246597223447,0.2323957300496105,132681.9331056564,3159.6478818242917,135841.5809874807,2974,84,930.2285714285714,33,2,17,32.57144343999049,0.6537247474747474,42.432598039215684,1030.2696078431368,31.22029114676172,0
3006,4,0,0,35,0.0,0.0,1.0,35,1200,1100,100,0.9166666666666666,13,11,2,382.0604228378793,0.7483193277310923,0.05826357168327978,0.2330873341069672,132871.38848339577,3152.979773404462,136024.36825680023,2975,85,931.2285714285714,33,2,17,32.40112029002735,0.6556186868686869,42.24877450980392,1031.004901960784,31.242572786690427,0
3007,4,0,0,35,0.0,0.0,1.0,35,650,400,250,0.6153846153846154,9,4,5,380.5868957919239,0.7482492997198879,0.05926177459336479,0.23238448049297897,132902.97752066524,3116.226331218778,136019.20385188403,2976,86,932.2285714285714,33,2,17,32.4072973615403,0.6559343434343433,42.21813725490197,1031.1274509803932,31.246286393345247,0
3008,4,0,0,35,0.0,0.0,1.0,35,450,300,150,0.6666666666666666,6,3,3,383.3486378940921,0.7485994397759103,0.06187590187590164,0.23426861204638988,132934.57031250015,3192.057291666681,136126.62760416683,2977,87,933.2285714285714,33,2,17,32.30429292929293,0.65625,42.18750000000001,1031.2500000000011,31.250000000000036,0
3009,4,0,0,35,0.0,0.0,1.0,35,850,300,550,0.35294117647058826,14,3,11,383.9433788458781,0.7485294117647058,0.057638452791120676,0.23502919416332763,132997.76715986631,3212.7224204632817,136210.4895803296,2978,88,934.2285714285714,33,2,17,32.2253326600927,0.6568813131313131,42.12622549019608,1031.495098039215,31.257427213309544,0
3010,4,1,1,35,0.027777777777777776,0.027777777777777776,0.9722222222222222,36,700,400,300,0.5714285714285714,10,4,6,394.4471671839873,0.7584986772486773,0.062488817319735546,0.24742595032450104,133903.12499999997,3363.541666666667,137266.66666666663,2979,0,909.25,34,2,17,31.043679549114334,0.6636029411764706,41.25,1034.9999999999998,30.44117647058823,4
3011,4,0,0,35,0.0,0.0,1.0,35,950,800,150,0.8421052631578947,11,8,3,403.5432406414211,0.7464985994397758,0.0660991419432364,0.25213238299439195,133757.3007527153,3795.3709210399834,137552.67167375528,2980,90,936.2285714285714,33,2,18,30.954937211230906,0.6644570707070707,41.39093137254902,1034.4362745098038,31.346553773024358,0
3012,4,0,0,35,0.0,0.0,1.0,35,800,600,200,0.75,10,6,4,404.91090815868756,0.7467787114845937,0.07084820899815591,0.25342200130346904,133820.69283749035,3837.091653450593,137657.78449094095,2981,91,937.2285714285714,33,2,18,30.855812507402586,0.6650883838383839,41.3296568627451,1034.6813725490192,31.353980986333916,0
3013,4,0,0,35,0.0,0.0,1.0,35,350,200,150,0.5714285714285714,5,2,3,409.15560967932026,0.7463585434173668,0.07674532690518499,0.2565196082956093,133884.09994052764,3955.886107506723,137839.98604803436,2982,92,938.2285714285714,33,2,18,30.68223307677127,0.665719696969697,41.268382352941174,1034.926470588235,31.36140819964348,0
3014,4,0,0,35,0.0,0.0,1.0,35,850,700,150,0.8235294117647058,10,7,3,406.69478879706156,0.7466386554621848,0.07443181818181821,0.25563672438672436,133979.2387543252,3897.7316416762696,137876.97039600147,2983,93,939.2285714285714,33,2,18,30.650252525252526,0.6666666666666667,41.17647058823529,1035.2941176470583,31.372549019607828,0
3015,4,0,0,35,0.0,0.0,1.0,35,1300,1100,200,0.8461538461538461,15,11,4,406.51823196228054,0.7445378151260503,0.07127307146237571,0.2564098579511341,134106.1430699731,3903.3184352172243,138009.46150519032,2984,94,940.2285714285714,33,2,18,30.527291370878682,0.6679292929292929,41.05392156862745,1035.7843137254904,31.387403446226983,0
3016,4,0,0,35,0.0,0.0,1.0,35,650,500,150,0.7692307692307693,8,5,3,405.21517584710307,0.7429971988795517,0.06558994458710665,0.2564745154912502,134233.10745866972,3878.6584486735833,138111.7659073433,2985,95,941.2285714285714,33,2,19,30.43351860611794,0.6691919191919191,40.931372549019606,1036.2745098039213,31.4022578728461,0
3017,4,0,0,35,0.0,0.0,1.0,35,750,400,350,0.5333333333333333,11,4,7,406.3421804179312,0.7411764705882352,0.0674907125970956,0.25808219567084806,134360.13192041515,3919.23779315647,138279.36971357162,2986,96,942.2285714285714,33,2,19,30.276792750197004,0.6704545454545454,40.80882352941176,1036.7647058823525,31.417112299465227,0
3018,4,0,0,35,0.0,0.0,1.0,35,900,600,300,0.6666666666666666,12,6,6,402.48333589747625,0.7408963585434173,0.06265930689893828,0.2562992078028852,134455.43968966274,3823.214779171491,138278.65446883423,2987,97,943.2285714285714,33,2,19,30.281199535231792,0.6714015151515151,40.71691176470589,1037.1323529411775,31.42825311942962,0
3019,4,0,0,35,0.0,0.0,1.0,35,900,700,200,0.7777777777777778,11,7,4,405.6726404440088,0.7413865546218487,0.0641836131971989,0.25878062557336373,134518.99697532208,3914.1353385717175,138433.1323138938,2988,98,944.2285714285714,33,2,19,30.134746012994697,0.6720328282828282,40.65563725490197,1037.377450980393,31.43568033273918,0
3020,4,0,0,35,0.0,0.0,1.0,35,1000,600,400,0.6,14,6,8,404.94983902168093,0.7410364145658263,0.06823128448261317,0.2587705876978548,134582.56927924376,3899.8379529508156,138482.4072321946,2989,99,945.2285714285714,33,2,19,30.089735640329128,0.6726641414141413,40.59436274509805,1037.6225490196096,31.443107546048775,0
3021,4,0,0,35,0.0,0.0,1.0,35,700,500,200,0.7142857142857143,9,5,4,402.8268393622047,0.7411064425770307,0.06523865744644963,0.2580895105444686,134677.95589436765,3850.379060938111,138528.33495530576,2990,100,946.2285714285714,33,2,19,30.049193231011408,0.673611111111111,40.50245098039216,1037.990196078432,31.454248366013093,0
3022,4,0,0,35,0.0,0.0,1.0,35,800,300,500,0.375,13,3,10,399.10952570752414,0.7423669467787114,0.06332119249966262,0.25615575013592023,134741.5657439447,3755.3284794309957,138496.89422337568,2991,101,947.2285714285714,33,2,19,30.081936575385587,0.6742424242424241,40.44117647058824,1038.2352941176475,31.46167557932265,0
3023,4,0,0,35,0.0,0.0,1.0,35,700,500,200,0.7142857142857143,9,5,4,398.57635030062363,0.7414565826330531,0.06278026905829637,0.2562622149049688,134805.19061178408,3746.032175124973,138551.22278690906,2992,102,948.2285714285714,33,2,15,30.03205884666826,0.6748737373737372,40.37990196078432,1038.480392156864,31.46910279263224,0
3024,4,0,0,35,0.0,0.0,1.0,35,550,300,250,0.5454545454545454,8,3,5,398.64828900344554,0.7415966386554621,0.06407334996292069,0.25675857884446845,134868.83049788547,3753.045703575551,138621.876201461,2993,103,949.2285714285714,33,2,16,29.966473965707088,0.6755050505050504,40.318627450980394,1038.7254901960787,31.47653000594178,0
3025,4,0,0,35,0.0,0.0,1.0,35,950,700,250,0.7368421052631579,12,7,5,396.9142331078574,0.7428571428571428,0.06360588344312856,0.2563165104738405,134964.3184862794,3713.8517937812517,138678.17028006064,2994,104,950.2285714285714,33,2,16,29.91594429374534,0.6764520202020201,40.22671568627452,1039.0931372549028,31.487670825906147,0
3026,4,0,0,35,0.0,0.0,1.0,35,750,500,250,0.6666666666666666,10,5,5,398.95127793542116,0.7431372549019607,0.060161013238117844,0.25831333888917896,135059.84026576325,3776.4591743560277,138836.29944011927,2995,105,951.2285714285714,33,2,16,29.767448714925727,0.6773989898989898,40.13480392156863,1039.4607843137262,31.49881164587049,0
3027,4,0,0,35,0.0,0.0,1.0,35,900,500,400,0.5555555555555556,13,5,8,396.1756700212279,0.7416666666666666,0.058395340224235204,0.25742318038285944,135187.2552023262,3711.5802816224746,138898.83548394867,2996,106,952.2285714285714,33,2,16,29.712172990808398,0.6786616161616161,40.012254901960794,1039.950980392158,31.513666072489638,0
3028,4,0,0,35,0.0,0.0,1.0,35,1100,800,300,0.7272727272727273,14,8,6,396.2455890527807,0.7413165266106442,0.051134547778842965,0.2590695756601438,135410.37589208488,3731.1528318435353,139141.5287239284,2997,107,953.2285714285714,33,2,16,29.48739648337848,0.680871212121212,39.797794117647065,1040.8088235294126,31.539661319073108,0
3029,4,0,0,35,0.0,0.0,1.0,35,1000,700,300,0.7,13,7,6,394.9881538875653,0.7394957983193277,0.05654418565542785,0.2587065819024571,135474.15845167733,3702.1375492599104,139176.29600093723,2998,108,954.2285714285714,33,2,16,29.456420443398088,0.6815025252525253,39.73651960784314,1041.053921568628,31.54708853238267,0
3030,4,0,0,35,0.0,0.0,1.0,35,800,500,300,0.625,11,5,6,394.33352887156684,0.7386554621848739,0.05714958220548483,0.25873760577773763,135537.95602953184,3689.4320994329037,139227.38812896475,2999,109,955.2285714285714,33,2,18,29.40976717272763,0.6821338383838385,39.67524509803921,1041.2990196078426,31.5545157456922,0
3031,4,0,0,35,0.0,0.0,1.0,35,750,500,250,0.6666666666666666,10,5,5,392.68048685946184,0.738375350140056,0.052954129057200205,0.25811225505170665,135601.76862564884,3649.6337045847813,139251.40233023363,3000,110,956.2285714285714,33,2,18,29.389119308153898,0.6827651515151516,39.6139705882353,1041.5441176470592,31.561942959001794,0
3032,4,0,0,35,0.0,0.0,1.0,35,1150,700,450,0.6086956521739131,16,7,9,392.9097597394418,0.7392857142857142,0.04853210546658415,0.2587239246742831,135665.5962400279,3660.867364715498,139326.4636047434,3001,111,957.2285714285714,33,2,18,29.319467317570478,0.6833964646464646,39.552696078431374,1041.7892156862747,31.569370172311356,0
3033,4,0,0,35,0.0,0.0,1.0,35,400,300,100,0.75,5,3,2,391.5011753155479,0.7389355742296918,0.04594008837217123,0.25825713682762635,135729.43887266915,3627.6469687139574,139357.08584138312,3002,112,958.2285714285714,33,2,18,29.292480105060957,0.6840277777777778,39.49142156862745,1042.0343137254902,31.576797385620914,0
3034,4,0,0,35,0.0,0.0,1.0,35,900,700,200,0.7777777777777778,11,7,4,389.10263139277106,0.7391456582633052,0.06003393591333306,0.2573249728455515,135819.75623582755,3569.564909297038,139389.3211451246,3003,113,959.2285714285714,34,1,18,29.26493261763362,0.6825980392156863,39.4047619047619,1042.3809523809516,30.658263305322105,3
3035,4,0,0,35,0.0,0.0,1.0,35,1300,1000,300,0.7692307692307693,16,10,6,389.02167598986676,0.7377450980392156,0.06343261670962086,0.25771950365501156,135881.8098072562,3572.1938775510203,139454.00368480722,3004,114,960.2285714285714,34,1,15,29.205202862145097,0.6832107843137255,39.345238095238095,1042.6190476190473,30.665266106442566,0
3036,4,0,0,35,0.0,0.0,1.0,35,1450,1200,250,0.8275862068965517,17,12,5,389.05844709745423,0.7377450980392156,0.06814344610954781,0.2520221335352352,135076.21882086172,3510.508786848077,138586.7276077098,3005,115,961.2285714285714,34,1,17,30.00815964269355,0.6752450980392157,40.11904761904762,1039.5238095238096,30.574229691876752,1
3037,4,0,0,35,0.0,0.0,1.0,35,900,500,400,0.5555555555555556,13,5,8,387.9968899174281,0.7369747899159663,0.06329217433968437,0.2519816233032517,135169.0493905896,3489.0341553288,138658.08354591837,3006,116,962.2285714285714,34,1,17,29.942997519557327,0.6761642156862745,40.029761904761905,1039.8809523809525,30.584733893557427,0
3038,4,0,0,35,0.0,0.0,1.0,35,750,500,250,0.6666666666666666,10,5,5,389.2319353533563,0.7338235294117647,0.06598335867130944,0.25365383169671746,135292.8730867348,3532.0613662131645,138824.93445294796,3007,117,963.2285714285714,34,1,17,29.78720868138994,0.6773897058823529,39.91071428571429,1040.3571428571436,30.59873949579834,0
3039,4,0,0,35,0.0,0.0,1.0,35,700,500,200,0.7142857142857143,9,5,4,391.0746459387957,0.7322128851540616,0.07144654910356785,0.25529376252061337,135354.80619331062,3586.7665816326507,138941.57277494328,3008,118,964.2285714285714,34,1,17,29.67743011859818,0.6780024509803921,39.851190476190474,1040.5952380952378,30.60574229691876,0
3040,4,0,0,35,0.0,0.0,1.0,35,500,300,200,0.6,7,3,4,389.2562411279476,0.7312324929971988,0.06777135013236579,0.2543257144948071,135385.77806122456,3539.951814058967,138925.72987528352,3009,119,965.2285714285714,34,1,17,29.693815297796085,0.6783088235294117,39.82142857142858,1040.7142857142862,30.609243697479005,0
3041,4,0,0,35,0.0,0.0,1.0,35,950,700,250,0.7368421052631579,12,7,5,385.91408438796645,0.7307422969187675,0.06156711540975035,0.252577301937753,135447.73242630396,3454.2375283446813,138901.96995464864,3010,120,966.2285714285714,34,1,17,29.718950137236956,0.6789215686274509,39.761904761904766,1040.9523809523819,30.616246498599466,0
3042,4,0,0,35,0.0,0.0,1.0,35,1200,800,400,0.6666666666666666,16,8,8,384.13875679027205,0.7301120448179271,0.06062526542746105,0.2518498925702939,135509.70096371887,3410.905612244906,138920.6065759638,3011,121,967.2285714285714,34,1,18,29.703340574738927,0.6795343137254901,39.702380952380956,1041.1904761904766,30.6232492997199,0
3043,4,0,0,35,0.0,0.0,1.0,35,750,600,150,0.8,9,6,3,383.68000000000006,0.7292717086834734,0.06354285714285712,0.25242105263157905,135633.6805555556,3408.04280045352,139041.7233560091,3012,122,968.2285714285714,33,2,19,29.591666666666676,0.683080808080808,39.583333333333336,1041.666666666667,31.565656565656575,0
3044,4,0,0,35,0.0,0.0,1.0,35,850,500,350,0.5882352941176471,12,5,7,380.55247533339406,0.728641456582633,0.05606773283160882,0.25125918091888066,135761.36582083817,3332.8647635524803,139094.23058439064,3013,123,969.2285714285714,33,2,19,29.545899968642203,0.6843434343434343,39.46078431372549,1042.1568627450981,31.580510992275702,0
3045,4,0,0,35,0.0,0.0,1.0,35,1050,700,350,0.6666666666666666,14,7,7,379.8311232946719,0.726890756302521,0.05750554100342531,0.2516824919774975,135889.11115916952,3322.9827470203736,139212.0939061899,3014,124,970.2285714285714,33,2,16,29.43749020529698,0.6856060606060606,39.338235294117645,1042.647058823529,31.59536541889482,0
3046,4,0,0,35,0.0,0.0,1.0,35,700,500,200,0.7142857142857143,9,5,4,379.7506012356444,0.7265406162464986,0.05627695457367721,0.2527612875933574,136048.8773098088,3332.928591166865,139381.80590097565,3015,125,971.2285714285714,33,2,16,29.280585575002934,0.6871843434343434,39.185049019607845,1043.259803921569,31.61393345216876,0
3047,4,0,0,35,0.0,0.0,1.0,35,1000,500,500,0.5,15,5,10,381.1726808596533,0.7254901960784313,0.055666297526762776,0.25393616626283955,136080.8418036333,3374.0598567858547,139454.90166041916,3016,126,972.2285714285714,33,2,16,29.21169054889985,0.6875,39.154411764705884,1043.3823529411768,31.61764705882354,0
3048,4,0,0,35,0.0,0.0,1.0,35,1050,800,250,0.7619047619047619,13,8,5,379.9586455830852,0.7242296918767507,0.053607071571143194,0.25381237524950084,136176.75781250003,3348.307291666667,139525.0651041667,3017,127,973.2285714285714,33,2,17,29.14795409181636,0.6884469696969697,39.0625,1043.7500000000002,31.628787878787886,0
3049,4,0,0,35,0.0,0.0,1.0,35,400,100,300,0.25,7,1,6,379.9586455830852,0.7242296918767507,0.053607071571143194,0.25381237524950084,136176.75781250003,3348.307291666667,139525.0651041667,3018,128,974.2285714285714,33,2,17,29.14795409181636,0.6884469696969697,39.0625,1043.7500000000002,31.628787878787886,0
3050,4,0,0,35,0.0,0.0,1.0,35,700,400,300,0.5714285714285714,10,4,6,378.8895763005936,0.7242997198879552,0.05398353260778466,0.25355540459581727,136240.72059123876,3324.037779940391,139564.75837117914,3019,129,975.2285714285714,33,2,18,29.11225398129672,0.6890782828282829,39.00122549019607,1043.9950980392143,31.636215092097405,0
3051,4,0,0,35,0.0,0.0,1.0,35,1050,700,350,0.6666666666666666,14,7,7,377.081854627078,0.7242997198879552,0.13088344346851644,0.23167417418583558,133134.14292800458,3040.493905895694,136174.63683390027,3020,130,976.2285714285714,34,1,18,32.2651113161841,0.6559436274509804,41.99404761904762,1032.0238095238099,30.353641456582643,7
3052,4,0,0,35,0.0,0.0,1.0,35,1250,1000,250,0.8,15,10,5,375.66419845732025,0.7245098039215686,0.13356393404819555,0.23156614024309446,133257.03125,3011.9791666666665,136269.01041666666,3021,131,977.2285714285714,34,1,18,32.178167877320426,0.6571691176470589,41.875,1032.5,30.36764705882353,0
3053,4,0,0,35,0.0,0.0,1.0,35,1050,900,150,0.8571428571428571,12,9,3,374.990355104334,0.7230392156862745,0.13603372192583874,0.23172480917985758,133349.23469387754,3000.935374149657,136350.1700680272,3022,132,978.2285714285714,34,1,18,32.1029276164131,0.6580882352941178,41.785714285714285,1032.8571428571427,30.378151260504197,0
3054,4,0,0,35,0.0,0.0,1.0,35,800,600,200,0.75,10,6,4,353.3937263385613,0.7230392156862745,0.08192691029900345,0.20535040854808295,131023.24263038556,2260.5583900226834,133283.80102040825,3023,133,979.2285714285714,34,1,19,35.00242248062015,0.6348039215686274,44.04761904761905,1023.8095238095243,30.112044817927185,6
3055,4,0,0,35,0.0,0.0,1.0,35,1200,1100,100,0.9166666666666666,13,11,2,355.45122104799015,0.7213585434173669,0.0864945629617333,0.20736662760121718,131175.6395266439,2325.3082482993095,133500.94777494323,3024,134,980.2285714285714,34,1,19,34.79566143714893,0.6363357843137255,43.89880952380952,1024.4047619047612,30.12955182072827,0
3056,4,1,0,36,0.027777777777777776,0.0,1.0,36,750,400,350,0.5333333333333333,11,4,7,350.90100847871247,0.7311838624338625,0.08246275875411069,0.2063489548152976,131480.69905045364,2027.4305555555673,133508.1296060092,3025,0,953.9722222222222,34,2,20,34.60413039272586,0.6393995098039215,43.60119047619048,1025.595238095239,30.16456582633056,0
3057,4,1,1,36,0.02702702702702703,0.02702702702702703,0.972972972972973,37,700,600,100,0.8571428571428571,8,6,2,342.4412361293399,0.7414914914914915,0.08628912888547724,0.20340184266477684,131862.5217013891,1631.0329861111356,133493.55468750023,3026,0,929.1621621621622,35,2,15,34.436274509803916,0.6410714285714285,43.22916666666668,1027.083333333335,29.345238095238145,0
3058,4,0,0,36,0.0,0.0,1.0,36,600,300,300,0.5,9,3,6,350.88016961304686,0.7340939153439154,0.08931356248952782,0.20732953682207547,131663.90483276665,2039.6506519274596,133703.5554846941,3027,1,955.9444444444445,34,2,15,34.41982755287476,0.6412377450980391,43.42261904761906,1026.3095238095254,30.185574229691923,0
3059,4,0,0,36,0.0,0.0,1.0,36,950,500,450,0.5263157894736842,14,5,9,353.30728838479286,0.7303571428571429,0.09785829307568439,0.20943473280541855,131786.11288265313,2112.1988378684846,133898.31172052163,3028,2,956.9444444444445,34,2,16,34.234299516908195,0.6424632352941175,43.30357142857143,1026.785714285715,30.19957983193279,0
3060,4,1,1,36,0.02702702702702703,0.02702702702702703,0.972972972972973,37,1200,800,400,0.6666666666666666,16,8,8,347.94350760545467,0.7441191191191191,0.09090134709225195,0.2082971780031579,132159.8776148836,1796.834276406054,133956.71189128965,3029,0,932.0540540540541,35,2,17,33.99557256491069,0.644047619047619,42.939814814814824,1028.2407407407422,29.378306878306923,0
3061,4,0,0,36,0.0,0.0,1.0,36,1150,900,250,0.782608695652174,14,9,5,355.1685365892281,0.7324074074074075,0.09333596066509009,0.21212184085063468,132070.63567654754,2181.4668799297056,134252.10255647724,3030,4,958.9444444444445,35,1,17,33.89973445182599,0.6431547619047618,43.026620370370374,1027.893518518519,29.368386243386254,0
3062,4,1,1,36,0.02702702702702703,0.02702702702702703,0.972972972972973,37,1100,1000,100,0.9090909090909091,12,10,2,346.8034221219204,0.7463713713713713,0.08609003091761713,0.20828726239866835,132282.13168827622,1775.1791910153495,134057.31087929156,3031,0,934.0,36,1,17,33.90188834154351,0.6432291666666665,42.82094594594595,1028.716216216217,28.57545045045047,0
3063,4,0,0,36,0.0,0.0,1.0,36,800,600,200,0.75,10,6,4,354.71200980198114,0.732936507936508,0.0892046520352654,0.21251626480718822,132189.63162562152,2177.8499817815423,134367.48160740305,3032,6,960.9444444444445,35,1,18,33.791619771149875,0.6443452380952381,42.910879629629626,1028.356481481481,29.381613756613746,0
3064,4,0,0,36,0.0,0.0,1.0,36,800,500,300,0.625,11,5,6,355.2435023237393,0.7329034391534393,0.085845519310086,0.21367488062638987,132338.4519140089,2202.475030006856,134540.92694401578,3033,7,961.9444444444445,35,1,18,33.62814023247093,0.6458333333333333,42.7662037037037,1028.9351851851852,29.39814814814815,0
3065,4,0,0,36,0.0,0.0,1.0,36,1050,700,350,0.6666666666666666,14,7,7,353.5543936140572,0.7330357142857143,0.08423301844354514,0.21299496395773673,132398.00347222213,2161.9791666666565,134559.9826388888,3034,8,962.9444444444445,35,1,18,33.611673414305,0.6464285714285715,42.70833333333333,1029.1666666666658,29.40476190476188,0
3066,4,0,0,36,0.0,0.0,1.0,36,1100,800,300,0.7272727272727273,14,8,6,354.12306014889225,0.7341931216931218,0.08576943257626901,0.21367506763665162,132457.56842635444,2181.2558942043725,134638.8243205588,3035,9,963.9444444444445,35,1,19,33.537122404617335,0.6470238095238096,42.650462962962955,1029.398148148147,29.411375661375626,0
3067,4,0,0,36,0.0,0.0,1.0,36,600,100,500,0.16666666666666666,11,1,10,353.1039334946752,0.7331679894179894,0.08784796373309378,0.21356666868131358,132546.94097490126,2160.569246184822,134707.51022108606,3036,10,964.9444444444445,35,1,20,33.47347888801468,0.6479166666666667,42.5636574074074,1029.745370370369,29.42129629629626,0
3068,4,0,0,36,0.0,0.0,1.0,36,650,600,50,0.9230769230769231,7,6,1,364.1002858924761,0.7331679894179894,0.11785973189821419,0.204126403305993,129631.08114448926,2239.7427410518803,131870.82388554115,3037,11,965.9444444444445,36,0,17,36.14144457960117,0.6166087962962963,45.411036036036045,1018.3558558558573,28.2876626626627,5
3069,4,0,0,36,0.0,0.0,1.0,36,850,800,50,0.9411764705882353,9,8,1,364.64252354231,0.732473544973545,0.11747979462991598,0.20487927130209577,129717.10519641281,2260.0745170846685,131977.1797134975,3038,12,966.9444444444445,36,0,17,36.04010059694892,0.6174768518518519,45.326576576576585,1018.6936936936952,28.297047047047087,0
3070,4,0,0,36,0.0,0.0,1.0,36,900,600,300,0.6666666666666666,12,6,6,363.6894485986858,0.7325066137566139,0.11780762192500926,0.20449337734445694,129745.78622118749,2237.434689757336,131983.22091094483,3039,13,967.9444444444445,36,0,17,36.03519582918831,0.6177662037037037,45.29842342342343,1018.806306306307,28.300175175175195,0
3071,4,3,1,38,0.07692307692307693,0.02564102564102564,0.9743589743589743,39,900,600,300,0.6666666666666666,12,6,6,337.17451346355034,0.7638326585695007,0.10852457384987302,0.19093555010535707,130023.43885633687,968.1179470486211,130991.5568033855,3040,0,894.4102564102565,39,0,17,36.42896963197496,0.6151175213675213,45.02604166666667,1019.8958333333339,26.15117521367523,4
3072,4,2,1,39,0.05,0.025,0.975,40,900,600,300,0.6666666666666666,12,6,6,330.74871922484857,0.7715277777777778,0.10698143046627884,0.18857872001877513,130289.1723632814,618.8151041666817,130907.98746744808,3041,0,873.0,39,1,19,36.32378073665953,0.6177884615384615,44.76562500000001,1020.9375000000011,26.177884615384645,0
3073,4,0,0,39,0.0,0.0,1.0,39,1000,900,100,0.9,11,9,2,336.69080467000174,0.763888888888889,0.10658896008414653,0.1919700077223473,130289.85407991837,973.4791621009766,131263.33324201935,3042,1,896.3846153846154,38,1,20,36.171428073112885,0.619517543859649,44.764957264957275,1020.9401709401724,26.866846603688746,0
3074,4,0,0,39,0.0,0.0,1.0,39,850,600,250,0.7058823529411765,11,6,5,336.993019917254,0.7642262708052182,0.10710319184895467,0.19241214363017423,130344.39718934921,985.0304076265716,131329.4275969758,3043,2,897.3846153846154,38,1,20,36.108495501150884,0.6200657894736842,44.71153846153847,1021.1538461538469,26.87246963562755,0
3075,4,0,0,39,0.0,0.0,1.0,39,850,300,550,0.35294117647058826,14,3,11,338.59132368130815,0.763888888888889,0.11263812895612069,0.19359647454505413,130398.9517130543,1030.390733435607,131429.3424464899,3044,3,898.3846153846154,38,1,20,36.012465132496516,0.6206140350877192,44.65811965811966,1021.3675213675215,26.878092667566353,0
3076,4,1,1,39,0.025,0.025,0.975,40,1150,800,350,0.6956521739130435,15,8,7,333.91818951156745,0.770673076923077,0.10757768721344818,0.19222328622029541,130661.65500217026,726.0606553819536,131387.7156575522,3045,0,876.9,39,1,15,35.866127525895735,0.6215277777777778,44.40104166666667,1022.3958333333343,26.215277777777803,0
3077,4,0,0,39,0.0,0.0,1.0,39,1000,800,200,0.8,12,8,4,338.52380695006735,0.7614709851551957,0.1086735746574814,0.19478859342785282,130644.58832137109,1045.2606791949656,131689.84900056606,3046,5,900.3846153846154,38,1,15,35.76566691050963,0.6230811403508772,44.41773504273504,1022.3290598290592,26.903396311291033,0
3078,4,0,0,39,0.0,0.0,1.0,39,1300,1100,200,0.8461538461538461,15,11,4,336.936773346058,0.761808367071525,0.11169424731225996,0.19414941948796632,130699.20562358461,1007.4737243407089,131706.67934792532,3047,6,901.3846153846154,38,1,15,35.751009995472444,0.6236293859649124,44.36431623931624,1022.5427350427349,26.909019343229865,0
3079,4,1,2,38,0.025,0.05,0.95,40,1200,600,600,0.5,18,6,12,332.423582543206,0.7701923076923077,0.11142791738732316,0.19322243600338118,131034.66932508699,711.802842881963,131746.47216796895,3048,0,879.825,39,1,15,35.5276265812053,0.6252670940170939,44.03645833333334,1023.8541666666681,26.252670940170976,0
3080,4,1,2,37,0.02564102564102564,0.05128205128205128,0.9487179487179487,39,1000,600,400,0.6,14,6,8,339.10256292240547,0.7609649122807017,0.11341891938906867,0.19678629045182094,130972.46334876529,1082.6195987654153,132055.0829475307,3049,0,903.1794871794872,38,1,15,35.419493441881485,0.6263706140350878,44.097222222222214,1023.6111111111101,26.93713450292395,0
3081,4,0,0,37,0.0,0.0,1.0,37,800,500,300,0.625,11,5,6,353.03034031611975,0.744994994994995,0.11901657109852803,0.2030931197331896,130636.47050766971,1823.7275282038681,132460.1980358736,3050,10,952.7567567567568,36,1,15,35.403126606447834,0.6267361111111112,44.42567567567567,1022.2972972972964,28.397147147147123,0
3082,4,0,0,37,0.0,0.0,1.0,37,1150,900,250,0.782608695652174,14,9,5,352.2882350745183,0.7446196196196196,0.11427313260307126,0.20349826284892772,130794.81336805563,1815.4947916666715,132610.3081597223,3051,11,953.7567567567568,37,0,15,35.26179565512558,0.6264076576576576,44.270833333333336,1022.9166666666673,27.646396396396415,0
3083,4,3,2,38,0.075,0.05,0.95,40,1100,800,300,0.7272727272727273,14,8,6,337.5504684052248,0.7740918803418804,0.12819649347872542,0.19858157745047023,131496.76462950153,880.6141072253132,132377.37873672685,3052,0,883.15,37,3,16,34.930243745991014,0.6334459459459458,43.58552631578948,1025.6578947368432,27.720483641536305,0
3084,4,0,0,38,0.0,0.0,1.0,38,900,400,500,0.4444444444444444,14,4,10,367.5710555317435,0.7533783783783784,0.10373291952239327,0.20493345150879397,129413.28124999999,1980.8633425669436,131394.14459256694,3053,1,930.6315789473684,34,4,18,36.27491127491128,0.6185661764705883,45.625,1017.4999999999999,29.92647058823529,6
3085,4,0,0,38,0.0,0.0,1.0,38,950,600,350,0.631578947368421,13,6,7,368.05145833992503,0.753645092460882,0.10680692180656237,0.20594024348333206,129554.63927469132,1936.554783950609,131491.19405864194,3054,2,931.6315789473684,35,3,16,36.118690313778956,0.6178571428571429,45.48611111111111,1018.0555555555553,29.08730158730158,0
3086,4,1,1,38,0.02564102564102564,0.02564102564102564,0.9743589743589743,39,650,300,350,0.46153846153846156,10,3,7,362.7965327061016,0.7619208277103015,0.11389590043882425,0.20459011947183342,129860.54202428785,1622.5908763493292,131483.13290063717,3055,0,908.7179487179487,36,3,16,35.941240378595374,0.6189236111111112,45.185810810810814,1019.2567567567571,28.3126876876877,0
3087,4,1,0,39,0.02564102564102564,0.0,1.0,39,1200,1000,200,0.8333333333333334,14,10,4,359.5695734726759,0.7620332883490778,0.11462747062702872,0.20396623457038024,130090.20580969493,1555.2959631929339,131645.50177288786,3056,0,909.6923076923077,36,3,17,35.79014423961438,0.6212384259259258,44.96058558558559,1020.1576576576584,28.337712712712733,0
3088,4,0,0,39,0.0,0.0,1.0,39,1600,1200,400,0.75,20,12,8,365.7502687155454,0.7611898335582546,0.11586849057097304,0.2088682602509547,130351.21588059382,1735.3125815496996,132086.52846214353,3057,1,910.6923076923077,35,4,17,35.367434546072765,0.6258928571428573,44.70486111111109,1021.180555555553,29.17658730158723,0
3089,4,0,0,39,0.0,0.0,1.0,39,1300,1000,300,0.7692307692307693,16,10,6,362.5554419472368,0.7612460638776428,0.11842231679128323,0.20795373452776392,130521.37230135537,1664.2467636555416,132185.61906501092,3058,2,911.6923076923077,36,3,17,35.27638490926455,0.6255787037037037,44.538288288288285,1021.8468468468466,28.384634634634626,0
3090,4,0,0,39,0.0,0.0,1.0,39,1300,1000,300,0.7692307692307693,16,10,6,364.7513648506775,0.76259559154296,0.09173576055589017,0.20829781825744487,130351.21588059393,1714.1279678819942,132065.34384847592,3059,3,912.6923076923077,35,4,19,35.392936076164574,0.6258928571428573,44.7048611111111,1021.1805555555538,29.17658730158725,3
3091,4,0,0,39,0.0,0.0,1.0,39,750,500,250,0.6666666666666666,10,5,5,363.30820406230714,0.7628767431399011,0.09198227645819768,0.20778968897277103,130410.31867551857,1675.82773383915,132086.14640935772,3060,4,913.6923076923077,35,4,20,35.36980642115202,0.6264880952380952,44.64699074074073,1021.4120370370362,29.183201058201032,0
3092,4,0,0,39,0.0,0.0,1.0,39,800,500,300,0.625,11,5,6,363.4047048743417,0.7627642825011246,0.09576600603113206,0.20800323769266787,130439.87509645052,1680.4928626543112,132120.36795910483,3061,5,914.6923076923077,35,4,20,35.33735554044868,0.6267857142857144,44.61805555555555,1021.5277777777769,29.186507936507912,0
3093,4,2,2,39,0.04878048780487805,0.04878048780487805,0.9512195121951219,41,950,600,350,0.631578947368421,13,6,7,348.16514499585,0.7849593495934959,0.09387538522261263,0.20140911146660107,130850.90033712289,911.5445377423782,131762.44487486526,3062,0,871.0243902439024,37,4,17,35.31050173257601,0.6269707207207207,44.21600877192982,1023.1359649122801,27.65232337600757,0
3094,4,1,1,39,0.025,0.025,0.975,40,900,600,300,0.6666666666666666,12,6,6,357.3637346365093,0.7683760683760684,0.10331725616291587,0.20658015143485933,130822.85534972289,1350.268832717754,132173.12418244063,3063,0,893.775,37,3,17,35.10360843158273,0.6266891891891893,44.243421052631575,1023.0263157894727,27.649359886201967,0
3095,4,0,1,38,0.0,0.02564102564102564,0.9743589743589743,39,1000,700,300,0.7,13,7,6,368.54413133903705,0.759952766531714,0.11558085492674253,0.21249201629776457,130722.82745160689,1835.4261778670452,132558.25362947394,3064,8,917.6923076923077,36,3,17,34.9190617773373,0.6276041666666667,44.34121621621621,1022.6351351351341,28.406531531531503,0
3096,4,0,0,38,0.0,0.0,1.0,38,1150,700,450,0.6086956521739131,16,7,9,376.7312584703236,0.760164770033191,0.12398104096081375,0.21778466930145104,130824.41332572426,2257.1291741683617,133081.54249989262,3065,9,932.4736842105264,35,3,17,34.60669099068522,0.630654761904762,44.24189814814814,1023.0324074074059,29.229497354497312,0
3097,4,0,0,38,0.0,0.0,1.0,38,1000,500,500,0.5,15,5,10,377.80622567368584,0.7584459459459459,0.11658724634577289,0.21975356203386553,131061.33355034707,2303.157552083314,133364.4911024304,3066,10,933.4736842105264,35,3,20,34.33897083757205,0.6330357142857144,44.01041666666666,1023.9583333333321,29.255952380952348,0
3098,4,0,0,38,0.0,0.0,1.0,38,1150,900,250,0.782608695652174,14,9,5,374.8196225361006,0.7598980559506875,0.11376554807715178,0.21885905664179167,131209.51753257884,2235.9803669410153,133445.49789951986,3067,11,934.4736842105264,35,3,20,34.26532610332882,0.6345238095238095,43.86574074074074,1024.537037037037,29.27248677248677,0
3099,4,0,0,38,0.0,0.0,1.0,38,1200,1000,200,0.8333333333333334,14,10,4,372.50267612101044,0.7587126600284495,0.10908539702543041,0.21784271429163962,131268.8145683298,2179.5969435870984,133448.4115119169,3068,12,935.4736842105264,35,3,20,34.2646449815526,0.6351190476190476,43.80787037037037,1024.7685185185178,29.279100529100507,0
3100,4,0,0,38,0.0,0.0,1.0,38,800,500,300,0.625,11,5,6,371.80249851278995,0.7579717875770507,0.10376551133932366,0.2177700348432055,131328.12500000003,2165.651791838135,133493.77679183817,3069,13,936.4736842105264,33,5,21,34.222560975609746,0.6401515151515151,43.75,1025.0000000000002,31.060606060606066,0
3101,4,0,0,38,0.0,0.0,1.0,38,1000,600,400,0.6,14,6,8,370.3513629385783,0.7578532479848269,0.10776825974851212,0.21761300411684262,131450.17715419497,2136.5504535147375,133586.7276077097,3070,14,937.4736842105264,34,4,21,34.13628976085441,0.639093137254902,43.63095238095238,1025.4761904761904,30.161064425770306,0
3102,4,0,0,38,0.0,0.0,1.0,38,1050,700,350,0.6666666666666666,14,7,7,368.42046218689836,0.7567863916548128,0.10494249433494396,0.21699788945075194,131541.75347222213,2092.534722222217,133634.28819444435,3071,15,938.4736842105264,34,4,23,34.09321689683185,0.6400122549019608,43.541666666666664,1025.8333333333328,30.171568627450966,0
3103,4,0,0,38,0.0,0.0,1.0,38,1400,1000,400,0.7142857142857143,18,10,8,368.68117591752315,0.7561344238975818,0.10210379794748436,0.217847869608291,131663.9048327664,2108.4006519274303,133772.30548469382,3072,16,939.4736842105264,34,4,19,33.963093995282826,0.6412377450980392,43.422619047619044,1026.3095238095234,30.185574229691866,0
3104,4,0,0,38,0.0,0.0,1.0,38,950,700,250,0.7368421052631579,12,7,5,368.19815736211865,0.7548601232811759,0.10035030758714969,0.21808660089910092,131755.55555555545,2102.4305555555466,133857.98611111098,3073,17,940.4736842105264,34,4,19,33.88291396103896,0.6421568627450981,43.33333333333333,1026.6666666666658,30.196078431372523,0
3105,4,0,0,38,0.0,0.0,1.0,38,800,500,300,0.625,11,5,6,364.8686336320344,0.754208155523945,0.09878506003511922,0.21638466026627054,131803.0907064471,2018.162722908081,133821.2534293552,3074,18,941.4736842105264,35,3,19,33.92038623384429,0.6404761904761905,43.28703703703703,1026.851851851851,29.338624338624317,0
3106,4,0,0,38,0.0,0.0,1.0,38,1200,600,600,0.5,18,6,12,363.47061297361654,0.7554824561403509,0.09918754633061555,0.21606173410186502,131892.24222232925,1987.7908254029342,133880.0330477322,3075,19,942.4736842105264,35,3,19,33.86631455399061,0.6413690476190477,43.200231481481474,1027.199074074073,29.348544973544943,0
3107,4,0,0,38,0.0,0.0,1.0,38,800,600,200,0.75,10,6,4,363.96303200639085,0.7552157420578474,0.10471182461673445,0.2168633421579018,131981.42387902946,2007.271840706443,133988.6957197359,3076,20,943.4736842105264,35,3,19,33.763704287752496,0.6422619047619048,43.113425925925924,1027.546296296296,29.358465608465604,0
3108,4,0,0,38,0.0,0.0,1.0,38,800,600,200,0.75,10,6,4,364.87538833624336,0.7547119487908962,0.10562770819378664,0.21757747300453356,132011.15779588904,2033.5244930984225,134044.68228898747,3077,21,944.4736842105264,35,3,19,33.71027611968315,0.6425595238095239,43.08449074074074,1027.662037037037,29.361772486772484,0
3109,4,1,0,39,0.02564102564102564,0.0,1.0,39,1000,700,300,0.7,13,7,6,353.8062134423586,0.7668128654970761,0.10392234448270354,0.21281944517595988,132340.0612394489,1564.5471907718545,133904.60843022075,3078,0,921.2307692307693,36,3,21,33.66349275838168,0.6438078703703705,42.76463963963964,1028.9414414414414,28.581706706706704,0
3110,4,1,0,40,0.025,0.0,1.0,40,850,500,350,0.5882352941176471,12,5,7,347.1451896033315,0.7762286324786325,0.10619312436804895,0.2106298113605486,132666.1512586803,1210.9086097287834,133877.0598684091,3079,0,899.175,35,5,16,33.50711998651836,0.649107142857143,42.44791666666665,1030.2083333333312,29.43452380952375,0
3111,4,0,0,40,0.0,0.0,1.0,40,700,400,300,0.5714285714285714,10,4,6,345.72669062480077,0.7767895299145299,0.10254890175937059,0.21021561102375744,132745.9231824729,1178.7617431620704,133924.68492563497,3080,1,900.175,36,4,16,33.46355589553055,0.6478587962962964,42.37049549549549,1030.5180180180173,28.62550050050048,0
3112,4,0,0,40,0.0,0.0,1.0,40,500,300,200,0.6,7,3,4,345.72669062480077,0.7767895299145299,0.10254890175937059,0.21021561102375744,132745.9231824729,1178.7617431620704,133924.68492563497,3081,2,901.175,36,4,16,33.46355589553055,0.6478587962962964,42.37049549549549,1030.5180180180173,28.62550050050048,0
3113,4,0,1,39,0.0,0.025,0.975,40,750,500,250,0.6666666666666666,10,5,5,347.95405661522676,0.7747596153846154,0.09945658110322286,0.21222647490422358,132861.99787202713,1245.974225915074,134107.9720979422,3082,3,902.175,36,4,16,33.28964136173311,0.6490162037037039,42.25788288288287,1030.9684684684662,28.63801301301295,0
3114,4,0,0,39,0.0,0.0,1.0,39,800,600,200,0.75,10,6,4,357.70591611511145,0.7643387314439947,0.1038081415439911,0.21755556537492793,132755.59413580218,1697.4922839505796,134453.08641975277,3083,4,926.2051282051282,35,4,16,33.14521563342316,0.6500000000000001,42.36111111111109,1030.5555555555532,29.444444444444375,0
3115,4,0,0,39,0.0,0.0,1.0,39,1150,1000,150,0.8695652173913043,13,10,3,358.6514957657769,0.7631578947368421,0.10002561512270836,0.21900110868932837,132904.7325772674,1733.2962266374843,134638.0288039049,3084,5,927.2051282051282,35,4,16,32.97098907471843,0.6514880952380953,42.21643518518517,1031.134259259257,29.460978835978775,0
3116,4,0,0,39,0.0,0.0,1.0,39,800,500,300,0.625,11,5,6,364.2012029876397,0.7629892037786775,0.06087137794454889,0.21331784746418908,131328.1250000001,1794.9141053669557,133123.03910536703,3085,6,928.2051282051282,34,5,17,34.41734417344174,0.6378676470588235,43.75000000000001,1025.0000000000007,30.14705882352943,7
3117,4,0,1,38,0.0,0.02564102564102564,0.9743589743589743,39,1100,700,400,0.6363636363636364,15,7,8,362.8098501891561,0.7630454340980657,0.05652450744119353,0.21386424684884717,131572.28599773237,1747.1442743764123,133319.4302721088,3086,7,929.2051282051282,34,5,13,34.206264021041235,0.6403186274509804,43.51190476190476,1025.9523809523805,30.17507002801119,0
3118,4,1,1,38,0.02564102564102564,0.02564102564102564,0.9743589743589743,39,1050,900,150,0.8571428571428571,12,9,3,360.3510613092837,0.7595591542959964,0.05919767348504479,0.21326748124021638,131725.00177154198,1693.448837868486,133418.45060941047,3087,0,930.0,34,5,13,34.115157137887046,0.6418504901960784,43.36309523809524,1026.5476190476193,30.19257703081233,0
3119,4,0,1,37,0.0,0.02631578947368421,0.9736842105263158,38,1450,1000,450,0.6896551724137931,19,10,9,367.64560341033945,0.7539414414414415,0.06681515176265851,0.21765139362320945,131736.68368235772,2086.482512735486,133823.16619509322,3088,32,955.4736842105264,33,5,14,33.91615435119971,0.6442550505050505,43.35171568627451,1026.5931372549019,31.10888294711824,0
3120,4,1,0,38,0.02631578947368421,0.0,1.0,38,1050,900,150,0.8571428571428571,12,9,3,362.1812148139651,0.7632764343290659,0.06530710377191928,0.21854717128376516,132459.27047902488,1996.5076625012653,134455.77814152616,3089,0,935.9473684210526,34,4,19,33.32803284376084,0.649203431372549,42.64880952380952,1029.4047619047615,30.27661064425769,7
3121,4,0,0,38,0.0,0.0,1.0,38,750,500,250,0.6666666666666666,10,5,5,363.56894650079954,0.7636913229018493,0.06551120086127682,0.22045985242266428,132643.15653344677,2044.986536281179,134688.14306972796,3090,1,936.9473684210526,34,4,17,33.107255672406474,0.6510416666666667,42.470238095238095,1030.119047619048,30.297619047619058,0
3122,4,0,1,37,0.0,0.02631578947368421,0.9736842105263158,38,1100,1000,100,0.9090909090909091,12,10,2,366.8941143102494,0.7637209577999051,0.06380036591073468,0.22357045290728,132827.17013888885,2146.701388888885,134973.87152777772,3091,2,937.9473684210526,34,4,17,32.83649959579627,0.6528799019607843,42.291666666666664,1030.833333333333,30.318627450980383,0
3123,4,1,0,38,0.02631578947368421,0.0,1.0,38,1150,800,350,0.6956521739130435,15,8,7,362.35939997782475,0.7619428639165481,0.07038296838460867,0.22189711666486556,133011.31129535136,2039.579790249425,135050.8910856008,3092,0,938.8684210526316,34,4,18,32.76832083092904,0.654718137254902,42.113095238095234,1031.5476190476181,30.339635854341708,0
3124,4,1,0,39,0.02564102564102564,0.0,1.0,39,1200,900,300,0.75,15,9,6,354.2153494373338,0.7701866846603689,0.07535392202507185,0.2185552799225374,133292.8843557098,1642.8771219135676,134935.76147762337,3093,0,915.7692307692307,35,4,20,32.69586415601883,0.655357142857143,41.84027777777777,1032.6388888888882,29.503968253968235,0
3125,4,0,0,39,0.0,0.0,1.0,39,1100,800,300,0.7272727272727273,14,8,6,354.2153494373338,0.7689496176338282,0.07535392202507185,0.2185552799225374,133292.8843557098,1642.8771219135676,134935.76147762337,3094,1,916.7692307692307,35,4,20,32.69586415601883,0.655357142857143,41.84027777777777,1032.6388888888882,29.503968253968235,0
3126,4,0,1,38,0.0,0.02564102564102564,0.9743589743589743,39,1350,1000,350,0.7407407407407407,17,10,7,352.4973985431843,0.7684997750787225,0.07609594706368905,0.21854838709677418,133472.22222222216,1609.8427854938227,135082.06500771598,3095,2,917.7692307692307,34,5,20,32.56048387096774,0.6593137254901962,41.666666666666664,1033.333333333333,30.39215686274509,0
3127,4,1,0,39,0.02564102564102564,0.0,1.0,39,1000,600,400,0.6,14,6,8,346.46878962859734,0.7717049032838507,0.07839004938118532,0.2160642049894922,133687.58680555562,1463.7152777777835,135151.3020833334,3096,0,912.7179487179487,34,5,21,32.500671501477285,0.6614583333333333,41.458333333333336,1034.1666666666672,30.416666666666682,0
3128,4,0,1,38,0.0,0.02564102564102564,0.9743589743589743,39,900,500,400,0.5555555555555556,13,5,8,353.54236335263573,0.7720422852001799,0.07631555649176835,0.21316599496042965,132429.53619100814,1692.0152405324761,134121.5514315406,3097,1,913.7179487179487,33,6,20,33.58026253125373,0.651199494949495,42.67769607843137,1029.2892156862736,31.19058229352344,5
3129,4,0,0,38,0.0,0.0,1.0,38,600,200,400,0.3333333333333333,10,2,8,351.19543035111514,0.7713074917022286,0.07701150865498474,0.21210588140760006,132492.612892277,1706.160040609382,134198.77293288638,3098,2,927.6578947368421,33,5,20,33.57722790937587,0.6518308080808082,42.61642156862745,1029.53431372549,31.198009506833028,0
3130,4,1,0,39,0.02564102564102564,0.0,1.0,39,1500,1300,200,0.8666666666666667,17,13,4,344.48806985864087,0.7758097165991903,0.11010847076420838,0.2087819953711018,132623.79410010795,1337.4629693752136,133961.25706948317,3099,0,904.8461538461538,37,2,18,33.618089560712505,0.6447072072072071,42.48903508771931,1030.0438596491244,27.83902323376012,1
3131,4,0,0,39,0.0,0.0,1.0,39,650,400,250,0.6153846153846154,9,4,5,344.6668182916356,0.7759221772379667,0.10780966416942972,0.20904743433504977,132652.03145439006,1344.150724261334,133996.1821786514,3100,1,905.8461538461538,37,2,17,33.585129501507886,0.6449887387387386,42.461622807017555,1030.1535087719317,27.84198672356572,0
3132,4,0,0,39,0.0,0.0,1.0,39,950,600,350,0.631578947368421,13,6,7,347.714803078316,0.775472334682861,0.11104200763775274,0.21169165472384543,132793.26331178838,1434.8366805171013,134228.09999230548,3101,2,906.8461538461538,37,2,17,33.36480496453902,0.6463963963963963,42.32456140350878,1030.701754385966,27.856804172593677,0
3133,4,0,0,39,0.0,0.0,1.0,39,1350,900,450,0.6666666666666666,18,9,9,348.57667584940305,0.7756972559604138,0.11033411033411022,0.2130190796857464,132934.57031250012,1467.5781250000146,134402.14843750012,3102,3,907.8461538461538,37,2,18,33.20075757575758,0.647804054054054,42.18750000000001,1031.250000000001,27.871621621621646,0
3134,4,0,0,39,0.0,0.0,1.0,39,950,800,150,0.8421052631578947,11,8,3,348.98350042718175,0.7749662618083671,0.11363177895178778,0.21342905104148746,132962.84072984022,1480.3675169283163,134443.20824676854,3103,4,908.8461538461538,37,2,18,33.16190020554257,0.6480855855855854,42.16008771929826,1031.359649122809,27.874585111427272,0
3135,4,0,0,39,0.0,0.0,1.0,39,950,700,250,0.7368421052631579,12,7,5,347.81243492294834,0.7741228070175439,0.12022501308215539,0.2130351163903063,133019.39058171777,1453.1596260388164,134472.55020775658,3104,5,909.8461538461538,37,2,18,33.13536352040816,0.6486486486486485,42.105263157894754,1031.5789473684235,27.880512091038476,0
3136,4,0,0,39,0.0,0.0,1.0,39,1350,1200,150,0.8888888888888888,15,12,3,349.29812705256757,0.7731668915879443,0.12075498424165176,0.21475788830475642,133160.81781173067,1502.5648516851502,134663.3826634158,3105,6,910.8461538461538,37,2,18,32.95519936966607,0.6500563063063062,41.96820175438597,1032.1271929824572,27.895329540066413,0
3137,4,0,0,39,0.0,0.0,1.0,39,800,400,400,0.5,12,4,8,356.8220072452795,0.7740665766981557,0.1661306554651263,0.213364996169116,132116.03570329322,1635.598573599554,133751.6342768928,3106,7,911.8461538461538,37,2,20,33.8115045506257,0.6396396396396398,42.98245614035087,1028.0701754385957,27.785680417259343,8
3138,4,1,0,40,0.025,0.0,1.0,40,1350,1200,150,0.8888888888888888,15,12,3,353.89151334687097,0.7801282051282051,0.18711044286495349,0.21418516807128635,132571.9062601453,1383.815653243089,133955.7219133884,3107,0,890.025,36,4,21,33.42810278840897,0.6461226851851851,42.539414414414416,1029.8423423423426,28.606731731731738,0
3139,4,1,0,41,0.024390243902439025,0.0,1.0,41,950,800,150,0.8421052631578947,11,8,3,346.09680022684137,0.7908028455284553,0.19233218440762911,0.21142571618920725,132920.79863393973,1000.6926181605781,133921.4912521003,3108,0,869.2926829268292,38,3,18,33.27850877192982,0.6458333333333333,42.200854700854705,1031.196581196582,27.136752136752158,0
3140,4,0,0,41,0.0,0.0,1.0,41,1250,800,450,0.64,17,8,9,342.9065043321359,0.7915650406504064,0.182662843718028,0.2099405389554074,133003.4394061839,921.5488941851245,133924.98830036903,3109,1,870.2926829268292,38,3,18,33.27787847402038,0.6466557017543859,42.1207264957265,1031.517094017095,27.14518668466039,0
3141,4,0,0,41,0.0,0.0,1.0,41,850,500,350,0.5882352941176471,12,5,7,343.4794640792437,0.7901930894308943,0.18560813106616814,0.2108121171727998,133095.751953125,943.1315104166682,134038.88346354166,3110,2,871.2926829268292,39,2,18,33.170553200080754,0.6458333333333334,42.03125,1031.875,26.458333333333332,0
3142,4,0,0,41,0.0,0.0,1.0,41,750,300,450,0.4,12,3,9,346.36133249472056,0.789989837398374,0.19267997282314386,0.21288759816114702,133149.5008680555,1023.5677083333297,134173.06857638885,3111,3,872.2926829268292,39,2,18,33.04232270219351,0.6463675213675215,41.979166666666664,1032.083333333333,26.463675213675206,0
3143,4,0,0,41,0.0,0.0,1.0,41,1050,600,450,0.5714285714285714,15,6,9,346.6531965095503,0.7887703252032521,0.19714914115047932,0.21399251495614463,133310.812717014,1042.5238715277892,134353.33658854177,3112,4,873.2926829268292,39,2,18,32.87312554636541,0.6479700854700854,41.82291666666667,1032.7083333333342,26.479700854700877,0
3144,4,0,0,41,0.0,0.0,1.0,41,1050,800,250,0.7619047619047619,13,8,5,347.76837008117053,0.7879573170731707,0.19634195535178423,0.21499196743920765,133364.6050347224,1075.9982638889092,134440.6032986113,3113,5,874.2926829268292,39,2,18,32.79043969342477,0.6485042735042734,41.77083333333334,1032.916666666668,26.48504273504277,0
3145,4,0,0,41,0.0,0.0,1.0,41,1050,700,350,0.6666666666666666,14,7,7,348.4757916440037,0.7883130081300813,0.19721739215980416,0.21558542892910731,133391.50526258704,1096.7420789930807,134488.24734158014,3114,6,875.2926829268292,39,2,18,32.7452228496521,0.6487713675213674,41.74479166666668,1033.0208333333353,26.487713675213726,0
3146,4,0,1,40,0.0,0.024390243902439025,0.975609756097561,41,1350,1000,350,0.7407407407407407,17,10,7,349.88996933042506,0.7867886178861788,0.1991856263876719,0.2174577116276981,133561.93636670505,1146.4940200617064,134708.43038676676,3115,7,876.2926829268292,35,6,19,32.53799966409137,0.6580357142857144,41.5798611111111,1033.6805555555538,29.53373015873011,0
3147,4,0,0,40,0.0,0.0,1.0,40,1000,700,300,0.7,13,7,6,360.4405321677372,0.7834668803418804,0.20024467472654006,0.2244032990592685,133626.0363520407,1632.8479308389803,135258.8842828797,3116,8,897.325,34,6,19,32.20111303012856,0.6608455882352942,41.51785714285713,1033.9285714285704,30.40966386554619,0
3148,4,0,0,40,0.0,0.0,1.0,40,700,400,300,0.5714285714285714,10,4,6,357.77107716162664,0.783974358974359,0.19473595882747774,0.22361943270423892,133771.38658479066,1571.9066143689743,135343.29319915964,3117,9,898.325,35,5,16,32.1245431491012,0.6601190476190477,41.3773148148148,1034.4907407407395,29.55687830687827,0
3149,4,0,0,40,0.0,0.0,1.0,40,1350,1000,350,0.7407407407407407,17,10,7,357.6679905891826,0.7837873931623932,0.1942349548373059,0.22403620760218096,133850.68081172364,1574.8208089846348,135425.50162070827,3118,10,899.325,36,4,16,32.047828925889654,0.6588541666666669,41.30067567567566,1034.7972972972955,28.74436936936932,0
3150,4,0,0,40,0.0,0.0,1.0,40,1500,1300,200,0.8666666666666667,17,13,4,356.2042157426032,0.7836538461538461,0.19280720338983115,0.22357498647673987,133925.8233302552,1540.9885734071738,135466.81190366237,3119,11,900.325,37,3,16,32.01050494350283,0.6576576576576578,41.22807017543858,1035.0877192982434,27.97534376481739,0
3151,4,0,0,40,0.0,0.0,1.0,40,1050,500,550,0.47619047619047616,16,5,11,357.5054253244477,0.7838675213675214,0.1962939432443882,0.22508541578427207,134039.34383656495,1583.9585257001945,135623.30236226515,3120,12,901.325,37,3,17,31.863264153607215,0.658783783783784,41.11842105263157,1035.5263157894724,27.987197724039795,0
3152,4,0,0,40,0.0,0.0,1.0,40,1200,900,300,0.75,15,9,6,348.02836337805536,0.783306623931624,0.17824675324675332,0.21647558089782662,133591.84777949253,1300.6981433508593,134892.5459228434,3121,13,902.325,35,5,21,32.55616509926855,0.6583333333333332,41.55092592592593,1033.7962962962968,29.53703703703705,3
3153,4,0,0,40,0.0,0.0,1.0,40,1000,700,300,0.7,13,7,6,348.1072179198777,0.7840811965811966,0.17548136124482205,0.21669977544796318,133621.76254125958,1302.940002357695,134924.70254361728,3122,14,903.325,35,5,21,32.52418467106981,0.6586309523809523,41.52199074074075,1033.9120370370383,29.540343915343954,0
3154,4,0,0,40,0.0,0.0,1.0,40,1050,800,250,0.7619047619047619,13,8,5,348.0374310764971,0.7830662393162393,0.18019131796822485,0.21753556356375778,133771.38658479103,1311.4899477023484,135082.8765324934,3123,15,904.325,35,5,19,32.376277317819024,0.6601190476190475,41.377314814814824,1034.4907407407425,29.556878306878357,0
3155,4,0,0,40,0.0,0.0,1.0,40,1400,1000,400,0.7142857142857143,18,10,8,346.77717219945043,0.7824519230769231,0.17989932885906024,0.2170999943601604,133831.25964506192,1281.925154321013,135113.18479938293,3124,16,905.325,35,5,19,32.34899328859061,0.6607142857142856,41.31944444444446,1034.7222222222238,29.563492063492106,0
3156,4,0,0,40,0.0,0.0,1.0,40,800,600,200,0.75,10,6,4,347.1018103645747,0.7818376068376068,0.18141914560500982,0.21765668922019835,133891.14610125183,1294.7718407064647,135185.9179419583,3125,17,906.325,35,5,20,32.28071646909717,0.6613095238095237,41.26157407407408,1034.9537037037046,29.570105820105844,0
3157,4,0,0,40,0.0,0.0,1.0,40,950,600,350,0.631578947368421,13,6,7,348.4550322999009,0.7814369658119658,0.17958501033394914,0.21895742391886486,133967.2374020983,1336.3116072153484,135303.54900931366,3126,18,907.325,36,4,20,32.169630878567034,0.660011574074074,41.188063063063076,1035.2477477477498,28.756881881881938,0
3158,4,0,0,40,0.0,0.0,1.0,40,1150,900,250,0.782608695652174,14,9,5,347.2597887390842,0.7797542735042735,0.17798539064154162,0.21897302833307,134096.12212411506,1313.2382079101221,135409.3603320252,3127,19,908.325,37,3,20,32.07177641329665,0.6593468468468469,41.06359649122807,1035.7456140350873,27.99312470365101,0
3159,4,0,0,40,0.0,0.0,1.0,40,1100,900,200,0.8181818181818182,13,9,4,349.9740768735479,0.7781517094017094,0.18296825396825445,0.22136914501037655,134209.71476800545,1393.9842066789677,135603.6989746844,3128,20,909.325,37,3,20,31.88800705467371,0.660472972972973,40.95394736842105,1036.184210526315,28.004978662873377,0
3160,4,0,0,40,0.0,0.0,1.0,40,800,700,100,0.875,9,7,2,352.806014355204,0.7762553418803418,0.18390439932318126,0.2242025317031458,134380.19390581717,1482.0281240381673,135862.22202985533,3129,21,910.325,37,3,20,31.644370417371686,0.6621621621621621,40.78947368421053,1036.842105263158,28.02275960170697,0
3161,4,0,0,40,0.0,0.0,1.0,40,750,500,250,0.6666666666666666,10,5,5,352.6489834366315,0.7772435897435898,0.18828893117665757,0.2246267161163028,134465.4740521121,1483.8225463604122,135949.29659847252,3130,22,911.325,37,3,20,31.563303908094575,0.6630067567567568,40.70723684210526,1037.1710526315783,28.03165007112374,0
3162,4,0,0,40,0.0,0.0,1.0,40,1350,1100,250,0.8148148148148148,16,11,5,354.86044811155176,0.7766292735042735,0.17407855332872657,0.22037899932077926,133533.737244898,1487.3277433087815,135021.06498820678,3131,23,912.325,34,6,19,32.43780234968902,0.6599264705882353,41.60714285714286,1033.571428571429,30.399159663865557,2
3163,4,0,0,40,0.0,0.0,1.0,40,1300,900,400,0.6923076923076923,17,9,8,351.6802179048775,0.7778044871794871,0.17428915258031985,0.21892399906231877,133621.76254125958,1398.4261134688072,135020.18865472838,3132,24,913.325,35,5,19,32.431830478749205,0.6586309523809523,41.52199074074075,1033.9120370370383,29.540343915343954,0
3164,4,1,1,40,0.024390243902439025,0.024390243902439025,0.975609756097561,41,1150,900,250,0.782608695652174,14,9,5,340.6483409939672,0.7826727642276423,0.16098594460520865,0.2138111927515326,133925.8233302555,924.3219067405347,134850.14523699603,3133,0,892.0243902439024,37,4,17,32.41304731638418,0.6576576576576576,41.228070175438596,1035.0877192982457,27.975343764817453,0
3165,4,0,0,40,0.0,0.0,1.0,40,800,600,200,0.75,10,6,4,348.0265053708466,0.7772970085470086,0.16870237317657288,0.21748105294806797,133763.29665814465,1310.6345365635943,135073.93119470825,3134,26,915.325,36,4,17,32.38465236954786,0.6579861111111112,41.38513513513514,1034.4594594594598,28.734984984984994,0
3166,4,0,0,40,0.0,0.0,1.0,40,1000,800,200,0.8,12,8,4,346.81722670743267,0.7778044871794871,0.16648252966147803,0.2168965188401078,133792.4215389376,1280.3033185212225,135072.72485745882,3135,27,916.325,36,4,17,32.38679656035702,0.658275462962963,41.35698198198198,1034.5720720720722,28.738113113113116,0
3167,4,0,0,40,0.0,0.0,1.0,40,700,300,400,0.42857142857142855,11,3,8,344.16417426701906,0.7763621794871794,0.1636465020128386,0.2159189710367354,133908.95276611077,1217.3328311419607,135126.28559725272,3136,28,917.325,36,4,17,32.33892757407609,0.6594328703703705,41.24436936936937,1035.022522522523,28.75062562562564,0
3168,4,0,0,40,0.0,0.0,1.0,40,950,600,350,0.631578947368421,13,6,7,345.5649566502334,0.7750267094017094,0.16765825538394608,0.2173135575541891,133996.38447569186,1260.8909585260872,135257.27543421794,3137,29,918.325,36,4,17,32.21530345877747,0.6603009259259259,41.159909909909906,1035.36036036036,28.760010010009996,0
3169,4,0,0,40,0.0,0.0,1.0,40,850,600,250,0.7058823529411765,11,6,5,344.4813751725648,0.7748130341880342,0.1673541247484911,0.21671802969717036,134010.9592013888,1232.8559027777678,135243.81510416657,3138,30,919.325,37,3,17,32.22878940308517,0.6585022522522523,41.14583333333333,1035.4166666666658,27.98423423423421,0
3170,4,0,0,40,0.0,0.0,1.0,40,1150,700,450,0.6086956521739131,16,7,9,344.7159070517253,0.7746527777777777,0.16880755795490665,0.21753715256630896,134124.51577648876,1246.9708227531396,135371.4865992419,3139,31,920.325,37,3,17,32.109289545181895,0.6596283783783785,41.03618421052631,1035.8552631578934,27.99608819345658,0
3171,4,0,0,40,0.0,0.0,1.0,40,850,600,250,0.7058823529411765,11,6,5,347.98243287758527,0.7745459401709401,0.13912213740458013,0.2147374770852935,133297.72973987524,1277.7299482080864,134575.45968808333,3140,32,921.325,36,4,21,32.851917484551066,0.6533564814814814,41.8355855855856,1032.6576576576595,28.684934934934986,3
3172,4,0,0,40,0.0,0.0,1.0,40,1050,700,350,0.6666666666666666,14,7,7,350.54630593132106,0.7740384615384616,0.14677419354838683,0.21733870967741947,133472.2222222226,1357.6388888889273,134829.86111111153,3141,33,922.325,36,4,22,32.6108870967742,0.6550925925925924,41.666666666666686,1033.3333333333362,28.703703703703784,0
3173,4,0,0,40,0.0,0.0,1.0,40,950,500,450,0.5263157894736842,14,5,9,348.6781452097941,0.7731303418803419,0.14633900582176462,0.21687974881712296,133591.84777949267,1316.1115397805452,134907.9593192732,3142,34,923.325,35,5,22,32.53937154799225,0.6583333333333332,41.55092592592594,1033.796296296298,29.537037037037084,0
3174,4,0,0,40,0.0,0.0,1.0,40,1100,800,300,0.7272727272727273,14,8,6,350.8343695952454,0.7715277777777778,0.14747341913822032,0.21875122765760793,133681.60211173288,1380.0201206704592,135061.62223240334,3143,35,924.325,35,5,22,32.39379313560902,0.6592261904761904,41.46412037037038,1034.14351851852,29.546957671957717,0
3175,4,0,0,40,0.0,0.0,1.0,40,1300,1000,300,0.7692307692307693,16,10,6,353.5699258672927,0.7718482905982906,0.14740858772224108,0.22189304189692619,133921.09435281638,1470.0942804784029,135391.18863329478,3144,36,925.325,35,5,17,32.08340322039584,0.6616071428571428,41.23263888888889,1035.0694444444448,29.57341269841271,0
3176,4,1,0,41,0.024390243902439025,0.0,1.0,41,1100,900,200,0.8181818181818182,13,9,4,335.77896754577307,0.7757621951219512,0.11758873686297844,0.19667053813395263,131328.12499999988,675.1748167438127,132003.2998167437,3145,0,903.7317073170732,37,4,18,35.14566395663956,0.6317567567567568,43.74999999999999,1024.999999999999,27.702702702702677,8
3177,4,0,0,41,0.0,0.0,1.0,41,1200,900,300,0.75,15,9,6,333.7023962370437,0.7745934959349593,0.11765154325850458,0.19601441854854001,131437.65637555695,572.212177660893,132009.86855321785,3146,1,904.7317073170732,38,3,18,35.08847329304716,0.6310307017543859,43.64316239316239,1025.42735042735,26.984930274403943,0
3178,4,0,0,41,0.0,0.0,1.0,41,1000,700,300,0.7,13,7,6,332.6132812500002,0.7747459349593496,0.11748475609756115,0.19565487132352935,131492.43918474676,547.2263313609355,132039.6655161077,3147,2,905.7317073170732,38,3,18,35.061197916666664,0.631578947368421,43.589743589743584,1025.6410256410247,26.990553306342758,0
3179,4,0,0,41,0.0,0.0,1.0,41,1200,1000,200,0.8333333333333334,14,10,4,333.96144116683314,0.7739837398373983,0.12349021241149538,0.1970126339659867,131602.03904594915,590.0013240557972,132192.04037000495,3148,3,906.7317073170732,38,3,15,34.91622414271831,0.6326754385964912,43.482905982905976,1026.0683760683748,27.00179937022039,0
3180,4,0,0,41,0.0,0.0,1.0,41,1300,900,400,0.6923076923076923,17,9,8,333.57833768804403,0.7739837398373983,0.11526610999720788,0.1976379670272564,131766.5244448095,590.8916374460988,132357.4160822556,3149,4,907.7317073170732,38,3,16,34.76044918487685,0.6343201754385965,43.32264957264956,1026.7094017094,27.018668466036843,0
3181,4,0,0,41,0.0,0.0,1.0,41,1150,900,250,0.782608695652174,14,9,5,335.41788896846793,0.7738313008130081,0.09042076084588024,0.20104188039915774,132205.65440317048,668.8283019212569,132874.48270509174,3150,5,908.7317073170732,38,3,18,34.27154754484384,0.6387061403508771,42.89529914529915,1028.4188034188037,27.063652721547466,1
3182,4,0,0,41,0.0,0.0,1.0,41,1350,1000,350,0.7407407407407407,17,10,7,336.17151670198314,0.7744410569105691,0.08820407863440938,0.20193359540383027,132288.07259706708,694.2964013076273,132982.3689983747,3151,6,909.7317073170732,38,3,18,34.16934953439262,0.6395285087719298,42.815170940170944,1028.739316239317,27.07208726945571,0
3183,4,0,0,41,0.0,0.0,1.0,41,900,600,300,0.6666666666666666,12,6,6,337.44875397410397,0.7728150406504065,0.08985307587664404,0.20314785134126587,132371.20361328125,733.699544270833,133104.9031575521,3152,7,910.7317073170732,39,2,18,34.052978540338096,0.6386217948717949,42.734375,1029.0625,26.38621794871795,0
3184,4,1,1,41,0.023809523809523808,0.023809523809523808,0.9761904761904762,42,1200,800,400,0.6666666666666666,16,8,8,330.12546798936944,0.7793505613627565,0.08392751458444891,0.20040790386085205,132685.78247901384,360.59120728402524,133046.37368629785,3153,0,890.0238095238095,40,2,15,33.92578253435917,0.6401041666666667,42.42886178861789,1030.2845528455287,25.757113821138216,0
3185,4,0,0,41,0.0,0.0,1.0,41,850,300,550,0.35294117647058826,14,3,11,339.5168273954468,0.7722560975609756,0.07726825321252084,0.20556049433305484,132585.67843967024,803.0137803819541,133388.6922200522,3154,9,912.7317073170732,39,2,19,33.78436751963857,0.6407585470085471,42.52604166666667,1029.8958333333342,26.40758547008549,0
3186,4,1,1,41,0.023809523809523808,0.023809523809523808,0.9761904761904762,42,800,500,300,0.625,11,5,6,334.5558189204786,0.7768099109562524,0.08434730359020559,0.2039503742265227,132842.8845264064,488.6720040980992,133331.5565305045,3155,0,891.9761904761905,40,2,16,33.654130520504715,0.6416666666666666,42.27642276422765,1030.8943089430904,25.77235772357726,0
3187,4,0,0,41,0.0,0.0,1.0,41,850,600,250,0.7058823529411765,11,6,5,343.41419491321983,0.7714939024390244,0.07988088370877611,0.2089631023660146,132773.486328125,919.2599826388889,133692.74631076388,3156,11,914.7317073170732,39,2,16,33.49546863418907,0.6426282051282051,42.34375,1030.625,26.42628205128205,0
3188,4,0,0,41,0.0,0.0,1.0,41,1100,600,500,0.5454545454545454,16,6,10,343.2365967419287,0.7713414634146342,0.07535934696452884,0.20915451732500767,132827.17013888882,918.2291666666626,133745.39930555547,3157,12,915.7317073170732,39,2,16,33.4461735381299,0.6431623931623932,42.291666666666664,1030.8333333333328,26.431623931623918,0
3189,4,1,0,42,0.023809523809523808,0.0,1.0,42,750,400,350,0.5333333333333333,11,4,7,336.91646962559514,0.7761324041811847,0.07498335162309933,0.2068349354642257,133104.92782900395,569.048474783531,133673.9763037875,3158,0,894.9047619047619,40,2,17,33.33066607576653,0.6442708333333333,42.02235772357724,1031.9105691056914,25.797764227642283,0
3190,4,0,0,42,0.0,0.0,1.0,42,1300,900,400,0.6923076923076923,17,9,8,337.34490197325624,0.7764227642276422,0.06203184872816925,0.20497639866827097,132719.8133680556,554.9765506229811,133274.78991867858,3159,1,895.9047619047619,39,3,13,33.705688098126444,0.642094017094017,42.395833333333336,1030.416666666667,26.420940170940177,1
3191,4,1,0,43,0.023255813953488372,0.0,1.0,43,1200,700,500,0.5833333333333334,17,7,10,332.5958434164762,0.7811000369139903,0.06496600509465389,0.20389571270314405,133052.49851278996,250.54159230616204,133303.04010509612,3160,0,876.046511627907,40,3,14,33.49463159968479,0.64375,42.073170731707314,1031.7073170731703,25.792682926829258,0
3192,4,0,1,42,0.0,0.023255813953488372,0.9767441860465116,43,1200,900,300,0.75,15,9,6,328.5069712288704,0.7811461794019933,0.06864563157918835,0.20224083719653702,133209.81744497298,152.07073335974556,133361.88817833274,3161,1,877.046511627907,40,3,15,33.44264783093784,0.6453125000000002,41.92073170731706,1032.3170731707296,25.80792682926824,0
3193,4,0,0,42,0.0,0.0,1.0,42,1000,400,600,0.4,16,4,12,333.6964070377844,0.7762291908633372,0.07039023968157831,0.20480772045330192,133095.751953125,482.7148437500001,133578.466796875,3162,2,898.8571428571429,39,3,16,33.42292549969715,0.6458333333333334,42.03125,1031.875,26.458333333333332,0
3194,4,1,0,43,0.023255813953488372,0.0,1.0,43,550,300,250,0.5454545454545454,8,3,5,328.24664744164374,0.7846530084902178,0.07783821385829581,0.2027945700881109,133340.98755907518,153.7464265648658,133494.73398564005,3163,0,878.9302325581396,40,3,17,33.318163927974034,0.6466145833333334,41.793699186991866,1032.8252032520318,25.820630081300795,0
3195,4,0,0,43,0.0,0.0,1.0,43,650,400,250,0.6153846153846154,9,4,5,328.6909326943673,0.7839608711701734,0.0805762243394379,0.2032125693373204,133367.22932778104,167.3197997223822,133534.54912750341,3164,1,879.9302325581396,40,3,17,33.280450609996066,0.6468750000000001,41.76829268292683,1032.9268292682923,25.823170731707307,0
3196,4,0,0,43,0.0,0.0,1.0,43,750,600,150,0.8,9,6,3,327.50003689734257,0.7835917312661499,0.0804996625447556,0.20261946896296315,133393.47367844853,137.2735103113056,133530.74718875982,3165,2,880.9302325581396,40,3,17,33.284964748319396,0.6471354166666667,41.74288617886178,1033.0284552845517,25.82571138211379,0
3197,4,0,0,43,0.0,0.0,1.0,43,950,800,150,0.8421052631578947,11,8,3,331.0620183087152,0.7809616094499815,0.08032761138576161,0.20540752242906588,133499.13330078122,239.32174026032374,133738.45504104154,3166,3,881.9302325581396,39,4,17,33.08732738635219,0.6498397435897436,41.640625,1033.4374999999998,26.49839743589743,0
3198,4,0,2,41,0.0,0.046511627906976744,0.9534883720930233,43,1150,700,450,0.6086956521739131,16,7,9,329.4608810410571,0.7792081949058693,0.07924550407123165,0.2050093570114418,133606.80474175364,203.64312065974153,133810.4478624134,3167,4,882.9302325581396,39,4,18,33.02109571788413,0.6509081196581196,41.53645833333334,1033.854166666668,26.509081196581235,0
3199,4,1,1,41,0.023809523809523808,0.023809523809523808,0.9761904761904762,42,900,500,400,0.5555555555555556,13,5,8,330.09574092288574,0.7813588850174216,0.08767258666513156,0.2055539726725574,133633.72938368062,422.3849826388989,134056.11436631953,3168,0,881.7380952380952,39,3,18,32.977785613540206,0.6511752136752136,41.51041666666667,1033.958333333334,26.511752136752154,0
3200,4,0,0,41,0.0,0.0,1.0,41,900,600,300,0.6666666666666666,12,6,6,331.7417126306646,0.7734247967479675,0.0840141170456441,0.20627849349290198,133579.8828125,662.8038194444451,134242.68663194444,3169,6,904.2439024390244,39,2,18,32.989050114201255,0.6506410256410255,41.5625,1033.75,26.506410256410255,0
3201,4,0,0,41,0.0,0.0,1.0,41,1100,800,300,0.7272727272727273,14,8,6,332.0209119196305,0.7722052845528455,0.08811150668170331,0.20690342703240247,133660.65673828122,675.6266276041674,134336.28336588538,3170,7,905.2439024390244,39,2,18,32.90111564420268,0.6514423076923077,41.484375,1034.0624999999998,26.51442307692307,0
3202,4,0,0,41,0.0,0.0,1.0,41,950,800,150,0.8421052631578947,11,8,3,328.8478252752414,0.7715955284552846,0.08343677659610194,0.20533823102155851,133734.88519565063,595.6852320047483,134330.5704276554,3171,8,906.2439024390244,40,1,15,32.90901126612957,0.6505208333333334,41.412601626016254,1034.349593495934,25.85873983739835,0
3203,4,0,0,41,0.0,0.0,1.0,41,850,600,250,0.7058823529411765,11,6,5,327.81302124164824,0.7721036585365854,0.08639828295749075,0.20527627197309087,133840.02267995215,574.9004395531506,134414.92311950529,3172,9,907.2439024390244,40,1,15,32.830812545014076,0.6515625000000002,41.310975609756085,1034.7560975609736,25.86890243902434,0
3204,4,0,0,41,0.0,0.0,1.0,41,850,600,250,0.7058823529411765,11,6,5,327.8783923317775,0.7710873983739838,0.08553225416420274,0.20605164606315934,133971.50262946964,585.2721800845845,134556.77480955422,3173,10,908.2439024390244,40,1,15,32.69792382448218,0.6528645833333334,41.18394308943088,1035.2642276422746,25.881605691056865,0
3205,4,0,0,41,0.0,0.0,1.0,41,1200,800,400,0.6666666666666666,16,8,8,335.8326258289813,0.770020325203252,0.08309721637247769,0.21180730955748642,134103.04712803237,807.2356897349578,134910.28281776732,3174,11,909.2439024390244,40,1,15,32.360756802721085,0.6541666666666666,41.056910569105696,1035.7723577235781,25.894308943089452,0
3206,4,0,0,41,0.0,0.0,1.0,41,1150,900,250,0.782608695652174,14,9,5,335.26513247472263,0.7702743902439024,0.08192767625145359,0.21175295913552195,134155.6830011898,795.5445667261588,134951.22756791598,3175,12,910.2439024390244,40,1,15,32.322935059839125,0.6546875,41.00609756097561,1035.9756097560978,25.899390243902445,0
3207,4,0,1,40,0.0,0.024390243902439025,0.975609756097561,41,900,400,500,0.4444444444444444,14,4,10,334.03447972544086,0.7684959349593496,0.08586571255004549,0.21158283380372958,134260.98573104638,769.5597032189871,135030.54543426537,3176,13,911.2439024390244,40,1,15,32.24978754004053,0.6557291666666667,40.90447154471545,1036.3821138211385,25.909552845528463,0
3208,4,0,0,40,0.0,0.0,1.0,40,1400,1200,200,0.8571428571428571,16,12,4,339.9599913923129,0.7610576923076923,0.08559509449135483,0.21513498691925748,134226.7578125,1126.345486111111,135353.10329861112,3177,14,934.625,39,1,17,32.1304114729929,0.6570512820512822,40.9375,1036.25,26.57051282051282,0
3209,4,0,0,40,0.0,0.0,1.0,40,900,700,200,0.7777777777777778,11,7,4,344.3322165367822,0.7607638888888889,0.09485833417060174,0.21870699114171,134361.7201063369,1253.0137803819541,135614.73388671887,3178,15,935.625,39,1,18,31.88245168960782,0.6583867521367521,40.80729166666667,1036.7708333333342,26.583867521367544,0
3210,4,0,0,40,0.0,0.0,1.0,40,1000,500,500,0.5,15,5,10,346.03875815653925,0.7596153846153846,0.08918283362727841,0.22045390547725596,134471.7151249257,1306.4850618018413,135778.20018672754,3179,16,936.625,40,0,18,31.728476713044607,0.6578125,40.701219512195124,1037.1951219512198,25.929878048780495,0
3211,4,0,0,40,0.0,0.0,1.0,40,750,400,350,0.5333333333333333,11,4,7,341.73127590249953,0.7588675213675213,0.08198105436573355,0.2183482994450705,134578.49368105762,1197.9825462451618,135776.47622730277,3180,17,937.625,38,2,18,31.73372288577705,0.662280701754386,40.59829059829059,1037.6068376068363,27.305443094916743,0
3212,4,0,0,40,0.0,0.0,1.0,40,1350,1000,350,0.7407407407407407,17,10,7,342.66901918117134,0.7595886752136752,0.043746823864214024,0.2005663581037212,131301.43364800382,1015.5055050331625,132316.93915303698,3181,18,938.625,39,1,21,34.996040417386595,0.6279380341880341,43.776041666666686,1024.8958333333362,26.279380341880415,7
3213,4,0,0,40,0.0,0.0,1.0,40,700,300,400,0.42857142857142855,11,3,8,328.8596747900285,0.7595619658119658,0.03618166164442549,0.18497361368940352,129759.3730763312,539.0877631819429,130298.46083951315,3182,19,939.625,37,3,15,36.90854139761802,0.6159909909909909,45.28508771929825,1018.8596491228072,27.536747273589384,5
3214,4,1,1,40,0.024390243902439025,0.024390243902439025,0.975609756097561,41,900,500,400,0.5555555555555556,13,5,8,323.9664027818327,0.7692581300813008,0.03571921325750038,0.18342724086330792,130017.30974687698,224.24802761340294,130241.55777449039,3183,0,917.6829268292682,38,3,15,36.77194636496962,0.6167763157894738,45.03205128205128,1019.8717948717942,26.838731443994586,0
3215,4,2,0,42,0.047619047619047616,0.0,1.0,42,1100,900,200,0.8181818181818182,13,9,4,320.9504823094833,0.7759872241579558,0.056047021318987866,0.1835099647654702,130398.95171305432,-29.44757195558222,130369.50414109875,3184,0,896.7857142857143,38,4,18,36.462909693165955,0.6206140350877192,44.65811965811966,1021.3675213675217,26.87809266756636,0
3216,4,2,0,44,0.045454545454545456,0.0,1.0,44,750,300,450,0.4,12,3,9,312.79107182170696,0.7884513742071882,0.11195286195286136,0.16890717878372202,128144.53125000019,-783.5069444444305,127361.02430555577,3185,0,856.9772727272727,42,2,18,38.95747599451303,0.5915178571428571,46.87500000000001,1012.5000000000015,24.107142857142893,7
3217,4,1,0,45,0.022222222222222223,0.0,1.0,45,950,800,150,0.8421052631578947,11,8,3,309.3194582346811,0.7953703703703704,0.12888124216742058,0.16837149698497572,128463.58861396552,-1052.7424734090494,127410.84614055647,3186,0,838.9111111111112,42,3,18,38.72068756770535,0.5947420634920635,46.560077519379846,1013.7596899224807,24.137135474344777,0
3218,4,2,2,45,0.0425531914893617,0.0425531914893617,0.9574468085106383,47,1000,800,200,0.8,12,8,4,302.24885423898803,0.8129818069688559,0.13627499490642392,0.16612324244263188,128848.62075617288,-1611.1304012345645,127237.49035493832,3187,0,804.1702127659574,44,3,18,38.508891928864564,0.5958806818181819,46.18055555555556,1015.277777777778,23.074494949494955,0
3219,4,0,0,45,0.0,0.0,1.0,45,950,800,150,0.8421052631578947,11,8,3,314.81135040606694,0.7956649831649832,0.13237361190734043,0.17178392040406118,128561.83992097818,-905.4547127576593,127656.38520822051,3188,2,840.9111111111112,42,3,18,38.48155137269888,0.595734126984127,46.46317829457364,1014.1472868217045,24.146363971945345,0
3220,4,2,1,46,0.0425531914893617,0.02127659574468085,0.9787234042553191,47,1250,800,450,0.64,17,8,9,304.4048131755234,0.809050262102991,0.1443706683468231,0.16830442441316704,129083.74592764048,-1541.257287379983,127542.4886402605,3189,0,806.0851063829788,44,3,21,38.215641609719064,0.5982481060606061,45.94907407407407,1016.2037037037028,23.0955387205387,0
3221,4,3,3,46,0.061224489795918366,0.061224489795918366,0.9387755102040817,49,1450,1200,250,0.8275862068965517,17,12,5,288.1970207944369,0.8242276077097506,0.1481345402318046,0.16154897220678988,129625.34722222232,-2328.3650548696723,127296.98216735265,3190,0,771.3265306122449,44,5,13,38.07965084560828,0.6036931818181819,45.41666666666667,1018.3333333333342,23.143939393939412,0
3222,4,3,3,46,0.061224489795918366,0.061224489795918366,0.9387755102040817,49,950,700,250,0.7368421052631579,12,7,5,288.6244478415079,0.8249716553287982,0.14517376522543968,0.16227566681656141,129743.23666838113,-2310.5859910836944,127432.65067729744,3191,0,772.265306122449,44,5,15,37.949687963888636,0.604876893939394,45.30092592592592,1018.7962962962946,23.15446127946124,0
3223,4,1,1,46,0.02127659574468085,0.02127659574468085,0.9787234042553191,47,950,800,150,0.8421052631578947,11,8,3,299.9334022106033,0.8115556583410422,0.1466234087107272,0.16779021957532442,129546.418672255,-1628.9403806862836,127917.47829156871,3192,0,806.063829787234,42,5,16,37.86070658036676,0.6056547619047621,45.494186046511615,1018.0232558139513,24.238648947951223,0
3224,4,0,0,46,0.0,0.0,1.0,46,1100,800,300,0.7272727272727273,14,8,6,304.2888766181098,0.8044082125603865,0.14924391031212014,0.17022678049786236,129546.41867225498,-1316.093158464061,128230.32551379091,3193,2,824.5869565217391,42,4,16,37.74985722444317,0.6056547619047621,45.494186046511615,1018.0232558139512,24.23864894795122,0
3225,4,1,0,47,0.02127659574468085,0.0,1.0,47,1250,1000,250,0.8,15,10,5,301.4699049399522,0.8105149552883132,0.15246941773583522,0.16976021177701825,129803.80980436441,-1573.6115594869416,128230.19824487747,3194,0,808.0212765957447,43,4,18,37.5612745098039,0.6068313953488373,45.24147727272726,1019.0340909090888,23.698467230443928,0
3226,4,0,0,47,0.0,0.0,1.0,47,1200,900,300,0.75,15,9,6,298.553681360702,0.8109389454209065,0.14884339435922844,0.1683646989968547,129861.17969821654,-1645.8933470507723,128215.28635116576,3195,1,809.0212765957447,44,3,18,37.57759508236433,0.6060606060606062,45.185185185185176,1019.2592592592576,23.164983164983127,0
3227,4,0,0,47,0.0,0.0,1.0,47,1000,800,200,0.8,12,8,4,300.8037940873702,0.810977489978415,0.15550407039768754,0.16994102497157668,129931.9712362824,-1583.1940157750507,128348.77722050736,3196,2,810.0212765957447,44,3,18,37.44872551690733,0.6067708333333335,45.11574074074073,1019.5370370370357,23.171296296296266,0
3228,4,0,2,45,0.0,0.0425531914893617,0.9574468085106383,47,1000,800,200,0.8,12,8,4,309.920118762183,0.8105534998458217,0.17606900780967627,0.1703747641337957,128856.8191890508,-1398.0138765551176,127458.80531249568,3197,3,811.0212765957447,42,5,14,38.30585512502385,0.5987103174603177,46.17248062015502,1015.3100775193772,24.174049464747075,3
3229,4,0,0,45,0.0,0.0,1.0,45,800,600,200,0.75,10,6,4,321.54179806676296,0.8015151515151515,0.1738948446492785,0.17566002662859104,128607.9830643961,-729.4315759468652,127878.55148844924,3198,4,846.6222222222223,40,5,14,38.263951507864945,0.5992187500000001,46.417682926829265,1014.3292682926822,25.358231707317053,0
3230,4,2,2,45,0.0425531914893617,0.0425531914893617,0.9574468085106383,47,1650,1500,150,0.9090909090909091,18,15,3,309.282070834826,0.8169904409497378,0.16923070679852792,0.1708710113158053,129053.65982362835,-1417.203368187014,127636.45645544134,3199,0,811.5531914893617,42,5,16,38.12225824909404,0.6006944444444444,45.97868217054263,1016.0852713178291,24.192506459948312,0
3231,4,0,0,45,0.0,0.0,1.0,45,1250,900,350,0.72,16,9,7,320.27051633939965,0.8021464646464647,0.16994409162459978,0.17614017919042216,128873.80248685123,-745.104146982866,128128.69833986837,3200,6,848.6222222222223,41,4,18,38.02587119361667,0.6003556910569106,46.15575396825397,1015.3769841269842,24.765292295780103,0
3232,4,1,0,46,0.021739130434782608,0.0,1.0,46,850,500,350,0.5882352941176471,12,5,7,313.15758017654,0.8048711755233494,0.17350600433365027,0.1735542913368692,129177.32119669713,-1109.4285360709316,128067.8926606262,3201,0,831.1521739130435,43,3,19,37.89832712311755,0.6005329457364341,45.85700757575758,1016.57196969697,23.641208597603953,0
3233,4,3,1,48,0.061224489795918366,0.02040816326530612,0.9795918367346939,49,1200,900,300,0.75,15,9,6,295.3841813362637,0.8208971088435374,0.19168103208585885,0.16677845315447487,129908.3719135802,-2125.4198989580227,127782.95201462218,3202,0,781.204081632653,44,5,15,37.61069482288827,0.6065340909090909,45.138888888888886,1019.444444444444,23.16919191919191,0
3234,4,1,0,49,0.02040816326530612,0.0,1.0,49,1050,700,350,0.6666666666666666,14,7,7,295.7931592107335,0.824015022675737,0.19493308176054036,0.16711023479063025,129931.97123628242,-2113.402349108384,127818.56888717404,3203,0,782.1632653061224,44,5,16,37.57643871280235,0.6067708333333335,45.11574074074073,1019.5370370370358,23.17129629629627,0
3235,4,2,0,51,0.0392156862745098,0.0,1.0,51,1350,900,450,0.6666666666666666,18,9,9,289.9925659777175,0.8297385620915033,0.21859146921115502,0.16623729691242145,130498.99798525378,-2630.411951303157,127868.58603395062,3204,0,752.4509803921569,44,7,13,37.15262045008306,0.6124526515151516,44.56018518518518,1021.7592592592594,23.22180134680135,0
3236,4,1,2,50,0.019230769230769232,0.038461538461538464,0.9615384615384616,52,1050,700,350,0.6666666666666666,14,7,7,307.1163825875914,0.8376068376068375,0.23459152814712425,0.16859874323023347,128801.6214420438,-2469.6137688614635,126332.00767318234,3205,0,738.9615384615385,44,8,12,38.43306272613944,0.595407196969697,46.22685185185185,1015.0925925925918,23.070286195286176,6
3237,4,0,2,48,0.0,0.04,0.96,50,1450,1000,450,0.6896551724137931,19,10,9,313.9214828515247,0.830391156462585,0.247262715818946,0.17187882926694337,128696.43814745444,-1919.8846598083298,126776.5534876461,3206,1,769.2,43,7,12,38.367261627002655,0.595687984496124,46.330492424242415,1014.6780303030284,23.597163495419267,0
3238,4,0,0,48,0.0,0.0,1.0,48,500,100,400,0.2,9,1,8,324.910011409684,0.8217715721040189,0.2584055028215422,0.1768916039741905,128471.19005298855,-1251.6848348135795,127219.50521817496,3207,2,802.125,41,7,12,38.31781893205467,0.5962906504065042,46.55257936507935,1013.7896825396805,24.726577622919038,0
3239,4,0,0,48,0.0,0.0,1.0,48,1550,1000,550,0.6451612903225806,21,10,11,328.8399111627206,0.822122488179669,0.2598287358570548,0.17948373795069358,128571.78411005599,-1144.093187043344,127427.69092301265,3208,3,803.125,41,7,13,38.11574798656623,0.5973069105691057,46.45337301587301,1014.1865079365074,24.736256291134325,0
3240,4,1,1,48,0.02040816326530612,0.02040816326530612,0.9795918367346939,49,1250,900,350,0.72,16,9,7,328.3447431220254,0.8232001133786848,0.2686354450194499,0.18095213445873184,128955.22072742059,-1331.6462352021733,127623.57449221841,3209,0,787.7142857142857,42,7,16,37.73810659543345,0.5997023809523808,46.075581395348856,1015.6976744186076,24.1832779623478,0
3241,4,2,0,50,0.04,0.0,1.0,50,800,500,300,0.625,11,5,6,317.4169089535497,0.831921768707483,0.252509090909091,0.17151017055659726,128169.06003996138,-1856.8008796046097,126312.25916035677,3210,0,772.78,42,8,17,38.81539074960128,0.5917658730158731,46.85077519379844,1012.5968992248048,24.109449981542973,2
3242,4,1,1,50,0.0196078431372549,0.0196078431372549,0.9803921568627451,51,1300,900,400,0.6923076923076923,17,9,8,310.2686921511737,0.8357189542483661,0.25188743625704557,0.16872883124584684,128425.93557098765,-2230.690586419755,126195.2449845679,3211,0,758.6078431372549,44,7,10,38.734927377363654,0.5916193181818181,46.59722222222222,1013.6111111111111,23.036616161616163,0
3243,4,0,0,50,0.0,0.0,1.0,50,1350,1000,350,0.7407407407407407,17,10,7,316.13196163432804,0.8320578231292517,0.25614277705101873,0.1717382869751562,128384.34504849621,-1882.7210313360983,126501.62401716011,3212,2,774.78,43,7,10,38.62868311219086,0.5925387596899225,46.63825757575757,1013.4469696969687,23.568534178999272,0
3244,4,0,0,50,0.0,0.0,1.0,50,1250,900,350,0.72,16,9,7,317.65809720397834,0.8329591836734693,0.256,0.17305254549171947,128496.3348765432,-1836.4197530864178,126659.91512345678,3213,3,775.78,44,6,10,38.47602739726026,0.5923295454545455,46.52777777777778,1013.8888888888888,23.04292929292929,0
3245,4,0,1,49,0.0,0.02,0.98,50,1000,600,400,0.6,14,6,8,320.2408258672414,0.8325850340136054,0.25658603377453226,0.1749744761783354,128613.70991940988,-1762.5278635116877,126851.1820558982,3214,4,776.78,44,6,10,38.29111516811197,0.5935132575757576,46.412037037037024,1014.3518518518497,23.05345117845113,0
3246,4,0,0,49,0.0,0.0,1.0,49,800,400,400,0.5,12,4,8,329.3024922523096,0.8280187074829932,0.26571016901344047,0.17954027938073971,128528.34093778687,-1335.0594008264538,127193.2815369604,3215,5,793.5510204081633,43,6,10,38.14826920682356,0.5939922480620154,46.49621212121212,1014.0151515151508,23.58174770965467,0
3247,4,1,1,49,0.02,0.02,0.98,50,1400,1000,400,0.7142857142857143,18,10,8,323.54859775987927,0.8347959183673469,0.28082071858471624,0.17793550265972086,128872.12362825785,-1660.7210219478825,127211.40260630996,3216,0,778.66,44,6,11,37.94436591890083,0.5961174242424243,46.157407407407405,1015.37037037037,23.076599326599318,0
3248,4,0,1,48,0.0,0.02040816326530612,0.9795918367346939,49,1250,900,350,0.72,16,9,7,326.854914010608,0.8332624716553289,0.27422648626736,0.17982889907315264,128888.68375695862,-1374.4200707357793,127514.26368622284,3217,1,795.4081632653061,43,6,12,37.84359554229226,0.5976259689922481,46.14109848484848,1015.4356060606046,23.61478153629313,0
3249,4,1,1,48,0.02040816326530612,0.02040816326530612,0.9795918367346939,49,1050,700,350,0.6666666666666666,14,7,7,319.95575711945287,0.8392148526077098,0.2693484596548552,0.17681101888502554,129063.29175199525,-1541.091354232316,127522.20039776294,3218,0,785.4081632653061,45,4,12,37.841341296725496,0.5967592592592593,45.96920289855072,1016.123188405796,22.580515297906576,0
3250,4,3,2,49,0.058823529411764705,0.0392156862745098,0.9607843137254902,51,1050,800,250,0.7619047619047619,13,8,5,313.77115886494363,0.8440849673202615,0.28684891678190216,0.17564163911528852,129571.08126201855,-2068.497124631478,127502.58413738706,3219,0,755.5490196078431,42,9,12,37.48354271755336,0.6059027777777777,45.46996124031008,1018.12015503876,24.24095607235143,0
3251,4,2,2,49,0.0392156862745098,0.0392156862745098,0.9607843137254902,51,1450,900,550,0.6206896551724138,20,9,11,315.1002604327305,0.8515686274509805,0.29314947366064703,0.17682962292623752,129669.75509472085,-2028.2052798810146,127641.54981483983,3220,0,756.5098039215686,42,9,12,37.34976056829355,0.6068948412698413,45.373062015503876,1018.5077519379844,24.250184569952008,0
3252,4,1,0,50,0.02,0.0,1.0,50,1250,800,450,0.64,17,8,9,328.09574178599087,0.8422278911564626,0.3036606546426188,0.18047849229267188,128881.41605259603,-1542.9112395589163,127338.50481303711,3221,0,772.62,42,8,16,37.81948818271465,0.5989583333333334,46.14825581395349,1015.4069767441863,24.176356589147293,4
3253,4,1,1,50,0.0196078431372549,0.0196078431372549,0.9803921568627451,51,1750,1300,450,0.7428571428571429,22,13,9,322.01269944816136,0.8480392156862746,0.30372152587858947,0.17824457468680338,129129.19253795058,-1883.7520266586293,127245.44051129195,3222,0,758.4509803921569,43,8,16,37.72215363831174,0.6000484496124031,45.90435606060606,1016.3825757575762,23.636804087385492,0
3254,4,1,1,50,0.0196078431372549,0.0196078431372549,0.9803921568627451,51,1150,700,450,0.6086956521739131,16,7,9,325.3927146013912,0.8467973856209151,0.3106534141341659,0.18055768134914854,129226.01861554297,-1790.1388242005542,127435.87979134242,3223,0,759.4313725490196,42,9,16,37.53792210680135,0.6024305555555556,45.809108527131784,1016.7635658914731,24.20865633074936,0
3255,4,2,1,51,0.038461538461538464,0.019230769230769232,0.9807692307692307,52,1100,800,300,0.7272727272727273,14,8,6,323.64410607993165,0.8538524384112619,0.32740956959706913,0.1812406994047619,129586.77685950429,-2012.0006887052239,127574.77617079906,3224,0,745.7884615384615,43,9,15,37.21633184523809,0.6046511627906976,45.45454545454546,1018.1818181818195,23.678646934460918,0
3256,4,1,1,51,0.019230769230769232,0.019230769230769232,0.9807692307692307,52,1200,800,400,0.6666666666666666,16,8,8,323.029225651493,0.8591000502765208,0.3324686276191293,0.18223724239584232,129876.19447314054,-2009.2386937557376,127866.9557793848,3225,0,744.3653846153846,43,9,17,36.93871547132415,0.6075581395348837,45.17045454545455,1019.3181818181822,23.70507399577168,0
3257,4,0,1,50,0.0,0.0196078431372549,0.9803921568627451,51,1600,1300,300,0.8125,19,13,6,326.80618816635723,0.8552941176470589,0.3381697404073072,0.1848240038957634,129972.73875114789,-1704.8209366391143,128267.91781450878,3226,1,757.6666666666666,43,8,17,36.744675581971265,0.6085271317829457,45.07575757575758,1019.69696969697,23.713883016208605,0
3258,4,0,0,50,0.0,0.0,1.0,50,1100,700,400,0.6363636363636364,15,7,8,330.06476889936266,0.8512074829931973,0.33910266159695857,0.18628118931444704,129891.90853915014,-1425.451445225664,128466.45709392447,3227,2,773.72,42,8,18,36.74350443599493,0.6091269841269842,45.155038759689916,1019.3798449612391,24.27094868955331,0
3259,4,0,0,50,0.0,0.0,1.0,50,1300,1000,300,0.7692307692307693,16,10,6,330.6683199810245,0.8511394557823129,0.3380727929297733,0.18697596620958168,129966.00193986212,-1404.8720967790643,128561.12984308306,3228,3,774.72,42,8,18,36.65304570939847,0.6098710317460319,45.08236434108526,1019.6705426356567,24.27787006275373,0
3260,4,1,1,50,0.0196078431372549,0.0196078431372549,0.9803921568627451,51,900,500,400,0.5555555555555556,13,5,8,325.3015169126696,0.8538235294117648,0.33505102115085084,0.1848865583465679,130165.9349173553,-1731.3647842057003,128434.57013314961,3229,0,760.5098039215686,43,8,18,36.58747834694383,0.6104651162790697,44.88636363636363,1020.4545454545449,23.73150105708244,0
3261,4,0,0,50,0.0,0.0,1.0,50,900,500,400,0.5555555555555556,13,5,8,331.8056626119814,0.8505952380952381,0.3410031347962381,0.188094680146275,130064.82600392099,-1368.7508450513876,128696.0751588696,3230,5,776.72,42,8,18,36.52393844400113,0.6108630952380953,44.985465116279066,1020.0581395348834,24.287098560354366,0
3262,4,0,0,50,0.0,0.0,1.0,50,1750,1400,350,0.8,21,14,7,335.69346105789236,0.8505952380952381,0.34408163265306113,0.19126720455624113,130262.58680555565,-1254.3402777777687,129008.24652777788,3231,6,777.72,42,8,18,36.22448979591837,0.6128472222222221,44.79166666666667,1020.8333333333342,24.305555555555575,0
3263,4,0,0,50,0.0,0.0,1.0,50,1150,800,350,0.6956521739130435,15,8,7,340.51164555187813,0.8493367346938775,0.35188086495308024,0.19454406602509428,130368.94531250028,-1121.5711805555243,129247.37413194476,3232,7,778.72,39,11,18,35.9938120495036,0.6185897435897435,44.687500000000014,1021.2500000000022,26.18589743589749,0
3264,4,2,2,50,0.038461538461538464,0.038461538461538464,0.9615384615384616,52,1500,1200,300,0.8,18,12,6,328.000683741175,0.8520613373554549,0.35336060378678,0.1897731079245519,130856.77059859704,-1815.7779542996047,129040.99264429744,3233,0,749.7307692307693,42,10,16,35.820350727657285,0.618799603174603,44.210271317829466,1023.1589147286837,24.360926541159138,0
3265,4,1,1,50,0.0196078431372549,0.0196078431372549,0.9803921568627451,51,1300,800,500,0.6153846153846154,18,8,10,336.35527565457323,0.8529411764705883,0.3687019592637366,0.19493488896924605,130921.69390904512,-1392.7595112118893,129528.93439783323,3234,0,764.4901960784314,41,10,17,35.54106888975055,0.6209349593495934,44.1468253968254,1023.4126984126985,24.961285327138988,0
3266,4,0,0,50,0.0,0.0,1.0,50,950,700,250,0.7368421052631579,12,7,5,340.1520851676939,0.8538095238095238,0.36335285359801506,0.19775142862461154,131041.82287535543,-1085.1701409544394,129956.652734401,3235,1,747.16,40,10,18,35.3225806451613,0.6236979166666665,44.029471544715456,1023.8821138211393,25.597052845528484,0
3267,4,0,0,50,0.0,0.0,1.0,50,900,600,300,0.6666666666666666,12,6,6,338.4262852159468,0.8539285714285714,0.35940133682069164,0.1970431213922291,131099.43000637766,-1126.5013818027087,129972.92862457495,3236,2,748.16,41,9,18,35.308594885207796,0.6227134146341463,43.97321428571429,1024.1071428571436,24.978222996515697,0
3268,4,0,0,50,0.0,0.0,1.0,50,850,600,250,0.7058823529411765,11,6,5,337.5865609782348,0.8535714285714285,0.3578599786966197,0.19707498107530988,131201.04762101604,-1141.6579073759162,130059.38971364012,3237,3,749.16,41,9,18,35.227538652722615,0.6237296747967479,43.87400793650794,1024.5039682539687,24.98790166473094,0
3269,4,3,3,50,0.05660377358490566,0.05660377358490566,0.9433962264150944,53,1350,900,450,0.6666666666666666,18,9,9,315.94848154049816,0.8615445089501693,0.3461648211688235,0.18742589353529293,131813.89534550023,-2270.658472056963,129543.23687344327,3238,0,707.6981132075472,43,10,12,35.16537563014878,0.626937984496124,43.27651515151514,1026.8939393939374,23.881254404510173,0
3270,4,0,0,50,0.0,0.0,1.0,50,800,400,400,0.5,12,4,8,332.3257318153777,0.8524659863945578,0.35764472640761347,0.19491290596241462,131380.21349725698,-1267.7948806927038,130112.41861656427,3239,5,751.16,40,10,18,35.181651467089615,0.6270833333333332,43.69918699186992,1025.2032520325206,25.630081300813014,0
3271,4,0,0,50,0.0,0.0,1.0,50,1700,1200,500,0.7058823529411765,22,12,10,331.74952953544687,0.8512414965986395,0.36033268858800827,0.19534681864444875,131531.57675107082,-1272.8922587553484,130258.68449231547,3240,6,752.16,41,9,18,35.04392327530627,0.6270325203252032,43.551587301587304,1025.7936507936508,25.01935733643051,0
3272,4,0,1,49,0.0,0.02,0.98,50,1200,800,400,0.6666666666666666,16,8,8,319.44017423674785,0.8520918367346938,0.3249660786974222,0.18537591213581348,130972.46334876538,-1618.214994331067,129354.24835443431,3241,7,753.16,44,6,16,35.92265943012212,0.6171875,44.09722222222222,1023.6111111111107,23.263888888888882,4
3273,4,1,1,49,0.02,0.02,0.98,50,1300,800,500,0.6153846153846154,18,8,10,319.97560193077305,0.8549149659863945,0.32612532778732284,0.186144670265777,131067.25930212624,-1612.3349622770832,129454.92433984917,3242,0,753.7,44,6,16,35.8134023570546,0.6181344696969697,44.00462962962963,1023.9814814814818,23.272306397306405,0
3274,4,0,1,48,0.0,0.02040816326530612,0.9795918367346939,49,1300,900,400,0.6923076923076923,17,9,8,322.624793071802,0.8499858276643991,0.31831124709581693,0.18768582780542167,131067.2593021265,-1342.890517832624,129724.36878429388,3243,9,770.0816326530612,44,5,16,35.74558429032159,0.6181344696969696,44.00462962962964,1023.9814814814839,23.27230639730645,0
3275,4,1,0,49,0.02040816326530612,0.0,1.0,49,1550,1100,450,0.7096774193548387,20,11,9,318.070784537575,0.8483560090702948,0.31421009434049196,0.18572312564159735,131209.51753257902,-1453.217163923166,129756.30036865585,3244,0,770.8775510204082,44,5,17,35.71885826178641,0.6195549242424241,43.86574074074075,1024.5370370370383,23.28493265993269,0
3276,4,1,1,49,0.02,0.02,0.98,50,1600,1300,300,0.8125,19,13,6,313.06329439768916,0.851734693877551,0.3119378724941293,0.18382093966914176,131423.049554184,-1771.1998456790027,129651.84970850499,3245,0,756.44,44,6,17,35.63226175425921,0.621685606060606,43.65740740740741,1025.3703703703718,23.303872053872087,0
3277,4,0,0,49,0.0,0.0,1.0,49,1000,700,300,0.7,13,7,6,320.5784488073823,0.8473639455782314,0.31678260468973085,0.1883504679332498,131446.78605109744,-1372.1986454046614,130074.58740569279,3246,2,772.8775510204082,44,5,18,35.41572610985703,0.6219223484848485,43.63425925925926,1025.4629629629633,23.30597643097644,0
3278,4,0,0,49,0.0,0.0,1.0,49,1100,700,400,0.6363636363636364,15,7,8,319.9616460228954,0.8474702380952381,0.31183334500075555,0.18833874147936402,131518.00840192032,-1383.8563100137271,130134.1520919066,3247,3,773.8775510204082,44,5,18,35.35987241981105,0.6226325757575759,43.56481481481481,1025.7407407407397,23.31228956228954,0
3279,4,1,0,50,0.02,0.0,1.0,50,800,300,500,0.375,13,3,10,316.85381056261946,0.8508673469387755,0.3259610126135666,0.18797339876234523,131816.00934841685,-1646.719028959248,130169.29031945759,3248,0,759.38,45,5,15,35.14000984975449,0.6243055555555556,43.27445652173913,1026.9021739130437,22.82004830917875,0
3280,4,0,0,50,0.0,0.0,1.0,50,1050,600,450,0.5714285714285714,15,6,9,316.1913852762202,0.8509523809523809,0.3249898580121706,0.18781006378454998,131862.52170138882,-1661.2413194444482,130201.28038194437,3249,1,760.38,45,5,15,35.11029411764705,0.6247685185185186,43.229166666666664,1027.0833333333328,22.824074074074062,0
3281,4,0,1,49,0.0,0.02,0.98,50,1550,1200,350,0.7741935483870968,19,12,7,315.2262537277462,0.85,0.3212708204811847,0.18815740668325795,132048.65316011594,-1674.9595509084365,130373.6936092075,3250,2,761.38,45,5,15,34.94820584001643,0.6266203703703704,43.048007246376805,1027.8079710144918,22.840177133655374,0
3282,4,0,1,48,0.0,0.02040816326530612,0.9795918367346939,49,1300,800,500,0.6153846153846154,18,8,10,319.55108535285075,0.8445294784580499,0.31828789910124633,0.19034129866669802,131969.53125,-1365.798611111109,130603.73263888889,3251,3,777.795918367347,44,5,16,34.91653149499866,0.6271306818181819,43.125,1027.5,23.352272727272727,0
3283,4,0,0,48,0.0,0.0,1.0,48,1350,900,450,0.6666666666666666,18,9,9,328.87250217953397,0.8402593085106382,0.3253329186250118,0.19596900171060544,131984.12682399276,-918.8099926825081,131065.31683131025,3252,4,794.4375,43,5,16,34.66241590636808,0.6286337209302326,43.11079545454545,1027.556818181818,23.896670190274836,0
3284,4,0,0,48,0.0,0.0,1.0,48,800,500,300,0.625,11,5,6,331.5679380706401,0.8394466607565012,0.32606517733763307,0.19808310224308162,132081.451275898,-841.2051086145675,131240.24616728342,3253,5,795.4375,43,5,16,34.495336250575775,0.6296027131782946,43.01609848484848,1027.9356060606046,23.905479210711736,0
3285,4,0,0,48,0.0,0.0,1.0,48,1350,900,450,0.6666666666666666,18,9,9,331.20772275508466,0.8390588061465721,0.3214642045803404,0.19824991475604795,132154.46815455696,-845.8839101239668,131308.584244433,3254,6,796.4375,43,5,16,34.43121814944434,0.6303294573643411,42.94507575757576,1028.2196969696972,23.91208597603947,0
3286,4,0,0,48,0.0,0.0,1.0,48,1550,1100,450,0.7096774193548387,20,11,9,333.8911289885282,0.8378952423167848,0.3240825969563088,0.200630156268328,132300.56244260792,-765.2031680440714,131535.35927456385,3255,7,797.4375,43,5,17,34.21545164457537,0.6317829457364341,42.803030303030305,1028.787878787879,23.92529950669486,0
3287,4,0,0,48,0.0,0.0,1.0,48,1450,1100,350,0.7586206896551724,18,11,7,330.27913914340496,0.8365839243498818,0.318066801619433,0.1989730423620026,132398.0034722223,-854.3402777777721,131543.66319444453,3256,8,798.4375,43,5,17,34.21052631578947,0.6327519379844961,42.708333333333336,1029.1666666666672,23.934108527131794,0
3288,4,0,0,48,0.0,0.0,1.0,48,1200,900,300,0.75,15,9,6,331.69900383141754,0.8362514775413712,0.31690613026819925,0.20073604155073277,132568.61158638954,-805.4247194960877,131763.18686689346,3257,9,799.4375,43,5,17,34.00277777777779,0.6344476744186045,42.54261363636364,1029.829545454546,23.94952431289642,0
3289,4,0,0,48,0.0,0.0,1.0,48,1400,1100,300,0.7857142857142857,17,11,6,334.1624553409653,0.8354942375886525,0.3197024028441824,0.20235806594033082,132592.99314164385,-738.4799701560984,131854.51317148775,3258,10,800.4375,43,5,17,33.914889052347675,0.6346899224806202,42.5189393939394,1029.9242424242434,23.95172656800566,0
3290,4,0,0,48,0.0,0.0,1.0,48,1200,900,300,0.75,15,9,6,332.943481165745,0.8342198581560284,0.32390367000582065,0.2022757129293395,132714.93454610018,-762.6855379074863,131952.24900819268,3259,11,801.4375,43,5,16,33.82396302423183,0.6359011627906976,42.40056818181818,1030.397727272727,23.962737843551793,0
3291,4,0,0,48,0.0,0.0,1.0,48,1300,1100,200,0.8461538461538461,15,11,4,331.66433476893917,0.8337027186761229,0.32167248560578154,0.20189231653384443,132788.1262913225,-791.7828856749165,131996.34340564758,3260,12,802.4375,43,5,16,33.78353546490259,0.6366279069767441,42.32954545454546,1030.6818181818196,23.969344608879524,0
3292,4,0,0,48,0.0,0.0,1.0,48,1050,700,350,0.6666666666666666,14,7,7,372.53547882170665,0.8330562943262411,0.3685915338004806,0.2192681924660699,131515.04041883693,227.32041203944698,131742.36083087637,3261,13,803.4375,39,9,20,34.01469567719443,0.6300747863247862,43.56770833333334,1025.7291666666679,26.300747863247896,4
3293,4,0,0,48,0.0,0.0,1.0,48,1700,1300,400,0.7647058823529411,21,13,8,375.30028259078813,0.8325391548463357,0.36957808905129186,0.22167016691153782,131648.6328125003,281.55381944447413,131930.18663194476,3262,14,804.4375,39,9,13,33.80870212478008,0.6314102564102563,43.437500000000014,1026.2500000000023,26.314102564102622,0
3294,4,0,0,48,0.0,0.0,1.0,48,1550,1100,450,0.7096774193548387,20,11,9,381.75290740358423,0.8336473108747045,0.3708762471837783,0.21924330560128208,130570.58572108728,385.93701908279957,130956.52274017008,3263,15,805.4375,37,11,15,34.73596806494295,0.6241554054054053,44.49013157894737,1022.0394736842107,27.62268847795164,3
3295,4,0,1,47,0.0,0.020833333333333332,0.9791666666666666,48,1800,1600,200,0.8888888888888888,20,16,4,379.1654442745808,0.8316526300236406,0.3708494173993855,0.21854740008063905,130710.70545744844,312.19654124346044,131022.9019986919,3264,16,806.4375,37,11,16,34.65982200300236,0.6255630630630631,44.353070175438596,1022.5877192982456,27.63750592697961,0
3296,4,0,0,47,0.0,0.0,1.0,47,1050,600,450,0.5714285714285714,15,6,9,382.42446001280814,0.8318686401480111,0.36199737557409306,0.2203308437129632,130694.0386332279,596.1194302410615,131290.15806346896,3265,17,809.1276595744681,36,11,17,34.59342878120412,0.6273148148148149,44.36936936936937,1022.5225225225231,28.40340340340342,0
3297,4,1,0,48,0.020833333333333332,0.0,1.0,48,1300,800,500,0.6153846153846154,18,8,10,373.4425306165943,0.8324652777777778,0.3703988529718456,0.21810681294842507,131218.63928153994,200.52414347286538,131419.1634250128,3266,0,793.25,38,10,18,34.29136253041363,0.6288377192982456,43.85683760683761,1024.5726495726497,26.962438146648676,0
3298,4,0,0,48,0.0,0.0,1.0,48,1500,900,600,0.6,21,9,12,373.78544517152505,0.8315418144208038,0.37042682926829307,0.21893147502903598,131328.12499999997,217.7083333333327,131545.8333333333,3267,1,794.25,38,10,18,34.17174796747968,0.6299342105263158,43.75,1024.9999999999998,26.97368421052631,0
3299,4,0,0,48,0.0,0.0,1.0,48,1500,1000,500,0.6666666666666666,20,10,10,372.66784890111137,0.8311354905437353,0.3653755990831431,0.21890244882208482,131437.65637555698,196.5177332164477,131634.17410877344,3268,2,795.25,38,10,18,34.08956727095923,0.6310307017543859,43.64316239316239,1025.4273504273501,26.98493027440395,0
3300,4,0,0,48,0.0,0.0,1.0,48,1000,700,300,0.7,13,7,6,370.9638903616651,0.8306922281323876,0.36267449734347323,0.218057708731269,131465.0463533676,153.75700836437153,131618.80336173196,3269,3,796.25,38,10,18,34.10554918915165,0.6313048245614036,43.61645299145299,1025.5341880341875,26.987741790373356,0
3301,4,0,0,48,0.0,0.0,1.0,48,1300,1000,300,0.7692307692307693,16,10,6,369.43350993364305,0.8295840721040189,0.3615132264111649,0.2176258013731801,131547.2334082108,119.59123201108383,131666.8246402219,3270,4,797.25,38,10,18,34.061697215857805,0.6321271929824562,43.536324786324776,1025.8547008546993,26.99617633828156,0
3302,4,0,0,48,0.0,0.0,1.0,48,1000,600,400,0.6,14,6,8,366.6037379994548,0.8303782505910166,0.35816982408660425,0.2167361299052773,131684.26890432072,55.18904320984922,131739.45794753058,3271,5,798.25,38,10,17,33.99582769508344,0.633497807017544,43.402777777777764,1026.3888888888869,27.010233918128602,0
3303,4,0,0,48,0.0,0.0,1.0,48,1200,700,500,0.5833333333333334,17,7,10,340.08102254041484,0.8309877364066194,0.315881969272394,0.20145955937439902,131760.64819735757,-634.2827813996028,131126.36541595796,3272,6,799.25,41,7,16,34.59945807968563,0.629319105691057,43.32837301587301,1026.6865079365073,25.041134339914812,3
3304,4,0,0,48,0.0,0.0,1.0,48,1500,1100,400,0.7333333333333333,19,11,8,342.3319045111538,0.8298241725768322,0.3114858991694043,0.20347328009807567,131887.99622858362,-570.1062137818465,131317.8900148018,3273,7,800.25,41,7,16,34.413431202111916,0.630589430894309,43.20436507936506,1027.1825396825366,25.053232675183818,0
3305,4,0,0,48,0.0,0.0,1.0,48,1400,1100,300,0.7857142857142857,17,11,6,344.87619277822245,0.8291777482269503,0.30793962937940433,0.205951713739202,132066.3868122477,-490.68946444321404,131575.6973478045,3274,8,801.25,41,7,16,34.168496445002084,0.632367886178862,43.030753968253954,1027.8769841269816,25.070170344560527,0
3306,4,1,0,49,0.02040816326530612,0.0,1.0,49,1400,1000,400,0.7142857142857143,18,10,8,339.2060885506226,0.8320223922902494,0.30705788335773376,0.204787646496384,132478.4193250869,-811.2552518837324,131667.16407320317,3275,0,785.8775510204082,39,10,17,33.90006829909946,0.639690170940171,42.630208333333336,1029.4791666666674,26.396901709401728,0
3307,4,0,0,49,0.0,0.0,1.0,49,1000,600,400,0.6,14,6,8,340.52475326494755,0.8309240362811792,0.30662625228156815,0.20573023601899387,132505.23003472216,-775.737847222227,131729.49218749994,3276,1,786.8775510204082,39,10,17,33.83920140294078,0.639957264957265,42.604166666666664,1029.583333333333,26.39957264957264,0
3308,4,1,1,49,0.02,0.02,0.98,50,1500,900,600,0.6,21,9,12,335.53598683686755,0.8329251700680271,0.3072239747634067,0.20454789966785986,132842.88452640636,-1085.2863292352338,131757.59819717112,3277,0,772.12,40,10,16,33.62886928233439,0.6416666666666666,42.27642276422765,1030.8943089430902,25.772357723577255,0
3309,4,0,0,49,0.0,0.0,1.0,49,2100,1800,300,0.8571428571428571,24,18,6,347.10578386551833,0.8277706916099773,0.310758382391096,0.2120458993909341,132921.47040658674,-572.4377643928826,132349.03264219387,3278,3,788.8775510204082,40,9,16,33.25182319897508,0.6424479166666666,42.20020325203252,1031.1991869918702,25.779979674796756,0
3310,4,0,0,49,0.0,0.0,1.0,49,950,700,250,0.7368421052631579,12,7,5,349.1247057681575,0.8280895691609977,0.31139036895546424,0.21372833314516265,133000.07952442317,-513.2772737788471,132486.80225064434,3279,4,789.8775510204082,40,9,16,33.12089490968801,0.6432291666666667,42.12398373983739,1031.5040650406495,25.787601626016237,0
3311,4,0,0,49,0.0,0.0,1.0,49,1500,1000,500,0.6666666666666666,20,10,10,351.95747442690424,0.8275581065759637,0.315124868379806,0.21637288803145505,133157.3674730649,-426.85384856898094,132730.5136244959,3280,5,790.8775510204082,40,9,17,32.890040370224504,0.6447916666666667,41.97154471544715,1032.1138211382108,25.802845528455272,0
3312,4,0,0,49,0.0,0.0,1.0,49,1150,1000,150,0.8695652173913043,13,10,3,349.53555269733283,0.8272392290249433,0.30756980862689165,0.21522289712239293,133216.0621771855,-487.25001574705794,132728.81216143843,3281,6,791.8775510204082,41,8,17,32.893683131526686,0.6438008130081301,41.91468253968253,1032.3412698412683,25.179055361982154,0
3313,4,0,0,49,0.0,0.0,1.0,49,1350,1000,350,0.7407407407407407,17,10,7,348.10898921809707,0.826530612244898,0.304739941522876,0.21449202195338865,133241.66710955207,-523.4755881519341,132718.19152140015,3282,7,792.8775510204082,41,8,17,32.90483568751801,0.6440548780487805,41.88988095238095,1032.4404761904757,25.181475029035994,0
3314,4,0,0,49,0.0,0.0,1.0,49,500,300,200,0.6,7,3,4,348.18770822527136,0.8263180272108843,0.30429353568341155,0.21513247657764392,133344.11144376732,-514.2438862118969,132829.86755755544,3283,8,793.8775510204082,41,8,17,32.80014327794319,0.6450711382113821,41.7906746031746,1032.8373015873015,25.191153697251256,0
3315,4,0,0,49,0.0,0.0,1.0,49,1350,900,450,0.6666666666666666,18,9,9,341.8893976960006,0.8252551020408163,0.29481765834932894,0.21255892147925556,133574.7551335348,-666.4414840010102,132908.3136495338,3284,9,794.8775510204082,41,8,17,32.731925783749205,0.6473577235772358,41.567460317460316,1033.730158730158,25.212930700735562,0
3316,4,0,0,49,0.0,0.0,1.0,49,1000,400,600,0.4,16,4,12,344.2182081672791,0.8240504535147393,0.30043165467625865,0.21475013884762922,133702.97663336166,-595.4001913265313,133107.57644203512,3285,10,795.8775510204082,41,8,16,32.54346522781774,0.6486280487804879,41.44345238095238,1034.2261904761904,25.225029036004642,0
3317,4,0,0,49,0.0,0.0,1.0,49,1550,1100,450,0.7096774193548387,20,11,9,341.16029087460436,0.8227749433106576,0.29836523453544705,0.21417969163571743,133933.93034297056,-661.4122732426301,133272.51806972793,3286,11,796.8775510204082,41,8,16,32.39170021084914,0.6509146341463414,41.220238095238095,1035.119047619048,25.246806039488973,0
3318,4,0,0,49,0.0,0.0,1.0,49,1350,1000,350,0.7407407407407407,17,10,7,336.77942207206127,0.8225269274376418,0.29526637745815765,0.21216900344057033,134062.3240760426,-770.1135952065882,133292.21048083602,3287,12,797.8775510204082,41,8,16,32.376883960788064,0.6521849593495934,41.096230158730165,1035.6150793650806,25.258904374758064,0
3319,4,0,0,49,0.0,0.0,1.0,49,1450,1000,450,0.6896551724137931,19,10,9,339.76987088104835,0.8202947845804989,0.3019611060966596,0.215105216437784,134242.1786422905,-677.7104591836514,133564.46818310686,3288,13,798.8775510204082,41,8,17,32.11995022017997,0.6539634146341462,40.92261904761906,1036.3095238095257,25.275842044134773,0
3320,4,0,0,49,0.0,0.0,1.0,49,1150,600,550,0.5217391304347826,17,6,11,340.0957089772363,0.8205428004535148,0.3014885793567259,0.2160693163842613,134370.72000385815,-660.218942901227,133710.5010609569,3289,14,799.8775510204082,41,8,17,31.983283098906,0.6552337398373983,40.798611111111114,1036.8055555555563,25.287940379403814,0
3321,4,0,0,49,0.0,0.0,1.0,49,1350,900,450,0.6666666666666666,18,9,9,341.6457543142497,0.8191964285714286,0.30000409841664544,0.21797374331080602,134525.05083341213,-608.017506771224,133917.0333266409,3290,15,800.8775510204082,41,8,17,31.789212170475924,0.6567581300813008,40.64980158730159,1037.400793650794,25.30245838172668,0
3322,4,0,0,49,0.0,0.0,1.0,49,1350,1100,250,0.8148148148148148,16,11,5,341.44610570797244,0.8189838435374149,0.3012867797721499,0.21800020595201317,134550.78125,-611.6270234945836,133939.15422650543,3291,16,801.8775510204082,39,10,17,31.76874163319946,0.6602564102564104,40.625,1037.5,26.602564102564102,0
3323,4,0,0,49,0.0,0.0,1.0,49,1800,1500,300,0.8333333333333334,21,15,6,343.69918397280617,0.8172123015873016,0.31182608517566646,0.2202548146809653,134685.9063042533,-541.7127821180761,134144.19352213523,3292,17,802.8775510204082,39,10,17,31.57561883258069,0.6615918803418804,40.49479166666666,1038.020833333332,26.615918803418765,0
3324,4,0,1,48,0.0,0.02040816326530612,0.9795918367346939,49,1400,1000,400,0.7142857142857143,18,10,8,342.2001209244586,0.8160785147392291,0.3038503264896735,0.2201119487494742,134821.09917534713,-572.8407118055668,134248.25846354157,3293,18,803.8775510204082,39,10,15,31.479856235372782,0.6629273504273505,40.36458333333333,1038.5416666666658,26.62927350427348,0
3325,4,0,0,48,0.0,0.0,1.0,48,1550,1200,350,0.7741935483870968,19,12,7,345.29321894417444,0.8135527482269503,0.30951844056925215,0.22343292727788433,135037.54882812515,-274.4900173610962,134763.05881076405,3294,19,816.6875,39,9,15,31.18402151399746,0.6650641025641024,40.15625000000001,1039.3750000000011,26.650641025641054,0
3326,4,0,0,48,0.0,0.0,1.0,48,1700,1300,400,0.7647058823529411,21,13,8,345.50883150659917,0.8123153073286051,0.3136728271394702,0.22441214475799492,135172.91802300356,-259.3126085069342,134913.60541449662,3295,20,817.6875,39,9,17,31.043711810077127,0.6663995726495726,40.02604166666667,1039.8958333333342,26.66399572649575,0
3327,4,0,0,48,0.0,0.0,1.0,48,1100,1000,100,0.9090909090909091,12,10,2,345.2222010299449,0.8115580673758865,0.30610258121940426,0.2248447204968943,135272.2318672837,-260.2044753086674,135012.02739197502,3296,21,818.6875,41,7,18,30.952380952380945,0.6641260162601628,39.93055555555554,1040.2777777777758,25.372628726287214,0
3328,4,0,0,48,0.0,0.0,1.0,48,1400,900,500,0.6428571428571429,19,9,10,346.220204760664,0.8108192966903073,0.30806762939662624,0.22630505720524133,135401.26532383775,-224.26923894558956,135176.99608489216,3297,22,819.6875,41,7,18,30.79812458297588,0.6653963414634146,39.80654761904761,1040.7738095238085,25.384727061556305,0
3329,4,0,0,48,0.0,0.0,1.0,48,1250,1000,250,0.8,15,10,5,343.9938390317675,0.8094156323877069,0.3053696204541847,0.22549752283812602,135504.53637762967,-277.454865047883,135227.0815125818,3298,23,820.6875,41,7,18,30.75343417500396,0.6664126016260162,39.707341269841265,1041.1706349206343,25.394405729771567,0
3330,4,0,0,48,0.0,0.0,1.0,48,1200,600,600,0.5,18,6,12,340.4799999999998,0.8088430851063829,0.29649999999999976,0.22400000000000014,135633.68055555574,-363.76586514233634,135269.9146904134,3299,24,821.6875,39,9,18,30.716666666666672,0.6709401709401709,39.58333333333334,1041.666666666668,26.709401709401746,0
3331,4,0,0,48,0.0,0.0,1.0,48,1350,1000,350,0.7407407407407407,17,10,7,340.15897400129126,0.8081966607565012,0.2927600886400741,0.22429862998911798,135715.07297092033,-367.0600043402578,135348.01296658008,3300,25,822.6875,39,9,18,30.644244226731978,0.6717414529914529,39.50520833333334,1041.9791666666683,26.717414529914574,0
3332,4,0,0,48,0.0,0.0,1.0,48,850,400,450,0.47058823529411764,13,4,9,339.4449438671794,0.8073101359338061,0.2946856885868474,0.2243385804712682,135796.4898003474,-380.91362847220245,135415.5761718752,3301,26,823.6875,39,9,18,30.582067426210944,0.6725427350427349,39.42708333333334,1042.291666666668,26.72542735042739,0
3333,4,0,0,48,0.0,0.0,1.0,48,950,600,350,0.631578947368421,13,6,7,338.91183741333566,0.8072731973995272,0.2964743589743588,0.22466937036473472,135905.08355034745,-388.03168402775214,135517.0518663197,3302,27,824.6875,39,9,17,30.488261738261745,0.6736111111111109,39.32291666666668,1042.708333333335,26.736111111111157,0
3334,4,0,0,48,0.0,0.0,1.0,48,1150,900,250,0.782608695652174,14,9,5,337.2913232040353,0.8069038120567376,0.2924364223420548,0.22427857307869933,136013.72070312512,-424.750434027764,135588.97026909736,3303,28,825.6875,39,9,17,30.422824712069772,0.6746794871794872,39.21875000000001,1043.125000000001,26.746794871794894,0
3335,4,0,0,48,0.0,0.0,1.0,48,1250,800,450,0.64,17,8,9,339.88289296598504,0.8064051418439716,0.3003047766357323,0.22721590863323107,136203.94015842,-341.3221571180652,135862.61800130195,3304,29,826.6875,39,9,17,30.166753983301742,0.6765491452991453,39.03645833333333,1043.8541666666656,26.765491452991427,0
3336,4,0,0,48,0.0,0.0,1.0,48,900,800,100,0.8888888888888888,10,8,2,343.12184689247414,0.8044473995271867,0.30577581621118455,0.23026369725193743,136339.892578125,-243.76085069444332,136096.13172743056,3305,30,827.6875,39,9,18,29.947553028791816,0.6778846153846154,38.90625,1044.375,26.778846153846153,0
3337,4,0,0,48,0.0,0.0,1.0,48,1100,800,300,0.7272727272727273,14,8,6,341.9353107178961,0.8047429078014184,0.30207294782319716,0.23017524607385897,136448.70334201393,-268.6740451388833,136180.02929687506,3306,31,828.6875,39,9,18,29.870804253904947,0.6789529914529915,38.802083333333336,1044.791666666667,26.789529914529922,0
3338,4,0,0,48,0.0,0.0,1.0,48,1550,1000,550,0.6451612903225806,21,10,11,340.66864628508733,0.8039856678486997,0.3060434313237004,0.2302094185502258,136584.77783203137,-293.9697265624854,136290.8081054689,3307,32,829.6875,39,9,18,29.769245142003005,0.6802884615384615,38.67187500000001,1045.312500000001,26.802884615384638,0
3339,4,0,0,48,0.0,0.0,1.0,48,1150,700,450,0.6086956521739131,16,7,9,342.34857225351845,0.8036716903073285,0.3069447210328913,0.23278312194597756,136802.63807508693,-233.16243489582297,136569.4756401911,3308,33,830.6875,39,9,19,29.509878356400797,0.6824252136752136,38.46354166666667,1046.1458333333344,26.824252136752165,0
3340,4,0,0,48,0.0,0.0,1.0,48,1150,800,350,0.6956521739130435,15,8,7,345.4613522374797,0.8021572104018913,0.31115189978430413,0.23526503615088032,136857.1302625869,-144.23014322916185,136712.90011935774,3309,34,831.6875,39,9,19,29.374585199933623,0.6829594017094017,38.411458333333336,1046.3541666666672,26.82959401709403,0
3341,4,0,0,48,0.0,0.0,1.0,48,1150,800,350,0.6956521739130435,15,8,7,346.5784616008762,0.8013815011820331,0.3117369957537155,0.23657747161451126,136938.88888888896,-107.98611111110546,136830.90277777787,3310,35,832.6875,39,9,20,29.264530254777064,0.6837606837606838,38.333333333333336,1046.6666666666672,26.837606837606852,0
3342,4,0,1,47,0.0,0.020833333333333332,0.9791666666666666,48,1300,900,400,0.6923076923076923,17,9,8,346.5797985770452,0.800107121749409,0.3103611221647431,0.23731744790847809,137047.9383680555,-100.39062500000551,136947.5477430555,3311,36,833.6875,39,9,16,29.15671839766546,0.6848290598290598,38.229166666666664,1047.083333333333,26.84829059829059,0
3343,4,0,0,47,0.0,0.0,1.0,47,950,900,50,0.9473684210526315,10,9,1,345.21413312388745,0.7992213999383286,0.3055634922146666,0.23656698570514223,137075.20751953113,64.05978732637493,137139.2673068575,3312,37,843.468085106383,39,8,16,29.16552687423322,0.685096153846154,38.20312499999999,1047.187499999999,26.850961538461515,0
3344,4,0,0,47,0.0,0.0,1.0,47,1400,1100,300,0.7857142857142857,17,11,6,344.15746375975135,0.7990672217082947,0.30263809471407566,0.23602722651026878,137102.47938368065,36.96831597222695,137139.44769965287,3313,38,844.468085106383,39,8,16,29.166252237915252,0.6853632478632479,38.177083333333336,1047.2916666666672,26.85363247863249,0
3345,4,0,0,47,0.0,0.0,1.0,47,1100,600,500,0.5454545454545454,16,6,10,318.26694925148536,0.7984119642306505,0.23174024256414527,0.20773503613558342,135349.6445597913,-782.7025413753647,134566.94201841595,3314,39,845.468085106383,41,6,18,31.57663186830647,0.664888211382114,39.856150793650784,1040.5753968253953,25.379887727448665,5
3346,4,0,0,47,0.0,0.0,1.0,47,750,300,450,0.4,12,3,9,320.3875678048275,0.7981036077705828,0.23476867533415824,0.20926933912033868,135375.45371157717,-725.4775289745619,134649.9761826026,3315,40,846.468085106383,41,6,18,31.49586908166507,0.6651422764227642,39.8313492063492,1040.6746031746027,25.382307394502504,0
3347,4,0,0,47,0.0,0.0,1.0,47,1100,900,200,0.8181818181818182,13,9,4,319.48001096817376,0.7966389145852605,0.2357291126102754,0.209578887195122,135530.36029226508,-740.1518014613214,134790.20849080375,3316,41,847.468085106383,41,6,18,31.365917174796753,0.6666666666666666,39.682539682539684,1041.2698412698414,25.396825396825403,0
3348,4,0,0,47,0.0,0.0,1.0,47,1050,800,250,0.7619047619047619,13,8,5,319.8929996774742,0.7962920135676842,0.22954087772541776,0.2107601181062003,135685.35545005032,-719.0409265558221,134966.3145234945,3317,42,848.468085106383,41,6,20,31.201596521297517,0.6681910569105691,39.53373015873015,1041.8650793650786,25.411343399148258,0
3349,4,0,0,47,0.0,0.0,1.0,47,1500,1200,300,0.8,18,12,6,320.60793581538593,0.7950971322849213,0.22884034756970562,0.211996701171319,135814.58574459873,-691.3532021604956,135123.23254243823,3318,43,849.468085106383,41,6,20,31.05499111703309,0.6694613821138211,39.40972222222222,1042.3611111111109,25.423441734417338,0
3350,4,0,0,47,0.0,0.0,1.0,47,900,300,600,0.3333333333333333,15,3,12,319.4333897073988,0.7941335183472094,0.2216215887901556,0.21152649605765952,135866.2950857427,-719.9537627550949,135146.3413229876,3319,44,850.468085106383,41,6,15,31.034410981063854,0.6699695121951219,39.36011904761905,1042.5595238095243,25.42828106852498,0
3351,4,0,0,47,0.0,0.0,1.0,47,900,700,200,0.7777777777777778,11,7,4,297.47773976192394,0.7935938945420906,0.14324425714726474,0.18599433611415647,133783.36012517143,-1440.4856824417018,132342.87444272972,3320,45,851.468085106383,44,3,17,33.67194725379636,0.6451231060606061,41.36574074074074,1034.5370370370367,23.51220538720538,8
3352,4,0,0,47,0.0,0.0,1.0,47,1600,1300,300,0.8125,19,13,6,299.7942274890313,0.7927073697193956,0.14027709054923299,0.1882977226588411,133951.04595336088,-1368.4499314128825,132582.596021948,3321,46,852.468085106383,44,3,18,33.44514013118664,0.646780303030303,41.20370370370371,1035.1851851851861,23.52693602693605,0
3353,4,0,0,47,0.0,0.0,1.0,47,1150,900,250,0.782608695652174,14,9,5,298.27059809537855,0.7921677459142769,0.137042279243905,0.1878298631249275,134046.91358024682,-1403.549382716058,132643.36419753075,3322,47,853.468085106383,44,3,18,33.38921673819743,0.6477272727272728,41.11111111111111,1035.5555555555547,23.53535353535352,0
3354,4,0,0,47,0.0,0.0,1.0,47,1500,1100,400,0.7333333333333333,19,11,8,326.24500953816164,0.7925146469318531,0.07554309499647394,0.1988005304427128,132827.17013888928,-686.477623456751,132140.69251543254,3323,48,854.468085106383,39,8,15,33.884060900026945,0.6431623931623931,42.291666666666686,1030.8333333333364,26.43162393162401,5
3355,4,0,0,47,0.0,0.0,1.0,47,1050,800,250,0.7619047619047619,13,8,5,322.54055042524726,0.7925917360468702,0.07337783778797169,0.19717719913948276,132947.670863904,-823.7970123603433,132123.87385154367,3324,49,855.468085106383,40,7,16,33.85888845092629,0.6427083333333332,42.17479674796749,1031.300813008132,25.7825203252033,0
3356,4,0,0,47,0.0,0.0,1.0,47,1250,800,450,0.64,17,8,9,323.2440274988251,0.793709528214616,0.07418617178477338,0.19802354394330607,133026.2877276261,-800.0093983408995,132226.2783292852,3325,50,856.468085106383,40,7,16,33.76206777657373,0.6434895833333332,42.098577235772375,1031.6056910569134,25.790142276422834,0
3357,4,1,0,48,0.020833333333333332,0.0,1.0,48,1300,1100,200,0.8461538461538461,15,11,4,318.34067804520964,0.8010305851063829,0.0754147450678968,0.19628493940133573,133267.2745023937,-1115.1210947341701,132152.15340765953,3326,0,839.6041666666666,41,7,17,33.64759479887269,0.6443089430894309,41.865079365079374,1032.5396825396838,25.183894696089848,0
3358,4,0,0,48,0.0,0.0,1.0,48,1100,800,300,0.7272727272727273,14,8,6,318.39148236427496,0.8008274231678487,0.07357108549471669,0.19658691170890305,133318.49666950127,-1110.5052437641582,132207.9914257371,3327,1,840.6041666666666,41,7,17,33.595100864553324,0.6448170731707317,41.8154761904762,1032.7380952380963,25.18873403019747,0
3359,4,0,0,48,0.0,0.0,1.0,48,1050,700,350,0.6666666666666666,14,7,7,317.4218246116442,0.8007904846335697,0.07980042890980088,0.196529778924237,133420.97052941564,-1129.8544186192833,132291.11611079637,3328,2,841.6041666666666,41,7,18,33.517780551821254,0.6458333333333333,41.71626984126985,1033.134920634922,25.198412698412735,0
3360,4,0,0,48,0.0,0.0,1.0,48,850,400,450,0.47058823529411764,13,4,9,318.7408103365374,0.7998854905437353,0.07541192179784328,0.19805041083089964,133552.96359592042,-1086.2243483185848,132466.73924760183,3329,3,842.6041666666666,39,9,18,33.351913903725325,0.6503739316239315,41.58854166666668,1033.6458333333355,26.503739316239372,0
3361,4,1,1,48,0.02040816326530612,0.02040816326530612,0.9795918367346939,49,1350,1000,350,0.7407407407407407,17,10,7,310.99019225647544,0.8042091836734694,0.08024938855699393,0.19446438311860717,133787.44877387813,-1478.6831168616472,132308.76565701648,3330,0,826.3877551020408,40,9,13,33.318393909626714,0.6510416666666666,41.361788617886184,1034.5528455284564,25.86382113821141,0
3362,4,0,0,48,0.0,0.0,1.0,48,1400,1100,300,0.7857142857142857,17,11,6,317.1540946653749,0.7972259160756501,0.07915438768827787,0.19831871521458946,133787.44877387793,-1113.7525613061064,132673.6962125718,3331,5,844.6041666666666,40,8,14,33.15897184020956,0.6510416666666667,41.36178861788618,1034.552845528455,25.863821138211375,0
3363,4,0,0,48,0.0,0.0,1.0,48,1200,1000,200,0.8333333333333334,14,10,4,317.68484241874114,0.7965425531914894,0.07972064021995262,0.19921813024584106,133892.60691387395,-1092.8696543063033,132799.73725956766,3332,6,845.6041666666666,40,8,14,33.04039015449071,0.6520833333333333,41.260162601626014,1034.9593495934955,25.87398373983739,0
3364,4,0,0,48,0.0,0.0,1.0,48,1050,800,250,0.7619047619047619,13,8,5,337.1022398125449,0.7973552009456265,0.10618799123824241,0.19956144036500031,131735.18597253683,-716.7410231851453,131018.44494935169,3333,7,846.6041666666666,41,7,15,34.70155263496973,0.6290650406504066,43.35317460317459,1026.587301587299,25.03871467286095,7
3365,4,0,0,48,0.0,0.0,1.0,48,1300,900,400,0.6923076923076923,17,9,8,332.62422229758033,0.7974844858156028,0.12232835256289021,0.19431870312566948,131228.82207349333,-870.0230229553383,130358.79905053799,3334,8,847.6041666666666,42,6,18,35.32662663135995,0.6225198412698412,43.84689922480621,1024.6124031007762,24.395533407161338,1
3366,4,0,0,48,0.0,0.0,1.0,48,900,700,200,0.7777777777777778,11,7,4,333.7220143916178,0.7970966312056738,0.1167186712052446,0.1952126119582827,131278.46884201674,-837.8969863589862,130440.57185565775,3335,9,848.6041666666666,42,6,18,35.248439863842684,0.623015873015873,43.798449612403104,1024.8062015503879,24.400147655961614,0
3367,4,1,1,48,0.02040816326530612,0.02040816326530612,0.9795918367346939,49,1100,700,400,0.6363636363636364,15,7,8,325.6724400025993,0.8031462585034014,0.12111012781267694,0.19168538653350856,131515.04041883693,-1233.7976201122967,130281.24279872463,3336,0,832.265306122449,39,10,19,35.21641532107919,0.6300747863247863,43.56770833333334,1025.7291666666679,26.300747863247896,0
3368,4,0,0,48,0.0,0.0,1.0,48,1000,400,600,0.4,16,4,12,333.2110678633459,0.7960808215130023,0.12364814429052529,0.196147116036541,131519.83486969463,-835.2270755716288,130684.607794123,3337,11,850.6041666666666,38,10,19,35.01827066625005,0.6318530701754386,43.56303418803419,1025.747863247863,26.993364822312184,0
3369,4,1,1,48,0.02040816326530612,0.02040816326530612,0.9795918367346939,49,850,600,250,0.7058823529411765,11,6,5,325.16077005048385,0.8000637755102041,0.12551227387506736,0.19313766221070885,131862.5217013887,-1224.6961805555761,130637.82552083312,3338,0,834.2244897959183,39,10,15,34.879986477349554,0.6335470085470087,43.22916666666666,1027.0833333333317,26.335470085470043,0
3370,4,0,0,48,0.0,0.0,1.0,48,1350,1000,350,0.7407407407407407,17,10,7,343.4207753585703,0.7987403959810875,0.18873052350218433,0.1877979063538365,128647.2554878434,-754.2063295225364,127893.04915832086,3339,1,849.6041666666666,41,7,17,37.66909511702198,0.5980691056910568,46.37896825396826,1014.4841269841279,24.743515292295804,5
3371,4,1,1,48,0.02040816326530612,0.02040816326530612,0.9795918367346939,49,1800,1300,500,0.7222222222222222,23,13,10,336.3036138792038,0.8023667800453514,0.18208253088628168,0.18513962809243228,128912.72454660239,-1129.2369719926546,127783.48757460974,3340,0,833.2448979591836,43,6,17,37.57926146960089,0.5978682170542635,46.11742424242424,1015.5303030303031,23.616983791402397,0
3372,4,3,1,50,0.058823529411764705,0.0196078431372549,0.9803921568627451,51,950,800,150,0.8421052631578947,11,8,3,326.5919015702684,0.8120588235294118,0.19437257005601438,0.18169000362452306,129327.49438027518,-1751.246214691505,127576.24816558367,3341,0,801.5098039215686,41,10,19,37.40439789980167,0.6049288617886179,45.70932539682539,1017.1626984126978,24.808846302748726,0
3373,4,0,1,49,0.0,0.02,0.98,50,600,400,200,0.6666666666666666,8,4,4,318.7704711514236,0.8058333333333333,0.19750140056022425,0.17400773425238267,128576.35750258272,-1802.7307879935647,126773.62671458915,3342,1,818.54,43,7,16,38.36640211640213,0.5944767441860466,46.44886363636364,1014.204545454546,23.58615221987316,1
3374,4,0,0,49,0.0,0.0,1.0,49,2050,1800,250,0.8780487804878049,23,18,5,322.210995336664,0.8020124716553289,0.19630564216721424,0.17567389705015257,128528.3409377869,-1517.3510674931208,127010.98987029378,3343,2,836.2244897959183,43,6,16,38.32804133980822,0.5939922480620154,46.49621212121212,1014.015151515151,23.581747709654675,0
3375,4,1,0,50,0.02,0.0,1.0,50,1350,1000,350,0.7407407407407407,17,10,7,321.3251559739333,0.8092006802721088,0.21621444201312912,0.176922405156732,128919.13580246919,-1715.0077160493765,127204.1280864198,3344,0,820.48,44,6,17,37.953022428884026,0.5965909090909092,46.111111111111114,1015.555555555556,23.08080808080809,0
3376,4,0,0,50,0.0,0.0,1.0,50,1150,600,550,0.5217391304347826,17,6,11,319.5079736781155,0.8095238095238095,0.21869497858379638,0.17644494188072282,129036.70374657058,-1754.3488511659884,127282.3548954046,3345,1,821.48,44,6,17,37.87971991858805,0.5977746212121213,45.99537037037037,1016.018518518518,23.091329966329955,0
3377,4,0,0,50,0.0,0.0,1.0,50,1200,700,500,0.5833333333333334,17,7,10,329.2125772641765,0.8100510204081632,0.22770491803278725,0.18256333830104318,129201.38888888876,-1492.7404835391042,127708.64840534965,3346,2,822.48,41,9,17,37.465846994535546,0.603658536585366,45.83333333333333,1016.6666666666656,24.79674796747965,0
3378,4,2,3,49,0.038461538461538464,0.057692307692307696,0.9423076923076923,52,1500,900,600,0.6,21,9,12,315.6532849745935,0.821612619406737,0.22321540979478827,0.17693959368759282,129625.34722222197,-2216.6666666666893,127408.68055555529,3347,0,791.8076923076923,44,8,17,37.38066012002182,0.6036931818181819,45.41666666666666,1018.3333333333313,23.14393939393935,0
3379,4,1,0,50,0.02,0.0,1.0,50,1000,400,600,0.4,16,4,12,324.0560296983307,0.8120748299319728,0.22357890729107188,0.181285018530919,129546.41867225514,-1603.9403806862701,127942.47829156887,3187,0,757.52,42,8,18,37.24677168602068,0.605654761904762,45.49418604651162,1018.0232558139525,24.238648947951248,0
3380,4,0,0,50,0.0,0.0,1.0,50,1200,900,300,0.75,15,9,6,326.7799718028343,0.8120068027210884,0.14770480571596334,0.17768552272004062,128420.90778730501,-1513.7921707997243,126907.11561650528,3188,1,758.52,41,9,17,38.3216493752243,0.5957825203252032,46.60218253968255,1013.591269841272,24.721738288811512,4
3381,4,1,0,51,0.0196078431372549,0.0,1.0,51,1450,900,550,0.6206896551724138,20,9,11,325.74113840773293,0.8190849673202615,0.16227619448734165,0.17873957175594568,128783.04268260623,-1810.0130137912365,126973.029668815,3189,0,744.6274509803922,42,9,18,37.97931583134447,0.5979662698412698,46.24515503875969,1015.0193798449613,24.167128091546697,0
3382,4,1,2,50,0.019230769230769232,0.038461538461538464,0.9615384615384616,52,1300,900,400,0.6923076923076923,17,9,8,320.5007513392305,0.8229952237305178,0.16264673612953717,0.17676151977459756,128984.86036680723,-2132.051068210514,126852.80929859672,3190,0,731.2884615384615,43,9,18,37.907169603182005,0.5985949612403101,46.046401515151516,1015.8143939393935,23.623590556730083,0
3383,4,1,2,49,0.0196078431372549,0.0392156862745098,0.9607843137254902,51,800,600,200,0.75,10,6,4,328.0957417859911,0.8200326797385622,0.16139842710631358,0.18047849229267177,128881.41605259587,-1742.9112395589318,127138.50481303694,3191,0,746.5490196078431,42,9,18,37.81948818271462,0.5989583333333334,46.14825581395348,1015.406976744185,24.176356589147264,0
3384,4,1,0,50,0.02,0.0,1.0,50,1050,700,350,0.6666666666666666,14,7,7,332.7315654183359,0.8196768707482993,0.1609633610161212,0.18299342138939634,128873.80248685108,-1423.923591427327,127449.87889542375,3192,0,762.18,41,9,19,37.70955463279595,0.6003556910569106,46.15575396825396,1015.3769841269831,24.765292295780075,0
3385,4,1,1,50,0.0196078431372549,0.0196078431372549,0.9803921568627451,51,1150,700,450,0.6086956521739131,16,7,9,326.6086016869521,0.8267647058823531,0.1603101957793036,0.1806683024521495,129102.89345592214,-1766.7768989243389,127336.1165569978,3193,0,748.2156862745098,42,9,19,37.63209541062802,0.6011904761904763,45.93023255813954,1016.279069767442,24.19712070874862,0
3386,4,0,1,49,0.0,0.02,0.98,50,1350,1100,250,0.8148148148148148,16,11,5,336.1085790451656,0.8192517006802721,0.1613407075426725,0.18580762617009217,129078.27546609267,-1323.1368494982355,127755.13861659444,3194,2,764.18,42,8,19,37.41576872953817,0.6009424603174605,45.95445736434108,1016.1821705426347,24.194813584348445,0
3387,4,0,0,49,0.0,0.0,1.0,49,1250,1000,250,0.8,15,10,5,335.7606782616732,0.8174248866213152,0.17388464119911684,0.1860756987640539,129176.17517203606,-1125.5439617977186,128050.63121023834,3195,3,777.9387755102041,41,8,19,37.32505042126149,0.6034044715447155,45.8581349206349,1016.5674603174575,24.794328300425793,0
3388,4,1,0,50,0.02,0.0,1.0,50,800,600,200,0.75,10,6,4,349.8434325067481,0.8248299319727891,0.23373814041745722,0.1900695762175839,128388.0362426037,-942.027317549562,127446.00892505414,3196,0,763.36,38,12,14,37.77079380139153,0.600328947368421,46.634615384615394,1013.4615384615397,26.670040485829993,7
3389,4,1,0,51,0.0196078431372549,0.0,1.0,51,1050,300,750,0.2857142857142857,18,3,15,342.6547873540274,0.8289869281045752,0.2327109107912122,0.18809247769347714,128798.2646762411,-1373.331601158959,127424.93307508214,3197,0,749.3725490196078,41,10,17,37.53461363044046,0.5995934959349591,46.23015873015874,1015.079365079367,24.758033294618706,0
3390,4,2,1,52,0.03773584905660377,0.018867924528301886,0.9811320754716981,53,2000,1600,400,0.8,24,16,8,329.0754808146571,0.8377177068214804,0.23827228247006715,0.18297796097234148,129307.31336805577,-2087.1072097820365,127220.20615827372,3198,0,722.0566037735849,39,14,18,37.36173699303564,0.6079059829059827,45.72916666666668,1017.0833333333351,26.079059829059872,0
3391,4,4,1,55,0.07142857142857142,0.017857142857142856,0.9821428571428571,56,1700,1300,400,0.7647058823529411,21,13,8,316.7720799437524,0.8535443722943723,0.2667431435998089,0.17959309711337385,130069.31889921954,-2959.5342630853934,127109.78463613414,3199,0,684.3035714285714,43,13,19,36.90277262037381,0.6094961240310077,44.98106060606061,1020.0757575757582,23.72269203664554,0
3392,4,0,0,55,0.0,0.0,1.0,55,1500,800,700,0.5333333333333333,22,8,14,323.08761286827,0.848709315375982,0.2775558424681237,0.18328714341389535,130093.46954093494,-2593.682295253666,127499.78724568128,3200,1,697.7454545454545,43,12,19,36.71727544169068,0.6097383720930232,44.95738636363637,1020.1704545454547,23.72489429175476,0
3393,4,2,1,56,0.03508771929824561,0.017543859649122806,0.9824561403508771,57,1400,1100,300,0.7857142857142857,17,11,6,316.72938060313027,0.8555242272347535,0.29865709792270345,0.1825275502651035,130703.86860499743,-3119.899670501941,127583.9689344955,3201,0,674.2280701754386,40,17,18,36.26287848671573,0.6203124999999998,44.359756097561,1022.5609756097593,25.564024390243983,0
3394,4,0,0,56,0.0,0.0,1.0,56,1500,1100,400,0.7333333333333333,19,11,8,319.579893674402,0.8506764069264069,0.2967314169288551,0.18412017686428553,130693.353223813,-2846.6064145565306,127846.74680925647,3202,1,687.1785714285714,41,15,19,36.20062012871511,0.6186483739837396,44.3700396825397,1022.5198412698439,24.93950832365473,0
3395,4,1,2,55,0.017543859649122806,0.03508771929824561,0.9649122807017544,57,1650,1200,450,0.7272727272727273,21,12,9,308.7638691570162,0.8556808688387635,0.2864216811251936,0.1790700844523433,130948.7697187931,-3313.550240054845,127635.21947873826,3203,0,676.1052631578947,44,13,19,36.219731922079475,0.6169507575757576,44.12037037037038,1023.5185185185204,23.261784511784555,0
3396,4,0,0,55,0.0,0.0,1.0,55,1550,1000,550,0.6451612903225806,21,10,11,317.86911130567586,0.8464646464646465,0.2863851706375864,0.1833218907497328,130732.8708085455,-2688.8117075295627,128044.05910101594,3204,3,701.6181818181818,42,13,19,36.204480133914494,0.6175595238095237,44.331395348837226,1022.6744186046539,24.349390919158424,0
3397,4,0,0,55,0.0,0.0,1.0,55,1400,900,500,0.6428571428571429,19,9,10,319.3568170566205,0.8463804713804713,0.28657287020613365,0.18465330090272775,130831.985945857,-2643.582679826896,128188.4032660301,3205,4,702.6181818181818,42,13,20,36.066450400959766,0.6185515873015872,44.234496124031025,1023.0620155038789,24.358619416759023,0
3398,4,0,0,55,0.0,0.0,1.0,55,1650,900,750,0.5454545454545454,24,9,15,319.3935456206497,0.8466329966329966,0.28723175319141525,0.18503100577617626,130906.34694617266,-2637.871540922965,128268.4754052497,3206,5,703.6181818181818,42,13,20,35.99051541836318,0.6192956349206347,44.161821705426384,1023.352713178299,24.3655407899595,0
3399,4,0,1,54,0.0,0.01818181818181818,0.9818181818181818,55,1750,1200,550,0.6857142857142857,23,12,11,308.3989339650047,0.8462401795735129,0.19026459579228172,0.17912230551623295,131005.52780970205,-2869.5705448891144,128135.95726481294,3207,6,704.6181818181818,42,13,19,36.17191197349741,0.6202876984126984,44.06492248062016,1023.7403100775202,24.374769287560007,4
3400,4,1,1,54,0.01818181818181818,0.01818181818181818,0.9818181818181818,55,1700,1300,400,0.7647058823529411,21,13,8,307.0535463787309,0.8450897867564534,0.20238469804427228,0.17949647611692018,131253.6442840727,-2939.6206094885874,128314.02367458412,3208,0,705.4363636363636,42,13,20,35.95665878644601,0.622767857142857,43.82267441860466,1024.7093023255834,24.39784053156151,0
3401,4,1,0,55,0.01818181818181818,0.0,1.0,55,950,600,350,0.631578947368421,13,6,7,305.708927700861,0.8437429854096521,0.21678524629090523,0.1796539616625246,131455.26389085758,-2962.5693207739473,128492.69457008362,3209,0,706.2545454545455,41,14,22,35.78840975782788,0.6262703252032519,43.62599206349208,1025.496031746034,25.012098335269123,0
3402,4,0,0,55,0.0,0.0,1.0,55,1700,1200,500,0.7058823529411765,22,12,10,304.77598150247957,0.8432379349046015,0.21563942295012706,0.17958338602376916,131557.01929209218,-2980.916064342371,128576.10322774982,3210,1,707.2545454545455,41,14,16,35.71009815298327,0.6272865853658536,43.52678571428573,1025.8928571428598,25.021777003484388,0
3403,4,0,0,55,0.0,0.0,1.0,55,1200,900,300,0.75,15,9,6,328.2511012365957,0.8432379349046015,0.30867624259857607,0.1789023639102478,128513.93771701399,-2371.062969458607,126142.87474755538,3211,2,708.2545454545455,39,16,15,38.1895931785494,0.5998931623931624,46.51041666666667,1013.9583333333343,25.998931623931647,7
3404,4,2,1,56,0.03508771929824561,0.017543859649122806,0.9824561403508771,57,2150,1800,350,0.8372093023255814,25,18,7,319.54866438473704,0.8495196324143692,0.3288035114483385,0.17676299536219012,129102.89345592215,-3149.0685655910097,125953.82489033115,3212,0,684.3684210526316,42,15,16,37.8114670734808,0.601190476190476,45.93023255813954,1016.2790697674421,24.19712070874862,0
3405,4,2,2,56,0.034482758620689655,0.034482758620689655,0.9655172413793104,58,1200,900,300,0.75,15,9,6,333.3525794435964,0.8548472474289172,0.3379223921873651,0.18140709110473957,128453.40617563963,-3006.485712584668,125446.92046305496,3213,0,673.5344827586207,40,18,16,38.12197159565581,0.59765625,46.57012195121952,1013.7195121951229,25.34298780487807,3
3406,4,1,0,57,0.017543859649122806,0.0,1.0,57,1650,1100,550,0.6666666666666666,22,11,11,340.7578372306196,0.8495196324143692,0.3379664320215017,0.1853172665506108,128427.65239771307,-2647.4541856698957,125780.19821204318,3214,0,686.3333333333334,40,17,17,37.960572488470035,0.5973958333333333,46.59552845528456,1013.6178861788624,25.34044715447156,0
3407,4,1,1,57,0.017241379310344827,0.017241379310344827,0.9827586206896551,58,1300,900,400,0.6923076923076923,17,9,8,332.29386032865966,0.8532844323452309,0.3340593098054019,0.1819433406553283,128697.58204207617,-3046.9167296548185,125650.66531242136,3215,0,675.4827586206897,41,17,17,37.900045626385094,0.5985772357723577,46.32936507936508,1014.6825396825404,24.748354626403426,0
3408,4,3,2,58,0.05,0.03333333333333333,0.9666666666666667,60,1300,800,500,0.6153846153846154,18,8,10,319.53243287917184,0.8615701506591337,0.33654459324041097,0.17687884597653444,129130.7966820991,-3747.704475308612,125383.09220679049,3216,0,653.9166666666666,44,16,18,37.783547417327135,0.5987215909090908,45.90277777777779,1016.3888888888916,23.099747474747538,0
3409,4,0,1,57,0.0,0.017241379310344827,0.9827586206896551,58,1100,500,600,0.45454545454545453,17,5,12,325.2133065945978,0.8569772131478121,0.3307110662457322,0.1792516920109794,128960.81285152676,-3212.0455262855658,125748.76732524119,3217,1,677.4655172413793,43,15,19,37.81193672695632,0.5983527131782944,46.070075757575765,1015.719696969698,23.621388301620883,0
3410,4,3,2,58,0.05,0.03333333333333333,0.9666666666666667,60,1300,800,500,0.6153846153846154,18,8,10,317.46528649877115,0.8667255178907721,0.3476167809088604,0.17737528560548374,129497.10053482371,-3777.1606118851632,125719.93992293855,3218,0,655.4166666666666,42,18,15,37.464497651688255,0.6051587301587301,45.54263565891473,1017.8294573643417,24.234034699150993,0
3411,4,0,0,58,0.0,0.0,1.0,58,1150,800,350,0.6956521739130435,15,8,7,331.495703511464,0.859875983061101,0.3430381960794866,0.1843001058784996,129302.26836104822,-3027.3707168052338,126274.89764424298,3219,1,679.0172413793103,41,17,20,37.305322538691634,0.6046747967479674,45.73412698412699,1017.0634920634928,24.806426635694947,0
3412,4,1,1,58,0.01694915254237288,0.01694915254237288,0.9830508474576272,59,2300,1800,500,0.782608695652174,28,18,10,330.6818215220924,0.8615819209039548,0.3481225368118188,0.18604169894621733,129768.46648526232,-3217.585425304964,126550.88105995736,3220,0,668.4915254237288,42,17,17,36.85290854335078,0.6078869047619047,45.276162790697676,1018.8953488372094,24.259413067552607,0
3413,4,0,0,58,0.0,0.0,1.0,58,1550,1100,450,0.7096774193548387,20,11,9,331.622745941561,0.8579350675539423,0.3456766784791956,0.18685465925775308,129827.93578541109,-2989.220686983453,126838.71509842764,3221,3,681.0172413793103,43,15,18,36.76864585269157,0.6070736434108526,45.21780303030304,1019.1287878787891,23.700669485553234,0
3414,4,1,3,56,0.01694915254237288,0.05084745762711865,0.9491525423728814,59,1400,900,500,0.6428571428571429,19,9,10,330.41339793674575,0.858781414377557,0.35999646585872136,0.1877126461131271,130149.48710452227,-3199.3731452139978,126950.11395930828,3222,0,670.457627118644,46,13,19,36.473718505647255,0.6064311594202897,44.90248226950356,1020.3900709219887,22.18239284613019,0
3415,4,0,1,55,0.0,0.017857142857142856,0.9821428571428571,56,1800,1100,700,0.6111111111111112,25,11,14,340.15032663045787,0.8528544372294372,0.36092450628009054,0.19272799411555316,130045.17049938321,-2353.0185555842327,127692.15194379898,3223,1,704.3392857142857,43,13,19,36.33106257543404,0.609253875968992,45.00473484848486,1019.9810606060621,23.72048978153633,0
3416,4,3,2,56,0.05172413793103448,0.034482758620689655,0.9655172413793104,58,750,200,550,0.26666666666666666,13,2,11,327.62369072009056,0.8580737043758823,0.35747235490414186,0.1872643004441299,130386.26359593778,-3055.929443698009,127330.33415223977,3224,0,680.8448275862069,42,16,20,36.30534471853259,0.6140873015873016,44.67054263565892,1021.3178294573647,24.317091177556303,0
3417,4,0,1,55,0.0,0.017857142857142856,0.9821428571428571,56,1250,900,350,0.72,16,9,7,339.2475025491903,0.8535173160173161,0.3598122323996866,0.19293247150251328,130190.09452658703,-2366.6671150424613,127823.42741154456,3225,1,706.1607142857143,43,13,20,36.20721985091706,0.6107073643410852,44.8626893939394,1020.5492424242435,23.73370331219171,0
3418,4,0,0,55,0.0,0.0,1.0,55,1700,1300,400,0.7647058823529411,21,13,8,342.7928522624313,0.854685746352413,0.3630789278410216,0.1954425081627917,130288.52390276968,-2067.5647010391995,128220.95920173048,3226,2,716.3272727272728,40,15,20,36.0170299953547,0.6161458333333333,44.76626016260163,1020.9349593495948,25.52337398373987,0
3419,4,1,2,54,0.017857142857142856,0.03571428571428571,0.9642857142857143,56,1250,800,450,0.64,17,8,9,333.99602250813996,0.8585633116883117,0.3554060237956569,0.19179637814263428,130566.58340419504,-2478.2560941043057,128088.32731009074,3227,0,704.5178571428571,41,15,18,35.96025043680839,0.6173780487804879,44.49404761904762,1022.0238095238097,24.927409988385605,0
3420,4,0,0,54,0.0,0.0,1.0,54,1450,1100,350,0.7586206896551724,18,11,7,346.3601704664543,0.8516917074307012,0.3568009250053392,0.19906803397437725,130599.9704623572,-1753.0743935487988,128846.8960688084,3228,4,726.1481481481482,40,14,18,35.61054218863922,0.6192708333333332,44.461382113821145,1022.1544715447166,25.553861788617915,0
3421,4,0,0,54,0.0,0.0,1.0,54,1600,1200,400,0.75,20,12,8,344.251665664023,0.8516480316794782,0.3513881067791431,0.198521748514445,130729.84959556167,-1799.2063049441317,128930.64329061753,3229,5,727.1481481481482,40,14,19,35.533016992944454,0.6205729166666666,44.33434959349594,1022.6626016260176,25.56656504065044,0
3422,4,1,1,54,0.01818181818181818,0.01818181818181818,0.9818181818181818,55,1650,1100,550,0.6666666666666666,22,11,11,342.6888884312155,0.8564814814814815,0.3560509217685277,0.19992121253902448,131175.63952664402,-2009.513180272102,129166.12634637192,3230,0,714.9090909090909,41,14,20,35.12250629478986,0.6234756097560975,43.898809523809526,1024.4047619047622,24.985481997677127,0
3423,4,0,1,53,0.0,0.018518518518518517,0.9814814814814815,54,1300,700,600,0.5384615384615384,19,7,12,347.46073535686776,0.8524050780340089,0.357003744492582,0.2025481059376443,131145.89659139735,-1686.3900662634628,129459.50652513388,3231,1,729.0370370370371,40,14,21,35.030343618745235,0.6247395833333333,43.927845528455286,1024.2886178861793,25.60721544715448,0
3424,4,1,1,53,0.018518518518518517,0.018518518518518517,0.9814814814814815,54,1750,1200,550,0.6857142857142857,23,12,11,342.8432733782983,0.8549091544374563,0.3480522167673008,0.20150997172593096,131461.62245008664,-1785.7268909901068,129675.89555909653,3232,0,724.5370370370371,39,15,21,34.82996868122566,0.6295405982905984,43.61979166666666,1025.520833333332,26.295405982905947,0
3425,4,0,0,53,0.0,0.0,1.0,53,1150,800,350,0.6956521739130435,15,8,7,347.97177370521075,0.8535619254958877,0.3490605362297188,0.20410373719286032,131382.88498064107,-1456.4928957557545,129926.39208488532,3233,3,739.2075471698113,38,15,21,34.777945671807686,0.630482456140351,43.69658119658118,1025.2136752136726,26.97930724246507,0
3426,4,0,0,53,0.0,0.0,1.0,53,1100,700,400,0.6363636363636364,15,7,8,348.2318870609332,0.8530781325592646,0.3508278061074046,0.20454893831155654,131437.6563755569,-1445.8433778946808,129991.81299766221,3234,4,740.2075471698113,38,15,21,34.71599986108216,0.631030701754386,43.643162393162385,1025.4273504273492,26.984930274403926,0
3427,4,0,0,53,0.0,0.0,1.0,53,1750,1600,150,0.9142857142857143,19,16,3,350.2969530795786,0.8535014513788098,0.347616259191285,0.20635284315767535,131547.2334082108,-1383.8809902111398,130163.35241799966,3235,5,741.2075471698113,38,15,22,34.55248038603068,0.6321271929824562,43.536324786324776,1025.8547008546993,26.99617633828156,0
3428,4,0,0,53,0.0,0.0,1.0,53,1350,1100,250,0.8148148148148148,16,11,5,346.1584392944792,0.8532595549104983,0.3432147083264725,0.20474461349386505,131702.08875868036,-1482.0421006944641,130220.04665798589,3236,6,742.2075471698113,39,14,19,34.502486299979715,0.6319444444444446,43.38541666666666,1026.4583333333317,26.3194444444444,0
3429,4,0,0,53,0.0,0.0,1.0,53,1900,1400,500,0.7368421052631579,24,14,10,341.2892050574167,0.8526245766811804,0.33602510620383486,0.2027175639678388,131862.5217013887,-1599.3489583333549,130263.17274305534,3237,7,743.2075471698113,39,14,19,34.4658553076403,0.6335470085470087,43.22916666666666,1027.0833333333317,26.335470085470043,0
3430,4,0,0,53,0.0,0.0,1.0,53,1950,1200,750,0.6153846153846154,27,12,15,340.56329721733863,0.852322206095791,0.3344999085892526,0.20333277379316156,132058.30379569015,-1605.157726882177,130453.14606880798,3238,8,744.2075471698113,40,13,20,34.28745633115813,0.6338541666666668,43.03861788617885,1027.8455284552824,25.69613821138206,0
3431,4,0,1,52,0.0,0.018867924528301886,0.9811320754716981,53,1400,1000,400,0.7142857142857143,18,10,8,340.6096242855324,0.8521710208030963,0.33366533121451614,0.20364107324305195,132110.5368828076,-1600.3759336374087,130510.16094917018,3239,9,745.2075471698113,40,13,20,34.23372215632002,0.6343750000000001,42.98780487804877,1028.0487804878028,25.70121951219507,0
3432,4,0,0,52,0.0,0.0,1.0,52,1150,900,250,0.782608695652174,14,9,5,341.43831697590656,0.8508358471593764,0.3254977308490503,0.20455975899817613,132188.9058781973,-1373.128490812373,130815.77738738494,3240,10,711.6153846153846,40,12,21,34.133601805184966,0.6351562500000001,42.91158536585365,1028.3536585365837,25.708841463414593,0
3433,4,1,0,53,0.018867924528301886,0.0,1.0,53,1650,1100,550,0.6666666666666666,22,11,11,337.2496404657608,0.8525943396226415,0.3328656912989949,0.20389680097884078,132532.04345703125,-1660.392707674932,130871.65074935631,3241,0,699.1698113207547,39,14,22,33.896581520822814,0.640224358974359,42.578125,1029.6875,26.40224358974359,0
3434,4,0,0,53,0.0,0.0,1.0,53,1500,1200,300,0.8,18,12,6,340.7039997386714,0.8521407837445573,0.3382384169504593,0.19984080571468749,131382.8849806412,-1640.8190676307356,129742.06591301045,3242,1,700.1698113207547,38,15,19,34.96422120327915,0.630482456140351,43.696581196581185,1025.2136752136735,26.97930724246509,2
3435,4,0,0,53,0.0,0.0,1.0,53,1350,1000,350,0.7407407407407407,17,10,7,340.19338160852027,0.851747701983551,0.3380361033242576,0.20023217147035832,131515.04041883655,-1651.8907335069694,129863.14968532958,3243,2,701.1698113207547,39,14,19,34.84405148776277,0.6300747863247864,43.56770833333332,1025.7291666666647,26.300747863247814,0
3436,4,0,0,53,0.0,0.0,1.0,53,1200,1000,200,0.8333333333333334,14,10,4,339.3338665902835,0.8507498790517658,0.33636401005990435,0.20038557806015664,131640.8109012491,-1665.9629271597728,129974.84797408932,3244,3,702.1698113207547,40,13,17,34.739346075130385,0.6296875000000002,43.445121951219505,1026.2195121951206,25.655487804878014,0
3437,4,0,0,53,0.0,0.0,1.0,53,1100,900,200,0.8181818181818182,13,9,4,338.56611945952056,0.8498730043541364,0.33893911578664304,0.20061780087387282,131771.2064268125,-1677.3467967149418,130093.85963009756,3245,4,703.1698113207547,40,13,17,34.62770959121052,0.6309895833333334,43.3180894308943,1026.727642276421,25.668191056910523,0
3438,4,0,0,53,0.0,0.0,1.0,53,1150,700,450,0.6086956521739131,16,7,9,345.7316731453455,0.8485425737784228,0.3475662449115957,0.20570932806511422,131927.7662622279,-1477.678527166402,130450.0877350615,3246,5,704.1698113207547,40,13,19,34.28607346588846,0.6325520833333336,43.16565040650405,1027.3373983739814,25.683434959349533,0
3439,4,0,0,53,0.0,0.0,1.0,53,1150,800,350,0.6956521739130435,15,8,7,343.8471814501719,0.8483611514271892,0.346964317269699,0.2047858112869132,131964.43457301857,-1524.8802240804218,130439.55434893815,3247,6,705.1698113207547,41,12,19,34.2975564030768,0.6313516260162604,43.129960317460295,1027.4801587301552,25.060491676345247,0
3440,4,0,0,53,0.0,0.0,1.0,53,2100,1500,600,0.7142857142857143,27,15,12,347.74577417740227,0.8479983067247218,0.3559730224176072,0.20822558921714415,132168.37841907557,-1407.8009849773634,130760.5774340982,3248,7,706.1698113207547,41,12,19,33.99210082006751,0.6333841463414636,42.9315476190476,1028.2738095238064,25.079849012775767,0
3441,4,0,0,53,0.0,0.0,1.0,53,1450,1000,450,0.6896551724137931,19,10,9,349.31868355624175,0.8477564102564102,0.35709294199860264,0.20959121013374465,132244.8979591835,-1360.8772675737175,130884.02069160978,3249,8,707.1698113207547,41,12,19,33.8746624228395,0.6341463414634148,42.85714285714285,1028.571428571427,25.087108013937247,0
3442,4,0,1,52,0.0,0.018867924528301886,0.9811320754716981,53,1300,1100,200,0.8461538461538461,15,11,4,345.9363783115822,0.8470307208514756,0.3551117462729467,0.20856164310923725,132426.2167806441,-1437.4365262898732,130988.78025435423,3250,9,708.1698113207547,37,16,19,33.7793180284791,0.6427364864864864,42.68092105263158,1029.2763157894742,27.818278805120926,0
3443,4,0,0,52,0.0,0.0,1.0,52,1950,1400,550,0.717948717948718,25,14,11,350.9318297300397,0.8439071141277023,0.35697601993148553,0.2114150291300484,132398.0034722223,-1107.4652777777733,131290.53819444453,3251,10,721.8461538461538,37,15,19,33.67914979757085,0.642454954954955,42.708333333333336,1029.1666666666672,27.81531531531533,0
3444,4,0,0,52,0.0,0.0,1.0,52,1050,800,250,0.7619047619047619,13,8,5,352.75531361957763,0.8428701608848667,0.36151730908916724,0.21313498165215525,132507.9800044747,-1051.4211912849407,131456.55881318977,3252,11,722.8461538461538,38,14,19,33.5216267164747,0.64172149122807,42.60149572649574,1029.5940170940194,27.094579397211035,0
3445,4,0,0,52,0.0,0.0,1.0,52,1550,1000,550,0.6451612903225806,21,10,11,354.24511968276454,0.8398378582202111,0.36202227203471615,0.21497707294530544,132673.0304099096,-1000.2452927532871,131672.7851171563,3253,12,723.8461538461538,38,14,18,33.31734591586298,0.6433662280701753,42.441239316239326,1030.2350427350443,27.11144849302748,0
3446,4,0,0,52,0.0,0.0,1.0,52,1300,900,400,0.6923076923076923,17,9,8,356.8168247461904,0.8386280794369029,0.3660454665609305,0.2171184295226823,132773.48632812526,-924.8372395833038,131848.64908854195,3254,13,724.8461538461538,39,13,18,33.150141499898936,0.6426282051282051,42.343750000000014,1030.625000000002,26.426282051282104,0
3447,4,0,1,51,0.0,0.019230769230769232,0.9807692307692307,52,1550,900,650,0.5806451612903226,22,9,13,354.5341325209908,0.8375282805429863,0.36787468542494084,0.21673568535078439,132947.670863904,-973.102567915899,131974.5682959881,3255,14,725.8461538461538,40,12,18,33.03401327026671,0.6427083333333332,42.17479674796749,1031.300813008132,25.7825203252033,0
3448,4,0,0,51,0.0,0.0,1.0,51,1300,1000,300,0.7692307692307693,16,10,6,354.71200818625886,0.8377777777777778,0.36707890443227975,0.21791291247014302,133131.14636005374,-755.356744497303,132375.78961555642,3256,15,737.7843137254902,40,11,19,32.84527326440178,0.64453125,41.996951219512205,1032.0121951219528,25.80030487804882,0
3449,4,0,0,51,0.0,0.0,1.0,51,1250,800,450,0.64,17,8,9,352.5937364374727,0.837124183006536,0.3618805002315886,0.2173757501337819,133262.27774472875,-802.5111127635561,132459.7666319652,3257,16,738.7843137254902,40,11,19,32.76841371391077,0.6458333333333333,41.869918699187,1032.5203252032527,25.813008130081318,0
3450,4,1,1,51,0.019230769230769232,0.019230769230769232,0.9807692307692307,52,1250,1000,250,0.8,15,10,5,346.6895640623062,0.8412204625439919,0.35544267785021555,0.21541643983658523,133552.96359592024,-1139.385763230479,132413.57783268977,3258,0,725.5576923076923,39,13,19,32.62968608283786,0.6503739316239316,41.58854166666667,1033.6458333333342,26.503739316239336,0
3451,4,0,1,50,0.0,0.0196078431372549,0.9803921568627451,51,1700,1100,600,0.6470588235294118,23,11,12,344.5913069643432,0.8362418300653596,0.32644767284553944,0.21206997071583764,133197.0089406436,-1020.293721080462,132176.71521956314,3259,18,740.7843137254902,42,9,18,33.040379861697794,0.6421130952380952,41.93313953488372,1032.2674418604652,24.57779623477298,1
3452,4,0,0,50,0.0,0.0,1.0,50,1300,900,400,0.6923076923076923,17,9,8,342.4883636585446,0.8344897959183674,0.3152003754106052,0.21105919692202385,133247.02659282793,-872.8887799711599,132374.13781285676,3260,19,745.64,42,8,18,33.04454090411386,0.642609126984127,41.88468992248062,1032.4612403100773,24.58241048357327,0
3453,4,0,0,50,0.0,0.0,1.0,50,1100,1000,100,0.9090909090909091,12,10,2,349.57075962538994,0.8336904761904762,0.324838709677419,0.21673387096774194,133472.2222222223,-668.4027777777688,132803.81944444453,3261,20,746.64,42,8,19,32.636088709677416,0.6448412698412698,41.66666666666667,1033.3333333333342,24.603174603174622,0
3454,4,0,0,50,0.0,0.0,1.0,50,1550,1300,250,0.8387096774193549,18,13,5,353.42269776225356,0.8341156462585034,0.2693774135819911,0.21235363792540163,132298.2967989454,-644.2155294152942,131654.0812695301,3262,21,747.64,42,8,16,33.71538570217576,0.6331845238095237,42.80523255813954,1028.7790697674423,24.49473975636767,5
3455,4,0,0,50,0.0,0.0,1.0,50,1650,1100,550,0.6666666666666666,22,11,11,352.18888496009913,0.8341496598639455,0.26712402698495086,0.21248214818976544,132452.98603121119,-670.1558766501428,131782.83015456103,3263,22,748.64,38,12,17,33.59150665974744,0.6411732456140351,42.65491452991453,1029.3803418803418,27.088956365272153,0
3456,4,0,1,49,0.0,0.02,0.98,50,1550,1200,350,0.7741935483870968,19,12,7,349.010164612319,0.8332993197278912,0.2668979467988266,0.21130823622302494,132585.67843967013,-745.2501085069467,131840.4283311632,3264,23,749.64,39,11,17,33.53993880853644,0.6407585470085471,42.526041666666664,1029.8958333333333,26.40758547008547,0
3457,4,0,0,49,0.0,0.0,1.0,49,1350,800,550,0.5925925925925926,19,8,11,350.92069695769715,0.8321641156462585,0.25856126683038383,0.21249218082111804,132590.49236613332,-494.25040178246354,132096.24196435086,3265,24,750.2244897959183,38,11,17,33.485909405255875,0.6425438596491229,42.521367521367516,1029.914529914529,27.103013945119187,0
3458,4,0,0,49,0.0,0.0,1.0,49,1000,800,200,0.8,12,8,4,350.7529519375367,0.8315263605442177,0.25763965108890274,0.21312335384312744,132719.81336805562,-489.62673611110444,132230.18663194453,3266,25,751.2244897959183,39,10,12,33.36029114435908,0.642094017094017,42.395833333333336,1030.4166666666672,26.420940170940185,0
3459,4,0,0,49,0.0,0.0,1.0,49,1450,1000,450,0.6896551724137931,19,10,9,348.6891030968476,0.8315263605442177,0.25115835967609224,0.21262945491987062,132854.01611328125,-535.0504557291663,132318.9656575521,3267,26,752.2244897959183,39,10,15,33.27870819440234,0.6434294871794872,42.265625,1030.9375,26.434294871794872,0
3460,4,0,0,49,0.0,0.0,1.0,49,1100,800,300,0.7272727272727273,14,8,6,347.35231098867473,0.8320578231292517,0.25050505050505034,0.21227085671530116,132934.5703125,-564.973958333333,132369.59635416666,3268,27,753.2244897959183,39,10,15,33.23232323232323,0.6442307692307693,42.1875,1031.25,26.442307692307693,0
3461,4,0,0,49,0.0,0.0,1.0,49,1200,800,400,0.6666666666666666,16,8,8,332.33034214974805,0.8323412698412699,0.19724450573269903,0.20106595853686746,132558.85959201408,-987.1636284722022,131571.6959635419,3269,28,754.2244897959183,39,10,17,33.996307910176,0.6404914529914529,42.55208333333334,1029.7916666666683,26.404914529914574,3
3462,4,0,0,49,0.0,0.0,1.0,49,1250,900,350,0.72,16,9,7,327.8019156789964,0.8312074829931974,0.18981342660326206,0.19941447071989807,132764.32188388187,-1095.9201905281266,131668.40169335375,3270,29,755.2244897959183,40,9,13,33.906912533280746,0.6408854166666667,42.35264227642276,1030.5894308943084,25.76473577235771,0
3463,4,0,1,48,0.0,0.02040816326530612,0.9795918367346939,49,1300,900,400,0.6923076923076923,17,9,8,328.2761145566833,0.8309594671201814,0.220678516234734,0.18739835835310545,130336.78583768995,-1240.8270221306034,129095.95881555935,3271,30,756.2244897959183,42,7,18,36.33872651356992,0.6135912698412699,44.71899224806201,1021.1240310077512,24.31247692875598,4
3464,4,0,0,48,0.0,0.0,1.0,48,1250,1000,250,0.8,15,10,5,332.7140279671026,0.8315048758865248,0.22282054395337547,0.19018827972911273,130389.20899667732,-923.5362142542281,129465.67278242309,3272,31,752.7083333333334,41,7,18,36.17239355674276,0.615599593495935,44.66765873015873,1021.3293650793647,24.910472319008896,0
3465,4,1,0,49,0.02040816326530612,0.0,1.0,49,1850,1600,250,0.8648648648648649,21,16,5,337.9536082394753,0.8336522108843538,0.24800884186282013,0.195909221197878,130931.13864100707,-950.2698530737391,129980.86878793333,3273,0,738.3265306122449,42,7,14,35.490634665151795,0.6195436507936508,44.1375968992248,1023.4496124031001,24.367847914359526,0
3466,4,0,0,49,0.0,0.0,1.0,49,1200,900,300,0.75,15,9,6,337.18398389915546,0.8332624716553289,0.2440326499708343,0.19596732529584593,131030.32889399685,-963.7343383810976,130066.59455561575,3274,1,739.3265306122449,42,7,14,35.41015994699981,0.6205357142857142,44.04069767441861,1023.8372093023263,24.37707641196015,0
3467,4,1,1,49,0.02,0.02,0.98,50,1200,900,300,0.75,15,9,6,334.8755715609665,0.8385374149659863,0.24972188857063604,0.1960172153058055,131303.86002245478,-1205.9089653638518,130097.95105709093,3275,0,725.52,43,7,15,35.19328051372079,0.6218507751937984,43.77367424242425,1024.9053030303041,23.835007047216376,0
3468,4,0,1,48,0.0,0.02040816326530612,0.9795918367346939,49,950,500,450,0.5263157894736842,14,5,9,344.86164661034616,0.8337939342403629,0.2536834669559138,0.20146779288717132,131228.8220734932,-748.8424673997972,130479.97960609342,3276,3,741.3265306122449,42,7,15,35.013161213038266,0.6225198412698414,43.8468992248062,1024.6124031007753,24.395533407161317,0
3469,4,0,0,48,0.0,0.0,1.0,48,1350,1000,350,0.7407407407407407,17,10,7,348.42965142489084,0.8324837470449172,0.2488495918839433,0.2042190525231185,131354.1679576474,-446.4250512230067,130907.7429064244,3277,4,752.9166666666666,40,8,17,34.795198440236604,0.6268229166666668,43.724593495934954,1025.1016260162592,25.62754065040648,0
3470,4,0,0,48,0.0,0.0,1.0,48,1050,500,550,0.47619047619047616,16,5,11,345.7607615919137,0.8319481382978723,0.25436496420971166,0.20332620894978384,131480.69905045338,-507.8266723356197,130972.87237811775,3278,5,753.9166666666666,41,7,17,34.73592571096923,0.6265243902439025,43.60119047619047,1025.595238095237,25.014518002322852,0
3471,4,0,0,48,0.0,0.0,1.0,48,950,600,350,0.631578947368421,13,6,7,342.7857208063609,0.8320774231678487,0.25625684909430824,0.2021145909110252,131582.4642935877,-579.082026329068,131003.38226725862,3279,6,754.9166666666666,41,7,11,34.70959840134081,0.6275406504065042,43.50198412698412,1025.9920634920625,25.02419667053811,0
3472,4,0,0,48,0.0,0.0,1.0,48,2000,1500,500,0.75,25,15,10,344.96018281662884,0.8334072104018913,0.25983874605322543,0.20394046008119063,131684.26890432072,-514.8341049383,131169.43479938243,3280,7,755.9166666666666,41,7,11,34.55119530897607,0.6285569105691058,43.402777777777764,1026.3888888888869,25.033875338753337,0
3473,4,0,0,48,0.0,0.0,1.0,48,950,500,450,0.5263157894736842,14,5,9,345.31840804008186,0.8340351654846335,0.26124118101865346,0.20428871172045296,131709.7262081914,-503.6414044784756,131206.08480371293,3281,8,756.9166666666666,41,7,12,34.51634531748334,0.6288109756097562,43.37797619047618,1026.4880952380936,25.036295005807162,0
3474,4,0,0,48,0.0,0.0,1.0,48,1550,1300,250,0.8387096774193549,18,13,5,343.0506196177279,0.8336103723404256,0.25496376811594246,0.20335474874246723,131786.1128826528,-558.1384637188457,131227.97441893394,3282,9,757.9166666666666,41,7,12,34.497584541062785,0.6295731707317074,43.303571428571416,1026.7857142857122,25.04355400696859,0
3475,4,0,0,48,0.0,0.0,1.0,48,1550,1300,250,0.8387096774193549,18,13,5,343.28391824652687,0.8333887411347517,0.25909987123772793,0.2041760467227329,131913.47321625383,-543.2452089632416,131370.2280072906,3283,10,758.9166666666666,41,7,12,34.36333091904071,0.6308434959349594,43.17956349206348,1027.281746031744,25.055652342237657,0
3476,4,0,0,48,0.0,0.0,1.0,48,1450,1100,350,0.7586206896551724,18,11,7,346.0029900636911,0.834127511820331,0.26146363693506913,0.2063952594271934,132024.2971050414,-463.8396881197385,131560.45741692165,3284,11,759.9166666666666,42,6,12,34.18190961091206,0.6304563492063493,43.07170542635657,1027.7131782945708,24.46936138796597,0
3477,4,0,0,48,0.0,0.0,1.0,48,1450,1100,350,0.7586206896551724,18,11,7,345.6933591099926,0.8335364952718676,0.25491581857017276,0.20702584237444888,132173.71627306024,-461.6848071029631,131712.0314659573,3285,12,760.9166666666666,42,6,13,34.03949145621309,0.6319444444444446,42.926356589147275,1028.2945736434087,24.483204134366876,0
3478,4,2,2,48,0.04,0.04,0.96,50,1300,800,500,0.6153846153846154,18,8,10,333.0531527344918,0.8413265306122448,0.24509076558800302,0.20190351412181895,132633.43578557746,-1164.4426644799116,131468.99312109753,3286,0,731.44,40,10,13,33.902879176532494,0.6395833333333333,42.47967479674797,1030.081300813009,25.752032520325223,0
3479,4,0,0,48,0.0,0.0,1.0,48,1600,1300,300,0.8125,19,13,6,342.79380314507404,0.8306737588652482,0.2438819739593876,0.20680637134796215,132451.61132812497,-519.2816840277773,131932.3296440972,3287,14,762.9166666666666,39,9,14,33.83466572218849,0.6394230769230769,42.65625,1029.3749999999998,26.394230769230763,0
3480,4,0,1,47,0.0,0.020833333333333332,0.9791666666666666,48,950,600,350,0.631578947368421,13,6,7,343.14519490435487,0.8308030437352245,0.24543875623903988,0.20731339281385341,132505.23003472213,-506.2934027777833,131998.93663194435,3288,15,763.9166666666666,39,9,15,33.77175232699313,0.639957264957265,42.604166666666664,1029.5833333333328,26.399572649572637,0
3481,4,0,0,47,0.0,0.0,1.0,47,1050,700,350,0.6666666666666666,14,7,7,352.80155766479874,0.829941412272587,0.24080666126715045,0.21378754352271045,132618.00219382346,-42.432450325080026,132575.56974349837,3289,16,735.3191489361702,38,9,15,33.409829547419015,0.6428179824561404,42.49465811965812,1030.0213675213672,27.10582546108861,0
3482,4,0,0,47,0.0,0.0,1.0,47,900,700,200,0.7777777777777778,11,7,4,349.5055972602634,0.8289392537773665,0.24237378919585217,0.21221361955194995,132692.98095703122,-124.61208767361109,132568.3688693576,3290,17,736.3191489361702,39,8,14,33.41937535806964,0.6418269230769231,42.421875,1030.3124999999998,26.418269230769226,0
3483,4,0,0,47,0.0,0.0,1.0,47,700,500,200,0.7142857142857143,9,5,4,349.3757408250902,0.8286308973172988,0.24737456744614228,0.2124384882595338,132746.64849175335,-124.30826822917243,132622.34022352417,3291,18,737.3191489361702,39,8,15,33.36881717712862,0.6423611111111112,42.369791666666664,1030.5208333333326,26.423611111111093,0
3484,4,0,0,47,0.0,0.0,1.0,47,1250,1000,250,0.8,15,10,5,345.4731364969246,0.8269349367869256,0.2364937545737238,0.21104851992981913,132921.47040658677,-215.84054217066046,132705.6298644161,3292,19,738.3191489361702,40,7,15,33.29391281495352,0.6424479166666668,42.20020325203252,1031.1991869918704,25.77997967479676,0
3485,4,0,0,47,0.0,0.0,1.0,47,1150,500,650,0.43478260869565216,18,5,13,345.43948815072423,0.8258171446191798,0.24041980139660923,0.2112464069891134,132960.1481796422,-214.0628936759913,132746.0852859662,3293,20,739.3191489361702,41,6,15,33.255979864050275,0.641260162601626,42.16269841269841,1031.349206349206,25.15485869144405,0
3486,4,0,0,47,0.0,0.0,1.0,47,1800,1500,300,0.8333333333333334,21,15,6,347.9944715052469,0.825431699044095,0.2426620085335469,0.21368586142842824,133113.66705246898,-135.43595679014368,132978.23109567884,3294,21,740.3191489361702,41,6,15,33.03611484970837,0.6427845528455285,42.01388888888888,1031.9444444444432,25.169376693766907,0
3487,4,0,0,47,0.0,0.0,1.0,47,1300,1000,300,0.7692307692307693,16,10,6,345.74568045484426,0.8241982732038236,0.2507623031840016,0.21306652546248472,133247.02659282778,-186.08322441562018,133060.94336841215,3295,22,741.3191489361702,42,5,16,32.96046457062411,0.6426091269841271,41.88468992248061,1032.4612403100762,24.58241048357324,0
3488,4,0,0,47,0.0,0.0,1.0,47,1000,500,500,0.5,15,5,10,345.02942460200086,0.8253546099290779,0.24773390981150722,0.2131981818453752,133347.09006557582,-198.2660484646525,133148.82401711115,3296,23,742.3191489361702,42,5,16,32.87870969759514,0.6436011904761905,41.78779069767441,1032.8488372093009,24.59163898117383,0
3489,4,0,0,47,0.0,0.0,1.0,47,800,500,300,0.625,11,5,6,346.7400810549847,0.8250462534690102,0.24939578938545148,0.21454416738985438,133397.1358861396,-149.1732580674344,133247.96262807216,3297,24,743.3191489361702,42,5,16,32.78440890473063,0.6440972222222223,41.73934108527131,1033.0426356589142,24.596253229974145,0
3490,4,0,0,47,0.0,0.0,1.0,47,1800,1400,400,0.7777777777777778,22,14,8,348.28393013802815,0.825431699044095,0.24032307158076116,0.21687994294542487,133633.7293836808,-91.44052739653955,133542.28885628426,3298,25,744.3191489361702,39,8,17,32.50763986835919,0.6511752136752136,41.51041666666668,1033.9583333333353,26.511752136752186,0
3491,4,0,0,47,0.0,0.0,1.0,47,900,600,300,0.6666666666666666,12,6,6,346.6964298584986,0.824313906876349,0.24012008722212563,0.21632921929306823,133708.60727947994,-128.74064297043935,133579.8666365095,3299,26,745.3191489361702,40,7,14,32.47375618224101,0.6502604166666666,41.43800813008131,1034.247967479676,25.856199186991898,0
3492,4,0,0,47,0.0,0.0,1.0,47,950,500,450,0.5263157894736842,14,5,9,344.96138904150445,0.8226564909034844,0.24039648893337007,0.21616872766828588,133866.3135059325,-164.25810942558508,133702.05539650694,3300,27,746.3191489361702,40,7,14,32.36092016105274,0.6518229166666666,41.28556910569107,1034.8577235772375,25.871443089430937,0
3493,4,1,0,48,0.020833333333333332,0.0,1.0,48,800,500,300,0.625,11,5,6,338.3405998150347,0.8249852245862884,0.24528256704980822,0.21330168249208728,134088.01020408177,-526.516439909286,133561.49376417248,3301,0,731.75,41,7,15,32.310823754789276,0.6524390243902438,41.07142857142858,1035.7142857142867,25.26132404181187,0
3494,4,1,2,47,0.02040816326530612,0.04081632653061224,0.9591836734693877,49,850,500,350,0.5882352941176471,12,5,7,332.44102435654224,0.8301445578231292,0.2439514936409346,0.2105066166662654,134249.35142306663,-874.0016187428536,133375.34980432378,3302,0,717.795918367347,42,7,15,32.30267258843696,0.6525297619047619,40.91569767441861,1036.3372093023263,24.674695459579198,0
3495,4,0,0,47,0.0,0.0,1.0,47,1050,800,250,0.7619047619047619,13,8,5,344.0354386742602,0.8238128276287388,0.23811581766974155,0.21682530337225667,134076.7330643964,-174.57046483572483,133902.16259956066,3303,2,715.3617021276596,40,7,15,32.17463121054525,0.6539062499999999,41.08231707317074,1035.6707317073187,25.89176829268297,0
3496,4,1,1,47,0.020833333333333332,0.020833333333333332,0.9791666666666666,48,1400,1100,300,0.7857142857142857,17,11,6,336.7756318183372,0.8278110224586288,0.23637000487329463,0.21329123348494702,134256.1983471075,-557.1567952249685,133699.04155188255,3304,0,701.4375,43,5,15,32.18354044834309,0.6511627906976745,40.909090909090914,1036.363636363637,24.101479915433416,0
3497,4,1,1,47,0.020833333333333332,0.020833333333333332,0.9791666666666666,48,1050,500,550,0.47619047619047616,16,5,11,337.36133487753716,0.8247081855791962,0.23494503319325188,0.21394885119174523,134305.2730787993,-538.1187586088195,133767.1543201905,3305,0,702.4166666666666,43,5,15,32.11941957488276,0.6516472868217055,40.86174242424242,1036.55303030303,24.105884425651862,0
3498,4,0,0,47,0.0,0.0,1.0,47,1700,1100,600,0.6470588235294118,23,11,12,342.2316896444231,0.822463768115942,0.24387537141561544,0.2171527055644153,134324.6771903733,-205.9677528393578,134118.70943753395,3306,5,718.3617021276596,42,5,17,31.973850252383624,0.6532738095238095,40.84302325581396,1036.6279069767452,24.681616832779646,0
3499,4,0,0,47,0.0,0.0,1.0,47,1450,900,550,0.6206896551724138,20,9,11,287.2912449981252,0.8217314215232808,0.08354362758582212,0.17933021924619816,133722.6625878854,-1633.090521903724,132089.57206598166,3307,6,719.3617021276596,42,5,15,33.99576853413281,0.6473214285714286,41.424418604651166,1034.3023255813957,24.62624584717609,8
3500,4,0,0,47,0.0,0.0,1.0,47,1400,900,500,0.6428571428571429,19,9,10,288.22518968677156,0.8207292630280604,0.08191001137860443,0.1802800439534658,133797.8404712008,-1687.2184101015446,132110.62206109925,3308,7,720.3617021276596,42,5,16,33.89684992663357,0.648065476190476,41.35174418604652,1034.593023255815,24.63316722037655,0
3501,4,0,0,47,0.0,0.0,1.0,47,1250,800,450,0.64,17,8,9,287.14335311198073,0.8199583718778908,0.07650808829388844,0.17997012976736843,133873.0394808006,-1711.8493104380573,132161.19017036253,3309,8,721.3617021276596,42,5,16,33.8500702247191,0.6488095238095237,41.27906976744187,1034.8837209302337,24.640088593576994,0
3502,4,0,0,47,0.0,0.0,1.0,47,1250,1100,150,0.88,14,11,3,287.61342163080093,0.8192260252852297,0.08155729624119434,0.18063340289722815,133948.25961668495,-1694.936546030866,132253.3230706541,3310,9,722.3617021276596,42,5,16,33.763143935848234,0.6495535714285714,41.20639534883722,1035.174418604653,24.647009966777453,0
3503,4,0,0,47,0.0,0.0,1.0,47,1300,1000,300,0.7692307692307693,16,10,6,290.6043156128199,0.8185707678075855,0.08728859792689625,0.1828856134651705,134023.5008788535,-1610.4384502133166,132413.06242864017,3311,10,723.3617021276596,42,5,16,33.610955143801874,0.650297619047619,41.13372093023256,1035.4651162790703,24.653931339977866,0
3504,4,0,0,47,0.0,0.0,1.0,47,1250,900,350,0.72,16,9,7,293.1332487698618,0.8175686093123651,0.07923203667884526,0.1852352657120192,134174.0467820444,-1533.8251532359764,132640.22162880842,3312,11,724.3617021276596,42,5,17,33.39588009726899,0.6517857142857142,40.98837209302326,1036.0465116279074,24.66777408637875,0
3505,4,0,0,47,0.0,0.0,1.0,47,1000,600,400,0.6,14,6,8,292.727711590275,0.8164893617021276,0.07734701105014175,0.18523255312108888,134224.24752869428,-1541.7686361997335,132682.47889249455,3313,12,725.3617021276596,42,5,18,33.356516114955454,0.6522817460317459,40.93992248062016,1036.2403100775202,24.672388335179054,0
3506,4,0,0,47,0.0,0.0,1.0,47,900,500,400,0.5555555555555556,13,5,8,295.2957379115691,0.8153330249768732,0.07674210952306137,0.18749964984663986,134349.79047420542,-1465.415896730953,132884.37457747446,3314,13,726.3617021276596,42,5,18,33.1652880331495,0.6535218253968254,40.81879844961241,1036.7248062015515,24.683923957179797,0
3507,4,0,0,47,0.0,0.0,1.0,47,1600,1300,300,0.8125,19,13,6,297.7213892536451,0.814831945729263,0.06434252417614306,0.18995263369186668,134525.64918724826,-1389.7673667447978,133135.88182050345,3315,14,727.3617021276596,42,5,18,32.927797496730804,0.6552579365079365,40.649224806201545,1037.403100775193,24.700073827980788,0
3508,4,0,0,47,0.0,0.0,1.0,47,650,500,150,0.7692307692307693,8,5,3,296.6081192238836,0.8146006783842121,0.06579509527471616,0.189372876119864,134550.78124999985,-1418.2221245718538,133132.559125428,3316,15,728.3617021276596,39,8,18,32.93172690763054,0.6602564102564104,40.62499999999999,1037.4999999999989,26.602564102564074,0
3509,4,0,0,47,0.0,0.0,1.0,47,1550,1100,450,0.7096774193548387,20,11,9,327.9097635932289,0.8149861239592969,0.02536617368728855,0.19463349544043615,131835.7760959202,-675.8273654513839,131159.94873046884,3317,16,729.3617021276596,39,8,16,34.83629593941238,0.6332799145299146,43.255208333333336,1026.9791666666672,26.33279914529916,7
3510,4,0,0,47,0.0,0.0,1.0,47,900,600,300,0.6666666666666666,12,6,6,326.2211789784812,0.814677767499229,0.0304888309738216,0.19404060718249605,131916.0210503473,-793.240017361106,131122.7810329862,3318,17,730.3617021276596,39,8,16,34.79897586696409,0.6340811965811965,43.177083333333336,1027.2916666666672,26.34081196581198,0
3511,4,0,0,47,0.0,0.0,1.0,47,1300,1000,300,0.7692307692307693,16,10,6,328.75757560077295,0.8147163120567376,0.028142932597108317,0.19587907170886382,131979.97352972772,-722.1167749025004,131257.85675482522,3319,18,731.3617021276596,40,7,16,34.669543071901884,0.6330729166666667,43.114837398373986,1027.5406504065045,25.68851626016261,0
3512,4,0,0,47,0.0,0.0,1.0,47,1600,1200,400,0.75,20,12,8,332.74606467488877,0.8143694110391612,0.02883376183988462,0.19260840266950122,130874.74093967021,-689.0670329566719,130185.67390671353,3320,19,732.3617021276596,39,8,16,35.68082137161084,0.62366452991453,44.192708333333336,1023.2291666666673,26.236645299145316,2
3513,4,1,1,47,0.020833333333333332,0.020833333333333332,0.9791666666666666,48,900,600,300,0.6666666666666666,12,6,6,326.3949695874585,0.8200908687943262,0.031221748676223626,0.19016375090411522,131124.83071932473,-1040.3029730410733,130084.52774628365,3321,0,718.0833333333334,41,7,17,35.59101769340049,0.6229674796747968,43.948412698412696,1024.206349206349,24.980642663569487,0
3514,4,0,0,47,0.0,0.0,1.0,47,1000,800,200,0.8,12,8,4,331.72718620737277,0.8126734505087881,0.027847930198576343,0.1929840143317255,131067.837431423,-704.2470173177419,130363.59041410526,3322,21,734.3617021276596,40,7,17,35.51198392219134,0.6239583333333334,44.0040650406504,1023.9837398373976,25.59959349593494,0
3515,4,0,0,47,0.0,0.0,1.0,47,1250,900,350,0.72,16,9,7,331.87357387799443,0.8125192722787542,0.02689702769271074,0.19372423267307834,131197.94894118918,-691.773559884978,130506.1753813042,3323,22,735.3617021276596,40,7,18,35.37698806335351,0.6252604166666667,43.87703252032521,1024.4918699186999,25.6122967479675,0
3516,4,0,0,47,0.0,0.0,1.0,47,1250,900,350,0.72,16,9,7,326.98661174769126,0.8127505396238051,0.022578094983294328,0.19139664595768294,131303.29574732587,-813.1160424553783,130490.17970487049,3324,23,736.3617021276596,42,5,18,35.39598499889698,0.6232638888888888,43.77422480620155,1024.9031007751937,24.402454780361754,0
3517,4,0,0,47,0.0,0.0,1.0,47,1300,900,400,0.6923076923076923,17,9,8,327.46342172222694,0.8114014801110083,0.03011579416439991,0.19221201579622058,131410.26925131466,-793.5793268453217,130616.68992446933,3325,24,737.3617021276596,38,9,18,35.27599770761696,0.6307565789473686,43.66987179487178,1025.3205128205107,26.982118758434492,0
3518,4,0,0,47,0.0,0.0,1.0,47,1150,800,350,0.6956521739130435,15,8,7,324.35456534125586,0.810977489978415,0.03138000713181954,0.19064302661400953,131461.62245008664,-871.9645182291848,130589.65793185745,3326,25,738.3617021276596,39,8,18,35.30398256306077,0.6295405982905984,43.61979166666666,1025.520833333332,26.295405982905947,0
3519,4,0,0,47,0.0,0.0,1.0,47,1400,1100,300,0.7857142857142857,17,11,6,323.3489449865106,0.8112858464384828,0.0788742225379846,0.17862674727895608,129050.14349489809,-1051.0314249397586,127999.11206995833,3327,26,739.3617021276596,41,6,17,37.76850224565512,0.6021341463414633,45.98214285714286,1016.0714285714296,24.78222996515682,5
3520,4,2,3,46,0.04081632653061224,0.061224489795918366,0.9387755102040817,49,1100,800,300,0.7272727272727273,14,8,6,315.53895022104336,0.8230583900226758,0.05888225103516809,0.17674217958010255,129595.74619914667,-1615.829924001334,127979.91627514534,3328,0,710.1428571428571,42,7,13,37.413557924121285,0.6061507936507937,45.445736434108525,1018.2170542635658,24.243263196751567,3
3521,4,1,1,46,0.02127659574468085,0.02127659574468085,0.9787234042553191,47,1000,600,400,0.6,14,6,8,326.33196930243184,0.8177227875423989,0.08342773978549745,0.18617564457098834,130313.22830057955,-894.9255165028937,129418.30278407666,3329,0,735.4042553191489,41,6,14,36.412180981992485,0.6148373983739838,44.742063492063494,1021.0317460317465,24.903213317847474,3
3522,4,0,0,46,0.0,0.0,1.0,46,1350,800,550,0.5925925925925926,19,8,11,320.5038802314121,0.8099235104669887,0.11199004022217918,0.1740535426137094,128370.63536352034,-971.3426516440036,127399.29271187633,3330,29,752.3913043478261,41,5,14,38.53187714145862,0.5952743902439025,46.65178571428571,1013.3928571428567,24.716898954703822,5
3523,4,1,1,46,0.02127659574468085,0.02127659574468085,0.9787234042553191,47,1200,800,400,0.6666666666666666,16,8,8,313.62498720558074,0.8164508171446191,0.11340742607663512,0.17134793142317406,128610.97965867417,-1332.8766300102332,127278.10302866394,3331,0,737.3617021276596,42,5,15,38.46166093491275,0.5962301587301588,46.414728682170534,1014.3410852713163,24.150978220745625,0
3524,4,1,0,47,0.02127659574468085,0.0,1.0,47,850,400,450,0.47058823529411764,13,4,9,312.9124596293418,0.8138683317915509,0.1238771588411427,0.1715939844061635,128758.45520852103,-1341.9750165254588,127416.48019199558,3332,0,738.3404255319149,42,5,16,38.32983260136211,0.5977182539682541,46.269379844961236,1014.9224806201543,24.16482096714653,0
3525,4,0,0,47,0.0,0.0,1.0,47,1400,1000,400,0.7142857142857143,18,10,8,309.98505549050793,0.8152944804193647,0.11899177273214412,0.1704440905112423,128864.64520919413,-1410.7771608126739,127453.86804838145,3333,1,739.3404255319149,43,4,16,38.296260026114545,0.5973837209302326,46.16477272727273,1015.3409090909084,23.612579281183915,0
3526,4,2,0,49,0.04081632653061224,0.0,1.0,49,1350,1000,350,0.7407407407407407,17,10,7,293.3065975119846,0.8266369047619048,0.12698921408159425,0.158956128682027,128288.3926265496,-2250.2302858126686,126038.16234073693,3334,0,710.1224489795918,43,6,18,39.30446500903595,0.5915697674418605,46.73295454545455,1013.068181818182,23.559725158562372,5
3527,4,0,1,48,0.0,0.02040816326530612,0.9795918367346939,49,1200,700,500,0.5833333333333334,17,7,10,293.6185367254393,0.826388888888889,0.12967698994372068,0.15941207313540978,128360.35358019115,-2262.2041616448537,126098.1494185463,3335,1,711.1224489795918,43,6,18,39.22345653054231,0.5922965116279071,46.66193181818182,1013.352272727273,23.56633192389007,0
3528,4,1,0,49,0.02040816326530612,0.0,1.0,49,1150,900,250,0.782608695652174,14,9,5,291.55620030576097,0.8292587868480726,0.14931212101454006,0.15930165458102816,128613.7099194103,-2300.3750857338673,126313.33483367643,3336,0,709.2857142857143,44,5,14,39.01852274456112,0.5935132575757576,46.412037037037045,1014.3518518518531,23.05345117845121,0
3529,4,1,1,49,0.02,0.02,0.98,50,900,400,500,0.4444444444444444,14,4,10,284.9364297360982,0.8357142857142857,0.15084745762711882,0.15672901753393811,128879.27710171178,-2655.5197831337987,126223.75731857798,3337,0,696.08,45,5,14,38.91726137377341,0.5949074074074074,46.15036231884058,1015.3985507246373,22.56441223832527,0
3530,4,1,2,48,0.02,0.04,0.96,50,750,500,250,0.6666666666666666,10,5,5,283.47768158803405,0.83078231292517,0.15152336782019282,0.15610765058767365,128925.26845725677,-2690.5127599243974,126234.75569733237,3338,0,697.06,45,5,14,38.90771792127481,0.5953703703703704,46.10507246376811,1015.5797101449267,22.568438003220592,0
3531,4,0,0,48,0.0,0.0,1.0,48,1250,900,350,0.72,16,9,7,292.17005277375165,0.8278664302600472,0.15467725139109056,0.16074599671077186,128888.6837569591,-2068.51729295796,126820.16646400114,3339,3,724.6041666666666,43,5,16,38.72410161957164,0.5976259689922478,46.1410984848485,1015.4356060606085,23.614781536293222,0
3532,4,1,1,48,0.02040816326530612,0.02040816326530612,0.9795918367346939,49,1650,1100,550,0.6666666666666666,22,11,11,286.4716787969034,0.8347505668934241,0.15688877814738755,0.15858405070449225,129132.33109017294,-2401.4488651281035,126730.88222504484,3340,0,710.795918367347,45,4,16,38.622059085643,0.5974537037037035,45.90126811594204,1016.3949275362334,22.58655394524963,0
3533,4,0,0,48,0.0,0.0,1.0,48,1450,900,550,0.6206896551724138,20,9,11,291.29155618744187,0.8267767434988179,0.1594058466211088,0.1610541475645933,129083.74592764064,-2079.7989540466356,127003.94697359401,3341,5,726.6041666666666,44,4,16,38.5487851176917,0.598248106060606,45.949074074074076,1016.203703703704,23.095538720538727,0
3534,4,2,1,49,0.04,0.02,0.98,50,1450,1000,450,0.6896551724137931,19,10,9,287.02954385846874,0.8368197278911564,0.16339918134899412,0.1604795031781827,129523.90270557656,-2564.5090738536637,126959.3936317229,3342,0,698.5,45,5,11,38.21187043957999,0.6013888888888889,45.516304347826086,1017.9347826086957,22.620772946859905,0
3535,4,2,0,51,0.0392156862745098,0.0,1.0,51,1000,800,200,0.8,12,8,4,284.2913901134464,0.8390196078431373,0.18456091124695262,0.16015263531342877,129819.89354263095,-2818.6644000771785,127001.22914255377,3343,0,685.7647058823529,47,4,13,37.98268029528679,0.6019503546099292,45.225694444444436,1019.0972222222204,21.68291962174937,0
3536,4,2,1,52,0.03773584905660377,0.018867924528301886,0.9811320754716981,53,1750,1400,350,0.8,21,14,7,280.06118702486896,0.8492985002418965,0.20108327274071636,0.1593954190836711,130220.05555555584,-3306.0833333333144,126913.97222222252,3344,0,660.8490566037735,49,4,14,37.68710537774875,0.6037414965986394,44.83333333333334,1020.6666666666689,20.82993197278916,0
3537,4,0,1,51,0.0,0.019230769230769232,0.9807692307692307,52,2000,1400,600,0.7,26,14,12,284.04831320283154,0.8433100804424333,0.19772370486656143,0.161841480778358,130262.58680555588,-2999.826388888863,127262.76041666702,3345,1,674.5576923076923,49,3,15,37.54251700680272,0.6041666666666665,44.79166666666668,1020.833333333336,20.83333333333339,0
3538,4,0,0,51,0.0,0.0,1.0,51,1750,900,850,0.5142857142857142,26,9,17,287.0470637234485,0.8379738562091504,0.19575830332132838,0.1635500711912673,130262.58680555566,-2721.70138888888,127540.88541666679,3346,2,688.6078431372549,48,3,17,37.465986394557824,0.605251736111111,44.79166666666667,1020.8333333333343,21.267361111111132,0
3539,4,2,1,52,0.03773584905660377,0.018867924528301886,0.9811320754716981,53,1700,1300,400,0.7647058823529411,21,13,8,294.4430791074558,0.848421625544267,0.25590016362646684,0.16049414871928094,128518.33861551157,-2988.3301534770517,125530.00846203452,3347,0,663.5849056603773,47,6,12,39.04212324858031,0.5888741134751774,46.506076388888886,1013.9756944444437,21.57395094562646,8
3540,4,0,0,52,0.0,0.0,1.0,52,1700,1400,300,0.8235294117647058,20,14,6,295.055799751844,0.8446141277023629,0.2560029981379288,0.1613150270692949,128638.69024602602,-2808.881674085834,125829.80857194019,3348,1,677.25,46,6,12,38.90442483031842,0.5912590579710146,46.38741134751772,1014.4503546099263,22.053268578476658,0
3541,4,3,2,53,0.05454545454545454,0.03636363636363636,0.9636363636363636,55,1600,1200,400,0.75,20,12,8,294.7957463108793,0.8537598204264871,0.2835767926740398,0.16422698954677872,129381.71181027075,-3368.0803122328207,126013.63149803792,3349,0,641.2545454545455,46,9,14,38.15807627512487,0.5987318840579712,45.65602836879431,1017.3758865248196,22.116867098365645,0
3542,4,1,0,54,0.018518518518518517,0.0,1.0,54,1400,800,600,0.5714285714285714,20,8,12,301.1148254749821,0.8474842767295597,0.29999548289469,0.1680358328452755,129449.36532524759,-3004.1753904481784,126445.18993479942,3350,0,654.0185185185185,46,8,13,37.92886285100328,0.5994112318840581,45.58953900709219,1017.6418439716301,22.12264878199196,0
3543,4,0,2,52,0.0,0.037037037037037035,0.962962962962963,54,1550,900,650,0.5806451612903226,22,9,13,302.0720453116791,0.8468728162124389,0.30607954288957306,0.16924875670487496,129607.29229540727,-2969.8520258035683,126637.4402696037,3351,1,655.0185185185185,46,8,13,37.74468193162691,0.6009963768115943,45.43439716312055,1018.2624113475144,22.13613937711988,0
3544,4,0,0,52,0.0,0.0,1.0,52,1350,1100,250,0.8148148148148148,16,11,5,305.9657784139885,0.8422417043740572,0.3064044507264929,0.17113516967987444,129539.59751930203,-2473.0632419144154,127066.53427738762,3352,2,677.5961538461538,46,6,13,37.714084588812455,0.6003170289855074,45.50088652482268,1017.9964539007066,22.13035769349362,0
3545,4,0,0,52,0.0,0.0,1.0,52,1400,900,500,0.6428571428571429,19,9,10,307.34528771018364,0.8423673956762191,0.30626092371979086,0.1723023582199547,129629.86115040716,-2431.7746057794075,127198.08654462775,3353,3,678.5961538461538,46,6,13,37.58759902498477,0.6012228260869567,45.41223404255318,1018.3510638297851,22.138066604995327,0
3546,4,2,1,53,0.037037037037037035,0.018518518518518517,0.9814814814814815,54,1650,1200,450,0.7272727272727273,21,12,9,301.71221906690994,0.8470620778010716,0.31266286292961976,0.1710463033991796,130067.34751723772,-2951.4183904854826,127115.92912675223,3354,0,654.425925925926,48,6,15,37.28881849505393,0.6032986111111112,44.982993197278894,1020.0680272108806,21.251417233560012,0
3547,4,0,0,53,0.0,0.0,1.0,53,1700,900,800,0.5294117647058824,25,9,16,314.6651761500513,0.843976777939042,0.32237893777244153,0.17887832740909124,130173.98787133506,-2407.755835262328,127766.23203607273,3355,1,667.7735849056604,47,6,16,36.85068617443574,0.6054964539007093,44.87847222222223,1020.4861111111126,21.712470449172606,0
3548,4,1,1,53,0.018518518518518517,0.018518518518518517,0.9814814814814815,54,1650,900,750,0.5454545454545454,24,9,15,306.4349217253823,0.8469164919636618,0.3126424037920781,0.17561722888538212,130488.93356879694,-2802.666489527614,127686.26707926932,3356,0,656.3888888888889,46,8,12,36.74276934201013,0.6098278985507246,44.57003546099291,1021.7198581560292,22.211301264261504,0
3549,4,0,0,53,0.0,0.0,1.0,53,1750,1300,450,0.7428571428571429,22,13,9,316.0017647559239,0.8418299467827769,0.32831258820303155,0.1815562074086482,130586.4215763497,-2346.8920657424733,128239.52951060723,3357,3,669.7735849056604,45,8,12,36.39999113789436,0.6120370370370369,44.47463768115943,1022.101449275364,22.713365539452532,0
3550,4,1,1,53,0.018518518518518517,0.018518518518518517,0.9814814814814815,54,800,400,400,0.5,12,4,8,310.9508816849716,0.8454606335895645,0.3289472417213113,0.17967262011832202,130806.14912636453,-2665.1425198682023,128141.00660649633,3358,0,658.3518518518518,46,8,12,36.30748620619926,0.6129981884057971,44.25975177304965,1022.9609929078027,22.23828245451745,0
3551,4,0,0,53,0.0,0.0,1.0,53,1300,900,400,0.6923076923076923,17,9,8,316.28196050131675,0.841799709724238,0.3231140430025601,0.18258976983542305,130771.65051984899,-2327.8571991178064,128443.79332073119,3359,5,671.7735849056604,45,8,12,36.20594226000711,0.6138888888888887,44.29347826086958,1022.8260869565235,22.729468599033854,0
3552,4,1,1,53,0.018518518518518517,0.018518518518518517,0.9814814814814815,54,1600,1200,400,0.75,20,12,8,307.7908003667016,0.8442959468902865,0.3102769775367642,0.17965118822590545,131194.69536675335,-2723.895941840287,128470.79942491307,3360,0,660.3148148148148,47,7,14,35.99707676664972,0.6156914893617021,43.88020833333333,1024.4791666666656,21.79742907801416,0
3553,4,0,0,53,0.0,0.0,1.0,53,1700,1200,500,0.7058823529411765,22,12,10,312.7162419039246,0.8426161103047896,0.3173148349199455,0.18262059664899707,131214.56356728775,-2393.414959634841,128821.14860765291,3361,7,673.7735849056604,46,7,15,35.85092728793515,0.6170742753623188,43.86081560283687,1024.5567375886515,22.272972556275032,0
3554,4,0,0,53,0.0,0.0,1.0,53,1800,1200,600,0.6666666666666666,24,12,12,310.4925973031418,0.842343976777939,0.3085424515522204,0.18219843825848892,131399.31520061716,-2440.1988271185887,128959.11637349857,3362,8,674.7735849056604,44,9,15,35.722026551070165,0.6214488636363638,43.68055555555555,1025.2777777777767,23.301767676767653,0
3555,4,1,0,54,0.018518518518518517,0.0,1.0,54,1350,1100,250,0.8148148148148148,16,11,5,307.8776690083174,0.8450821104122991,0.3226287701272259,0.18220248683400841,131723.0092565243,-2689.0853910680557,129033.92386545624,3363,0,663.2592592592592,45,9,13,35.4638187887879,0.6233796296296297,43.365036231884055,1026.5398550724633,22.811996779388075,0
3556,4,1,0,55,0.01818181818181818,0.0,1.0,55,1500,1100,400,0.7333333333333333,19,11,8,304.1899389455426,0.8476711560044894,0.33232636928289105,0.1813873339638234,132010.52512449055,-2968.7452844424533,129041.7798400481,3364,0,652.1818181818181,46,9,14,35.270013802622486,0.625,43.085106382978715,1027.6595744680837,22.340425531914864,0
3557,4,0,0,55,0.0,0.0,1.0,55,1300,800,500,0.6153846153846154,18,8,10,303.9485763684929,0.8471941638608306,0.3310172880159954,0.18157051741332653,132078.86239531433,-2970.9635613148484,129107.89883399948,3365,1,653.1818181818181,46,9,14,35.20770447031766,0.6256793478260871,43.01861702127658,1027.925531914891,22.34620721554111,0
3558,4,1,1,55,0.017857142857142856,0.017857142857142856,0.9821428571428571,56,1550,1200,350,0.7741935483870968,19,12,7,307.2957632241063,0.8513528138528138,0.24818180055079275,0.1776719459896995,130830.33371913618,-3104.377670402749,127725.95604873342,3366,0,642.5,44,12,13,36.37659516698345,0.6157670454545453,44.23611111111113,1023.0555555555586,23.251262626262697,7
3559,4,0,0,55,0.0,0.0,1.0,55,1500,1100,400,0.7333333333333333,19,11,8,308.6844367943371,0.8464085297418631,0.257940666047062,0.17891395279957079,130925.0782321677,-2917.0931927297356,128007.98503943796,3367,1,654.9636363636364,44,11,13,36.24562712988932,0.616714015151515,44.14351851851853,1023.4259259259287,23.2596801346802,0
3560,4,1,1,55,0.017857142857142856,0.017857142857142856,0.9821428571428571,56,1600,1200,400,0.75,20,12,8,306.58689562924417,0.8504599567099567,0.2619205507136537,0.178921454570008,131188.89561672986,-3155.8407503675544,128033.0548663623,3368,0,644.25,45,11,15,36.033745947539046,0.6180555555555554,43.8858695652174,1024.4565217391319,22.76570048309182,0
3561,4,2,1,56,0.03508771929824561,0.017543859649122806,0.9824561403508771,57,1750,1300,450,0.7428571428571429,22,13,9,309.9360911058249,0.8532529239766081,0.2501485912924726,0.18033080339430504,131072.92753787275,-3264.061105203744,127808.866432669,3369,0,633.8245614035088,45,12,14,36.06470219666813,0.6168981481481481,43.99909420289855,1024.0036231884053,22.755636070853452,4
3562,4,0,1,55,0.0,0.017857142857142856,0.9821428571428571,56,1700,900,800,0.5294117647058824,25,9,16,307.74521082575586,0.8489448051948052,0.25346694117792556,0.179293011632373,131123.74978779987,-3129.4587954579756,127994.29099234189,3370,1,646.1428571428571,46,10,14,36.0696355924868,0.6161684782608695,43.94946808510638,1024.2021276595742,22.265263644773352,0
3563,4,0,0,55,0.0,0.0,1.0,55,1350,700,650,0.5185185185185185,20,7,13,314.16719333524895,0.8444163860830528,0.26167026194144927,0.18316071548201238,131150.23389274665,-2759.379822530885,128390.85407021576,3371,2,658.4,47,8,15,35.87853107344633,0.6152482269503545,43.9236111111111,1024.3055555555534,21.793735224586243,0
3564,4,0,0,55,0.0,0.0,1.0,55,1550,1000,550,0.6451612903225806,21,10,11,315.6143434780207,0.8438552188552189,0.26510542249886404,0.1841109672458783,131172.46368784946,-2720.0177981529882,128452.44588969648,3372,3,659.4,47,8,15,35.81908665932266,0.6154698581560284,43.901909722222214,1024.3923611111097,21.795582151300206,0
3565,4,0,0,55,0.0,0.0,1.0,55,1350,800,550,0.5925925925925926,19,8,11,314.2884669642569,0.8440796857463524,0.25795878130679895,0.18365648831911313,131239.16437596438,-2750.608844521618,128488.55553144276,3373,4,660.4,47,8,16,35.78589178809443,0.6161347517730498,43.83680555555555,1024.6527777777767,21.80112293144206,0
3566,4,0,2,53,0.0,0.03636363636363636,0.9636363636363636,55,1100,600,500,0.5454545454545454,16,6,10,315.6498021833064,0.8430695847362514,0.2539576983467253,0.18523254245196008,131400.9333839103,-2704.5437108617557,128696.38967304854,3374,5,661.4,43,12,16,35.588209260798614,0.6228197674418604,43.67897727272728,1025.2840909090924,23.84381606765331,0
3567,4,0,0,53,0.0,0.0,1.0,53,850,600,250,0.7058823529411765,11,6,5,317.1236219729612,0.8386248185776487,0.2636631750583145,0.1865706653769225,131498.04261542988,-2259.7728886880136,129238.26972674187,3375,6,681.0,43,10,17,35.452732126919635,0.6237887596899225,43.584280303030305,1025.662878787879,23.85262508809021,0
3568,4,0,1,52,0.0,0.018867924528301886,0.9811320754716981,53,800,500,300,0.625,11,5,6,318.4136701898888,0.8387457668118045,0.2606770655949864,0.18766082264382827,131565.50068587123,-2221.549211248268,129343.95147462297,3376,7,682.0,44,9,15,35.35179753309265,0.6231060606060606,43.518518518518526,1025.9259259259272,23.316498316498347,0
3569,4,1,1,52,0.018867924528301886,0.018867924528301886,0.9811320754716981,53,1100,700,400,0.6363636363636364,15,7,8,319.16010357394714,0.8438558297048863,0.24208729151162256,0.1884356227950291,131633.3616780046,-2187.0741300635414,129446.28754794107,3377,0,674.5849056603773,41,12,16,35.264404485692204,0.6280487804878048,43.452380952380956,1026.1904761904768,25.029036004645775,2
3570,4,0,1,51,0.0,0.019230769230769232,0.9807692307692307,52,1050,700,350,0.6666666666666666,14,7,7,323.3951792175041,0.8407491201608848,0.2442991715507321,0.19032230576339745,131510.4799247305,-1894.028955152374,129616.45096957812,3378,9,688.5576923076923,40,12,17,35.279401565441404,0.6283854166666667,43.57215447154471,1025.7113821138198,25.642784552845495,0
3571,4,0,0,51,0.0,0.0,1.0,51,1600,1000,600,0.625,22,10,12,322.81765278498284,0.8401960784313727,0.2375497669615314,0.19102408381845992,131719.04047070193,-1695.753705631572,130023.28676507036,3379,10,685.9803921568628,40,11,16,35.08439758439757,0.6304687500000001,43.36890243902439,1026.5243902439022,25.663109756097555,0
3572,4,1,0,52,0.019230769230769232,0.0,1.0,52,1650,1200,450,0.7272727272727273,21,12,9,313.3971856523094,0.8437342885872297,0.23779585798816627,0.1871912919707038,132074.09410492162,-2121.6701219878564,129952.42398293376,3380,0,673.7692307692307,42,10,17,34.96967697335344,0.6309523809523809,43.02325581395349,1027.9069767441863,24.47397563676634,0
3573,4,0,0,52,0.0,0.0,1.0,52,900,600,300,0.6666666666666666,12,6,6,318.9970151204972,0.8429644293614881,0.2461666585867539,0.1912088422527454,132207.48563957508,-1965.241340877884,130242.2442986972,3381,1,674.7692307692307,44,8,17,34.69189850244591,0.629498106060606,42.89351851851853,1028.4259259259286,23.37331649831656,0
3574,4,0,1,51,0.0,0.019230769230769232,0.9807692307692307,52,1700,1100,600,0.6470588235294118,23,11,12,317.4941402088213,0.8429801407742583,0.25046714419184,0.19127086007702201,132398.00347222257,-1992.8819444444096,130405.12152777816,3382,2,675.7692307692307,44,8,19,34.53947368421055,0.6313920454545453,42.70833333333335,1029.1666666666695,23.39015151515158,0
3575,4,0,0,51,0.0,0.0,1.0,51,1350,900,450,0.6666666666666666,18,9,9,323.24531398995356,0.840686274509804,0.2542703810771505,0.19448414074279283,132349.27847365718,-1643.7431846877678,130705.5352889694,3383,3,689.7647058823529,43,8,19,34.44037977790051,0.632267441860465,42.75568181818183,1028.9772727272739,23.929704016913345,0
3576,4,0,0,51,0.0,0.0,1.0,51,1250,700,550,0.56,18,7,11,325.52868860492214,0.8395098039215687,0.25280934765060126,0.1963835668183,132450.3036903464,-1576.6983643233639,130873.60532602303,3384,4,690.7647058823529,40,11,20,34.2802843321157,0.6377604166666667,42.65752032520325,1029.369918699187,25.73424796747968,0
3577,4,0,0,51,0.0,0.0,1.0,51,1600,1100,500,0.6875,21,11,10,325.545935220024,0.8383006535947714,0.25065855894537714,0.1976278258239883,132685.78247901384,-1560.9365704937527,131124.84590852007,3385,5,691.7647058823529,40,11,15,34.043738081146834,0.6401041666666667,42.42886178861789,1030.2845528455287,25.757113821138216,0
3578,4,0,0,51,0.0,0.0,1.0,51,1700,1200,500,0.7058823529411765,22,12,10,321.0504905532776,0.8354901960784314,0.24690112591458857,0.1959914727529217,132895.2725312316,-1666.7815123273008,131228.49101890431,3386,6,692.7647058823529,40,11,18,33.94975031210987,0.6421874999999999,42.22560975609757,1031.0975609756113,25.777439024390283,0
3579,4,0,0,51,0.0,0.0,1.0,51,1200,700,500,0.5833333333333334,17,7,10,318.4011366305193,0.8348039215686275,0.23798616648851678,0.19537995410584244,133088.07442247728,-1724.9211663832225,131363.15325609405,3387,7,693.7647058823529,41,10,18,33.82517306028266,0.6425304878048781,42.038690476190474,1031.8452380952378,25.166957026713117,0
3580,4,0,1,50,0.0,0.0196078431372549,0.9803921568627451,51,1450,1100,350,0.7586206896551724,18,11,7,319.1746951831034,0.8344771241830066,0.23374065668696842,0.19642796232152518,133197.0089406436,-1697.3770544137967,131499.6318862298,3388,8,694.7647058823529,42,9,18,33.696298382302324,0.6421130952380952,41.93313953488372,1032.2674418604652,24.57779623477298,0
3581,4,0,1,49,0.0,0.02,0.98,50,1650,1400,250,0.8484848484848485,19,14,5,307.8820231096915,0.8332993197278912,0.1968119944762281,0.18690466768179959,132685.78247901384,-1807.0321514384086,130878.75032757543,3389,9,707.92,40,10,15,34.49870947589925,0.6401041666666667,42.42886178861789,1030.2845528455287,25.757113821138216,5
3582,4,0,0,49,0.0,0.0,1.0,49,1400,1200,200,0.8571428571428571,16,12,4,316.0523458586781,0.8289399092970522,0.19025473462542752,0.1917308575684871,132659.6078413147,-1414.523948212046,131245.08389310265,3390,22,723.1836734693877,40,9,16,34.3144750254842,0.63984375,42.454268292682926,1030.1829268292681,25.754573170731703,0
3583,4,0,1,48,0.0,0.02040816326530612,0.9795918367346939,49,900,700,200,0.7777777777777778,11,7,4,316.0597601978084,0.8288336167800454,0.18959984861966106,0.19186909274762767,132685.78247901384,-1412.6726816048647,131273.10979740898,3391,23,724.1836734693877,40,9,16,34.28807457092128,0.6401041666666667,42.42886178861789,1030.2845528455287,25.757113821138216,0
3584,4,0,1,47,0.0,0.020833333333333332,0.9791666666666666,48,1000,800,200,0.8,12,8,4,325.244954444515,0.8233968676122931,0.19444163633912903,0.19762426838852235,132719.81336805562,-966.7100694444398,131753.10329861118,3392,24,739.3541666666666,39,9,17,34.0173877881116,0.642094017094017,42.395833333333336,1030.4166666666672,26.420940170940185,0
3585,4,0,0,47,0.0,0.0,1.0,47,1000,800,200,0.8,12,8,4,326.74263097464603,0.8204209065679925,0.19269791706987682,0.198818671024794,132773.48632812515,-723.4483506944298,132050.0379774307,3393,25,752.6382978723404,39,8,18,33.92502189879389,0.6426282051282051,42.34375000000001,1030.6250000000011,26.42628205128208,0
3586,4,0,0,47,0.0,0.0,1.0,47,1450,900,550,0.6206896551724138,20,9,11,327.25577357103117,0.8189176688251618,0.1958260461097756,0.19977960762043856,132895.27253123172,-701.8509567717324,132193.42157446,3394,26,753.6382978723404,40,7,19,33.789794007490634,0.6421874999999999,42.225609756097576,1031.0975609756122,25.777439024390304,0
3587,4,0,0,47,0.0,0.0,1.0,47,1050,600,450,0.5714285714285714,15,6,9,329.5445169744471,0.8179155103299414,0.19228592390734733,0.2017416675084826,133000.07952442343,-634.1106071121515,132365.9689173113,3395,27,754.6382978723404,40,7,19,33.62582101806239,0.6432291666666665,42.123983739837406,1031.5040650406515,25.78760162601629,0
3588,4,0,1,46,0.0,0.02127659574468085,0.9787234042553191,47,800,600,200,0.75,10,6,4,330.9648038545389,0.817491520197348,0.18862649430779754,0.2028958145369135,133052.4985127904,-592.8611854715716,132459.6373273188,3396,28,755.6382978723404,40,7,19,33.53670048594694,0.6437499999999998,42.073170731707336,1031.707317073174,25.79268292682935,0
3589,4,0,2,44,0.0,0.043478260869565216,0.9565217391304348,46,1150,800,350,0.6956521739130435,15,8,7,338.07410763772407,0.8164452495974235,0.22753593123571014,0.20486313461566943,132618.00219382372,-206.938324804525,132411.06386901918,3397,29,768.5652173913044,38,8,19,33.789069252843774,0.6428179824561402,42.49465811965813,1030.0213675213693,27.105825461088664,5
3590,4,0,0,44,0.0,0.0,1.0,44,1200,1100,100,0.9166666666666666,13,11,2,350.5642282141289,0.8165961945031713,0.22589008824963885,0.21104351069636704,132371.2036132814,480.921766493071,132852.12537977446,3398,30,783.8636363636364,39,5,19,33.71556247258493,0.6386217948717948,42.73437500000001,1029.0625000000011,26.386217948717977,0
3591,4,0,0,44,0.0,0.0,1.0,44,1000,500,500,0.5,15,5,10,345.42890019721256,0.8147683227625089,0.22736468324703618,0.20901375825492374,132562.98539201205,358.21996283799865,132921.20535485004,3399,31,784.8636363636364,38,6,19,33.654943458865034,0.6422697368421051,42.548076923076934,1029.807692307694,27.100202429149842,0
3592,4,0,0,44,0.0,0.0,1.0,44,750,500,250,0.6666666666666666,10,5,5,336.93161063568573,0.8152087737843552,0.14512055215291508,0.19543624593307266,130954.69292534741,27.66265768821816,130982.35558303562,3400,32,785.8636363636364,39,5,16,35.49299477576498,0.624465811965812,44.11458333333334,1023.5416666666681,26.24465811965816,4
3593,4,0,0,44,0.0,0.0,1.0,44,1200,800,400,0.6666666666666666,16,8,8,338.19074831649766,0.8147903453136012,0.1425367613058357,0.19671095005628225,131061.33355034716,64.74609374999554,131126.07964409716,3401,33,786.8636363636364,39,5,16,35.35308579179384,0.625534188034188,44.010416666666664,1023.9583333333328,26.255341880341867,0
3594,4,1,1,44,0.022222222222222223,0.022222222222222223,0.9777777777777777,45,650,300,350,0.46153846153846156,10,3,7,330.1510008931287,0.8217171717171717,0.14147183139366604,0.19351245287535512,131355.50356353613,-326.02727041332133,131029.4762931228,3402,0,770.3555555555556,38,7,17,35.26228938683341,0.6302083333333335,43.72329059829058,1025.1068376068354,26.976495726495667,0
3595,4,0,0,44,0.0,0.0,1.0,44,1250,800,450,0.64,17,8,9,330.2409835381412,0.8231148696264976,0.1337479050477699,0.19439875431941703,131519.83486969452,-113.35207557164267,131406.4827941229,3403,1,761.6818181818181,38,6,18,35.09443460750615,0.6318530701754387,43.56303418803418,1025.7478632478621,26.993364822312163,0
3596,4,2,1,45,0.043478260869565216,0.021739130434782608,0.9782608695652174,46,1200,900,300,0.75,15,9,6,319.44124539336644,0.8296296296296296,0.13695308200330203,0.19045930857415802,132006.08103642007,-766.3626148456676,131239.71842157442,3404,0,729.5217391304348,40,6,17,34.88264767932489,0.6333333333333333,43.08943089430894,1027.6422764227639,25.691056910569095,0
3597,4,0,0,45,0.0,0.0,1.0,45,1500,1000,500,0.6666666666666666,20,10,10,325.2736815171326,0.824452861952862,0.14075876362980977,0.19374997551237885,131969.53124999988,-414.75694444445816,131554.77430555542,3405,1,746.7333333333333,39,6,19,34.76953230602865,0.6346153846153848,43.12499999999999,1027.499999999999,26.346153846153822,0
3598,4,0,0,45,0.0,0.0,1.0,45,950,500,450,0.5263157894736842,14,5,9,322.9408015734861,0.8234848484848485,0.14159113132711454,0.1926784853281809,132032.19112507437,-472.2836729129518,131559.90745216142,3406,2,747.7333333333333,40,5,19,34.76651339859586,0.6335937500000001,43.0640243902439,1027.7439024390244,25.69359756097561,0
3599,4,0,0,45,0.0,0.0,1.0,45,1750,1300,450,0.7428571428571429,22,13,9,357.1309721444336,0.823063973063973,0.21613400246522252,0.21060714338611036,131588.67076475677,414.4988515434303,132003.1696163002,3407,3,748.7333333333333,40,5,15,34.33538034865294,0.6291666666666664,43.49593495934961,1026.0162601626043,25.65040650406511,5
3600,4,0,0,45,0.0,0.0,1.0,45,950,700,250,0.7368421052631579,12,7,5,360.7113348723089,0.8227272727272728,0.21607101607101575,0.21344728726099557,131719.04047070208,502.5101832573307,132221.55065395942,3408,4,749.7333333333333,40,5,15,34.111927861927846,0.6304687499999999,43.368902439024396,1026.5243902439033,25.663109756097583,0
3601,4,0,0,45,0.0,0.0,1.0,45,1450,1000,450,0.6896551724137931,19,10,9,363.81742324102566,0.8218855218855219,0.22341415141019239,0.21587639822962837,131823.382710771,591.9286841496726,132415.31139492066,3409,5,750.7333333333333,40,5,15,33.92689262741218,0.6315104166666665,43.26727642276424,1026.9308943089452,25.67327235772363,0
3602,4,0,0,45,0.0,0.0,1.0,45,1000,700,300,0.7,13,7,6,364.484043502438,0.8210437710437711,0.22083731768171355,0.21686693324109171,131927.7662622283,617.1131395003085,132544.87940172863,3410,6,751.7333333333333,40,5,15,33.80444818148844,0.6325520833333333,43.16565040650407,1027.3373983739848,25.68343495934962,0
3603,4,0,0,45,0.0,0.0,1.0,45,1500,1100,400,0.7333333333333333,19,11,8,366.71417600217376,0.8208333333333334,0.2258032624814632,0.2190970992476071,132084.41904826826,687.4457788023052,132771.86482707056,3411,7,752.7333333333333,40,5,16,33.589141538968526,0.6341145833333333,43.01321138211382,1027.947154471545,25.698678861788625,0
3604,4,0,0,45,0.0,0.0,1.0,45,1450,1000,450,0.6896551724137931,19,10,9,362.589651224764,0.8196548821548822,0.21474979368294655,0.21740699330521296,132219.3889853396,588.2764274691475,132807.66541280877,3412,8,753.7333333333333,41,4,16,33.55910983569661,0.6338922764227641,42.88194444444445,1028.472222222223,25.08468834688349,0
3605,4,0,1,44,0.0,0.022222222222222223,0.9777777777777777,45,1150,800,350,0.6956521739130435,15,8,7,364.9221908836771,0.818392255892256,0.21475267573040213,0.21939756763215157,132321.43964356574,657.4059311224481,132978.8455746882,3413,9,754.7333333333333,41,4,16,33.39630942049946,0.6349085365853657,42.782738095238095,1028.8690476190475,25.09436701509872,0
3606,4,0,0,44,0.0,0.0,1.0,44,1550,1200,350,0.7741935483870968,19,12,7,374.35454351470787,0.815473044397463,0.21208305274971906,0.2252132948952122,132345.7135819454,1108.8438388194973,133454.5574207649,3414,12,772.6818181818181,40,4,16,33.12921810699589,0.63671875,42.75914634146342,1028.9634146341473,25.724085365853682,0
3607,4,1,1,44,0.022222222222222223,0.022222222222222223,0.9777777777777777,45,700,300,400,0.42857142857142855,11,3,8,367.0202394212434,0.817929292929293,0.20683136506683297,0.2220308111077888,132554.9351101363,730.0791319651123,133285.01424210143,3415,0,756.4888888888889,40,5,16,33.10717457811113,0.6388020833333332,42.555894308943095,1029.7764227642288,25.744410569105717,0
3608,4,0,0,44,0.0,0.0,1.0,44,1300,900,400,0.6923076923076923,17,9,8,370.94304714785085,0.8146141649048626,0.203101869304964,0.22458750196881855,132585.67843967036,1036.3471137153026,133622.02555338567,3416,14,774.6818181818181,39,5,17,32.97522420012812,0.6407585470085468,42.52604166666668,1029.895833333335,26.407585470085515,0
3609,4,0,0,44,0.0,0.0,1.0,44,1100,700,400,0.6363636363636364,15,7,8,369.23543311749347,0.8147463002114165,0.1992227360060299,0.22387303483132423,132639.32427300367,995.0276692708533,133634.35194227452,3417,15,775.6818181818181,39,5,15,32.96518437995079,0.641292735042735,42.47395833333334,1030.1041666666683,26.412927350427392,0
3610,4,0,0,44,0.0,0.0,1.0,44,950,400,550,0.42105263157894735,15,4,11,368.66635130741753,0.813535059901339,0.19808542311827448,0.22416817538317663,132746.64849175353,987.84450954862,133734.49300130215,3418,16,776.6818181818181,39,5,15,32.87183277738468,0.642361111111111,42.36979166666667,1030.520833333334,26.423611111111125,0
3611,4,0,0,44,0.0,0.0,1.0,44,1650,1300,350,0.7878787878787878,20,13,7,373.27803828058234,0.8117512332628612,0.20244239546694298,0.22795060462304076,132907.71620008704,1122.306315104192,134030.02251519123,3419,17,777.6818181818181,39,5,16,32.59093932047007,0.6439636752136751,42.21354166666668,1031.1458333333353,26.439636752136803,0
3612,4,0,0,44,0.0,0.0,1.0,44,1050,700,350,0.6666666666666666,14,7,7,355.35629897553883,0.8113328047921071,0.16643077778770987,0.2164056024300139,132803.95418645005,712.6627108791733,133516.61689732922,3420,18,778.6818181818181,36,8,17,33.15716158636511,0.6484375,42.31418918918919,1030.7432432432438,28.631756756756772,4
3613,4,0,1,43,0.0,0.022727272727272728,0.9772727272727273,44,1400,1200,200,0.8571428571428571,16,12,4,357.9578524464731,0.8094388653981678,0.17156142453888124,0.21858673015627517,132906.30290089283,714.970952600827,133621.27385349365,3421,19,779.6818181818181,37,7,17,32.987292641429185,0.6475225225225224,42.21491228070177,1031.1403508771948,27.868658131816076,0
3614,4,0,1,42,0.0,0.023255813953488372,0.9767441860465116,43,1100,800,300,0.7272727272727273,14,8,6,366.02764538876477,0.8059708379475821,0.17981890984816795,0.22334574624208675,132878.0384950178,1127.4071108418077,134005.4456058596,3422,20,796.7441860465116,37,6,17,32.80768105923642,0.6472409909909909,42.242324561403514,1031.0307017543867,27.86569464201045,0
3615,4,0,0,42,0.0,0.0,1.0,42,1050,700,350,0.6666666666666666,14,7,7,360.57667444532234,0.8022406116918313,0.13235658315749865,0.21425118344359265,131876.23844875448,1110.2990996420488,132986.53754839653,3423,21,815.3333333333334,38,4,16,33.95677310866099,0.6354166666666666,43.215811965811966,1027.1367521367522,27.02991452991453,5
3616,4,0,0,42,0.0,0.0,1.0,42,1050,700,350,0.6666666666666666,14,7,7,373.8577011614485,0.8015873015873016,0.09944205509705917,0.21775882214569703,131114.67013888905,1404.6759715830422,132519.3461104721,3424,22,816.3333333333334,39,3,19,34.38601844317874,0.626068376068376,43.95833333333334,1024.166666666668,26.260683760683797,2
3617,4,0,0,42,0.0,0.0,1.0,42,900,500,400,0.5555555555555556,13,5,8,375.2108663797053,0.8016840882694541,0.10835329072607092,0.21902146751440724,131197.9489411892,1445.3792178927993,132643.328159082,3425,23,817.3333333333334,40,2,19,34.267020467546196,0.6252604166666667,43.87703252032521,1024.4918699187,25.612296747967502,0
3618,4,0,0,42,0.0,0.0,1.0,42,600,300,300,0.5,9,3,6,377.5540517172607,0.8012243515292296,0.11333843335033356,0.2208384604128108,131276.04683059032,1512.7606748628539,132788.80750545318,3426,24,818.3333333333334,40,2,19,34.127908898585225,0.6260416666666666,43.800813008130085,1024.7967479674803,25.619918699187007,0
3619,4,0,0,42,0.0,0.0,1.0,42,900,500,400,0.5555555555555556,13,5,8,362.4826281693566,0.8012243515292296,0.07357127873175684,0.20352823185904861,129690.63321827743,1002.1409712762155,130692.77418955365,3427,25,819.3333333333334,38,4,16,36.12203692049508,0.6134868421052632,45.3525641025641,1018.5897435897434,26.80499325236167,4
3620,4,1,1,42,0.023255813953488372,0.023255813953488372,0.9767441860465116,43,1300,1000,300,0.7692307692307693,16,10,6,355.6591481908666,0.806109265411591,0.07991336069311461,0.2015401839748246,130050.00000000013,650.6944444444605,130700.6944444446,3428,0,801.2558139534884,39,4,16,35.93069172113291,0.6153846153846153,45.00000000000001,1020.000000000001,26.15384615384618,0
3621,4,0,0,42,0.0,0.0,1.0,42,900,700,200,0.7777777777777778,11,7,4,365.6098630537375,0.8013211382113821,0.07174476696389043,0.20675649621219158,129970.32470703126,1103.6865234375014,131074.01123046878,3429,27,821.3333333333334,39,3,16,35.75792981918481,0.6145833333333334,45.078125,1019.6875000000001,26.145833333333336,0
3622,4,3,2,43,0.06666666666666667,0.044444444444444446,0.9555555555555556,45,800,400,400,0.5,12,4,8,348.201794325952,0.8137626262626263,0.08911529971132626,0.20044578365449978,130661.65500217024,100.30924479167794,130761.96424696191,3430,0,767.5111111111111,39,6,16,35.50104007471559,0.6215277777777778,44.40104166666667,1022.3958333333342,26.2152777777778,0
3623,4,0,1,42,0.0,0.023255813953488372,0.9767441860465116,43,1200,800,400,0.6666666666666666,16,8,8,362.2449188785494,0.8027870062753784,0.09259397914514023,0.20758906236840863,130486.54994806094,853.6179401354245,131340.16788819636,3431,1,804.2093023255813,37,6,17,35.31963225298705,0.6233108108108107,44.57236842105263,1021.7105263157895,27.61379800853485,0
3624,4,1,0,43,0.023255813953488372,0.0,1.0,43,800,400,400,0.5,12,4,8,356.37896500760473,0.8068475452196382,0.09310304417532556,0.20556256070661258,130738.73842191811,718.5072570406153,131457.24567895872,3432,0,795.7209302325581,37,6,17,35.21396215288948,0.6258445945945947,44.325657894736835,1022.6973684210512,27.64046941678517,0
3625,4,0,1,42,0.0,0.023255813953488372,0.9767441860465116,43,1200,600,600,0.5,18,6,12,355.98737815365786,0.804032853451458,0.09579608307798404,0.2061455325245303,130890.45606874116,719.0700562495263,131609.5261249907,3433,1,796.7209302325581,38,5,17,35.070386997981494,0.6255482456140352,44.17735042735042,1023.2905982905969,26.92869995501571,0
3626,4,1,1,42,0.023255813953488372,0.023255813953488372,0.9767441860465116,43,850,400,450,0.47058823529411764,13,4,9,357.92799316334174,0.810031376891842,0.10022032845440121,0.20815424068431201,131054.4963109064,781.6145719190456,131836.11088282545,3434,0,792.7906976744187,38,5,17,34.85474923483585,0.6271929824561404,44.01709401709401,1023.9316239316225,26.945569050832173,0
3627,4,1,0,43,0.023255813953488372,0.0,1.0,43,1350,800,550,0.5925925925925926,19,8,11,359.88108920375623,0.8135382059800664,0.1035041346363701,0.21018633650816235,131218.6392815401,844.621365695102,132063.2606472352,3435,0,793.7674418604652,38,5,18,34.63872957942301,0.6288377192982455,43.856837606837615,1024.572649572651,26.96243814664871,0
3628,4,0,0,43,0.0,0.0,1.0,43,1050,800,250,0.7619047619047619,13,8,5,361.51084188331805,0.8134459210040605,0.10378725385686272,0.21159459686436466,131301.43364800356,893.3783637152885,132194.81201171884,3436,1,794.7674418604652,39,4,18,34.51326777789071,0.6279380341880341,43.77604166666667,1024.8958333333342,26.279380341880362,0
3629,4,0,0,43,0.0,0.0,1.0,43,800,500,300,0.625,11,5,6,371.26155808268646,0.8134920634920635,0.1940062335171422,0.19787017106604737,127617.73003472228,898.2747395833385,128516.00477430562,3437,2,795.7674418604652,37,6,18,38.01761168384879,0.5943130630630631,47.395833333333336,1010.4166666666672,27.308558558558573,8
3630,4,5,3,45,0.10416666666666667,0.0625,0.9375,48,1100,800,300,0.7272727272727273,14,8,6,328.339188315294,0.8379321808510638,0.18361487642910923,0.1794257584632063,128619.58007812517,-1150.575086805541,127469.00499131963,3438,0,713.7708333333334,39,9,19,38.07977339631683,0.6009615384615383,46.40625000000001,1014.3750000000014,26.00961538461542,2
3631,4,1,0,46,0.021739130434782608,0.0,1.0,46,1300,800,500,0.6153846153846154,18,8,10,335.98527895097686,0.8331320450885669,0.19233348866986866,0.18378855012425238,128659.52934967632,-554.4584283495099,128105.07092132681,3439,0,736.7826086956521,40,6,20,37.84517012254165,0.5997395833333332,46.366869918699194,1014.5325203252048,25.36331300813012,0
3632,4,1,0,47,0.02127659574468085,0.0,1.0,47,1550,1000,550,0.6451612903225806,21,10,11,330.90684832190783,0.8401557200123342,0.19372364327148728,0.18222126983708292,128924.17332963283,-867.6216261967639,128056.55170343607,3440,0,722.0851063829788,41,6,21,37.70462944873174,0.6008638211382114,46.1061507936508,1015.5753968253972,24.770131629887736,0
3633,4,0,0,47,0.0,0.0,1.0,47,1350,1100,250,0.8148148148148148,16,11,5,330.87602267608025,0.8414662349676225,0.19494110126929054,0.18268747223584544,129029.04652852906,-861.4764549906723,128167.57007353839,3441,1,723.0851063829788,42,5,21,37.598752185662065,0.6004464285714285,46.00290697674419,1015.9883720930242,24.190199335548193,0
3634,4,1,1,47,0.020833333333333332,0.020833333333333332,0.9791666666666666,48,1050,600,450,0.5714285714285714,15,6,9,324.6742952919139,0.8453014184397163,0.192676858206152,0.18040951308679332,129280.82817925357,-1204.7075597005264,128076.12061955304,3442,0,709.0,39,9,21,37.50053347673187,0.607638888888889,45.755208333333336,1016.9791666666674,26.076388888888907,0
3635,4,0,1,46,0.0,0.02127659574468085,0.9787234042553191,47,1300,1000,300,0.7692307692307693,16,10,6,335.2536554439351,0.8381128584643848,0.20804527563015118,0.18629769679923056,129282.8654051611,-731.4893573306958,128551.3760478304,3443,3,725.0851063829788,38,9,21,37.2294883916378,0.609375,45.75320512820513,1016.9871794871797,26.762820512820518,0
3636,4,2,1,47,0.041666666666666664,0.020833333333333332,0.9791666666666666,48,1150,800,350,0.6956521739130435,15,8,7,332.91190528207176,0.8426787825059101,0.22808177041766475,0.1870576759275498,129718.50419723713,-963.0331234714724,128755.47107376566,3444,0,710.0833333333334,40,8,18,36.84677607076351,0.6104166666666666,45.32520325203252,1018.6991869918701,25.467479674796753,0
3637,4,1,1,47,0.020833333333333332,0.020833333333333332,0.9791666666666666,48,1400,1100,300,0.7857142857142857,17,11,6,329.40190228482226,0.8450243794326241,0.22947563139715466,0.18578973780879585,129867.21543364272,-1044.2984383450603,128822.91699529765,3445,0,711.0625,42,6,18,36.78542003359,0.6088789682539684,45.17926356589147,1019.2829457364334,24.268641565153175,0
3638,4,0,2,45,0.0,0.0425531914893617,0.9574468085106383,47,950,600,350,0.631578947368421,13,6,7,352.1153211255498,0.8376503237742831,0.23073713937293427,0.19665068656361928,129480.23069598334,-182.80715477042816,129297.4235412129,3446,2,727.1914893617021,37,10,18,36.59996049701933,0.6131756756756757,45.55921052631579,1017.7631578947364,27.507112375533417,6
3639,4,2,2,45,0.0425531914893617,0.0425531914893617,0.9574468085106383,47,1050,700,350,0.6666666666666666,14,7,7,346.9219537948853,0.8365710761640456,0.24832159441661128,0.1951330989504888,129759.37307633119,-396.72495383194575,129362.64812249925,3447,0,727.8510638297872,37,10,18,36.44846821638687,0.6159909909909909,45.28508771929825,1018.8596491228071,27.53674727358938,0
3640,4,1,0,46,0.021739130434782608,0.0,1.0,46,1500,1100,400,0.7333333333333333,19,11,8,355.7041001875442,0.8291264090177134,0.2590964133317948,0.20014991906075286,129774.47041636256,32.26224535348146,129806.73266171604,3448,0,744.6521739130435,36,10,19,36.20942933981726,0.6180555555555556,45.27027027027028,1018.9189189189209,28.30330330330336,0
3641,4,0,0,46,0.0,0.0,1.0,46,1350,1100,250,0.8148148148148148,16,11,5,358.1611747022778,0.8293679549114332,0.26250584385226716,0.20260942364544898,129982.90339335172,110.96587411510112,130093.86926746683,3449,1,745.6521739130435,37,9,19,35.93503584229391,0.6182432432432432,45.065789473684205,1019.7368421052626,27.560455192034123,0
3642,4,0,0,46,0.0,0.0,1.0,46,900,700,200,0.7777777777777778,11,7,4,355.0849282708867,0.8299516908212561,0.2587997140007552,0.201186694967487,130044.55133912271,35.37203685441122,130079.92337597713,3450,2,746.6521739130435,38,8,19,35.95086589155406,0.6170504385964912,45.00534188034188,1019.978632478633,26.841542959964027,0
3643,4,0,0,46,0.0,0.0,1.0,46,1800,1500,300,0.8333333333333334,21,15,6,350.7385703050266,0.8300925925925926,0.25523283682780873,0.1992943755631117,130156.27170138908,-69.83506944442371,130086.43663194466,3451,3,747.6521739130435,39,7,19,35.94834626378114,0.6164529914529913,44.89583333333334,1020.4166666666682,26.164529914529954,0
3644,4,0,0,46,0.0,0.0,1.0,46,1500,1000,500,0.6666666666666666,20,10,10,347.89974873089153,0.8301932367149759,0.23744233111769675,0.19836849823863287,130291.32806793277,-134.20573233707609,130157.12233559569,3452,4,748.6521739130435,36,10,19,35.88384256195306,0.623263888888889,44.76351351351351,1020.9459459459457,28.359609609609603,0
3645,4,1,1,46,0.02127659574468085,0.02127659574468085,0.9787234042553191,47,1400,900,500,0.6428571428571429,19,9,10,338.5238069500671,0.8378815911193339,0.22836153091876898,0.19478859342785296,130644.58832137125,-554.7393208050182,130089.84900056623,3453,0,733.7021276595744,38,9,16,35.76566691050963,0.6230811403508771,44.417735042735046,1022.3290598290605,26.903396311291065,0
3646,4,0,0,46,0.0,0.0,1.0,46,1200,800,400,0.6666666666666666,16,8,8,343.19351675355716,0.8287842190016104,0.23083686672917114,0.19709838383610015,130570.5857210872,-237.80430036166078,130332.78142072554,3454,6,750.6521739130435,37,9,16,35.721198548081375,0.6241554054054055,44.49013157894736,1022.0394736842102,27.622688477951627,0
3647,4,0,1,45,0.0,0.021739130434782608,0.9782608695652174,46,1400,1100,300,0.7857142857142857,17,11,6,324.42066074586705,0.8305354267310789,0.2044017735219248,0.18801817619406536,130921.69390904509,-705.2595112118879,130216.4343978332,3455,7,751.6521739130435,41,5,18,35.84641980095645,0.6209349593495934,44.1468253968254,1023.4126984126983,24.961285327138985,2
3648,4,0,0,45,0.0,0.0,1.0,45,1000,600,400,0.6,14,6,8,328.82414952334653,0.8251683501683502,0.20704402515723297,0.1905212419850461,130911.78882444323,-390.60847544449666,130521.18034899872,3456,12,769.2,40,5,18,35.74375206885138,0.6223958333333333,44.15650406504066,1023.3739837398382,25.584349593495954,0
3649,4,1,1,45,0.021739130434782608,0.021739130434782608,0.9782608695652174,46,1400,900,500,0.6428571428571429,19,9,10,321.3768115160638,0.8285628019323672,0.20795424404579022,0.187612116027495,131201.0476210158,-767.0051295981505,130434.04249141765,3457,0,753.4565217391304,41,5,19,35.64271246893258,0.623729674796748,43.87400793650793,1024.5039682539668,24.9879016647309,0
3650,4,0,0,45,0.0,0.0,1.0,45,1350,900,450,0.6666666666666666,18,9,9,324.11816578483246,0.8288299663299664,0.20185185185185173,0.18906893004115222,131171.9214753123,-496.9594817899464,130674.96199352235,3458,1,763.3777777777777,40,5,19,35.60185185185185,0.625,43.90243902439024,1024.3902439024387,25.609756097560968,0
3651,4,0,0,45,0.0,0.0,1.0,45,1000,700,300,0.7,13,7,6,324.9263743166514,0.8283670033670034,0.2016334358363916,0.18966895075194903,131197.94894118895,-474.065226551673,130723.88371463728,3459,2,764.3777777777777,40,5,19,35.55492180008596,0.6252604166666667,43.877032520325194,1024.491869918698,25.612296747967452,0
3652,4,1,1,45,0.021739130434782608,0.021739130434782608,0.9782608695652174,46,1100,800,300,0.7272727272727273,14,8,6,318.4847454729979,0.8297705314009662,0.2100602165729104,0.18756038627797167,131536.54095611052,-821.4590975940528,130715.08185851647,3460,0,748.7391304347826,40,6,22,35.37910309754968,0.6286458333333336,43.54674796747966,1025.8130081300792,25.64532520325198,0
3653,4,0,0,45,0.0,0.0,1.0,45,1300,800,500,0.6153846153846154,18,8,10,327.9886650930526,0.8260101010101011,0.2158304556842039,0.1929137632321501,131488.33007812474,-374.6636284722499,131113.6664496525,3461,1,765.7555555555556,39,6,22,35.18391563409845,0.6298076923076925,43.593749999999986,1025.624999999998,26.29807692307687,0
3654,4,0,0,45,0.0,0.0,1.0,45,1000,500,500,0.5,15,5,10,332.4060804864207,0.8255892255892257,0.22457228988568745,0.1964288476788975,131666.88484243813,-246.62537593366142,131420.25946650447,3462,2,766.7555555555556,40,5,18,34.89083077532426,0.6299479166666668,43.41971544715446,1026.3211382113802,25.658028455284505,0
3655,4,0,0,45,0.0,0.0,1.0,45,1300,1000,300,0.7692307692307693,16,10,6,329.01410434418017,0.8252104377104378,0.21913403059597258,0.19495774171197944,131771.20642681266,-329.0829078260384,131442.12351898663,3463,3,767.7555555555556,40,5,19,34.87289254016959,0.6309895833333334,43.318089430894304,1026.727642276422,25.66819105691055,0
3656,4,0,0,45,0.0,0.0,1.0,45,1050,600,450,0.5714285714285714,15,6,9,326.8809945666378,0.8242424242424243,0.21163225366668859,0.19409279266101295,131849.47472569224,-380.18251371539463,131469.29221197683,3464,4,768.7555555555556,40,5,19,34.84893462629461,0.6317708333333334,43.24186991869918,1027.0325203252023,25.675813008130056,0
3657,4,2,1,46,0.0425531914893617,0.02127659574468085,0.9787234042553191,47,1200,900,300,0.75,15,9,6,316.49907536326214,0.8348365710761639,0.1910200540295388,0.18145722758605753,130504.3734575874,-1049.5910063689723,129454.78245121843,3465,0,737.0,43,4,14,36.47011121408712,0.6138565891472867,44.55492424242425,1021.7803030303044,23.76233262861173,8
3658,4,0,0,46,0.0,0.0,1.0,46,1750,1300,450,0.7428571428571429,22,13,9,325.0478801398582,0.8313003220611916,0.20301941523552092,0.187221901268329,130683.32732407919,-704.3322967369606,129978.99502734223,3466,1,753.8478260869565,42,4,15,36.070966009603254,0.6170634920634921,44.379844961240316,1022.4806201550396,24.344776670358083,0
3659,4,0,0,46,0.0,0.0,1.0,46,1200,900,300,0.75,15,9,6,320.0403263068472,0.8292673107890499,0.20118217716598608,0.18516744139583588,130856.77059859707,-824.1112876329337,130032.65931096414,3467,2,754.8478260869565,42,4,15,36.02396849449127,0.618799603174603,44.210271317829466,1023.158914728684,24.36092654115914,0
3660,4,1,1,46,0.02127659574468085,0.02127659574468085,0.9787234042553191,47,1250,1000,250,0.8,15,10,5,314.9189732165736,0.836840888066605,0.19576041216030204,0.18398613877987738,131231.07854109287,-1134.5686983470935,130096.50984274577,3468,0,739.7659574468086,43,4,16,35.77788046826864,0.6211240310077519,43.844696969696976,1024.6212121212131,23.828400281888676,0
3661,4,1,1,46,0.02127659574468085,0.02127659574468085,0.9787234042553191,47,1500,1100,400,0.7333333333333333,19,11,8,316.85560114571126,0.8420058587727413,0.20589645442469884,0.18605815885063795,131425.20732897168,-1071.4373852157769,130353.7699437559,3469,0,740.5744680851063,43,4,16,35.53287772441819,0.623062015503876,43.65530303030304,1025.3787878787891,23.84601832276254,0
3662,4,0,0,46,0.0,0.0,1.0,46,1350,800,550,0.5925925925925926,19,8,11,325.2489806711667,0.8351449275362319,0.20999835620941898,0.19075023367521876,131377.79054744315,-653.9015083228086,130723.88903912033,3470,2,757.6739130434783,42,4,16,35.365469439193454,0.6240079365079365,43.7015503875969,1025.193798449613,24.409376153562214,0
3663,4,1,2,45,0.02127659574468085,0.0425531914893617,0.9574468085106383,47,1150,600,550,0.5217391304347826,17,6,11,320.4514416758996,0.8426996608078938,0.2033048925369909,0.18900878446153385,131595.18771701408,-966.0264756944234,130629.16124131966,3471,0,742.531914893617,43,4,14,35.26967005076141,0.6247577519379843,43.48958333333334,1026.0416666666683,23.86143410852717,0
3664,4,0,0,45,0.0,0.0,1.0,45,850,600,250,0.7058823529411765,11,6,5,326.3807908134634,0.8322811447811448,0.19282212774891105,0.19203672433354702,131501.99549493726,-416.0549433627717,131085.9405515745,3472,4,730.9555555555555,42,3,16,35.2113840340104,0.6252480158730158,43.58042635658915,1025.6782945736438,24.42091177556295,0
3665,4,0,1,44,0.0,0.022222222222222223,0.9777777777777777,45,800,300,500,0.375,13,3,10,330.61157522954,0.8321969696969698,0.20224110796348738,0.19516034457529713,131626.25912655497,-296.5670257196023,131329.69210083538,3473,5,731.9555555555555,42,3,14,34.97776990871891,0.6264880952380951,43.4593023255814,1026.162790697675,24.432447397563692,0
3666,4,0,1,43,0.0,0.022727272727272728,0.9772727272727273,44,1250,900,350,0.72,16,9,7,332.43548590880033,0.8301841085271319,0.19796407922253656,0.1965358592692829,131684.26890432113,-44.69521604936688,131639.57368827178,3474,6,727.9545454545455,41,3,14,34.8725755525485,0.6285569105691056,43.402777777777786,1026.38888888889,25.033875338753415,0
3667,4,0,0,43,0.0,0.0,1.0,43,750,300,450,0.4,12,3,9,333.49968494013837,0.8298726467331118,0.17803842264914005,0.19769311220678318,131786.11288265313,190.1254251700731,131976.2383078232,3475,7,690.9302325581396,41,2,14,34.7427536231884,0.6295731707317073,43.30357142857143,1026.785714285715,25.043554006968655,0
3668,4,0,1,42,0.0,0.023255813953488372,0.9767441860465116,43,900,300,600,0.3333333333333333,15,3,12,335.4467617640883,0.8295957918050941,0.1800084909665547,0.19924729343336853,131862.52170138914,246.57118055558007,132109.09288194473,3476,8,691.9302325581396,41,2,15,34.61587221095335,0.6303353658536585,43.22916666666668,1027.0833333333353,25.05081300813013,0
3669,4,0,0,42,0.0,0.0,1.0,42,1000,800,200,0.8,12,8,4,337.5318304831649,0.8196138211382114,0.1819317196395578,0.20014211356818665,131797.29327781094,497.15633055721685,132294.44960836816,3477,12,709.2142857142857,40,2,15,34.6279938638163,0.6312499999999999,43.29268292682927,1026.8292682926838,25.670731707317096,0
3670,4,0,0,42,0.0,0.0,1.0,42,600,300,300,0.5,9,3,6,380.8963933260392,0.8196138211382114,0.1954966514060208,0.2167260663071157,130209.423828125,1558.3018269445283,131767.72565506952,3478,13,710.2142857142857,39,3,17,35.124940464040286,0.6169871794871795,44.84375,1020.625,26.169871794871796,7
3671,4,2,0,44,0.045454545454545456,0.0,1.0,44,1000,700,300,0.7,13,7,6,365.5229015404009,0.826528365045807,0.19682487678413763,0.21091927284184797,130753.83434007232,758.7367351865599,131512.5710752589,3479,0,678.8863636363636,38,6,14,34.96487516974826,0.6241776315789473,44.31089743589744,1022.7564102564103,26.914642375168693,0
3672,4,0,0,44,0.0,0.0,1.0,44,1100,800,300,0.7272727272727273,14,8,6,363.0100470474434,0.827012861169838,0.1917150831624519,0.20991450546656487,130835.79881656796,698.9418967784269,131534.74071334637,3480,1,679.8863636363636,38,6,15,34.94608918128654,0.625,44.230769230769226,1023.0769230769223,26.923076923076902,0
3673,4,0,0,44,0.0,0.0,1.0,44,1600,1400,200,0.875,18,14,4,361.04105500528294,0.8260218463706837,0.188916119485804,0.21000198643206705,131061.33355034732,663.7044270833436,131725.03797743068,3481,2,680.8863636363636,39,5,15,34.768141742963714,0.625534188034188,44.01041666666667,1023.9583333333342,26.255341880341902,0
3674,4,0,0,44,0.0,0.0,1.0,44,1500,1100,400,0.7333333333333333,19,11,8,359.7058975732747,0.8252730796335448,0.1830110310366284,0.20968627771203216,131145.89659139735,634.7904892920924,131780.68708068944,3482,3,681.8863636363636,40,4,15,34.71677911168437,0.6247395833333333,43.927845528455286,1024.2886178861793,25.60721544715448,0
3675,4,0,0,44,0.0,0.0,1.0,44,900,600,300,0.6666666666666666,12,6,6,349.43631745627926,0.8256915081042988,0.17930926339723152,0.19432681539115412,129312.88954293645,269.9264158912159,129582.81595882766,3483,4,682.8863636363636,37,7,16,36.838346269943926,0.6114864864864864,45.72368421052632,1017.105263157896,27.489331436699892,5
3676,4,2,0,46,0.043478260869565216,0.0,1.0,46,1000,700,300,0.7,13,7,6,337.06857091231154,0.840841384863124,0.1978736260318641,0.19022797202698316,129890.67382812529,-443.5872395833068,129447.08658854198,3484,0,654.1521739130435,39,7,17,36.566268138156545,0.6137820512820511,45.156250000000014,1019.3750000000023,26.13782051282057,0
3677,4,1,0,47,0.02127659574468085,0.0,1.0,47,1500,1000,500,0.6666666666666666,20,10,10,331.2296246657329,0.8460915818686401,0.20831453868943584,0.1889758114149134,130314.46358194557,-767.1978278471499,129547.26575409842,3485,0,641.2127659574468,40,7,19,36.28591453501876,0.6164062499999998,44.7408536585366,1021.036585365856,25.5259146341464,0
3678,4,0,0,47,0.0,0.0,1.0,47,1400,900,500,0.6428571428571429,19,9,10,327.61523987598525,0.8458603145235892,0.21442247912307666,0.1880091691344029,130541.2368216966,-846.5402769903894,129694.69654470621,3486,1,642.2127659574468,41,6,18,36.14889735624375,0.6171239837398372,44.51884920634922,1021.9246031746057,24.924990321331848,0
3679,4,0,1,46,0.0,0.02127659574468085,0.9787234042553191,47,1550,1200,350,0.7741935483870968,19,12,7,305.821887816961,0.8460144927536232,0.1265708943743642,0.17511711920219603,130455.9981921487,-1418.3755547577941,129037.62263739092,3487,2,643.2127659574468,43,4,17,36.79165121740206,0.6133720930232558,44.60227272727273,1021.5909090909087,23.757928118393224,6
3680,4,0,0,46,0.0,0.0,1.0,46,1300,800,500,0.6153846153846154,18,8,10,313.62565693900245,0.835426731078905,0.13646781899654115,0.18006585757951313,130559.50969180025,-1010.6376006550242,129548.87209114523,3488,3,658.1304347826087,42,4,13,36.48786384753957,0.6158234126984128,44.500968992248055,1021.9961240310068,24.333241048357305,0
3681,4,0,1,45,0.0,0.021739130434782608,0.9782608695652174,46,750,500,250,0.6666666666666666,10,5,5,314.4125532750525,0.8345410628019324,0.13348744301432114,0.18093805571201857,130649.55305899907,-984.4280876951306,129665.12497130394,3489,4,659.1304347826087,43,3,13,36.37689885142645,0.6153100775193798,44.41287878787879,1022.3484848484848,23.775546159267087,0
3682,4,0,0,45,0.0,0.0,1.0,45,1600,1200,400,0.75,20,12,8,321.7266624553602,0.8308501683501683,0.12226012972790867,0.18530893789459416,130683.32732407919,-591.1378522925177,130092.18947178667,3490,5,673.4666666666667,42,3,14,36.15586302754615,0.6170634920634921,44.379844961240316,1022.4806201550396,24.344776670358083,0
3683,4,0,1,44,0.0,0.022222222222222223,0.9777777777777777,45,1650,1400,250,0.8484848484848485,19,14,5,317.73252506610055,0.829419191919192,0.10869574365124479,0.18418720799934996,130931.13864100722,-679.7837419626128,130251.3548990446,3491,6,674.4666666666667,42,3,14,36.00801615855584,0.6195436507936507,44.13759689922481,1023.4496124031012,24.367847914359555,0
3684,4,0,0,44,0.0,0.0,1.0,44,1600,1200,400,0.75,20,12,8,325.29470569933096,0.8263081395348838,0.11875539657086431,0.1887733843310292,130972.46334876557,-279.07021604936966,130693.3931327162,3492,7,690.5227272727273,41,3,16,35.772840343735865,0.6214430894308942,44.09722222222223,1023.6111111111122,24.96612466124664,0
3685,4,0,1,43,0.0,0.022727272727272728,0.9772727272727273,44,700,300,400,0.42857142857142855,11,3,8,323.81692806922666,0.8272330866807611,0.11236786469344628,0.1881638906348209,131023.24263038555,-314.49121315191985,130708.75141723362,3493,8,691.5227272727273,41,3,16,35.759447674418595,0.621951219512195,44.04761904761905,1023.8095238095242,24.97096399535425,0
3686,4,0,0,43,0.0,0.0,1.0,43,1050,900,150,0.8571428571428571,12,9,3,327.11017981159887,0.8241971207087486,0.11095316992574134,0.1905558608174162,131119.87428944441,-21.870868861098245,131098.00342058332,3494,9,703.4883720930233,40,3,17,35.57770225573856,0.6244791666666665,43.95325203252034,1024.1869918699213,25.604674796748032,0
3687,4,0,2,41,0.0,0.046511627906976744,0.9534883720930233,43,900,600,300,0.6666666666666666,12,6,6,328.56538361068834,0.8232281284606866,0.11157992354948232,0.19179314604396944,131197.94894118927,21.420884559481976,131219.36982574876,3495,10,704.4883720930233,40,3,17,35.46171841417852,0.6252604166666667,43.877032520325216,1024.4918699187006,25.612296747967513,0
3688,4,2,0,43,0.046511627906976744,0.0,1.0,43,1100,900,200,0.8181818181818182,13,9,4,319.14468038480663,0.827750092284976,0.10486081992065222,0.18794903172720187,131536.5409561108,-204.1625355277921,131332.37842058303,3496,0,690.5348837209302,40,3,19,35.36217885212336,0.6286458333333333,43.546747967479675,1025.8130081300817,25.645325203252042,0
3689,4,0,3,40,0.0,0.06976744186046512,0.9302325581395349,43,750,600,150,0.8,9,6,3,317.88040045358514,0.8270579549649317,0.10833671175321524,0.18746031092169385,131588.67076475653,-234.10812842883627,131354.5626363277,3497,1,691.5348837209302,40,3,16,35.34217346804013,0.6291666666666667,43.4959349593496,1026.0162601626025,25.650406504065064,0
3690,4,0,0,40,0.0,0.0,1.0,40,1050,700,350,0.6666666666666666,14,7,7,336.6217717911428,0.8125267094017093,0.10382063356164428,0.19658711472602727,131215.75869498303,834.0162357648439,132049.77493074787,3498,13,740.275,37,3,18,35.23740724885845,0.6306306306306306,43.859649122807014,1024.5614035087715,27.69084874348031,0
3691,4,1,0,41,0.024390243902439025,0.0,1.0,41,1500,1200,300,0.8,18,12,6,332.73048751459226,0.819359756097561,0.1088379393634622,0.19614554153484495,131574.63480029558,555.7784763313373,132130.4132766269,3499,0,723.1951219512196,38,3,18,34.9753983130272,0.6324013157894738,43.50961538461537,1025.961538461536,26.99898785425095,0
3692,4,0,0,41,0.0,0.0,1.0,41,1300,1100,200,0.8461538461538461,15,11,4,333.09912098192865,0.8195121951219512,0.10513246294236844,0.19678660246939744,131656.85609796166,570.9566074950467,132227.81270545672,3500,1,724.1951219512196,38,3,18,34.88314595044764,0.6332236842105264,43.42948717948717,1026.2820512820497,27.007422402159204,0
3693,4,0,0,41,0.0,0.0,1.0,41,1150,900,250,0.782608695652174,14,9,5,335.2252953641552,0.81875,0.11009365244536862,0.19861375391180816,131766.52444480953,634.2944152238776,132400.8188600334,3501,2,725.1951219512196,38,3,18,34.71817551161981,0.6343201754385965,43.32264957264956,1026.7094017094003,27.01866846603685,0
3694,4,0,0,41,0.0,0.0,1.0,41,1450,1200,250,0.8275862068965517,17,12,5,336.8322364140742,0.8178353658536586,0.11179030883486818,0.2004318555295627,131931.11257213808,687.7303400540357,132618.8429121921,3502,3,726.1951219512196,38,3,18,34.51127461175817,0.6359649122807018,43.16239316239315,1027.3504273504261,27.035537561853317,0
3695,4,0,0,41,0.0,0.0,1.0,41,1100,700,400,0.6363636363636364,15,7,8,339.1884287058431,0.8162093495934959,0.11879029926179285,0.20275291356135458,132103.35422092007,761.5858289930509,132864.94004991313,3503,4,727.1951219512196,39,2,18,34.27747238828657,0.6359508547008548,42.994791666666664,1028.0208333333328,26.359508547008534,0
3696,4,0,0,41,0.0,0.0,1.0,41,1250,1100,150,0.88,14,11,3,335.6020268513145,0.8159044715447155,0.11791912084436929,0.2010353889002533,132183.68055555547,672.2222222222181,132855.9027777777,3504,5,728.1951219512196,39,2,18,34.2888978930308,0.6367521367521367,42.916666666666664,1028.3333333333328,26.367521367521356,0
3697,4,0,0,41,0.0,0.0,1.0,41,1000,800,200,0.8,12,8,4,335.6020268513145,0.8159044715447155,0.11791912084436929,0.2010353889002533,132183.68055555547,672.2222222222181,132855.9027777777,3505,6,729.1951219512196,39,2,18,34.2888978930308,0.6367521367521367,42.916666666666664,1028.3333333333328,26.367521367521356,0
3698,4,0,0,41,0.0,0.0,1.0,41,1100,900,200,0.8181818181818182,13,9,4,334.89761256208965,0.8154979674796748,0.11349181846248868,0.2010403601246585,132264.03130425338,658.9816623263846,132923.01296657976,3506,7,730.1951219512196,39,2,18,34.22626582278481,0.6375534188034189,42.838541666666664,1028.6458333333328,26.375534188034173,0
3699,4,0,0,41,0.0,0.0,1.0,41,750,500,250,0.6666666666666666,10,5,5,335.7581239860865,0.8146849593495935,0.11677094701702262,0.20198652550149587,132344.40646701382,687.1419270833289,133031.54839409716,3507,8,731.1951219512196,39,2,19,34.12338867517042,0.6383547008547009,42.760416666666664,1028.9583333333328,26.383547008546994,0
3700,4,0,0,41,0.0,0.0,1.0,41,600,300,300,0.5,9,3,6,335.1964464259373,0.8146849593495935,0.11276784832625664,0.2019354201639182,132398.00347222213,675.8789062499907,133073.88237847213,3508,9,732.1951219512196,38,3,19,34.08400809716599,0.640625,42.70833333333333,1029.1666666666658,27.08333333333331,0
3701,4,0,0,41,0.0,0.0,1.0,41,1000,500,500,0.5,15,5,10,337.30636077251995,0.8149390243902439,0.11628260088369724,0.20394973055994625,132535.48127145867,741.0121721820275,133276.4934436407,3509,10,733.1951219512196,38,3,20,33.891670125198864,0.6419956140350878,42.57478632478632,1029.7008547008534,27.09739091318035,0
3702,4,0,0,41,0.0,0.0,1.0,41,1350,900,450,0.6666666666666666,18,9,9,336.25236885464,0.8120426829268292,0.1270933294213168,0.2040579982923403,132673.03040990917,722.3241516911153,133395.35456160028,3510,11,734.1951219512196,38,3,18,33.78076497632134,0.6433662280701755,42.441239316239304,1030.235042735041,27.111448493027392,0
3703,4,0,0,41,0.0,0.0,1.0,41,750,300,450,0.4,12,3,9,338.8525221409319,0.811280487804878,0.13779501676418393,0.20608899297423888,132755.5941358024,796.9135802469057,133552.50771604932,3511,12,735.1951219512196,38,3,18,33.63095238095237,0.6441885964912281,42.36111111111111,1030.555555555555,27.119883040935658,0
3704,4,0,0,41,0.0,0.0,1.0,41,950,500,450,0.5263157894736842,14,5,9,337.1282245229509,0.8093495934959349,0.1375467220634281,0.20579535071922808,132893.25741699527,760.4135848126076,133653.67100180787,3512,13,736.1951219512196,38,3,18,33.537327738058224,0.6455592105263158,42.227564102564095,1031.0897435897425,27.1339406207827,0
3705,4,0,0,41,0.0,0.0,1.0,41,1300,1000,300,0.7692307692307693,16,10,6,341.17383765486096,0.8080284552845528,0.13941611923108965,0.20918830160209476,133058.54752218936,879.219058185406,133937.76658037477,3513,14,737.1951219512196,38,3,18,33.267319043181125,0.647203947368421,42.06730769230769,1031.7307692307693,27.15080971659919,0
3706,4,0,0,41,0.0,0.0,1.0,41,900,600,300,0.6666666666666666,12,6,6,338.3276286828482,0.8064532520325203,0.1314882037249272,0.20821156358813236,133196.36774965294,812.8022499817321,134009.16999963467,3514,15,738.1951219512196,38,3,18,33.20266680466432,0.6485745614035088,41.93376068376068,1032.2649572649568,27.164867296446232,0
3707,4,0,0,41,0.0,0.0,1.0,41,1450,1200,250,0.8275862068965517,17,12,5,323.8722502972654,0.8064532520325203,0.10916736753574452,0.1806210626657825,129424.43828870411,183.68217126029327,129608.12045996441,3515,16,739.1951219512196,37,4,19,37.37517959770117,0.6126126126126126,45.614035087719294,1017.5438596491219,27.501185395922214,8
3708,4,0,0,41,0.0,0.0,1.0,41,1250,900,350,0.72,16,9,7,325.34744027379804,0.8076219512195122,0.1109698300774482,0.1819593756326468,129536.03512619252,228.84349030469411,129764.87861649721,3516,17,740.1951219512196,37,4,17,37.22443630618986,0.6137387387387387,45.504385964912274,1017.9824561403497,27.513039355144585,0
3709,4,0,0,41,0.0,0.0,1.0,41,1000,700,300,0.7,13,7,6,324.6666533127684,0.8064024390243902,0.12434612718220195,0.18209564468411774,129647.68005540149,218.45567867033878,129866.13573407182,3517,18,741.1951219512196,37,4,17,37.12855297157621,0.6148648648648649,45.39473684210525,1018.4210526315776,27.524893314366963,0
3710,4,1,1,41,0.023809523809523808,0.023809523809523808,0.9761904761904762,42,950,700,250,0.7368421052631579,12,7,5,319.6753895127613,0.8164440572977159,0.12186876793618429,0.18090300944103607,129996.88042534684,-88.63932291670648,129908.24110243014,3518,0,724.5238095238095,39,3,17,36.90202587674498,0.6148504273504276,45.052083333333314,1019.7916666666636,26.148504273504194,0
3711,4,0,0,41,0.0,0.0,1.0,41,1000,700,300,0.7,13,7,6,325.5648196957438,0.8045731707317073,0.12088788462816513,0.18381890588975033,129908.37191357995,258.7191358024329,130167.09104938238,3519,20,743.1951219512196,38,3,17,36.841507720254306,0.6156798245614037,45.13888888888887,1019.444444444442,26.827485380116894,0
3712,4,0,2,39,0.0,0.04878048780487805,0.9512195121951219,41,1150,1000,150,0.8695652173913043,13,10,3,323.9111087154677,0.8040650406504065,0.08559535303334842,0.1763770383500126,128477.80687326865,170.3385763995706,128648.14544966823,3520,21,744.1951219512196,37,4,15,38.33639772153724,0.6030405405405406,46.546052631578945,1013.8157894736839,27.400426742531998,6
3713,4,1,1,39,0.025,0.025,0.975,40,1150,1000,150,0.8695652173913043,13,10,3,332.8325518124018,0.8036858974358975,0.09128526994001351,0.18114622922703996,128458.27880245112,551.0193470497572,129009.29814950089,3521,0,761.2,36,4,16,38.13018403317781,0.6047453703703705,46.56531531531532,1013.738738738739,28.159409409409417,0
3714,4,2,2,39,0.04878048780487805,0.04878048780487805,0.9512195121951219,41,700,400,300,0.5714285714285714,10,4,6,325.24580983553346,0.8129065040650406,0.09004249575569667,0.17784717686751525,128644.60699445991,168.22387657741697,128812.83087103734,3522,0,743.5853658536586,37,4,16,38.132746072921165,0.6047297297297296,46.381578947368425,1014.473684210527,27.418207681365594,0
3715,4,2,1,40,0.04878048780487805,0.024390243902439025,0.975609756097561,41,1200,800,400,0.6666666666666666,16,8,8,325.6656180342572,0.8152439024390243,0.0935100541406424,0.17874922223821377,128794.39153928349,188.78102399738253,128983.17256328087,3523,0,744.5365853658536,38,3,17,37.96968740132617,0.6044407894736842,46.233974358974365,1015.0641025641036,26.712213225371148,0
3716,4,0,0,40,0.0,0.0,1.0,40,1000,600,400,0.6,14,6,8,328.85723155015256,0.8051549145299145,0.10224964891433541,0.18045236469826684,128783.6897530971,470.28953620345067,129253.97928930055,3524,1,764.15,37,3,17,37.899584998739705,0.6061373873873874,46.24451754385965,1015.0219298245613,27.43302513039355,0
3717,4,0,0,40,0.0,0.0,1.0,40,750,500,250,0.6666666666666666,10,5,5,326.795355476086,0.8046207264957265,0.09941960911348646,0.17982482394914023,128895.0100631925,424.458126538932,129319.46818973143,3525,2,765.15,37,3,18,37.83867382932008,0.6072635135135136,46.13486842105263,1015.4605263157894,27.444879089615927,0
3718,4,3,3,40,0.06976744186046512,0.06976744186046512,0.9302325581395349,43,850,700,150,0.8235294117647058,10,7,3,306.31861368276896,0.8257198228128461,0.09188069791245113,0.17101330603889472,129466.28146701412,-668.0499348356943,128798.23153217843,3526,0,712.6976744186046,39,4,11,37.779341521664975,0.6095085470085468,45.57291666666668,1017.7083333333353,26.09508547008552,0
3719,4,1,1,40,0.024390243902439025,0.024390243902439025,0.975609756097561,41,1100,700,400,0.6363636363636364,15,7,8,318.89293704201464,0.8179369918699188,0.09917016375855936,0.1773411800960267,129312.88954293623,47.393428747305364,129360.28297168354,3527,0,748.439024390244,37,4,19,37.614992094293534,0.6114864864864864,45.723684210526315,1017.1052631578942,27.489331436699842,0
3720,4,1,0,41,0.024390243902439025,0.0,1.0,41,1250,1000,250,0.8,15,10,5,314.2903497485913,0.8119918699186992,0.09958911739052811,0.17577539801601932,129536.03512619264,-57.6148430286234,129478.42028316401,3528,0,749.4146341463414,37,4,15,37.50583441045526,0.6137387387387387,45.50438596491228,1017.9824561403506,27.51303935514461,0
3721,4,0,1,40,0.0,0.024390243902439025,0.975609756097561,41,950,600,350,0.631578947368421,13,6,7,316.4623837700761,0.8119918699186992,0.08878316805146014,0.16940045248868763,127793.20987654307,-111.6512345679185,127681.55864197515,3529,1,750.4146341463414,38,3,17,39.22275641025642,0.5942982456140351,47.222222222222214,1011.1111111111101,26.608187134502895,3
3722,4,1,1,40,0.024390243902439025,0.024390243902439025,0.975609756097561,41,1500,1100,400,0.7333333333333333,19,11,8,315.93512508011787,0.8223577235772358,0.09383597638257757,0.16957334264504278,127901.25739644966,-118.30004930966993,127782.95734713998,3530,0,747.4146341463414,38,3,17,39.125871356147016,0.5953947368421053,47.11538461538461,1011.5384615384611,26.619433198380555,0
3723,4,1,1,40,0.024390243902439025,0.024390243902439025,0.975609756097561,41,1150,500,650,0.43478260869565216,18,5,13,318.3175108570353,0.8210873983739837,0.10029045814106796,0.17131269675214994,128009.3505734532,-50.476431806552625,127958.87414164664,3531,0,748.390243902439,38,3,17,38.955386050112594,0.5964912280701754,47.00854700854701,1011.9658119658123,26.63067926225822,0
3724,4,1,0,41,0.024390243902439025,0.0,1.0,41,800,700,100,0.875,9,7,2,318.5205752293992,0.8263719512195122,0.10332650392776621,0.17188502112037515,128117.48940755351,-38.38871539191592,128079.10069216159,3532,0,749.3658536585366,38,3,18,38.84000809061489,0.5975877192982456,46.901709401709404,1012.3931623931625,26.641925326135855,0
3725,4,2,3,40,0.046511627906976744,0.06976744186046512,0.9302325581395349,43,1100,700,400,0.6363636363636364,15,7,8,304.6385072826058,0.8387320044296788,0.0973119345140725,0.16658475139951154,128645.99745008687,-761.8922202161602,127884.1052298707,3533,0,715.4651162790698,39,4,12,38.65397285826745,0.6012286324786325,46.380208333333336,1014.4791666666672,26.012286324786338,0
3726,4,1,2,39,0.024390243902439025,0.04878048780487805,0.9512195121951219,41,1350,900,450,0.6666666666666666,18,9,9,321.5979099610502,0.8228150406504064,0.09809928673775525,0.17475188017460255,128394.44739006247,58.27718624963299,128452.7245763121,3534,0,751.3170731707318,37,4,12,38.479908218832264,0.6021959459459458,46.62828947368422,1013.4868421052644,27.391536273115253,0
3727,4,2,2,39,0.04878048780487805,0.04878048780487805,0.9512195121951219,41,1300,800,500,0.6153846153846154,18,8,10,318.34637147788476,0.8240345528455284,0.10834056939684622,0.17389991086369627,128604.6791675799,-11.833406384676124,128592.84576119523,3535,0,749.9268292682926,38,3,12,38.34834281300469,0.6025219298245613,46.42094017094018,1014.3162393162402,26.692532613585268,0
3728,4,1,0,40,0.025,0.0,1.0,40,700,500,200,0.7142857142857143,9,5,4,324.78875988042677,0.8198450854700855,0.11551789382635946,0.1772254418958155,128561.19340806812,351.046115150846,128912.23952321897,3536,0,769.65,37,3,14,38.22924550401846,0.6038851351351349,46.4638157894737,1014.1447368421074,27.40931721194885,0
3729,4,1,1,40,0.024390243902439025,0.024390243902439025,0.975609756097561,41,1050,700,350,0.6666666666666666,14,7,7,320.0028217783898,0.8286585365853658,0.11049519586104961,0.17600155197811468,128875.73964497066,48.12006903355848,128923.85971400421,3537,0,751.8536585365854,38,3,15,38.0306976010101,0.6052631578947366,46.15384615384617,1015.3846153846173,26.720647773279403,0
3730,4,3,2,41,0.06976744186046512,0.046511627906976744,0.9534883720930233,43,900,700,200,0.7777777777777778,11,7,4,314.3763321926803,0.8421926910299002,0.12801291222590638,0.17539362588179885,129439.78000217034,-461.0284307455835,128978.75157142476,3538,0,717.8139534883721,39,4,11,37.601191694816926,0.6092414529914529,45.59895833333334,1017.6041666666683,26.092414529914574,0
3731,4,3,1,43,0.06818181818181818,0.022727272727272728,0.9772727272727273,44,800,400,400,0.5,12,4,8,308.7719106224462,0.8373634601832277,0.13882339605531602,0.17360843544531832,129744.38707325346,-787.7155421706573,128956.6715310828,3539,0,702.4318181818181,40,4,13,37.43536990856193,0.6106770833333333,45.299796747967484,1018.800813008131,25.470020325203272,0
3732,4,0,0,43,0.0,0.0,1.0,43,1050,900,150,0.8571428571428571,12,9,3,313.2715778453909,0.8335640457733481,0.13929353009842105,0.1756740056848721,129640.87106095918,-477.43995389648114,129163.4311070627,3540,1,719.7674418604652,40,3,14,37.42557296344343,0.6096354166666667,45.40142276422765,1018.3943089430902,25.459857723577255,0
3733,4,2,0,45,0.044444444444444446,0.0,1.0,45,1100,800,300,0.7272727272727273,14,8,6,301.6371816733888,0.8448232323232324,0.15345975665094347,0.17120958953310572,130114.25212014,-1150.5407389880406,128963.71138115195,3541,0,688.7333333333333,42,3,16,37.24336752461457,0.611359126984127,44.93701550387597,1020.251937984496,24.291712809154667,0
3734,4,0,1,44,0.0,0.022222222222222223,0.9777777777777777,45,1600,1100,500,0.6875,21,11,10,303.93804937187764,0.8439814814814816,0.1610261928120087,0.17295405046104742,130213.1325209573,-1084.6548997956847,129128.47762116161,3542,1,689.7333333333333,42,3,17,37.084836545460306,0.6123511904761905,44.84011627906977,1020.6395348837211,24.300941306755266,0
3735,4,0,0,44,0.0,0.0,1.0,44,1450,1200,250,0.8275862068965517,17,12,5,313.0930139924276,0.8395657152924595,0.1744232963241228,0.178512194888876,130289.17236328112,-641.4552879207571,129647.71707536036,3543,2,706.2727272727273,39,5,18,36.77441502567766,0.6177884615384617,44.76562499999999,1020.937499999999,26.17788461538459,0
3736,4,2,1,45,0.043478260869565216,0.021739130434782608,0.9782608695652174,46,1450,1000,450,0.6896551724137931,19,10,9,301.1108754352374,0.8468800322061192,0.181074314140524,0.17410342950959656,130831.98594585642,-1321.0132353825115,129510.9727104739,3544,0,676.5217391304348,42,4,16,36.53311864620823,0.6185515873015873,44.234496124031,1023.0620155038744,24.358619416758913,0
3737,4,0,0,45,0.0,0.0,1.0,45,1450,1000,450,0.6896551724137931,19,10,9,305.65292283395763,0.8425925925925927,0.18088095853805752,0.1766756132434848,130820.18455530345,-1002.8856449987541,129817.2989103047,3545,1,692.5555555555555,41,4,16,36.428836953710906,0.6199186991869918,44.24603174603174,1023.0158730158719,24.951606658923705,0
3738,4,0,1,44,0.0,0.022222222222222223,0.9777777777777777,45,1550,1100,450,0.7096774193548387,20,11,9,304.44766727919756,0.8421296296296297,0.18188817367158827,0.17671347017238714,130980.72907277216,-1024.64451505318,129956.08455771898,3546,2,693.5555555555555,42,3,18,36.29800107282593,0.6200396825396826,44.08914728682171,1023.6434108527139,24.372462163159856,0
3739,4,0,0,44,0.0,0.0,1.0,44,900,600,300,0.6666666666666666,12,6,6,319.2340678044451,0.8371652572233967,0.17902820655404517,0.17297013890981405,128279.78326576077,-585.3507777223531,127694.43248803841,3547,3,710.2045454545455,38,6,21,38.65657737467482,0.5992324561403508,46.74145299145299,1013.0341880341875,26.658794421952305,7
3740,4,1,1,44,0.022222222222222223,0.022222222222222223,0.9777777777777777,45,1350,900,450,0.6666666666666666,18,9,9,313.05333331588423,0.8430976430976431,0.17395155582950994,0.17061932511180383,128513.93771701382,-953.6566840277819,127560.28103298604,3548,0,695.4,39,6,19,38.57484076433122,0.5998931623931625,46.510416666666664,1013.9583333333327,25.998931623931608,0
3741,4,0,0,44,0.0,0.0,1.0,44,900,300,600,0.3333333333333333,15,3,12,321.72322732325136,0.8361081747709656,0.17726889427637849,0.17491050186909343,128415.10662073537,-537.1754921835332,127877.93112855183,3549,5,712.2045454545455,38,6,19,38.45569375636837,0.6006030701754387,46.60790598290597,1013.568376068374,26.672852001799317,0
3742,4,0,0,44,0.0,0.0,1.0,44,1250,900,350,0.72,16,9,7,321.91191844446337,0.8352713178294574,0.17712614606386423,0.17525084303611618,128469.25593770505,-528.8430719921473,127940.4128657129,3550,6,713.2045454545455,38,6,19,38.395774054168,0.6011513157894739,46.55448717948716,1013.782051282048,26.678475033738106,0
3743,4,1,0,45,0.022222222222222223,0.0,1.0,45,1550,1100,450,0.7096774193548387,20,11,9,316.9826121975502,0.8377525252525253,0.18488268691428966,0.17414388604719966,128830.99500868039,-832.5629340277967,127998.43207465259,3551,0,698.3333333333334,39,6,20,38.15283193104863,0.6030982905982907,46.19791666666666,1015.208333333332,26.03098290598287,0
3744,4,2,2,45,0.0425531914893617,0.0425531914893617,0.9574468085106383,47,1400,1200,200,0.8571428571428571,16,12,4,304.44206137534246,0.8477104532839962,0.18511655125329218,0.16936757760615176,129327.49438027486,-1525.4542036722498,127802.0401766026,3552,0,669.5744680851063,41,6,21,37.967647680353714,0.604928861788618,45.70932539682538,1017.1626984126951,24.808846302748663,0
3745,4,0,0,45,0.0,0.0,1.0,45,1150,1000,150,0.8695652173913043,13,10,3,316.1112604138675,0.8399410774410775,0.18888888888888933,0.1752980625931443,129201.38888888851,-831.597222222261,128369.79166666625,3553,1,698.7111111111111,39,6,22,37.79883879781422,0.606837606837607,45.833333333333314,1016.6666666666637,26.06837606837599,0
3746,4,0,0,45,0.0,0.0,1.0,45,1050,800,250,0.7619047619047619,13,8,5,316.7224193054157,0.8404461279461279,0.18651923142554883,0.17646479574192767,129386.78521050331,-804.0608723958532,128582.72433810745,3554,2,699.7111111111111,39,6,22,37.59523992355211,0.6087072649572651,45.65104166666666,1017.395833333332,26.087072649572615,0
3747,4,0,0,45,0.0,0.0,1.0,45,1050,800,250,0.7619047619047619,13,8,5,331.603032579742,0.8409090909090909,0.14196510560146947,0.17445203018325547,127092.01388888882,-507.6307508680602,126584.38313802076,3555,3,700.7111111111111,40,5,20,39.557506887052355,0.5838541666666668,47.916666666666664,1008.3333333333327,25.208333333333318,8
3748,4,1,0,46,0.021739130434782608,0.0,1.0,46,1150,900,250,0.782608695652174,14,9,5,339.1322317381979,0.8491545893719807,0.16420027937838344,0.182779059962795,128067.37061273053,-504.9648026968039,127562.40581003373,3556,0,686.4565217391304,40,6,18,38.36951974564928,0.59375,46.951219512195124,1012.1951219512196,25.304878048780488,5
3749,4,1,1,46,0.02127659574468085,0.02127659574468085,0.9787234042553191,47,1450,1000,450,0.6896551724137931,19,10,9,329.3933265429143,0.8526056120875731,0.17146237024942113,0.1789937353171495,128395.7703451751,-941.4580183925435,127454.31232678256,3557,0,672.8297872340426,41,6,14,38.28104607152179,0.5955284552845528,46.62698412698413,1013.4920634920634,24.719318621757644,0
3750,4,0,0,46,0.0,0.0,1.0,46,1250,900,350,0.72,16,9,7,333.32282542993573,0.8490136876006441,0.1707526525488008,0.18127382011113316,128427.65239771309,-638.4264078921165,127789.22598982097,3558,2,688.4565217391304,40,6,15,38.148979012098124,0.5973958333333333,46.59552845528456,1013.6178861788625,25.340447154471562,0
3751,4,2,1,47,0.041666666666666664,0.020833333333333332,0.9791666666666666,48,1050,700,350,0.6666666666666666,14,7,7,321.69686889457216,0.8596889775413712,0.1755668257756564,0.1765204139167441,128783.04268260625,-1314.1796804579028,127468.86300214834,3559,0,660.7291666666666,42,6,16,38.08194112967382,0.5979662698412698,46.24515503875969,1015.0193798449615,24.1671280915467,0
3752,4,0,0,47,0.0,0.0,1.0,47,1200,600,600,0.5,18,6,12,334.23022164134494,0.85572772124576,0.1776487614991764,0.18346800578509917,128798.26467624112,-790.345490047848,128007.91918619326,3560,1,675.7872340425532,41,6,17,37.748403700807934,0.5995934959349591,46.23015873015874,1015.0793650793671,24.75803329461871,0
3753,4,1,0,48,0.020833333333333332,0.0,1.0,48,700,300,400,0.42857142857142855,11,3,8,334.9187819815429,0.8580821513002364,0.18536681285155887,0.18538063874429594,129127.51379311652,-950.5540720208971,128176.95972109563,3561,0,662.6875,42,6,19,37.395922712683145,0.6014384920634919,45.90600775193799,1016.375968992249,24.199427833148786,0
3754,4,0,0,48,0.0,0.0,1.0,48,1300,800,500,0.6153846153846154,18,8,10,333.9828137490007,0.8564753250591016,0.19010624833466538,0.18569444444444447,129304.72932778116,-962.846281041984,128341.88304673917,3562,1,663.6875,40,8,19,37.239583333333314,0.60625,45.73170731707317,1017.0731707317079,25.4268292682927,0
3755,4,1,3,46,0.02040816326530612,0.061224489795918366,0.9387755102040817,49,900,500,400,0.5555555555555556,13,5,8,336.3453254856926,0.859906462585034,0.12482148378262958,0.1796124762348747,127696.68104383671,-1162.7963720984012,126533.88467173831,3563,0,651.1224489795918,39,10,17,38.81885756982376,0.5916132478632479,47.31770833333333,1010.7291666666658,25.916132478632456,7
3756,4,3,3,46,0.061224489795918366,0.061224489795918366,0.9387755102040817,49,1550,1400,150,0.9032258064516129,17,14,3,335.01525139006964,0.8641227324263039,0.1338934609407354,0.17986741166864867,127913.11905115983,-1229.4308529975729,126683.68819816226,3564,0,651.1428571428571,40,9,18,38.6312453954859,0.5921875000000001,47.10365853658536,1011.585365853657,25.289634146341424,0
3757,4,2,0,48,0.041666666666666664,0.0,1.0,48,950,600,350,0.631578947368421,13,6,7,342.2079638470813,0.8613696808510638,0.15482900923161402,0.18394388228260644,127960.02739800341,-842.2119140625048,127117.81548394091,3565,0,665.5625,39,9,20,38.40139074779507,0.594284188034188,47.057291666666664,1011.7708333333328,25.942841880341867,0
3758,4,3,3,48,0.058823529411764705,0.058823529411764705,0.9411764705882353,51,1100,800,300,0.7272727272727273,14,8,6,322.5492899183501,0.8733660130718955,0.15511409536587717,0.1756783569544097,128487.53390842002,-1910.8886718750118,126576.64523654501,3566,0,627.3529411764706,39,12,12,38.361009794855974,0.5996260683760685,46.53645833333333,1013.8541666666657,25.99626068376066,0
3759,4,2,1,49,0.04,0.02,0.98,50,1350,1100,250,0.8148148148148148,16,11,5,333.659283494736,0.8692857142857142,0.16406826082376513,0.18214074630336546,128577.58881446769,-1419.7787685367935,127157.81004593089,3567,0,640.86,38,12,14,37.98764001544999,0.6022478070175439,46.44764957264957,1014.2094017094006,26.689721097615806,0
3760,4,0,3,46,0.0,0.061224489795918366,0.9387755102040817,49,1100,900,200,0.8181818181818182,13,9,4,327.10498987321574,0.8656462585034014,0.12480701210600587,0.17177552799853943,127018.74441327158,-1490.3069789976373,125528.43743427393,3568,1,654.3469387755102,42,7,20,39.74594668204686,0.5801091269841269,47.98934108527133,1008.0426356589159,24.001015134736093,5
3761,4,8,3,51,0.14814814814814814,0.05555555555555555,0.9444444444444444,54,1200,700,500,0.5833333333333334,17,7,10,330.8462229545948,0.8858315863032844,0.26488343173119855,0.17488671969277056,127285.5725439558,-2135.8570494310916,125149.71549452472,3569,0,594.2407407407408,37,17,22,39.37835035676771,0.5909346846846846,47.72478070175438,1009.1008771929822,27.272996680891413,8
3762,4,6,6,51,0.10526315789473684,0.10526315789473684,0.8947368421052632,57,1050,600,450,0.5714285714285714,15,6,9,314.7785638403989,0.8882623224728488,0.3052721237601277,0.17119769505301696,128429.74044568224,-3303.060113765401,125126.68033191684,3570,0,563.7719298245614,36,21,13,38.61677406214124,0.6044560185185185,46.59346846846847,1013.6261261261267,28.156281281281295,0
3763,4,0,1,50,0.0,0.0196078431372549,0.9803921568627451,51,1500,1100,400,0.7333333333333333,19,11,8,355.1732427054724,0.8724183006535948,0.30942806528313826,0.18970813018635418,127705.4548852238,-1128.4878954475284,126576.96698977627,3571,1,594.4313725490196,35,16,19,38.33412057712127,0.5991071428571428,47.30902777777778,1010.763888888889,28.878968253968257,0
3764,4,4,3,51,0.07407407407407407,0.05555555555555555,0.9444444444444444,54,1250,900,350,0.72,16,9,7,324.1211865920489,0.88501630561379,0.30692969581858454,0.17729251791182582,128658.13607103737,-2457.573893044214,126200.56217799315,3572,0,555.6851851851852,36,18,16,38.14750064750065,0.6067708333333334,46.36824324324325,1014.527027027028,28.181306306306332,0
3765,4,0,0,51,0.0,0.0,1.0,51,1600,1000,600,0.625,22,10,12,350.77439651238086,0.8750653594771243,0.32371922631588923,0.18971201654308326,128206.57920030746,-1205.682910419086,127000.89628988838,3573,1,589.3725490196078,33,18,20,37.93259922555662,0.6085858585858586,46.81372549019607,1012.7450980392148,30.68924539512772,0
3766,4,0,0,51,0.0,0.0,1.0,51,800,700,100,0.875,9,7,2,351.78538159028324,0.8748039215686275,0.3282979576250482,0.19070227866274558,128299.67928501051,-1173.209672962329,127126.46961204818,3574,2,590.3725490196078,33,18,20,37.811857384782876,0.6095328282828283,46.72181372549019,1013.1127450980388,30.700386215092085,0
3767,4,1,1,51,0.019230769230769232,0.019230769230769232,0.9807692307692307,52,900,600,300,0.6666666666666666,12,6,6,343.4280575252825,0.8799805178481648,0.32288465928045995,0.18736716314050572,128555.01570001704,-1570.1201346022003,126984.89556541484,3575,0,580.0,35,17,17,37.76297268507954,0.6077380952380952,46.469907407407405,1014.1203703703695,28.9748677248677,0
3768,4,2,2,51,0.03773584905660377,0.03773584905660377,0.9622641509433962,53,1450,800,650,0.5517241379310345,21,8,13,336.4467254908458,0.882710449927431,0.3287130866552468,0.18563216578916938,129001.10995708547,-1919.5997940508137,127081.51016303466,3576,0,570.0188679245283,36,17,18,37.4856815578465,0.6102430555555556,46.0304054054054,1015.8783783783784,28.218843843843846,0
3769,4,0,1,50,0.0,0.0196078431372549,0.9803921568627451,51,1100,600,500,0.5454545454545454,16,6,10,347.38687890770484,0.8771568627450981,0.33142887798074105,0.19093218682821958,128848.62075617274,-1247.9359567901352,127600.6847993826,3577,1,590.7843137254902,35,16,18,37.36320109439124,0.6107142857142858,46.18055555555555,1015.2777777777769,29.007936507936485,0
3770,4,1,1,50,0.0196078431372549,0.0196078431372549,0.9803921568627451,51,1350,800,550,0.5925925925925926,19,8,11,348.42684407379403,0.879248366013072,0.32380645968505983,0.19207248640650845,128966.15655006857,-1212.945816186555,127753.210733882,3578,0,591.6078431372549,35,16,19,37.21703129747799,0.6119047619047618,46.06481481481482,1015.7407407407405,29.021164021164015,0
3771,4,2,2,50,0.038461538461538464,0.038461538461538464,0.9615384615384616,52,1750,1200,550,0.6857142857142857,23,12,11,356.2802585298917,0.8833270487682251,0.29836496264658874,0.19634751156205688,128955.22072742016,-1133.7852955588692,127821.43543186129,3579,0,581.1923076923077,42,10,16,37.02875564459709,0.5997023809523809,46.075581395348834,1015.697674418604,24.183277962347717,8
3772,4,1,0,51,0.0196078431372549,0.0,1.0,51,1300,900,400,0.6923076923076923,17,9,8,372.04832955462393,0.874967320261438,0.3322789836145257,0.2061860050268377,129176.1751720363,-588.0439617976884,128588.1312102386,3580,0,593.5098039215686,41,10,18,36.402829283367495,0.6034044715447153,45.85813492063492,1016.5674603174594,24.79432830042584,0
3773,4,0,0,51,0.0,0.0,1.0,51,1750,1200,550,0.6857142857142857,23,12,11,373.65387179846556,0.8745424836601308,0.3378446236105588,0.20748629672904542,129254.34570312487,-540.7177353001528,128713.62796782472,3581,1,594.5098039215686,39,12,18,36.28226797787338,0.6073717948717949,45.78124999999999,1016.874999999999,26.073717948717924,0
3774,4,2,2,51,0.03773584905660377,0.03773584905660377,0.9622641509433962,53,1850,1300,550,0.7027027027027027,24,13,11,363.3725185157308,0.8808357522980164,0.33260022379133436,0.20424041557953118,129731.44531249985,-1171.8315972222374,128559.61371527762,3582,0,573.0377358490566,41,12,15,36.05785616905248,0.6089939024390245,45.31249999999999,1018.7499999999989,24.847560975609728,0
3775,4,0,2,49,0.0,0.0392156862745098,0.9607843137254902,51,1450,1300,150,0.896551724137931,16,13,3,375.58931759955374,0.8727450980392157,0.33461537689873877,0.21011072701204592,129545.80213758688,-468.7961154513784,129077.00602213551,3583,3,596.5098039215686,39,12,15,35.935847914321776,0.610309829059829,45.49479166666667,1018.020833333334,26.103098290598307,0
3776,4,0,2,47,0.0,0.04081632653061224,0.9591836734693877,49,1250,800,450,0.64,17,8,9,383.53941557959797,0.8682327097505669,0.3327091911717446,0.21416157519409448,129473.0771513625,131.60566878516062,129604.68282014766,3584,4,609.7142857142857,38,11,15,35.80770172860243,0.6112938596491228,45.56623931623932,1017.7350427350434,26.782501124606405,0
3777,4,1,3,45,0.020833333333333332,0.0625,0.9375,48,950,600,350,0.631578947368421,13,6,7,384.6763405972673,0.8675384160756501,0.3420977915225216,0.21674114666020874,129826.69850107755,388.2518582438522,130214.9503593214,3585,0,613.3125,38,10,16,35.41819547821227,0.6148574561403508,45.2190170940171,1019.123931623932,26.819050832208735,0
3778,4,1,0,46,0.021739130434782608,0.0,1.0,46,1050,500,550,0.47619047619047616,16,5,11,388.44222934070814,0.8630837359098229,0.336139243487682,0.20917863341976278,128033.53555901808,763.9904863636727,128797.52604538176,3586,0,628.1521739130435,37,9,16,37.15646442759119,0.598536036036036,46.984649122807014,1012.0614035087713,27.353010905642467,6
3779,4,3,1,48,0.061224489795918366,0.02040816326530612,0.9795918367346939,49,1100,800,300,0.7272727272727273,14,8,6,369.6762829762464,0.874858276643991,0.3571106676108933,0.20415920157398962,129038.51290269547,-259.4082544287768,128779.10464826669,3587,0,590.6326530612245,38,11,16,36.603575184016805,0.6069078947368423,45.99358974358974,1016.02564102564,26.73751686909579,0
3780,4,1,1,48,0.02040816326530612,0.02040816326530612,0.9795918367346939,49,1350,600,750,0.4444444444444444,21,6,15,367.81033425504563,0.8736181972789115,0.35383400435466683,0.2035678557213455,129123.91067031866,-301.3782512062842,128822.53241911237,3588,0,591.1632653061224,40,9,16,36.56384361563843,0.6044270833333333,45.90955284552846,1016.3617886178866,25.409044715447166,0
3781,4,1,0,49,0.02040816326530612,0.0,1.0,49,1600,1100,500,0.6875,21,11,10,370.0024654000615,0.8775510204081632,0.353270005965185,0.2057796962742216,129315.90374157953,-230.46640941106784,129085.43733216847,3589,0,592.1428571428571,36,13,18,36.31232469737231,0.6134259259259258,45.72072072072073,1017.117117117118,28.253253253253277,0
3782,4,0,1,48,0.0,0.02040816326530612,0.9795918367346939,49,1050,900,150,0.8571428571428571,12,9,3,367.98333203019905,0.8765589569160998,0.35207469441960093,0.20525292519906668,129430.46932067208,-274.34892662932225,129156.12039404277,3590,1,593.1428571428571,36,13,13,36.246910506123655,0.6145833333333334,45.60810810810811,1017.5675675675681,28.265765765765778,0
3783,4,3,3,48,0.058823529411764705,0.058823529411764705,0.9411764705882353,51,1100,600,500,0.5454545454545454,16,6,10,350.65306078858544,0.8884313725490197,0.3419518134051005,0.1987034011135318,130050.00000000001,-1079.5138888888882,128970.48611111112,3591,0,563.1960784313726,39,12,15,36.05834694989105,0.6153846153846154,45.0,1020.0000000000001,26.153846153846157,0
3784,4,1,1,48,0.02040816326530612,0.02040816326530612,0.9795918367346939,49,1500,1100,400,0.7333333333333333,19,11,8,365.2483404376479,0.8786493764172336,0.34902679737844533,0.205881341683926,129843.17440222,-314.9992064866034,129528.17519573339,3592,0,587.1224489795918,37,12,16,35.89642729065806,0.6168355855855856,45.202850877192986,1019.1885964912287,27.545637743006182,0
3785,4,0,1,47,0.0,0.020833333333333332,0.9791666666666666,48,1450,900,550,0.6206896551724138,20,9,11,344.992051090528,0.875849586288416,0.1627360500391999,0.19377813139656969,129704.91672092034,-524.2510390817102,129180.66568183864,3593,2,600.3541666666666,39,9,14,36.5529237822545,0.6119123931623931,45.33854166666668,1018.6458333333351,26.119123931623978,8
3786,4,0,0,47,0.0,0.0,1.0,47,1200,1100,100,0.9166666666666666,13,11,2,346.08495199983815,0.8689870490286771,0.17842181107596433,0.1948617634105349,129799.47973738053,-415.670657096927,129383.80908028361,3594,7,614.0851063829788,38,9,15,36.42906444397846,0.6145833333333333,45.2457264957265,1019.0170940170952,26.816239316239347,0
3787,4,0,1,46,0.0,0.02127659574468085,0.9787234042553191,47,1850,1500,350,0.8108108108108109,22,15,7,390.14086868974505,0.8679463459759481,0.19385081711056573,0.22065743697599277,129975.3485537904,776.4413258479601,130751.78987963837,3595,8,615.0851063829788,36,11,14,35.127461807472855,0.6200810185185185,45.073198198198206,1019.7072072072083,28.32520020020023,4
3788,4,1,1,46,0.02127659574468085,0.02127659574468085,0.9787234042553191,47,1750,1400,350,0.8,21,14,7,388.6056791822304,0.8647471477027443,0.22751631559399366,0.22175157191110184,130321.6695066014,729.0652181679809,131050.73472476938,3596,0,615.8936170212766,35,12,15,34.814006650041556,0.6255952380952381,44.73379629629629,1021.0648148148141,29.173280423280403,0
3789,4,2,1,47,0.041666666666666664,0.020833333333333332,0.9791666666666666,48,1450,900,550,0.6206896551724138,20,9,11,374.6774600600731,0.8658392434988179,0.26573102620315225,0.21712252812555596,130917.78897518077,210.388929980269,131128.17790516105,3597,0,603.8333333333334,38,10,13,34.56454222778996,0.6258223684210527,44.15064102564102,1023.3974358974356,26.931511470985146,0
3790,4,2,0,49,0.04081632653061224,0.0,1.0,49,850,600,250,0.7058823529411765,11,6,5,368.8798411482541,0.8649730725623583,0.2788144255944909,0.21638415424057408,131385.8453047644,-104.95589219274964,131280.88941257165,3598,0,592.469387755102,36,13,15,34.23907073813708,0.6342592592592592,43.6936936936937,1025.2252252252267,28.47847847847852,0
3791,4,1,1,49,0.02,0.02,0.98,50,1400,900,500,0.6428571428571429,19,9,10,360.87182066568175,0.8664795918367346,0.27582014987510406,0.2135010131130462,131711.68456424866,-493.79291767112613,131217.89164657754,3599,0,581.6,38,12,13,34.115233832917,0.6337719298245614,43.376068376068375,1026.4957264957263,27.01304543409806,0
3792,4,0,1,48,0.0,0.02040816326530612,0.9795918367346939,49,1400,1000,400,0.7142857142857143,18,10,8,369.6603866041267,0.8651502267573696,0.2841528147912298,0.2181136127264451,131609.2511638197,-69.85466682055323,131539.39649699914,3600,2,594.469387755102,37,12,13,33.9931965519698,0.634572072072072,43.47587719298246,1026.0964912280706,27.732337600758665,0
3793,4,1,1,48,0.02040816326530612,0.02040816326530612,0.9795918367346939,49,1850,1300,550,0.7027027027027027,24,13,11,367.32364064325037,0.861890589569161,0.2739523533422108,0.21747460646586514,131739.10307774486,-121.8226084812697,131617.28046926358,3601,0,595.4081632653061,38,11,13,33.92197419086272,0.634046052631579,43.34935897435897,1026.6025641025637,27.015856950067466,0
3794,4,0,3,45,0.0,0.0625,0.9375,48,1400,800,600,0.5714285714285714,20,8,12,374.7451694298695,0.8590610224586288,0.28266878538617646,0.22160388698881933,131693.64762474992,270.31165839488756,131963.95928314482,3602,4,608.8125,37,11,13,33.77744097852793,0.6354166666666667,43.39364035087719,1026.4254385964912,27.74122807017544,0
3795,4,1,0,46,0.021739130434782608,0.0,1.0,46,1100,900,200,0.8181818181818182,13,9,4,376.23363826134545,0.8552334943639291,0.28061616050871563,0.22355876316493387,131876.9799148812,723.3111912588331,132600.29110614004,3603,0,587.8913043478261,36,10,15,33.55397799948837,0.6391782407407407,43.215090090090094,1027.1396396396403,28.531656656656676,0
3796,4,1,1,46,0.02127659574468085,0.02127659574468085,0.9787234042553191,47,1300,900,400,0.6923076923076923,17,9,8,370.6089062660277,0.8609697810669132,0.2832675079909175,0.22210485187661777,132200.59447378016,398.9435451292469,132599.5380189094,3604,0,576.3617021276596,37,10,16,33.37187244553434,0.6404842342342343,42.9002192982456,1028.3991228070156,27.794570886676098,0
3797,4,0,1,45,0.0,0.021739130434782608,0.9782608695652174,46,1350,1100,250,0.8148148148148148,16,11,5,380.1138830813178,0.8568035426731079,0.28683871207131717,0.22695462038243724,132059.67821829763,839.54341720526,132899.22163550288,3605,2,589.8913043478261,37,9,16,33.26977099779533,0.6390765765765767,43.03728070175437,1027.8508771929799,27.779753437648104,0
3798,4,0,1,44,0.0,0.022222222222222223,0.9777777777777777,45,1100,900,200,0.8181818181818182,13,9,4,382.4465777120297,0.8571969696969698,0.27959802806219236,0.22868744340739697,132116.03570329305,1105.46514312093,133221.50084641398,3606,3,579.0888888888888,37,8,16,33.15290813424345,0.6396396396396398,42.98245614035086,1028.0701754385943,27.785680417259307,0
3799,4,0,0,44,0.0,0.0,1.0,44,1000,500,500,0.5,15,5,10,383.899588511739,0.8540565539112052,0.28739010961659117,0.22986145198037322,132166.31063073207,1347.7184532505491,133514.02908398263,3607,4,592.3636363636364,36,8,16,33.06478844960391,0.6420717592592593,42.93355855855856,1028.2657657657658,28.56293793793794,0
3800,4,0,1,43,0.0,0.022727272727272728,0.9772727272727273,44,850,400,450,0.47058823529411764,13,4,9,381.68304919158766,0.853704193093728,0.28074924856181704,0.22905998497476757,132253.17166828993,1295.75876552228,133548.9304338122,3608,5,593.3636363636364,36,8,16,33.03408510327712,0.6429398148148149,42.8490990990991,1028.6036036036037,28.572322322322325,0
3801,4,0,0,43,0.0,0.0,1.0,43,1500,1200,300,0.8,18,12,6,379.9625566797064,0.851328903654485,0.2825250623377946,0.22908032770794964,132426.97934420907,1463.4587289992692,133890.43807320835,3609,6,606.8372093023256,36,7,16,32.902990517870165,0.6446759259259259,42.68018018018018,1029.2792792792793,28.59109109109109,0
3802,4,0,0,43,0.0,0.0,1.0,43,1350,900,450,0.6666666666666666,18,9,9,381.06492177992544,0.8498062015503876,0.28906379137157123,0.2306312845583997,132571.90626014533,1503.700617847582,134075.60687799292,3610,7,607.8372093023256,36,7,16,32.72849462365591,0.6461226851851851,42.539414414414416,1029.8423423423428,28.606731731731745,0
3803,4,0,0,43,0.0,0.0,1.0,43,1050,900,150,0.8571428571428571,12,9,3,385.01872430033154,0.8501753414544112,0.2864369896584338,0.2335644091445247,132658.90045450858,1615.2321240159129,134274.1325785245,3611,8,608.8372093023256,36,7,14,32.53898848564349,0.6469907407407407,42.45495495495496,1030.1801801801803,28.616116116116117,0
3804,4,1,0,44,0.022727272727272728,0.0,1.0,44,1500,900,600,0.6,21,9,12,378.15732160211024,0.8511495771670191,0.27936572356215206,0.23162135948129253,133019.3905817174,1260.4512927054404,134279.84187442283,3612,0,595.9772727272727,37,7,15,32.35278486394557,0.6486486486486487,42.10526315789473,1031.5789473684206,27.880512091038394,0
3805,4,0,0,44,0.0,0.0,1.0,44,1450,1000,450,0.6896551724137931,19,10,9,376.0293726500844,0.8498722692036645,0.2813459644243581,0.23136866105411072,133189.11227493067,1216.6036665127626,134405.71594144343,3613,1,596.9772727272727,37,7,16,32.237005169605546,0.6503378378378378,41.940789473684205,1032.2368421052627,27.898293029871965,0
3806,4,0,0,44,0.0,0.0,1.0,44,1200,900,300,0.75,15,9,6,375.59159228915223,0.8481985553206484,0.2796933664063932,0.23198014477190332,133330.62967691984,1215.5727002539234,134546.20237717376,3614,2,597.9772727272727,37,7,16,32.10609318045086,0.6517454954954955,41.80372807017544,1032.7850877192984,27.913110478899956,0
3807,4,0,1,43,0.0,0.022727272727272728,0.9772727272727273,44,1200,800,400,0.6666666666666666,16,8,8,375.1079543261218,0.8487711416490487,0.2834977760607047,0.23274954001695908,133501.31539901404,1215.5562071474506,134716.8716061615,3615,3,598.9772727272727,36,8,16,31.947168646253314,0.6553819444444444,41.63851351351352,1033.4459459459474,28.706831831831874,0
3808,4,0,0,43,0.0,0.0,1.0,43,1550,1200,350,0.7741935483870968,19,12,7,389.67494102785054,0.8437615356220007,0.29657218313986067,0.2417934363056064,133502.1235880701,1804.486427254798,135306.6100153249,3616,4,613.6279069767442,35,8,16,31.57000130660396,0.6574404761904762,41.63773148148148,1033.4490740740737,29.52711640211639,0
3809,4,0,0,43,0.0,0.0,1.0,43,1250,900,350,0.72,16,9,7,388.3772030483858,0.8428848283499446,0.2988933160749063,0.24174176957201607,133617.71981018205,1778.8152595163,135396.53506969835,3617,5,614.6279069767442,36,7,16,31.487356134044965,0.6565393518518517,41.525900900900915,1033.8963963963984,28.7193443443444,0
3810,4,0,0,43,0.0,0.0,1.0,43,1200,800,400,0.6666666666666666,16,8,8,386.22544093779055,0.8427925433739387,0.2985859148510588,0.24116116077590832,133734.174947752,1730.3081375294441,135464.48308528145,3618,6,615.6279069767442,36,7,16,31.426011613137362,0.6576967592592592,41.4132882882883,1034.3468468468484,28.7318568568569,0
3811,4,0,0,43,0.0,0.0,1.0,43,1450,1300,150,0.896551724137931,16,13,3,386.71890129602633,0.8423311184939092,0.29871329811336,0.24185068388063968,133792.4215389377,1748.0116518545688,135540.43319079225,3619,7,616.6279069767442,36,7,16,31.354767606400358,0.6582754629629629,41.35698198198199,1034.572072072073,28.73811311311314,0
3812,4,0,0,43,0.0,0.0,1.0,43,1000,700,300,0.7,13,7,6,395.5211686679217,0.8419158361018826,0.3190231036494129,0.24407329183612655,133297.72973987498,1944.4147694992268,135242.1445093742,3620,8,617.6279069767442,36,7,16,31.624636495819697,0.6533564814814815,41.835585585585584,1032.6576576576574,28.68493493493493,1
3813,4,0,0,43,0.0,0.0,1.0,43,1450,1100,350,0.7586206896551724,18,11,7,395.51195666178126,0.8414082687338501,0.3160184464517961,0.2446413471651059,133384.96171424803,1951.069439371801,135336.03115361984,3621,9,618.6279069767442,36,7,16,31.53707438497038,0.6542245370370371,41.751126126126124,1032.9954954954953,28.694319319319316,0
3814,4,1,1,43,0.022727272727272728,0.022727272727272728,0.9772727272727273,44,850,300,550,0.35294117647058826,14,3,11,390.95172396665413,0.8413495419309374,0.3121149451884424,0.24331906305488957,133613.88991083775,1647.3161213065341,135261.20603214428,3622,0,605.5454545454545,37,7,17,31.424660621486886,0.654560810810811,41.52960526315788,1033.8815789473667,27.94274537695586,0
3815,4,0,1,42,0.0,0.023255813953488372,0.9767441860465116,43,1000,600,400,0.6,14,6,8,401.09921849327054,0.8378552971576227,0.31207736567544186,0.24926809252198595,133559.5112637977,2114.123118050494,135673.63438184818,3623,1,619.3953488372093,36,7,17,31.217089733812685,0.6559606481481481,41.58220720720721,1033.671171171172,28.713088088088114,0
3816,4,0,0,42,0.0,0.0,1.0,42,1200,900,300,0.75,15,9,6,399.9424241463248,0.8373741773132017,0.3040651923734876,0.24992320464000992,133763.29665814489,2299.523425452513,136062.82008359738,3624,2,621.8095238095239,36,6,15,31.042029537702323,0.6579861111111109,41.38513513513515,1034.4594594594614,28.73498498498504,0
3817,4,0,1,41,0.0,0.023809523809523808,0.9761904761904762,42,950,500,450,0.5263157894736842,14,5,9,398.4790362024231,0.837059620596206,0.2655255308729916,0.23901293965861198,132233.1242809005,2138.4255834976716,134371.54986439817,3625,3,622.8095238095239,38,4,15,32.62244208995533,0.6389802631578949,42.86858974358973,1028.525641025639,27.06646423751682,4
3818,4,0,1,40,0.0,0.024390243902439025,0.975609756097561,41,850,500,350,0.5882352941176471,12,5,7,404.358770703703,0.8351117886178862,0.28097269779861267,0.24269287447034116,132256.9820161009,2495.8541330024427,134752.83614910333,3626,14,638.9268292682926,37,4,15,32.44712273034148,0.6410472972972974,42.845394736842096,1028.6184210526299,27.800497866287294,0
3819,4,0,1,39,0.0,0.025,0.975,40,1500,1100,400,0.7333333333333333,19,11,8,405.3119721170654,0.830849358974359,0.29404423034814986,0.24324044371335587,132253.17166828993,2720.75876552228,134973.9304338122,3627,15,654.725,36,4,15,32.426465221516665,0.6429398148148149,42.8490990990991,1028.6036036036037,28.572322322322325,0
3820,4,0,0,39,0.0,0.0,1.0,39,1150,800,350,0.6956521739130435,15,8,7,414.6449748485203,0.8257422402159245,0.3080154169263085,0.24901111732794892,132278.91375171448,3169.75737311383,135448.6711248283,3628,30,672.1282051282051,35,4,16,32.16040354035403,0.6452380952380954,42.82407407407406,1028.703703703702,29.391534391534346,0
3821,4,0,0,39,0.0,0.0,1.0,39,950,500,450,0.5263157894736842,14,5,9,416.57351886132403,0.824842555105713,0.3130454846990287,0.2505641801540707,132338.45191400874,3225.7389188957295,135564.19083290445,3629,31,673.1282051282051,35,4,16,32.050524934383205,0.6458333333333335,42.766203703703695,1028.9351851851839,29.39814814814811,0
3822,4,0,0,39,0.0,0.0,1.0,39,850,500,350,0.5882352941176471,12,5,7,414.2805631020077,0.8225371120107963,0.30941811744402314,0.24998492876085518,132459.2704790247,3175.0736283453457,135634.34410737007,3630,32,674.1282051282051,34,5,16,31.987249913264712,0.6492034313725491,42.64880952380951,1029.40476190476,30.27661064425765,0
3823,4,0,0,39,0.0,0.0,1.0,39,900,700,200,0.7777777777777778,11,7,4,408.74624270797347,0.8217498875393613,0.303252842087794,0.24765213528777216,132612.49999999997,3040.972222222223,135653.4722222222,3631,33,675.1282051282051,34,5,16,31.9747842502697,0.650735294117647,42.5,1029.9999999999998,30.294117647058815,0
3824,4,0,0,39,0.0,0.0,1.0,39,1400,1000,400,0.7142857142857143,18,10,8,407.2341073224231,0.8201754385964912,0.2995826706118958,0.2477460061201839,132765.8180980726,3013.3538832199656,135779.17198129257,3632,34,676.1282051282051,34,5,15,31.858852181279122,0.652267156862745,42.35119047619048,1030.5952380952385,30.311624649859958,0
3825,4,0,0,39,0.0,0.0,1.0,39,1150,900,250,0.782608695652174,14,9,5,408.68133165875594,0.8188821412505624,0.29974695788100947,0.24915295147738128,132845.06715374233,3058.259789737658,135903.32694348,3633,35,677.1282051282051,35,4,15,31.741537554732233,0.6508928571428572,42.27430555555556,1030.902777777778,29.454365079365086,0
3826,4,0,1,38,0.0,0.02564102564102564,0.9743589743589743,39,600,500,100,0.8333333333333334,7,5,2,408.68133165875594,0.8193882141250562,0.29974695788100947,0.24915295147738128,132845.06715374233,3058.259789737658,135903.32694348,3634,36,678.1282051282051,35,4,15,31.741537554732233,0.6508928571428572,42.27430555555556,1030.902777777778,29.454365079365086,0
3827,4,0,0,38,0.0,0.0,1.0,38,950,700,250,0.7368421052631579,12,7,5,413.2042413154902,0.8189900426742532,0.30007900814391597,0.2519963894219824,132857.8514739231,3379.48554421771,136237.33701814082,3635,37,693.0526315789474,34,4,15,31.61205735180908,0.6531862745098038,42.26190476190477,1030.9523809523826,30.322128851540665,0
3828,4,0,0,38,0.0,0.0,1.0,38,850,600,250,0.7058823529411765,11,6,5,416.0125659802419,0.8188418681839734,0.3087123973368322,0.2545432818963853,132980.612244898,3464.321145124723,136444.93339002272,3636,38,694.0526315789474,34,4,15,31.41567597722376,0.6544117647058822,42.142857142857146,1031.4285714285718,30.336134453781522,0
3829,4,0,1,37,0.0,0.02631578947368421,0.9736842105263158,38,800,500,300,0.625,11,5,6,417.0309608754538,0.8174193930772878,0.3123884023467385,0.2555863017642637,133042.01388888917,3496.527777777811,136538.54166666698,3637,39,695.0526315789474,34,4,15,31.327409800753905,0.6550245098039214,42.08333333333335,1031.666666666669,30.34313725490203,0
3830,4,0,0,37,0.0,0.0,1.0,37,950,700,250,0.7368421052631579,12,7,5,422.5283134374041,0.8121871871871872,0.3070707070707066,0.258211747100636,132934.57031250012,3833.7239583333467,136768.29427083346,3638,40,711.8918918918919,33,4,15,31.294191919191928,0.65625,42.18750000000001,1031.250000000001,31.25000000000003,0
3831,4,0,1,36,0.0,0.02702702702702703,0.972972972972973,37,700,700,0,1.0,7,7,0,418.3203569763982,0.8111236236236237,0.3010794115569593,0.25628972088990704,133029.37121539802,3729.778811034228,136759.15002643224,3639,41,712.8918918918919,33,4,15,31.30692167577413,0.6571969696969696,42.09558823529412,1031.6176470588243,31.261140819964375,0
3832,4,0,0,36,0.0,0.0,1.0,36,650,400,250,0.6153846153846154,9,4,5,425.45423434036024,0.8100529100529101,0.3000122428991179,0.26011303788114276,132950.8468523622,4112.900150494871,137063.7470028571,3537,42,632.6111111111111,32,4,15,31.202303705517473,0.6588541666666665,42.171717171717184,1031.313131313133,32.228535353535406,0
3833,4,0,0,36,0.0,0.0,1.0,36,900,700,200,0.7777777777777778,11,7,4,427.2011839214355,0.8100859788359789,0.30401215681475047,0.26186503179460274,133048.52701573842,4167.69765202533,137216.22466776374,3538,43,633.6111111111111,32,4,15,31.058519968996034,0.6598307291666665,42.077020202020215,1031.691919191921,32.24037247474753,0
3834,4,0,0,36,0.0,0.0,1.0,36,1500,1200,300,0.8,18,12,6,424.6161404188529,0.8096230158730159,0.30060761764945787,0.2609633332168199,133146.24304917877,4107.208766962568,137253.45181614134,3539,44,634.6111111111111,32,4,15,31.026476225430233,0.6608072916666666,41.98232323232324,1032.0707070707078,32.25220959595962,0
3835,4,0,0,36,0.0,0.0,1.0,36,800,500,300,0.625,11,5,6,430.74115450140897,0.8068452380952381,0.3133504440642061,0.26659032724134124,133406.99450311204,4292.776566166732,137699.77106927877,3540,45,635.6111111111111,32,4,16,30.60503748064858,0.6634114583333333,41.729797979797986,1033.080808080809,32.28377525252528,0
3836,4,0,0,36,0.0,0.0,1.0,36,1050,700,350,0.6666666666666666,14,7,7,429.045706083194,0.8060846560846562,0.3064794982711072,0.26624986467414474,133505.8614942763,4256.039264462168,137761.90075873845,3541,46,636.6111111111111,31,5,16,30.549037209693,0.667002688172043,41.634114583333336,1033.463541666667,33.33753360215055,0
3837,4,0,0,36,0.0,0.0,1.0,36,1100,600,500,0.5454545454545454,16,6,10,430.2498895684324,0.8054563492063492,0.3092224041650915,0.2674826838906647,133573.152754042,4293.966844346798,137867.11959838882,3542,47,637.6111111111111,31,5,16,30.450019943737658,0.6676747311827957,41.56901041666667,1033.7239583333344,33.34593413978498,0
3838,4,0,1,35,0.0,0.027777777777777776,0.9722222222222222,36,1100,1000,100,0.9090909090909091,12,10,2,429.3370246887206,0.8032407407407408,0.3104451497395835,0.26807384956173785,133733.2925211714,4283.330782573215,138016.6233037446,3543,48,638.6111111111111,32,4,15,30.31209309895834,0.6666666666666666,41.41414141414142,1034.3434343434349,32.32323232323234,0
3839,4,1,0,36,0.027777777777777776,0.0,1.0,36,1100,700,400,0.6363636363636364,15,7,8,400.92089020524094,0.8096230158730159,0.22330206428703936,0.23912678415797642,132019.90370290267,3385.9074634755757,135405.81116637823,3544,0,622.8611111111111,33,3,18,32.77535972652833,0.6470959595959596,43.07598039215686,1027.696078431372,31.14230540701127,7
3840,4,0,0,36,0.0,0.0,1.0,36,750,400,350,0.5333333333333333,11,4,7,402.33179236649556,0.8096560846560847,0.22663712359074228,0.2401677396852526,132051.39136690216,3425.694594627071,135477.08596152923,3545,1,623.8611111111111,33,3,18,32.7072403720043,0.6474116161616161,43.0453431372549,1027.8186274509806,31.146019013666077,0
3841,4,0,0,36,0.0,0.0,1.0,36,1250,1000,250,0.8,15,10,5,404.5300537986507,0.8085648148148149,0.22560588001589155,0.24208324902786582,132145.87688629376,3491.395737216456,135637.27262351022,3546,2,624.8611111111111,33,3,19,32.55512514898688,0.6483585858585859,42.95343137254902,1028.186274509804,31.157159833630423,0
3842,4,0,0,36,0.0,0.0,1.0,36,700,400,300,0.5714285714285714,10,4,6,406.6757454041994,0.8075396825396826,0.22628879624114906,0.24438388565986086,132303.42784325744,3560.919027537494,135864.34687079492,3547,3,625.8611111111111,33,3,19,32.34055489378599,0.6499368686868687,42.80024509803922,1028.7990196078435,31.17572786690435,0
3843,4,0,0,36,0.0,0.0,1.0,36,550,300,250,0.5454545454545454,8,3,5,407.008850377037,0.8071428571428572,0.2224207294478855,0.24478841746171937,132334.94929834685,3572.2991157247284,135907.24841407157,3548,4,626.8611111111111,33,3,19,32.300103223757354,0.6502525252525253,42.76960784313726,1028.9215686274513,31.17944147355913,0
3844,4,0,1,35,0.0,0.027777777777777776,0.9722222222222222,36,750,500,250,0.6666666666666666,10,5,5,406.6613122654032,0.8063492063492064,0.21873594242015315,0.2449886442184261,132398.00347222236,3568.244184928892,135966.24765715125,3549,5,627.8611111111111,32,4,19,32.245276653171395,0.6533203125,42.70833333333334,1029.1666666666679,32.16145833333337,0
3845,4,0,0,35,0.0,0.0,1.0,35,1150,800,350,0.6956521739130435,15,8,7,410.00765565839447,0.8059523809523809,0.203604840166155,0.24832776081607202,132599.08888075093,3873.3283148871574,136472.4171956381,3550,6,605.9142857142857,31,4,19,31.955857564264644,0.6579301075268817,42.513020833333336,1029.9479166666672,33.22412634408604,0
3846,4,0,0,35,0.0,0.0,1.0,35,800,500,300,0.625,11,5,6,407.8672563700967,0.8046918767507002,0.19856775165023755,0.24741925239580806,132658.02158261914,3821.3726596775878,136479.39424229672,3551,7,606.9142857142857,32,3,17,31.95142378559465,0.6559244791666666,42.45580808080808,1030.176767676768,32.193023989899,0
3847,4,0,0,35,0.0,0.0,1.0,35,1600,1400,200,0.875,18,14,4,406.85694607916446,0.8032913165266106,0.19012388885000342,0.24787911252166409,132820.6624324049,3807.801818691973,136628.46425109688,3552,8,607.9142857142857,32,3,17,31.813194104197308,0.6575520833333334,42.2979797979798,1030.808080808081,32.21275252525253,0
3848,4,0,1,34,0.0,0.02857142857142857,0.9714285714285714,35,1150,800,350,0.6956521739130435,15,8,7,406.61643862295847,0.8002801120448179,0.19122224165063795,0.24902970791226173,133015.96297571674,3817.2954290378457,136833.2584047546,3553,9,608.9142857142857,32,3,17,31.622297021623822,0.6595052083333334,42.108585858585855,1031.5656565656564,32.23642676767676,0
3849,4,0,1,33,0.0,0.029411764705882353,0.9705882352941176,34,1050,500,550,0.47619047619047616,16,5,11,409.65576578112183,0.7985739750445633,0.18070219540807742,0.2522617084020592,133219.07439446365,4114.7923875432425,137333.8667820069,3554,10,613.9117647058823,33,1,18,31.33903133903133,0.6590909090909092,41.91176470588235,1032.3529411764703,31.28342245989304,0
3850,4,0,0,33,0.0,0.0,1.0,33,900,600,300,0.6666666666666666,12,6,6,421.0314664096849,0.790167297979798,0.18842530282637981,0.2585341979689219,133113.66705246898,4609.0084876543015,137722.67554012328,3555,60,633.2121212121212,32,1,19,31.15186182144459,0.6604817708333335,42.01388888888888,1031.9444444444432,32.24826388888885,0
3851,4,0,0,33,0.0,0.0,1.0,33,1200,1000,200,0.8333333333333334,14,10,4,424.4536683418979,0.7892992424242425,0.19709010881525857,0.26200804176365144,133309.18281616672,4716.714333996528,138025.89715016325,3556,61,634.2121212121212,32,1,19,30.866140930024045,0.6624348958333334,41.82449494949495,1032.70202020202,32.27193813131313,0
3852,4,0,0,33,0.0,0.0,1.0,33,1050,600,450,0.5714285714285714,15,6,9,424.64300213177404,0.7885890151515152,0.20022002200220013,0.262585366624342,133374.3866219009,4727.299988521589,138101.68661042248,3557,62,635.2121212121212,32,1,19,30.795440655176623,0.6630859375,41.76136363636364,1032.954545454546,32.27982954545456,0
3853,4,1,1,33,0.029411764705882353,0.029411764705882353,0.9705882352941176,34,850,500,350,0.5882352941176471,12,5,7,415.3736445655327,0.7954174093879977,0.18677903910102067,0.259229537301847,133715.38843002077,4308.477255527555,138023.8656855483,3558,0,617.5,30,4,16,30.691195581546456,0.671875,41.431451612903224,1034.2741935483868,34.4758064516129,0
3854,4,0,0,33,0.0,0.0,1.0,33,350,200,150,0.5714285714285714,5,2,3,425.9443201990679,0.7877209595959597,0.2001523092774269,0.2643412582653264,133508.10426311725,4773.4037422839465,138281.50800540118,3559,64,637.2121212121212,29,4,19,30.626903865967833,0.6727729885057472,41.63194444444444,1033.472222222222,35.636973180076616,0
3855,4,0,0,33,0.0,0.0,1.0,33,800,500,300,0.625,11,5,6,427.50348845288033,0.7869318181818182,0.19847141845530292,0.2665989091306654,133687.58680555545,4830.381944444433,138517.96874999988,3560,65,638.2121212121212,29,4,19,30.405586892291176,0.6745689655172414,41.45833333333333,1034.1666666666658,35.660919540229855,0
3856,4,0,0,33,0.0,0.0,1.0,33,550,400,150,0.7272727272727273,7,4,3,424.9974906577476,0.7859848484848485,0.19311265175926828,0.26555212335729056,133759.41358024685,4769.483024691351,138528.8966049382,3561,66,639.2121212121212,29,4,17,30.397981561045473,0.6752873563218391,41.388888888888886,1034.4444444444441,35.670498084291175,0
3857,4,0,1,32,0.0,0.030303030303030304,0.9696969696969697,33,1250,900,350,0.72,16,9,7,426.15382020576834,0.7841698232323233,0.19132624950806787,0.26721371462413795,133889.2140709908,4811.48001214012,138700.69408313092,3562,67,640.2121212121212,30,3,17,30.237283549783545,0.6736111111111112,41.26344086021505,1034.9462365591392,34.49820788530464,0
3858,4,0,0,32,0.0,0.0,1.0,32,900,700,200,0.7777777777777778,11,7,4,425.97602014969317,0.7803259408602151,0.18853869124902634,0.26760744756875504,133958.77594230545,5012.645248005547,138971.421190311,3563,68,651.9375,30,2,17,30.171816844109763,0.6743055555555555,41.196236559139784,1035.2150537634407,34.50716845878136,0
3859,4,1,0,33,0.030303030303030304,0.0,1.0,33,1100,700,400,0.6363636363636364,15,7,8,420.8566878426548,0.7898516414141414,0.18467954279104437,0.26770788034975285,134415.72401258696,4713.951280381963,139129.67529296892,3564,0,633.1515151515151,31,2,18,29.844717897204085,0.6760752688172043,40.75520833333334,1036.9791666666679,33.45094086021509,0
3860,4,0,0,33,0.0,0.0,1.0,33,650,500,150,0.7692307692307693,8,5,3,422.92679343209517,0.7907986111111112,0.18314182365895704,0.2697724390130909,134517.01058281804,4778.169589572502,139295.18017239054,3565,1,634.1515151515151,31,2,18,29.689265093510745,0.6770833333333333,40.65755208333334,1037.3697916666677,33.4635416666667,0
3861,4,1,0,34,0.029411764705882353,0.0,1.0,34,850,700,150,0.8235294117647058,10,7,3,416.095376285325,0.7920008912655973,0.1822939702196673,0.26864410216479717,134956.35986328122,4430.94770643446,139387.3075697157,3566,0,616.4705882352941,31,3,15,29.425647451963243,0.6814516129032258,40.234375,1039.0624999999998,33.51814516129031,0
3862,4,0,0,34,0.0,0.0,1.0,34,550,400,150,0.7272727272727273,7,4,3,418.32974104036776,0.7926693404634582,0.18489395256975283,0.27059221985285364,135024.0156385633,4496.912299262143,139520.92793782544,3567,1,617.4705882352941,31,3,16,29.299778668671166,0.6821236559139785,40.16927083333333,1039.322916666666,33.526545698924714,0
3863,4,0,1,33,0.0,0.029411764705882353,0.9705882352941176,34,1300,1000,300,0.7692307692307693,16,10,6,420.09843296392273,0.7927807486631017,0.18325451893755296,0.27275659232925914,135159.3780517578,4556.048583984376,139715.4266357422,3568,2,618.4705882352941,31,3,17,29.118144252441766,0.6834677419354838,40.0390625,1039.84375,33.54334677419355,0
3864,4,0,0,33,0.0,0.0,1.0,33,1300,1000,300,0.7692307692307693,16,10,6,437.94561266360716,0.782354797979798,0.19846604619096841,0.28422376338638156,135144.09180252065,5237.15241646435,140381.244218985,3569,3,638.0909090909091,30,3,19,28.66953205791107,0.686111111111111,40.05376344086022,1039.7849462365602,34.65949820788534,0
3865,4,0,0,33,0.0,0.0,1.0,33,900,600,300,0.6666666666666666,12,6,6,441.165673881121,0.7814867424242425,0.20284781127376084,0.2868689062598419,135213.97885593728,5330.353220025464,140544.33207596274,3570,4,639.0909090909091,30,3,19,28.515658654260356,0.6868055555555554,39.98655913978496,1040.0537634408618,34.668458781362055,0
3866,4,1,0,34,0.029411764705882353,0.0,1.0,34,1150,700,450,0.6086956521739131,16,7,9,430.4469454428206,0.7828282828282829,0.20917482435252954,0.28426545803006087,135769.34814453137,4888.300238715293,140657.64838324665,3571,0,621.2647058823529,31,3,20,28.237964351157764,0.689516129032258,39.45312500000001,1042.187500000001,33.61895161290325,0
3867,4,0,0,34,0.0,0.0,1.0,34,850,500,350,0.5882352941176471,12,5,7,430.5682803847653,0.7820112893642306,0.20705794183773962,0.2848867481620191,135837.20737033422,4897.4385579427135,140734.64592827694,3572,1,622.2647058823529,31,3,20,28.16689566158715,0.6901881720430108,39.388020833333336,1042.4479166666667,33.62735215053764,0
3868,4,0,0,34,0.0,0.0,1.0,34,600,400,200,0.6666666666666666,8,4,4,432.9077534059611,0.7816770647653001,0.2081151351788062,0.2872542002508983,135939.02799818246,4969.811842176639,140908.83984035908,3573,2,623.2647058823529,31,3,18,28.00404232738169,0.6911962365591398,39.29036458333333,1042.8385416666663,33.639952956989234,0
3869,4,0,1,33,0.0,0.029411764705882353,0.9705882352941176,34,1000,800,200,0.8,12,8,4,433.2405965701423,0.7811942959001783,0.2103473599177499,0.28774935145330355,135972.97668457034,4981.802707248264,140954.7793918186,3574,3,624.2647058823529,31,3,18,27.961402413649598,0.6915322580645162,39.2578125,1042.9687500000002,33.644153225806456,0
3870,4,0,0,33,0.0,0.0,1.0,33,650,500,150,0.7692307692307693,8,5,3,435.7942085501735,0.7791982323232324,0.21102409866454774,0.28944540717138395,135972.97668457034,5251.247151692709,141224.22383626306,3575,4,640.0,31,2,18,27.894818976279648,0.6915322580645161,39.2578125,1042.9687500000002,33.644153225806456,0
3871,4,0,0,33,0.0,0.0,1.0,33,950,400,550,0.42105263157894735,15,4,11,432.5163867343241,0.777304292929293,0.2124123329363503,0.28864436633435536,136142.78369479705,5176.796976725251,141319.5806715223,3576,5,641.0,31,2,18,27.810485547930973,0.6932123655913979,39.09505208333333,1043.6197916666663,33.66515456989246,0
3872,4,0,0,33,0.0,0.0,1.0,33,200,0,200,0.0,4,0,4,432.5163867343241,0.777304292929293,0.2124123329363503,0.28864436633435536,136142.78369479705,5176.796976725251,141319.5806715223,3577,6,642.0,31,2,18,27.810485547930973,0.6932123655913979,39.09505208333333,1043.6197916666663,33.66515456989246,0
3873,4,0,0,33,0.0,0.0,1.0,33,950,700,250,0.7368421052631579,12,7,5,431.06738946873156,0.7772253787878789,0.21014837827010457,0.28850570356930616,136244.7187635633,5146.131049262143,141390.84981282544,3578,7,643.0,31,2,18,27.746424711066766,0.694220430107527,38.99739583333333,1044.010416666666,33.67775537634407,0
3874,4,0,1,32,0.0,0.030303030303030304,0.9696969696969697,33,1450,1200,250,0.8275862068965517,17,12,5,430.3740629499244,0.7770675505050506,0.20511774438475983,0.2891508151578133,136380.69152832023,5138.9424641926935,141519.6339925129,3579,8,644.0,31,2,18,27.628708551483413,0.6955645161290324,38.86718749999999,1044.5312499999993,33.69455645161288,0
3875,4,0,0,32,0.0,0.0,1.0,32,900,700,200,0.7777777777777778,11,7,4,441.43729213078115,0.7716733870967742,0.21631242759685954,0.29590391048870035,136299.53833174345,5633.539823968075,141933.07815571153,3580,9,664.71875,30,2,18,27.420946496760628,0.6975694444444445,38.94489247311827,1044.220430107526,34.80734767025087,0
3876,4,0,0,32,0.0,0.0,1.0,32,750,600,150,0.8,9,6,3,439.7902903305618,0.7710013440860216,0.2175918478960237,0.2953855096075016,136369.7234687535,5594.816055324295,141964.53952407782,3581,10,665.71875,30,2,18,27.393782438982537,0.698263888888889,38.877688172043,1044.489247311827,34.81630824372757,0
3877,4,0,0,32,0.0,0.0,1.0,32,950,700,250,0.7368421052631579,12,7,5,437.87948574764755,0.7703713037634409,0.21265596861332625,0.29498051318909974,136475.03504740432,5551.923632789911,142026.95868019422,3582,11,666.71875,30,2,19,27.338457250664604,0.6993055555555556,38.776881720430104,1044.8924731182794,34.829749103942646,0
3878,4,0,0,32,0.0,0.0,1.0,32,900,600,300,0.6666666666666666,12,6,6,443.55412715717966,0.7693632392473119,0.21596168680894823,0.2999968696546557,136615.5137154583,5719.274988437951,142334.78870389625,3583,12,667.71875,30,2,19,27.049852147081506,0.7006944444444445,38.64247311827956,1045.4301075268806,34.84767025089602,0
3879,4,0,0,32,0.0,0.0,1.0,32,850,300,550,0.35294117647058826,14,3,11,444.91357280043167,0.7683971774193549,0.21426792828685226,0.3018197480348873,136720.92013888888,5765.839258873853,142486.75939776274,3584,13,668.71875,29,3,19,26.909030544488715,0.7047413793103449,38.541666666666664,1045.8333333333333,36.06321839080459,0
3880,4,0,1,31,0.0,0.03125,0.96875,32,750,500,250,0.6666666666666666,10,5,5,444.8401297535237,0.7667170698924731,0.21604559331032624,0.30302220050298806,136866.21334876554,5776.716820987671,142642.9301697532,3585,14,669.71875,29,3,19,26.765883550128322,0.7061781609195402,38.402777777777786,1046.3888888888896,36.082375478927226,0
3881,4,0,0,31,0.0,0.0,1.0,31,1100,900,200,0.8181818181818182,13,9,4,454.19260869747006,0.7656810035842294,0.21114057900847905,0.3077962332028129,136684.60889274685,6216.227816358018,142900.83670910486,3586,15,684.1612903225806,29,2,19,26.702721698322044,0.704382183908046,38.576388888888886,1045.6944444444441,36.05842911877394,0
3882,4,0,0,31,0.0,0.0,1.0,31,850,700,150,0.8235294117647058,10,7,3,453.1674100411104,0.7649641577060932,0.20897056933556102,0.30741897275761815,136720.92013888896,6191.497878086429,142912.4180169754,3587,16,685.1612903225806,28,3,19,26.693227091633467,0.7079613095238095,38.54166666666667,1045.833333333334,37.351190476190496,0
3883,4,0,0,31,0.0,0.0,1.0,31,1050,800,250,0.7619047619047619,13,8,5,456.8219400257783,0.764068100358423,0.2113095897206485,0.3112286425825767,136871.22483567856,6305.1556926278445,143176.3805283064,3588,17,686.1612903225806,28,3,19,26.447434665202074,0.7094494047619047,38.397988505747136,1046.4080459770125,37.37171592775045,0
3884,4,0,0,31,0.0,0.0,1.0,31,900,700,200,0.7777777777777778,11,7,4,456.80304029525644,0.7628136200716846,0.21236227130063634,0.3125562210921631,137021.6121061238,6318.377799246945,143339.98990537075,3589,18,687.1612903225806,28,3,18,26.297687662961437,0.7109375,38.254310344827594,1046.9827586206907,37.392241379310384,0
3885,4,0,0,31,0.0,0.0,1.0,31,900,600,300,0.6666666666666666,12,6,6,459.1230258862223,0.7629928315412187,0.20827470242046098,0.31516072115918675,137134.45674791923,6392.317347073599,143526.77409499284,3590,19,688.1612903225806,28,3,18,26.124256973022405,0.7120535714285714,38.146551724137936,1047.4137931034488,37.40763546798031,0
3886,4,0,0,31,0.0,0.0,1.0,31,550,300,250,0.5454545454545454,8,3,5,459.1346049387493,0.7620967741935484,0.21187411789170052,0.3155089919517835,137172.08195022467,6396.0899309684355,143568.17188119312,3591,20,689.1612903225806,28,3,18,26.086385040918024,0.7124255952380951,38.11063218390805,1047.5574712643684,37.4127668308703,0
3887,4,0,0,31,0.0,0.0,1.0,31,1000,800,200,0.8,12,8,4,460.0725628141115,0.7611111111111111,0.20726901182309132,0.31683750713912373,137247.3478373962,6428.747811798157,143676.09564919435,3592,21,690.1612903225806,28,3,18,25.986676721970838,0.7131696428571428,38.03879310344829,1047.8448275862088,37.42302955665031,0
3888,4,0,0,31,0.0,0.0,1.0,31,1450,1200,250,0.8275862068965517,17,12,5,441.29005041128397,0.7623655913978494,0.1603849238171613,0.2851236750584824,134983.4201388889,5767.061575175061,140750.48171406396,3593,22,691.1612903225806,29,2,15,28.743985565356866,0.6875,40.208333333333336,1039.1666666666667,35.833333333333336,8
3889,4,0,0,31,0.0,0.0,1.0,31,400,300,100,0.75,5,3,2,438.65354318844817,0.7621863799283154,0.15725650021065962,0.28385839744571295,135039.29509553133,5647.093052665051,140686.3881481964,3594,23,692.1612903225806,30,1,15,28.756358032673816,0.6850694444444445,40.15456989247312,1039.3817204301079,34.646057347670265,0
3890,4,0,0,31,0.0,0.0,1.0,31,1000,600,400,0.6,14,6,8,437.3032941249444,0.7601254480286739,0.16157387330286554,0.2838069029656518,135144.0918025205,5619.791305353222,140763.88310787373,3595,24,693.1612903225806,30,1,18,28.686228886590836,0.6861111111111111,40.053763440860216,1039.784946236559,34.659498207885306,0
3891,4,0,0,31,0.0,0.0,1.0,31,750,500,250,0.6666666666666666,10,5,5,434.89610261089257,0.760573476702509,0.16046084140236538,0.2830665212872749,135248.92915727253,5563.84643455891,140812.77559183145,3596,25,694.1612903225806,30,1,18,28.643612439160957,0.6871527777777777,39.95295698924731,1040.1881720430108,34.67293906810036,0
3892,4,0,0,31,0.0,0.0,1.0,31,600,400,200,0.6666666666666666,8,4,4,434.07313930119045,0.760752688172043,0.16422438943069118,0.2828052271204727,135283.88397502602,5544.620042779517,140828.50401780554,3597,26,695.1612903225806,30,1,18,28.629952627045654,0.6875,39.91935483870968,1040.3225806451615,34.67741935483871,0
3893,4,0,0,31,0.0,0.0,1.0,31,1200,900,300,0.75,15,9,6,436.35134634526526,0.7597670250896057,0.168018564114101,0.28511970251066565,135388.77552679504,5615.414896230782,141004.19042302584,3598,27,696.1612903225806,30,1,18,28.4654957165612,0.6885416666666666,39.818548387096776,1040.7258064516132,34.690860215053775,0
3894,4,0,0,31,0.0,0.0,1.0,31,950,700,250,0.7368421052631579,12,7,5,436.6079118386248,0.7591397849462366,0.16432206424960216,0.2861222407023679,135493.70772632674,5631.524959532898,141125.23268585964,3599,28,697.1612903225806,30,1,18,28.353612617264826,0.6895833333333332,39.71774193548387,1041.1290322580646,34.70430107526882,0
3895,4,0,0,31,0.0,0.0,1.0,31,950,700,250,0.7368421052631579,12,7,5,435.4446958383719,0.7579749103942652,0.16771029360334433,0.285917415538619,135563.68510810495,5606.097525725513,141169.78263383047,3600,29,698.1612903225806,30,1,18,28.31375838926175,0.6902777777777778,39.6505376344086,1041.3978494623652,34.71326164874551,0
3896,4,0,0,31,0.0,0.0,1.0,31,1000,800,200,0.8,12,8,4,432.4207524756298,0.7579749103942652,0.1616660960476981,0.27794365504382,134794.92752052261,5457.624797664474,140252.55231818708,3601,30,699.1612903225806,30,1,18,29.163700491845713,0.6826388888888888,40.38978494623656,1038.4408602150538,34.6146953405018,1
3897,4,0,0,31,0.0,0.0,1.0,31,450,300,150,0.6666666666666666,6,3,3,430.3956144524603,0.7569892473118279,0.15962899886462312,0.2771747757073845,134864.72424557758,5409.037171927401,140273.76141750498,3602,31,700.1612903225806,30,1,18,29.146178398895792,0.6833333333333332,40.322580645161295,1038.7096774193553,34.62365591397851,0
3898,4,0,0,31,0.0,0.0,1.0,31,500,300,200,0.6,7,3,4,428.7242568693222,0.7568996415770609,0.15770516571438087,0.2763644521553791,134899.62938273224,5366.948671811785,140266.57805454402,3603,32,701.1612903225806,30,1,18,29.154537025057135,0.6836805555555555,40.28897849462366,1038.8440860215064,34.62813620071688,0
3899,4,0,0,31,0.0,0.0,1.0,31,1050,500,550,0.47619047619047616,16,5,11,430.86583201373776,0.7562724014336918,0.18735368935238794,0.2541908625651372,131603.8071597873,5142.708513990063,136746.51567377738,3604,33,702.1612903225806,30,1,17,32.428663435507815,0.6506944444444445,43.48118279569893,1026.0752688172047,34.20250896057349,5
3900,4,0,0,31,0.0,0.0,1.0,31,850,700,150,0.8235294117647058,10,7,3,434.068141241009,0.7561827956989248,0.19239948130282514,0.2567760181764204,131707.2624906059,5233.985323447802,136941.2478140537,3605,34,703.1612903225806,30,1,17,32.241336039457025,0.6517361111111111,43.380376344086024,1026.4784946236564,34.215949820788545,0
3901,4,0,0,31,0.0,0.0,1.0,31,550,300,250,0.5454545454545454,8,3,5,437.82516926619337,0.7552867383512545,0.1911585880763389,0.25970374947156194,131810.75846918722,5342.013527575446,137152.77199676266,3606,35,704.1612903225806,30,1,17,32.03970331588131,0.6527777777777778,43.27956989247312,1026.8817204301076,34.229390681003586,0
3902,4,0,1,30,0.0,0.03225806451612903,0.967741935483871,31,600,400,200,0.6666666666666666,8,4,4,443.98756161483243,0.7554659498207885,0.1947384412822204,0.2643178287370544,131948.81633714875,5516.7266446988,137465.54298184754,3607,36,705.1612903225806,30,1,17,31.741125937554514,0.6541666666666666,43.14516129032258,1027.419354838709,34.24731182795697,0
3903,4,1,1,30,0.03225806451612903,0.03225806451612903,0.967741935483871,31,1050,600,450,0.5714285714285714,15,6,9,432.90047449774033,0.7670250896057348,0.16485822290804286,0.26033329904727126,132331.0089111328,5257.231309678818,137588.24022081163,2981,0,589.7741935483871,31,0,17,31.63808740403273,0.655241935483871,42.7734375,1028.90625,33.190524193548384,0
3904,4,0,0,30,0.0,0.0,1.0,30,750,600,150,0.8,9,6,3,445.57262071025326,0.7500957854406131,0.17987454260324132,0.267203894488625,132225.14886113987,5783.181220372279,138008.33008151213,2982,38,610.4333333333333,30,0,17,31.41961796480222,0.6569444444444446,42.8763440860215,1028.4946236559128,34.28315412186376,0
3905,4,0,0,30,0.0,0.0,1.0,30,650,400,250,0.6153846153846154,9,4,5,440.28599451953346,0.748227969348659,0.17804920531243207,0.26475956701076414,132328.84807853505,5652.507695976409,137981.35577451147,2983,39,611.4333333333333,30,0,18,31.450304811669927,0.657986111111111,42.7755376344086,1028.8978494623652,34.296594982078844,0
3906,4,0,1,29,0.0,0.03333333333333333,0.9666666666666667,30,1050,800,250,0.7619047619047619,13,8,5,441.5385611736392,0.7446360153256705,0.17752828546562194,0.2667338626648325,132501.77043588858,5700.9282142444235,138202.698650133,2984,40,612.4333333333333,30,0,18,31.242656657963437,0.6597222222222222,42.60752688172043,1029.5698924731187,34.31899641577062,0
3907,4,0,0,29,0.0,0.0,1.0,29,650,500,150,0.7692307692307693,8,5,3,447.5495025787735,0.7412766830870279,0.16413272047192828,0.27013329911350725,132469.4830246913,6057.330246913573,138526.81327160486,2985,41,618.2413793103449,29,0,18,31.12070516279907,0.6623563218390804,42.638888888888886,1029.4444444444441,35.49808429118773,0
3908,4,0,0,29,0.0,0.0,1.0,29,1050,700,350,0.6666666666666666,14,7,7,443.402390499839,0.7411740558292282,0.16071802264747603,0.26839418167806556,132576.73852237643,5956.968557098748,138533.70707947516,2986,42,619.2413793103449,29,0,18,31.118650258485054,0.663433908045977,42.534722222222214,1029.8611111111102,35.512452107279664,0
3909,4,0,0,29,0.0,0.0,1.0,29,850,500,350,0.5882352941176471,12,5,7,443.4129133328018,0.7419950738916256,0.16399996281179963,0.2691683298774732,132684.03742283944,5966.763117283939,138650.80054012337,2987,43,620.2413793103449,29,0,17,31.009593780893315,0.6645114942528736,42.43055555555555,1030.2777777777771,35.526819923371626,0
3910,4,0,0,29,0.0,0.0,1.0,29,850,400,450,0.47058823529411764,13,4,9,444.45332422751966,0.7410714285714285,0.16507110326238528,0.27031505457116334,132755.59413580233,6000.733024691336,138756.32716049367,2988,44,621.2413793103449,29,0,17,30.91026504941599,0.6652298850574714,42.3611111111111,1030.5555555555543,35.5363984674329,0
3911,4,1,0,30,0.03333333333333333,0.0,1.0,30,700,600,100,0.8571428571428571,8,6,2,430.29647697601126,0.7565613026819924,0.15569301558362647,0.2645513728341704,133159.90513715448,5459.647610995475,138619.55274814996,2989,0,601.5,30,0,19,30.86610669792074,0.6663194444444445,41.96908602150537,1032.1236559139775,34.40412186379925,0
3912,4,0,0,30,0.0,0.0,1.0,30,700,200,500,0.2857142857142857,12,2,10,431.74302842881934,0.7557471264367817,0.1579600694444443,0.26568801749465826,133194.58896982312,5501.167042432654,138695.75601225576,2990,1,602.5,30,0,19,30.793728298611114,0.6666666666666667,41.935483870967744,1032.2580645161293,34.40860215053764,0
3913,4,0,0,30,0.0,0.0,1.0,30,500,300,200,0.6,7,3,4,432.85218908561654,0.7557950191570881,0.1607646573796817,0.2666188985057432,133229.27731890956,5533.716867556921,138762.99418646647,2991,2,603.5,30,0,19,30.7300481708111,0.6670138888888889,41.9018817204301,1032.3924731182783,34.413082437275946,0
3914,4,0,0,30,0.0,0.0,1.0,30,500,300,200,0.6,7,3,4,432.97284176990877,0.7549808429118774,0.15738089039312664,0.2669420040510785,133263.97018441427,5539.935975257238,138803.90615967152,2992,3,604.5,30,0,19,30.69187711533455,0.6673611111111113,41.868279569892465,1032.5268817204292,34.4175627240143,0
3915,4,0,0,30,0.0,0.0,1.0,30,950,600,350,0.631578947368421,13,6,7,424.5262809459471,0.7566091954022989,0.14162152401589,0.24957818937140724,131470.52469135812,5168.721556602569,136639.2462479607,2993,4,605.5,29,1,20,32.72672896352474,0.6522988505747127,43.611111111111114,1025.555555555556,35.36398467432952,3
3916,4,0,0,30,0.0,0.0,1.0,30,1050,800,250,0.7619047619047619,13,8,5,423.961074897528,0.7566570881226053,0.13903253463291376,0.24994417081149567,131577.37509645068,5156.737075617295,136734.11217206798,2994,5,606.5,29,1,18,32.63263729073599,0.6533764367816092,43.50694444444445,1025.9722222222226,35.37835249042147,0
3917,4,0,0,30,0.0,0.0,1.0,30,750,500,250,0.6666666666666666,10,5,5,424.660566706021,0.7550766283524905,0.1432900432900428,0.25152972027972026,131755.55555555562,5190.277777777783,136945.8333333334,2995,6,607.5,29,1,18,32.43371212121211,0.6551724137931034,43.333333333333336,1026.6666666666672,35.40229885057473,0
3918,4,0,0,30,0.0,0.0,1.0,30,1050,700,350,0.6666666666666666,14,7,7,402.5920033539585,0.7539272030651342,0.08916534321510494,0.22171903624945397,128928.23592322801,4381.0953578448225,133309.33128107284,2996,7,608.5,30,0,21,35.880426151402844,0.6236111111111111,46.1021505376344,1015.5913978494615,33.85304659498205,6
3919,4,1,1,30,0.03225806451612903,0.03225806451612903,0.967741935483871,31,250,200,50,0.8,3,2,1,392.50475424233707,0.7653225806451613,0.0814488238429536,0.2174793907998526,129168.29639010945,3939.8340861002416,133108.13047620968,2997,0,589.8387096774194,31,0,21,35.89100059775414,0.6233198924731184,45.86588541666666,1016.5364583333321,32.79149865591394,0
3920,4,0,0,30,0.0,0.0,1.0,30,500,400,100,0.8,6,4,2,399.58182861622015,0.7525862068965518,0.08911816578483234,0.2208215368668585,129064.77627471385,4314.387862758702,133379.16413747254,2998,9,610.5,30,0,21,35.81707451499118,0.625,45.96774193548387,1016.1290322580646,33.87096774193549,0
3921,4,2,0,32,0.0625,0.0,1.0,32,900,500,400,0.5555555555555556,13,5,8,377.0319031315472,0.7671370967741936,0.08552421415793532,0.21227709884226523,129797.77865939663,3387.652964729249,133185.4316241259,2999,0,573.28125,31,1,20,35.64240991566572,0.6297043010752689,45.24739583333333,1019.0104166666661,32.87130376344084,0
3922,4,0,0,32,0.0,0.0,1.0,32,700,400,300,0.5714285714285714,10,4,6,377.36307650384316,0.7662550403225807,0.0891425514245563,0.2126436860903944,129830.95169067371,3398.6814710828853,133229.6331617566,3000,1,574.28125,31,1,20,35.60019270899877,0.6300403225806452,45.21484374999999,1019.1406249999991,32.875504032258036,0
3923,4,2,2,32,0.058823529411764705,0.058823529411764705,0.9411764705882353,34,950,800,150,0.8421052631578947,11,8,3,357.34836518096427,0.7828282828282829,0.07519652687382306,0.20428204423666557,130391.51178770015,2519.7550295372425,132911.2668172374,3001,0,541.4411764705883,32,2,22,35.54106399637368,0.6331380208333335,44.665404040404034,1021.3383838383832,31.916824494949473,0
3924,4,0,0,32,0.0,0.0,1.0,32,700,400,300,0.5714285714285714,10,4,6,371.85936317754977,0.7717993951612904,0.09940138375207241,0.2120544921218305,130295.81917656798,3290.344068739155,133586.16324530714,3002,1,574.5,31,1,22,35.26774327254178,0.634744623655914,44.759114583333336,1020.9635416666671,32.934307795698935,0
3925,4,1,1,32,0.030303030303030304,0.030303030303030304,0.9696969696969697,33,1450,1000,450,0.6896551724137931,19,10,9,359.4374718428042,0.7854324494949496,0.08809916675085216,0.20719459675835383,130714.10323245075,2796.709360014282,133510.81259246502,3003,0,558.060606060606,32,1,19,35.16071943038234,0.6363932291666667,44.349747474747474,1022.6010101010099,31.95628156565656,0
3926,4,2,1,33,0.058823529411764705,0.029411764705882353,0.9705882352941176,34,500,300,200,0.6,7,3,4,347.2482314965318,0.801507724301842,0.0701801294680553,0.20272312956082414,131202.5422914262,2311.9701557093167,133514.5124471355,3004,0,505.6470588235294,33,1,21,34.97856858054225,0.6388888888888891,43.87254901960783,1024.5098039215673,31.045751633986885,0
3927,4,0,0,33,0.0,0.0,1.0,33,600,500,100,0.8333333333333334,7,5,2,359.5512804047832,0.7955334595959597,0.09068440926847998,0.21024949697516085,131265.32613658224,2839.3232170319284,134104.64935361416,3005,1,521.8787878787879,33,0,22,34.59997608227695,0.639520202020202,43.81127450980393,1024.7549019607854,31.05317884729653,1
3928,4,0,1,32,0.0,0.030303030303030304,0.9696969696969697,33,1100,900,200,0.8181818181818182,13,9,4,360.72793564512614,0.7934027777777778,0.09220032840722503,0.21164095646231393,131392.84256708506,2879.4287898161415,134272.27135690118,3006,2,522.8787878787879,32,1,22,34.44093801313629,0.6432291666666666,43.68686868686869,1025.2525252525259,32.03914141414143,0
3929,4,1,1,32,0.030303030303030304,0.030303030303030304,0.9696969696969697,33,850,600,250,0.7058823529411765,11,6,5,360.9585841629653,0.7933238636363638,0.09062923285309665,0.2119555070128301,131425.20732897156,2887.8113521579457,134313.0186811295,3007,0,523.7575757575758,32,1,22,34.40232114271642,0.6435546875,43.65530303030303,1025.378787878788,32.043087121212125,0
3930,4,0,0,32,0.0,0.0,1.0,32,750,400,350,0.5333333333333333,11,4,7,371.27375091726867,0.7812500000000001,0.10317582552981741,0.21709349873519854,131263.42337516596,3346.9327109478822,134610.35608611384,3008,4,541.125,32,0,22,34.30158534581895,0.6419270833333333,43.81313131313132,1024.747474747476,32.023358585858624,0
3931,4,0,0,32,0.0,0.0,1.0,32,1100,800,300,0.7272727272727273,14,8,6,370.319150568366,0.7813760080645162,0.09911644227105332,0.21709029578739716,131361.49300469283,3329.1512436288253,134690.64424832165,3009,5,542.125,31,1,22,34.226814217367384,0.645497311827957,43.717447916666664,1025.1302083333328,33.06871639784944,0
3932,4,0,0,32,0.0,0.0,1.0,32,650,400,250,0.6153846153846154,9,4,5,363.29445644278144,0.7806619623655915,0.06443720671770747,0.20924313714606332,130681.82615294389,3095.1965998367887,133777.02275278067,3010,6,543.125,32,0,18,35.09482794105539,0.6360677083333331,44.38131313131315,1022.4747474747501,31.95233585858594,6
3933,4,0,1,31,0.0,0.03125,0.96875,32,650,400,250,0.6153846153846154,9,4,5,363.8278416772425,0.7795278897849462,0.06808820807108429,0.2104280514711421,130843.25140610673,3120.883551423344,133964.13495753007,3011,7,544.125,32,0,18,34.9176231025546,0.6376953125,44.22348484848486,1023.1060606060623,31.972064393939448,0
3934,4,1,0,32,0.03125,0.0,1.0,32,1050,600,450,0.5714285714285714,15,6,9,363.6914509689618,0.7748655913978495,0.07531458179126571,0.21087860526140245,130940.15438475681,3124.362947658424,134064.51733241524,3012,0,544.875,32,0,19,34.82297063903284,0.638671875,44.12878787878789,1023.4848484848496,31.98390151515155,0
3935,4,0,0,32,0.0,0.0,1.0,32,700,500,200,0.7142857142857143,9,5,4,364.7999683756485,0.773353494623656,0.0712083847102345,0.2122329801668948,131069.41415416804,3162.8236276910666,134232.23778185912,3013,1,545.875,32,0,19,34.66373818331279,0.6399739583333333,44.00252525252526,1023.9898989898998,31.999684343434367,0
3936,4,0,0,32,0.0,0.0,1.0,32,800,500,300,0.625,11,5,6,362.43269665584364,0.7725134408602151,0.06990232930736973,0.21156682738600835,131198.73769258245,3110.142459953073,134308.8801525355,3014,2,546.875,32,0,20,34.593500944868936,0.6412760416666666,43.87626262626263,1024.49494949495,32.01546717171719,0
3937,4,1,0,33,0.030303030303030304,0.0,1.0,33,700,500,200,0.7142857142857143,9,5,4,354.50532445235274,0.7805397727272728,0.06598666797017905,0.2084929768335727,131485.18786344194,2722.439836841608,134207.62770028354,3015,0,531.2727272727273,33,0,21,34.507184251404006,0.6417297979797979,43.5968137254902,1025.6127450980393,31.07917409387998,0
3938,4,0,0,33,0.0,0.0,1.0,33,500,100,400,0.2,9,1,8,354.45302318543935,0.7795928030303031,0.06868686868686869,0.20863374149522687,131516.6116998269,2723.2921232218305,134239.90382304872,3016,1,532.2727272727273,33,0,21,34.47680207088809,0.6420454545454546,43.56617647058823,1025.7352941176464,31.08288770053474,0
3939,4,1,2,32,0.029411764705882353,0.058823529411764705,0.9411764705882353,34,950,600,350,0.631578947368421,13,6,7,344.1622718584617,0.7859477124183007,0.05750770405519656,0.20450634170763138,131877.806122449,2277.4730725623594,134155.27919501136,3017,0,517.5882352941177,34,0,17,34.37669023334879,0.6433823529411764,43.214285714285715,1027.1428571428573,30.21008403361345,0
3940,4,0,0,32,0.0,0.0,1.0,32,550,400,150,0.7272727272727273,7,4,3,360.1273183431952,0.7691112231182796,0.07348846153846167,0.21218524014057005,131554.70623214464,3075.2887141618135,134629.99494630645,3018,6,550.875,32,0,17,34.29282051282051,0.6448567708333334,43.5290404040404,1025.883838383838,32.05886994949494,0
3941,4,1,1,32,0.030303030303030304,0.030303030303030304,0.9696969696969697,33,750,600,150,0.8,9,6,3,352.2170756314118,0.7768308080808082,0.06910494128539235,0.20886248242856326,131799.59518274217,2684.413596933869,134484.00877967605,3019,0,535.1515151515151,33,0,17,34.24869216692527,0.6448863636363636,43.29044117647059,1026.8382352941173,31.116310160427798,0
3942,4,0,0,32,0.0,0.0,1.0,32,550,400,150,0.7272727272727273,7,4,3,360.78085259493787,0.767515120967742,0.07725811907983804,0.21329364005412718,131684.26890432084,3101.832561728381,134786.1014660492,3020,8,552.875,32,0,18,34.14524131709518,0.6461588541666667,43.40277777777777,1026.3888888888878,32.07465277777774,0
3943,4,0,0,32,0.0,0.0,1.0,32,1050,800,250,0.7619047619047619,13,8,5,359.60022330850626,0.7673891129032259,0.07534594095940972,0.21277655134629944,131716.66953627174,3073.068755739202,134789.73829201094,3021,9,553.875,32,0,18,34.14283517835179,0.646484375,43.37121212121212,1026.515151515151,32.07859848484847,0
3944,4,0,0,32,0.0,0.0,1.0,32,650,400,250,0.6153846153846154,9,4,5,359.95134921037715,0.7661710349462366,0.07417696421984532,0.21352912641342056,131813.89534550044,3089.317894857662,134903.2132403581,3022,10,554.875,32,0,18,34.03571867699496,0.6474609375,43.27651515151515,1026.893939393939,32.090435606060595,0
3945,4,0,0,32,0.0,0.0,1.0,32,750,500,250,0.6666666666666666,10,5,5,356.5134906534589,0.7648269489247312,0.06934157959434573,0.2118507849865513,131878.7324794663,3003.3094518416387,134882.04193130793,3023,11,555.875,32,0,18,34.05859455029707,0.6481119791666667,43.213383838383834,1027.146464646464,32.098327020202,0
3946,4,0,1,31,0.0,0.03125,0.96875,32,400,200,200,0.5,6,2,4,356.7932797662525,0.7627688172043011,0.07499999999999973,0.2129250217959896,132040.89506172854,3022.2608024691526,135063.1558641977,3024,12,556.875,32,0,18,33.887950450450454,0.6497395833333333,43.055555555555564,1027.777777777779,32.11805555555559,0
3947,4,0,0,31,0.0,0.0,1.0,31,700,300,400,0.42857142857142855,11,3,8,365.63521551883366,0.7543906810035842,0.07902203687804055,0.21756122552365006,131929.39758300796,3447.6067437066126,135377.00432671458,3025,21,575.4516129032259,31,0,21,33.77323616392056,0.6512096774193548,43.16406250000001,1027.3437500000011,33.14012096774197,0
3948,4,0,0,31,0.0,0.0,1.0,31,850,600,250,0.7058823529411765,11,6,5,369.28910692087305,0.7564516129032258,0.08602150537634423,0.2209020294126678,132130.12695312512,3558.843315972237,135688.97026909736,3026,22,576.4516129032259,31,0,21,33.47686592367444,0.6532258064516128,42.96875000000001,1028.125000000001,33.16532258064519,0
3949,4,0,0,31,0.0,0.0,1.0,31,650,500,150,0.7692307692307693,8,5,3,369.53152489178234,0.757168458781362,0.08993206893593753,0.22124264231011426,132163.59668307842,3567.723083496104,135731.3197665745,3027,23,577.4516129032259,31,0,21,33.436880038833316,0.6535618279569892,42.93619791666667,1028.255208333334,33.16952284946238,0
3950,4,1,0,32,0.03125,0.0,1.0,32,850,600,250,0.7058823529411765,11,6,5,361.89552729762715,0.7629368279569894,0.10239182397646474,0.21934202910059758,132625.50536935008,3199.3154397510452,135824.82080910113,3028,0,560.375,32,0,17,33.16810697066274,0.6555989583333334,42.48737373737374,1030.050505050505,32.189078282828284,0
3951,4,1,0,33,0.030303030303030304,0.0,1.0,33,750,500,250,0.6666666666666666,10,5,5,354.89892716287324,0.7695707070707072,0.10208776610107262,0.2172497650858112,132997.76715986637,2840.1529760188373,135837.92013588522,3029,0,544.3636363636364,33,0,18,32.97431289849908,0.6568813131313131,42.12622549019608,1031.4950980392155,31.25742721330956,0
3952,4,0,0,33,0.0,0.0,1.0,33,700,500,200,0.7142857142857143,9,5,4,353.06743218056374,0.7702020202020202,0.09938299603303169,0.21631161892983894,133029.371215398,2793.6676999231186,135823.0389153211,3030,1,545.3636363636364,33,0,18,32.989823394313774,0.6571969696969696,42.09558823529412,1031.617647058824,31.261140819964368,0
3953,4,0,0,33,0.0,0.0,1.0,33,1000,600,400,0.6,14,6,8,353.38745834505016,0.7705176767676768,0.10154987711097441,0.2170587736486992,133124.20590938575,2808.8849541041836,135933.09086348992,3031,2,546.3636363636364,33,0,18,32.88640996714563,0.6581439393939394,42.00367647058823,1031.9852941176466,31.272281639928686,0
3954,4,0,0,33,0.0,0.0,1.0,33,1100,800,300,0.7272727272727273,14,8,6,378.92033322528755,0.7705176767676768,0.1459472065532672,0.2134892609147351,129825.09731833896,3238.673827374069,133063.77114571302,3032,3,547.3636363636364,33,0,16,35.56647827481161,0.625,45.22058823529411,1019.1176470588224,30.882352941176435,5
3955,4,0,0,33,0.0,0.0,1.0,33,700,500,200,0.7142857142857143,9,5,4,383.6363813835119,0.7688604797979799,0.1572320173617936,0.21718516774650262,130012.50270328736,3375.505214340658,133388.007917628,3033,4,548.3636363636364,33,0,16,35.25544740847552,0.6268939393939392,45.03676470588236,1019.852941176472,30.90463458110521,0
3956,4,0,0,33,0.0,0.0,1.0,33,1000,800,200,0.8,12,8,4,387.187187187187,0.7693339646464648,0.1537100737100734,0.21972279027493763,130106.25608239633,3475.0950655997854,133581.35114799612,3034,5,549.3636363636364,33,0,17,35.069444444444464,0.627840909090909,44.94485294117648,1020.2205882352952,30.91577540106955,0
3957,4,1,0,34,0.029411764705882353,0.0,1.0,34,700,400,300,0.5714285714285714,10,4,6,378.9560046139431,0.7790032679738562,0.1495997967221443,0.2166131236250072,130387.71896626313,3082.335670174953,133470.0546364381,3035,0,534.1764705882352,33,1,18,34.99320054395648,0.6306818181818181,44.66911764705883,1021.323529411766,30.949197860962606,0
3958,4,2,3,33,0.05555555555555555,0.08333333333333333,0.9166666666666666,36,900,600,300,0.6666666666666666,12,6,6,359.0127131202935,0.7989748677248678,0.1364133303174242,0.20802034137677827,130913.23329260977,2199.903013545958,133113.13630615573,3036,0,505.44444444444446,35,1,15,34.969935157958226,0.631547619047619,44.155092592592595,1023.37962962963,29.239417989418,0
3959,4,1,1,33,0.029411764705882353,0.029411764705882353,0.9705882352941176,34,600,400,200,0.6666666666666666,8,4,4,376.37404689628664,0.7802658942364825,0.15035892083997382,0.21653188270405685,130638.16350682438,3033.762855632461,133671.92636245684,3037,0,536.1176470588235,33,1,15,34.804803004874955,0.6332070707070706,44.42401960784314,1022.3039215686281,30.97890671420085,0
3960,4,0,0,33,0.0,0.0,1.0,33,600,300,300,0.5,9,3,6,383.1171576426754,0.7666508838383839,0.1551509160554012,0.21974253414614997,130520.5005388483,3400.928636108585,133921.4291749569,3038,9,553.3636363636364,32,1,15,34.751997611104244,0.6344401041666665,44.539141414141426,1021.8434343434361,31.93260732323238,0
3961,4,0,0,33,0.0,0.0,1.0,33,650,300,350,0.46153846153846156,10,3,7,387.2651819470696,0.7648358585858587,0.15587944664031572,0.22267747961956527,130617.28395061752,3516.705246913608,134133.98919753113,3039,10,554.3636363636364,32,1,15,34.547667572463766,0.6354166666666665,44.44444444444446,1022.2222222222241,31.944444444444503,0
3962,4,0,0,33,0.0,0.0,1.0,33,900,600,300,0.6666666666666666,12,6,6,367.2509899581312,0.7646780303030304,0.09473765042728477,0.20221986403873976,128921.21006644078,2869.2884047001153,131790.4984711409,3040,11,555.3636363636364,33,0,18,36.78489903865492,0.6158459595959596,46.10906862745098,1015.563725490196,30.774658348187756,6
3963,4,0,0,33,0.0,0.0,1.0,33,800,500,300,0.625,11,5,6,370.48302179320365,0.7642045454545455,0.09247743449697832,0.2043202772883477,128983.44574502605,2957.235348183404,131940.68109320945,3041,12,556.3636363636364,33,0,18,36.63929605501266,0.6164772727272727,46.047794117647065,1015.8088235294126,30.782085561497354,0
3964,4,2,1,34,0.05714285714285714,0.02857142857142857,0.9714285714285714,35,750,500,250,0.6666666666666666,10,5,5,352.6407575811155,0.7852941176470588,0.09144416293120239,0.19731730939462414,129554.6392746913,2137.2492283950533,131691.88850308635,3042,0,525.5142857142857,35,0,17,36.51091405184174,0.6178571428571429,45.48611111111111,1018.0555555555552,29.087301587301578,0
3965,4,2,1,35,0.05555555555555555,0.027777777777777776,0.9722222222222222,36,1050,700,350,0.6666666666666666,14,7,7,356.0487200177303,0.7945105820105821,0.11803101688260753,0.20152357553003547,130004.05811216628,2057.555697589492,132061.61380975577,3043,0,511.8611111111111,36,0,17,35.96740650765607,0.6203703703703705,45.04504504504505,1019.8198198198203,28.32832832832834,2
3966,4,1,0,36,0.027777777777777776,0.0,1.0,36,1000,400,600,0.4,16,4,12,359.1322060872998,0.7964947089947091,0.13493552025105404,0.20447074849091004,130233.84871357858,2154.233879149434,132388.08259272802,3044,0,512.8333333333334,36,0,18,35.65547771403354,0.6226851851851851,44.81981981981983,1020.7207207207218,28.353353353353384,0
3967,4,0,1,35,0.0,0.027777777777777776,0.9722222222222222,36,800,500,300,0.625,11,5,6,359.68346522282377,0.7960648148148148,0.1386621315192742,0.20493592785951603,130262.58680555562,2170.659722222232,132433.24652777784,3045,1,513.8333333333334,36,0,18,35.612244897959194,0.622974537037037,44.79166666666667,1020.8333333333339,28.3564814814815,0
3968,4,0,0,35,0.0,0.0,1.0,35,900,600,300,0.6666666666666666,12,6,6,361.8617355828327,0.7866946778711484,0.14275671034940784,0.20602057108489344,130233.05047850216,2425.2715352794844,132658.32201378164,3046,2,529.4285714285714,35,0,19,35.5866358619647,0.6247023809523811,44.82060185185185,1020.717592592592,29.163359788359774,0
3969,4,1,1,35,0.027777777777777776,0.027777777777777776,0.9722222222222222,36,850,500,350,0.5882352941176471,12,5,7,357.9537810780464,0.793452380952381,0.1398013423476392,0.2050098927992446,130463.84222059888,2140.0051233666,132603.84734396546,3047,0,515.6944444444445,36,0,19,35.45226153733099,0.625,44.59459459459459,1021.6216216216208,28.378378378378354,0
3970,4,0,0,35,0.0,0.0,1.0,35,950,800,150,0.8421052631578947,11,8,3,370.69838128272335,0.7884453781512605,0.13437449373035681,0.21089150491297137,130203.51750042879,2653.2466349451465,132856.76413537393,3048,4,531.4285714285714,35,0,22,35.39115067664627,0.6244047619047619,44.849537037037045,1020.6018518518528,29.160052910052936,1
3971,4,1,2,34,0.027777777777777776,0.05555555555555555,0.9444444444444444,36,1300,900,400,0.6923076923076923,17,9,8,360.3626222391689,0.7925264550264551,0.12410039349694513,0.2067749163971273,130536.16780045342,2208.0979369628403,132744.26573741625,3049,0,517.6388888888889,34,2,19,35.31740253184219,0.6299019607843137,44.52380952380952,1021.9047619047611,30.056022408963564,0
3972,4,0,0,34,0.0,0.0,1.0,34,950,700,250,0.7368421052631579,12,7,5,374.2957582831817,0.7813057040998218,0.15487937435593402,0.21394930380878174,130387.71896626301,2960.714028258367,133348.43299452137,3050,6,547.7647058823529,33,1,23,35.11219102471803,0.6306818181818181,44.669117647058826,1021.3235294117651,30.949197860962578,0
3973,4,0,0,34,0.0,0.0,1.0,34,700,400,300,0.5714285714285714,10,4,6,377.14747720430876,0.7813428401663697,0.15618186821328073,0.2161016163197472,130481.60750973185,3042.1618187716285,133523.7693285035,3051,7,548.7647058823529,33,1,23,34.94399964015833,0.6316287878787878,44.57720588235294,1021.6911764705883,30.960338680926917,0
3974,4,0,0,34,0.0,0.0,1.0,34,800,400,400,0.5,12,4,8,397.9967582046394,0.7813428401663697,0.18317080030099664,0.20853736707824666,126927.95011732307,3331.324011286778,130259.27412860985,3052,8,549.7647058823529,31,3,17,38.053069948744465,0.600470430107527,48.07942708333333,1007.6822916666661,32.50588037634407,8
3975,4,4,4,34,0.10526315789473684,0.10526315789473684,0.8947368421052632,38,1250,1000,250,0.8,15,10,5,359.8803994365579,0.8148411569464201,0.15402866433819096,0.19320360510291856,127910.26341735241,1606.4793381344161,129516.74275548683,3053,0,492.7894736842105,35,3,16,38.00533943554538,0.6011904761904763,47.106481481481474,1011.574074074073,28.90211640211637,0
3976,4,3,2,35,0.08108108108108109,0.05405405405405406,0.9459459459459459,37,1100,900,200,0.8181818181818182,13,9,4,369.2758291347502,0.8144394394394394,0.1712865656141045,0.1988268380513701,128027.37054183791,2055.482681755802,130082.85322359372,3054,0,507.02702702702703,35,2,18,37.64772034156755,0.6023809523809525,46.990740740740726,1012.0370370370352,28.915343915343865,0
3977,4,2,1,36,0.05405405405405406,0.02702702702702703,0.972972972972973,37,400,300,100,0.75,5,3,2,372.58483250208275,0.813501001001001,0.19010099790633506,0.20149899364877402,128204.80619331053,2153.486831975574,130358.29302528611,3055,0,507.97297297297297,34,3,19,37.382204850907094,0.6063112745098039,46.81547619047618,1012.7380952380942,29.7864145658263,0
3978,4,3,2,37,0.07692307692307693,0.05128205128205128,0.9487179487179487,39,1100,900,200,0.8181818181818182,13,9,4,358.0715529214743,0.8282726045883941,0.19114994908205474,0.19656863447223932,128800.98637488841,1423.9938418147888,130224.9802167032,3056,0,482.84615384615387,36,3,17,37.14060535463354,0.6082175925925927,46.22747747747748,1015.0900900900901,28.196946946946948,0
3979,4,4,3,38,0.0975609756097561,0.07317073170731707,0.926829268292683,41,900,500,400,0.5555555555555556,13,5,8,342.6394842474557,0.8374491869918699,0.1838530897127444,0.19040194107130923,129282.86540516098,659.482864891511,129942.34827005249,3057,0,460.1951219512195,38,3,18,37.0417060615611,0.609375,45.753205128205124,1016.9871794871788,26.762820512820493,0
3980,4,0,0,38,0.0,0.0,1.0,38,1100,700,400,0.6363636363636364,15,7,8,363.4898683019509,0.8198790896159317,0.19834480193416382,0.19993082223279118,128877.99968117732,1769.1694262260175,130647.16910740333,3058,1,497.5263157894737,35,3,18,36.92448896234659,0.6110119047619047,46.15162037037038,1015.3935185185201,29.011243386243432,0
3981,4,2,0,40,0.05,0.0,1.0,40,1300,800,500,0.6153846153846154,18,8,10,348.4695169181556,0.8338141025641026,0.1944848582821428,0.1942011199689829,129396.54659366346,1018.1504164743044,130414.69701013777,3059,0,473.6,37,3,21,36.77782717246831,0.612331081081081,45.641447368421055,1017.434210526316,27.498221906116648,0
3982,4,1,3,38,0.024390243902439025,0.07317073170731707,0.926829268292683,41,950,700,250,0.7368421052631579,12,7,5,339.1259712231713,0.8392276422764228,0.18555624649730929,0.19001820292345964,129609.02829142021,590.7575197238792,130199.78581114409,3060,0,463.0243902439024,38,3,15,36.799653761410134,0.6126644736842104,45.432692307692314,1018.2692307692315,26.79655870445346,0
3983,4,1,0,39,0.02564102564102564,0.0,1.0,39,1350,1100,250,0.8148148148148148,16,11,5,355.75339589371566,0.8257984705353126,0.1961412144075707,0.19799879390683547,129344.54038075262,1402.9518961529338,130747.49227690556,3061,0,487.6923076923077,36,3,20,36.6454942986826,0.6137152777777777,45.69256756756758,1017.2297297297317,28.256381381381438,0
3984,4,2,3,38,0.04878048780487805,0.07317073170731707,0.926829268292683,41,750,500,250,0.6666666666666666,10,5,5,340.4152332665194,0.8358739837398373,0.1781848502209855,0.19140328210079788,129745.05077069195,633.4383446563137,130378.48911534826,3062,0,464.8536585365854,38,3,16,36.62874021252798,0.6140350877192982,45.29914529914531,1018.8034188034201,26.81061628430053,0
3985,4,3,4,37,0.07317073170731707,0.0975609756097561,0.9024390243902439,41,1250,900,350,0.72,16,9,7,335.5323016053154,0.8380081300813008,0.16375393442581032,0.1890515431194982,129826.69850107758,512.210191577186,130338.90869265478,3063,0,465.7560975609756,38,3,16,36.6702921340462,0.6148574561403508,45.2190170940171,1019.1239316239322,26.81905083220874,0
3986,4,0,0,37,0.0,0.0,1.0,37,1050,800,250,0.7619047619047619,13,8,5,364.11371711788837,0.8101851851851852,0.18594693031296705,0.20221890762312086,129260.23046339184,2013.0845979081223,131273.31506129997,3064,8,516.9459459459459,35,2,20,36.51879884664999,0.6148809523809522,45.775462962962976,1016.8981481481499,29.054232804232853,0
3987,4,0,0,37,0.0,0.0,1.0,37,1000,700,300,0.7,13,7,6,367.04312888846175,0.8081831831831832,0.18891556782581675,0.20460850640827336,129407.39300679455,2099.618886102555,131507.0118928971,3065,9,517.9459459459459,35,2,21,36.2943398551549,0.6163690476190475,45.630787037037045,1017.476851851853,29.07076719576723,0
3988,4,0,0,37,0.0,0.0,1.0,37,1050,800,250,0.7619047619047619,13,8,5,369.9562766579175,0.8071196196196196,0.19534203295858998,0.2066960290298428,129495.73072059324,2181.551676097394,131677.28239669063,3066,10,518.9459459459459,35,2,16,36.13022136305057,0.6172619047619048,45.54398148148148,1017.8240740740738,29.080687830687822,0
3989,4,1,1,37,0.02631578947368421,0.02631578947368421,0.9736842105263158,38,1100,700,400,0.6363636363636364,15,7,8,365.82198959890263,0.8134483167377904,0.1783307836932022,0.20082335044120034,128800.98637488841,1825.910529914926,130626.89690480333,3067,0,506.2631578947368,36,2,17,36.94392056800533,0.6082175925925927,46.22747747747748,1015.0900900900901,28.196946946946948,4
3990,4,1,0,38,0.02631578947368421,0.0,1.0,38,750,500,250,0.6666666666666666,10,5,5,366.1311232409397,0.8127074442863916,0.18797450995267329,0.20171879050152935,128943.91593874284,1842.076155547445,130785.99209429028,3068,0,506.89473684210526,36,2,18,36.79015596703256,0.6096643518518519,46.086711711711715,1015.6531531531534,28.212587587587596,0
3991,4,1,1,38,0.02564102564102564,0.02564102564102564,0.9743589743589743,39,1100,800,300,0.7272727272727273,14,8,6,358.15569773155147,0.8206252811515969,0.17825368081253457,0.19995320953355755,129466.28146701385,1474.3308791265883,130940.61234614043,3069,0,494.87179487179486,35,4,15,36.4604657113613,0.6169642857142856,45.572916666666664,1017.7083333333329,29.077380952380942,0
3992,4,1,0,39,0.02564102564102564,0.0,1.0,39,600,400,200,0.6666666666666666,8,4,4,358.9556963764036,0.8192757534862798,0.18250462821241675,0.20070027651814834,129525.1833231526,1498.7604756087285,131023.94379876132,3070,0,495.84615384615387,35,4,16,36.38016391889332,0.6175595238095237,45.515046296296305,1017.9398148148161,29.083994708994748,0
3993,4,1,1,39,0.025,0.025,0.975,40,500,400,100,0.8,6,4,2,352.05985081334325,0.8219551282051282,0.18981931705160782,0.19824452955880204,129803.15778193761,1139.6960727619835,130942.8538546996,3071,0,484.425,36,4,17,36.273114892990016,0.6183449074074073,45.24211711711713,1019.0315315315337,28.30643143143149,0
3994,4,2,1,40,0.04878048780487805,0.024390243902439025,0.975609756097561,41,750,500,250,0.6666666666666666,10,5,5,337.2316030160248,0.828150406504065,0.18536794904031506,0.19242038525032018,130318.5595567868,589.5073484149124,130908.06690520172,3072,0,462.5365853658537,37,4,20,36.1285617124857,0.6216216216216215,44.736842105263165,1021.0526315789482,27.596017069701304,0
3995,4,0,1,39,0.0,0.025,0.975,40,800,500,300,0.625,11,5,6,330.11790182290474,0.8259615384615384,0.15307262569832414,0.1878201363183129,130206.62607725458,596.7076408125643,130803.33371806714,3073,1,474.975,37,3,18,36.42341713221602,0.6204954954954953,44.84649122807018,1020.6140350877197,27.58416311047891,2
3996,4,1,1,39,0.025,0.025,0.975,40,1000,400,600,0.4,16,4,12,331.67202066011544,0.8225961538461538,0.16863425925925868,0.18995761183261187,130463.8422205992,654.2532574078722,131118.09547800708,3074,0,475.925,36,4,20,36.1235119047619,0.625,44.594594594594604,1021.6216216216234,28.37837837837843,0
3997,4,2,1,40,0.04878048780487805,0.024390243902439025,0.975609756097561,41,1350,1200,150,0.8888888888888888,15,12,3,332.361572035646,0.8325711382113821,0.18150247662416685,0.1936737020826557,131131.51552641208,516.6153287550171,131648.1308551671,3075,0,450.7560975609756,37,4,19,35.43149823359384,0.6297860360360359,43.94188596491229,1024.2324561403518,27.68195827406356,0
3998,4,1,0,41,0.024390243902439025,0.0,1.0,41,1000,800,200,0.8,12,8,4,332.13753329331274,0.83125,0.19512195121951192,0.19425995239935714,131273.37643363295,520.1630871502763,131793.53952078323,3076,0,451.7317073170732,38,3,20,35.294168751737566,0.6293859649122806,43.80341880341881,1024.7863247863256,26.968061178587515,0
3999,4,0,0,41,0.0,0.0,1.0,41,600,200,400,0.3333333333333333,10,2,8,332.0010294832567,0.8314024390243903,0.19688535281074704,0.19474338931420632,131384.32618690358,523.957724677426,131908.283911581,3077,1,452.7317073170732,37,4,20,35.18582887700535,0.6323198198198199,43.695175438596486,1025.2192982456133,27.708629682313873,0
4000,4,0,0,41,0.0,0.0,1.0,41,1000,700,300,0.7,13,7,6,331.27919032396386,0.8310467479674797,0.1875290080675025,0.19489217272266388,131496.76462950124,512.4283433363946,132009.19297283763,3078,2,453.7317073170732,37,4,20,35.091048392844414,0.633445945945946,43.585526315789465,1025.657894736841,27.72048364153624,0
4001,4,0,0,41,0.0,0.0,1.0,41,1000,700,300,0.7,13,7,6,330.91995044552647,0.8308434959349593,0.18787706629069723,0.19539935749020068,131637.38031173046,512.2870739073501,132149.66738563782,3079,3,454.7317073170732,37,4,17,34.95866278448552,0.6348536036036037,43.4484649122807,1026.2061403508767,27.735301090564235,0
4002,4,0,0,41,0.0,0.0,1.0,41,950,800,150,0.8421052631578947,11,8,3,327.37463644656225,0.8294207317073171,0.18446359175253502,0.19402127187883572,131778.07113727284,428.1596260387711,132206.2307633116,3080,4,455.7317073170732,37,4,18,34.90806991314254,0.6362612612612613,43.311403508771924,1026.754385964911,27.75011853959219,0
4003,4,0,1,40,0.0,0.024390243902439025,0.975609756097561,41,1350,1000,350,0.7407407407407407,17,10,7,330.8527960616538,0.8293191056910569,0.18342796300201258,0.1968101489715323,131918.83710612875,529.1432219529083,132447.98032808164,3081,5,456.7317073170732,37,4,18,34.67719340377843,0.637668918918919,43.17434210526316,1027.302631578947,27.76493598862019,0
4004,4,0,0,40,0.0,0.0,1.0,40,1150,1000,150,0.8695652173913043,13,10,3,335.45179017687144,0.822809829059829,0.17940692830519578,0.19947791590569902,131905.89871966565,849.6139720801907,132755.51269174585,3082,6,468.975,36,4,19,34.572096762405906,0.6394675925925926,43.18693693693694,1027.2522522522527,28.534784784784797,0
4005,4,1,0,41,0.024390243902439025,0.0,1.0,41,1500,1200,300,0.8,18,12,6,329.50563543691726,0.8289126016260162,0.17757927739158097,0.19791433237318526,132285.18029586005,517.7424784548904,132802.92277431494,3083,0,458.5121951219512,37,4,20,34.34369004476658,0.6413288288288289,42.81798245614034,1028.7280701754369,27.80346135609289,0
4006,4,0,2,39,0.0,0.04878048780487805,0.9512195121951219,41,1000,700,300,0.7,13,7,6,332.57388254191994,0.828150406504065,0.1761627332872513,0.20035548533622996,132398.0034722223,606.4717028316458,133004.47517505396,3084,1,459.5121951219512,36,5,21,34.15148448043184,0.6443865740740742,42.708333333333336,1029.1666666666672,28.587962962962976,0
4007,4,1,0,40,0.025,0.0,1.0,40,1100,900,200,0.8181818181818182,13,9,4,340.2412693619308,0.8225160256410257,0.1770361247947454,0.2043460878120472,132282.1316882761,1001.5680799042246,133283.69976818032,3085,0,471.225,36,4,22,34.07065316548074,0.6432291666666667,42.820945945945944,1028.716216216216,28.575450450450447,0
4008,4,1,1,40,0.024390243902439025,0.024390243902439025,0.975609756097561,41,1100,600,500,0.5454545454545454,16,6,10,336.47776405323134,0.8267276422764228,0.17741655934106126,0.20396037825015936,132629.8992193206,725.4531135865551,133355.35233290715,3086,0,460.7073170731707,36,5,15,33.81823730913597,0.646701388888889,42.483108108108105,1030.067567567567,28.612987987987974,0
4009,4,0,0,40,0.0,0.0,1.0,40,1150,700,450,0.6086956521739131,16,7,9,331.3591300765507,0.821607905982906,0.13868898623279136,0.19325251454829498,131163.9135437213,692.4720578566858,131856.385601578,3087,2,473.225,38,2,20,35.42448894451398,0.6282894736842104,43.910256410256416,1024.358974358975,26.95681511470987,5
4010,4,1,1,40,0.024390243902439025,0.024390243902439025,0.975609756097561,41,1200,900,300,0.75,15,9,6,326.96222916700333,0.8289126016260162,0.13597606620917002,0.19192867576526362,131412.43128895434,393.5857518346629,131806.017040789,3088,0,462.6585365853659,37,4,21,35.28666720136883,0.6326013513513513,43.66776315789474,1025.3289473684215,27.7115931721195,0
4011,4,0,0,40,0.0,0.0,1.0,40,1250,900,350,0.72,16,9,7,334.78938029548686,0.8207264957264957,0.13944282289169174,0.1959508557153512,131300.7492900322,791.619297428597,132092.3685874608,3089,4,475.225,38,2,21,35.19862573404219,0.6296600877192982,43.776709401709404,1024.8931623931628,26.970872694556917,0
4012,4,0,0,40,0.0,0.0,1.0,40,550,300,250,0.5454545454545454,8,3,5,334.32982227672113,0.8196581196581196,0.1418241239151925,0.19596937361139696,131356.98356718215,783.3171013015625,132140.30066848372,3090,5,476.225,36,4,21,35.15370390713683,0.6339699074074073,43.72184684684685,1025.1126126126135,28.475350350350375,0
4013,4,2,0,42,0.047619047619047616,0.0,1.0,42,1300,900,400,0.6923076923076923,17,9,8,320.01152412468963,0.8293166860240031,0.14928745220716055,0.19061556002209787,131969.5312500001,46.35416666668141,132015.88541666677,3091,0,454.5,39,3,16,34.90470397404705,0.6346153846153846,43.12500000000001,1027.5000000000007,26.346153846153864,0
4014,4,0,2,40,0.0,0.047619047619047616,0.9523809523809523,42,1250,900,350,0.72,16,9,7,321.61244884486996,0.8281794425087108,0.07625315782475761,0.1811870582593457,129822.05119307281,-48.82799590191979,129773.2231971709,3092,1,455.5,40,2,17,37.02965031245846,0.6114583333333334,45.22357723577235,1019.1056910569098,25.477642276422745,7
4015,4,0,0,40,0.0,0.0,1.0,40,1150,700,450,0.6086956521739131,16,7,9,330.1619821693213,0.8181089743589743,0.08297230672401157,0.18525215868276296,129663.42872242325,561.9869283731639,130225.41565079642,3093,2,478.875,38,2,17,36.97266512815135,0.6132127192982455,45.37927350427351,1018.482905982907,26.80218173639229,0
4016,4,1,1,40,0.024390243902439025,0.024390243902439025,0.975609756097561,41,900,700,200,0.7777777777777778,11,7,4,325.37337234684486,0.823170731707317,0.08116124079695708,0.18362767138328875,129890.67382812513,252.5933159722364,130143.26714409736,3094,0,468.1707317073171,39,2,17,36.864312964098374,0.6137820512820513,45.15625000000001,1019.375000000001,26.13782051282054,0
4017,4,0,0,40,0.0,0.0,1.0,40,1550,1100,450,0.7096774193548387,20,11,9,333.3313555634664,0.818616452991453,0.07537735849056593,0.18794214728578454,129853.92011834348,656.8766436555209,130510.796761999,3095,4,480.875,38,2,18,36.69876834381553,0.6151315789473681,45.19230769230771,1019.2307692307716,26.8218623481782,0
4018,4,0,0,40,0.0,0.0,1.0,40,1600,1200,400,0.75,20,12,8,337.0622585329743,0.8189636752136752,0.08515502252016338,0.19097527490886104,130044.55133912279,766.6220368544239,130811.17337597722,3096,5,481.875,38,2,18,36.41043434237631,0.6170504385964912,45.00534188034189,1019.9786324786336,26.84154295996404,0
4019,4,1,0,41,0.024390243902439025,0.0,1.0,41,950,700,250,0.7368421052631579,12,7,5,331.88936581375776,0.8222560975609756,0.09642832543794477,0.18989791900331185,130426.23325525982,457.59859650085195,130883.83185176068,3097,0,471.0975609756098,38,3,20,36.15599832653487,0.6208881578947367,44.63141025641026,1021.47435897436,26.88090418353579,0
4020,4,0,0,41,0.0,0.0,1.0,41,1100,900,200,0.8181818181818182,13,9,4,331.7667709398159,0.8200711382113821,0.09766040587433977,0.19059107473427844,130581.79253472232,464.5399305555641,131046.33246527788,3098,1,472.0975609756098,39,2,17,36.001834488381576,0.6207264957264957,44.47916666666667,1022.0833333333342,26.20726495726498,0
4021,4,1,1,41,0.023809523809523808,0.023809523809523808,0.9761904761904762,42,1050,700,350,0.6666666666666666,14,7,7,322.1160846743229,0.8288327526132404,0.09296522820909447,0.18625747411926535,130833.79937743742,28.734239705204686,130862.53361714262,3099,0,461.8333333333333,40,2,17,35.99404821032415,0.6216145833333333,44.232723577235774,1023.0691056910573,25.57672764227643,0
4022,4,1,0,42,0.023809523809523808,0.0,1.0,42,1500,1100,400,0.7333333333333333,19,11,8,323.0635682292112,0.8266308555942702,0.09771027728145065,0.18768987233800905,131015.8109012494,65.2870728402547,131081.09797408964,3100,0,462.8095238095238,40,2,18,35.786223611938325,0.6234374999999999,44.054878048780495,1023.7804878048792,25.59451219512198,0
4023,4,0,2,40,0.0,0.047619047619047616,0.9523809523809523,42,600,400,200,0.6666666666666666,8,4,4,338.8962135549883,0.8272599690282617,-0.037888318978031466,0.1986281664585196,131353.54785722186,525.8582155879399,131879.4060728098,3101,1,463.8095238095238,41,1,20,35.04014242394917,0.6252540650406502,43.725198412698425,1025.0992063492085,25.002419667053868,6
4024,4,0,0,40,0.0,0.0,1.0,40,950,500,450,0.5263157894736842,14,5,9,350.86325064445737,0.8146367521367521,-0.015249950406665214,0.2049480471029792,131223.97898902782,1208.3343661180668,132432.3133551459,3102,5,487.725,40,0,20,34.86432090193746,0.6255208333333333,43.85162601626017,1024.5934959349604,25.61483739837401,0
4025,4,3,1,42,0.06976744186046512,0.023255813953488372,0.9767441860465116,43,900,600,300,0.6666666666666666,12,6,6,333.6942940441483,0.8362864525655223,0.06568580920740352,0.19012814428096783,130262.5868055553,211.7295426002698,130474.31634815557,3103,0,454.6279069767442,35,8,20,36.27551020408161,0.6250000000000002,44.79166666666665,1020.8333333333313,29.16666666666661,8
4026,4,1,1,42,0.023255813953488372,0.023255813953488372,0.9767441860465116,43,1250,900,350,0.72,16,9,7,329.45392329505756,0.8423311184939092,0.06257736574574024,0.1891468233221948,130558.13426997587,2.577910665282161,130560.71218064115,3104,0,454.86046511627904,35,8,16,36.084843337108346,0.6279761904761905,44.50231481481481,1021.9907407407397,29.19973544973542,0
4027,4,0,0,42,0.0,0.0,1.0,42,1050,600,450,0.5714285714285714,15,6,9,336.7355315824889,0.833454316686024,0.06300955043093404,0.19352150429499654,130597.0025510204,395.330215419502,130992.3327664399,3105,2,466.6904761904762,34,8,18,35.859490255454624,0.630514705882353,44.464285714285715,1022.1428571428571,30.06302521008403,0
4028,4,1,2,41,0.023255813953488372,0.046511627906976744,0.9534883720930233,43,1250,900,350,0.72,16,9,7,327.8318896900857,0.8361941675895164,0.0664736571972433,0.1900610471035564,130935.05333371795,-15.062807787026372,130919.99052593093,3106,0,456.8139534883721,37,6,19,35.745661024212566,0.6278153153153154,44.133771929824555,1023.4649122807008,27.661213845424346,0
4029,4,0,1,40,0.0,0.024390243902439025,0.975609756097561,41,1200,900,300,0.75,15,9,6,341.57683052261837,0.827489837398374,0.057741484903835794,0.19679680337216832,130694.03863322765,728.4110969076962,131422.44973013535,3107,4,480.0243902439024,36,5,20,35.63761930983848,0.6273148148148149,44.36936936936936,1022.5225225225212,28.403403403403367,0
4030,4,0,0,40,0.0,0.0,1.0,40,1150,900,250,0.782608695652174,14,9,5,342.3786052458695,0.822008547008547,0.070177273728254,0.1975528902695671,130751.6194403863,953.3114195276335,131704.93085991393,3108,5,491.725,36,4,20,35.55888937825736,0.6278935185185186,44.31306306306306,1022.7477477477476,28.409659659659653,0
4031,4,0,0,40,0.0,0.0,1.0,40,1000,700,300,0.7,13,7,6,341.10712484592017,0.8203258547008547,0.06782958199356948,0.19718274317301318,130822.8553497229,924.921610495529,131747.77696021844,3109,6,492.725,37,3,21,35.519381922115045,0.6266891891891893,44.243421052631575,1023.0263157894728,27.649359886201967,0
4032,4,1,1,40,0.024390243902439025,0.024390243902439025,0.975609756097561,41,1150,900,250,0.782608695652174,14,9,5,333.23446299586067,0.8229166666666666,0.072962094110822,0.1940695967362286,131109.19922017684,538.0207191905963,131647.21993936744,3110,0,481.6829268292683,38,3,22,35.43166249391473,0.6277412280701754,43.96367521367522,1024.1452991452998,26.951192082771048,0
4033,4,1,0,41,0.024390243902439025,0.0,1.0,41,900,500,400,0.5555555555555556,13,5,8,333.5275565069603,0.823170731707317,0.08484137669009684,0.1958065356590561,131417.11576485317,566.7937860120173,131983.90955086518,3111,0,479.9512195121951,35,6,23,35.11365560447004,0.6366071428571429,43.663194444444436,1025.3472222222206,29.295634920634875,0
4034,4,0,0,41,0.0,0.0,1.0,41,1600,1200,400,0.75,20,12,8,331.72547394763905,0.8235264227642276,0.0836481742795252,0.1953256200510048,131530.201548677,526.3836894326702,132056.58523810966,3112,1,480.9512195121951,36,5,23,35.04592527536868,0.6357060185185186,43.552927927927925,1025.788288288288,28.49411911911911,0
4035,4,0,0,41,0.0,0.0,1.0,41,1350,1000,350,0.7407407407407407,17,10,7,332.2301473743861,0.8238821138211382,0.08104199832725834,0.19646281803990073,131693.6476247499,550.5199917282225,132244.1676164781,3113,2,481.9512195121951,37,4,18,34.868403482533914,0.6354166666666666,43.39364035087719,1026.425438596491,27.74122807017543,0
4036,4,1,0,42,0.023809523809523808,0.0,1.0,42,1250,1200,50,0.96,13,12,1,324.62197993966504,0.8293892760356175,0.0829737530528123,0.1936348521212055,132023.05230034742,171.51692708335918,132194.5692274308,3114,0,471.45238095238096,39,3,19,34.73249881748769,0.6351495726495726,43.07291666666668,1027.708333333335,26.35149572649577,0
4037,4,0,1,41,0.0,0.023809523809523808,0.9761904761904762,42,1350,800,550,0.5925925925925926,19,8,11,326.1754377320566,0.8284698025551684,0.08184976118106824,0.19511221638881235,132130.12695312526,219.5203993055854,132349.64735243085,3115,1,472.45238095238096,39,3,19,34.585021952043256,0.6362179487179487,42.968750000000014,1028.125000000002,26.36217948717954,0
4038,4,0,0,41,0.0,0.0,1.0,41,1100,600,500,0.5454545454545454,16,6,10,329.98898191703904,0.8238313008130081,0.07671719031507784,0.19725386205567938,132103.35422092056,518.5302734375398,132621.8844943581,3116,2,484.8536585365854,39,2,19,34.51390296213733,0.6359508547008546,42.994791666666686,1028.0208333333367,26.359508547008634,0
4039,4,0,0,41,0.0,0.0,1.0,41,1100,800,300,0.7272727272727273,14,8,6,328.8098360984357,0.823119918699187,0.08338582930040772,0.19710622415299714,132210.4614257815,494.4200303819745,132704.88145616348,3117,3,485.8536585365854,39,2,19,34.43661585468789,0.6370192307692306,42.890625000000014,1028.437500000002,26.37019230769236,0
4040,4,0,0,41,0.0,0.0,1.0,41,1000,700,300,0.7,13,7,6,327.49800371849204,0.8224085365853658,0.0912343779709941,0.19687752785925441,132317.61203342033,466.75075954863166,132784.36279296895,3118,4,486.8536585365854,39,2,21,34.362766190813666,0.6380876068376068,42.78645833333334,1028.8541666666683,26.38087606837611,0
4041,4,0,0,41,0.0,0.0,1.0,41,1200,800,400,0.6666666666666666,16,8,8,329.6862909472016,0.820630081300813,0.087954941480197,0.19889865245056512,132451.61132812552,533.4960937500455,132985.10742187558,3119,5,487.8536585365854,39,2,21,34.171979356405565,0.6394230769230766,42.65625000000002,1029.375000000004,26.394230769230873,0
4042,4,0,0,41,0.0,0.0,1.0,41,1150,800,350,0.6956521739130435,15,8,7,325.1270430715126,0.8200711382113821,0.08928122054839793,0.19670783034302206,132558.8595920142,419.694010416702,132978.5536024309,3120,6,488.8536585365854,39,2,21,34.181755344257894,0.6404914529914528,42.55208333333335,1029.7916666666692,26.404914529914596,0
4043,4,0,0,41,0.0,0.0,1.0,41,800,700,100,0.875,9,7,2,327.02352979228266,0.8181910569105691,0.09244565901013413,0.19827931858466508,132639.32427300367,475.23600260418726,133114.56027560786,3121,7,489.8536585365854,39,2,17,34.05225081740656,0.6412927350427349,42.47395833333334,1030.1041666666683,26.412927350427392,0
4044,4,0,0,41,0.0,0.0,1.0,41,800,400,400,0.5,12,4,8,326.6091755917475,0.818140243902439,0.0970529996473748,0.19831131711344283,132692.98095703174,467.7490234375457,133160.7299804693,3122,8,490.8536585365854,39,2,17,34.00913709432816,0.6418269230769229,42.42187500000002,1030.3125000000039,26.41826923076933,0
4045,4,0,0,41,0.0,0.0,1.0,41,950,700,250,0.7368421052631579,12,7,5,324.0467557152014,0.8168191056910569,0.0950221225304726,0.19731954755704156,132800.32687717042,406.70301649309147,133207.0298936635,3123,9,491.8536585365854,39,2,17,33.96759727134918,0.642895299145299,42.31770833333335,1030.729166666669,26.428952991453052,0
4046,4,0,0,41,0.0,0.0,1.0,41,850,600,250,0.7058823529411765,11,6,5,325.1670441375196,0.8167682926829268,0.09765462310579331,0.19828578162840677,132854.01611328177,439.94954427087873,133293.96565755265,3124,10,492.8536585365854,39,2,18,33.88495251086188,0.643429487179487,42.26562500000002,1030.937500000004,26.434294871794975,0
4047,4,0,1,40,0.0,0.024390243902439025,0.975609756097561,41,1250,900,350,0.72,16,9,7,326.5337547401743,0.8158536585365853,0.09543323219985012,0.20012316255858228,133042.01388888908,488.5416666666873,133530.55555555577,3125,11,493.8536585365854,39,2,18,33.661483575659666,0.6452991452991452,42.08333333333334,1031.6666666666683,26.452991452991494,0
4048,4,0,0,40,0.0,0.0,1.0,40,1200,800,400,0.6666666666666666,16,8,8,331.4897770472029,0.8103098290598291,0.09541830606750845,0.20340077933430029,133086.105860545,823.3367119585059,133909.44257250353,3126,12,505.975,38,2,19,33.48950783461032,0.6474780701754386,42.04059829059829,1031.8376068376072,27.15362123256861,0
4049,4,0,0,40,0.0,0.0,1.0,40,1000,500,500,0.5,15,5,10,330.8329506690664,0.8089209401709402,0.09496998551024638,0.20359923371748545,133196.36774965297,813.1494722039558,134009.51722185692,3127,13,506.975,38,2,19,33.39607914165459,0.6485745614035088,41.93376068376068,1032.264957264957,27.16486729644624,0
4050,4,1,1,40,0.024390243902439025,0.024390243902439025,0.975609756097561,41,1450,900,550,0.6206896551724138,20,9,11,322.6406364378078,0.8109756097560976,0.09500962287663794,0.20047357766890214,133552.9635959201,417.9226345486077,133970.8862304687,3128,0,495.5853658536585,39,2,19,33.25113792871779,0.6503739316239316,41.588541666666664,1033.645833333333,26.503739316239308,0
4051,4,0,0,40,0.0,0.0,1.0,40,1100,1000,100,0.9090909090909091,12,10,2,346.8971145826159,0.8046474358974359,0.07652981579768992,0.20538104584253544,131739.1030777447,1193.2001779770492,132932.30325572172,3129,15,508.975,38,2,17,34.44622229160163,0.634046052631579,43.349358974358964,1026.6025641025624,27.01585695006743,8
4052,4,0,0,40,0.0,0.0,1.0,40,1350,1200,150,0.8888888888888888,15,12,3,347.74109198373225,0.8022970085470086,0.08150093613480358,0.20662440409960442,131876.23844875433,1171.757432975368,133047.9958817297,3130,16,509.975,38,2,18,34.286370570695524,0.6354166666666667,43.21581196581196,1027.136752136751,27.029914529914503,0
4053,4,0,0,40,0.0,0.0,1.0,40,1050,600,450,0.5714285714285714,15,6,9,347.9303660595834,0.8020833333333334,0.08178415470991918,0.2073354560570677,131985.99810979614,1184.387327416171,133170.3854372123,3131,17,510.975,38,2,18,34.17095550010398,0.6365131578947368,43.10897435897436,1027.5641025641023,27.041160593792167,0
4054,4,1,1,40,0.024390243902439025,0.024390243902439025,0.975609756097561,41,1300,1000,300,0.7692307692307693,16,10,6,338.6506720728132,0.8102134146341463,0.07706991112636596,0.20358202605375395,132317.6120334202,761.8896484375055,133079.5016818577,3132,0,499.4878048780488,39,2,19,34.0759044581688,0.6380876068376069,42.786458333333336,1028.8541666666672,26.380876068376082,0
4055,4,0,0,40,0.0,0.0,1.0,40,850,800,50,0.9411764705882353,9,8,1,342.9687300682338,0.8014957264957265,0.07890608767920249,0.20556768341449663,132205.65440317037,1068.4810796990203,133274.13548286937,3133,19,512.975,38,2,19,34.077411870628154,0.6387061403508772,42.89529914529914,1028.4188034188028,27.06365272154744,0
4056,4,0,0,40,0.0,0.0,1.0,40,1300,700,600,0.5384615384615384,19,7,12,341.43496278180527,0.8022435897435898,0.07433021806853612,0.2052446124587257,132315.55103550298,1035.4310486522063,133350.9820841552,3134,20,513.975,38,2,20,34.0063603322949,0.6398026315789473,42.78846153846154,1028.846153846154,27.074898785425106,0
4057,4,0,0,40,0.0,0.0,1.0,40,1000,700,300,0.7,13,7,6,339.6494596574558,0.8013354700854701,0.07917943107221004,0.20477546578292533,132426.9793442092,995.8017599000075,133422.7811041092,3135,21,514.975,36,4,20,33.940326404084615,0.6446759259259258,42.68018018018019,1029.2792792792802,28.591091091091116,0
4058,4,1,0,41,0.024390243902439025,0.0,1.0,41,1250,900,350,0.72,16,9,7,331.71750080443525,0.8095528455284553,0.0770082514257977,0.20204611412633802,132810.6508875741,611.123438527297,133421.77432610138,3136,0,503.390243902439,38,3,17,33.75958747927032,0.644736842105263,42.307692307692314,1030.7692307692319,27.125506072874522,0
4059,4,0,1,40,0.0,0.024390243902439025,0.975609756097561,41,950,800,150,0.8421052631578947,11,8,3,322.42838105698183,0.8095528455284553,0.03164059903443417,0.19803459213462632,133122.62505425359,395.82830926919513,133518.45336352277,3137,1,504.390243902439,39,2,16,33.68672403351165,0.6461004273504274,42.005208333333336,1031.9791666666674,26.461004273504294,4
4060,4,0,0,40,0.0,0.0,1.0,40,1100,600,500,0.5454545454545454,16,6,10,331.01539292465554,0.7988782051282052,0.046692546583851025,0.20341022236973116,133141.23109796192,814.359385272851,133955.59048323476,3138,24,517.975,38,2,17,33.446557971014514,0.6480263157894737,41.98717948717949,1032.0512820512824,27.159244264507432,0
4061,4,0,0,40,0.0,0.0,1.0,40,1150,800,350,0.6956521739130435,15,8,7,336.10442801002887,0.7975160256410256,0.05059764048432136,0.20699662765206597,133223.94035585164,955.4312541091596,134179.3716099608,3139,25,518.975,38,2,17,33.23243299182448,0.6488486842105262,41.90705128205129,1032.3717948717965,27.167678812415698,0
4062,4,0,0,40,0.0,0.0,1.0,40,1450,1300,150,0.896551724137931,16,13,3,335.2731079957942,0.7965544871794872,0.05580066204613643,0.2070980916929935,133334.25931633092,940.6783046607086,134274.93762099164,3140,26,519.975,38,2,17,33.14346919071757,0.6499451754385963,41.80021367521369,1032.7991452991475,27.178924876293355,0
4063,4,0,0,40,0.0,0.0,1.0,40,1400,1000,400,0.7142857142857143,18,10,8,337.185695172276,0.7939903846153846,0.05775095627003002,0.20921085499688435,133499.82336410627,1002.8461492804496,134502.66951338673,3141,27,520.975,38,2,17,32.92842620352184,0.6515899122807017,41.63995726495727,1033.4401709401714,27.195793972109772,0
4064,4,0,0,40,0.0,0.0,1.0,40,1400,900,500,0.6428571428571429,19,9,10,331.14050077714785,0.7948985042735043,0.05367624263718107,0.20607373800774662,133610.25646732782,848.753447110822,134459.00991443865,3142,28,521.975,38,2,17,32.97423443904791,0.6526864035087719,41.53311965811966,1033.8675213675217,27.207040035987415,0
4065,4,0,0,40,0.0,0.0,1.0,40,1350,700,650,0.5185185185185185,20,7,13,331.35638527227394,0.7938568376068376,0.05473042759760416,0.20698016272297784,133748.36205164727,863.6747571042399,134612.03680875152,3143,29,522.975,38,2,17,32.83068236590237,0.6540570175438596,41.39957264957265,1034.401709401709,27.22109761583445,0
4066,4,0,0,40,0.0,0.0,1.0,40,1250,900,350,0.72,16,9,7,331.35851437705355,0.7909455128205128,0.05517962217404815,0.20775857144145754,133886.5389751808,872.888929980279,134759.42790516108,3144,30,523.975,38,2,17,32.69265510477961,0.6554276315789473,41.26602564102564,1034.9358974358975,27.23515519568151,0
4067,4,0,0,40,0.0,0.0,1.0,40,1000,700,300,0.7,13,7,6,332.24543149719614,0.7895032051282052,0.06094862271742518,0.209256333171041,134052.44545118336,907.6625164365471,134960.1079676199,3145,31,524.975,38,2,17,32.504126689363446,0.6570723684210527,41.105769230769226,1035.5769230769224,27.252024291497957,0
4068,4,0,0,40,0.0,0.0,1.0,40,700,400,300,0.5714285714285714,10,4,6,318.9117457567299,0.7889155982905983,0.017999896981559793,0.20299516826626704,134439.9600614542,574.8964725326641,135014.85653398687,3146,32,525.975,38,2,20,32.46347137804334,0.6609100877192984,40.731837606837594,1037.0726495726476,27.291385515069674,3
4069,4,0,0,40,0.0,0.0,1.0,40,1050,800,250,0.7619047619047619,13,8,5,319.1144161325864,0.7880608974358975,0.018560177082260765,0.20405255588517485,134606.2089656838,590.956356380998,135197.1653220648,3147,33,526.975,38,2,20,32.29284635711589,0.6625548245614037,40.57158119658118,1037.7136752136726,27.30825461088612,0
4070,4,0,0,40,0.0,0.0,1.0,40,1350,1000,350,0.7407407407407407,17,10,7,318.361941159378,0.7870459401709402,0.01734173957797225,0.20388175730806551,134661.64809564236,574.2287374899386,135235.8768331323,3148,34,527.975,38,2,21,32.257248241550855,0.6631030701754387,40.518162393162385,1037.9273504273492,27.31387764282498,0
4071,4,0,1,39,0.0,0.025,0.975,40,650,400,250,0.6153846153846154,9,4,5,316.52658478033004,0.7865384615384615,0.01762193867050854,0.20317076293891967,134744.82819234408,530.0640569069901,135274.89224925108,3149,35,528.975,38,2,21,32.22220793030115,0.6639254385964912,40.43803418803418,1038.2478632478621,27.322312190733214,0
4072,4,0,0,39,0.0,0.0,1.0,39,1250,700,550,0.56,18,7,11,320.9616394626927,0.7778340080971661,0.02531337075639528,0.20604649247947351,134749.9365790434,849.912112380718,135599.84869142412,3150,39,542.6410256410256,37,2,22,32.10201270813532,0.6658220720720722,40.43311403508771,1038.267543859648,28.061284969179674,0
4073,4,0,0,39,0.0,0.0,1.0,39,1250,1000,250,0.8,15,10,5,324.1718987562077,0.7771030139451193,0.02735981074416638,0.2087614137945312,134863.80575032684,943.8111967143531,135807.61694704118,3151,40,543.6410256410256,37,2,20,31.9054813680988,0.6669481981981983,40.32346491228069,1038.7061403508758,28.07313892840205,0
4074,4,0,0,39,0.0,0.0,1.0,39,1200,800,400,0.6666666666666666,16,8,8,327.10938937529124,0.7744601889338731,0.035771381271961555,0.21164982265449728,135034.69967922816,1034.2236313096257,136068.9233105378,3152,41,544.6410256410256,37,2,20,31.659347856665597,0.6686373873873874,40.15899122807017,1039.3640350877188,28.09091986723564,0
4075,4,0,1,38,0.0,0.02564102564102564,0.9743589743589743,39,900,500,400,0.5555555555555556,13,5,8,326.30391042606254,0.7732231219073324,0.04069677817172823,0.2114618848085782,135091.6883680555,1016.1892361111072,136107.8776041666,3153,42,545.6410256410256,37,2,21,31.62366399465597,0.6692004504504505,40.104166666666664,1039.583333333333,28.096846846846837,0
4076,4,1,1,38,0.02564102564102564,0.02564102564102564,0.9743589743589743,39,1400,1100,300,0.7857142857142857,17,11,6,323.2311729249834,0.7716486729644625,0.04664971653269734,0.2113367843379319,135411.19352217094,953.8237818686363,136365.0173040396,3154,0,542.4102564102565,38,1,21,31.386436734414545,0.6705043859649124,39.79700854700854,1040.8119658119647,27.38978857399907,0
4077,4,0,0,38,0.0,0.0,1.0,38,1000,500,500,0.5,15,5,10,336.97682965788323,0.7682847321005216,0.03472282080898248,0.20617039297505374,132978.12328798402,1362.29190827576,134340.4151962598,3155,44,557.6842105263158,36,2,18,33.4561633366088,0.6501736111111112,42.145270270270274,1031.4189189189196,28.650525525525545,4
4078,4,0,0,38,0.0,0.0,1.0,38,700,500,200,0.7142857142857143,9,5,4,336.98723394966237,0.7690256045519204,0.03962162255327173,0.20649766222159582,133036.20501836296,1366.3005488596673,134402.50556722263,3156,45,558.6842105263158,36,2,18,33.3976913000764,0.6507523148148149,42.08896396396396,1031.6441441441443,28.65678178178179,0
4079,4,0,0,38,0.0,0.0,1.0,38,650,500,150,0.7692307692307693,8,5,3,338.23902614771197,0.7685218112849692,0.039209492522226386,0.207749493003863,133123.3513919326,1405.5025464653954,134528.853938398,3157,46,559.6842105263158,36,2,18,33.27808998981521,0.6516203703703705,42.00450450450451,1031.981981981983,28.666166166166192,0
4080,4,0,0,38,0.0,0.0,1.0,38,650,300,350,0.46153846153846156,10,3,7,336.26055281969434,0.7672771455666193,0.0385984044079668,0.20750398851659485,133297.7297398751,1364.5536583881287,134662.28339826321,3158,47,560.6842105263158,36,2,19,33.154534714649216,0.6533564814814814,41.83558558558559,1032.6576576576583,28.684934934934954,0
4081,4,1,1,38,0.02564102564102564,0.02564102564102564,0.9743589743589743,39,800,700,100,0.875,9,7,2,329.436683896507,0.7765407107512371,0.02969107871068699,0.20489354730148623,133588.61395178977,1001.9121317263398,134590.5260835161,3159,0,547.2820512820513,36,3,20,33.03989651416123,0.65625,41.55405405405406,1033.7837837837849,28.716216216216246,0
4082,4,0,0,38,0.0,0.0,1.0,38,1000,700,300,0.7,13,7,6,335.81633433611427,0.76683262209578,0.03826840337125015,0.20854241068299728,133532.02830289782,1368.4472522290828,134900.4755551269,3160,49,562.6842105263158,35,3,20,32.93159761104889,0.6577380952380951,41.6087962962963,1033.564814814815,29.530423280423285,0
4083,4,0,0,38,0.0,0.0,1.0,38,950,800,150,0.8421052631578947,11,8,3,333.6179842172242,0.7655286865813181,0.038616744431324346,0.20782091798389107,133646.82883897415,1317.3971268565952,134964.22596583076,3161,50,563.6842105263158,36,2,20,32.87364771654688,0.6568287037037037,41.49774774774775,1034.0090090090096,28.72247247247249,0
4084,4,0,0,38,0.0,0.0,1.0,38,1050,800,250,0.7619047619047619,13,8,5,332.55973639402043,0.7652027027027027,0.03750034864585916,0.2079324793159432,133783.99032635035,1298.233711334245,135082.2240376846,3162,51,564.6842105263158,37,1,16,32.763977212506624,0.65625,41.36513157894736,1034.53947368421,27.96052631578946,0
4085,4,0,0,38,0.0,0.0,1.0,38,950,500,450,0.5263157894736842,14,5,9,333.1457558226625,0.7622392128971076,0.041671079106215814,0.2095866337264089,134010.95920138867,1329.0364583333098,135339.995659722,3163,52,565.6842105263158,37,1,16,32.522216633132125,0.6585022522522523,41.14583333333332,1035.416666666665,27.984234234234187,0
4086,4,0,0,38,0.0,0.0,1.0,38,800,400,400,0.5,12,4,8,332.31416119794176,0.7615279753437648,0.03757766571006682,0.20938674132852275,134067.73147747366,1310.5211459294974,135378.25262340315,3164,53,566.6842105263158,37,1,16,32.4870963472737,0.6590653153153154,41.091008771929815,1035.6359649122792,27.990161213845383,0
4087,4,0,0,38,0.0,0.0,1.0,38,750,500,250,0.6666666666666666,10,5,5,332.0473387200788,0.7609352773826458,0.03976620568996059,0.2093804513718198,134096.12212411495,1305.2520967989974,135401.37422091395,3165,54,567.6842105263158,37,1,16,32.46568212294446,0.6593468468468469,41.06359649122806,1035.7456140350864,27.993124703650984,0
4088,4,0,0,38,0.0,0.0,1.0,38,850,500,350,0.5882352941176471,12,5,7,335.7570488622319,0.7598684210526316,0.04668122003241093,0.21254118344252848,134238.12044330928,1414.2790329716615,135652.39947628093,3166,55,568.6842105263158,37,1,16,32.22796088597327,0.6607545045045047,40.92653508771929,1036.2938596491213,28.007942152678954,0
4089,4,0,0,38,0.0,0.0,1.0,38,900,700,200,0.7777777777777778,11,7,4,335.0730071834048,0.7571420104314841,0.0511926299089871,0.2127679840778435,134351.77320185042,1403.5305334333502,135755.30373528376,3167,56,569.6842105263158,37,1,17,32.13235942182267,0.6618806306306306,40.816885964912274,1036.7324561403498,28.019796111901346,0
4090,4,0,0,38,0.0,0.0,1.0,38,1050,700,350,0.6666666666666666,14,7,7,332.5711016452942,0.758357041251778,0.04541003671970634,0.21200287207307839,134493.90677900886,1345.7573484148934,135839.66412742375,3168,57,570.6842105263158,37,1,18,32.055584918957,0.6632882882882883,40.67982456140351,1037.2807017543855,28.034613560929337,0
4091,4,0,0,38,0.0,0.0,1.0,38,1000,700,300,0.7,13,7,6,332.32241225968073,0.7588015647226174,0.04667764200737534,0.2123407823911787,134579.22299409422,1344.738405086168,135923.96139918038,3169,58,571.6842105263158,37,1,18,31.977064179787945,0.664132882882883,40.59758771929824,1037.609649122806,28.04350403034611,0
4092,4,0,1,37,0.0,0.02631578947368421,0.9736842105263158,38,850,500,350,0.5882352941176471,12,5,7,332.32241225968073,0.7587126600284495,0.04667764200737534,0.2123407823911787,134579.22299409422,1344.738405086168,135923.96139918038,3170,59,572.6842105263158,37,1,18,31.977064179787945,0.664132882882883,40.59758771929824,1037.609649122806,28.04350403034611,0
4093,4,0,0,37,0.0,0.0,1.0,37,1000,800,200,0.8,12,8,4,334.68315389667856,0.7558808808808809,0.06309923596955613,0.21402534789437164,134609.20538359313,1610.2866802613476,136219.49206385447,3171,68,587.5675675675676,36,1,19,31.885964912280702,0.6663773148148149,40.568693693693696,1037.7252252252258,28.825700700700718,0
4094,4,0,0,37,0.0,0.0,1.0,37,1100,900,200,0.8181818181818182,13,9,4,336.404934905016,0.7551926926926927,0.06255680718687895,0.21564538873118466,134696.8653619835,1662.538044801549,136359.40340678504,3172,69,588.5675675675676,36,1,19,31.753995805308442,0.6672453703703705,40.48423423423423,1038.0630630630624,28.835085085085066,0
4095,4,0,1,36,0.0,0.02702702702702703,0.972972972972973,37,750,600,150,0.8,9,6,3,336.43387974392704,0.7561936936936937,0.0622316275716126,0.2161851432138503,134784.55387397538,1669.2180778751774,136453.77195185056,3173,70,589.5675675675676,36,1,15,31.665943679282794,0.6681134259259258,40.39977477477478,1038.4009009009012,28.844469469469477,0
4096,4,0,1,35,0.0,0.027777777777777776,0.9722222222222222,36,1450,1100,350,0.7586206896551724,18,11,7,345.29868441835026,0.7532407407407408,0.0628273710018945,0.2221050247516745,134821.09917534736,2110.709635416687,136931.80881076405,3174,71,597.6944444444445,35,1,16,31.399406552992307,0.6705357142857142,40.36458333333334,1038.5416666666679,29.672619047619083,0
4097,4,0,0,35,0.0,0.0,1.0,35,1050,800,250,0.7619047619047619,13,8,5,352.3747752481507,0.7532212885154062,0.06437986082685265,0.22689814863764696,134859.73816609982,2504.233985260779,137363.9721513606,3175,72,611.6285714285714,34,1,17,31.177172874880622,0.6731004901960784,40.327380952380956,1038.6904761904766,30.549719887955195,0
4098,4,0,0,35,0.0,0.0,1.0,35,750,400,350,0.5333333333333333,11,4,7,358.4301345310308,0.7516106442577031,0.06833578792341677,0.23178482033006653,135014.34948979583,2678.6422902494223,137692.99178004524,3176,73,612.6285714285714,34,1,17,30.865788468881256,0.6746323529411765,40.17857142857142,1039.2857142857138,30.567226890756288,0
4099,4,0,0,35,0.0,0.0,1.0,35,750,500,250,0.6666666666666666,10,5,5,357.08262646701127,0.7513305322128851,0.06266185523243473,0.23471945146204962,135602.68034297042,2684.272250566884,138286.9525935373,3177,74,613.6285714285714,34,1,19,30.315131253095593,0.680453431372549,39.613095238095234,1041.5476190476184,30.63375350140054,1
4100,4,0,1,34,0.0,0.02857142857142857,0.9714285714285714,35,600,300,300,0.5,9,3,6,357.14794519263603,0.751750700280112,0.057567298431199676,0.2351694257622841,135664.68431122438,2690.4726473922783,138355.15695861666,3178,75,614.6285714285714,34,1,19,30.251780748866807,0.6810661764705883,39.55357142857142,1041.7857142857135,30.640756302520987,0
4101,4,0,0,34,0.0,0.0,1.0,34,1250,1000,250,0.8,15,10,5,365.7161586102073,0.7480689245395128,0.07232021146301126,0.2408174333342656,135665.59624002778,3123.020142493261,138788.61638252105,3179,76,631.3235294117648,33,1,20,30.027717327373242,0.6833964646464648,39.55269607843137,1041.7892156862738,31.569370172311327,0
4102,4,0,0,34,0.0,0.0,1.0,34,750,500,250,0.6666666666666666,10,5,5,366.6301802481415,0.7474376114081996,0.07250937054812545,0.24250049091684972,135825.23098087258,3159.52578335254,138984.75676422514,3180,77,632.3235294117648,33,1,20,29.84510933458736,0.6849747474747476,39.39950980392156,1042.4019607843125,31.587938205585225,0
4103,4,0,0,34,0.0,0.0,1.0,34,1250,800,450,0.64,17,8,9,367.5723412930454,0.7463978015448605,0.07487919365654383,0.24377810226520036,135921.0568801661,3192.164221693559,139113.22110185967,3181,78,633.3235294117648,33,1,16,29.725266384612382,0.6859217171717173,39.30759803921568,1042.7696078431359,31.59907902554957,0
4104,4,0,0,34,0.0,0.0,1.0,34,1400,1000,400,0.7142857142857143,18,10,8,365.06599979311727,0.7463235294117647,0.07058339726444007,0.2425508762091506,135984.9595858563,3128.697045607451,139113.65663146376,3182,79,634.3235294117648,33,1,16,29.727093369365132,0.6865530303030304,39.24632352941176,1043.0147058823522,31.606506238859158,0
4105,4,0,0,34,0.0,0.0,1.0,34,1150,900,250,0.782608695652174,14,9,5,365.39454745100113,0.744281045751634,0.07568701156017488,0.24320592513294526,136048.8773098086,3142.3035911668485,139191.18090097545,3183,80,635.3235294117648,33,1,17,29.655012921414304,0.6871843434343434,39.18504901960784,1043.2598039215677,31.61393345216872,0
4106,4,0,0,34,0.0,0.0,1.0,34,1100,700,400,0.6363636363636364,15,7,8,364.9063083319113,0.7437240047534166,0.07812046594536404,0.24309955470562525,136080.84180363308,3131.351523452506,139212.19332708558,3184,81,636.3235294117648,33,1,17,29.635991699945198,0.6875,39.15441176470588,1043.3823529411754,31.617647058823497,0
4107,4,0,0,34,0.0,0.0,1.0,34,950,700,250,0.7368421052631579,12,7,5,365.17672588674037,0.7426841948900773,0.0731218743956017,0.24371826000403438,136144.78205497874,3143.3811514801864,139288.16320645894,3185,82,637.3235294117648,33,1,17,29.565425865038364,0.6881313131313131,39.093137254901954,1043.6274509803911,31.625074272133066,0
4108,4,0,0,34,0.0,0.0,1.0,34,950,600,350,0.631578947368421,13,6,7,366.6380419604653,0.7413844325609033,0.08152522832862763,0.24580037415775938,136304.69838823995,3194.897545415205,139499.59593365516,3186,83,638.3235294117648,33,1,19,29.36849645972695,0.689709595959596,38.93995098039215,1044.2401960784302,31.643642305406978,0
4109,4,0,0,34,0.0,0.0,1.0,34,1050,700,350,0.6666666666666666,14,7,7,366.18829413887795,0.741198752228164,0.07872581223949027,0.2461663264384696,136400.69324298349,3189.667435601699,139590.3606785852,3187,84,639.3235294117648,33,1,19,29.284960112623192,0.6906565656565656,38.84803921568628,1044.607843137255,31.654783125371363,0
4110,4,0,0,34,0.0,0.0,1.0,34,1000,900,100,0.9,11,9,2,364.69851235451597,0.7399732620320856,0.07311377699901356,0.24583274425667634,136496.7218888167,3156.0302828239023,139652.7521716406,3188,85,640.3235294117648,33,1,21,29.22860228294438,0.6916035353535354,38.75612745098039,1044.9754901960778,31.66592394533569,0
4111,4,0,0,34,0.0,0.0,1.0,34,800,700,100,0.875,9,7,2,365.0308530073322,0.7405303030303031,0.06944597726520252,0.2462803096872253,136528.7389465589,3167.44040753555,139696.17935409446,3189,86,641.3235294117648,33,1,21,29.18816447779862,0.691919191919192,38.725490196078425,1045.0980392156855,31.66963755199047,0
4112,4,0,0,34,0.0,0.0,1.0,34,700,400,300,0.5714285714285714,10,4,6,366.93718741796783,0.7410502079619727,0.06938142197089903,0.248016973746059,136592.78432574004,3224.1944204152246,139816.97874615528,3190,87,642.3235294117648,33,1,21,29.074833919499806,0.6925505050505051,38.66421568627451,1045.3431372549016,31.67706476530005,0
4113,4,0,0,34,0.0,0.0,1.0,34,550,200,350,0.36363636363636365,9,2,7,368.48562616038157,0.7411244800950684,0.0704889550757013,0.2495174097143155,136656.84472318334,3271.216599384849,139928.0613225682,3191,88,643.3235294117648,33,1,21,28.97083528676355,0.6931818181818181,38.60294117647059,1045.5882352941173,31.684491978609618,0
4114,4,0,0,34,0.0,0.0,1.0,34,1100,600,500,0.5454545454545454,16,6,10,368.1335114557695,0.7394904931669638,0.06916745369189581,0.2495062155085053,136688.88055375344,3263.951515042302,139952.83206879575,3192,89,644.3235294117648,33,1,22,28.948274346654177,0.6934974747474747,38.57230392156863,1045.710784313726,31.688205585264424,0
4115,4,0,0,34,0.0,0.0,1.0,34,700,500,200,0.7142857142857143,9,5,4,366.6924028005331,0.7387477718360071,0.07354361348595484,0.2489901528524276,136753.9345474952,3229.329524895125,139983.26407239033,3193,90,645.3235294117648,32,2,22,28.921465073233556,0.6966145833333333,38.51010101010102,1045.9595959595965,32.68623737373739,0
4116,4,0,0,34,0.0,0.0,1.0,34,1400,1100,300,0.7857142857142857,17,11,6,370.2071702494,0.7394162210338682,0.07430303202362021,0.25232541340682796,136886.03203754724,3335.2381134578186,140221.27015100507,3194,91,646.3235294117648,32,2,22,28.698620495495497,0.6979166666666666,38.38383838383839,1046.4646464646469,32.702020202020215,0
4117,4,0,0,34,0.0,0.0,1.0,34,800,400,400,0.5,12,4,8,369.71280043708765,0.739007724301842,0.07718592322922668,0.2522262882981908,136919.06637396693,3324.146292470155,140243.2126664371,3195,92,647.3235294117648,32,2,23,28.678821329472793,0.6982421875,38.35227272727273,1046.590909090909,32.70596590909091,0
4118,4,0,0,34,0.0,0.0,1.0,34,900,500,400,0.5555555555555556,13,5,8,366.90465170341855,0.7383764111705289,0.07155018302545346,0.251020905274319,137018.1932966024,3254.5224977043163,140272.7157943067,3196,93,648.3235294117648,32,2,17,28.65412445730825,0.69921875,38.25757575757576,1046.969696969697,32.71780303030303,0
4119,4,0,0,34,0.0,0.0,1.0,34,1100,800,300,0.7272727272727273,14,8,6,369.0761226778802,0.735256981580511,0.0705988724603761,0.25322468466608933,137117.3560893023,3321.348427456399,140438.7045167587,3197,94,649.3235294117648,32,2,17,28.49909584086799,0.7001953125,38.162878787878796,1047.3484848484864,32.7296401515152,0
4120,4,0,1,33,0.0,0.029411764705882353,0.9705882352941176,34,1250,800,450,0.64,17,8,9,370.93035542414856,0.7336229946524064,0.06589213206063027,0.25595119537621436,137315.78928489445,3386.918904958684,140702.70818985312,3198,95,650.3235294117648,32,2,17,28.254126008914596,0.7021484375,37.97348484848485,1048.106060606061,32.753314393939405,0
4121,4,0,0,33,0.0,0.0,1.0,33,950,800,150,0.8421052631578947,11,8,3,376.27561785211526,0.7291666666666667,0.056923152238176344,0.2590153889526065,137232.0577833387,3727.4154663085883,140959.4732496473,3199,96,644.1515151515151,31,2,17,28.196972992005293,0.7039650537634409,38.053385416666664,1047.786458333333,33.799563172043,0
4122,4,0,0,33,0.0,0.0,1.0,33,800,500,300,0.625,11,5,6,374.7233156951101,0.7282986111111112,0.05177908466668857,0.25856843255071565,137315.78928489445,3691.08557162535,141006.8748565198,3200,97,645.1515151515151,32,1,18,28.154740392723777,0.7021484375,37.97348484848485,1048.106060606061,32.753314393939405,0
4123,4,0,0,33,0.0,0.0,1.0,33,800,600,200,0.75,10,6,4,375.65019078110623,0.7275094696969697,0.050491671683724926,0.26019806792636246,137448.15779320983,3726.485339506171,141174.643132716,3201,98,646.1515151515151,32,1,19,27.99944812362031,0.7034505208333334,37.84722222222222,1048.6111111111109,32.769097222222214,0
4124,4,0,0,33,0.0,0.0,1.0,33,800,600,200,0.75,10,6,4,374.94908613276453,0.7279829545454546,0.052617179377742795,0.26020902744401647,137514.36596074386,3712.177169421498,141226.54313016534,3202,99,647.1515151515151,32,1,21,27.952329360780066,0.7041015625,37.784090909090914,1048.863636363637,32.776988636363654,0
4125,4,0,0,33,0.0,0.0,1.0,33,800,700,100,0.875,9,7,2,374.32090138876777,0.7273516414141414,0.05368167657887302,0.2600801068090788,137555.2672049211,3697.962322183769,141253.22952710488,3203,100,648.1515151515151,33,0,21,27.928348909657323,0.702020202020202,37.745098039215684,1049.0196078431368,31.788472964943537,0
4126,4,0,0,33,0.0,0.0,1.0,33,1000,700,300,0.7,13,7,6,374.9421069176971,0.7262468434343435,0.04980680225892753,0.2614824270067717,137683.8535659361,3724.694828911947,141408.54839484804,3204,101,649.1515151515151,33,0,21,27.784913591779553,0.7032828282828283,37.62254901960784,1049.509803921568,31.803327391562664,0
4127,4,0,0,33,0.0,0.0,1.0,33,1050,800,250,0.7619047619047619,13,8,5,373.61887239028516,0.7234848484848485,0.05333934509383975,0.26179289364271513,137846.68180677632,3700.5445099757035,141547.22631675203,3205,102,650.1515151515151,31,2,23,27.658736309154786,0.710013440860215,37.46744791666667,1050.130208333334,33.87516801075271,0
4128,4,0,0,33,0.0,0.0,1.0,33,1050,900,150,0.8571428571428571,12,9,3,357.6055640181978,0.7231691919191919,0.073471416614584,0.24442767776379842,136985.14700349438,3201.403400229239,140186.5504037236,3206,103,651.1515151515151,32,1,19,28.930215494713135,0.6988932291666667,38.289141414141405,1046.843434343433,32.71385732323228,6
4129,4,0,0,33,0.0,0.0,1.0,33,650,400,250,0.6153846153846154,9,4,5,360.2130741737489,0.722064393939394,0.07603704312565052,0.24714370969985497,137117.35608930205,3278.2928719008123,140395.64896120285,3207,104,652.1515151515151,32,1,19,28.731163351416516,0.7001953125,38.16287878787878,1047.3484848484843,32.729640151515135,0
4130,4,0,0,33,0.0,0.0,1.0,33,750,400,350,0.5333333333333333,11,4,7,360.9185544682804,0.7212752525252526,0.07306186259898895,0.24786260992291806,137150.41832466057,3300.0261452912746,140450.44446995185,3208,105,653.1515151515151,32,1,19,28.67998633879781,0.7005208333333334,38.13131313131312,1047.474747474746,32.73358585858581,0
4131,4,0,0,33,0.0,0.0,1.0,33,1050,700,350,0.6666666666666666,14,7,7,371.2106704634005,0.7212752525252526,0.0831843563089012,0.24155082964277197,135239.3968089991,3440.461432506884,138679.85824150598,3209,106,654.1515151515151,32,1,19,30.309237679048298,0.681640625,39.96212121212121,1040.1515151515152,32.50473484848485,4
4132,4,0,0,33,0.0,0.0,1.0,33,750,500,250,0.6666666666666666,10,5,5,371.50366504996214,0.722064393939394,0.08802991693417606,0.24240393536632923,135337.91394054177,3455.706209825528,138793.6201503673,3210,107,655.1515151515151,32,1,19,30.20340371314161,0.6826171875,39.86742424242424,1040.530303030303,32.51657196969697,0
4133,4,0,0,33,0.0,0.0,1.0,33,950,800,150,0.8421052631578947,11,8,3,372.3965995933099,0.722616792929293,0.09271411188189083,0.24343102065405642,135403.61195605036,3484.768933017035,138888.3808890674,3211,108,656.1515151515151,32,1,19,30.1146932751021,0.6832682291666667,39.80429292929293,1040.782828282828,32.52446338383837,0
4134,4,0,0,33,0.0,0.0,1.0,33,1050,600,450,0.5714285714285714,15,6,9,370.80047096014584,0.7206439393939394,0.09249117682852637,0.23674183915147773,134550.78125,3378.2986111111113,137929.07986111112,3212,109,657.1515151515151,32,1,21,31.00736278447122,0.6748046875,40.625,1037.5,32.421875,2
4135,4,0,0,33,0.0,0.0,1.0,33,300,100,200,0.3333333333333333,5,1,4,371.98052983197397,0.7212752525252526,0.09410975169067148,0.23770886424254775,134583.53261146825,3412.490753494548,137996.0233649628,3213,110,658.1515151515151,32,1,21,30.944015169952134,0.6751302083333333,40.593434343434346,1037.626262626263,32.42582070707072,0
4136,4,0,0,33,0.0,0.0,1.0,33,850,700,150,0.8235294117647058,10,7,3,374.98341007842396,0.7208806818181819,0.09766111614810224,0.24049248031706713,134714.57791296803,3503.146362616058,138217.7242755841,3214,111,659.1515151515151,32,1,21,30.73512121949242,0.6764322916666667,40.467171717171716,1038.131313131313,32.44160353535353,0
4137,4,0,0,33,0.0,0.0,1.0,33,1050,700,350,0.6666666666666666,14,7,7,377.36754095028704,0.7203282828282829,0.1022676614165976,0.2426777188675614,134812.90373750124,3574.8027943577185,138387.70653185897,3215,112,660.1515151515151,32,1,18,30.574974670719357,0.6774088541666666,40.37247474747475,1038.510101010101,32.453440656565654,0
4138,4,0,0,33,0.0,0.0,1.0,33,450,200,250,0.4444444444444444,7,2,5,377.4976178961833,0.7196969696969697,0.10242468448157727,0.24298086109655753,134845.6869834711,3580.785123966948,138426.47210743805,3216,113,661.1515151515151,32,1,18,30.53884026258206,0.677734375,40.34090909090909,1038.636363636364,32.457386363636374,0
4139,4,0,0,33,0.0,0.0,1.0,33,550,300,250,0.5454545454545454,8,3,5,379.97941033486796,0.718671085858586,0.10298168854318579,0.2450212059745528,134911.2654320988,3652.7006172839524,138563.96604938275,3217,114,662.1515151515151,32,1,18,30.408868092691616,0.6783854166666666,40.27777777777778,1038.8888888888891,32.465277777777786,0
4140,4,0,0,33,0.0,0.0,1.0,33,1050,800,250,0.7619047619047619,13,8,5,377.21075590236484,0.7173295454545455,0.10319370533118422,0.24456325701575396,135108.09643148675,3592.8454366901547,138700.9418681769,3218,115,663.1515151515151,32,1,19,30.28423811837099,0.6803385416666666,40.08838383838385,1039.6464646464658,32.488952020202056,0
4141,4,0,0,33,0.0,0.0,1.0,33,700,600,100,0.8571428571428571,8,6,2,374.73077104345333,0.7170928030303031,0.10340541335686959,0.2442865153004794,135305.07091113174,3540.5947097235226,138845.66562085526,3219,116,664.1515151515151,32,1,21,30.152204692556637,0.6822916666666666,39.89898989898991,1040.404040404042,32.51262626262631,0
4142,4,0,0,33,0.0,0.0,1.0,33,850,400,450,0.47058823529411764,13,4,9,373.9993182043856,0.7171717171717172,0.11309504115521296,0.24447869785557144,135403.61195605062,3528.1717107948425,138931.78366684547,3220,117,665.1515151515151,32,1,21,30.072991224877665,0.6832682291666666,39.80429292929294,1040.78282828283,32.52446338383844,0
4143,4,0,0,33,0.0,0.0,1.0,33,950,700,250,0.7368421052631579,12,7,5,379.07885869241824,0.714804292929293,0.11360973692812282,0.24962327718045849,135666.56344059287,3685.6652063565057,139352.22864694937,3221,118,666.1515151515151,32,1,21,29.678725811012818,0.6858723958333333,39.55176767676768,1041.7929292929298,32.556029040404056,0
4144,4,0,0,33,0.0,0.0,1.0,33,750,600,150,0.8,9,6,3,378.81459431557926,0.714804292929293,0.10938457867591778,0.25036945364892754,135798.13483636864,3688.463071370257,139486.5979077389,3222,119,667.1515151515151,32,1,22,29.554562891177067,0.6871744791666667,39.425505050505045,1042.297979797979,32.571811868686844,0
4145,4,0,0,33,0.0,0.0,1.0,33,400,300,100,0.75,5,3,2,377.68515075716596,0.7144097222222223,0.11123590556730112,0.24985325357781754,135831.03764921954,3660.2731864095585,139491.3108356291,3223,120,668.1515151515151,32,1,22,29.551235465116267,0.6875,39.3939393939394,1042.424242424243,32.57575757575759,0
4146,4,0,0,33,0.0,0.0,1.0,33,750,600,150,0.8,9,6,3,386.1643773007176,0.7149621212121213,0.03788261595234843,0.235144400824037,132800.32687717018,3662.3620571840606,136462.68893435426,3224,121,669.1515151515151,31,2,19,32.36693616304531,0.6599462365591398,42.317708333333336,1030.729166666667,33.249327956989255,8
4147,4,0,0,33,0.0,0.0,1.0,33,450,100,350,0.2222222222222222,8,1,7,388.4926584890941,0.7143308080808082,0.03785773879231846,0.23698650769773846,132867.44011772994,3723.6050075954786,136591.0451253254,3225,122,670.1515151515151,31,2,19,32.23930706407342,0.6606182795698925,42.252604166666664,1030.9895833333328,33.25772849462364,0
4148,4,0,0,33,0.0,0.0,1.0,33,900,600,300,0.6666666666666666,12,6,6,390.44995408631775,0.7140940656565657,0.037588001224364787,0.23860830527497187,132934.5703125,3780.859374999998,136715.4296875,3226,123,671.1515151515151,31,2,19,32.12121212121211,0.6612903225806452,42.1875,1031.25,33.266129032258064,0
4149,4,0,0,33,0.0,0.0,1.0,33,1000,600,400,0.6,14,6,8,393.0158224715721,0.714251893939394,0.03731839985311369,0.24060829564295144,133001.71746147994,3854.3558756510315,136856.07333713098,3227,124,672.1515151515151,31,2,19,31.987397963477235,0.661962365591398,42.12239583333333,1031.5104166666658,33.274529569892444,0
4150,4,0,0,33,0.0,0.0,1.0,33,1650,1400,250,0.8484848484848485,19,14,5,395.55800387137145,0.7113320707070707,0.028682383879155005,0.2434770073518812,133203.26063368045,3937.923177083323,137141.18381076376,3228,125,673.1515151515151,31,2,19,31.718802556340407,0.663978494623656,41.92708333333333,1032.2916666666658,33.299731182795675,0
4151,4,0,0,33,0.0,0.0,1.0,33,750,400,350,0.5333333333333333,11,4,7,384.2514753742073,0.7113320707070707,0.05415102308082753,0.21542873038721685,129631.97708129883,3384.2283460829,133016.20542738173,3229,126,674.1515151515151,31,2,19,35.62750394237738,0.6280241935483871,45.41015625,1018.359375,32.85030241935484,8
4152,4,0,0,33,0.0,0.0,1.0,33,950,600,350,0.631578947368421,13,6,7,381.35504619000426,0.7109375000000001,0.05552457086199425,0.21434783630679544,129731.4453125,3294.748263888889,133026.19357638888,3230,127,675.1515151515151,31,2,19,35.59986366734834,0.6290322580645162,45.3125,1018.75,32.86290322580645,0
4153,4,0,0,33,0.0,0.0,1.0,33,850,400,450,0.47058823529411764,13,4,9,382.02811651321,0.7129103535353536,0.06330035149657065,0.21545505014880456,129864.1289605034,3322.34971788194,133186.47867838535,3231,128,676.1515151515151,31,2,20,35.44753874978709,0.6303763440860215,45.182291666666664,1019.2708333333327,32.87970430107525,0
4154,4,0,0,33,0.0,0.0,1.0,33,1050,800,250,0.7619047619047619,13,8,5,380.1217842349249,0.7107007575757577,0.06038167968462904,0.21529240317513856,130030.07888793945,3285.4531182183164,133315.53200615777,3232,129,677.1515151515151,31,2,20,35.32716817736925,0.6320564516129032,45.01953125,1019.921875,32.90070564516129,0
4155,4,2,2,33,0.05714285714285714,0.05714285714285714,0.9428571428571428,35,1050,800,250,0.7619047619047619,13,8,5,360.85490360950723,0.736484593837535,0.05184858378187607,0.2073186972831059,130585.01882779822,2424.656565463521,133009.67539326174,3233,0,639.4,32,3,14,35.25530162651844,0.6350911458333333,44.476010101010104,1022.0959595959599,31.940498737373748,0
4156,4,0,0,33,0.0,0.0,1.0,33,950,700,250,0.7368421052631579,12,7,5,379.4854349772068,0.7118055555555556,0.05544924947910035,0.21603386527133817,130229.3586730958,3284.028964572497,133513.3876376683,3234,131,679.1515151515151,31,2,21,35.14066951566953,0.6340725806451613,44.82421875000001,1020.7031250000008,32.92590725806454,0
4157,4,2,0,35,0.05714285714285714,0.0,1.0,35,600,400,200,0.6666666666666666,8,4,4,358.52038839263207,0.7427170868347338,0.0534405246734011,0.20735836596327642,130843.25140610672,2381.9989010869713,133225.2503071937,3235,0,641.2857142857143,32,3,19,35.05337529310131,0.6376953125,44.22348484848486,1023.1060606060622,31.972064393939444,0
4158,4,0,0,35,0.0,0.0,1.0,35,900,700,200,0.7777777777777778,11,7,4,360.2552917696795,0.7436274509803921,0.0512833168805531,0.20853634889296305,130875.54841342724,2429.72177583921,133305.27018926645,3236,1,642.2857142857143,32,3,19,34.97629771306352,0.6380208333333333,44.1919191919192,1023.2323232323236,31.97601010101011,0
4159,4,2,2,35,0.05405405405405406,0.05405405405405406,0.9459459459459459,37,1150,900,250,0.782608695652174,14,9,5,344.83418831002797,0.7603853853853854,0.0455555416075617,0.20229645979059702,131389.14399092985,1661.4937641723486,133050.6377551022,3237,0,608.5135135135135,34,3,19,34.85204753057748,0.6384803921568627,43.6904761904762,1025.2380952380963,30.15406162464989,0
4160,4,0,0,35,0.0,0.0,1.0,35,650,500,150,0.7692307692307693,8,5,3,373.69903505396707,0.7438375350140055,0.06332271026742364,0.19962886276717087,127710.6161091887,2545.066801230283,130255.68291041898,3238,3,644.2857142857143,33,2,18,37.86069350145489,0.6035353535353536,47.303921568627445,1010.7843137254897,30.629827688651204,5
4161,4,2,1,36,0.05405405405405406,0.02702702702702703,0.972972972972973,37,900,700,200,0.7777777777777778,11,7,4,360.499308503666,0.7682057057057057,0.10369930837352914,0.18993471030118522,127152.04081632651,1776.2950768542644,128928.33589318077,3239,0,610.4054054054054,34,3,17,38.767410292728975,0.5955882352941178,47.857142857142854,1008.5714285714284,29.663865546218485,8
4162,4,3,1,38,0.07692307692307693,0.02564102564102564,0.9743589743589743,39,850,400,450,0.47058823529411764,13,4,9,344.8164939658041,0.7856500224921278,0.10948546627833977,0.18475251287666575,127831.16731596454,1015.658986689388,128846.82630265394,3240,0,579.9230769230769,36,3,18,38.46719561989606,0.5983796296296295,47.18468468468468,1011.2612612612606,28.090590590590573,0
4163,4,2,1,39,0.05,0.025,0.975,40,1300,1100,200,0.8461538461538461,15,11,4,335.20097378119675,0.7984775641025641,0.11017114384748705,0.18075790829135552,128089.02739304396,587.1133425669391,128676.1407356109,3241,0,566.375,37,3,19,38.44688763720393,0.5990990990990992,46.92982456140351,1012.2807017543855,27.358937885253663,0
4164,4,3,2,40,0.07142857142857142,0.047619047619047616,0.9523809523809523,42,900,600,300,0.6666666666666666,12,6,6,323.6932314088265,0.8090882694541232,0.1169942309572698,0.17712202662482993,128672.4175347223,-69.89782913972618,128602.51970558258,3242,0,540.3333333333334,37,5,16,38.143822724161545,0.6050112612612613,46.35416666666667,1014.583333333334,27.421171171171192,0
4165,4,3,3,40,0.06976744186046512,0.06976744186046512,0.9302325581395349,43,1450,1200,250,0.8275862068965517,17,12,5,317.94129416756107,0.8189830195644149,0.1331872764216704,0.17570828871747082,129065.65176647308,-392.9399289575587,128672.71183751553,3243,0,528.6744186046511,38,5,19,37.89011845932779,0.6071820175438596,45.96688034188034,1016.1324786324786,26.740328385065226,0
4166,4,3,2,41,0.06976744186046512,0.046511627906976744,0.9534883720930233,43,1350,1000,350,0.7407407407407407,17,10,7,319.65153349718673,0.8167681801402731,0.12928688208125005,0.1770238174725055,129148.44292534716,-343.5004340277825,128804.94249131938,3244,0,529.5348837209302,39,4,20,37.76260504201681,0.6063034188034189,45.885416666666664,1016.4583333333328,26.063034188034173,0
4167,4,0,0,41,0.0,0.0,1.0,41,1150,1000,150,0.8695652173913043,13,10,3,352.90942339599565,0.7995934959349593,0.15457864758288387,0.184279309487903,126788.14785558992,789.3218646602527,127577.46972025017,3245,1,556.3658536585366,37,4,17,39.33258483033933,0.5858671171171173,48.21820175438595,1007.127192982454,27.219653864390647,8
4168,4,1,2,40,0.023809523809523808,0.047619047619047616,0.9523809523809523,42,1100,800,300,0.7272727272727273,14,8,6,348.20293697823104,0.8102013162988773,0.16290849419450382,0.18355981760818024,127174.94956380798,456.9018832717628,127631.85144707974,3246,0,544.0952380952381,37,5,18,39.053950610573615,0.5898085585585586,47.8344298245614,1008.6622807017535,27.261142721669014,0
4169,4,1,0,41,0.024390243902439025,0.0,1.0,41,1350,1100,250,0.8148148148148148,16,11,5,354.03638253104526,0.8114837398373984,0.17006736041908277,0.18677608449429373,127205.59030314116,807.081405730074,128012.67170887123,3247,0,554.0,36,5,19,38.875400014884285,0.5920138888888888,47.80405405405406,1008.7837837837852,28.02177177177181,0
4170,4,4,2,43,0.08888888888888889,0.044444444444444446,0.9555555555555556,45,1500,1200,300,0.8,18,12,6,325.38717079332014,0.8400673400673401,0.16350879541322283,0.17548357381008442,128093.08824319181,-664.0304836737462,127429.05775951807,3248,0,505.6666666666667,40,5,18,38.691103637519646,0.5940104166666667,46.92581300813008,1012.2967479674792,25.30741869918698,0
4171,4,1,2,42,0.022727272727272728,0.045454545454545456,0.9545454545454546,44,1050,600,450,0.5714285714285714,15,6,9,333.18661667433935,0.8317477096546865,0.16776361952342222,0.17956596529254326,128065.44189453124,-266.06174045138954,127799.38015407984,3249,0,518.1363636363636,39,5,19,38.52194178587355,0.5953525641025641,46.953125,1012.1874999999999,25.95352564102564,0
4172,4,1,0,43,0.023255813953488372,0.0,1.0,43,1550,1200,350,0.7741935483870968,19,12,7,340.90331758370166,0.8255352528608342,0.16958560627811292,0.18408779149519902,128144.53125000012,136.9791666666815,128281.5104166668,3250,0,531.0,38,5,21,38.24588477366257,0.597861842105263,46.87500000000001,1012.5000000000009,26.64473684210529,0
4173,4,2,2,43,0.044444444444444446,0.044444444444444446,0.9555555555555556,45,800,400,400,0.5,12,4,8,329.09022680029847,0.8376262626262627,0.17175450604608722,0.18007521399072526,128672.4175347223,-531.0329861111004,128141.38454861121,3251,0,508.35555555555555,37,8,16,38.006930184804936,0.6050112612612611,46.35416666666667,1014.583333333334,27.421171171171192,0
4174,4,1,0,44,0.022727272727272728,0.0,1.0,44,1400,1000,400,0.7142857142857143,18,10,8,337.08390138231834,0.8323202959830868,0.16868277589509373,0.1847076084839168,128728.04763244458,-121.56949734533791,128606.47813509924,3252,0,520.8636363636364,37,7,17,37.747501350621285,0.6055743243243243,46.29934210526316,1014.8026315789472,27.427098150782356,0
4175,4,1,4,41,0.022222222222222223,0.08888888888888889,0.9111111111111111,45,1700,1400,300,0.8235294117647058,20,14,6,328.97955111256863,0.834469696969697,0.16720667648502707,0.1811865360878378,128929.9859832714,-516.9342172547099,128413.0517660167,3253,0,510.26666666666665,38,7,17,37.747650606634416,0.6058114035087718,46.10042735042736,1015.5982905982919,26.726270805218206,0
4176,4,4,2,43,0.08888888888888889,0.044444444444444446,0.9555555555555556,45,1150,800,350,0.6956521739130435,15,8,7,322.50436582242895,0.8315656565656566,0.16118232121594178,0.17908964725191798,129255.70371283498,-662.6088921762175,128593.09482065876,3254,0,502.4,38,7,20,37.581205785529164,0.6091008771929824,45.77991452991452,1016.8803418803407,26.76000899685107,0
4177,4,2,1,44,0.044444444444444446,0.022222222222222223,0.9777777777777777,45,950,600,350,0.631578947368421,13,6,7,322.2627565255132,0.8308922558922559,0.1732143482064743,0.17982148540746967,129445.89548405625,-656.8817800789291,128789.01370397733,3255,0,503.35555555555555,38,7,14,37.394356955380566,0.6110197368421054,45.5929487179487,1017.6282051282028,26.779689608636914,0
4178,4,1,1,44,0.022222222222222223,0.022222222222222223,0.9777777777777777,45,1400,900,500,0.6428571428571429,19,9,10,320.35170897601046,0.8285353535353536,0.17345368038063258,0.17912623727250127,129527.44904667954,-701.1320677186375,128826.31697896091,3256,0,504.3333333333333,38,7,14,37.36028022670025,0.611842105263158,45.5128205128205,1017.9487179487157,26.788124156545152,0
4179,4,1,2,43,0.022222222222222223,0.044444444444444446,0.9555555555555556,45,1250,800,450,0.64,17,8,9,321.5900712294688,0.8291666666666667,0.16413484403413037,0.18031744464466434,129636.22708013716,-662.0552998758318,128974.17178026133,3257,0,505.31111111111113,38,7,15,37.21849209679675,0.6129385964912282,45.405982905982896,1018.376068376067,26.799370220422816,0
4180,4,2,0,45,0.044444444444444446,0.0,1.0,45,700,500,200,0.7142857142857143,9,5,4,323.16271355972214,0.8338804713804714,0.17705559632386336,0.18208205107183628,129826.69850107745,-608.9703639783841,129217.72813709907,3258,0,506.2,38,7,18,36.98544571408603,0.6148574561403508,45.21901709401709,1019.1239316239312,26.819050832208717,0
4181,4,0,0,45,0.0,0.0,1.0,45,1500,1100,400,0.7333333333333333,19,11,8,322.0048383393974,0.8335016835016835,0.17664605819274137,0.18193559338501308,129935.60209155167,-632.0214907955249,129303.58060075615,3259,1,507.2,38,7,18,36.90466834328826,0.615953947368421,45.11217948717949,1019.5512820512826,26.830296896086384,0
4182,4,0,1,44,0.0,0.022222222222222223,0.9777777777777777,45,800,500,300,0.625,11,5,6,322.71087337130376,0.8331228956228957,0.1746028420795367,0.1828439589362513,130044.55133912251,-606.6418520344937,129437.90948708802,3260,2,508.2,38,7,19,36.776386997660715,0.6170504385964912,45.005341880341874,1019.9786324786313,26.84154295996398,0
4183,4,1,0,45,0.022222222222222223,0.0,1.0,45,1500,1100,400,0.7333333333333333,19,11,8,320.64386019536323,0.8329966329966331,0.18484707454742932,0.18282394257679274,130290.5716783048,-644.443001613786,129646.128676691,3261,0,509.0,37,8,20,36.58027691261234,0.6213400900900901,44.76425438596491,1020.9429824561398,27.59305357989567,0
4184,4,1,2,44,0.021739130434782608,0.043478260869565216,0.9565217391304348,46,1000,700,300,0.7,13,7,6,329.27648629045154,0.8390499194847021,0.1362800341822501,0.18489289759603325,129692.62390318252,-659.0537006742147,129033.57020250832,3262,0,498.9130434782609,40,6,15,36.96560411054575,0.6101562500000001,45.350609756097555,1018.5975609756089,25.464939024390222,4
4185,4,0,1,43,0.0,0.022727272727272728,0.9772727272727273,44,1300,1000,300,0.7692307692307693,16,10,6,340.4568425660973,0.8299638830162086,0.14948763453171487,0.19036812182921187,129527.44904667964,19.701265614708632,129547.15031229435,3263,1,522.3409090909091,38,6,16,36.84863035264485,0.611842105263158,45.512820512820504,1017.9487179487165,26.788124156545173,0
4186,4,0,0,43,0.0,0.0,1.0,43,1100,700,400,0.6363636363636364,15,7,8,347.6822607015458,0.8247046880767811,0.15258620689655156,0.19389972231432356,129424.43828870416,399.716258848868,129824.15454755303,3264,2,534.953488372093,37,6,19,36.769486350574695,0.6126126126126126,45.614035087719294,1017.5438596491223,27.501185395922224,0
4187,4,1,1,43,0.022727272727272728,0.022727272727272728,0.9772727272727273,44,1100,600,500,0.5454545454545454,16,6,10,338.86507010507256,0.8333553558844257,0.14770939225465596,0.1901354157334699,129663.428722423,-12.318627182420386,129651.11009524058,3265,0,523.7727272727273,38,6,17,36.751066470855626,0.6132127192982457,45.3792735042735,1018.4829059829051,26.80218173639224,0
4188,4,0,1,42,0.0,0.023255813953488372,0.9767441860465116,43,1350,900,450,0.6666666666666666,18,9,9,349.13917690353827,0.824750830564784,0.1554127493751536,0.1955432084877114,129591.851579332,449.11847876268536,130040.97005809468,3266,4,536.953488372093,37,6,18,36.562208342307414,0.6143018018018018,45.44956140350877,1018.201754385964,27.518966334755785,0
4189,4,0,0,42,0.0,0.0,1.0,42,1200,800,400,0.6666666666666666,16,8,8,354.7158474028962,0.8216705381339527,0.15846230048952226,0.19799673335268525,129459.1186414456,784.2401945864967,130243.3588360321,3267,5,550.3809523809524,36,6,18,36.555272767511354,0.6148726851851851,45.579954954954964,1017.680180180181,28.268893893893917,0
4190,4,2,1,43,0.045454545454545456,0.022727272727272728,0.9772727272727273,44,1200,900,300,0.75,15,9,6,341.9083215591771,0.8290829809725159,0.16581027667984194,0.19345079604518944,129990.07100820009,88.93739955439617,130079.00840775449,3268,0,526.3181818181819,38,6,19,36.34210756067748,0.6165021929824561,45.05876068376069,1019.7649572649578,26.835919928025206,0
4191,4,0,0,43,0.0,0.0,1.0,43,1250,900,350,0.72,16,9,7,361.1556947040675,0.8244739756367663,0.17999356172935865,0.20306490004115485,129745.0507706917,771.6327891007287,130516.68355979242,3269,1,539.5581395348837,38,5,19,36.10047888702461,0.6140350877192983,45.299145299145295,1018.803418803418,26.810616284300476,1
4192,4,0,0,43,0.0,0.0,1.0,43,1150,900,250,0.782608695652174,14,9,5,365.69297558404713,0.8239664082687338,0.1821379714676572,0.20252168307316282,129148.44292534704,845.7356770833145,129994.17860243036,3270,2,540.5581395348837,39,4,18,36.59262485481997,0.6063034188034189,45.88541666666666,1016.4583333333319,26.063034188034152,3
4193,4,1,1,43,0.022727272727272728,0.022727272727272728,0.9772727272727273,44,1500,1100,400,0.7333333333333333,19,11,8,358.13950027900097,0.8275414023960536,0.1854187544738728,0.19984058231736843,129445.89548405634,471.95936575441857,129917.85484981076,3271,0,529.25,38,6,14,36.48162729658793,0.6110197368421053,45.59294871794871,1017.6282051282035,26.779689608636932,0
4194,4,0,0,43,0.0,0.0,1.0,43,1100,900,200,0.8181818181818182,13,9,4,364.32084015594677,0.8231358434846806,0.18968986401325028,0.2033230136793348,129452.33298947735,832.4365429747412,130284.76953245209,3272,4,542.5581395348837,37,6,14,36.317813274431636,0.6128941441441442,45.586622807017534,1017.6535087719284,27.504148885727794,0
4195,4,3,2,44,0.06521739130434782,0.043478260869565216,0.9565217391304348,46,1150,800,350,0.6956521739130435,15,8,7,353.01391843914166,0.8369565217391305,0.21103972919358616,0.20127690958260355,130289.85407991812,3.8820264438221557,130293.73610636195,3273,0,508.10869565217394,38,8,16,35.75480500906934,0.6195175438596492,44.76495726495726,1020.9401709401704,26.866846603688696,0
4196,4,0,0,44,0.0,0.0,1.0,44,1050,800,250,0.7619047619047619,13,8,5,368.25920342095884,0.8271229739252995,0.23174678724416942,0.20908890562842772,130126.2932372707,784.0410183358781,130910.33425560658,3274,1,531.8636363636364,38,6,17,35.53184991273996,0.6178728070175439,44.92521367521367,1020.2991452991446,26.849977507872225,0
4197,4,1,1,44,0.022222222222222223,0.022222222222222223,0.9777777777777777,45,1600,1300,300,0.8125,19,13,6,363.7005560169294,0.8283670033670034,0.22402595853315255,0.20782251403323174,130374.54433094789,483.6015311518386,130858.14586209973,3275,0,521.0222222222222,37,8,18,35.396088325817765,0.6221846846846848,44.682017543859644,1021.2719298245606,27.60194404931245,0
4198,4,0,0,44,0.0,0.0,1.0,44,1500,1200,300,0.8,18,12,6,393.9415508781727,0.8254272374911911,0.27132646594304255,0.2198918959410776,129459.11864144552,1406.8144482029797,130865.93308964849,3276,3,533.8636363636364,36,8,18,35.557292243000994,0.6148726851851851,45.57995495495496,1017.6801801801803,28.268893893893896,5
4199,4,2,2,44,0.043478260869565216,0.043478260869565216,0.9565217391304348,46,1050,700,350,0.6666666666666666,14,7,7,379.8234045207525,0.8352254428341385,0.25888843481814505,0.2146484690213118,129943.77170138872,671.13715277776,130614.90885416648,3277,0,511.60869565217394,39,7,19,35.42262634518458,0.6143162393162394,45.10416666666666,1019.5833333333319,26.143162393162356,0
4200,4,2,0,46,0.043478260869565216,0.0,1.0,46,1550,1200,350,0.7741935483870968,19,12,7,384.51283512320134,0.8361312399355878,0.2761479989662883,0.2129441682821907,129148.4429253473,731.8467881944541,129880.28971354176,3278,0,512.5652173913044,39,7,21,36.11438477830157,0.6063034188034189,45.88541666666667,1016.458333333334,26.063034188034205,1
4201,4,0,0,46,0.0,0.0,1.0,46,1450,1000,450,0.6896551724137931,19,10,9,381.58294521147286,0.8373188405797102,0.2731402184189966,0.2120425017786345,129282.86540516102,666.4381600304009,129949.30356519143,3279,1,513.5652173913044,38,8,21,36.051581048429455,0.609375,45.753205128205124,1016.9871794871791,26.762820512820504,0
4202,4,2,0,48,0.041666666666666664,0.0,1.0,48,1450,900,550,0.6206896551724138,20,9,11,376.98175803648166,0.8531139184397163,0.2847554456163246,0.1984602878455365,127119.65610812938,64.64058595748713,127184.29669408686,3280,0,493.125,37,11,19,38.38513917581821,0.5892454954954955,47.88925438596491,1008.4429824561399,27.255215742057835,8
4203,4,7,7,48,0.12727272727272726,0.12727272727272726,0.8727272727272728,55,1250,1000,250,0.8,15,10,5,332.8768345923464,0.8818742985409652,0.2618626445758312,0.18097435700731176,128415.10662073563,-2426.028071823393,125989.07854891224,3281,0,431.23636363636365,38,17,15,38.17307016619233,0.6006030701754386,46.60790598290598,1013.5683760683761,26.67285200179937,0
4204,4,3,2,49,0.058823529411764705,0.0392156862745098,0.9607843137254902,51,1850,1500,350,0.8108108108108109,22,15,7,365.5035491019255,0.868562091503268,0.2933697068468022,0.19724519805814647,128118.80845561514,-834.4241605525704,127284.38429506257,3282,0,465.94117647058823,40,11,20,37.649526534163165,0.5942708333333333,46.900406504065046,1012.3983739837406,25.309959349593516,0
4205,4,3,1,51,0.057692307692307696,0.019230769230769232,0.9807692307692307,52,1550,1200,350,0.7741935483870968,19,12,7,357.25554490859133,0.8650860985419808,0.32230944653977733,0.1960657777752407,128789.87295310354,-1197.8052601153781,127592.06769298816,3283,0,457.9230769230769,35,17,20,37.1726529836564,0.6101190476190477,46.238425925925924,1015.0462962962961,29.001322751322746,0
4206,4,2,1,52,0.03773584905660377,0.018867924528301886,0.9811320754716981,53,1550,1100,450,0.7096774193548387,20,11,9,352.9640389748178,0.86783381712627,0.3325804484674648,0.196319492057639,129319.08543381334,-1470.3462577160594,127848.73917609728,3284,0,449.54716981132077,35,18,22,36.742338036716724,0.6154761904761905,45.71759259259259,1017.1296296296288,29.060846560846535,0
4207,4,2,4,50,0.037037037037037035,0.07407407407407407,0.9259259259259259,54,1100,600,500,0.5454545454545454,16,6,10,331.82126352151613,0.8712293268110879,0.32022991253760513,0.18703933562355904,129843.17440221974,-2183.054762042187,127660.11964017755,3285,0,441.77777777777777,37,17,17,36.74813968083198,0.6168355855855856,45.20285087719297,1019.1885964912267,27.545637743006125,0
4208,4,1,1,50,0.0196078431372549,0.0196078431372549,0.9803921568627451,51,1050,600,450,0.5714285714285714,15,6,9,347.56258805118557,0.8641176470588237,0.3130343666744697,0.19433013108138442,129525.18332315245,-1196.3784132801752,128328.80490987227,3286,0,423.19607843137254,35,16,17,36.670101383361754,0.6175595238095237,45.5150462962963,1017.939814814815,29.083994708994716,0
4209,4,3,3,50,0.05660377358490566,0.05660377358490566,0.9433962264150944,53,1350,1200,150,0.8888888888888888,15,12,3,308.75581818409955,0.8746371552975326,0.2358297642474052,0.17354206332416602,129731.44531249985,-2588.932291666682,127142.51302083317,3287,0,408.1698113207547,39,14,17,37.448875255623705,0.6121794871794872,45.31249999999999,1018.7499999999989,26.121794871794844,2
4210,4,0,1,49,0.0,0.02,0.98,50,1150,600,550,0.5217391304347826,17,6,11,326.6126925313343,0.8639795918367347,0.2395946528676156,0.18163425275303674,129312.88954293601,-1552.953793474946,127759.93574946106,3288,1,433.58,37,13,24,37.41869699583154,0.6114864864864866,45.7236842105263,1017.1052631578925,27.489331436699796,0
4211,4,2,1,50,0.0392156862745098,0.0196078431372549,0.9803921568627451,51,1200,700,500,0.5833333333333334,17,7,10,322.3822388034713,0.8655882352941178,0.24346559524029998,0.18063639729781772,129609.02829141983,-1843.2702580539433,127765.75803336588,3289,0,425.98039215686276,38,13,18,37.22589444969047,0.6126644736842106,45.43269230769229,1018.2692307692284,26.79655870445338,0
4212,4,0,0,50,0.0,0.0,1.0,50,1200,800,400,0.6666666666666666,16,8,8,329.7341046513841,0.8608673469387755,0.25234256926952137,0.18437245006563294,129527.44904667969,-1458.0765121630661,128069.37253451662,3290,1,435.5,38,12,18,37.12151028547439,0.611842105263158,45.512820512820504,1017.9487179487169,26.78812415654518,0
4213,4,0,0,50,0.0,0.0,1.0,50,950,600,350,0.631578947368421,13,6,7,330.53471172384315,0.8604421768707483,0.25281427072402907,0.18507613412034207,129581.83235627128,-1433.7412794945103,128148.09107677676,3291,2,436.5,38,12,18,37.04595138160194,0.6123903508771931,45.459401709401696,1018.1623931623917,26.79374718848399,0
4214,4,0,0,50,0.0,0.0,1.0,50,1850,1300,550,0.7027027027027027,24,13,11,329.8697234734506,0.8600510204081633,0.2490844257996856,0.18534518640656145,129717.84056770017,-1442.0023604719318,128275.83820722824,3292,3,437.5,38,12,19,36.924925712288065,0.6137609649122808,45.32585470085469,1018.6965811965797,26.807804768331046,0
4215,4,1,1,50,0.0196078431372549,0.0196078431372549,0.9803921568627451,51,1300,900,400,0.6923076923076923,17,9,8,321.40765703425575,0.8596732026143792,0.24536533698540208,0.18225507732116183,130076.56385633671,-1838.4792751736195,128238.08458116309,3293,0,429.9019607843137,39,12,19,36.77722607985296,0.6156517094017095,44.97395833333333,1020.1041666666658,26.156517094017072,0
4216,4,0,1,49,0.0,0.02,0.98,50,1150,900,250,0.782608695652174,14,9,5,327.29131957794004,0.8587074829931972,0.2427124183006535,0.1854650810941661,130050.00000000001,-1487.1527777777771,128562.84722222223,3294,5,439.5,39,11,19,36.65407135076252,0.6153846153846154,45.0,1020.0000000000001,26.153846153846157,0
4217,4,0,0,49,0.0,0.0,1.0,49,1250,900,350,0.72,16,9,7,334.0584802433227,0.8561507936507937,0.24331609673302657,0.1892733715657566,130044.55133912251,-1111.5029631456064,128933.0483759769,3295,6,449.2244897959184,38,11,21,36.48702908418004,0.6170504385964912,45.005341880341874,1019.9786324786313,26.84154295996398,0
4218,4,1,0,50,0.02,0.0,1.0,50,1950,1500,450,0.7692307692307693,24,15,9,329.34751029904595,0.8618197278911565,0.24837486218302063,0.18834690532234236,130406.32482144321,-1409.65243339852,128996.6723880447,3296,0,441.22,36,14,23,36.24104189636162,0.6244212962962963,44.65090090090091,1021.3963963963976,28.372122122122153,0
4219,4,1,1,50,0.0196078431372549,0.0196078431372549,0.9803921568627451,51,1050,800,250,0.7619047619047619,13,8,5,323.4182702079382,0.8629738562091505,0.24919132622499074,0.18682161255540902,130794.81336805565,-1739.7135416666617,129055.09982638899,3297,0,433.54901960784315,37,14,20,36.00008486082823,0.6264076576576576,44.270833333333336,1022.9166666666674,27.646396396396415,0
4220,4,0,1,49,0.0,0.02,0.98,50,750,400,350,0.5333333333333333,11,4,7,331.94608861029707,0.8595408163265306,0.25499118942731247,0.19124812719425757,130694.03863322802,-1323.3250142033698,129370.71361902465,3298,1,442.94,36,14,21,35.88381057268723,0.6273148148148147,44.36936936936938,1022.5225225225241,28.40340340340345,0
4221,4,1,0,50,0.02,0.0,1.0,50,1500,1200,300,0.8,18,12,6,326.23415341988334,0.8613945578231292,0.24837921799678608,0.18927258061992605,130963.11034404821,-1455.072113534932,129508.03823051328,3299,0,442.74,37,13,22,35.758235136582755,0.6280968468468469,44.10635964912281,1023.574561403509,27.664177335229976,0
4222,4,0,0,50,0.0,0.0,1.0,50,1500,1100,400,0.7333333333333333,19,11,8,325.6969257316693,0.8600680272108844,0.24924823302634325,0.1893747131059981,131047.29940943365,-1463.659491381971,129583.63991805167,3300,1,443.74,37,13,22,35.68706718069536,0.6289414414414414,44.02412280701754,1023.9035087719296,27.673067804646745,0
4223,4,0,1,49,0.0,0.02,0.98,50,1300,800,500,0.6153846153846154,18,8,10,349.0028367598058,0.8599829931972789,0.19956262425447302,0.19912955886050554,130317.12420784951,-652.2951421076364,129664.82906574187,3301,2,444.74,38,12,17,35.82954030204737,0.6197916666666665,44.73824786324787,1021.0470085470097,26.86965811965815,8
4224,4,0,2,47,0.0,0.04081632653061224,0.9591836734693877,49,700,300,400,0.42857142857142855,11,3,8,353.8617424221133,0.8550170068027211,0.2087388750815713,0.2014877403309976,130237.2697487561,-582.802559681267,129654.46718907483,3302,5,454.7755102040816,41,8,17,35.786499335860306,0.6140752032520325,44.81646825396826,1020.7341269841279,24.895954316686048,0
4225,4,0,0,47,0.0,0.0,1.0,47,1050,500,550,0.47619047619047616,16,5,11,356.96153778820377,0.8470166512488436,0.23168234709143154,0.20324614228858878,130236.00396050366,-102.15115017359165,130133.85281033006,3303,6,474.40425531914894,39,8,17,35.7086820083682,0.6172542735042734,44.81770833333334,1020.7291666666681,26.17254273504277,0
4226,4,1,0,48,0.020833333333333332,0.0,1.0,48,1100,700,400,0.6363636363636364,15,7,8,349.24429625455866,0.8495124113475178,0.23099625370273547,0.20039122337581627,130535.38795976707,-482.24663378784066,130053.14132597923,3304,0,465.5,38,10,16,35.60223906603937,0.6219846491228069,44.524572649572654,1021.9017094017103,26.89215024741343,0
4227,4,0,0,48,0.0,0.0,1.0,48,1850,1500,350,0.8108108108108109,22,15,7,343.473955001863,0.8502696513002364,0.23066082586253733,0.19786034872642558,130688.28125000023,-622.3958333333042,130065.88541666693,3305,1,466.5,39,9,17,35.59494702526489,0.6217948717948717,44.375000000000014,1022.5000000000018,26.217948717948765,0
4228,4,1,0,49,0.02040816326530612,0.0,1.0,49,1450,1000,450,0.6896551724137931,19,10,9,340.81451151106154,0.8547689909297053,0.236540233959589,0.19813653799618847,131041.8228753554,-867.8090298433308,130174.01384551206,3306,0,457.9591836734694,40,9,18,35.30562448304385,0.6236979166666666,44.029471544715456,1023.8821138211391,25.597052845528477,0
4229,4,0,0,49,0.0,0.0,1.0,49,900,700,200,0.7777777777777778,11,7,4,327.0574607121689,0.8553004535147393,0.2290253744083186,0.18458393168948573,129891.90853915016,-1303.5764452256608,128588.3320939245,3307,1,458.9591836734694,42,7,21,36.82014416983524,0.6091269841269842,45.155038759689916,1019.3798449612392,24.270948689553315,4
4230,4,0,0,49,0.0,0.0,1.0,49,1150,800,350,0.6956521739130435,15,8,7,329.3325005473271,0.8556193310657597,0.23597290289298223,0.1862206288693997,129966.00193986262,-1239.5943190012413,128726.40762086137,3308,2,459.9591836734694,42,7,22,36.68709810256898,0.6098710317460316,45.08236434108528,1019.6705426356607,24.277870062753827,0
4231,4,0,0,49,0.0,0.0,1.0,49,1150,700,450,0.6086956521739131,16,7,9,328.3998496410784,0.8551941609977325,0.24248650828112361,0.18628198367571536,130089.53788834826,-1255.7230635177978,128833.81482483046,3309,3,460.9591836734694,42,7,22,36.58577127659573,0.6111111111111109,44.96124031007753,1020.1550387596916,24.289405684754563,0
4232,4,0,0,49,0.0,0.0,1.0,49,1200,700,500,0.5833333333333334,17,7,10,328.04551019092276,0.8553358843537415,0.23996062534394702,0.18655374262045377,130188.40889970574,-1258.4553963102962,128929.95350339545,3310,4,461.9591836734694,42,7,22,36.49473034561337,0.6121031746031745,44.86434108527133,1020.5426356589163,24.29863418235515,0
4233,4,1,0,50,0.02,0.0,1.0,50,1400,800,600,0.5714285714285714,20,8,12,324.54232691949744,0.8578061224489796,0.24342453487215154,0.18565594353260528,130418.24811826648,-1534.6882777332346,128883.55984053324,3311,0,453.7,40,10,23,36.35168971578284,0.6174479166666667,44.63922764227643,1021.4430894308962,25.536077235772403,0
4234,4,0,1,49,0.0,0.02,0.98,50,1600,1000,600,0.625,22,10,12,322.4321405523839,0.8565306122448979,0.24267249950288305,0.18531556969576457,130599.97046235722,-1578.074393548797,129021.89606880842,3312,1,454.7,40,10,16,36.22199575793729,0.6192708333333332,44.461382113821145,1022.1544715447167,25.553861788617915,0
4235,4,0,0,49,0.0,0.0,1.0,49,1100,900,200,0.8181818181818182,13,9,4,329.00871201618287,0.8521116780045351,0.248157906488635,0.18858914427655102,130496.11363110594,-1213.128346222475,129282.98528488346,3313,7,464.9591836734694,40,9,17,36.158908560440295,0.6182291666666666,44.56300813008131,1021.7479674796757,25.543699186991894,0
4236,4,0,0,49,0.0,0.0,1.0,49,1600,1000,600,0.625,22,10,12,329.8191194760672,0.8513321995464853,0.25004307399815784,0.18977029738698356,130642.6379145409,-1182.3120393990857,129460.32587514182,3314,8,465.9591836734694,41,8,18,35.99011402231926,0.6181402439024389,44.41964285714286,1022.3214285714292,24.934668989547056,0
4237,4,0,0,49,0.0,0.0,1.0,49,1550,1200,350,0.7741935483870968,19,12,7,328.5453509164192,0.8505881519274376,0.2544449897880017,0.18990805261491697,130820.18455530377,-1203.9273116653906,129616.25724363838,3315,9,466.9591836734694,41,8,20,35.84335402120507,0.6199186991869918,44.246031746031754,1023.0158730158744,24.951606658923765,0
4238,4,0,0,49,0.0,0.0,1.0,49,1600,1200,400,0.75,20,12,8,329.99932948447855,0.8500566893424036,0.2583688898647569,0.19137735144976759,130947.07739866778,-1157.5104520975037,129789.56694657028,3316,10,467.9591836734694,41,8,21,35.678067752253575,0.6211890243902438,44.12202380952381,1023.5119047619046,24.963704994192796,0
4239,4,1,0,50,0.02,0.0,1.0,50,1300,900,400,0.6923076923076923,17,9,8,324.57951477960495,0.8548469387755102,0.2624094562647752,0.18974175615225697,131253.6442840727,-1479.5511650441435,129774.09311902856,3317,0,459.58,42,8,22,35.50768321513002,0.622767857142857,43.82267441860466,1024.7093023255834,24.39784053156151,0
4240,4,0,1,49,0.0,0.02,0.98,50,1800,1400,400,0.7777777777777778,22,14,8,327.1861986912549,0.8547278911564625,0.2656910569105684,0.1916376306620209,131328.12500000017,-1406.249999999985,129921.87500000019,3318,1,460.58,42,8,22,35.36585365853659,0.6235119047619047,43.75000000000001,1025.0000000000014,24.404761904761937,0
4241,4,0,0,49,0.0,0.0,1.0,49,950,700,250,0.7368421052631579,12,7,5,327.62579343194005,0.8548044217687075,0.26138123643239686,0.19229699968697583,131408.21533203122,-1189.4558376736118,130218.75949435761,3319,2,466.0204081632653,39,10,22,35.27390446679535,0.6290064102564104,43.671875,1025.3124999999998,26.290064102564095,0
4242,4,0,0,49,0.0,0.0,1.0,49,700,300,400,0.42857142857142855,11,3,8,327.62579343194005,0.8550878684807256,0.26138123643239686,0.19229699968697583,131408.21533203122,-1189.4558376736118,130218.75949435761,3320,3,467.0204081632653,39,10,22,35.27390446679535,0.6290064102564104,43.671875,1025.3124999999998,26.290064102564095,0
4243,4,0,0,49,0.0,0.0,1.0,49,1600,1300,300,0.8125,19,13,6,328.52994017998424,0.8521116780045351,0.2666619302203037,0.19357994936759085,131557.019292092,-1155.9160643423893,130401.10322774961,3321,4,468.0204081632653,41,8,17,35.10087273958031,0.6272865853658536,43.52678571428572,1025.8928571428585,25.021777003484353,0
4244,4,0,0,49,0.0,0.0,1.0,49,1550,1000,550,0.6451612903225806,21,10,11,330.15986329736506,0.8517573696145125,0.26728835924047756,0.19532098945327825,131709.7262081916,-1102.946960034016,130606.77924815759,3322,5,469.0204081632653,41,8,17,34.90534696047163,0.6288109756097562,43.37797619047619,1026.4880952380952,25.0362950058072,0
4245,4,0,2,47,0.0,0.04081632653061224,0.9591836734693877,49,1600,1300,300,0.8125,19,13,6,335.11761002925334,0.8504818594104309,0.2717224820962867,0.1990517852342433,131862.52170138896,-962.1093749999906,130900.41232638898,3323,6,470.0204081632653,41,8,18,34.62432386747803,0.6303353658536586,43.22916666666667,1027.083333333334,25.050813008130095,0
4246,4,0,0,47,0.0,0.0,1.0,47,950,600,350,0.631578947368421,13,6,7,342.08695877844696,0.8468239284613012,0.26184214682009066,0.20298230877605464,131823.38271077088,-380.98798251700856,131442.39472825386,3324,7,483.6808510638298,40,7,18,34.484784760019785,0.6315104166666666,43.26727642276423,1026.9308943089443,25.673272357723608,0
4247,4,0,1,46,0.0,0.02127659574468085,0.9787234042553191,47,1150,800,350,0.6956521739130435,15,8,7,343.6610733954193,0.8462843046561825,0.25851379506281935,0.20461798892978186,131953.86860499732,-330.51837530567377,131623.35022969166,3325,8,484.6808510638298,40,7,18,34.31297395318167,0.6328124999999998,43.14024390243904,1027.4390243902462,25.685975609756156,0
4248,4,0,0,46,0.0,0.0,1.0,46,1200,700,500,0.5833333333333334,17,7,10,350.9550592968317,0.840841384863124,0.2646776064244982,0.20831221731532013,131835.7760959203,53.686523437518986,131889.46261935783,3326,20,496.04347826086956,39,7,18,34.24461997498056,0.6332799145299145,43.25520833333334,1026.979166666668,26.332799145299184,0
4249,4,0,0,46,0.0,0.0,1.0,46,1350,900,450,0.6666666666666666,18,9,9,347.6378504350157,0.841364734299517,0.2592651362883034,0.20707124134607482,131969.53125000015,-24.479166666654464,131945.0520833335,3327,21,497.04347826086956,39,7,19,34.195052716950535,0.6346153846153846,43.12500000000001,1027.5000000000011,26.346153846153875,0
4250,4,0,0,46,0.0,0.0,1.0,46,1400,1100,300,0.7857142857142857,17,11,6,348.6412435928984,0.8401972624798713,0.26000773711018965,0.2082992427018409,132084.41904826823,10.01522324674903,132094.43427151497,3328,22,498.04347826086956,40,6,21,34.05359202504532,0.6341145833333333,43.01321138211382,1027.9471544715448,25.69867886178862,0
4251,4,0,1,45,0.0,0.021739130434782608,0.9782608695652174,46,950,600,350,0.631578947368421,13,6,7,349.64679284788485,0.8384863123993559,0.2650223213326628,0.20947755457831563,132188.9058781977,43.885398076561216,132232.79127627425,3329,23,499.04347826086956,40,6,22,33.922571400336,0.6351562499999999,42.91158536585367,1028.3536585365869,25.70884146341467,0
4252,4,1,0,46,0.021739130434782608,0.0,1.0,46,900,500,400,0.5555555555555556,13,5,8,349.20717201536763,0.8419887278582932,0.2693285630226472,0.2097937212054343,132293.43401951555,39.56319403133642,132332.99721354689,3330,0,499.04347826086956,40,6,23,33.82869867298891,0.6361979166666667,42.8099593495935,1028.7601626016265,25.71900406504066,0
4253,4,1,0,47,0.02127659574468085,0.0,1.0,47,950,500,450,0.5263157894736842,14,5,9,338.96822300376004,0.845513413506013,0.2676766031889306,0.20531148129750945,132600.90115453315,-410.2950764465006,132190.60607808665,3331,0,489.40425531914894,36,11,24,33.7832112398863,0.646412037037037,42.511261261261275,1029.9549549549567,28.60985985985991,0
4254,4,0,0,47,0.0,0.0,1.0,47,1250,900,350,0.72,16,9,7,338.96822300376004,0.845513413506013,0.2676766031889306,0.20531148129750945,132600.90115453315,-410.50163339011874,132190.39952114303,3332,1,490.40425531914894,36,11,24,33.7832112398863,0.646412037037037,42.511261261261275,1029.9549549549567,28.60985985985991,0
4255,4,0,0,47,0.0,0.0,1.0,47,1000,700,300,0.7,13,7,6,338.9962470342436,0.8455519580635213,0.27277018997541824,0.2058046890588122,132687.90486009684,-403.8596451180614,132284.04521497877,3333,2,491.40425531914894,36,11,21,33.69516704922213,0.6472800925925926,42.426801801801815,1030.292792792795,28.619244244244303,0
4256,4,0,0,47,0.0,0.0,1.0,47,1100,800,300,0.7272727272727273,14,8,6,338.9962470342436,0.845513413506013,0.27277018997541824,0.2058046890588122,132687.90486009684,-403.8596451180614,132284.04521497877,3334,3,492.40425531914894,36,11,21,33.69516704922213,0.6472800925925926,42.426801801801815,1030.292792792795,28.619244244244303,0
4257,4,0,0,47,0.0,0.0,1.0,47,1250,900,350,0.72,16,9,7,337.25577184246276,0.8442028985507246,0.2725305568130376,0.20532410980046306,132793.26331178827,-442.9410972606902,132350.32221452758,3335,4,493.40425531914894,37,10,21,33.63430851063829,0.6463963963963963,42.324561403508774,1030.7017543859652,27.85680417259365,0
4258,4,0,0,47,0.0,0.0,1.0,47,1400,1100,300,0.7857142857142857,17,11,6,336.1442964780556,0.8437789084181313,0.2717688747373228,0.20489300800484914,132838.18354381275,-469.440449448439,132368.7430943643,3336,5,494.40425531914894,38,9,22,33.61790513697449,0.6450109649122806,42.28098290598292,1030.87606837607,27.128317588843945,0
4259,4,0,0,47,0.0,0.0,1.0,47,700,500,200,0.7142857142857143,9,5,4,333.53563777449347,0.843354918285538,0.2683615632378511,0.20360230488055917,132893.25741699562,-535.0725262984732,132358.18489069716,3337,6,495.40425531914894,38,9,22,33.629934721790484,0.6455592105263157,42.22756410256411,1031.0897435897452,27.13394062078277,0
4260,4,0,0,47,0.0,0.0,1.0,47,1800,1500,300,0.8333333333333334,21,15,6,334.43451603351565,0.8422756706753006,0.27109061151614333,0.20516698738902064,133078.71187991634,-498.77707961528097,132579.93480030107,3338,7,496.40425531914894,40,7,23,33.420951114613075,0.6440104166666666,42.04776422764229,1031.8089430894331,25.795223577235827,0
4261,4,0,0,47,0.0,0.0,1.0,47,1300,1000,300,0.7692307692307693,16,10,6,336.4551567881489,0.8426225716928769,0.26934012173020294,0.20669704278183038,133131.1463600537,-441.46785560841465,132689.6785044453,3339,8,497.40425531914894,40,7,23,33.31630559658626,0.6445312499999998,41.996951219512205,1032.0121951219526,25.800304878048813,0
4262,4,0,0,47,0.0,0.0,1.0,47,1300,1100,200,0.8461538461538461,15,11,4,337.268173800115,0.8417360468701819,0.27227908022943126,0.20752663207511524,133190.45970529428,-415.8193775195115,132774.64032777477,3340,9,498.40425531914894,41,6,23,33.235924235143386,0.6435467479674796,41.939484126984134,1032.2420634920645,25.176635694928404,0
4263,4,0,0,47,0.0,0.0,1.0,47,1600,1400,200,0.875,18,14,4,339.71978879867316,0.8411193339500462,0.2764179799800166,0.2101902650481633,133395.34837372456,-336.5920847505614,133058.756288974,3341,10,499.40425531914894,41,6,24,32.96750456160566,0.6455792682926829,41.74107142857143,1033.035714285715,25.1959930313589,0
4264,4,0,0,47,0.0,0.0,1.0,47,1350,1000,350,0.7407407407407407,17,10,7,342.09157127991705,0.840386987357385,0.28037062457103645,0.21209677419354833,133472.22222222204,-267.9669784580688,133204.25524376397,3342,11,500.40425531914894,37,10,24,32.829301075268816,0.6531531531531533,41.66666666666666,1033.333333333332,27.92792792792789,0
4265,4,0,1,46,0.0,0.02127659574468085,0.9787234042553191,47,1000,600,400,0.6,14,6,8,341.37204751587154,0.8399244526672833,0.2804322118813134,0.21229918627834005,133585.55036164966,-279.5254309018256,133306.02493074784,3343,12,501.40425531914894,37,10,24,32.73449653514355,0.6542792792792793,41.557017543859644,1033.7719298245606,27.939781887150286,0
4266,4,1,1,46,0.02127659574468085,0.02127659574468085,0.9787234042553191,47,1100,600,500,0.5454545454545454,16,6,10,331.5048543254687,0.8451279679309281,0.2632841433786861,0.20769443848618924,133858.89788333682,-525.0251114033395,133333.87277193347,3344,0,491.6808510638298,38,9,21,32.71646362447518,0.65515350877193,41.29273504273503,1034.8290598290585,27.232343679712063,0
4267,4,0,0,46,0.0,0.0,1.0,46,1050,600,450,0.5714285714285714,15,6,9,336.759655765021,0.8393719806763286,0.2628295219322081,0.2105128306502707,133775.99172921662,-189.9286151289595,133586.06311408765,3345,14,503.3695652173913,38,8,21,32.663344693449005,0.6543311403508772,41.372863247863236,1034.5085470085448,27.22390913180381,0
4268,4,0,1,45,0.0,0.021739130434782608,0.9782608695652174,46,1200,800,400,0.6666666666666666,16,8,8,337.02422145328785,0.8387882447665057,0.26030421321846875,0.21178759441519768,133969.4793721231,-169.80810322161847,133799.6712689015,3346,15,504.3695652173913,38,8,21,32.46323529411765,0.6562500000000002,41.18589743589741,1035.2564102564063,27.243589743589638,0
4269,4,0,0,45,0.0,0.0,1.0,45,1500,1000,500,0.6666666666666666,20,10,10,338.3971490209029,0.8400252525252526,0.2518243405894287,0.2131308359622877,134052.44545118324,72.59307199208746,134125.03852317535,3347,16,505.9111111111111,38,7,21,32.34486227174248,0.6570723684210528,41.10576923076922,1035.5769230769215,27.252024291497936,0
4270,4,0,0,45,0.0,0.0,1.0,45,1350,700,650,0.5185185185185185,20,7,13,336.45598470738173,0.8396043771043772,0.25004125412541245,0.21238784034653457,134135.43721236012,26.134122287948486,134161.57133464806,3348,17,506.9111111111111,38,7,21,32.312293729372925,0.6578947368421054,41.025641025641015,1035.8974358974344,27.26045883940617,0
4271,4,0,0,45,0.0,0.0,1.0,45,900,400,500,0.4444444444444444,14,4,10,340.58472742190753,0.8394781144781145,0.24611471973055643,0.2154814919285764,134218.454655654,142.55115877710074,134361.0058144311,3349,18,507.9111111111111,38,7,21,32.12251263016805,0.658717105263158,40.94551282051281,1036.2179487179474,27.268893387314403,0
4272,4,0,0,45,0.0,0.0,1.0,45,1300,900,400,0.6923076923076923,17,9,8,341.0291603067373,0.8398148148148149,0.2423072077334527,0.2160890845287821,134273.81388569265,158.25720012415982,134432.0710858168,3350,19,508.9111111111111,38,7,21,32.05575885647527,0.6592653508771931,40.892094017094,1036.431623931622,27.27451641925321,0
4273,4,0,0,45,0.0,0.0,1.0,45,1200,1000,200,0.8333333333333334,14,10,4,340.1328351157608,0.8385521885521886,0.24324994139120548,0.21603970056842145,134361.72010633664,140.16655815970384,134501.88666449633,3351,20,509.9111111111111,39,6,21,31.991296593991766,0.6583867521367522,40.80729166666666,1036.770833333332,26.583867521367484,0
4274,4,0,1,44,0.0,0.022222222222222223,0.9777777777777777,45,1300,1000,300,0.7692307692307693,16,10,6,336.7211719437624,0.8386784511784512,0.2421117249846536,0.2141890905239712,134415.72401258658,52.124023437476694,134467.84803602405,3352,21,510.9111111111111,39,6,21,32.02588732630169,0.6589209401709404,40.75520833333332,1036.979166666665,26.589209401709358,0
4275,4,0,0,44,0.0,0.0,1.0,44,1000,700,300,0.7,13,7,6,339.47096333099796,0.8336636715997181,0.25381240301781816,0.21440935565032188,134155.6830011898,308.39178894837966,134464.0747901382,3353,22,523.0227272727273,40,4,21,32.2140066051926,0.6546875,41.00609756097561,1035.9756097560978,25.899390243902445,1
4276,4,0,0,44,0.0,0.0,1.0,44,1500,1200,300,0.8,18,12,6,351.934967140004,0.8321000704721635,0.2591459221565122,0.2174102927846195,133337.7075195314,585.8212842858859,133923.5288038173,3354,23,524.0227272727273,39,5,20,32.70980416876785,0.6482371794871794,41.79687500000001,1032.8125000000011,26.482371794871824,2
4277,4,0,0,44,0.0,0.0,1.0,44,900,600,300,0.6666666666666666,12,6,6,348.1877239458762,0.8321661381254405,0.2601531693446715,0.21572361909553495,133445.97012566944,492.84972156126065,133938.8198472307,3355,24,525.0227272727273,40,4,22,32.69810825874561,0.6476562499999998,41.69207317073172,1033.2317073170746,25.830792682926862,0
4278,4,1,1,44,0.022222222222222223,0.022222222222222223,0.9777777777777777,45,1000,600,400,0.6,14,6,8,338.4107227066068,0.8358164983164984,0.2559525071557298,0.21126593959572637,133727.2781649162,50.959297722541095,133778.23746263876,3356,0,514.3333333333334,37,8,20,32.669330188345896,0.6556869369369368,41.419956140350884,1034.3201754385973,27.954599336178305,0
4279,4,0,0,44,0.0,0.0,1.0,44,1600,1000,600,0.625,22,10,12,349.1211233898673,0.829919837914024,0.26258611815014254,0.21782122263672182,133705.05640775923,535.8518991965079,134240.90830695574,3357,26,527.0227272727273,36,8,20,32.41461599883856,0.6574074074074073,41.44144144144145,1034.2342342342351,28.728728728728754,0
4280,4,0,0,44,0.0,0.0,1.0,44,1300,1200,100,0.9230769230769231,14,12,2,347.6158481349822,0.8293472515856237,0.2607638579724765,0.21773974291154416,133850.68081172404,505.72358676245653,134356.4043984865,3358,27,528.0227272727273,36,8,20,32.307877171981005,0.6588541666666665,41.300675675675684,1034.7972972972984,28.7443693693694,0
4281,4,0,0,44,0.0,0.0,1.0,44,1250,800,450,0.64,17,8,9,342.8620009797214,0.827431289640592,0.2515547832449241,0.21569925884420454,134010.95920138893,389.45312500000483,134400.41232638893,3359,28,529.0227272727273,37,7,21,32.270707578806174,0.6585022522522521,41.145833333333336,1035.416666666667,27.984234234234243,0
4282,4,0,0,44,0.0,0.0,1.0,44,1150,700,450,0.6086956521739131,16,7,9,341.75741320029476,0.8267926356589148,0.24873924508690526,0.21550337283644772,134096.1221241152,365.6687634656925,134461.7908875809,3360,29,530.0227272727273,37,7,21,32.21425294657351,0.6593468468468467,41.063596491228076,1035.7456140350885,27.99312470365104,0
4283,4,0,0,44,0.0,0.0,1.0,44,950,500,450,0.5263157894736842,14,5,9,342.77430327288516,0.8269908386187457,0.2510922178276893,0.21631187996118562,134124.51577648905,394.88748941983545,134519.40326590888,3361,30,531.0227272727273,37,7,21,32.159570057513854,0.6596283783783783,41.03618421052632,1035.8552631578957,27.99608819345664,0
4284,4,0,0,44,0.0,0.0,1.0,44,1450,1000,450,0.6896551724137931,19,10,9,343.9383276916196,0.8262861169837914,0.2575905951588877,0.21793244395404296,134273.81388569274,436.3822001241737,134710.19608581692,3362,31,532.0227272727273,38,6,21,31.980380029550226,0.6592653508771931,40.89209401709401,1036.4316239316227,27.274516419253228,0
4285,4,0,1,43,0.0,0.022727272727272728,0.9772727272727273,44,1050,700,350,0.6666666666666666,14,7,7,344.99339228003805,0.8251189217758985,0.26136949209710214,0.21893203958752175,134329.18453000576,468.53621064357435,134797.72074064933,3363,32,533.0227272727273,38,6,22,31.897780755092924,0.6598135964912281,40.83867521367521,1036.6452991452986,27.28013945119207,0
4286,4,0,0,43,0.0,0.0,1.0,43,1150,900,250,0.782608695652174,14,9,5,347.96124037665936,0.8205518641565153,0.2577519379844959,0.2211237559812965,134380.1939058172,751.8197907048351,135132.01369652204,3364,33,543.4418604651163,37,6,23,31.76995205865764,0.6621621621621622,40.78947368421053,1036.8421052631581,28.022759601706976,0
4287,4,0,0,43,0.0,0.0,1.0,43,1150,600,550,0.5217391304347826,17,6,11,345.96216190061443,0.8189368770764119,0.2506771271131034,0.2208835341365462,134550.78125000003,710.0040397045248,135260.78528970457,3365,34,544.4418604651163,36,7,23,31.651606425702802,0.6657986111111112,40.625,1037.5000000000002,28.81944444444445,0
4288,4,0,0,43,0.0,0.0,1.0,43,1250,800,450,0.64,17,8,9,348.37581493236405,0.8172296050203026,0.2510850694444444,0.22296052155671292,134638.4222059898,780.9540114438773,135419.3762174337,3366,35,545.4418604651163,36,7,23,31.50160047743055,0.6666666666666666,40.54054054054054,1037.837837837838,28.828828828828833,0
4289,4,0,0,43,0.0,0.0,1.0,43,950,700,250,0.7368421052631579,12,7,5,347.03837958702485,0.8180601698043558,0.24805865167745567,0.22246173734584115,134696.86536198366,748.9963781348964,135445.86174011856,3367,36,546.4418604651163,36,7,23,31.478041151370498,0.6672453703703705,40.484234234234236,1038.0630630630635,28.835085085085097,0
4290,4,0,0,43,0.0,0.0,1.0,43,1250,900,350,0.72,16,9,7,350.54181030818944,0.8147840531561461,0.2555920853587199,0.22579592585773325,134872.27091956828,855.6740017044111,135727.9449212727,3368,37,547.4418604651163,36,7,21,31.212281367447225,0.6689814814814815,40.31531531531532,1038.7387387387394,28.85385385385387,0
4291,4,0,0,43,0.0,0.0,1.0,43,1350,800,550,0.5925925925925926,19,8,11,348.4194306808501,0.8146456256921373,0.25107507095720405,0.22479144527702943,134930.76480196405,802.5000507263965,135733.26485269045,3369,38,548.4418604651163,36,7,21,31.209128188452922,0.6695601851851851,40.259009009009006,1038.9639639639634,28.860110110110092,0
4292,4,0,0,43,0.0,0.0,1.0,43,1400,1100,300,0.7857142857142857,17,11,6,347.26180357321016,0.8144149132521226,0.24532880429989357,0.22458859041185414,135018.52940355908,777.3556072964936,135795.88501085556,3370,39,549.4418604651163,36,7,21,31.15180409578502,0.6704282407407407,40.17454954954955,1039.3018018018026,28.869494494494518,0
4293,4,0,0,43,0.0,0.0,1.0,43,1200,800,400,0.6666666666666666,16,8,8,346.0731364341723,0.8142764857881136,0.24351504059156426,0.22391994950576935,135034.6996792283,746.3764090874188,135781.07608831572,3371,40,550.4418604651163,37,6,21,31.16659194007806,0.6686373873873874,40.15899122807018,1039.36403508772,28.090919867235673,0
4294,4,0,0,43,0.0,0.0,1.0,43,1350,700,650,0.5185185185185185,20,7,13,345.69673283490187,0.8151531930601698,0.23819368318827583,0.22438344404335203,135148.689079813,744.0920523622651,135892.78113217527,3372,41,551.4418604651163,37,6,21,31.062932792013772,0.6697635135135136,40.04934210526316,1039.8026315789473,28.102773826458034,0
4295,4,0,2,41,0.0,0.046511627906976744,0.9534883720930233,43,850,400,450,0.47058823529411764,13,4,9,346.79645043779453,0.813999630860096,0.24551943213459326,0.2259893352852881,135291.24345952595,783.7046014158151,136074.94806094177,3373,42,552.4418604651163,37,6,21,30.892530916245086,0.6711711711711712,39.91228070175438,1040.3508771929821,28.117591275486003,0
4296,4,0,0,41,0.0,0.0,1.0,41,1100,600,500,0.5454545454545454,16,6,10,351.6003202306017,0.814380081300813,0.23188465393610724,0.22948329016426472,135348.2862515389,1317.7001577408428,136665.98640927975,3374,43,534.9756097560976,37,4,21,30.71083596768529,0.6717342342342343,39.85745614035088,1040.5701754385964,28.1235182550972,0
4297,4,0,1,40,0.0,0.024390243902439025,0.975609756097561,41,400,200,200,0.5,6,2,4,352.22439713833217,0.8138211382113821,0.2292595552654504,0.23007307317549286,135376.81215614424,1336.6032096414283,136713.41536578568,3375,44,535.9756097560976,37,4,21,30.666223264144982,0.6720157657657657,39.83004385964912,1040.6798245614036,28.1264817449028,0
4298,4,0,0,40,0.0,0.0,1.0,40,650,400,250,0.6153846153846154,9,4,5,360.26273044681403,0.8091880341880342,0.2312290291157053,0.2348953681438333,135311.28415155032,1749.5225377404581,137060.8066892908,3376,45,548.0,36,4,21,30.522332864307113,0.6733217592592593,39.893018018018026,1040.427927927929,28.900775775775806,0
4299,4,0,0,40,0.0,0.0,1.0,40,800,300,500,0.375,13,3,10,359.3944470640862,0.8080929487179487,0.2264715429560702,0.23490265061996363,135399.17239875023,1732.3421394367501,137131.51453818698,3377,46,549.0,36,4,21,30.457422635793137,0.6741898148148147,39.808558558558566,1040.7657657657667,28.910160160160185,0
4300,4,1,1,40,0.024390243902439025,0.024390243902439025,0.975609756097561,41,1550,1200,350,0.7741935483870968,19,12,7,354.3636479563546,0.8093495934959349,0.21697906809393386,0.23370825620385954,135721.67342595977,1419.1683660011395,137140.8417919609,3378,0,536.5853658536586,36,5,21,30.26766093879462,0.6773726851851851,39.498873873873876,1042.004504504505,28.94456956956958,0
4301,4,0,0,40,0.0,0.0,1.0,40,1400,900,500,0.6428571428571429,19,9,10,360.3176711431475,0.8062232905982906,0.220890715237672,0.23785192895695742,135754.27061899856,1782.9325274348325,137537.2031464334,3379,48,551.0,35,5,21,30.08014956315711,0.6797619047619048,39.46759259259259,1042.129629629629,29.77513227513226,0
4302,4,0,0,40,0.0,0.0,1.0,40,1300,1100,200,0.8461538461538461,15,11,4,358.25269979083123,0.8054754273504273,0.2235790408525753,0.23728972939086806,135874.9142661179,1735.51097393689,137610.42524005478,3380,49,552.0,35,5,21,30.014061574896395,0.680952380952381,39.35185185185185,1042.5925925925922,29.788359788359777,0
4303,4,0,0,40,0.0,0.0,1.0,40,1200,900,300,0.75,15,9,6,354.4497261529679,0.8044871794871795,0.21927430093209033,0.23556791534591037,135995.6114969135,1640.7214506172752,137636.33294753078,3381,50,553.0,35,5,21,29.993342210386157,0.6821428571428572,39.23611111111111,1043.055555555555,29.801587301587286,0
4304,4,0,0,40,0.0,0.0,1.0,40,950,700,250,0.7368421052631579,12,7,5,354.41582232527145,0.8015758547008547,0.21759199309377353,0.23645582616906344,136132.6840987947,1649.5154360441443,137782.19953483884,3382,51,554.0,36,4,21,29.858188554368542,0.6814236111111112,39.104729729729726,1043.5810810810808,28.988363363363355,0
4305,4,0,0,40,0.0,0.0,1.0,40,1400,800,600,0.5714285714285714,20,8,12,355.6292391539821,0.7993589743589744,0.21800043140638503,0.23825103362974848,136279.62421881326,1693.0038146254178,137972.62803343867,3383,52,555.0,36,4,21,29.680759275237254,0.6828703703703705,38.963963963963955,1044.144144144143,29.00400400400397,0
4306,4,0,0,40,0.0,0.0,1.0,40,1150,800,350,0.6956521739130435,15,8,7,354.7102253752611,0.7990117521367521,0.2172119219575297,0.23862558091416197,136426.6435988352,1678.3850996266399,138105.02869846183,3384,53,556.0,36,4,21,29.558989975207496,0.6843171296296298,38.82319819819819,1044.7072072072062,29.019644644644618,0
4307,4,0,1,39,0.0,0.025,0.975,40,1400,900,500,0.6428571428571429,19,9,10,353.25465607985876,0.7987713675213676,0.2152283990519286,0.23863971744783455,136573.74223886037,1649.0620688255724,138222.80430768593,3385,54,557.0,36,4,21,29.451267686561813,0.685763888888889,38.68243243243243,1045.2702702702695,29.035285285285266,0
4308,4,0,0,39,0.0,0.0,1.0,39,750,300,450,0.4,12,3,9,354.2059742367851,0.7923414304993253,0.22407027519343603,0.24049281661741742,136751.18319455156,1887.6964742950831,138638.87966884664,3386,55,565.0512820512821,35,4,21,29.250696211869734,0.6895833333333332,38.51273148148148,1045.9490740740737,29.88425925925925,0
4309,4,0,0,39,0.0,0.0,1.0,39,700,400,300,0.5714285714285714,10,4,6,352.8193280601456,0.7925101214574899,0.22001361470388048,0.24017219319756897,136841.99245541837,1856.099965706443,138698.0924211248,3387,56,566.0512820512821,35,4,21,29.197087020648965,0.6904761904761905,38.425925925925924,1046.296296296296,29.89417989417989,0
4310,4,0,0,39,0.0,0.0,1.0,39,1100,700,400,0.6363636363636364,15,7,8,352.5508008772386,0.7914417453891138,0.22138463240111284,0.24019681919601457,136872.26890700014,1850.8856042095324,138723.15451120966,3388,57,567.0512820512821,35,4,22,29.174155698116003,0.6907738095238095,38.39699074074074,1046.412037037037,29.89748677248677,0
4311,4,0,0,39,0.0,0.0,1.0,39,1600,1400,200,0.875,18,14,4,348.5226582078164,0.7918353576248314,0.21712652672405008,0.23806940489663833,136963.11835562412,1746.950017146772,138710.06837277088,3389,58,568.0512820512821,35,4,18,29.18970219666815,0.6916666666666667,38.31018518518518,1046.759259259259,29.907407407407398,0
4312,4,0,0,39,0.0,0.0,1.0,39,1150,800,350,0.6956521739130435,15,8,7,342.5085167934384,0.7918353576248314,0.19797658980300592,0.22426040403013167,135462.40790435538,1482.0312826548939,136944.43918701028,3390,59,569.0512820512821,37,2,19,30.83394775647778,0.6728603603603602,39.74780701754387,1041.0087719298263,28.135372214319627,5
4313,4,0,0,39,0.0,0.0,1.0,39,950,600,350,0.631578947368421,13,6,7,339.69625594394245,0.7909356725146199,0.196111462062188,0.22312828761795087,135576.57764889213,1410.9711642043858,136987.5488130965,3391,60,570.0512820512821,37,2,19,30.793763599354246,0.6739864864864864,39.63815789473685,1041.447368421054,28.147226173542002,0
4314,4,0,0,39,0.0,0.0,1.0,39,1300,900,400,0.6923076923076923,17,9,8,339.19999999999965,0.7909356725146199,0.1950769230769227,0.22315789473684222,135633.68055555577,1401.3888888889082,137035.06944444467,3392,61,571.0512820512821,37,2,19,30.74999999999998,0.6745495495495495,39.58333333333334,1041.6666666666683,28.153153153153198,0
4315,4,0,0,39,0.0,0.0,1.0,39,1350,1000,350,0.7407407407407407,17,10,7,334.7731654288657,0.7892487629329735,0.189724706294933,0.22112709780412584,135776.49042253397,1290.8650979147587,137067.35552044873,3393,62,572.0512820512821,37,2,20,30.723632298790122,0.6759572072072071,39.44627192982457,1042.2149122807025,28.16797060218115,0
4316,4,0,0,39,0.0,0.0,1.0,39,1400,1000,400,0.7142857142857143,18,10,8,346.336496900793,0.7885177687809267,0.19042400164394868,0.2248184312251967,135151.85613854582,1583.302464089129,136735.15860263494,3394,63,573.0512820512821,35,4,18,31.04315078658356,0.6738095238095239,40.04629629629629,1039.8148148148139,29.70899470899468,3
4317,4,0,0,39,0.0,0.0,1.0,39,500,300,200,0.6,7,3,4,346.3968929862206,0.7881803868645975,0.18907652934580743,0.22542135244512407,135242.13291162965,1569.4909282835933,136811.62383991326,3395,64,574.0512820512821,35,4,18,30.95176829494455,0.674702380952381,39.95949074074073,1040.162037037036,29.718915343915317,0
4318,4,0,0,39,0.0,0.0,1.0,39,800,500,300,0.625,11,5,6,346.4982064022801,0.7871682411156096,0.18804179467212068,0.2258645668854309,135302.33417191767,1576.4032225222697,136878.73739443993,3396,65,575.0512820512821,35,4,19,30.88925816738977,0.6752976190476192,39.90162037037036,1040.393518518517,29.72552910052906,0
4319,4,0,0,39,0.0,0.0,1.0,39,950,600,350,0.631578947368421,13,6,7,346.58189760786763,0.7840755735492578,0.18145123359131143,0.22705784187784156,135483.01832829625,1591.1923171724688,137074.21064546873,3397,66,576.0512820512821,35,4,20,30.707453214748934,0.6770833333333335,39.728009259259245,1041.0879629629612,29.74537037037032,0
4320,4,0,0,39,0.0,0.0,1.0,39,1150,900,250,0.782608695652174,14,9,5,346.7747110867267,0.7823886639676114,0.18533683229760567,0.22794927867563536,135603.541412144,1604.7757791066256,137208.31719125062,3398,67,577.0512820512821,35,4,20,30.58268048301663,0.6782738095238097,39.612268518518505,1041.5509259259243,29.758597883597837,0
4321,4,0,0,39,0.0,0.0,1.0,39,1050,700,350,0.6666666666666666,14,7,7,347.2687300318382,0.7811515969410706,0.18142057831119507,0.2294317618442187,135784.42650730864,1630.7370702588964,137415.16357756755,3399,68,578.0512820512821,35,4,20,30.390176753655364,0.680059523809524,39.4386574074074,1042.245370370369,29.778439153439116,0
4322,4,0,0,39,0.0,0.0,1.0,39,1300,1000,300,0.7692307692307693,16,10,6,348.071478156496,0.7792397660818714,0.17341198364392252,0.23113279953339577,135965.4321657448,1665.1377904234994,137630.5699561683,3400,69,579.0512820512821,35,4,17,30.189606222024917,0.6818452380952382,39.26504629629628,1042.9398148148132,29.798280423280378,0
4323,4,0,0,39,0.0,0.0,1.0,39,1100,700,400,0.6363636363636364,15,7,8,347.73384584016634,0.7782276203328835,0.17484146830646408,0.2313007492662298,136025.79417706162,1660.1545085304876,137685.9486855921,3401,70,580.0512820512821,35,4,17,30.13852675764636,0.6824404761904763,39.20717592592591,1043.171296296294,29.804894179894116,0
4324,4,0,0,39,0.0,0.0,1.0,39,800,500,300,0.625,11,5,6,347.9065438591107,0.7762033288349078,0.17749379377415364,0.23220379762972573,136146.55838745253,1673.2557173782247,137819.81410483076,3402,71,581.0512820512821,35,4,17,30.014255480388904,0.6836309523809525,39.09143518518517,1043.6342592592569,29.818121693121626,0
4325,4,0,0,39,0.0,0.0,1.0,39,1200,700,500,0.5833333333333334,17,7,10,348.97566875285764,0.7750224921277553,0.1743134913866622,0.23351339259278744,136237.16670953357,1708.6912722908019,137945.85798182437,3403,72,582.0512820512821,35,4,17,29.896526237989637,0.6845238095238095,39.004629629629626,1043.981481481481,29.828042328042315,0
4326,4,0,0,39,0.0,0.0,1.0,39,900,600,300,0.6666666666666666,12,6,6,348.97566875285764,0.7750224921277553,0.1743134913866622,0.23351339259278744,136237.16670953357,1708.6912722908019,137945.85798182437,3404,73,583.0512820512821,35,4,17,29.896526237989637,0.6845238095238095,39.004629629629626,1043.981481481481,29.828042328042315,0
4327,4,0,0,39,0.0,0.0,1.0,39,750,600,150,0.8,9,6,3,349.429835323108,0.7742914979757085,0.1767644902204868,0.234216639991462,136297.58900248617,1725.2888160150758,138022.87781850123,3405,74,584.0512820512821,35,4,17,29.824780166999187,0.6851190476190476,38.94675925925925,1044.2129629629621,29.83465608465606,0
4328,4,0,0,39,0.0,0.0,1.0,39,950,700,250,0.7368421052631579,12,7,5,348.4958882077598,0.7725483580746739,0.17337730398548,0.23459152743112935,136448.7033420138,1710.3624131944343,138159.06575520823,3406,75,585.0512820512821,35,4,19,29.6994433366567,0.6866071428571429,38.80208333333333,1044.7916666666658,29.851190476190453,0
4329,4,0,0,39,0.0,0.0,1.0,39,950,800,150,0.8421052631578947,11,8,3,348.15880011026655,0.7717049032838507,0.17295980511571307,0.2351699419443392,136569.65509527165,1709.5854498885362,138279.2405451602,3407,76,586.0512820512821,35,4,20,29.58847765105378,0.6877976190476192,38.68634259259259,1045.2546296296287,29.864417989417962,0
4330,4,0,0,39,0.0,0.0,1.0,39,1100,600,500,0.5454545454545454,16,6,10,347.1319425051668,0.7709176788124157,0.171034063764274,0.23509263939901348,136662.03946767718,1687.951845426513,138349.9913131037,3408,77,587.0512820512821,36,3,21,29.523873631304983,0.6866319444444444,38.597972972972975,1045.6081081081084,29.044669669669677,0
4331,4,0,0,39,0.0,0.0,1.0,39,750,400,350,0.5333333333333333,11,4,7,343.57779113311,0.7709176788124157,0.16484636195819946,0.22371465370486035,135262.72657211838,1494.6537636580565,136757.38033577643,3409,78,588.0512820512821,37,2,20,31.004598397807534,0.6708896396396395,39.939692982456144,1040.2412280701758,28.114627785680426,5
4332,4,0,1,38,0.0,0.02564102564102564,0.9743589743589743,39,1200,800,400,0.6666666666666666,16,8,8,343.8316094882335,0.7690058479532164,0.16731356708181733,0.22494786139709166,135433.87298255242,1513.2893053631944,136947.16228791562,3410,79,589.0512820512821,37,2,21,30.82786878050493,0.6725788288288288,39.77521929824562,1040.899122807018,28.132408724514004,0
4333,4,0,0,38,0.0,0.0,1.0,38,1050,700,350,0.6666666666666666,14,7,7,355.24372433493494,0.7697961119013751,0.1744812274059948,0.2327589108062703,135487.0891795512,2026.1876318886466,137513.27681143984,3411,80,601.4473684210526,36,2,21,30.477961060032456,0.6750578703703705,39.7240990990991,1041.1036036036037,28.919544544544546,0
4334,4,0,1,37,0.0,0.02631578947368421,0.9736842105263158,38,1250,1000,250,0.8,15,10,5,348.0978360840908,0.7697961119013751,0.20360270278459502,0.2167189753684824,133626.03635204086,1703.1453397343903,135329.18169177524,3412,81,602.4473684210526,34,4,23,32.52014968336213,0.660845588235294,41.517857142857146,1033.9285714285718,30.40966386554623,8
4335,4,0,0,37,0.0,0.0,1.0,37,1200,700,500,0.5833333333333334,17,7,10,355.94438579546716,0.7695195195195195,0.1912514410144741,0.22220196864746639,133725.61034217622,2119.7760476739873,135845.3863898502,3413,82,554.0,33,4,16,32.217614533965246,0.6641414141414141,41.42156862745099,1034.3137254901972,31.342840166369612,0
4336,4,0,0,37,0.0,0.0,1.0,37,650,300,350,0.46153846153846156,10,3,7,354.2209069437722,0.7697697697697697,0.190012071068818,0.22131596413859217,133757.3007527153,2075.92647659554,135833.22722931084,3414,83,555.0,33,4,16,32.230457489239036,0.6644570707070707,41.39093137254902,1034.4362745098038,31.346553773024358,0
4337,4,0,0,37,0.0,0.0,1.0,37,1250,1000,250,0.8,15,10,5,353.86028071137605,0.7687062062062062,0.19086637561294162,0.22166143993522702,133852.39451172634,2073.0091791618706,135925.4036908882,3415,84,556.0,33,4,17,32.14461945365546,0.6654040404040404,41.29901960784314,1034.803921568628,31.35769459298873,0
4338,4,0,0,37,0.0,0.0,1.0,37,700,600,100,0.8571428571428571,8,6,2,355.0172624662559,0.7682682682682682,0.19289200390443728,0.22257763782683973,133884.09994052764,2106.233329728945,135990.33327025658,3416,85,557.0,33,4,17,32.08296329188868,0.665719696969697,41.268382352941174,1034.926470588235,31.36140819964348,0
4339,4,1,0,38,0.02631578947368421,0.0,1.0,38,1000,800,200,0.8,12,8,4,353.0457752744711,0.7712482219061166,0.2078977581726993,0.22445464982778407,134396.43565759627,1889.6187641723236,136286.0544217686,3417,0,543.3157894736842,34,4,20,31.62193838499809,0.6685049019607843,40.77380952380952,1036.904761904761,30.497198879551796,0
4340,4,0,0,38,0.0,0.0,1.0,38,850,400,450,0.47058823529411764,13,4,9,352.6880178622968,0.7706555239449976,0.20306705483009813,0.22498707083836403,134519.90504535133,1888.7117346938626,136408.6167800452,3418,1,544.3157894736842,34,4,21,31.507966108178408,0.6697303921568627,40.6547619047619,1037.3809523809514,30.51120448179269,0
4341,4,0,0,38,0.0,0.0,1.0,38,1050,700,350,0.6666666666666666,14,7,7,353.4686102186526,0.7702110004741584,0.20753794327525643,0.22625105314876737,134643.43112244885,1918.4452947845634,136561.8764172334,3419,2,545.3157894736842,34,4,23,31.364466238433895,0.6709558823529412,40.53571428571428,1037.8571428571418,30.52521008403358,0
4342,4,0,1,37,0.0,0.02631578947368421,0.9736842105263158,38,1500,1200,300,0.8,18,12,6,349.90943732625,0.7711000474158369,0.1989101968404159,0.2247356489219108,134767.01388888873,1831.2499999999795,136598.2638888887,3420,3,546.3157894736842,34,4,23,31.33360085607276,0.6721813725490197,40.41666666666666,1038.333333333332,30.539215686274467,0
4343,4,0,0,37,0.0,0.0,1.0,37,1350,1100,250,0.8148148148148148,16,11,5,349.2021671889761,0.7697697697697697,0.17760263702492063,0.22466369517379228,134828.82653061207,2016.503684807234,136845.3302154193,2189,4,469.64864864864865,34,3,15,31.29035801620052,0.6727941176470589,40.35714285714285,1038.571428571427,30.546218487394913,0
4344,4,0,0,37,0.0,0.0,1.0,37,1000,700,300,0.7,13,7,6,346.3697227556793,0.7697697697697697,0.17838424743962245,0.22061308067633492,134463.16882761125,1914.7941015339534,136377.9629291452,2190,5,470.64864864864865,36,1,18,31.72842019543973,0.6649305555555556,40.70945945945945,1037.1621621621612,28.81006006006003,1
4345,4,0,0,37,0.0,0.0,1.0,37,850,700,150,0.8235294117647058,10,7,3,345.1389840772923,0.7691441441441441,0.17574608911994938,0.22018146269529199,134521.57393880363,1885.7278731434053,136407.30181194702,2191,6,471.64864864864865,36,1,18,31.70208242871617,0.6655092592592593,40.65315315315315,1037.387387387387,28.816316316316303,0
4346,4,0,0,37,0.0,0.0,1.0,37,1350,1000,350,0.7407407407407407,17,10,7,347.54286403777155,0.7668293293293293,0.17534563670395054,0.2224423170468736,134640.85708429795,1958.6969879155736,136599.55407221353,2192,7,472.64864864864865,35,2,19,31.520784543325526,0.66875,40.53819444444445,1037.847222222223,29.652777777777803,0
4347,4,0,0,37,0.0,0.0,1.0,37,1100,900,200,0.8181818181818182,13,9,4,349.62350528096516,0.7665790790790791,0.17631903282477412,0.22414390413616725,134700.92438539542,2018.9218696416524,136719.8462550371,2193,8,473.64864864864865,35,2,19,31.406906195413818,0.669345238095238,40.48032407407408,1038.0787037037053,29.65939153439158,0
4348,4,0,0,37,0.0,0.0,1.0,37,750,600,150,0.8,9,6,3,347.2767397104284,0.7668293293293293,0.17214633288385972,0.22297294847703011,134755.32119957806,1959.4777209642177,136714.79892054226,2194,9,474.64864864864865,36,1,19,31.41359363702097,0.6678240740740741,40.42792792792793,1038.288288288289,28.841341341341362,0
4349,4,0,0,37,0.0,0.0,1.0,37,1050,800,250,0.7619047619047619,13,8,5,344.17620317124556,0.7655780780780781,0.17152567201347702,0.22187459638397936,134901.51627556633,1885.9783347537018,136787.49461032005,2195,10,475.64864864864865,36,1,18,31.348464317976525,0.6692708333333333,40.287162162162176,1038.8513513513533,28.856981981982035,0
4350,4,0,1,36,0.0,0.02702702702702703,0.972972972972973,37,850,500,350,0.5882352941176471,12,5,7,344.2903540223721,0.7649524524524525,0.16629222698367574,0.22230700465811287,134960.0164987626,1893.0863718448509,136853.10287060743,2196,11,476.64864864864865,36,1,18,31.287254795708265,0.6698495370370369,40.23085585585587,1039.0765765765789,28.863238238238303,0
4351,4,0,0,36,0.0,0.0,1.0,36,1550,1200,350,0.7741935483870968,19,12,7,351.9777695458007,0.7630621693121694,0.15426703287186538,0.2279100467405073,135061.60950628007,2307.7368130572777,137369.34631933735,2197,12,463.72222222222223,35,1,19,30.986364732954755,0.6729166666666666,40.133101851851855,1039.467592592593,29.699074074074087,0
4352,4,0,0,36,0.0,0.0,1.0,36,750,600,150,0.8,9,6,3,350.5113275485696,0.7617063492063493,0.154224794696745,0.22752845135089228,135151.85613854596,2274.45130315501,137426.30744170098,2198,13,464.72222222222223,35,1,19,30.93462451766103,0.6738095238095239,40.0462962962963,1039.814814814815,29.708994708994716,0
4353,4,0,0,36,0.0,0.0,1.0,36,650,400,250,0.6153846153846154,9,4,5,348.32245169385226,0.7615410052910053,0.15151206063078781,0.22667442964320422,135242.13291162977,2221.5742616169414,137463.70717324672,2199,14,465.72222222222223,35,1,19,30.90169596825043,0.6747023809523809,39.95949074074074,1040.162037037037,29.71891534391534,0
4354,4,0,0,36,0.0,0.0,1.0,36,400,300,100,0.75,5,3,2,348.74369201273794,0.762202380952381,0.15281949543268913,0.22732828480801323,135302.33417191796,2237.167111411187,137539.50128332915,2200,15,466.72222222222223,35,1,19,30.830853450513587,0.675297619047619,39.901620370370374,1040.3935185185192,29.72552910052912,0
4355,4,0,0,36,0.0,0.0,1.0,36,950,800,150,0.8421052631578947,11,8,3,370.84449055169415,0.7615740740740741,0.18248504297424017,0.2308539257211351,133621.76254125967,2710.578891246599,136332.34143250628,2201,16,467.72222222222223,35,1,19,31.936476174484135,0.6586309523809522,41.521990740740755,1033.912037037039,29.54034391534397,3
4356,4,1,1,36,0.02702702702702703,0.02702702702702703,0.972972972972973,37,900,600,300,0.6666666666666666,12,6,6,365.59560816875586,0.7681431431431431,0.17976854138734044,0.22954609496497316,133938.09349890446,2393.435749939146,136331.5292488436,2202,0,456.05405405405406,36,1,18,31.755194734551797,0.6597222222222221,41.216216216216225,1035.1351351351364,28.753753753753788,0
4357,4,0,0,36,0.0,0.0,1.0,36,1050,1000,50,0.9523809523809523,11,10,1,370.42271859088333,0.7601190476190477,0.18902120839390224,0.2324694998146153,133921.0943528163,2721.4831693672777,136642.57752218356,2203,18,469.72222222222223,35,1,18,31.64730795035223,0.6616071428571428,41.232638888888886,1035.0694444444441,29.57341269841269,0
4358,4,0,0,36,0.0,0.0,1.0,36,600,300,300,0.5,9,3,6,369.4224608856221,0.7598875661375661,0.18833233949513084,0.23203051194950863,133951.0459533607,2696.905006858708,136647.9509602194,2204,19,470.72222222222223,35,1,18,31.643187239117477,0.6619047619047619,41.2037037037037,1035.1851851851848,29.576719576719565,0
4359,4,0,0,36,0.0,0.0,1.0,36,850,600,250,0.7058823529411765,11,6,5,373.3515510678516,0.762367724867725,0.1869017022386119,0.2354561684641438,134100.8541907792,2813.352382330235,136914.20657310943,2205,20,471.72222222222223,35,1,18,31.391426416359362,0.6633928571428572,41.05902777777777,1035.763888888888,29.593253968253943,0
4360,4,0,0,36,0.0,0.0,1.0,36,1050,600,450,0.5714285714285714,15,6,9,380.4651397691975,0.7613756613756614,0.19394193188163023,0.2411228115097782,134280.734592014,3017.8276909722326,137298.5622829862,2206,21,472.72222222222223,35,1,19,31.02701005025126,0.6651785714285714,40.88541666666667,1036.4583333333342,29.613095238095262,0
4361,4,0,0,36,0.0,0.0,1.0,36,1100,700,400,0.6363636363636364,15,7,8,382.1059490157197,0.7601851851851852,0.19029591596284323,0.24295863713497762,134400.72183909902,3071.0630733453463,137471.78491244436,2207,22,473.72222222222223,35,1,19,30.86433102652826,0.6663690476190476,40.76967592592593,1036.921296296297,29.62632275132277,0
4362,4,0,0,36,0.0,0.0,1.0,36,1250,600,650,0.48,19,6,13,381.1228851147561,0.7584656084656085,0.19466755912539035,0.24333230357326757,134550.78125000012,3056.0763888889032,137606.85763888902,2208,23,474.72222222222223,35,1,19,30.739625167336,0.6678571428571427,40.62500000000001,1037.500000000001,29.642857142857167,0
4363,4,0,0,36,0.0,0.0,1.0,36,700,500,200,0.7142857142857143,9,5,4,385.71168458107826,0.7570436507936509,0.19970329901760375,0.24728006426073576,134700.9243853954,3191.144091863874,137892.06847725928,2209,24,475.72222222222223,35,1,19,30.470346935741627,0.669345238095238,40.48032407407408,1038.078703703705,29.659391534391574,0
4364,4,0,0,36,0.0,0.0,1.0,36,1250,900,350,0.72,16,9,7,387.09342248107157,0.756712962962963,0.19542909870075187,0.24857659936132379,134761.0050824117,3233.0197348679676,137994.02481727966,2210,25,476.72222222222223,35,1,20,30.374377624196473,0.6699404761904761,40.4224537037037,1038.3101851851852,29.66600529100529,0
4365,4,0,0,36,0.0,0.0,1.0,36,1150,900,250,0.782608695652174,14,9,5,385.55430593166943,0.7566798941798942,0.19381299061486268,0.24820404170952653,134851.15124528456,3198.48840449245,138049.639649777,2211,26,477.72222222222223,35,1,16,30.3241772528044,0.6708333333333334,40.335648148148145,1038.657407407407,29.675925925925913,0
4366,4,0,0,36,0.0,0.0,1.0,36,950,600,350,0.631578947368421,13,6,7,386.4851985157552,0.7568121693121693,0.19195688225538987,0.24963051167442063,134971.3930148318,3232.8891246570442,138204.28213948885,2212,27,478.72222222222223,35,1,16,30.17979134179847,0.6720238095238096,40.2199074074074,1039.120370370369,29.6891534391534,0
4367,4,0,0,36,0.0,0.0,1.0,36,1350,900,450,0.6666666666666666,18,9,9,388.4059441976194,0.7556878306878307,0.18984367270208757,0.25212709556874396,135151.85613854614,3298.75685871058,138450.6129972567,2213,28,479.72222222222223,35,1,17,29.949539922825767,0.6738095238095237,40.046296296296305,1039.8148148148161,29.708994708994748,0
4368,4,0,0,36,0.0,0.0,1.0,36,800,500,300,0.625,11,5,6,389.50665845215894,0.7558862433862434,0.1866916437915771,0.2532638808141174,135212.0373049555,3333.1977666323837,138545.2350715879,2214,29,480.72222222222223,35,1,17,29.860801988278066,0.6744047619047618,39.98842592592593,1040.046296296297,29.715608465608486,0
4369,4,0,0,36,0.0,0.0,1.0,36,500,200,300,0.4,8,2,6,389.4832166596217,0.7543320105820106,0.18374618360712458,0.25388430997486183,135302.33417191808,3339.597666966757,138641.93183888483,2215,30,481.72222222222223,35,1,17,29.771225015760002,0.675297619047619,39.90162037037038,1040.39351851852,29.725529100529144,0
4370,4,0,0,36,0.0,0.0,1.0,36,550,400,150,0.7272727272727273,7,4,3,389.3501740284903,0.7548280423280423,0.18484118155975793,0.25401001919565525,135332.43982553162,3338.3417995541954,138670.7816250858,2216,31,482.72222222222223,35,1,18,29.744623655913973,0.675595238095238,39.87268518518519,1040.50925925926,29.728835978836003,0
4371,4,0,0,36,0.0,0.0,1.0,36,1200,900,300,0.75,15,9,6,388.72701881307574,0.7547949735449736,0.1814357719961457,0.25445493502218364,135452.89592978402,3330.840084876556,138783.73601466056,2217,32,483.72222222222223,35,1,18,29.640593729152776,0.6767857142857142,39.75694444444445,1040.9722222222229,29.74206349206351,0
4372,4,0,0,36,0.0,0.0,1.0,36,1600,1300,300,0.8125,19,13,6,389.1249289387447,0.7535052910052911,0.18649735096884146,0.2553579128856227,135543.27317226087,3348.6533082561814,138891.92648051705,2218,33,484.72222222222223,35,1,18,29.540055018339448,0.6776785714285714,39.67013888888889,1041.319444444445,29.751984126984144,0
4373,4,0,0,36,0.0,0.0,1.0,36,900,800,100,0.8888888888888888,10,8,2,388.2787219861311,0.7540674603174604,0.1887024276999829,0.2550169299584823,135573.4056177126,3328.0537337105598,138901.45935142314,2219,34,485.72222222222223,35,1,18,29.532025635326374,0.6779761904761905,39.6412037037037,1041.435185185185,29.755291005291,0
4374,4,0,0,36,0.0,0.0,1.0,36,550,300,250,0.5454545454545454,8,3,5,389.664241563999,0.7535052910052911,0.18957353286167633,0.25614233088637156,135603.5414121442,3367.9702235510986,138971.5116356953,2220,35,486.72222222222223,35,1,18,29.465889728488357,0.6782738095238094,39.61226851851852,1041.5509259259259,29.758597883597883,0
4375,4,0,0,36,0.0,0.0,1.0,36,1200,800,400,0.6666666666666666,16,8,8,388.2465310120654,0.7514219576719577,0.18358775543170958,0.25636694935788706,135765.2360090807,3342.0864294512858,139107.32243853196,2221,36,487.72222222222223,32,4,18,29.34158185930054,0.6868489583333334,39.457070707070706,1042.171717171717,32.56786616161616,0
4376,4,0,0,36,0.0,0.0,1.0,36,650,300,350,0.46153846153846156,10,3,7,387.2712023391022,0.7500992063492063,0.17982881136950946,0.25619479539356,135831.0376492195,3320.6898530762255,139151.72750229572,2222,37,488.72222222222223,32,4,18,29.30141715116279,0.6875,39.3939393939394,1042.4242424242427,32.575757575757585,0
4377,4,0,1,35,0.0,0.027777777777777776,0.9722222222222222,36,550,400,150,0.7272727272727273,7,4,3,387.2712023391022,0.7500992063492063,0.17982881136950946,0.25619479539356,135831.0376492195,3320.6898530762255,139151.72750229572,2223,38,489.72222222222223,32,4,18,29.30141715116279,0.6875,39.3939393939394,1042.4242424242427,32.575757575757585,0
4378,4,0,1,34,0.0,0.02857142857142857,0.9714285714285714,35,750,400,350,0.5333333333333333,11,4,7,387.08837209466066,0.7474089635854341,0.1554421356770881,0.25631023964599947,135863.944447633,3518.2706165187374,139382.21506415174,2224,39,480.4,32,3,17,29.273394291712094,0.6878255208333333,39.362373737373744,1042.5505050505058,32.579703282828305,0
4379,4,0,0,34,0.0,0.0,1.0,34,1050,900,150,0.8571428571428571,12,9,3,395.19714032016213,0.7470291146761735,0.1542546545045611,0.26073888820958435,135735.42488945858,3928.450351291238,139663.87524074983,2225,40,489.79411764705884,31,3,19,29.190225540422343,0.6891801075268817,39.485677083333336,1042.0572916666667,33.614751344086024,0
4380,4,0,0,34,0.0,0.0,1.0,34,650,400,250,0.6153846153846154,9,4,5,395.9214795400901,0.7464720736779561,0.152967633830144,0.2614649770824159,135769.34814453125,3950.800238715278,139720.14838324653,2226,41,490.79411764705884,31,3,19,29.137514576045316,0.689516129032258,39.453125,1042.1875,33.618951612903224,0
4381,4,0,0,34,0.0,0.0,1.0,34,750,500,250,0.6666666666666666,10,5,5,396.7960111816255,0.7442439096850862,0.15934065934065922,0.263041594167422,135905.08355034728,3985.319010416676,139890.40256076396,2227,42,491.79411764705884,31,3,17,28.979353979353974,0.6908602150537634,39.32291666666667,1042.708333333334,33.63575268817206,0
4382,4,0,0,34,0.0,0.0,1.0,34,950,600,350,0.631578947368421,13,6,7,394.461591301194,0.7422385620915033,0.1525041284664883,0.262889563751054,136094.4036322825,3936.8030047954385,140031.20663707796,2228,43,492.79411764705884,32,2,17,28.851544853178453,0.6901041666666666,39.141414141414145,1043.434343434344,32.60732323232325,0
4383,4,0,0,34,0.0,0.0,1.0,34,550,400,150,0.7272727272727273,7,4,3,393.87880804081664,0.7417557932263815,0.15173481370769726,0.26274482231294183,136127.34231519746,3923.535066574839,140050.8773817723,2229,44,493.79411764705884,32,2,17,28.833938294010878,0.6904296875,39.109848484848484,1043.5606060606062,32.611268939393945,0
4384,4,0,1,33,0.0,0.029411764705882353,0.9705882352941176,34,800,500,300,0.625,11,5,6,393.3215739734151,0.7399732620320856,0.15371889653405835,0.26286090962313874,136193.2316377157,3913.547246454469,140106.77888417017,2230,45,494.79411764705884,32,2,19,28.782861578162183,0.6910807291666666,39.046717171717184,1043.8131313131328,32.6191603535354,0
4385,4,0,0,33,0.0,0.0,1.0,33,1100,900,200,0.8181818181818182,13,9,4,399.84803461356387,0.7354008838383839,0.1492550851493235,0.26761114703936184,136244.71876356337,4295.4366048177135,140540.1553683811,2231,46,492.0,31,2,19,28.561258002826968,0.6942204301075268,38.997395833333336,1044.0104166666667,33.67775537634409,0
4386,4,0,0,33,0.0,0.0,1.0,33,900,600,300,0.6666666666666666,12,6,6,401.2885492005645,0.735479797979798,0.14838660923448943,0.26909148533348903,136312.6966688369,4340.144856770843,140652.84152560774,2232,47,493.0,31,2,19,28.45594347464671,0.6948924731182795,38.93229166666667,1044.2708333333342,33.686155913978524,0
4387,4,0,0,33,0.0,0.0,1.0,33,800,500,300,0.625,11,5,6,392.79229450121574,0.7359532828282829,0.12672510428726325,0.2572337147071105,135469.32591380965,4042.261472043646,139511.5873858533,2233,48,494.0,32,1,19,29.518394986860734,0.6839192708333334,39.741161616161605,1041.0353535353522,32.53235479797976,2
4388,4,0,0,33,0.0,0.0,1.0,33,950,800,150,0.8421052631578947,11,8,3,391.99280243578124,0.7346906565656566,0.12670172073591512,0.25718095797039664,135535.05581381993,4025.7532713498504,139560.80908516978,2234,49,495.0,32,1,19,29.473596459318543,0.6845703125,39.6780303030303,1041.287878787878,32.54024621212119,0
4389,4,0,0,33,0.0,0.0,1.0,33,650,400,250,0.6153846153846154,9,4,5,391.57833636417513,0.7350852272727273,0.12390147841166255,0.25714475464424486,135567.92674216902,4017.0926436077734,139585.0193857768,2235,50,496.0,32,1,20,29.451584222437756,0.6848958333333334,39.646464646464636,1041.4141414141404,32.54419191919189,0
4390,4,0,0,33,0.0,0.0,1.0,33,500,300,200,0.6,7,3,4,370.1777745821865,0.7350852272727273,0.09856826152397469,0.2275062503334433,133146.24304917885,3257.5559891848047,136403.79903836365,2236,51,497.0,32,1,18,32.431082293450785,0.6608072916666665,41.982323232323246,1032.0707070707087,32.25220959595965,6
4391,4,0,0,33,0.0,0.0,1.0,33,650,300,350,0.46153846153846156,10,3,7,376.0362547971797,0.7365056818181819,0.05369628319640629,0.2209961260103251,131457.57607642072,3286.5629144985132,134744.13899091922,2237,52,498.0,32,1,21,33.98306041204957,0.6438802083333334,43.62373737373737,1025.5050505050501,32.047032828282816,6
4392,4,0,0,33,0.0,0.0,1.0,33,800,300,500,0.375,13,3,10,377.0981107457741,0.7379261363636365,0.049013025379347486,0.22199601823903412,131522.3255280074,3319.364095500463,134841.68962350787,2238,53,499.0,32,1,21,33.890324963072366,0.64453125,43.56060606060606,1025.7575757575762,32.054924242424256,0
4393,4,0,1,32,0.0,0.030303030303030304,0.9696969696969697,33,600,300,300,0.5,9,3,6,378.44752434415165,0.7376104797979799,0.049746791070935936,0.22316869251237853,131587.09092184468,3359.7617590041837,134946.85268084885,2239,54,500.0,32,1,18,33.79020018049062,0.6451822916666667,43.49747474747475,1026.010101010101,32.062815656565654,0
4394,4,0,0,32,0.0,0.0,1.0,32,1150,800,350,0.6956521739130435,15,8,7,379.1996288658793,0.7334929435483871,0.06474828701941382,0.2238556011304863,131628.58963012684,3582.702467176635,135211.29209730346,2240,55,511.1875,31,1,18,33.72893139618491,0.6481854838709677,43.45703124999999,1026.171874999999,33.10231854838707,0
4395,4,0,0,32,0.0,0.0,1.0,32,600,400,200,0.6666666666666666,8,4,4,380.1051877409311,0.7326948924731184,0.06472704793304618,0.2253766549266903,131795.66277397994,3619.2430284288093,135414.90580240876,2241,56,512.1875,31,1,19,33.5367528954265,0.6498655913978495,43.29427083333333,1026.8229166666658,33.12331989247309,0
4396,4,1,0,33,0.030303030303030304,0.0,1.0,33,1000,800,200,0.8,12,8,4,366.6834045144186,0.7429766414141414,0.06124605584330589,0.21957865046804598,132170.69686766656,3092.9602208958368,135263.65708856238,2242,0,497.6363636363636,32,1,20,33.50293672233139,0.6510416666666666,42.929292929292934,1028.2828282828284,32.13383838383839,0
4397,4,0,0,33,0.0,0.0,1.0,33,950,600,350,0.631578947368421,13,6,7,366.41921035793615,0.7405303030303031,0.06809444134597542,0.22055513769698518,132365.5191434548,3100.253800632602,135465.7729440874,2243,1,498.6363636363636,32,1,20,33.31339468302661,0.6529947916666666,42.739898989899,1029.0404040404044,32.15751262626264,0
4398,4,0,0,33,0.0,0.0,1.0,33,950,700,250,0.7368421052631579,12,7,5,371.35350609173105,0.7385574494949495,0.07689449670813109,0.22468540027330555,132560.48489950006,3245.360167329867,135805.84506682993,2244,2,499.6363636363636,32,1,21,32.990027791401,0.6549479166666666,42.55050505050505,1029.7979797979801,32.18118686868688,0
4399,4,0,0,33,0.0,0.0,1.0,33,900,800,100,0.8888888888888888,10,8,2,367.77951989619385,0.7391887626262627,0.07417557932263819,0.22329470850840338,132690.54178145083,3160.172750229564,135850.7145316804,2245,3,500.6363636363636,32,1,17,32.95113357843137,0.65625,42.42424242424242,1030.30303030303,32.19696969696969,0
4400,4,0,0,33,0.0,0.0,1.0,33,850,600,250,0.7058823529411765,11,6,5,377.1091923909076,0.7405303030303031,0.06078570065231781,0.21701870154862707,130649.55305899923,3314.127066115719,133963.68012511494,2246,4,501.6363636363636,32,1,15,34.774453501296776,0.6357421875,44.412878787878796,1022.3484848484861,31.94839015151519,6
4401,4,0,1,32,0.0,0.030303030303030304,0.9696969696969697,33,850,500,350,0.5882352941176471,12,5,7,373.04740064103964,0.7406881313131314,0.010169095869625222,0.2088462132429755,129575.4337274125,3067.555747789304,132642.98947520182,2247,5,502.6363636363636,33,0,14,35.97034986358529,0.6224747474747474,45.4656862745098,1018.1372549019605,30.8526440879382,4
4402,4,2,0,34,0.058823529411764705,0.0,1.0,34,750,500,250,0.6666666666666666,10,5,5,360.678163671639,0.747140522875817,0.029192094622888076,0.20454342716758933,130080.35891439911,2583.42899659864,132663.78791099775,2248,0,488.6470588235294,34,0,16,35.771871474695615,0.6253063725490196,44.970238095238095,1020.1190476190478,30.00350140056023,0
4403,4,1,0,35,0.02857142857142857,0.0,1.0,35,1200,900,300,0.75,15,9,6,358.6899852752071,0.7533613445378151,0.05278309343539411,0.20597682432024444,130566.58340419515,2366.712726757388,132933.29613095254,2249,0,475.65714285714284,34,1,16,35.32930498932246,0.6302083333333333,44.49404761904763,1022.0238095238105,30.05952380952384,0
4404,4,1,1,35,0.027777777777777776,0.027777777777777776,0.9722222222222222,36,850,700,150,0.8235294117647058,10,7,3,349.9992691689597,0.764484126984127,0.06082965810999319,0.20295367457449898,130942.84664619768,1965.980125814467,132908.82677201214,2250,0,463.4166666666667,35,1,17,35.17059161672132,0.6318452380952382,44.126157407407405,1023.4953703703701,29.24272486772486,0
4405,4,1,0,36,0.027777777777777776,0.0,1.0,36,1150,900,250,0.782608695652174,14,9,5,350.0918162093281,0.7605158730158731,0.06807737220778276,0.20394749714524973,131120.59709630057,1980.8495959790837,133101.44669227966,2251,0,464.3333333333333,35,1,18,34.98853448600596,0.6336309523809524,43.9525462962963,1024.1898148148148,29.262566137566136,0
4406,4,0,0,36,0.0,0.0,1.0,36,900,700,200,0.7777777777777778,11,7,4,350.01038312612343,0.7594246031746033,0.06977707486067208,0.2043728173768104,131209.51753257884,1984.9387002743485,133194.4562328532,2252,1,465.3333333333333,35,1,18,34.90077571923484,0.6345238095238095,43.86574074074074,1024.537037037037,29.27248677248677,0
4407,4,0,0,36,0.0,0.0,1.0,36,700,500,200,0.7142857142857143,9,5,4,350.12661949809876,0.7587962962962963,0.06402657032102699,0.20523305551917007,131357.7852393047,1998.3714581190031,133356.15669742372,2253,2,466.3333333333333,35,1,18,34.7480570923187,0.6360119047619047,43.72106481481482,1025.1157407407409,29.289021164021168,0
4408,4,1,1,36,0.02702702702702703,0.02702702702702703,0.972972972972973,37,800,500,300,0.625,11,5,6,341.56029826700694,0.7683308308308309,0.06020047047376642,0.20142109239551476,131587.96623904322,1589.0449993912978,133177.01123843453,2254,0,454.7027027027027,36,1,13,34.73548457908023,0.6362847222222221,43.49662162162163,1026.0135135135145,28.500375375375402,0
4409,4,0,0,36,0.0,0.0,1.0,36,900,400,500,0.4444444444444444,14,4,10,350.2476861124692,0.7593915343915344,0.05952112252191255,0.20594192081238172,131476.45968632132,2009.8651566786884,133486.324843,2255,4,468.3333333333333,35,1,19,34.62515987661287,0.6372023809523808,43.60532407407408,1025.578703703705,29.302248677248716,0
4410,4,0,0,36,0.0,0.0,1.0,36,1100,900,200,0.8181818181818182,13,9,4,349.7566075614726,0.7597883597883598,0.061106096506074126,0.20597294437324454,131535.81700370798,2001.1042256087085,133536.92122931668,2256,5,469.3333333333333,35,1,19,34.5778564443943,0.637797619047619,43.5474537037037,1025.810185185185,29.30886243386243,0
4411,4,0,0,36,0.0,0.0,1.0,36,800,600,200,0.75,10,6,4,347.06851636239435,0.7590277777777779,0.05202806938330129,0.20375612898969198,131417.11576485337,1956.3116212277055,133373.42738608108,2257,6,470.3333333333333,35,1,18,34.76655096512021,0.6366071428571429,43.66319444444444,1025.3472222222222,29.29563492063492,3
4412,4,1,2,35,0.02702702702702703,0.05405405405405406,0.9459459459459459,37,750,500,250,0.6666666666666666,10,5,5,339.15118359390914,0.7653903903903904,0.04526945468457577,0.20030361218997403,131645.74361100985,1529.561952154875,133175.30556316473,2258,0,458.5945945945946,36,1,13,34.7390632429862,0.6368634259259258,43.440315315315324,1026.2387387387403,28.506631631631674,0
4413,4,0,0,35,0.0,0.0,1.0,35,1050,500,550,0.47619047619047616,16,5,11,355.4930718180653,0.7502100840336134,0.05302331752296885,0.20888249117604496,131450.17715419523,2345.925453514765,133796.10260771,2259,8,485.51428571428573,34,1,20,34.51721035523567,0.6390931372549018,43.630952380952394,1025.4761904761924,30.161064425770366,0
4414,4,0,0,35,0.0,0.0,1.0,35,1250,900,350,0.72,16,9,7,352.9071003220163,0.7492997198879552,0.05452611904224813,0.2083138716015312,131624.87809713653,2290.270811899872,133915.14890903642,2260,9,486.51428571428573,35,0,15,34.4071922700955,0.6386904761904761,43.46064814814815,1026.1574074074078,29.31878306878308,0
4415,4,0,0,35,0.0,0.0,1.0,35,550,400,150,0.7272727272727273,7,4,3,354.66318576354706,0.7487394957983192,0.05658882267675991,0.21000416940738725,131743.6731074245,2344.9261616940958,134088.5992691186,2261,10,487.51428571428573,35,0,15,34.242296129274706,0.6398809523809523,43.344907407407405,1026.6203703703698,29.332010582010565,0
4416,4,1,0,36,0.027777777777777776,0.0,1.0,36,750,600,150,0.8,9,6,3,343.67416948011015,0.7561838624338625,0.052137735412634,0.20514808010758448,132050.54029959018,1876.4719533722978,133927.01225296248,2262,0,474.94444444444446,36,0,16,34.215331799422955,0.6409143518518519,43.046171171171174,1027.8153153153157,28.550425425425438,0
4417,4,0,1,35,0.0,0.027777777777777776,0.9722222222222222,36,800,400,400,0.5,12,4,8,342.6602066548322,0.755357142857143,0.050893465770766255,0.20469910774511207,132079.4781267756,1851.676253956676,133931.15438073227,2263,1,475.94444444444446,36,0,16,34.21226811276658,0.6412037037037037,43.018018018018026,1027.9279279279292,28.553553553553588,0
4418,4,1,0,36,0.027777777777777776,0.0,1.0,36,1050,700,350,0.6666666666666666,14,7,7,333.8851644839285,0.7627314814814815,0.06196581196581219,0.20114545275007414,132398.0034722223,1641.1458333333385,134039.14930555565,2264,0,471.6666666666667,36,0,18,34.11774628879891,0.6443865740740742,42.708333333333336,1029.1666666666672,28.587962962962976,0
4419,4,1,0,37,0.02702702702702703,0.0,1.0,37,800,600,200,0.75,10,6,4,325.689641059513,0.7701451451451451,0.06077988579319071,0.19753739042957547,132652.03145438977,1240.678502039084,133892.70995642885,2265,0,459.8918918918919,37,0,13,34.073864644314355,0.6449887387387387,42.46162280701754,1030.1535087719294,27.84198672356566,0
4420,4,1,1,37,0.02631578947368421,0.02631578947368421,0.9736842105263158,38,700,500,200,0.7142857142857143,9,5,4,317.50976753064043,0.7756934566145093,0.061134525945029106,0.1941052429368759,132948.34270445243,842.4794771349166,133790.82218158734,2266,0,448.7631578947368,38,0,13,33.9879225801996,0.6461074561403508,42.174145299145295,1031.3034188034183,27.139563652721534,0
4421,4,0,0,37,0.0,0.0,1.0,37,650,400,250,0.6153846153846154,9,4,5,327.1235853327298,0.7697072072072072,0.0592179413456011,0.19915555065593643,132793.26331178815,1287.961680517072,134081.22499230521,2267,2,461.8918918918919,37,0,13,33.895390070922,0.6463963963963963,42.32456140350877,1030.7017543859643,27.856804172593627,0
4422,4,0,0,37,0.0,0.0,1.0,37,800,200,600,0.25,14,2,12,330.2995772918899,0.7688938938938938,0.052606485337622244,0.20261532088113965,133075.95245652494,1390.9861688211563,134466.9386253461,2268,3,462.8918918918919,37,0,15,33.53037548707049,0.6492117117117118,42.05043859649122,1031.798245614034,27.886439070649566,0
4423,4,0,1,36,0.0,0.02702702702702703,0.972972972972973,37,900,600,300,0.6666666666666666,12,6,6,330.7194011631614,0.767454954954955,0.05368079223385713,0.20333518766484887,133160.8178117304,1407.7731850184537,134568.59099674886,2269,4,463.8918918918919,37,0,15,33.43458957470167,0.6500563063063063,41.96820175438596,1032.1271929824552,27.895329540066356,0
4424,4,1,0,37,0.02702702702702703,0.0,1.0,37,500,400,100,0.8,6,4,2,330.73298161582517,0.7723348348348348,0.056729769922886586,0.20349805810009008,133189.11227493064,1410.0064442905389,134599.11871922118,2270,0,464.6756756756757,37,0,16,33.40592026060476,0.6503378378378379,41.940789473684205,1032.2368421052624,27.898293029871958,0
4425,4,1,1,37,0.02631578947368421,0.02631578947368421,0.9736842105263158,38,600,500,100,0.8333333333333334,7,5,2,321.62146618367416,0.782450213371266,0.0461635165361447,0.1992569634505002,133444.6239339065,983.7311207903848,134428.35505469688,2271,0,453.42105263157896,38,0,16,33.38568055699169,0.6510416666666667,41.693376068376054,1033.2264957264933,27.190170940170876,0
4426,4,0,0,37,0.0,0.0,1.0,37,1250,800,450,0.64,17,8,9,330.13405830998084,0.7737112112112112,0.04337862217518351,0.2045268396748817,133443.89770169675,1410.8751009926198,134854.77280268937,2272,2,466.6756756756757,37,0,18,33.16652074710814,0.6528716216216215,41.694078947368425,1033.223684210527,27.92496443812235,0
4427,4,0,0,37,0.0,0.0,1.0,37,1150,900,250,0.782608695652174,14,9,5,328.25812140257176,0.7728978978978979,0.042261797272933554,0.2043000545679768,133613.88991083793,1371.9688990843383,134985.85880992227,2273,3,467.6756756756757,37,0,18,33.04510464170821,0.6545608108108107,41.5296052631579,1033.8815789473683,27.9427453769559,0
4428,4,0,0,37,0.0,0.0,1.0,37,600,500,100,0.8333333333333334,7,5,2,328.8266317324456,0.7715840840840841,0.044643880521743506,0.2051251845569063,133698.92659279774,1392.7535395506268,135091.68013234835,2274,4,468.6756756756757,37,0,19,32.94546932428613,0.6554054054054055,41.44736842105263,1034.210526315789,27.951635846372675,0
4429,4,0,0,37,0.0,0.0,1.0,37,1250,1100,150,0.88,14,11,3,327.9757926636824,0.7709584584584585,0.04374958830824016,0.20538205410531984,133840.7145107148,1379.302886465059,135220.01739717988,2275,5,469.6756756756757,37,0,15,32.82591130655928,0.6568130630630631,41.310307017543856,1034.7587719298242,27.966453295400655,0
4430,4,0,0,37,0.0,0.0,1.0,37,950,700,250,0.7368421052631579,12,7,5,326.92632821646055,0.7704579579579579,0.037864753194766676,0.20504037289270244,133897.4507180094,1354.9203841566598,135252.37110216607,2276,6,470.6756756756757,37,0,15,32.79644294946497,0.6573761261261262,41.25548245614035,1034.9780701754387,27.972380275011858,0
4431,4,0,0,37,0.0,0.0,1.0,37,500,300,200,0.6,7,3,4,326.3887891410514,0.7701451451451451,0.036120018323408054,0.20486104850342576,133925.82333025534,1342.3774622960746,135268.20079255142,2277,7,471.6756756756757,37,0,15,32.78204449152543,0.6576576576576577,41.22807017543859,1035.0877192982446,27.97534376481742,0
4432,4,0,1,36,0.0,0.02702702702702703,0.972972972972973,37,700,500,200,0.7142857142857143,9,5,4,333.9240807127238,0.7701451451451451,0.003925360757296215,0.20624465024479655,133330.6296769198,1504.4615891428134,134835.09126606263,2278,8,472.6756756756757,37,0,17,33.18193279541353,0.6517454954954955,41.80372807017544,1032.7850877192982,27.913110478899952,3
4433,4,0,0,36,0.0,0.0,1.0,36,900,400,500,0.4444444444444444,14,4,10,340.43957288100313,0.758994708994709,0.005157950881276463,0.2094274580555219,133181.4648263129,1868.0482002272706,135049.51302654017,2279,14,486.5833333333333,36,0,17,33.163093679540346,0.6521990740740741,41.948198198198206,1032.207207207208,28.672422422422446,0
4434,4,0,0,36,0.0,0.0,1.0,36,800,500,300,0.625,11,5,6,340.5749843872221,0.7590939153439153,0.006165097369154493,0.2100021541255171,133268.65875588427,1877.5942750182635,135146.25303090253,2280,15,487.5833333333333,36,0,17,33.07226342385575,0.6530671296296295,41.86373873873874,1032.545045045045,28.681806806806808,0
4435,4,0,0,36,0.0,0.0,1.0,36,650,300,350,0.46153846153846156,10,3,7,339.65244152123785,0.7583333333333334,0.011429713621165405,0.20992534997525567,133355.88121905693,1858.9301294537786,135214.8113485107,2281,16,488.5833333333333,36,0,17,33.00874945486261,0.6539351851851851,41.77927927927928,1032.8828828828832,28.6911911911912,0
4436,4,0,0,36,0.0,0.0,1.0,36,1200,900,300,0.75,15,9,6,341.11602497398553,0.7573412698412699,0.013664874551970962,0.21149193548387085,133472.22222222207,1905.9027777777583,135378.12499999983,2282,17,489.5833333333333,36,0,17,32.85450268817204,0.6550925925925927,41.66666666666666,1033.3333333333321,28.70370370370367,0
4437,4,0,0,36,0.0,0.0,1.0,36,950,700,250,0.7368421052631579,12,7,5,342.7111874629374,0.7546296296296297,0.01723783247416444,0.21348535436124047,133646.8288389738,1960.452682412108,135607.2815213859,2283,18,490.5833333333333,36,0,17,32.63858636462644,0.6568287037037039,41.49774774774773,1034.0090090090066,28.722472472472404,0
4438,4,0,0,36,0.0,0.0,1.0,36,1100,800,300,0.7272727272727273,14,8,6,348.43924599965214,0.7530753968253969,0.017787816116976884,0.2179109157929749,133792.42153893746,2123.7060962989867,135916.12763523645,2284,19,491.5833333333333,36,0,15,32.344844163854724,0.658275462962963,41.356981981981974,1034.572072072071,28.738113113113084,0
4439,4,0,1,35,0.0,0.027777777777777776,0.9722222222222222,36,900,600,300,0.6666666666666666,12,6,6,344.2432852932988,0.7543320105820106,0.014645805383323607,0.21631090373898104,133967.23740209788,2023.4643849930853,135990.70178709095,2285,20,492.5833333333333,36,0,15,32.27863591863374,0.6600115740740742,41.188063063063055,1035.2477477477464,28.756881881881846,0
4440,4,0,0,35,0.0,0.0,1.0,35,1100,700,400,0.6363636363636364,15,7,8,351.949465028486,0.7484593837535013,0.01633200747591923,0.22087607478945598,133921.09435281626,2426.6915027006107,136347.78585551688,2286,21,506.6857142857143,35,0,16,32.12533545790003,0.6616071428571428,41.232638888888886,1035.069444444444,29.57341269841268,0
4441,4,0,0,35,0.0,0.0,1.0,35,900,500,400,0.5555555555555556,13,5,8,351.949465028486,0.7484593837535013,0.01633200747591923,0.22087607478945598,133921.09435281626,2426.6915027006107,136347.78585551688,2287,22,507.6857142857143,35,0,16,32.12533545790003,0.6616071428571428,41.232638888888886,1035.069444444444,29.57341269841268,0
4442,4,0,0,35,0.0,0.0,1.0,35,1100,700,400,0.6363636363636364,15,7,8,351.4739363580038,0.7465686274509803,0.01356560060036105,0.22129748828958912,134040.92084887266,2422.3780167609816,136463.29886563364,2288,23,508.6857142857143,35,0,17,32.01783186170411,0.662797619047619,41.11689814814815,1035.5324074074078,29.586640211640223,0
4443,4,0,0,35,0.0,0.0,1.0,35,1050,800,250,0.7619047619047619,13,8,5,353.11593110973104,0.747829131652661,0.011261311585297973,0.22305862380827102,134160.80092860505,2474.863227666318,136635.66415627138,2289,24,509.6857142857143,35,0,17,31.855495661564817,0.6639880952380952,41.001157407407405,1035.9953703703698,29.599867724867707,0
4444,4,0,0,35,0.0,0.0,1.0,35,1200,900,300,0.75,15,9,6,349.947667331389,0.7483193277310923,0.006661136987175631,0.2219639736982946,134310.7263803155,2400.3450788751697,136711.07145919066,2290,25,510.6857142857143,35,0,18,31.787814500521062,0.6654761904761904,40.85648148148148,1036.574074074074,29.61640211640211,0
4445,4,0,0,35,0.0,0.0,1.0,35,850,700,150,0.8235294117647058,10,7,3,350.60985331632605,0.7485994397759103,0.013545918367346532,0.22311536120129868,134430.7270233198,2426.547496570658,136857.27451989046,2291,26,511.6857142857143,35,0,19,31.65085565476189,0.6666666666666665,40.74074074074075,1037.0370370370385,29.629629629629672,0
4446,4,0,0,35,0.0,0.0,1.0,35,1200,900,300,0.75,15,9,6,351.3315536024985,0.7468487394957982,0.014688959372658683,0.22412702597431988,134520.76266986024,2452.2777081189943,136973.04037797923,2292,27,512.6857142857143,35,0,19,31.54228959797687,0.6675595238095238,40.65393518518518,1037.3842592592591,29.639550264550262,0
4447,4,1,1,35,0.027777777777777776,0.027777777777777776,0.9722222222222222,36,750,500,250,0.6666666666666666,10,5,5,344.01096971959,0.7530423280423281,0.017023292098517828,0.22127673342608475,134821.09917534728,2075.990762174216,136897.0899375215,2293,0,499.4166666666667,35,1,14,31.43284018722835,0.6705357142857142,40.364583333333336,1038.541666666667,29.672619047619055,0
4448,4,0,0,35,0.0,0.0,1.0,35,900,600,300,0.6666666666666666,12,6,6,352.79058746796125,0.745658263305322,-0.019735569171235534,0.20727616743807284,131446.78605109747,2274.637774348423,133721.4238254459,2294,29,514.6857142857143,35,0,17,34.58991723100074,0.6369047619047619,43.63425925925926,1025.4629629629635,29.298941798941815,8
4449,4,1,0,36,0.027777777777777776,0.0,1.0,36,1100,800,300,0.7272727272727273,14,8,6,349.05267751904114,0.7557870370370371,-0.019502638538505312,0.20677798966478877,131761.33639974432,1998.3294527635724,133759.6658525079,2295,0,501.3611111111111,36,0,16,34.368487441044195,0.6380208333333334,43.3277027027027,1026.6891891891892,28.519144144144143,0
4450,4,0,0,36,0.0,0.0,1.0,36,700,400,300,0.5714285714285714,10,4,6,350.48479450608585,0.7555886243386244,-0.015666313314081748,0.20794214971379302,131819.1518165125,2040.121667275387,133859.27348378787,2296,1,502.3611111111111,36,0,17,34.27344920861205,0.6385995370370371,43.2713963963964,1026.9144144144148,28.52540040040041,0
4451,4,0,0,36,0.0,0.0,1.0,36,700,200,500,0.2857142857142857,12,2,10,352.9129855095972,0.7521825396825398,-0.008786351015636296,0.21018133680088558,131963.7458404351,2114.3439047155343,134078.08974515062,2297,2,503.3611111111111,36,0,17,34.06537702761946,0.6400462962962963,43.130630630630634,1027.477477477478,28.541041041041055,0
4452,4,0,0,36,0.0,0.0,1.0,36,700,400,300,0.5714285714285714,10,4,6,356.82149252151737,0.7513558201058201,-0.005067382491509065,0.2129960603168013,132050.5402995902,2223.69417559452,134274.23447518473,2298,3,504.3611111111111,36,0,17,33.877506299989044,0.6409143518518519,43.046171171171174,1027.815315315316,28.550425425425445,0
4453,4,0,0,36,0.0,0.0,1.0,36,1250,900,350,0.72,16,9,7,358.38230575118587,0.748015873015873,0.0029255772084761933,0.21507647705199312,132253.17166829004,2279.4393210778508,134532.61098936788,2299,4,505.3611111111111,36,0,18,33.63326582001313,0.6429398148148147,42.84909909909911,1028.6036036036048,28.572322322322357,0
4454,4,1,0,37,0.02702702702702703,0.0,1.0,37,800,500,300,0.625,11,5,6,376.4110856444293,0.7571321321321322,-0.05287855596030944,0.21855225695181968,130992.77388038556,2535.800862224616,133528.5747426102,2300,0,492.6756756756757,34,3,18,34.44416986471295,0.6344975490196079,44.077380952380956,1023.6904761904768,30.108543417366967,6
4455,4,1,1,37,0.02631578947368421,0.02631578947368421,0.9736842105263158,38,850,600,250,0.7058823529411765,11,6,5,367.0513105678072,0.7701517306780464,-0.05110667213611775,0.21448879554170255,131239.1643759644,2034.3014564043108,133273.4658323687,2301,0,480.6842105263158,35,3,18,34.43430193154862,0.6348214285714285,43.83680555555555,1024.652777777777,29.275793650793627,0
4456,4,0,0,37,0.0,0.0,1.0,37,1500,1300,200,0.8666666666666667,17,13,4,378.4909919402195,0.7566316316316316,-0.04659680601103189,0.22063255383832323,131145.15306122453,2527.4518140589626,133672.6048752835,2302,2,494.6756756756757,34,3,18,34.23649852781652,0.6360294117647058,43.92857142857143,1024.2857142857147,30.126050420168077,0
4457,4,1,1,37,0.02631578947368421,0.02631578947368421,0.9736842105263158,38,1200,800,400,0.6666666666666666,16,8,8,372.04996037247884,0.7644025604551921,-0.05538928556158873,0.21913564651603898,131541.75347222216,2188.1483843537367,133729.9018565759,2303,0,482.63157894736844,34,4,19,34.00013539128081,0.6400122549019608,43.541666666666664,1025.833333333333,30.17156862745097,0
4458,4,2,2,37,0.05128205128205128,0.05128205128205128,0.9487179487179487,39,900,500,400,0.5555555555555556,13,5,8,361.9049322658046,0.7766531713900136,-0.053709740815240936,0.21462704271806268,131803.0907064472,1740.0377229080955,133543.1284293553,2304,0,471.20512820512823,35,4,17,33.996468289750524,0.6404761904761904,43.28703703703704,1026.851851851852,29.338624338624342,0
4459,4,1,1,37,0.02631578947368421,0.02631578947368421,0.9736842105263158,38,950,700,250,0.7368421052631579,12,7,5,368.2589501129088,0.7663584637268848,-0.059885740095338535,0.21794762709839474,131725.00177154187,2101.782171201805,133826.78394274367,2305,0,484.57894736842104,34,4,18,33.912211527310674,0.6418504901960784,43.363095238095234,1026.5476190476184,30.192577030812306,0
4460,4,1,1,37,0.02631578947368421,0.02631578947368421,0.9736842105263158,38,800,600,200,0.75,10,6,4,367.46901911363176,0.7604907539118065,-0.056613272311212826,0.21782957318591561,131786.11288265296,2085.4627267573596,133871.57560941033,2306,0,485.55263157894734,34,4,18,33.870772946859894,0.6424632352941178,43.30357142857142,1026.7857142857135,30.199579831932752,0
4461,4,0,0,37,0.0,0.0,1.0,37,1000,600,400,0.6,14,6,8,375.0208673710942,0.7551301301301301,-0.05935878571981723,0.22183437747883383,131705.23356401388,2478.4421856978092,134183.6757497117,2307,7,499.6756756756757,33,4,18,33.758655682903544,0.6439393939393939,43.38235294117647,1026.4705882352944,31.105169340463465,0
4462,4,0,0,37,0.0,0.0,1.0,37,950,600,350,0.631578947368421,13,6,7,374.75692712461034,0.755005005005005,-0.05969301839437935,0.22204480448726924,131768.13755526725,2476.2044646289864,134244.34201989623,2308,8,500.6756756756757,33,4,18,33.70185804090075,0.6445707070707071,43.32107843137255,1026.71568627451,31.11259655377303,0
4463,4,0,0,37,0.0,0.0,1.0,37,1000,600,400,0.6,14,6,8,372.27870193776323,0.753003003003003,-0.05559513945533234,0.22149129583706656,131925.4632382977,2422.60804137831,134348.07127967602,2309,9,501.6756756756757,33,4,19,33.60657978448447,0.6461489898989898,43.16789215686274,1027.3284313725485,31.131164587046925,0
4464,4,0,0,37,0.0,0.0,1.0,37,750,500,250,0.6666666666666666,10,5,5,372.976345423468,0.752565065065065,-0.05401537955795044,0.22245943333721202,132019.90370290267,2448.060241253354,134467.963944156,2310,10,502.6756756756757,33,4,19,33.49332220367278,0.6470959595959596,43.07598039215686,1027.696078431372,31.14230540701127,0
4465,4,0,0,37,0.0,0.0,1.0,37,600,300,300,0.5,9,3,6,374.4864305321613,0.753003003003003,-0.0587325522947838,0.2237316367025475,132082.88278546702,2492.6494617454714,134575.53224721248,2311,11,503.6756756756757,33,4,19,33.39095533301543,0.6477272727272728,43.014705882352935,1027.9411764705874,31.14973262032083,0
4466,4,1,0,38,0.02631578947368421,0.0,1.0,38,1250,800,450,0.64,17,8,9,363.1175371538035,0.7591868183973447,-0.055261331677563086,0.21893404645967804,132428.63520408154,2017.431972789106,134446.06717687065,2312,0,491.39473684210526,34,4,20,33.33477908859588,0.6488970588235294,42.67857142857142,1029.2857142857135,30.27310924369746,0
4467,4,0,0,38,0.0,0.0,1.0,38,800,500,300,0.625,11,5,6,363.8195590997531,0.7586237553342816,-0.05778395914615975,0.21953578000945972,132459.2704790246,2038.2546768707084,134497.5251558953,2313,1,492.39473684210526,34,4,20,33.28586985852511,0.6492034313725492,42.648809523809504,1029.4047619047592,30.276610644257623,0
4468,4,1,1,38,0.02564102564102564,0.02564102564102564,0.9743589743589743,39,950,500,450,0.5263157894736842,14,5,9,356.0834449099468,0.76731893837157,-0.059039145395125114,0.21674115358325877,132785.41512613595,1656.5376103823698,134441.95273651832,2314,0,480.7435897435897,35,4,16,33.15705128205127,0.6502976190476191,42.332175925925924,1030.671296296296,29.447751322751316,0
4469,4,1,2,37,0.02564102564102564,0.05128205128205128,0.9487179487179487,39,1150,700,450,0.6086956521739131,16,7,9,343.317428781893,0.7660818713450293,-0.029759095710015893,0.20509172054457606,132079.4781267756,1269.0373650677857,133348.51549184337,2315,0,481.71794871794873,36,3,14,34.195378688285125,0.6412037037037036,43.018018018018026,1027.9279279279292,28.553553553553588,2
4470,4,0,0,37,0.0,0.0,1.0,37,750,500,250,0.6666666666666666,10,5,5,356.3394745659946,0.7515640640640641,-0.02308010374769731,0.21174221670491747,131877.80612244896,1998.6536281179158,133876.4597505669,2316,16,508.6756756756757,34,3,14,34.063997063823216,0.6433823529411764,43.214285714285715,1027.142857142857,30.210084033613445,0
4471,4,0,0,37,0.0,0.0,1.0,37,1500,1100,400,0.7333333333333333,19,11,8,356.2143599043787,0.7517517517517518,-0.018481302706459646,0.21269396842423288,132061.28826530615,2008.4254535147372,134069.7137188209,2317,17,509.6756756756757,34,3,16,33.88227743031425,0.6452205882352942,43.035714285714285,1027.8571428571431,30.231092436974798,0
4472,4,0,0,37,0.0,0.0,1.0,37,1050,700,350,0.6666666666666666,14,7,7,357.518941681482,0.7520645645645646,-0.02352190077989058,0.21381811498346803,132122.47732426302,2047.2576530612207,134169.73497732423,2318,18,510.6756756756757,34,3,16,33.78710243940097,0.6458333333333333,42.976190476190474,1028.0952380952378,30.23809523809523,0
4473,4,0,1,36,0.0,0.02702702702702703,0.972972972972973,37,750,500,250,0.6666666666666666,10,5,5,355.828510936749,0.7521896896896897,-0.02308467300363537,0.2131516419883243,132183.68055555547,2006.94444444444,134190.6249999999,2319,19,511.6756756756757,34,3,16,33.768908698001084,0.6464460784313726,42.916666666666664,1028.3333333333328,30.24509803921567,0
4474,4,1,0,37,0.02702702702702703,0.0,1.0,37,1100,800,300,0.7272727272727273,14,8,6,349.47705111819204,0.756443943943944,0.0011415594430648213,0.21221314522879564,132695.96220207462,1874.8387131344152,134570.80091520902,2320,0,505.5135135135135,35,2,16,33.41711600389425,0.649404761904762,42.418981481481474,1030.324074074073,29.437830687830658,0
4475,4,1,1,37,0.02631578947368421,0.02631578947368421,0.9736842105263158,38,1000,700,300,0.7,13,7,6,340.8755591639362,0.7658250355618776,0.004379260008505748,0.20839374972118319,132949.08717839443,1463.8188864540057,134412.90606484844,2321,0,493.1842105263158,36,2,16,33.38474557763705,0.6498842592592593,42.173423423423415,1031.3063063063048,28.647397397397356,0
4476,4,0,0,37,0.0,0.0,1.0,37,700,400,300,0.5714285714285714,10,4,6,348.56557189700646,0.7570695695695696,0.0028165166851295,0.21216516867688578,132785.41512613583,1856.8848326045772,134642.29995874042,2322,2,507.5135135135135,35,2,16,33.35076268014224,0.6502976190476191,42.33217592592592,1030.6712962962952,29.44775132275129,0
4477,4,0,1,36,0.0,0.02702702702702703,0.972972972972973,37,900,600,300,0.6666666666666666,12,6,6,349.50751906749616,0.7563188188188188,0.0025725579659805486,0.21341757966911035,132904.73257726748,1890.2406710819437,134794.97324834942,2323,3,508.5135135135135,35,2,18,33.206705765705095,0.6514880952380953,42.216435185185176,1031.1342592592578,29.460978835978793,0
4478,4,1,0,37,0.02702702702702703,0.0,1.0,37,1050,700,350,0.6666666666666666,14,7,7,352.9953231963558,0.7569444444444444,0.022908882646521578,0.2172784877562659,133203.26063368033,2004.0256076388644,135207.2862413192,2324,0,508.86486486486484,35,2,20,32.81723007063572,0.6544642857142857,41.92708333333332,1032.291666666665,29.49404761904757,0
4479,4,0,0,37,0.0,0.0,1.0,37,1500,1000,500,0.6666666666666666,20,10,10,352.9199509539295,0.7558183183183184,0.026191139593201962,0.21810648492471352,133352.65024862808,2012.562157064452,135365.21240569252,2325,1,509.86486486486484,35,2,21,32.66939339608547,0.6559523809523811,41.7824074074074,1032.8703703703688,29.510582010581967,0
4480,4,0,0,37,0.0,0.0,1.0,37,1250,1000,250,0.8,15,10,5,355.42403746097807,0.7555680680680681,0.03334786399302536,0.22036290322580654,133472.22222222228,2087.9008058985005,135560.12302812078,2326,2,510.86486486486484,34,3,21,32.48487903225807,0.6593137254901961,41.66666666666667,1033.333333333334,30.392156862745114,0
4481,4,0,0,37,0.0,0.0,1.0,37,700,600,100,0.8571428571428571,8,6,2,352.9017271160978,0.7563188188188188,0.03352658525072316,0.21950684029254786,133591.84777949253,2028.9587620027532,135620.8065414953,2327,3,511.86486486486484,35,2,21,32.43021346469623,0.6583333333333332,41.55092592592593,1033.7962962962968,29.53703703703705,0
4482,4,0,0,37,0.0,0.0,1.0,37,600,400,200,0.6666666666666666,8,4,4,351.42421184951115,0.7568193193193193,0.032526818289075,0.21894169516482098,133651.68065200618,1993.6873070987683,135645.36795910494,2328,4,512.8648648648649,35,2,22,32.40849563465413,0.6589285714285713,41.49305555555556,1034.0277777777778,29.543650793650794,0
4483,4,0,0,37,0.0,0.0,1.0,37,500,300,200,0.6,7,3,4,347.68049052329036,0.7568193193193193,0.02917721346724389,0.21713630634567768,133741.45507812512,1899.8589409722358,135641.31401909736,2329,5,513.8648648648649,35,2,16,32.41544981537429,0.6598214285714286,41.40625000000001,1034.375000000001,29.553571428571455,0
4484,4,0,1,36,0.0,0.02702702702702703,0.972972972972973,37,600,300,300,0.5,9,3,6,346.76303089737473,0.7563188188188188,0.03253281248582751,0.21691495683636328,133801.3214404363,1879.4703521519123,135680.79179258822,2330,6,514.8648648648649,35,2,17,32.379297647014944,0.6604166666666667,41.348379629629626,1034.6064814814808,29.560185185185166,0
4485,4,0,0,36,0.0,0.0,1.0,36,800,600,200,0.75,10,6,4,355.75071669211167,0.7535383597883598,0.0301365397154143,0.22259391495832564,133810.73022959183,2320.652636054423,136131.38286564627,2331,7,510.3888888888889,34,2,18,32.13741226556208,0.6626838235294117,41.339285714285715,1034.642857142857,30.43067226890756,0
4486,4,0,0,36,0.0,0.0,1.0,36,700,400,300,0.5714285714285714,10,4,6,356.5996348545803,0.7530092592592593,0.03335058859618867,0.22349824266696944,133872.32320011334,2347.7643140589566,136220.0875141723,2332,8,511.3888888888889,34,2,18,32.05380766133671,0.663296568627451,41.279761904761905,1034.8809523809523,30.437675070028007,0
4487,4,0,0,36,0.0,0.0,1.0,36,700,400,300,0.5714285714285714,10,4,6,352.37194651250184,0.75489417989418,-0.06203529165357613,0.22936603389556096,135250.98519800068,2343.242063982446,137594.22726198312,2333,9,512.3888888888889,33,3,22,30.787582469368516,0.6792929292929293,39.95098039215686,1040.196078431372,31.52109328579915,7
4488,4,0,0,36,0.0,0.0,1.0,36,800,600,200,0.75,10,6,4,352.76865124950666,0.7553902116402117,-0.06472101150508491,0.22982755797828563,135282.8558276865,2344.7101175028874,137627.5659451894,2334,10,513.3888888888889,33,3,22,30.745548160364397,0.6796085858585859,39.9203431372549,1040.3186274509806,31.524806892453956,0
4489,4,0,0,36,0.0,0.0,1.0,36,1300,1100,200,0.8461538461538461,15,11,4,350.4101264352888,0.7554563492063493,-0.06856299959443679,0.22910186326519688,135410.37589208473,2289.8333873990773,137700.2092794838,2335,11,514.3888888888889,33,3,22,30.68004533144944,0.6808712121212122,39.79779411764706,1040.8088235294115,31.539661319073076,0
4490,4,0,0,36,0.0,0.0,1.0,36,950,500,450,0.5263157894736842,14,5,9,352.0309228187821,0.7511574074074074,-0.06509589363454504,0.2313929476439929,135601.7686256488,2347.203149029226,137948.97177467804,2336,12,515.3888888888889,33,3,22,30.44757716594109,0.6827651515151516,39.6139705882353,1041.544117647059,31.561942959001787,0
4491,4,0,0,36,0.0,0.0,1.0,36,900,500,400,0.5555555555555556,13,5,8,355.21616257131296,0.7493716931216932,-0.07940100594421584,0.23474075079013348,135793.29652357282,2447.194738802399,138240.49126237523,2337,13,516.3888888888889,33,3,22,30.174284734469914,0.6846590909090908,39.430147058823536,1042.279411764707,31.584224598930515,0
4492,4,0,0,36,0.0,0.0,1.0,36,500,200,300,0.4,8,2,6,353.8482317208045,0.7490740740740741,-0.07985866185960244,0.2340461165643208,135825.23098087288,2412.3035611303494,138237.53454200324,2338,14,517.3888888888889,33,3,22,30.17820753977585,0.6849747474747474,39.399509803921575,1042.4019607843147,31.587938205585296,0
4493,4,0,0,36,0.0,0.0,1.0,36,950,700,250,0.7368421052631579,12,7,5,354.59864208116073,0.748478835978836,-0.07744345191453805,0.2349630254537784,135889.11115916955,2437.2188581314836,138326.33001730102,2339,15,518.3888888888889,33,3,20,30.095204513399146,0.6856060606060606,39.338235294117645,1042.6470588235293,31.595365418894826,0
4494,4,0,0,36,0.0,0.0,1.0,36,750,500,250,0.6666666666666666,10,5,5,353.52211047482893,0.7475198412698413,-0.07656925347018206,0.23445983149106178,135921.05688016638,2410.2197772491445,138331.27665741552,2340,16,519.3888888888889,33,3,20,30.091545226622788,0.6859217171717171,39.30759803921569,1042.769607843138,31.599079025549635,0
4495,4,0,0,36,0.0,0.0,1.0,36,1600,1100,500,0.6875,21,11,10,352.54839622152883,0.7428571428571429,-0.06936127744510978,0.23550232867598123,136176.75781250003,2401.7795138888887,138578.5373263889,2341,17,520.3888888888889,33,3,20,29.863190286094472,0.6884469696969697,39.0625,1043.7500000000002,31.628787878787886,0
4496,4,0,0,36,0.0,0.0,1.0,36,1200,800,400,0.6666666666666666,16,8,8,353.4036407656521,0.7428571428571429,-0.0636257515879537,0.23650004836469685,136240.720591239,2429.5933354959616,138670.31392673496,2342,18,521.3888888888889,33,3,20,29.777433775482248,0.6890782828282829,39.00122549019608,1043.995098039216,31.63621509209745,0
4497,4,0,0,36,0.0,0.0,1.0,36,1150,900,250,0.782608695652174,14,9,5,353.5826307389075,0.742228835978836,-0.06764659859953814,0.2370478046047388,136304.69838824015,2438.994767637457,138743.6931558776,2343,19,522.3888888888889,33,3,21,29.70932108907406,0.689709595959596,38.93995098039216,1044.2401960784318,31.643642305407024,0
4498,4,0,0,36,0.0,0.0,1.0,36,1050,800,250,0.7619047619047619,13,8,5,354.29429006338984,0.7427248677248678,-0.06433674932853495,0.23773983778899277,136336.69291858905,2460.662365436379,138797.35528402543,2344,20,523.3888888888889,33,3,21,29.659019791911135,0.6900252525252525,38.9093137254902,1044.3627450980396,31.647355912061805,0
4499,4,0,0,36,0.0,0.0,1.0,36,1600,1300,300,0.8125,19,13,6,357.35924758087054,0.7422619047619048,-0.07126567101936498,0.24066705725706963,136464.70858564012,2553.3851163014274,139018.09370194154,2345,21,524.3888888888889,33,3,21,29.452068183595298,0.6912878787878788,38.786764705882355,1044.8529411764705,31.662210338680925,0
4500,4,0,0,36,0.0,0.0,1.0,36,500,200,300,0.4,8,2,6,357.35924758087054,0.7422619047619048,-0.07126567101936498,0.24066705725706963,136464.70858564012,2553.3851163014274,139018.09370194154,2346,22,525.3888888888889,33,3,21,29.452068183595298,0.6912878787878788,38.786764705882355,1044.8529411764705,31.662210338680925,0
4501,4,0,0,36,0.0,0.0,1.0,36,750,500,250,0.6666666666666666,10,5,5,357.7255427026463,0.7402447089947091,-0.06665819882492374,0.2415709543714069,136560.75975886677,2570.2543793252617,139131.01413819203,2347,23,526.3888888888889,33,3,21,29.347300386915236,0.6922348484848484,38.69485294117647,1045.220588235294,31.67335115864527,0
4502,4,0,0,36,0.0,0.0,1.0,36,700,400,300,0.5714285714285714,10,4,6,356.7024426397107,0.7397817460317461,-0.06915309191765262,0.24175869285501606,136688.88055375344,2551.4515150423013,139240.33206879575,2348,24,527.3888888888889,33,3,21,29.24711414508381,0.6934974747474747,38.57230392156863,1045.710784313726,31.688205585264424,0
4503,4,0,0,36,0.0,0.0,1.0,36,1100,800,300,0.7272727272727273,14,8,6,355.391184266916,0.7389550264550265,-0.06961044710048736,0.24108969527296228,136720.92013888902,2517.8819444444557,139238.8020833335,2349,25,528.3888888888889,33,3,21,29.2496679946879,0.6938131313131313,38.54166666666667,1045.8333333333344,31.691919191919226,0
4504,4,0,0,36,0.0,0.0,1.0,36,1050,600,450,0.5714285714285714,15,6,9,354.17922197656173,0.7370701058201059,-0.07320866192967435,0.24114690568069264,136849.1160250866,2493.8226883890866,139342.93871347568,2350,26,529.3888888888889,33,3,21,29.154466307488082,0.6950757575757576,38.419117647058826,1046.3235294117655,31.70677361853835,0
4505,4,0,0,36,0.0,0.0,1.0,36,1400,1000,400,0.7142857142857143,18,10,8,354.20092105572144,0.7363756613756615,-0.06949160259662501,0.2418249453826472,136945.30236267298,2501.230446222608,139446.5328088956,2351,27,530.3888888888889,33,3,21,29.058731413183487,0.6960227272727273,38.32720588235294,1046.691176470588,31.717914438502667,0
4506,4,0,1,35,0.0,0.027777777777777776,0.9722222222222222,36,700,300,400,0.42857142857142855,11,3,8,354.2729607609591,0.7367724867724869,-0.06819423309532135,0.2423181668359387,137009.44536055843,2507.748372020377,139517.1937325788,2352,28,531.3888888888889,33,3,18,28.993401030083103,0.6966540404040404,38.26593137254902,1046.9362745098038,31.725341651812236,0
4507,4,0,0,35,0.0,0.0,1.0,35,850,600,250,0.7058823529411765,11,6,5,352.40671610490824,0.7334033613445378,-0.055190169689877,0.24148479463644285,137073.60337670622,2661.1316861303476,139734.73506283655,2353,29,539.3428571428572,33,2,18,28.978813146089326,0.6972853535353535,38.204656862745104,1047.1813725490206,31.732768865121837,0
4508,4,0,0,35,0.0,0.0,1.0,35,750,500,250,0.6666666666666666,10,5,5,354.25857484177976,0.732422969187675,-0.05634075831759744,0.2436489586743667,137201.96446378817,2720.9944792868355,139922.958943075,2354,30,540.3428571428572,33,2,18,28.803441923031933,0.6985479797979798,38.082107843137265,1047.6715686274524,31.747623291740982,0
4509,4,0,0,35,0.0,0.0,1.0,35,600,300,300,0.5,9,3,6,352.79942546424525,0.7318627450980392,-0.05924143692564754,0.24286916970364722,137234.06412197236,2683.2197952710562,139917.28391724342,2355,31,541.3428571428572,33,2,18,28.80994152046783,0.6988636363636364,38.0514705882353,1047.7941176470592,31.751336898395735,0
4510,4,0,0,35,0.0,0.0,1.0,35,850,700,150,0.8235294117647058,10,7,3,353.6478756275372,0.7316526610644257,-0.0657223038888145,0.24390295422312083,137298.27470203768,2711.0486351403356,140009.323337178,2356,32,542.3428571428572,33,2,18,28.724275023386337,0.6994949494949495,37.990196078431374,1048.0392156862747,31.758764111705293,0
4511,4,0,0,35,0.0,0.0,1.0,35,550,400,150,0.7272727272727273,7,4,3,354.7731997779008,0.7313025210084033,-0.06743044189852732,0.2451316600080908,137362.50030036527,2746.50675221069,140109.00705257597,2357,33,543.3428571428572,33,2,19,28.631342062193124,0.7001262626262625,37.92892156862745,1048.2843137254904,31.76619132501486,0
4512,4,0,0,35,0.0,0.0,1.0,35,900,400,500,0.4444444444444444,14,4,10,352.9518661010459,0.7315826330532212,-0.07055523085914672,0.24409888556947834,137394.61873137738,2698.737414696272,140093.35614607367,2358,34,544.3428571428572,33,2,19,28.647355347749855,0.7004419191919191,37.89828431372549,1048.4068627450981,31.76990493166964,0
4513,4,0,1,34,0.0,0.02857142857142857,0.9714285714285714,35,850,600,250,0.7058823529411765,11,6,5,354.52908580693725,0.7303921568627451,-0.0635497049477981,0.2463809388115719,137562.61337868482,2753.9895124716613,140316.60289115648,2359,35,545.3428571428572,34,1,19,28.440147904372814,0.6997549019607843,37.73809523809524,1049.0476190476193,30.854341736694685,0
4514,4,0,0,34,0.0,0.0,1.0,34,700,400,300,0.5714285714285714,10,4,6,355.09445629632654,0.726678550207962,-0.047080118979741625,0.2474104010793691,137651.70134383414,2975.8712093906274,140627.57255322477,2360,36,553.3529411764706,33,1,20,28.337396356417152,0.7029671717171717,37.65318627450981,1049.3872549019611,31.799613784907912,0
4515,4,0,0,34,0.0,0.0,1.0,34,600,400,200,0.6666666666666666,8,4,4,353.4847866781582,0.7261586452762924,-0.04752927440678523,0.2467479378890322,137716.00954260383,2936.102851066902,140652.11239367074,2361,37,554.3529411764706,33,1,20,28.31618505545827,0.7035984848484849,37.591911764705884,1049.6323529411766,31.807040998217474,0
4516,4,0,0,34,0.0,0.0,1.0,34,650,500,150,0.7692307692307693,8,5,3,351.8384307905026,0.726232917409388,-0.046344042461153534,0.24605712951691702,137780.3327596356,2895.2832143886826,140675.6159740243,2362,38,555.3529411764706,33,1,20,28.295956383020126,0.704229797979798,37.530637254901954,1049.8774509803911,31.814468211527004,0
4517,4,0,0,34,0.0,0.0,1.0,34,850,700,150,0.8235294117647058,10,7,3,352.7336860670194,0.7259729649435532,-0.05018674136321177,0.24691358024691357,137812.5,2922.222222222222,140734.72222222222,2363,39,556.3529411764706,33,1,20,28.240740740740733,0.7045454545454546,37.5,1050.0,31.818181818181817,0
4518,4,0,0,34,0.0,0.0,1.0,34,900,800,100,0.8888888888888888,10,8,2,352.7336860670194,0.7259729649435532,-0.05018674136321177,0.24691358024691357,137812.5,2922.222222222222,140734.72222222222,2364,40,557.3529411764706,33,1,20,28.240740740740733,0.7045454545454546,37.5,1050.0,31.818181818181817,0
4519,4,0,0,34,0.0,0.0,1.0,34,1200,600,600,0.5,18,6,12,349.6075841016416,0.723596256684492,-0.04758310230298346,0.24564231237043213,137941.20650711263,2845.0583910034547,140786.2648981161,2365,41,558.3529411764706,33,1,21,28.195967491056145,0.7058080808080809,37.377450980392155,1050.4901960784312,31.833036244800944,0
4520,4,0,0,34,0.0,0.0,1.0,34,1100,800,300,0.7272727272727273,14,8,6,348.3458762930414,0.7223707664884136,-0.04907220030869497,0.245445019655943,138037.77581038524,2816.9779952421904,140854.75380562744,2366,42,559.3529411764706,33,1,21,28.13398931000972,0.7067550505050506,37.28553921568626,1050.8578431372534,31.844177064765255,0
4521,4,0,0,34,0.0,0.0,1.0,34,450,300,150,0.6666666666666666,6,3,3,344.57741353317994,0.7223707664884136,-0.058392982078467215,0.22552282215075806,135447.73242630393,2534.4458616780144,137982.17828798195,2367,43,560.3529411764706,34,0,22,30.79468778591034,0.6789215686274509,39.761904761904766,1040.9523809523816,30.61624649859946,6
4522,4,0,0,34,0.0,0.0,1.0,34,800,500,300,0.625,11,5,6,344.0293274247158,0.7221108140225788,-0.05630252100840294,0.22734805203941008,135793.29652357262,2549.3312183942194,138342.62774196683,2368,44,561.3529411764706,33,1,19,30.46577993337253,0.6846590909090908,39.43014705882353,1042.2794117647056,31.584224598930472,3
4523,4,1,2,33,0.02857142857142857,0.05714285714285714,0.9428571428571428,35,550,300,250,0.5454545454545454,8,3,5,334.31268737647446,0.7312324929971988,-0.06663919617103531,0.22256237548091096,136055.9802061897,2097.048075274317,138153.028281464,2369,0,546.2857142857143,35,0,19,30.45863841431846,0.6827380952380954,39.178240740740726,1043.2870370370347,29.80820105820099,0
4524,4,0,0,33,0.0,0.0,1.0,33,1050,900,150,0.8571428571428571,12,9,3,349.0550010230535,0.714251893939394,-0.05378021931043353,0.23087572618212224,135825.23098087273,2882.0952277969996,138707.32620866972,2370,50,579.030303030303,33,0,21,30.303119366721535,0.6849747474747475,39.39950980392157,1042.4019607843136,31.58793820558526,0
4525,4,0,0,33,0.0,0.0,1.0,33,850,400,450,0.47058823529411764,13,4,9,348.46898456938953,0.7133838383838385,-0.05665395584324029,0.2315237726518402,135984.95958585633,2877.3081567185613,138862.26774257488,2371,51,580.030303030303,33,0,19,30.159866643167657,0.6865530303030303,39.24632352941176,1043.0147058823525,31.606506238859165,0
4526,4,0,0,33,0.0,0.0,1.0,33,1450,1100,350,0.7586206896551724,18,11,7,350.87257517072146,0.7124368686868687,-0.05929627494109524,0.23375032120528358,136080.8418036333,2949.4070790080764,139030.24888264138,2372,52,581.030303030303,33,0,19,30.00205543810195,0.6875,39.154411764705884,1043.3823529411768,31.61764705882354,0
4527,4,0,0,33,0.0,0.0,1.0,33,600,400,200,0.6666666666666666,8,4,4,350.87257517072146,0.7124368686868687,-0.05929627494109524,0.23375032120528358,136080.8418036333,2949.4070790080764,139030.24888264138,2373,53,582.030303030303,33,0,19,30.00205543810195,0.6875,39.154411764705884,1043.3823529411768,31.61764705882354,0
4528,4,0,0,33,0.0,0.0,1.0,33,800,700,100,0.875,9,7,2,352.2296723917434,0.7110164141414143,-0.06024315006350911,0.2352894211576845,136176.7578125,2993.0989583333326,139169.85677083334,2374,54,583.030303030303,33,0,20,29.871506986027942,0.6884469696969697,39.0625,1043.75,31.62878787878788,0
4529,4,0,0,33,0.0,0.0,1.0,33,900,600,300,0.6666666666666666,12,6,6,352.2239855407877,0.7112531565656566,-0.06336605491535063,0.23592361295656533,136272.70761245672,2999.7032391387907,139272.41085159552,2375,55,584.030303030303,33,0,20,29.776506259780913,0.6893939393939394,38.970588235294116,1044.1176470588234,31.639928698752225,0
4530,4,0,0,33,0.0,0.0,1.0,33,650,500,150,0.7692307692307693,8,5,3,351.1107906804542,0.7117266414141414,-0.06190039327800412,0.23560363450227,136336.692918589,2973.8568098808096,139310.5497284698,2376,56,585.030303030303,33,0,20,29.74213799577565,0.6900252525252526,38.90931372549019,1044.3627450980389,31.647355912061784,0
4531,4,0,0,33,0.0,0.0,1.0,33,1150,900,250,0.782608695652174,14,9,5,352.50566980558483,0.7121212121212122,-0.066478961363992,0.23696832250968494,136400.69324298343,3016.403546712794,139417.09678969622,2377,57,586.030303030303,33,0,20,29.642284529954633,0.6906565656565657,38.84803921568627,1044.6078431372546,31.654783125371353,0
4532,4,0,0,33,0.0,0.0,1.0,33,350,100,250,0.2857142857142857,6,1,5,352.50566980558483,0.7121212121212122,-0.066478961363992,0.23696832250968494,136400.69324298343,3016.403546712794,139417.09678969622,2378,58,587.030303030303,33,0,20,29.642284529954633,0.6906565656565657,38.84803921568627,1044.6078431372546,31.654783125371353,0
4533,4,0,0,33,0.0,0.0,1.0,33,1150,1000,150,0.8695652173913043,13,10,3,353.90427823674975,0.7114109848484849,-0.06306498379669145,0.23877339278504747,136528.73894655894,3063.6209630911044,139592.35990965005,2379,59,588.030303030303,33,0,20,29.478873514696684,0.6919191919191919,38.725490196078425,1045.0980392156857,31.669637551990476,0
4534,4,0,0,33,0.0,0.0,1.0,33,1000,800,200,0.8,12,8,4,351.6868184070732,0.710858585858586,-0.06281598965383695,0.23749302250149854,136560.7597588668,3005.323823769706,139566.0835826365,2380,60,589.030303030303,33,0,20,29.50509536092547,0.6922348484848484,38.69485294117647,1045.2205882352941,31.67335115864528,0
4535,4,0,0,33,0.0,0.0,1.0,33,1200,1000,200,0.8333333333333334,14,10,4,352.57455667835603,0.7101483585858587,-0.06520141056646411,0.23896097634125574,136688.88055375323,3038.604292820051,139727.4848465733,2381,61,590.030303030303,33,0,20,29.355028516738933,0.6934974747474748,38.57230392156862,1045.7107843137244,31.688205585264374,0
4536,4,0,0,33,0.0,0.0,1.0,33,650,300,350,0.46153846153846156,10,3,7,352.21663148204,0.7102272727272728,-0.0683327296873113,0.23893614730268117,136720.92013888885,3031.0763888888823,139751.99652777772,2382,62,591.030303030303,33,0,21,29.332669322709158,0.6938131313131313,38.541666666666664,1045.833333333333,31.691919191919183,0
4537,4,0,0,33,0.0,0.0,1.0,33,1100,800,300,0.7272727272727273,14,8,6,352.98956842548364,0.709201388888889,-0.06710184899244309,0.24011728650584482,136817.06142168873,3058.999092896953,139876.0605145857,2383,63,592.030303030303,33,0,21,29.217304088087147,0.694760101010101,38.44975490196078,1046.2009803921565,31.70306001188353,0
4538,4,0,1,32,0.0,0.030303030303030304,0.9696969696969697,33,500,300,200,0.6,7,3,4,354.62597831392696,0.7079387626262627,-0.07093889716840551,0.2418934388818639,136913.23649557852,3110.5980872741115,140023.83458285264,2384,64,593.030303030303,33,0,21,29.07933255269321,0.6957070707070707,38.357843137254896,1046.5686274509796,31.71420083184787,0
4539,4,0,0,32,0.0,0.0,1.0,32,600,400,200,0.6666666666666666,8,4,4,362.4459949533718,0.7043430779569892,-0.062096506576565735,0.24680279048303955,136853.00168669017,3520.364471737581,140373.36615842776,2385,90,610.5625,32,0,21,28.934375125698875,0.6975911458333334,38.41540404040404,1046.338383838384,32.6980744949495,0
4540,4,0,0,32,0.0,0.0,1.0,32,750,500,250,0.6666666666666666,10,5,5,363.94242297366844,0.7031670026881721,-0.05783756482933278,0.24875899660961942,136985.1470034945,3570.941262371181,140556.08826586566,2386,91,611.5625,32,0,20,28.764373014915765,0.6988932291666667,38.28914141414141,1046.843434343434,32.71385732323231,0
4541,4,0,0,32,0.0,0.0,1.0,32,1150,900,250,0.782608695652174,14,9,5,366.89909718646766,0.702116935483871,-0.05353893740902449,0.24005683787343193,135436.4669421489,3538.3034894398716,138974.77043158875,2387,92,612.5625,32,0,23,30.225012130033974,0.68359375,39.77272727272728,1040.909090909092,32.52840909090912,2
4542,4,0,0,32,0.0,0.0,1.0,32,300,200,100,0.6666666666666666,4,2,2,366.89909718646766,0.702116935483871,-0.05353893740902449,0.24005683787343193,135436.4669421489,3538.3034894398716,138974.77043158875,2388,93,613.5625,32,0,23,30.225012130033974,0.68359375,39.77272727272728,1040.909090909092,32.52840909090912,0
4543,4,0,0,32,0.0,0.0,1.0,32,650,400,250,0.6153846153846154,9,4,5,363.94747135838304,0.7003108198924731,-0.05313144017456628,0.23921933794703612,135600.8016560811,3470.313775380079,139071.1154314612,2389,94,614.5625,32,0,23,30.13824908069665,0.6852213541666666,39.614898989899,1041.5404040404048,32.54813762626265,0
4544,4,0,0,32,0.0,0.0,1.0,32,850,600,250,0.7058823529411765,11,6,5,366.9558741281936,0.7002688172043011,-0.054837853036740714,0.24187651604397106,135701.50587293855,3559.296927185988,139260.80280012454,2390,95,615.5625,31,1,23,29.959697575606093,0.6888440860215053,39.51822916666668,1041.9270833333348,33.610551075268866,0
4545,4,0,0,32,0.0,0.0,1.0,32,850,600,250,0.7058823529411765,11,6,5,369.06833939352157,0.6997647849462366,-0.052926661669165265,0.24373126967869227,135769.34814453148,3621.633572048642,139390.98171658014,2391,96,616.5625,31,1,23,29.83716475095786,0.6895161290322579,39.453125000000014,1042.1875000000018,33.61895161290328,0
4546,4,0,0,32,0.0,0.0,1.0,32,350,0,350,0.0,7,0,7,370.42791415889735,0.6990507392473119,-0.04922314178638354,0.2448617219522689,135803.27563815666,3661.064826117647,139464.3404642743,2392,97,617.5625,31,1,23,29.7679835519467,0.6898521505376343,39.42057291666668,1042.3177083333348,33.62315188172048,0
4547,4,0,0,32,0.0,0.0,1.0,32,750,500,250,0.6666666666666666,10,5,5,371.24713448389764,0.6980006720430109,-0.04536088911088898,0.24610488848899464,135905.08355034742,3690.8745659722495,139595.95811631967,2393,98,618.5625,31,1,20,29.645354645354654,0.6908602150537633,39.32291666666668,1042.7083333333348,33.63575268817209,0
4548,4,0,0,32,0.0,0.0,1.0,32,800,400,400,0.5,12,4,8,369.9816135077773,0.6976226478494624,-0.04032123834886825,0.24589043517198328,135995.61149691374,3663.1751543210094,139658.78665123475,2394,99,619.5625,32,0,20,29.588326675543723,0.6891276041666665,39.23611111111112,1043.055555555557,32.59548611111116,0
4549,4,0,0,32,0.0,0.0,1.0,32,450,300,150,0.6666666666666666,6,3,3,369.9816135077773,0.6976226478494624,-0.04032123834886825,0.24589043517198328,135995.61149691374,3663.1751543210094,139658.78665123475,2395,100,620.5625,32,0,20,29.588326675543723,0.6891276041666665,39.23611111111112,1043.055555555557,32.59548611111116,0
4550,4,0,0,32,0.0,0.0,1.0,32,700,500,200,0.7142857142857143,9,5,4,369.5151742451418,0.6956065188172044,-0.03981226552099726,0.24603576831487586,136061.46893493025,3655.3554803081497,139716.8244152384,2396,101,621.5625,32,0,20,29.535025616200727,0.6897786458333333,39.17297979797981,1043.308080808082,32.60337752525256,0
4551,4,0,0,32,0.0,0.0,1.0,32,800,400,400,0.5,12,4,8,368.176781730743,0.6928763440860216,-0.029435776487663157,0.24628524525483678,136226.18227731864,3631.06347566575,139857.2457529844,2397,102,622.5625,32,0,20,29.406295355587808,0.69140625,39.015151515151516,1043.939393939394,32.62310606060606,0
4552,4,0,0,32,0.0,0.0,1.0,32,1100,900,200,0.8181818181818182,13,9,4,368.1840862426341,0.6910702284946237,-0.032284993351867186,0.24744004431237335,136390.9952587748,3643.39879221511,140034.3940509899,2398,103,623.5625,32,0,20,29.24246544985696,0.6930338541666666,38.857323232323246,1044.5707070707087,32.64283459595965,0
4553,4,0,0,32,0.0,0.0,1.0,32,500,300,200,0.6,7,3,4,369.65915639765933,0.6898521505376345,-0.027413605606573244,0.24912859758526293,136489.93087440057,3690.950540761148,140180.8814151617,2399,104,624.5625,32,0,20,29.105747543096506,0.6940104166666666,38.76262626262626,1044.949494949495,32.654671717171716,0
4554,4,0,0,32,0.0,0.0,1.0,32,750,600,150,0.8,9,6,3,370.40717946283337,0.6888860887096775,-0.03001947698997487,0.25033477867533055,136588.90236009087,3718.7020138251246,140307.604373916,2400,105,625.5625,32,0,20,28.988001771550508,0.6949869791666666,38.667929292929294,1045.3282828282831,32.66650883838385,0
4555,4,0,0,32,0.0,0.0,1.0,32,650,300,350,0.46153846153846156,10,3,7,371.9071623608486,0.6887600806451614,-0.03238224637681131,0.2515842568911623,136621.90082644636,3762.1326905417895,140384.03351698816,2401,106,626.5625,32,0,20,28.916062801932366,0.6953125,38.63636363636364,1045.454545454546,32.67045454545456,0
4556,4,0,0,32,0.0,0.0,1.0,32,800,500,300,0.625,11,5,6,371.38232998001314,0.6867439516129032,-0.027144711422361745,0.2517011830519206,136687.90971584537,3752.6948780736716,140440.60459391904,2402,107,627.5625,32,0,21,28.864304113338164,0.6959635416666666,38.573232323232325,1045.7070707070711,32.67834595959597,0
4557,4,0,0,32,0.0,0.0,1.0,32,750,500,250,0.6666666666666666,10,5,5,373.6747328831782,0.6853158602150539,-0.022407653307580988,0.25373126944297136,136753.93454749527,3820.2979925517957,140574.23254004706,2403,108,628.5625,32,0,21,28.738884194431037,0.6966145833333333,38.51010101010102,1045.959595959597,32.686237373737406,0
4558,4,0,0,32,0.0,0.0,1.0,32,850,600,250,0.7058823529411765,11,6,5,374.4976528288157,0.6861139112903226,-0.025759472668034356,0.2550092069837632,136853.0016866903,3850.225582848707,140703.227269539,2404,109,629.5625,32,0,22,28.61912232009975,0.6975911458333333,38.41540404040405,1046.338383838385,32.69807449494953,0
4559,4,0,0,32,0.0,0.0,1.0,32,900,700,200,0.7777777777777778,11,7,4,376.4979097580033,0.6853998655913979,-0.026372135102533223,0.25709783129273867,136952.10469594944,3912.436230996841,140864.54092694627,2405,110,630.5625,32,0,20,28.468536389223964,0.6985677083333334,38.32070707070707,1046.717171717172,32.70991161616163,0
4560,4,0,0,32,0.0,0.0,1.0,32,750,300,450,0.4,12,3,9,376.4979097580033,0.6853998655913979,-0.026372135102533223,0.25709783129273867,136952.10469594944,3912.436230996841,140864.54092694627,2406,111,631.5625,32,0,20,28.468536389223964,0.6985677083333334,38.32070707070707,1046.717171717172,32.70991161616163,0
4561,4,0,0,32,0.0,0.0,1.0,32,700,400,300,0.5714285714285714,10,4,6,376.98955884228394,0.6838457661290324,-0.022502260397829987,0.2586541266002271,137117.3560893021,3938.362316345273,141055.71840564738,2407,112,632.5625,32,0,20,28.29189270644968,0.7001953125,38.16287878787879,1047.348484848485,32.729640151515156,0
4562,4,0,0,32,0.0,0.0,1.0,32,800,600,200,0.75,10,6,4,378.11426740050274,0.6823756720430109,-0.02137563268257381,0.2601651899576593,137216.55475206615,3976.707415059692,141193.26216712585,2408,113,633.5625,32,0,20,28.16416606411183,0.701171875,38.06818181818182,1047.727272727273,32.74147727272728,0
4563,4,0,0,32,0.0,0.0,1.0,32,500,200,300,0.4,8,2,6,381.65916678763233,0.6810315860215055,-0.020625000000000338,0.26310391065924815,137282.70712172217,4079.0407228854046,141361.74784460757,2409,114,634.5625,32,0,20,28.00577309236948,0.7018229166666667,38.0050505050505,1047.9797979797972,32.749368686868664,0
4564,4,0,0,32,0.0,0.0,1.0,32,650,400,250,0.6153846153846154,9,4,5,380.737088194565,0.6804435483870969,-0.020123163093230367,0.2629683283021031,137348.8754336292,4058.7621798796,141407.6376135088,2410,115,635.5625,32,0,20,27.96439612944672,0.7024739583333334,37.94191919191919,1048.232323232323,32.7572601010101,0
4565,4,0,0,32,0.0,0.0,1.0,32,600,400,200,0.6666666666666666,8,4,4,379.63297968700095,0.6789734543010754,-0.015750901984365573,0.2654876556852327,137779.3580533876,4061.11764743396,141840.47570082158,2411,116,636.5625,32,0,21,27.567398276207665,0.7067057291666665,37.53156565656567,1049.8737373737388,32.80855429292934,2
4566,4,0,1,31,0.0,0.03125,0.96875,32,1050,900,150,0.8571428571428571,12,9,3,379.83293374868464,0.6788894489247312,-0.019890726993472274,0.26615557949582713,137847.78451627356,4071.833651839933,141919.6181681135,2412,117,637.5625,30,2,21,27.494507018217504,0.7128472222222222,37.46639784946237,1050.1344086021506,35.00448028673836,0
4567,4,0,0,31,0.0,0.0,1.0,31,850,600,250,0.7058823529411765,11,6,5,379.83677187729614,0.6782258064516129,-0.01831287102553736,0.26643128684463147,137883.0735489654,4274.612310671779,142157.68585963716,2413,118,646.0645161290323,30,1,21,27.45952777066803,0.7131944444444444,37.43279569892474,1050.2688172043026,35.008960573476756,0
4568,4,0,0,31,0.0,0.0,1.0,31,700,400,300,0.5714285714285714,10,4,6,379.7472703545176,0.6764336917562724,-0.01883989800212893,0.26746523960645247,138024.27484391278,4282.868322927533,142307.1431668403,2414,119,647.0645161290323,30,1,21,27.322365055001278,0.7145833333333332,37.298387096774206,1050.8064516129048,35.02688172043016,0
4569,4,0,0,31,0.0,0.0,1.0,31,900,500,400,0.5555555555555556,13,5,8,382.6317486864634,0.6742831541218638,-0.022434654943459753,0.2706099039986906,138165.5484015494,4373.305078621821,142538.8534801712,2415,120,648.0645161290323,30,1,21,27.10703784198416,0.7159722222222222,37.16397849462366,1051.3440860215062,35.04480286738354,0
4570,4,0,0,31,0.0,0.0,1.0,31,700,300,400,0.42857142857142855,11,3,8,383.8966203595013,0.6724910394265233,-0.02250850252499248,0.27234733040009973,138271.55099216686,4416.39622355187,142687.94721571874,2416,121,649.0645161290323,30,1,21,26.969116080937173,0.7170138888888888,37.06317204301076,1051.747311827958,35.058243727598594,0
4571,4,0,0,31,0.0,0.0,1.0,31,900,700,200,0.7777777777777778,11,7,4,383.95444583535755,0.671326164874552,-0.022642878044156323,0.2729529016851355,138342.241968002,4423.423770089021,142765.66573809102,2417,122,650.0645161290323,30,1,21,26.89781099612453,0.7177083333333334,36.99596774193548,1052.0161290322574,35.06720430107524,0
4572,4,0,0,31,0.0,0.0,1.0,31,600,400,200,0.6666666666666666,8,4,4,382.6908764988959,0.6707885304659498,-0.01754812346299417,0.2731861671707251,138483.67811668984,4399.288031853405,142882.96614854326,2418,123,651.0645161290323,30,1,21,26.791491082450115,0.7190972222222223,36.86155913978495,1052.5537634408606,35.085125448028684,0
4573,4,0,0,31,0.0,0.0,1.0,31,1150,900,250,0.782608695652174,14,9,5,381.57597122202543,0.6696236559139785,-0.01603227865039014,0.27352678266464486,138625.1865280668,4379.208037056307,143004.39456512313,2419,124,652.0645161290323,30,1,21,26.681291214635184,0.720486111111111,36.72715053763441,1053.0913978494623,35.103046594982075,0
4574,4,0,0,31,0.0,0.0,1.0,31,1000,700,300,0.7,13,7,6,380.7237365481914,0.6691756272401433,-0.016483064104464207,0.27320065930326276,138660.57492195634,4358.274439241535,143018.84936119788,2420,125,653.0645161290323,30,1,21,26.668846775565758,0.7208333333333333,36.693548387096776,1053.2258064516132,35.10752688172044,0
4575,4,0,0,31,0.0,0.0,1.0,31,900,700,200,0.7777777777777778,11,7,4,377.1687517710558,0.668100358422939,-0.018344999567917464,0.2714991593327188,138766.76720213323,4267.6976745866605,143034.4648767199,2421,126,654.0645161290323,30,1,22,26.657843262320874,0.721875,36.59274193548387,1053.6290322580649,35.120967741935495,0
4576,4,0,0,31,0.0,0.0,1.0,31,700,400,300,0.5714285714285714,10,4,6,378.21346757865985,0.6673835125448029,-0.01765514064055429,0.27310773598083327,138873.00013007285,4304.727786449302,143177.72791652216,2422,127,655.0645161290323,30,1,22,26.525705602312335,0.7229166666666667,36.49193548387097,1054.032258064516,35.134408602150536,0
4577,4,0,0,31,0.0,0.0,1.0,31,800,500,300,0.625,11,5,6,378.21346757865985,0.6673835125448029,-0.01765514064055429,0.27310773598083327,138873.00013007285,4304.727786449302,143177.72791652216,2423,128,656.0645161290323,30,1,22,26.525705602312335,0.7229166666666667,36.49193548387097,1054.032258064516,35.134408602150536,0
4578,4,0,0,31,0.0,0.0,1.0,31,750,500,250,0.6666666666666666,10,5,5,378.5446107302495,0.6666666666666666,-0.0142208550607823,0.27392102643616933,138943.844664123,4319.2887183489365,143263.13338247192,2424,129,657.0645161290323,30,1,22,26.447231429542743,0.7236111111111112,36.424731182795696,1054.3010752688172,35.143369175627235,0
4579,4,0,0,31,0.0,0.0,1.0,31,700,400,300,0.5714285714285714,10,4,6,376.648261340257,0.6649641577060932,-0.011553041204476644,0.27312220503471846,139014.70726384534,4271.9295583304165,143286.63682217576,2425,130,658.0645161290323,30,1,22,26.427478970175887,0.7243055555555555,36.35752688172042,1054.5698924731169,35.15232974910389,0
4580,4,0,0,31,0.0,0.0,1.0,31,700,400,300,0.5714285714285714,10,4,6,375.1639344568153,0.6619175627240144,-0.013296025573072523,0.27348301294526034,139191.94280046812,4243.959381142309,143435.90218161044,2426,131,659.0645161290323,30,1,22,26.292298221033413,0.7260416666666667,36.18951612903225,1055.2419354838698,35.17473118279566,0
4581,4,0,0,31,0.0,0.0,1.0,31,600,400,200,0.6666666666666666,8,4,4,375.0857366631642,0.6615591397849462,-0.014765089642252649,0.2737149818103311,139227.40345704684,4244.442637877182,143471.84609492403,2427,132,660.0645161290323,30,1,22,26.25949864153506,0.726388888888889,36.15591397849461,1055.3763440860198,35.179211469533996,0
4582,4,0,0,31,0.0,0.0,1.0,31,1150,800,350,0.6956521739130435,15,8,7,376.09637032219473,0.66084229390681,-0.011922797423296272,0.2759093540262823,139404.77448621223,4285.9259379697005,143690.70042418194,2428,133,661.0645161290323,30,1,22,26.058504094013827,0.728125,35.98790322580645,1056.048387096774,35.2016129032258,0
4583,4,0,0,31,0.0,0.0,1.0,31,900,700,200,0.7777777777777778,11,7,4,376.716386018935,0.6623655913978495,-0.012704613629555439,0.2775414723987672,139546.7526050698,4313.909664412053,143860.66226948187,2429,134,662.0645161290323,30,1,22,25.90266293516516,0.729513888888889,35.853494623655905,1056.5860215053754,35.21953405017918,0
4584,4,0,0,31,0.0,0.0,1.0,31,650,400,250,0.6153846153846154,9,4,5,376.716386018935,0.6623655913978495,-0.012704613629555439,0.2775414723987672,139546.7526050698,4313.909664412053,143860.66226948187,2430,135,663.0645161290323,30,1,22,25.90266293516516,0.729513888888889,35.853494623655905,1056.5860215053754,35.21953405017918,0
4585,4,0,0,31,0.0,0.0,1.0,31,900,600,300,0.6666666666666666,12,6,6,376.716386018935,0.6623655913978495,-0.012704613629555439,0.2775414723987672,139546.7526050698,4313.909664412053,143860.66226948187,2431,136,664.0645161290323,30,1,22,25.90266293516516,0.729513888888889,35.853494623655905,1056.5860215053754,35.21953405017918,0
4586,4,0,0,31,0.0,0.0,1.0,31,850,600,250,0.7058823529411765,11,6,5,377.8963445429278,0.660394265232975,-0.010042953317497716,0.27900459691465146,139617.7687630071,4352.208889756017,143969.97765276313,2432,137,665.0645161290323,30,1,22,25.801750816058348,0.7302083333333333,35.78629032258063,1056.854838709676,35.22849462365586,0
4587,4,0,0,31,0.0,0.0,1.0,31,850,600,250,0.7058823529411765,11,6,5,377.7908273313697,0.6597670250896057,-0.009416975985890641,0.2795225641543951,139688.80298661682,4354.629689848521,144043.43267646534,2433,138,666.0645161290323,30,1,22,25.734795507522783,0.7309027777777779,35.71908602150537,1057.1236559139775,35.23745519713258,0
4588,4,0,0,31,0.0,0.0,1.0,31,850,500,350,0.5882352941176471,12,5,7,377.45593949700014,0.6578853046594982,-0.012232566338305606,0.28047221793219024,139830.9256308533,4356.002680945776,144186.92831179907,2434,139,667.0645161290323,30,1,22,25.604164019146875,0.7322916666666668,35.58467741935484,1057.6612903225807,35.255376344086024,0
4589,4,0,0,31,0.0,0.0,1.0,31,650,400,250,0.6153846153846154,9,4,5,392.615573752893,0.6578853046594982,-0.01974999899807206,0.2707937234907485,137300.2815246582,4581.245761447484,141881.52728610567,2435,140,668.0645161290323,31,0,19,27.70129312129871,0.7046370967741935,37.98828125,1048.046875,33.807963709677416,8
4590,4,0,0,31,0.0,0.0,1.0,31,700,500,200,0.7142857142857143,9,5,4,394.9070238679582,0.6567204301075269,-0.02743457846577879,0.27317795156226793,137402.64892578125,4652.254231770833,142054.9031575521,2436,141,669.0645161290323,31,0,19,27.539741679085942,0.7056451612903225,37.890625,1048.4375,33.82056451612903,0
4591,4,0,0,31,0.0,0.0,1.0,31,1050,700,350,0.6666666666666666,14,7,7,391.63508100646095,0.6545698924731183,-0.02997622078639517,0.27252119885579124,137607.4981689453,4578.384738498265,142185.88290744356,2437,142,670.0645161290323,31,0,19,27.4225407462563,0.7076612903225806,37.6953125,1049.21875,33.845766129032256,0
4592,4,0,0,31,0.0,0.0,1.0,31,550,300,250,0.5454545454545454,8,3,5,389.6759922065171,0.6517921146953405,-0.02535190979585611,0.27223291587252524,137744.14910210512,4535.117594401053,142279.26669650618,2438,143,671.0645161290323,31,0,19,27.338646324319857,0.709005376344086,37.56510416666667,1049.739583333334,33.862567204301094,0
4593,4,0,0,31,0.0,0.0,1.0,31,750,500,250,0.6666666666666666,10,5,5,398.2744061284945,0.6509856630824373,-0.026067774600857296,0.26177460761066795,135599.77425469298,4601.183912489159,140200.95816718214,2439,144,672.0645161290323,31,0,19,29.24545255656957,0.6878360215053763,39.61588541666667,1041.536458333334,33.59795026881722,4
4594,4,0,0,31,0.0,0.0,1.0,31,950,800,150,0.8421052631578947,11,8,3,396.70099970633447,0.650089605734767,-0.02941200183824999,0.26148281710462007,135701.50587293832,4566.584608289926,140268.09048122825,2440,145,673.0645161290323,31,0,19,29.184891277180707,0.6888440860215054,39.518229166666664,1041.927083333333,33.61055107526881,0
4595,4,0,0,31,0.0,0.0,1.0,31,750,600,150,0.8,9,6,3,395.1971403201619,0.6495519713261648,-0.028118487825130156,0.2607388882095843,135735.4248894586,4528.450351291238,140263.87524074985,2441,146,674.0645161290323,31,0,19,29.19022554042235,0.6891801075268817,39.485677083333336,1042.057291666667,33.61475134408603,0
4596,4,0,0,31,0.0,0.0,1.0,31,900,600,300,0.6666666666666666,12,6,6,396.43328198729074,0.6486559139784946,-0.035839608084861196,0.26255097509282355,135871.14334106445,4572.76865641276,140443.9119974772,2442,147,675.0645161290323,31,0,19,29.022652054452355,0.690524193548387,39.35546875,1042.578125,33.63155241935484,0
4597,4,0,0,31,0.0,0.0,1.0,31,350,200,150,0.5714285714285714,5,2,3,395.1992063880176,0.6479390681003584,-0.03686635944700467,0.26198305006252026,135905.08355034716,4541.916232638882,140446.99978298604,2443,148,676.0645161290323,31,0,19,29.020979020979016,0.6908602150537635,39.322916666666664,1042.708333333333,33.63575268817203,0
4598,4,0,0,31,0.0,0.0,1.0,31,1050,800,250,0.7619047619047619,13,8,5,397.4900288497056,0.646326164874552,-0.040723289436591315,0.26400457140017763,135972.9766845703,4609.580485026043,140582.55716959634,2444,149,677.0645161290323,31,0,19,28.89357053682896,0.6915322580645162,39.2578125,1042.96875,33.64415322580645,0
4599,4,1,1,31,0.03125,0.03125,0.96875,32,750,400,350,0.5333333333333333,11,4,7,386.3614497996138,0.6588541666666667,-0.050876662636033854,0.2589310526614916,136292.0955132129,4131.602323742473,140423.69783695537,2445,0,656.875,32,0,19,28.866132607819434,0.6920572916666667,38.9520202020202,1044.191919191919,32.63099747474747,0
4600,4,0,0,31,0.0,0.0,1.0,31,500,300,200,0.6,7,3,4,395.5636906688565,0.6455197132616487,-0.05049228366487679,0.2637310663078381,136108.81381564657,4567.940945095466,140676.75476074204,2446,151,679.0645161290323,31,0,19,28.808439397720658,0.6928763440860215,39.12760416666666,1043.4895833333321,33.66095430107523,0
4601,4,0,0,31,0.0,0.0,1.0,31,750,600,150,0.8,9,6,3,398.04622292341463,0.6448924731182796,-0.04970703753782746,0.2658948769128409,136176.7578125,4640.928819444444,140817.68663194444,2447,152,680.0645161290323,31,0,19,28.67598137059215,0.6935483870967742,39.0625,1043.75,33.66935483870968,0
4602,4,0,0,31,0.0,0.0,1.0,31,1050,800,250,0.7619047619047619,13,8,5,398.57377523172016,0.6441756272401433,-0.04480242036064008,0.2667583079973231,136244.7187635633,4660.714382595478,140905.43314615876,2448,153,681.0645161290323,31,0,19,28.594516504531466,0.694220430107527,38.99739583333333,1044.010416666666,33.67775537634407,0
4603,4,0,0,31,0.0,0.0,1.0,31,300,100,200,0.3333333333333333,5,1,4,398.57377523172016,0.6441756272401433,-0.04480242036064008,0.2667583079973231,136244.7187635633,4660.714382595478,140905.43314615876,2449,154,682.0645161290323,31,0,19,28.594516504531466,0.694220430107527,38.99739583333333,1044.010416666666,33.67775537634407,0
4604,4,0,0,31,0.0,0.0,1.0,31,1000,600,400,0.6,14,6,8,397.69545225543345,0.6459677419354839,-0.04710216327302119,0.26693851234651295,136346.69197930224,4644.891866048167,140991.5838453504,2450,155,683.0645161290323,31,0,19,28.515900968291565,0.695228494623656,38.89973958333333,1044.401041666666,33.69035618279568,0
4605,4,0,0,31,0.0,0.0,1.0,31,550,400,150,0.7272727272727273,7,4,3,400.5431362940092,0.6448924731182796,-0.05017206445180589,0.2696273595321417,136448.70334201385,4730.718315972213,141179.42165798607,2451,156,684.0645161290323,31,0,19,28.339980059820526,0.696236559139785,38.80208333333333,1044.7916666666663,33.7029569892473,0
4606,4,0,0,31,0.0,0.0,1.0,31,800,500,300,0.625,11,5,6,396.45324139357973,0.6443548387096775,-0.04964510502158315,0.2673893878508292,136516.7321099174,4624.500189887133,141141.2322998045,2452,157,685.0645161290323,31,0,19,28.37912202010135,0.6969086021505377,38.73697916666666,1045.0520833333321,33.711357526881685,0
4607,4,0,0,31,0.0,0.0,1.0,31,650,500,150,0.7692307692307693,8,5,3,411.02525907720496,0.6443548387096775,-0.02436678691870564,0.25317441980529354,133229.27731890965,4772.888552669783,138002.16587157943,2453,158,686.0645161290323,30,1,17,31.293397127110186,0.6670138888888889,41.901881720430104,1032.392473118279,34.41308243727597,8
4608,4,0,1,30,0.0,0.03225806451612903,0.967741935483871,31,650,500,150,0.7692307692307693,8,5,3,407.88530496294214,0.6439068100358423,-0.030104728524356084,0.25218009401771574,133368.0758794368,4679.775660480962,138047.85153991776,2454,159,687.0645161290323,30,1,17,31.234547820429416,0.6684027777777779,41.76747311827956,1032.9301075268806,34.43100358422935,0
4609,4,0,0,30,0.0,0.0,1.0,30,750,400,350,0.5333333333333333,11,4,7,412.7037882617125,0.6359674329501916,-0.004705566012368934,0.25538192821053374,133400.47260802463,5010.976080246905,138411.44868827154,2455,190,705.6666666666666,29,1,18,31.07746257954648,0.6716954022988506,41.73611111111111,1033.055555555555,35.622605363984654,0
4610,4,0,0,30,0.0,0.0,1.0,30,600,500,100,0.8333333333333334,7,5,2,412.6154372918414,0.6365900383141763,-0.0016798817363259388,0.25606934686310184,133508.10426311725,5017.500964506171,138525.60522762343,2456,191,706.6666666666666,29,1,19,30.971279621914622,0.6727729885057472,41.63194444444444,1033.472222222222,35.636973180076616,0
4611,4,0,0,30,0.0,0.0,1.0,30,850,600,250,0.7058823529411765,11,6,5,416.7245430446727,0.6370210727969349,0.0008733037753592132,0.2591212008255221,133579.8828125,5133.203125000001,138713.0859375,2457,192,707.6666666666666,29,1,19,30.79277509068924,0.6734913793103449,41.5625,1033.75,35.64655172413793,0
4612,4,0,0,30,0.0,0.0,1.0,30,750,600,150,0.8,9,6,3,413.64003137402074,0.6362547892720307,-0.0049026192075218855,0.2577029316802998,133651.6806520061,5056.737075617273,138708.41772762337,2458,193,708.6666666666666,29,1,19,30.800173494515334,0.6742097701149425,41.49305555555555,1034.0277777777771,35.65613026819921,0
4613,4,0,0,30,0.0,0.0,1.0,30,650,400,250,0.6153846153846154,9,4,5,413.2185255191121,0.6362068965517241,-0.004163309159280315,0.2576905478237278,133687.5868055556,5048.437500000006,138736.0243055556,2459,194,709.6666666666666,29,1,19,30.774912704807942,0.6745689655172413,41.458333333333336,1034.166666666667,35.6609195402299,0
4614,4,0,0,30,0.0,0.0,1.0,30,700,400,300,0.5714285714285714,10,4,6,412.4614804021557,0.6371168582375479,-0.007721230025513837,0.25746862066679416,133723.49778163587,5031.158371913586,138754.65615354947,2460,195,710.6666666666666,29,1,17,30.75833109529565,0.6749281609195401,41.423611111111114,1034.305555555556,35.665708812260554,0
4615,4,0,0,30,0.0,0.0,1.0,30,800,600,200,0.75,10,6,4,408.3926267171329,0.6383620689655173,0.0006710828246088152,0.2558352183153138,133854.4399099607,4933.033262515897,138787.4731724766,2461,196,711.6666666666666,30,0,17,30.731804996319863,0.6732638888888889,41.29704301075269,1034.8118279569894,34.493727598566316,0
4616,4,0,0,30,0.0,0.0,1.0,30,1000,800,200,0.8,12,8,4,409.67514456476323,0.6366379310344827,0.0020122030377773825,0.2576104194761118,133993.56365258983,4978.766512024498,138972.33016461434,2462,197,712.6666666666666,30,0,18,30.558710891860304,0.6746527777777779,41.162634408602145,1035.3494623655909,34.51164874551969,0
4617,4,0,0,30,0.0,0.0,1.0,30,850,500,350,0.5882352941176471,12,5,7,411.25022220375087,0.6363984674329503,0.0040228393459644796,0.25933667858446,134097.95388195154,5029.562666204172,139127.51654815572,2463,198,713.6666666666666,30,0,18,30.412989878017125,0.6756944444444445,41.06182795698924,1035.752688172042,34.525089605734735,0
4618,4,0,0,30,0.0,0.0,1.0,30,300,200,100,0.6666666666666666,4,2,2,412.40028742454996,0.6355842911877395,0.0020111586869080433,0.26030868265200674,134132.75965790826,5063.277727193872,139196.03738510213,2464,199,714.6666666666666,30,0,18,30.34822239522512,0.6760416666666667,41.0282258064516,1035.887096774192,34.52956989247307,0
4619,4,0,0,30,0.0,0.0,1.0,30,600,400,200,0.6666666666666666,8,4,4,413.5389700185468,0.635727969348659,-0.0005362394049477359,0.2612752771231931,134167.56995028316,5096.703737426272,139264.2736877094,2465,200,715.6666666666666,30,0,18,30.28374199965404,0.6763888888888889,40.99462365591397,1036.0215053763432,34.53405017921144,0
4620,4,0,0,30,0.0,0.0,1.0,30,700,500,200,0.7142857142857143,9,5,4,413.65435823137585,0.634147509578544,-0.0022781308088013486,0.2620943924668969,134272.02792591613,5108.441908024027,139380.46983394015,2466,201,716.6666666666666,30,0,18,30.17577702848744,0.6774305555555556,40.893817204301065,1036.4247311827944,34.54749103942648,0
4621,4,0,0,30,0.0,0.0,1.0,30,1200,900,300,0.75,15,9,6,417.9626679390421,0.6329022988505747,-0.0033484553899332248,0.2658352830296542,134411.36845661336,5235.786832292732,139647.1552889061,2467,202,717.6666666666666,30,0,18,29.924119680276508,0.6788194444444444,40.75940860215053,1036.962365591397,34.5654121863799,0
4622,4,0,0,30,0.0,0.0,1.0,30,900,800,100,0.8888888888888888,10,8,2,420.75242207482063,0.6350574712643678,-0.0016066338429645555,0.26837745401433577,134515.92127702612,5319.5799369869155,139835.50121401303,2468,203,718.6666666666666,30,0,18,29.74675002159453,0.6798611111111111,40.658602150537625,1037.3655913978484,34.57885304659495,0
4623,4,0,0,30,0.0,0.0,1.0,30,800,500,300,0.625,11,5,6,423.828472182716,0.6328544061302682,-0.004884249966546461,0.27140275686559023,134658.8758680556,5414.457641418087,140073.33350947368,2469,204,719.6666666666666,29,1,19,29.523367456175567,0.6842672413793103,40.520833333333336,1037.916666666667,35.790229885057485,0
4624,4,0,0,30,0.0,0.0,1.0,30,800,600,200,0.75,10,6,4,425.0295861081235,0.633955938697318,-0.005218089376505253,0.2724417775790837,134694.91705246922,5449.8649691358105,140144.78202160503,2470,205,720.6666666666666,29,1,19,29.45600303273571,0.6846264367816092,40.486111111111114,1038.055555555556,35.79501915708814,0
4625,4,0,0,30,0.0,0.0,1.0,30,400,200,200,0.5,6,2,4,426.1083299624608,0.6333812260536399,-0.0016051364365974319,0.2736757624398073,134767.01388888888,5485.069444444441,140252.0833333333,2471,206,721.6666666666666,29,1,19,29.35560460139111,0.6853448275862069,40.416666666666664,1038.3333333333333,35.804597701149426,0
4626,4,0,0,30,0.0,0.0,1.0,30,350,100,250,0.2857142857142857,6,1,5,424.0489817941964,0.6326628352490422,0.0,0.27256259844775066,134794.92752052261,5431.930353220027,140226.85787374264,2472,207,722.6666666666666,30,0,18,29.38104021054448,0.6826388888888889,40.38978494623656,1038.4408602150538,34.6146953405018,0
4627,4,0,0,30,0.0,0.0,1.0,30,950,700,250,0.7368421052631579,12,7,5,422.2894315141484,0.6322318007662835,-0.0022728252900336976,0.2722164317074942,134899.62938273224,5393.33756070067,140292.9669434329,2473,208,723.6666666666666,30,0,18,29.321656531677228,0.6836805555555555,40.28897849462366,1038.8440860215064,34.62813620071688,0
4628,4,0,0,30,0.0,0.0,1.0,30,550,400,150,0.7272727272727273,7,4,3,421.8965104622537,0.6322796934865901,-0.005881845623113113,0.2722253777857449,134934.5390363049,5385.682232049968,140320.22126835486,2474,209,724.6666666666666,30,0,19,29.29684131090988,0.6840277777777777,40.25537634408603,1038.9784946236568,34.63261648745523,0
4629,4,0,0,30,0.0,0.0,1.0,30,850,600,250,0.7058823529411765,11,6,5,420.301111064274,0.6300766283524905,-0.00801240630653921,0.2733016804550718,135213.97885593717,5366.117108914338,140580.0959648515,2475,210,725.6666666666666,30,0,19,29.058165331265613,0.6868055555555554,39.98655913978495,1040.0537634408608,34.66845878136203,0
4630,4,0,0,30,0.0,0.0,1.0,30,400,200,200,0.5,6,2,4,420.301111064274,0.6300766283524905,-0.00801240630653921,0.2733016804550718,135213.97885593717,5366.117108914338,140580.0959648515,2476,211,726.6666666666666,30,0,19,29.058165331265613,0.6868055555555554,39.98655913978495,1040.0537634408608,34.66845878136203,0
4631,4,0,0,30,0.0,0.0,1.0,30,450,200,250,0.4444444444444444,7,2,5,421.09695864669726,0.6312739463601533,-0.011082396519791482,0.2740848917549868,135248.92915727265,5390.582545670035,140639.5117029427,2477,212,727.6666666666666,30,0,19,29.00245509755783,0.6871527777777777,39.95295698924732,1040.1881720430117,34.67293906810039,0
4632,4,0,0,30,0.0,0.0,1.0,30,800,600,200,0.75,10,6,4,420.27756077692965,0.6315134099616858,-0.009345391903531564,0.27381719868799975,135283.88397502605,5371.356153890627,140655.2401289167,2478,213,728.6666666666666,30,0,19,28.988748923341948,0.6875,39.91935483870968,1040.3225806451617,34.677419354838726,0
4633,4,0,0,30,0.0,0.0,1.0,30,750,400,350,0.5333333333333333,11,4,7,438.0816343853477,0.6320402298850575,0.00843416689074128,0.27108579006307937,133400.47260802463,5735.974093022948,139136.4467010476,2479,214,729.6666666666666,29,1,19,30.4220444563951,0.6716954022988506,41.73611111111111,1033.055555555555,35.622605363984654,6
4634,4,0,0,30,0.0,0.0,1.0,30,700,500,200,0.7142857142857143,9,5,4,436.14660287220227,0.6318007662835249,0.0056299496040317365,0.2706915243027206,133510.66745057396,5646.083391400539,139156.7508419745,2480,215,730.6666666666666,27,3,19,30.36072114230862,0.6793981481481481,41.629464285714285,1033.4821428571427,38.2771164021164,0
4635,4,0,0,30,0.0,0.0,1.0,30,800,700,100,0.875,9,7,2,438.8643795838566,0.6337164750957854,0.005062137133534872,0.2729445698271307,133587.57451548323,5725.365601969943,139312.94011745317,2481,216,731.6666666666666,27,3,19,30.212831677942518,0.6801697530864198,41.55505952380952,1033.7797619047615,38.28813932980598,0
4636,4,0,1,29,0.0,0.03333333333333333,0.9666666666666667,30,400,100,300,0.25,7,1,6,437.8325699561917,0.6327586206896552,0.010842480663239229,0.27282086631815683,133657.87102407846,5703.953833069092,139361.82485714756,2482,217,732.6666666666666,28,2,19,30.168530869343705,0.6774553571428572,41.48706896551724,1034.0517241379307,36.93041871921181,0
4637,4,0,0,29,0.0,0.0,1.0,29,650,500,150,0.7692307692307693,8,5,3,442.82976845819167,0.6316707717569786,0.00441641317778263,0.27598422071892137,133664.50372466692,6038.124247094667,139702.6279717616,2483,218,729.7241379310345,27,2,20,30.032648582529855,0.6809413580246915,41.48065476190476,1034.0773809523807,38.29916225749558,0
4638,4,0,0,29,0.0,0.0,1.0,29,400,200,200,0.5,6,2,4,443.1727023707747,0.6320812807881773,0.002014098690835908,0.27677389525420076,133741.455078125,6054.112413194443,139795.56749131944,2484,219,730.7241379310345,27,2,18,29.946080899630736,0.681712962962963,41.40625,1034.375,38.31018518518518,0
4639,4,1,0,30,0.03333333333333333,0.0,1.0,30,900,700,200,0.7777777777777778,11,7,4,428.5019567466656,0.6508141762452108,0.00022656864105075059,0.2702598955543929,134103.95455558854,5492.761386907118,139596.71594249565,2485,0,707.3333333333334,28,2,20,29.960234891570735,0.6819196428571429,41.05603448275862,1035.7758620689651,36.99199507389161,0
4640,4,0,0,30,0.0,0.0,1.0,30,400,200,200,0.5,6,2,4,429.7821833983854,0.649808429118774,0.00039759593157651096,0.27134234170773713,134141.16172876203,5530.296274276653,139671.4580030387,2486,1,708.3333333333334,28,2,20,29.889620896902453,0.6822916666666667,41.020114942528735,1035.919540229885,36.997126436781606,0
4641,4,0,0,30,0.0,0.0,1.0,30,600,300,300,0.5,9,3,6,429.7188023042879,0.6506704980842912,-0.006230356812719551,0.27185368440513374,134215.59155766948,5534.9926509446495,139750.58420861413,2487,2,709.3333333333334,28,2,20,29.81633619892771,0.6830357142857144,40.94827586206897,1036.2068965517244,37.00738916256159,0
4642,4,1,0,31,0.03225806451612903,0.0,1.0,31,650,400,250,0.6153846153846154,9,4,5,415.8122957476084,0.6728494623655914,-0.010282202231532755,0.26575189379550695,134588.05035341525,4993.091268661651,139581.14162207692,2488,0,687.4193548387096,28,3,22,29.802455460168012,0.6867559523809523,40.589080459770116,1037.6436781609195,37.058702791461414,0
4643,4,0,0,31,0.0,0.0,1.0,31,700,500,200,0.7142857142857143,9,5,4,417.26410868997664,0.6726702508960574,-0.013308740448298995,0.2669529368527635,134625.32461768392,5034.863216739322,139660.18783442324,2489,1,688.4193548387096,28,3,22,29.72737551340625,0.6871279761904763,40.553160919540225,1037.7873563218386,37.063834154351376,0
4644,4,0,0,31,0.0,0.0,1.0,31,800,400,400,0.5,12,4,8,419.9350394510581,0.6717741935483871,-0.010472933760702796,0.2694893956548265,134737.17837561105,5116.172463337295,139853.35083894836,2490,2,689.4193548387096,28,3,22,29.545795276317,0.6882440476190477,40.445402298850574,1038.2183908045977,37.07922824302135,0
4645,4,0,0,31,0.0,0.0,1.0,31,750,600,150,0.8,9,6,3,419.4058498976698,0.6706093189964157,-0.007284511040587027,0.2694263179742632,134774.47328329372,5105.040502378121,139879.51378567185,2491,3,690.4193548387096,28,3,22,29.522104607721037,0.6886160714285714,40.40948275862069,1038.3620689655174,37.08435960591134,0
4646,4,0,2,29,0.0,0.06451612903225806,0.935483870967742,31,550,300,250,0.5454545454545454,8,3,5,413.40089469038526,0.6697132616487456,-0.06236674697959821,0.25730403512334676,133615.77932098758,4847.376543209867,138463.15586419744,2492,4,691.4193548387096,29,2,20,30.842512985849897,0.6738505747126438,41.52777777777777,1033.8888888888882,35.65134099616856,6
4647,4,0,0,29,0.0,0.0,1.0,29,950,500,450,0.5263157894736842,14,5,9,429.0455159370882,0.6239737274220033,-0.033614815454183766,0.26574214514242905,133435.10794441137,5649.946946426204,139085.05489083758,2493,228,739.7241379310345,28,1,20,30.620451490288772,0.6752232142857143,41.70258620689655,1033.1896551724135,36.89963054187191,0
4648,4,0,0,29,0.0,0.0,1.0,29,850,600,250,0.7058823529411765,11,6,5,427.536541705155,0.6217159277504105,-0.02628392194231033,0.26617597596482206,133626.03635204065,5626.0078535972225,139252.04420563788,2494,229,740.7241379310345,27,2,22,30.46680099788908,0.6805555555555556,41.51785714285713,1033.92857142857,38.29365079365074,0
4649,4,0,0,29,0.0,0.0,1.0,29,800,700,100,0.875,9,7,2,428.89349312255297,0.6208949096880131,-0.02340521582109245,0.26785612495012256,133741.45507812497,5672.167968749998,139413.62304687497,2495,230,741.7241379310345,27,2,20,30.315332326283997,0.681712962962963,41.40625,1034.3749999999998,38.310185185185176,0
4650,4,0,0,29,0.0,0.0,1.0,29,400,300,100,0.75,5,3,2,428.89349312255297,0.6208949096880131,-0.02340521582109245,0.26785612495012256,133741.45507812497,5672.167968749998,139413.62304687497,2496,231,742.7241379310345,27,2,20,30.315332326283997,0.681712962962963,41.40625,1034.3749999999998,38.310185185185176,0
4651,4,0,0,29,0.0,0.0,1.0,29,900,700,200,0.7777777777777778,11,7,4,427.2241038904299,0.6216133004926108,-0.02089748071388553,0.26728416786402986,133806.48296092608,5633.070955542336,139439.5539164684,2497,232,743.7241379310345,28,1,20,30.29295699671342,0.6789434523809523,41.343390804597696,1034.6264367816086,36.950944170771734,0
4652,4,0,0,29,0.0,0.0,1.0,29,700,500,200,0.7142857142857143,9,5,4,431.90909798967925,0.6223316912972086,-0.02541086807699844,0.270760768739744,133880.81989447083,5764.868831747915,139645.68872621874,2498,233,744.7241379310345,28,1,20,30.096834652228235,0.6796875,41.27155172413793,1034.913793103448,36.96120689655171,0
4653,4,0,0,29,0.0,0.0,1.0,29,550,400,150,0.7272727272727273,7,4,3,431.90909798967925,0.6223316912972086,-0.02541086807699844,0.270760768739744,133880.81989447083,5764.868831747915,139645.68872621874,2499,234,745.7241379310345,28,1,20,30.096834652228235,0.6796875,41.27155172413793,1034.913793103448,36.96120689655171,0
4654,4,0,0,29,0.0,0.0,1.0,29,450,400,50,0.8888888888888888,5,4,1,431.0344279576844,0.6219211822660098,-0.02214936945129109,0.27075876664647897,133955.17747142943,5747.858658673522,139703.03613010296,2500,235,746.7241379310345,28,1,21,30.044529262086506,0.6804315476190477,41.199712643678154,1035.2011494252865,36.97146962233166,0
4655,4,1,1,29,0.03333333333333333,0.03333333333333333,0.9666666666666667,30,900,600,300,0.6666666666666666,12,6,6,417.5488171786414,0.6397988505747126,-0.03180538801769206,0.2642350911764073,134226.7578125,5209.244791666665,139436.00260416666,2501,0,722.8,29,1,21,30.120375954965812,0.6799568965517242,40.9375,1036.25,35.73275862068966,0
4656,4,0,0,29,0.0,0.0,1.0,29,500,400,100,0.8,6,4,2,427.53319471151207,0.6237684729064039,-0.024474721573729985,0.26937581009445605,134066.75254326852,5663.597403884257,139730.34994715278,2502,237,748.7241379310345,28,1,21,30.022775619681845,0.6815476190476191,41.0919540229885,1035.6321839080454,36.98686371100162,0
4657,4,0,0,29,0.0,0.0,1.0,29,800,500,300,0.625,11,5,6,431.3357075115763,0.6229474548440066,-0.03099240729053121,0.2728765896994289,134215.59155766948,5778.395428722425,139993.98698639192,2503,238,749.7241379310345,28,1,21,29.774449990756146,0.6830357142857142,40.94827586206897,1036.2068965517244,37.00738916256159,0
4658,4,0,0,29,0.0,0.0,1.0,29,350,100,250,0.2857142857142857,6,1,5,433.0915274782218,0.6226395730706076,-0.03220302530647379,0.2748245708667874,134327.27500743172,5835.20094299116,140162.47595042287,2504,239,750.7241379310345,28,1,21,29.61653961653962,0.6841517857142856,40.84051724137932,1036.6379310344835,37.02278325123155,0
4659,4,1,0,30,0.03333333333333333,0.0,1.0,30,750,400,350,0.5333333333333333,11,4,7,422.06410363860573,0.6343869731800766,-0.03163552479815479,0.27057791914719853,134699.88862878195,5370.58334159071,140070.47197037266,2505,0,726.6666666666666,28,2,22,29.527970011534016,0.6878720238095237,40.481321839080465,1038.0747126436788,37.074096880131385,0
4660,4,0,0,30,0.0,0.0,1.0,30,850,500,350,0.5882352941176471,12,5,7,417.3532138505074,0.6343869731800766,-0.011737089201877993,0.2625627180806357,134010.95920138893,5185.980902777783,139196.94010416672,2506,1,727.6666666666666,29,1,18,30.34247149564051,0.677801724137931,41.145833333333336,1035.416666666667,35.704022988505756,3
4661,4,0,0,30,0.0,0.0,1.0,30,1000,700,300,0.7,13,7,6,418.6339721264505,0.6350095785440614,-0.009305443818718118,0.2641431610929836,134118.8368055555,5229.340277777774,139348.17708333328,2507,2,728.6666666666666,29,1,18,30.20079109680879,0.6788793103448276,41.041666666666664,1035.833333333333,35.71839080459769,0
4662,4,0,0,30,0.0,0.0,1.0,30,350,100,250,0.2857142857142857,6,1,5,419.03811623845775,0.6345306513409962,-0.006260892881083446,0.26465751981563557,134154.80565200615,5243.195408950615,139398.00106095677,2508,3,729.6666666666666,29,1,18,30.15414823256021,0.6792385057471264,41.00694444444444,1035.9722222222222,35.72318007662835,0
4663,4,0,0,30,0.0,0.0,1.0,30,850,600,250,0.7058823529411765,11,6,5,417.5488171786413,0.6327107279693487,-0.0074118750837690595,0.26423509117640737,134226.75781250003,5209.244791666666,139436.0026041667,2509,4,730.6666666666666,29,1,19,30.120375954965816,0.6799568965517242,40.9375,1036.2500000000002,35.732758620689665,0
4664,4,0,0,30,0.0,0.0,1.0,30,300,100,200,0.3333333333333333,5,1,4,419.85908267752546,0.6318007662835249,-0.005440900562851958,0.26595827461287713,134262.74112654311,5274.286265432086,139537.0273919752,2510,5,731.6666666666666,29,1,19,30.024345573126066,0.680316091954023,40.90277777777777,1036.3888888888882,35.737547892720286,0
4665,4,0,0,30,0.0,0.0,1.0,30,650,400,250,0.6153846153846154,9,4,5,418.3174080067335,0.6309865900383141,-0.007568653717347162,0.2657650596400223,134370.7200038578,5241.9222608024465,139612.64226466024,2511,6,732.6666666666666,29,1,19,29.955765795936614,0.6813936781609196,40.7986111111111,1036.8055555555538,35.7519157088122,0
4666,4,1,1,30,0.03225806451612903,0.03225806451612903,0.967741935483871,31,650,500,150,0.7692307692307693,8,5,3,408.3135326174424,0.6477598566308244,-0.015187145226031928,0.2616933952202908,134690.26630607567,4799.171688923551,139489.43799499923,2512,0,710.0,30,1,20,29.894471060468728,0.6815972222222223,40.49059139784945,1038.0376344086008,34.60125448028669,0
4667,4,0,0,30,0.0,0.0,1.0,30,1050,900,150,0.8571428571428571,12,9,3,417.05982564933475,0.6285919540229885,-0.009219858156028327,0.267068387067479,134658.8758680556,5232.1614583333385,139891.03732638893,2513,8,734.6666666666666,29,1,20,29.698999732369874,0.6842672413793104,40.520833333333336,1037.916666666667,35.790229885057485,0
4668,4,0,1,29,0.0,0.03333333333333333,0.9666666666666667,30,950,800,150,0.8421052631578947,11,8,3,423.96091194536166,0.6293103448275862,-0.0027114493133910678,0.2474295613206391,131190.39231414034,5123.919672794539,136314.3119869349,2514,9,735.6666666666666,30,0,18,33.026108632904744,0.6465277777777778,43.884408602150536,1024.4623655913977,34.14874551971325,6
4669,4,0,1,28,0.0,0.034482758620689655,0.9655172413793104,29,600,300,300,0.5,9,3,6,432.64457997872734,0.618431855500821,0.00785931820414576,0.25130206454083526,131008.0078125,5535.980902777778,136543.98871527778,2515,250,761.7241379310345,29,0,18,32.989502781169456,0.6476293103448276,44.0625,1023.75,35.30172413793103,0
4670,4,1,1,28,0.034482758620689655,0.034482758620689655,0.9655172413793104,29,850,400,450,0.47058823529411764,13,4,9,426.0006439896532,0.6382389162561576,-0.021315084629300207,0.24882080369846962,131221.3758680555,5380.078124999995,136601.4539930555,2516,0,726.8965517241379,29,0,18,32.94233767114003,0.6497844827586208,43.854166666666664,1024.583333333333,35.330459770114935,0
4671,4,0,0,28,0.0,0.0,1.0,28,750,700,50,0.9333333333333333,8,7,1,436.47329898954456,0.6177248677248677,-0.00959263862716031,0.2536956548612963,131033.7499174263,5838.546621086002,136872.2965385123,2517,252,753.8571428571429,28,0,18,32.86527037140986,0.6510416666666667,44.03735632183908,1023.8505747126434,36.56609195402298,0
4672,4,0,0,28,0.0,0.0,1.0,28,500,400,100,0.8,6,4,2,437.3462213425708,0.6188822751322751,-0.017579103460713785,0.25493386851604133,131144.10186699024,5871.075480578664,137015.1773475689,2518,253,754.8571428571429,28,0,18,32.73045541684201,0.6521577380952381,43.92959770114942,1024.2816091954014,36.58148604269291,0
4673,4,0,0,28,0.0,0.0,1.0,28,800,600,200,0.75,10,6,4,438.44203480934334,0.6205908289241622,-0.015683839435942648,0.25630890100493725,131254.50026423566,5909.498034746986,137163.99829898265,2519,254,755.8571428571429,28,0,18,32.58991166573192,0.6532738095238095,43.82183908045977,1024.7126436781605,36.59688013136287,0
4674,4,0,0,28,0.0,0.0,1.0,28,600,500,100,0.8333333333333334,7,5,2,437.9007204706196,0.6212522045855379,-0.019454123112659705,0.25648470770421994,131328.12499999997,5901.736111111113,137229.8611111111,2520,255,756.8571428571429,28,0,18,32.528794037940386,0.6540178571428572,43.75,1024.9999999999998,36.60714285714285,0
4675,4,0,0,28,0.0,0.0,1.0,28,600,400,200,0.6666666666666666,8,4,4,437.44738693992963,0.6211970899470899,-0.01669336269896915,0.25646566194054204,131364.9451091623,5893.050394702062,137257.99550386437,2521,256,757.8571428571429,28,0,18,32.50291987853304,0.6543898809523809,43.71408045977011,1025.143678160919,36.61227422003282,0
4676,4,0,0,28,0.0,0.0,1.0,28,700,500,200,0.7142857142857143,9,5,4,450.2827837137268,0.621031746031746,-0.02775538988515036,0.2529718650182508,129713.1494418022,6081.51960298588,135794.66904478808,2522,257,758.8571428571429,28,0,18,33.86312881993418,0.6376488095238095,45.33045977011495,1018.6781609195411,36.38136288998361,8
4677,4,0,0,28,0.0,0.0,1.0,28,850,700,150,0.8235294117647058,10,7,3,447.05329583407683,0.6220238095238095,-0.02803964225284039,0.25162714079803755,129786.34066587398,6004.282269784653,135790.62293565864,2523,258,759.8571428571429,28,0,19,33.87032336905433,0.6383928571428571,45.258620689655174,1018.9655172413795,36.39162561576355,0
4678,4,1,0,29,0.034482758620689655,0.0,1.0,29,500,300,200,0.6,7,3,4,434.8220769789395,0.6401888341543513,-0.03211629479377964,0.24639917695473265,130050.00000000012,5509.722222222237,135559.72222222236,2524,0,734.6206896551724,29,0,20,33.912037037037045,0.6379310344827586,45.00000000000001,1020.0000000000009,35.17241379310348,0
4679,4,0,0,29,0.0,0.0,1.0,29,400,300,100,0.75,5,3,2,433.2882430825257,0.6403940886699507,-0.02956871911124881,0.24620021051255359,130156.27170138893,5479.03645833334,135635.30815972228,2525,1,735.6206896551724,29,0,20,33.842469715530136,0.6390086206896551,44.895833333333336,1020.4166666666671,35.186781609195414,0
4680,4,1,0,30,0.03333333333333333,0.0,1.0,30,500,300,200,0.6,7,3,4,420.5964355778456,0.6599137931034483,-0.02744405182567755,0.2414000446943673,130546.305941358,4981.505594135798,135527.8115354938,2526,0,712.0666666666667,29,1,17,33.768234121591,0.6429597701149425,44.513888888888886,1021.9444444444442,35.23946360153256,0
4681,4,1,0,31,0.03225806451612903,0.0,1.0,31,900,600,300,0.6666666666666666,12,6,6,408.1746141746762,0.667831541218638,-0.024559009843095225,0.2363067176967154,130880.75798141393,4484.440578390552,135365.19855980447,2527,0,690.0645161290323,30,1,20,33.745183677043656,0.6434027777777779,44.18682795698924,1023.2526881720422,34.10842293906807,0
4682,4,1,1,31,0.03125,0.03125,0.96875,32,450,300,150,0.6666666666666666,6,3,3,394.17806103710734,0.6822496639784946,-0.03004257752923234,0.23007366351928477,131194.6953667534,3942.8141276041565,135137.50949435757,2528,0,669.46875,31,1,21,33.78452804609387,0.6438172043010754,43.88020833333333,1024.479166666666,33.04771505376342,0
4683,4,1,1,31,0.03125,0.03125,0.96875,32,550,500,50,0.9090909090909091,6,5,1,395.75504133875427,0.6852318548387097,-0.02955072417735982,0.23159761564143752,131294.76123385964,3992.1127319335988,135286.87396579323,2529,0,670.3125,31,1,22,33.64261741413629,0.6448252688172043,43.782552083333336,1024.869791666667,33.06031586021506,0
4684,4,0,0,31,0.0,0.0,1.0,31,600,200,400,0.3333333333333333,10,2,8,405.82491164982355,0.6703405017921147,-0.021479976293285574,0.23642093476847512,131121.55306971894,4442.478537981258,135564.0316077002,2530,2,692.9354838709677,30,1,22,33.560531496062985,0.6458333333333335,43.9516129032258,1024.193548387096,34.13978494623653,0
4685,4,0,0,31,0.0,0.0,1.0,31,450,200,250,0.4444444444444444,7,2,5,405.6349108631717,0.6690860215053763,-0.0204782201980096,0.23652208536252697,131155.97043372053,4440.288075210985,135596.25850893153,2531,3,693.9354838709677,30,1,22,33.53043126448847,0.6461805555555556,43.91801075268816,1024.327956989246,34.14426523297487,0
4686,4,0,0,31,0.0,0.0,1.0,31,950,700,250,0.7368421052631579,12,7,5,406.42649359623516,0.6686379928315412,-0.02419989673356393,0.23719622773281002,131190.3923141401,4463.850228350067,135654.24254249016,2532,4,694.9354838709677,30,1,22,33.47519242543514,0.6465277777777779,43.88440860215052,1024.4623655913958,34.148745519713195,0
4687,4,0,0,31,0.0,0.0,1.0,31,650,500,150,0.7692307692307693,8,5,3,405.0962644450424,0.6668458781362007,-0.01621152829190864,0.23705748399028714,131293.68505390768,4437.31627211235,135731.00132602002,2533,5,695.9354838709677,30,1,22,33.40437158469946,0.6475694444444446,43.78360215053762,1024.865591397847,34.16218637992824,0
4688,4,0,0,31,0.0,0.0,1.0,31,850,600,250,0.7058823529411765,11,6,5,405.0962644450424,0.6668458781362007,-0.01621152829190864,0.23705748399028714,131293.68505390768,4437.31627211235,135731.00132602002,2534,6,696.9354838709677,30,1,22,33.40437158469946,0.6475694444444446,43.78360215053762,1024.865591397847,34.16218637992824,0
4689,4,0,0,31,0.0,0.0,1.0,31,450,200,250,0.4444444444444444,7,2,5,405.0962644450424,0.6668458781362007,-0.01621152829190864,0.23705748399028714,131293.68505390768,4437.31627211235,135731.00132602002,2535,7,697.9354838709677,30,1,22,33.40437158469946,0.6475694444444446,43.78360215053762,1024.865591397847,34.16218637992824,0
4690,4,0,0,31,0.0,0.0,1.0,31,850,600,250,0.7058823529411765,11,6,5,403.4651916833383,0.6634408602150538,-0.004709144787179209,0.23738187183774503,131500.39247673136,4411.166211411719,135911.55868814306,2536,8,698.9354838709677,30,1,22,33.236415061372476,0.6496527777777779,43.581989247311824,1025.672043010752,34.189068100358405,0
4691,4,3,2,32,0.08823529411764706,0.058823529411764705,0.9411764705882353,34,500,400,100,0.8,6,4,2,372.7868295285085,0.7074792038027332,-0.01934615600291556,0.22345907667165998,132208.88600538237,3057.1462898884874,135266.03229527085,2537,0,638.1764705882352,33,1,20,33.307515093740086,0.6489898989898991,42.89215686274509,1028.4313725490183,31.16458704693995,0
4692,4,0,0,32,0.0,0.0,1.0,32,850,700,150,0.8235294117647058,10,7,3,389.3221272856658,0.6793094758064516,-0.005996514575411949,0.23165547392789615,131929.39758300784,3872.606743706597,135802.00432671444,2538,1,679.0625,31,1,21,33.16487114490916,0.6512096774193548,43.1640625,1027.3437500000002,33.14012096774194,0
4693,4,0,0,32,0.0,0.0,1.0,32,750,500,250,0.6666666666666666,10,5,5,390.24293753816374,0.6790154569892474,-0.011166371008616727,0.23261308633317157,131996.2904188369,3902.1240234375077,135898.4144422744,2539,2,680.0625,31,1,21,33.07357661767189,0.6518817204301075,43.098958333333336,1027.6041666666674,33.148521505376365,0
4694,4,0,1,31,0.0,0.03125,0.96875,32,450,400,50,0.8888888888888888,5,4,1,391.1801852372724,0.6783014112903226,-0.01184989864436825,0.2333775662946175,132029.74319458008,3929.4838799370677,135959.22707451714,2540,3,681.0625,31,1,21,33.015673170319694,0.6522177419354838,43.06640625,1027.734375,33.15272177419355,0
4695,4,1,1,31,0.03125,0.03125,0.96875,32,450,300,150,0.6666666666666666,6,3,3,388.09292804024943,0.6859459005376345,-0.016509658011399697,0.23194501641769658,132096.66146172426,3853.156026204432,135949.8174879287,2541,0,681.625,31,1,21,33.02736436563225,0.6528897849462365,43.001302083333336,1027.9947916666672,33.161122311827974,0
4696,4,0,0,31,0.0,0.0,1.0,31,850,700,150,0.8235294117647058,10,7,3,399.3626754456685,0.671236559139785,-0.014468225194464113,0.23753532516974663,131914.2950955313,4336.329163776161,136250.62425930746,2542,5,704.6129032258065,30,1,21,32.92228182650791,0.6538194444444445,43.178763440860216,1027.2849462365593,34.24283154121864,0
4697,4,0,0,31,0.0,0.0,1.0,31,650,300,350,0.46153846153846156,10,3,7,402.61495310847954,0.6706093189964157,-0.013044982406993366,0.240124331627725,132017.87236963812,4430.473898716616,136448.34626835474,2543,6,705.6129032258065,30,1,21,32.73389135931642,0.6548611111111111,43.07795698924731,1027.6881720430108,34.25627240143369,0
4698,4,0,0,31,0.0,0.0,1.0,31,850,600,250,0.7058823529411765,11,6,5,387.061744629635,0.6697132616487456,0.01022167437250987,0.22769868278175004,131495.0074089897,3979.3373955620564,135474.34480455177,2544,7,706.6129032258065,31,0,21,33.66248254411578,0.6468413978494624,43.58723958333333,1025.6510416666658,33.08551747311825,6
4699,4,0,0,31,0.0,0.0,1.0,31,1000,600,400,0.6,14,6,8,389.09173009549926,0.6703405017921147,0.0154557101399444,0.2296952752721071,131628.58963012695,4043.1191338433155,135671.70876397027,2545,8,707.6129032258065,31,0,19,33.47515649452269,0.6481854838709677,43.45703125,1026.171875,33.102318548387096,0
4700,4,1,1,31,0.03125,0.03125,0.96875,32,900,800,100,0.8888888888888888,10,8,2,380.3406965413741,0.6831737231182796,0.004435756421285575,0.22639592156233782,131943.58555568295,3636.703046882959,135580.2886025659,2546,0,686.46875,32,0,19,33.38121133915038,0.6487630208333335,43.15025252525252,1027.398989898989,32.106218434343404,0
4701,4,0,0,31,0.0,0.0,1.0,31,1300,1000,300,0.7692307692307693,16,10,6,393.81006403443473,0.6690860215053763,0.009677828046901649,0.2349465484069382,132029.74319458008,4198.92832438151,136228.67151896158,2547,10,709.6129032258065,31,0,19,32.94810274927151,0.6522177419354838,43.06640625,1027.734375,33.15272177419355,0
4702,4,0,0,31,0.0,0.0,1.0,31,700,500,200,0.7142857142857143,9,5,4,392.283063821575,0.6701612903225806,0.004967807301369254,0.23465659635872393,132130.1269531249,4166.482204861096,136296.609157986,2548,11,710.6129032258065,31,0,19,32.88584937521107,0.653225806451613,42.96874999999999,1028.1249999999993,33.16532258064514,0
4703,4,0,0,31,0.0,0.0,1.0,31,1100,700,400,0.6363636363636364,15,7,8,388.3654187670421,0.6702508960573477,0.008886384148258708,0.23293078533339895,132230.5488586425,4070.754496256495,136301.303354899,2549,12,711.6129032258065,31,0,19,32.88509621471072,0.654233870967742,42.87109374999999,1028.5156249999993,33.177923387096754,0
4704,4,0,0,31,0.0,0.0,1.0,31,850,500,350,0.5882352941176471,12,5,7,391.0913115207839,0.6674731182795699,0.010188046189075095,0.23539943906692712,132364.50407240118,4153.321499294698,136517.82557169587,2550,13,712.6129032258065,31,0,19,32.67970496435953,0.6555779569892474,42.740885416666664,1029.0364583333328,33.19472446236558,0
4705,4,0,0,31,0.0,0.0,1.0,31,650,500,150,0.7692307692307693,8,5,3,389.76684305764104,0.6683691756272402,0.00705147823957919,0.23501959529905816,132431.50711059567,4123.482089572482,136554.98920016814,2551,14,713.6129032258065,31,0,19,32.64613641155387,0.65625,42.67578125,1029.2968749999998,33.20312499999999,0
4706,4,0,0,31,0.0,0.0,1.0,31,900,500,400,0.5555555555555556,13,5,8,379.4811798324474,0.6685483870967742,0.011218778408743857,0.23045545479770943,132699.68880547408,3871.4068942599743,136571.09569973405,2552,15,714.6129032258065,31,0,16,32.64051244787059,0.6589381720430108,42.41536458333333,1030.3385416666658,33.23672715053761,1
4707,4,0,0,31,0.0,0.0,1.0,31,950,800,150,0.8421052631578947,11,8,3,379.5895189292104,0.6698924731182796,0.011215943594237165,0.2309339771195003,132766.77661471892,3879.375372992618,136646.15198771155,2553,16,715.6129032258065,31,0,16,32.57014634659928,0.6596102150537635,42.350260416666664,1030.598958333333,33.24512768817203,0
4708,4,0,0,31,0.0,0.0,1.0,31,400,200,200,0.5,6,2,4,379.6555806852287,0.6708781362007168,0.009909260187346947,0.23138823959083574,132833.88137817386,3886.2248738606777,136720.10625203454,2554,17,716.6129032258065,31,0,16,32.50086838448907,0.6602822580645162,42.28515625,1030.8593750000002,33.253528225806456,0
4709,4,0,0,31,0.0,0.0,1.0,31,650,400,250,0.6153846153846154,9,4,5,379.00829841254756,0.668100358422939,0.013292554296255643,0.23182430360816933,132968.14176771388,3879.2058308919377,136847.34759860582,2555,18,717.6129032258065,31,0,17,32.38240647224676,0.6616263440860215,42.15494791666667,1031.3802083333344,33.2703293010753,0
4710,4,0,0,31,0.0,0.0,1.0,31,900,700,200,0.7777777777777778,11,7,4,380.85945711926104,0.667921146953405,0.013548061422220758,0.233585939490172,133068.8815646701,3936.108398437495,137004.9899631076,2556,19,718.6129032258065,31,0,17,32.23329968029614,0.6626344086021505,42.057291666666664,1031.770833333333,33.28293010752687,0
4711,4,0,0,31,0.0,0.0,1.0,31,600,300,300,0.5,9,3,6,381.7809312462064,0.6688172043010753,0.010680777449883161,0.23436203564106758,133102.46997409387,3963.196987575946,137065.6669616698,2557,20,719.6129032258065,31,0,17,32.175736067297585,0.662970430107527,42.02473958333333,1031.9010416666658,33.28713037634406,0
4712,4,0,0,31,0.0,0.0,1.0,31,800,500,300,0.625,11,5,6,381.8727783146197,0.667741935483871,0.013801634061391344,0.23505336851539638,133203.2606336806,3973.339843750006,137176.6004774306,2558,21,720.6129032258065,31,0,19,32.0719811638076,0.663978494623656,41.927083333333336,1032.291666666667,33.29973118279571,0
4713,4,0,0,31,0.0,0.0,1.0,31,600,400,200,0.6666666666666666,8,4,4,380.47073121411216,0.6673835125448029,0.012237641324822413,0.2344018980417013,133236.86599731445,3938.5455661349833,137175.41156344942,2559,22,721.6129032258065,31,0,19,32.07437360743262,0.6643145161290323,41.89453125,1032.421875,33.303931451612904,0
4714,4,1,0,32,0.03125,0.0,1.0,32,900,700,200,0.7777777777777778,11,7,4,371.86898075967076,0.6827956989247312,0.02292226428920352,0.23137258468542446,133602.72548719533,3536.5418707274953,137139.26735792283,2560,0,700.03125,32,0,20,31.929093388698917,0.6653645833333333,41.54040404040405,1033.838383838385,32.30744949494953,0
4715,4,0,0,32,0.0,0.0,1.0,32,550,300,250,0.5454545454545454,8,3,5,370.5939650535584,0.6821236559139785,0.023162841796875,0.2313952562285634,133733.2925211714,3512.150227017661,137245.44274818906,2561,1,701.03125,32,0,16,31.831105550130214,0.6666666666666666,41.41414141414142,1034.3434343434349,32.32323232323234,0
4716,4,0,0,32,0.0,0.0,1.0,32,850,700,150,0.8235294117647058,10,7,3,371.3858849149297,0.6812415994623656,0.026810234346393402,0.23209493173974233,133765.9442435722,3535.756714876048,137301.70095844823,2562,2,702.03125,32,0,16,31.777889661906524,0.6669921875,41.382575757575765,1034.4696969696977,32.32717803030305,0
4717,4,0,0,32,0.0,0.0,1.0,32,600,200,400,0.3333333333333333,10,2,8,373.0500612018718,0.682543682795699,0.0314558931185942,0.23375522183566846,133863.92332415073,3587.5889577594294,137451.51228191017,2563,3,703.03125,32,0,17,31.636621522694004,0.66796875,41.287878787878796,1034.848484848486,32.339015151515184,0
4718,4,0,0,32,0.0,0.0,1.0,32,950,600,350,0.631578947368421,13,6,7,373.3246899403677,0.6817456317204301,0.02653905964141945,0.23455089140391386,133961.9382747934,3602.2598140495916,137564.198088843,2564,4,704.03125,32,0,17,31.53128430296378,0.6689453125,41.19318181818182,1035.227272727273,32.35085227272728,0
4719,4,0,0,32,0.0,0.0,1.0,32,950,800,150,0.8421052631578947,11,8,3,373.4342811823539,0.6817456317204301,0.00238163972286376,0.24058291552758235,134878.47421500363,3673.6492130905126,138552.12342809414,2565,5,705.03125,32,0,16,30.611604067906494,0.6780598958333333,40.30934343434344,1038.7626262626268,32.46133207070709,2
4720,4,0,0,32,0.0,0.0,1.0,32,650,400,250,0.6153846153846154,9,4,5,370.5209728211845,0.6804435483870969,-0.003007290400971696,0.2393553851113304,134976.85982297733,3602.3514819916463,138579.21130496898,2566,6,706.03125,32,0,16,30.58905427298502,0.6790364583333333,40.21464646464647,1039.1414141414148,32.47316919191921,0
4721,4,0,0,32,0.0,0.0,1.0,32,650,500,150,0.7692307692307693,8,5,3,375.37592347093425,0.6804435483870969,0.04012250677173124,0.2206080499588228,131457.5760764209,3469.201803387431,134926.77787980833,2567,7,707.03125,32,0,20,33.999989739801364,0.6438802083333333,43.623737373737384,1025.5050505050517,32.047032828282866,6
4722,4,0,0,32,0.0,0.0,1.0,32,600,200,400,0.3333333333333333,10,2,8,376.9025564095327,0.680569556451613,0.04227579096392908,0.22169293741597682,131489.94880943294,3511.779569686794,135001.72837911974,2568,8,708.03125,32,0,20,33.92809512085026,0.6442057291666665,43.59217171717173,1025.631313131315,32.05097853535359,0
4723,4,1,0,33,0.030303030303030304,0.0,1.0,33,800,600,200,0.75,10,6,4,365.3698133050433,0.6949968434343435,0.04055827269473933,0.2173807767875217,131925.46323829785,3040.316374711657,134965.7796130095,2569,0,687.5454545454545,33,0,16,33.784022227523955,0.6461489898989898,43.16789215686275,1027.3284313725496,31.131164587046957,0
4724,4,0,0,33,0.0,0.0,1.0,33,350,0,350,0.0,7,0,7,365.3698133050433,0.6949968434343435,0.04055827269473933,0.2173807767875217,131925.46323829785,3040.316374711657,134965.7796130095,2570,1,688.5454545454545,33,0,16,33.784022227523955,0.6461489898989898,43.16789215686275,1027.3284313725496,31.131164587046957,0
4725,4,0,0,33,0.0,0.0,1.0,33,900,700,200,0.7777777777777778,11,7,4,367.0586771167396,0.6959438131313131,0.041280922750037696,0.21892987669281486,132019.90370290267,3091.810241253354,135111.713944156,2571,2,689.5454545454545,33,0,17,33.64536131647984,0.6470959595959596,43.07598039215686,1027.696078431372,31.14230540701127,0
4726,4,1,0,34,0.029411764705882353,0.0,1.0,34,1150,800,350,0.6956521739130435,15,8,7,347.65180212932364,0.7051767676767677,0.04391349646608278,0.20229655004126923,131077.01965590141,2321.777080930392,133398.7967368318,2572,0,670.2352941176471,33,1,20,35.095041487154944,0.6376262626262628,43.99509803921568,1024.019607843136,31.03089720736776,7
4727,4,0,0,34,0.0,0.0,1.0,34,700,500,200,0.7142857142857143,9,5,4,348.7938444487162,0.7049539512774807,0.0365764396210746,0.20329281394019305,131139.7734645328,2348.149149365621,133487.9226138984,2573,1,671.2352941176471,33,1,20,35.00239291696578,0.6382575757575759,43.93382352941176,1024.2647058823525,31.03832442067735,0
4728,4,0,1,33,0.0,0.029411764705882353,0.9705882352941176,34,750,400,350,0.5333333333333333,11,4,7,351.2850498899904,0.7031714200831848,0.03841608396527718,0.20541577532727967,131265.326136582,2422.3093281430097,133687.63546472503,2574,2,672.2352941176471,33,1,21,34.811747588296264,0.6395202020202021,43.811274509803916,1024.7549019607836,31.053178847296472,0
4729,4,0,2,31,0.0,0.06060606060606061,0.9393939393939394,33,1150,900,250,0.782608695652174,14,9,5,391.0827322901068,0.6925505050505051,-0.009898641449656242,0.21190442510931212,128280.65609102187,3533.2860300268476,131813.94212104872,2575,3,692.1515151515151,30,3,21,36.836053248418935,0.617013888888889,46.74059139784945,1013.0376344086004,33.76792114695335,8
4730,4,2,2,31,0.06060606060606061,0.06060606060606061,0.9393939393939394,33,500,300,200,0.6,7,3,4,386.24751510870885,0.6950757575757577,0.005456313332208307,0.21017884263707629,128450.91376170634,3322.769250780407,131773.68301248676,2576,0,692.8181818181819,30,3,19,36.78400954653937,0.6187500000000001,46.572580645161274,1013.709677419353,33.7903225806451,0
4731,4,2,1,32,0.06060606060606061,0.030303030303030304,0.9696969696969697,33,600,400,200,0.6666666666666666,8,4,4,385.96976396814745,0.6938920454545455,0.03229754838813248,0.2116527006335132,128757.66210327759,3339.312890218486,132096.9749934961,2577,0,693.7575757575758,30,3,20,36.47695669447755,0.6218750000000002,46.27016129032256,1014.9193548387077,33.830645161290256,0
4732,4,2,2,32,0.058823529411764705,0.058823529411764705,0.9411764705882353,34,750,500,250,0.6666666666666666,10,5,5,375.11819678380596,0.707553475935829,0.02561232105298905,0.2071512589882545,129035.96878051746,2880.747985839831,131916.7167663573,2578,0,674.2941176470588,31,3,21,36.4679450211457,0.621975806451613,45.99609374999999,1016.0156249999991,32.77469758064513,0
4733,4,1,0,33,0.030303030303030304,0.0,1.0,33,550,500,50,0.9090909090909091,6,5,1,384.19996685981704,0.6903409090909092,0.051487578592538386,0.21216647851430645,129035.96878051746,3315.122985839831,132351.0917663573,2579,0,695.6969696969697,31,2,22,36.23726451364859,0.621975806451613,45.99609374999999,1016.0156249999991,32.77469758064513,0
4734,4,1,1,33,0.029411764705882353,0.029411764705882353,0.9705882352941176,34,700,600,100,0.8571428571428571,8,6,2,374.4199721874941,0.7009803921568628,0.045019698236575145,0.20780707624819753,129234.48562622059,2877.700466579848,132112.18609280043,2580,0,676.2058823529412,31,3,22,36.28305480855423,0.623991935483871,45.80078124999999,1016.7968749999991,32.799899193548356,0
4735,4,1,1,33,0.029411764705882353,0.029411764705882353,0.9705882352941176,34,1250,900,350,0.72,16,9,7,377.7652099458006,0.7076277480689246,0.03971134082712857,0.21036917928058008,129366.91496107301,2974.063958062048,132340.97891913506,2581,0,677.1764705882352,31,3,23,36.0628919749136,0.6253360215053765,45.67057291666666,1017.3177083333323,32.81670026881717,0
4736,4,1,1,33,0.029411764705882353,0.029411764705882353,0.9705882352941176,34,600,400,200,0.6666666666666666,8,4,4,377.7652099458006,0.7038398692810458,0.03971134082712857,0.21036917928058008,129366.91496107301,2974.063958062048,132340.97891913506,2582,0,678.1470588235294,31,3,23,36.0628919749136,0.6253360215053765,45.67057291666666,1017.3177083333323,32.81670026881717,0
4737,4,1,1,33,0.029411764705882353,0.029411764705882353,0.9705882352941176,34,750,600,150,0.8,9,6,3,373.1318574769182,0.7037284610814023,0.04006450012403917,0.20861227704430743,129522.50567544119,2865.794625548401,132388.3003009896,2583,0,679.1176470588235,32,2,18,36.022130571404944,0.6243489583333335,45.51767676767676,1017.9292929292922,31.81029040404038,0
4738,4,0,0,33,0.0,0.0,1.0,33,500,400,100,0.8,6,4,2,380.1137195669496,0.6920770202020202,0.042656179095447166,0.211677012899257,129366.914961073,3234.8278469509364,132601.74280802393,2584,5,700.6969696969697,31,2,23,36.003162464268954,0.6253360215053765,45.67057291666666,1017.3177083333322,32.81670026881717,0
4739,4,2,0,35,0.05714285714285714,0.0,1.0,35,700,500,200,0.7142857142857143,9,5,4,374.00830186323776,0.7186274509803922,0.07787177440808768,0.20791144730906688,129297.68207644622,2674.771206438041,131972.45328288426,2585,0,661.6,32,3,21,36.22905027932962,0.6220703125,45.73863636363636,1017.045454545454,31.78267045454544,1
4740,4,0,0,35,0.0,0.0,1.0,35,800,600,200,0.75,10,6,4,375.4875838187113,0.7192577030812325,0.082242592953776,0.20907418540617506,129361.89746263115,2714.7572632894344,132076.65472592058,2586,1,662.6,32,3,21,36.125936039055055,0.6227213541666667,45.67550505050504,1017.2979797979781,31.790561868686815,0
4741,4,0,0,35,0.0,0.0,1.0,35,650,500,150,0.7692307692307693,8,5,3,376.8179393131661,0.7198179271708683,0.08485664670234283,0.2106731086506757,129522.50567544118,2761.2807366595107,132283.7864121007,2587,2,663.6,32,3,17,35.928326304473664,0.6243489583333335,45.51767676767676,1017.929292929292,31.810290404040376,0
4742,4,1,1,35,0.027777777777777776,0.027777777777777776,0.9722222222222222,36,900,400,500,0.4444444444444444,14,4,10,368.9476231293884,0.7312830687830688,0.10231915404950764,0.20886953195120875,130012.5027032871,2393.5607698961835,132406.06347318328,2588,0,646.1388888888889,33,3,18,35.629956741167994,0.6268939393939394,45.03676470588235,1019.8529411764698,30.904634581105146,0
4743,4,0,0,35,0.0,0.0,1.0,35,1300,800,500,0.6153846153846154,18,8,10,378.5563149927704,0.7221988795518207,0.09968340437574086,0.21426764934804546,130004.92814827577,2842.83730614224,132847.765454418,2589,1,665.5142857142857,32,3,19,35.39267879988445,0.6292317708333333,45.044191919191924,1019.8232323232329,31.869476010101028,0
4744,4,1,0,36,0.027777777777777776,0.0,1.0,36,600,400,200,0.6666666666666666,8,4,4,371.21535995697343,0.7334325396825397,0.10252712539486364,0.2123855913756661,130423.7529971433,2483.315159167454,132907.06815631076,2590,0,648.0,32,4,20,35.154254223320976,0.6334635416666665,44.633838383838395,1021.4646464646477,31.92077020202024,0
4745,4,1,2,35,0.02702702702702703,0.05405405405405406,0.9459459459459459,37,650,500,150,0.7692307692307693,8,5,3,365.0333990172895,0.742555055055055,0.08602658980130529,0.21051857047679917,130732.14215986653,2144.3196426855266,132876.46180255205,2591,0,631.4594594594595,33,4,17,34.99937587377672,0.6341540404040403,44.332107843137265,1022.6715686274521,30.990047534165214,0
4746,4,2,1,36,0.05405405405405406,0.02702702702702703,0.972972972972973,37,1050,800,250,0.7619047619047619,13,8,5,363.54232851661936,0.740990990990991,0.09086259912607231,0.21051168121454725,130888.84833958092,2116.7273404459834,133005.5756800269,2592,0,632.3783783783783,33,4,18,34.87874251497006,0.6357323232323232,44.17892156862745,1023.2843137254902,31.008615567439097,0
4747,4,0,0,36,0.0,0.0,1.0,36,750,300,450,0.4,12,3,9,373.6959420316173,0.735218253968254,0.08920979730656398,0.21595467349073927,130810.9583843486,2576.704864299576,133387.66324864817,2593,1,650.9444444444445,32,4,19,34.69796552291615,0.6373697916666665,44.25505050505051,1022.9797979797986,31.968118686868706,0
4748,4,2,2,36,0.05263157894736842,0.05263157894736842,0.9473684210526316,38,950,600,350,0.631578947368421,13,6,7,355.13309512278386,0.7590979137031769,0.07569021367648365,0.20784557549981864,131298.46810967528,1725.6862729338382,133024.15438260912,2594,0,617.6315789473684,35,3,19,34.67967720685113,0.6354166666666665,43.7789351851852,1024.884259259261,29.282407407407455,0
4749,4,0,0,36,0.0,0.0,1.0,36,950,900,50,0.9473684210526315,10,9,1,372.971129277152,0.7383597883597884,0.08289442183385254,0.21667599540899365,131014.28086553254,2572.9088571703296,133587.18972270287,2595,3,652.9444444444445,33,3,20,34.510414172851334,0.6369949494949494,44.05637254901961,1023.774509803922,31.023469994058242,0
4750,4,0,1,35,0.0,0.027777777777777776,0.9722222222222222,36,1100,900,200,0.8181818181818182,13,9,4,368.98275719806213,0.7375330687830688,0.084064502406211,0.2150598245928454,131139.7734645329,2477.6630382545236,133617.4365027874,2596,4,653.9444444444445,33,3,20,34.485423147483466,0.6382575757575757,43.93382352941177,1024.2647058823532,31.03832442067737,0
4751,4,0,0,35,0.0,0.0,1.0,35,450,200,250,0.4444444444444444,7,2,5,379.31104315599754,0.726750700280112,0.08730374103508476,0.22011987307556713,130972.46334876551,2935.860339506186,133908.3236882717,2597,5,673.3142857142857,32,3,20,34.39054726368159,0.6389973958333333,44.09722222222223,1023.6111111111118,31.987847222222243,0
4752,4,0,0,35,0.0,0.0,1.0,35,750,600,150,0.8,9,6,3,375.9531448389652,0.7268207282913165,0.05331912040300568,0.2106402346909619,129606.62853529908,2745.203917964263,132351.83245326334,2598,6,674.3142857142857,33,2,16,35.86459963092231,0.622790404040404,45.43504901960785,1018.2598039215699,30.856357694593026,6
4753,4,2,1,36,0.05405405405405406,0.02702702702702703,0.972972972972973,37,950,700,250,0.7368421052631579,12,7,5,358.5112448279066,0.7556931931931932,0.04998098416164698,0.2030334890375009,130026.38996056248,1923.1845850480204,131949.5745456105,2599,0,638.8108108108108,35,2,17,35.88194129217734,0.6226190476190476,45.02314814814815,1019.907407407408,29.140211640211657,0
4754,4,1,2,35,0.02702702702702703,0.05405405405405406,0.9459459459459459,37,1100,800,300,0.7272727272727273,14,8,6,360.73544377806803,0.7588213213213213,0.052753763635416284,0.20444768270200084,130055.90284475735,1983.154765732166,132039.05761048952,2600,0,639.7837837837837,35,2,17,35.79525038768487,0.6229166666666666,44.99421296296296,1020.0231481481479,29.143518518518512,0
4755,4,0,0,35,0.0,0.0,1.0,35,750,600,150,0.8,9,6,3,378.52943477070176,0.7299019607843137,0.059231271253392226,0.21360975837331744,129887.55076172634,2833.2522347174254,132720.80299644376,2601,2,677.1142857142858,33,2,19,35.512843632283406,0.6256313131313131,45.1593137254902,1019.3627450980398,30.889780154486054,0
4756,4,0,0,35,0.0,0.0,1.0,35,950,700,250,0.7368421052631579,12,7,5,377.73367971103823,0.730672268907563,0.057309648903344224,0.21355042684653758,129958.94451530624,2817.9740646258656,132776.9185799321,2602,3,678.1142857142858,34,1,20,35.46044950379452,0.6240808823529411,45.08928571428572,1019.6428571428581,29.989495798319357,0
4757,4,0,0,35,0.0,0.0,1.0,35,800,500,300,0.625,11,5,6,377.49387636173503,0.7296218487394958,0.0519753292215368,0.2142465245311305,130110.72137188209,2823.2001133786825,132933.92148526077,2603,4,679.1142857142858,34,1,20,35.312135355892636,0.6256127450980392,44.94047619047619,1020.2380952380953,30.00700280112045,0
4758,4,1,1,35,0.027777777777777776,0.027777777777777776,0.9722222222222222,36,900,500,400,0.5555555555555556,13,5,8,368.9986421153671,0.7400132275132275,0.04283251603686744,0.2109420506057392,130391.51178770051,2423.1238898988126,132814.63567759932,2604,0,661.2222222222222,32,4,21,35.24359212098734,0.6331380208333333,44.665404040404056,1021.338383838386,31.916824494949562,0
4759,4,1,0,36,0.027777777777777776,0.0,1.0,36,750,700,50,0.9333333333333333,8,7,1,366.558708890698,0.7362433862433863,0.04842450415866906,0.20986493113412502,130450.30757401003,2363.539263744716,132813.84683775474,2605,0,662.1944444444445,33,3,22,35.24622120921303,0.6313131313131313,44.6078431372549,1021.5686274509808,30.956625074272146,0
4760,4,1,2,35,0.02702702702702703,0.05405405405405406,0.9459459459459459,37,1150,800,350,0.6956521739130435,15,8,7,360.5181691487186,0.7464964964964965,0.04648758750829596,0.20809268848904194,130765.21675936668,2028.6473068844616,132793.86406625115,2606,0,645.2702702702703,35,2,16,35.081310588057775,0.6300595238095237,44.29976851851853,1022.800925925928,29.22288359788366,0
4761,4,1,0,36,0.027777777777777776,0.0,1.0,36,950,600,350,0.631578947368421,13,6,7,370.293248407422,0.7348214285714286,0.0560211049037862,0.21381448859654406,130779.59183673494,2485.359977324291,133264.95181405923,2607,0,664.1388888888889,34,2,19,34.81678693358161,0.6323529411764705,44.2857142857143,1022.8571428571448,30.084033613445435,0
4762,4,0,0,36,0.0,0.0,1.0,36,850,300,550,0.35294117647058826,14,3,11,369.7699695665271,0.7354828042328043,0.05868435342486977,0.21384946961337392,130840.48327664411,2476.176303854887,133316.659580499,2608,1,665.1388888888889,34,2,19,34.76844309983709,0.6329656862745097,44.22619047619048,1023.0952380952391,30.091036414565856,0
4763,4,2,2,36,0.05263157894736842,0.05263157894736842,0.9473684210526316,38,900,600,300,0.6666666666666666,12,6,6,355.6084341331218,0.7589497392128971,0.05198973042361987,0.20828493999225717,131328.12500000012,1740.2777777777924,133068.4027777779,2609,0,631.078947368421,37,1,19,34.63753387533876,0.6317567567567566,43.75000000000001,1025.000000000001,27.702702702702727,0
4764,4,0,0,36,0.0,0.0,1.0,36,500,200,300,0.4,8,2,6,375.5935524787723,0.7335978835978837,0.06182957771246289,0.21829832885855596,131031.70680084026,2642.9328489369072,133674.63964977715,2610,3,667.1388888888889,35,1,19,34.42563493857864,0.6327380952380952,44.039351851851855,1023.8425925925931,29.252645502645517,0
4765,4,0,0,36,0.0,0.0,1.0,36,900,500,400,0.5555555555555556,13,5,8,377.14389794357595,0.7335317460317461,0.057787950717757885,0.21936831460268352,131061.33355034718,2685.7964409722176,133747.12999131938,2611,4,668.1388888888889,35,1,19,34.35592573753814,0.6330357142857144,44.010416666666664,1023.9583333333329,29.25595238095237,0
4766,4,0,0,36,0.0,0.0,1.0,36,450,400,50,0.8888888888888888,5,4,1,377.690813547018,0.7324404761904763,0.06098051034759955,0.2198558104121063,131090.963648834,2702.370541838134,133793.33419067215,2612,5,669.1388888888889,35,1,19,34.31189722724533,0.6333333333333333,43.98148148148148,1024.074074074074,29.259259259259256,0
4767,4,0,0,36,0.0,0.0,1.0,36,1000,700,300,0.7,13,7,6,375.77707555300213,0.7319775132275133,0.056064030131826925,0.21907952033228378,131150.23389274685,2656.65027006172,133806.88416280856,2613,6,670.1388888888889,35,1,19,34.30084745762712,0.6339285714285714,43.92361111111111,1024.305555555555,29.265873015872998,0
4768,4,0,0,36,0.0,0.0,1.0,36,900,600,300,0.6666666666666666,12,6,6,377.6115667407745,0.7312169312169313,0.05959282263630139,0.22100134986712183,131298.4681096749,2715.964050711573,134014.43216038647,2614,7,671.1388888888889,35,1,20,34.10373141351403,0.6354166666666667,43.778935185185176,1024.8842592592578,29.282407407407366,0
4769,4,0,0,36,0.0,0.0,1.0,36,1100,700,400,0.6363636363636364,15,7,8,373.6107403722488,0.7314484126984128,0.062027914614121826,0.21919936501608814,131392.84256708494,2617.965485159888,134010.80805224483,2615,8,672.1388888888889,32,4,20,34.11073481116585,0.6432291666666667,43.686868686868685,1025.252525252525,32.039141414141405,0
4770,4,1,0,37,0.02702702702702703,0.0,1.0,37,1050,800,250,0.7619047619047619,13,8,5,361.43772442090756,0.7369244244244244,0.0567764327162823,0.21433026843048691,131799.595182742,2127.469152489397,133927.06433523138,2616,0,654.9459459459459,33,4,17,34.01198929864343,0.6448863636363638,43.29044117647057,1026.8382352941157,31.11631016042775,0
4771,4,0,0,37,0.0,0.0,1.0,37,1050,600,450,0.5714285714285714,15,6,9,361.1205970812471,0.7364864864864865,0.059755495860972285,0.21449693296512604,131862.52170138867,2123.654513888856,133986.17621527752,2617,1,655.9459459459459,33,4,19,33.95664300202838,0.6455176767676769,43.22916666666665,1027.0833333333314,31.123737373737317,0
4772,4,0,0,37,0.0,0.0,1.0,37,1050,900,150,0.8571428571428571,12,9,3,358.510934007021,0.7353603603603603,0.057882829168304895,0.2138316282064632,132019.90370290246,2066.1157968088814,134086.01949971134,2618,2,656.9459459459459,33,4,20,33.864973368312256,0.6470959595959598,43.07598039215684,1027.6960784313703,31.14230540701122,0
4773,4,0,0,37,0.0,0.0,1.0,37,850,500,350,0.5882352941176471,12,5,7,356.97215525978896,0.7371746746746747,0.046813348922751574,0.21380109598750074,132177.3795685551,2036.7288122356479,134214.10838079074,2619,3,657.9459459459459,33,4,20,33.74585369244825,0.6486742424242425,42.922794117647044,1028.30882352941,31.160873440285147,0
4774,4,1,0,38,0.02631578947368421,0.0,1.0,38,800,300,500,0.375,13,3,10,350.9710835417434,0.7478070175438597,0.046116033689220126,0.2126829096732769,132618.81134960096,1709.2575571895254,134328.0689067905,2620,0,641.6052631578947,33,5,21,33.4561520920087,0.6530934343434345,42.4938725490196,1030.0245098039204,31.212863933452134,0
4775,4,0,0,38,0.0,0.0,1.0,38,1100,900,200,0.8181818181818182,13,9,4,355.3716274012737,0.7455251303935515,0.04440202766130552,0.21625726385272828,132776.64389898084,1837.0104046520196,134613.65430363285,2621,1,642.6052631578947,33,5,15,33.18420531113753,0.6546717171717173,42.340686274509785,1030.6372549019582,31.231431966726007,0
4776,4,0,0,38,0.0,0.0,1.0,38,1300,1100,200,0.8461538461538461,15,11,4,355.6015663441854,0.7447249881460408,0.04779883263370577,0.21694532107713055,132871.3884833957,1849.8547734044473,134721.24325680017,2622,2,643.6052631578947,33,5,16,33.08310055865921,0.6556186868686871,42.248774509803916,1031.0049019607836,31.242572786690413,0
4777,4,0,0,38,0.0,0.0,1.0,38,750,500,250,0.6666666666666666,10,5,5,355.5963677175798,0.7430654338549075,0.05481127060074398,0.21730889138296536,132934.5703124999,1854.2100694444302,134788.78038194435,2623,3,644.6052631578947,33,5,17,33.019781144781135,0.65625,42.18749999999999,1031.2499999999993,31.24999999999998,0
4778,4,0,0,38,0.0,0.0,1.0,38,800,600,200,0.75,10,6,4,355.46735398093125,0.7418207681365576,0.05692325004219767,0.2179664714614319,133060.97902549495,1859.7668264609724,134920.74585195593,2624,4,645.6052631578947,33,5,18,32.896202042997984,0.6575126262626263,42.064950980392155,1031.740196078431,31.26485442661912,0
4779,4,0,0,38,0.0,0.0,1.0,38,1200,1000,200,0.8333333333333334,14,10,4,355.573484690337,0.7414947842579421,0.057344668083510575,0.21821638054611053,133092.59059015758,1864.8392445213326,134957.42983467891,2625,5,646.6052631578947,33,5,18,32.86173792557403,0.6578282828282829,42.03431372549019,1031.8627450980387,31.268568033273898,0
4780,4,0,0,38,0.0,0.0,1.0,38,850,600,250,0.7058823529411765,11,6,5,356.1581925554524,0.7413466097676624,0.05797096921336964,0.2191322465956592,133187.44781153876,1887.1601367262506,135074.607948265,2626,6,647.6052631578947,33,5,18,32.75146919149948,0.6587752525252526,41.94240196078431,1032.230392156862,31.279708853238244,0
4781,4,0,0,38,0.0,0.0,1.0,38,1150,600,550,0.5217391304347826,17,6,11,357.5277617696106,0.7407835467045993,0.056692657569850535,0.22016183224760225,133219.0743944636,1925.9034986543538,135144.97789311793,2627,7,648.6052631578947,33,5,18,32.684393795504896,0.6590909090909092,41.91176470588235,1032.3529411764698,31.283422459893025,0
4782,4,0,0,38,0.0,0.0,1.0,38,950,700,250,0.7368421052631579,12,7,5,358.96882163035025,0.7399241346609767,0.06496349453198702,0.22161393845267097,133313.97667063138,1971.112222462501,135285.0888930939,2628,8,649.6052631578947,33,5,18,32.55199062537084,0.6600378787878789,41.819852941176464,1032.7205882352932,31.29456327985737,0
4783,4,0,0,38,0.0,0.0,1.0,38,1050,1000,50,0.9523809523809523,11,10,1,366.5139910942763,0.7402797534376482,0.048429057434460354,0.22417018525068527,132966.16685890034,2146.792099192603,135112.95895809293,2629,9,650.6052631578947,33,5,16,32.70655101394168,0.6565656565656567,42.15686274509803,1031.372549019607,31.25371360665476,2
4784,4,1,1,38,0.02564102564102564,0.02564102564102564,0.9743589743589743,39,1400,1100,300,0.7857142857142857,17,11,6,361.2254897889696,0.7508996851102114,0.04814896918643341,0.22303424369532435,133318.49666950098,1831.607851473907,135150.10452097488,2630,0,634.8974358974359,34,5,16,32.48919308357349,0.6577818627450981,41.81547619047618,1032.738095238094,30.374649859943943,0
4785,4,0,0,38,0.0,0.0,1.0,38,1300,1100,200,0.8461538461538461,15,11,4,367.1080240721559,0.7375237079184448,0.041392641446978296,0.2266387779381727,133313.9766706315,2188.1261113514047,135502.10278198292,2631,11,652.6052631578947,33,5,17,32.34185257703413,0.6600378787878787,41.81985294117647,1032.7205882352941,31.2945632798574,0
4786,4,0,0,38,0.0,0.0,1.0,38,700,500,200,0.7142857142857143,9,5,4,367.1322724959787,0.7374940730203888,0.04478804985886642,0.22684683230176744,133345.6182718185,2191.0959727028057,135536.7142445213,2632,12,653.6052631578947,33,5,17,32.309464483467806,0.6603535353535354,41.78921568627451,1032.8431372549019,31.298276886512177,0
4787,4,0,0,38,0.0,0.0,1.0,38,700,400,300,0.5714285714285714,10,4,6,369.7063799983152,0.736160502607871,0.04520149537843188,0.2294138265287559,133503.88259623697,2271.4474300749644,135775.33002631195,2633,13,654.6052631578947,33,5,17,32.08414858294795,0.6619318181818181,41.6360294117647,1033.4558823529408,31.316844919786085,0
4788,4,1,1,38,0.02564102564102564,0.02564102564102564,0.9743589743589743,39,900,600,300,0.6666666666666666,12,6,6,360.7336403548934,0.7429712100764733,0.03732233083061831,0.22514754794564032,133718.36734693882,1847.342687074835,135565.71003401364,2634,0,638.7948717948718,34,5,15,32.10103015653775,0.661764705882353,41.42857142857143,1034.2857142857147,30.420168067226903,0
4789,4,0,0,38,0.0,0.0,1.0,38,850,500,350,0.5882352941176471,12,5,7,371.70362339557914,0.7369606448553817,0.040736767255897144,0.23164218421062757,133662.24078479435,2336.5478421760895,135998.78862697043,2635,15,656.6052631578947,33,5,18,31.873666745674328,0.663510101010101,41.4828431372549,1034.0686274509808,31.335412953060025,0
4790,4,0,0,38,0.0,0.0,1.0,38,1100,900,200,0.8181818181818182,13,9,4,372.1726825543002,0.7352121858700806,0.03861312047892218,0.23233265094366093,133725.6103421762,2353.8038254517646,136079.41416762795,2636,16,657.6052631578947,33,5,16,31.79798578199053,0.6641414141414141,41.42156862745099,1034.313725490197,31.342840166369605,0
4791,4,0,0,38,0.0,0.0,1.0,38,1000,600,400,0.6,14,6,8,379.3340404305657,0.7333155523944997,0.048136055778133624,0.23823305870014794,133947.52206182724,2562.170949875056,136509.6930117023,2637,17,658.6052631578947,33,5,17,31.39021250147982,0.6663510101010102,41.20710784313726,1035.1715686274513,31.368835412953068,0
4792,4,0,0,38,0.0,0.0,1.0,38,1200,1000,200,0.8333333333333334,14,10,4,376.7428953211241,0.7310040303461356,0.05129897626223623,0.237629175466727,134106.1430699731,2504.7073241061153,136610.85039407923,2638,18,659.6052631578947,33,5,17,31.298312036598823,0.6679292929292928,41.05392156862745,1035.7843137254904,31.387403446226983,0
4793,4,0,0,38,0.0,0.0,1.0,38,800,500,300,0.625,11,5,6,377.33742591750035,0.7309151256519678,0.049385290547480754,0.23862288228365508,134201.36072964736,2527.839202470217,136729.19993211757,2639,19,660.6052631578947,33,5,18,31.18753696037848,0.6688762626262625,40.962009803921575,1036.1519607843145,31.398544266191347,0
4794,4,0,1,37,0.0,0.02631578947368421,0.9736842105263158,38,950,800,150,0.8421052631578947,11,8,3,375.3309972111843,0.7302927927927928,0.04069926589523476,0.2383859036341307,134360.13192041527,2485.904459823153,136846.03638023842,2640,20,661.6052631578947,33,5,18,31.080575256107178,0.6704545454545454,40.80882352941177,1036.7647058823534,31.417112299465256,0
4795,4,0,0,37,0.0,0.0,1.0,37,800,600,200,0.75,10,6,4,383.55147330630854,0.7164039039039038,0.044427113963537934,0.2427628187333942,134233.10745866984,2897.0612264513766,137130.16868512123,2641,25,679.9459459459459,33,4,18,30.99475717439294,0.6691919191919191,40.93137254901961,1036.2745098039222,31.40225787284613,0
4796,4,0,0,37,0.0,0.0,1.0,37,800,400,400,0.5,12,4,8,383.55147330630854,0.7162162162162162,0.044427113963537934,0.2427628187333942,134233.10745866984,2897.0612264513766,137130.16868512123,2642,26,680.9459459459459,33,4,18,30.99475717439294,0.6691919191919191,40.93137254901961,1036.2745098039222,31.40225787284613,0
4797,4,0,0,37,0.0,0.0,1.0,37,850,700,150,0.8235294117647058,10,7,3,386.89215950333573,0.7149024024024024,0.04618049120295509,0.24530239018584823,134296.61218041147,2991.6612600922817,137288.27344050375,2643,27,681.9459459459459,33,4,18,30.844565303066126,0.6698232323232323,40.87009803921569,1036.519607843138,31.409685086155694,0
4798,4,0,0,37,0.0,0.0,1.0,37,950,600,350,0.631578947368421,13,6,7,386.30920290361314,0.716529029029029,0.03928383032860672,0.2456024202401804,134396.43565759642,2983.715986394562,137380.15164399098,2644,28,682.9459459459459,34,3,18,30.759663222349793,0.6685049019607843,40.773809523809526,1036.9047619047622,30.497198879551828,0
4799,4,0,1,36,0.0,0.02702702702702703,0.972972972972973,37,1050,600,450,0.5714285714285714,15,6,9,384.3076671683842,0.714527027027027,0.03325496715443932,0.2451579071526577,134519.9050453516,2939.4061791383383,137459.31122448994,2645,29,683.9459459459459,34,3,18,30.6879255604009,0.6697303921568627,40.65476190476191,1037.3809523809534,30.51120448179275,0
4800,4,0,0,36,0.0,0.0,1.0,36,1050,900,150,0.8571428571428571,12,9,3,391.18518964375494,0.7098214285714286,0.034460461879816995,0.24910460947743407,134455.4396896627,3319.3953347270317,137774.83502438973,2646,30,700.9444444444445,33,3,18,30.574141360431682,0.6714015151515151,40.716911764705884,1037.1323529411768,31.4282531194296,0
4801,4,0,0,36,0.0,0.0,1.0,36,900,600,300,0.6666666666666666,12,6,6,389.21740574527877,0.710681216931217,0.03372383015029201,0.24828374827684901,134518.99697532202,3271.427005238371,137790.4239805604,2647,31,701.9444444444445,33,3,18,30.56150324867099,0.6720328282828283,40.65563725490196,1037.3774509803925,31.435680332739167,0
4802,4,0,0,36,0.0,0.0,1.0,36,1200,1000,200,0.8333333333333334,14,10,4,388.8646957307139,0.7108796296296297,0.03157072735386013,0.24827515188960983,134550.78125000012,3264.409722222237,137815.19097222236,2648,32,702.9444444444445,33,3,19,30.538821954484604,0.6723484848484848,40.62500000000001,1037.500000000001,31.439393939393966,0
4803,4,0,0,36,0.0,0.0,1.0,36,1050,800,250,0.7619047619047619,13,8,5,389.5347130078785,0.709457671957672,0.03396883484830582,0.24979171490459826,134709.75894187353,3294.825457756656,138004.5843996302,2649,33,703.9444444444445,33,3,19,30.362289969700548,0.6739267676767676,40.47181372549021,1038.112745098041,31.457961972667906,0
4804,4,0,0,36,0.0,0.0,1.0,36,1350,1200,150,0.8888888888888888,15,12,3,387.7065878038668,0.7090608465608466,0.03435845000262172,0.2497113250931291,134868.83049788562,3257.906814686677,138126.73731257228,2650,34,704.9444444444445,33,3,17,30.250609564259868,0.6755050505050504,40.3186274509804,1038.7254901960798,31.47653000594181,0
4805,4,0,0,36,0.0,0.0,1.0,36,450,200,250,0.4444444444444444,7,2,5,383.8846652543547,0.7093253968253969,0.03228617860606531,0.24768448949972774,134932.4854022493,3159.702398116125,138092.1878003654,2651,35,705.9444444444445,33,3,17,30.286231029330818,0.6761363636363635,40.25735294117648,1038.9705882352953,31.483957219251373,0
4806,4,0,1,35,0.0,0.027777777777777776,0.9722222222222222,36,1100,900,200,0.8181818181818182,13,9,4,383.7291638329007,0.7095568783068783,0.028577138289368698,0.24780194822080492,134964.31848627943,3157.949016003475,138122.2675022829,2652,36,706.9444444444445,33,3,18,30.258457168691283,0.6764520202020201,40.22671568627452,1039.093137254903,31.48767082590615,0
4807,4,0,0,35,0.0,0.0,1.0,35,1050,900,150,0.8571428571428571,12,9,3,390.69256460185204,0.7049719887955181,0.03893547211082771,0.25215757757714835,134944.06063475672,3544.328225436188,138488.3888601929,2653,37,724.6,32,3,18,30.09782476607121,0.6787109375,40.246212121212125,1039.015151515152,32.4692234848485,0
4808,4,0,0,35,0.0,0.0,1.0,35,950,700,250,0.7368421052631579,12,7,5,394.20084573153724,0.7058123249299719,-0.008635737253100295,0.25019686331124097,134334.72222222225,3590.972222222227,137925.69444444447,2654,38,725.6,34,1,18,30.616961414790996,0.6678921568627452,40.833333333333336,1036.6666666666667,30.490196078431374,4
4809,4,0,0,35,0.0,0.0,1.0,35,850,600,250,0.7058823529411765,11,6,5,400.2712333612823,0.7042016806722688,-0.005424996310083197,0.2546941354134497,134427.29768990914,3761.4760487528215,138188.77373866196,2655,39,726.6,34,1,18,30.366777637469884,0.6688112745098039,40.74404761904761,1037.0238095238083,30.500700280112007,0
4810,4,0,0,35,0.0,0.0,1.0,35,750,600,150,0.8,9,6,3,400.44014130414325,0.7044817927170868,-0.012774189317682483,0.2554491501701541,134519.90504535148,3773.4339569161016,138293.33900226757,2656,40,727.6,34,1,18,30.26953752582052,0.6697303921568627,40.654761904761905,1037.3809523809525,30.51120448179272,0
4811,4,0,0,35,0.0,0.0,1.0,35,1000,900,100,0.9,11,9,2,403.28434213083506,0.701750700280112,-0.008745529387947704,0.25793140552597515,134614.36106305264,3857.5763516190764,138471.9374146717,2657,41,728.6,33,2,18,30.101066761139975,0.6729797979797979,40.56372549019608,1037.7450980392155,31.4468211527035,0
4812,4,0,0,35,0.0,0.0,1.0,35,550,300,250,0.5454545454545454,8,3,5,403.14911020073623,0.7009103641456582,-0.006706021251475347,0.2582959881543295,134677.95589436762,3859.059616493666,138537.0155108613,2658,42,729.6,33,2,19,30.04083038173948,0.673611111111111,40.50245098039216,1037.9901960784318,31.454248366013086,0
4813,4,0,0,35,0.0,0.0,1.0,35,700,500,200,0.7142857142857143,9,5,4,403.7112822276801,0.7004201680672268,-0.0030490581311024556,0.2588825338191279,134709.75894187338,3876.769902201085,138586.52884407446,2659,43,730.6,33,2,19,29.99436803997954,0.6739267676767677,40.4718137254902,1038.1127450980398,31.457961972667874,0
4814,4,0,0,35,0.0,0.0,1.0,35,750,500,250,0.6666666666666666,10,5,5,403.4058502902908,0.7006302521008403,-0.004464074985670363,0.2593673122427864,134805.19061178397,3876.240508458292,138681.43112024225,2660,44,731.6,33,2,15,29.906675320588473,0.6748737373737373,40.379901960784316,1038.480392156863,31.469102792632214,0
4815,4,0,0,35,0.0,0.0,1.0,35,800,500,300,0.625,11,5,6,402.8318806385784,0.7000700280112044,-0.00013483449066264974,0.2594531170435099,134868.83049788547,3865.892925797773,138734.72342368326,2661,45,732.6,33,2,16,29.85783388390749,0.6755050505050504,40.318627450980394,1038.7254901960787,31.47653000594178,0
4816,4,0,0,35,0.0,0.0,1.0,35,650,400,250,0.6153846153846154,9,4,5,402.3696008360978,0.6997899159663865,-0.00381536594819587,0.2593830499078024,134900.6560727845,3855.984627306808,138756.64070009132,2662,46,733.6,33,2,16,29.837968424363957,0.6758207070707071,40.28799019607843,1038.8480392156864,31.480243612596556,0
4817,4,0,0,35,0.0,0.0,1.0,35,1050,700,350,0.6666666666666666,14,7,7,402.9967121969065,0.6988095238095238,-0.00043121599541828814,0.26070290740976076,135027.99591803632,3883.16768190119,138911.1635999375,2663,47,734.6,33,2,16,29.694193884368975,0.6770833333333334,40.16544117647059,1039.3382352941176,31.495098039215684,0
4818,4,0,0,35,0.0,0.0,1.0,35,700,400,300,0.5714285714285714,10,4,6,402.1648740489938,0.6993697478991596,-0.0034223734294474006,0.2603940810445469,135059.84026576314,3863.2647299115683,138923.10499567472,2664,48,735.6,33,2,16,29.68393853650868,0.6773989898989898,40.134803921568626,1039.4607843137253,31.498811645870465,0
4819,4,0,0,35,0.0,0.0,1.0,35,800,600,200,0.75,10,6,4,400.028350753253,0.6983893557422969,-0.0007272482407998382,0.25992653786310155,135187.25520232608,3815.746948289127,139003.0021506152,2665,49,736.6,33,2,16,29.61200801319821,0.6786616161616161,40.01225490196079,1039.9509803921571,31.51366607248961,0
4820,4,0,1,34,0.0,0.02857142857142857,0.9714285714285714,35,1050,800,250,0.7619047619047619,13,8,5,401.31347342619864,0.6982492997198879,-0.010633107323720914,0.26191796332527695,135346.60835075454,3863.283502739332,139209.89185349387,2666,50,737.6,33,2,17,29.419262552506577,0.680239898989899,39.85906862745098,1040.5637254901962,31.53223410576352,0
4821,4,0,0,34,0.0,0.0,1.0,34,1050,700,350,0.6666666666666666,14,7,7,411.31833989600716,0.6873885918003565,0.0016099897903087967,0.2678934231148779,135272.2318672841,4327.989969135821,139600.22183641992,2667,51,758.0,32,2,17,29.233422340898972,0.6819661458333333,39.930555555555564,1040.277777777779,32.50868055555559,0
4822,4,0,0,34,0.0,0.0,1.0,34,950,600,350,0.631578947368421,13,6,7,408.2392063885551,0.6865715983363042,0.0007492079801354468,0.267105080751369,135436.46694214878,4258.095156106522,139694.5620982553,2668,52,759.0,32,2,18,29.149229742843286,0.68359375,39.77272727272727,1040.909090909091,32.52840909090909,0
4823,4,0,0,34,0.0,0.0,1.0,34,500,300,200,0.6,7,3,4,406.56898846389083,0.6860145573380868,-0.002671851032711281,0.26625586258020484,135469.32591380985,4215.5253609325655,139684.85127474242,2669,53,760.0,32,2,18,29.15984435011119,0.6839192708333333,39.74116161616162,1041.0353535353538,32.53235479797981,0
4824,4,0,0,34,0.0,0.0,1.0,34,1100,500,600,0.45454545454545453,17,5,12,418.58364095304916,0.6860145573380868,0.010462116627918183,0.2470044680000898,131613.00154320974,4267.1725142842415,135880.17405749398,2670,54,761.0,29,5,19,32.734389099440534,0.6537356321839081,43.472222222222214,1026.1111111111102,35.38314176245208,7
4825,4,0,0,34,0.0,0.0,1.0,34,750,500,250,0.6666666666666666,10,5,5,416.3434855078286,0.6863859180035651,0.030099584317712536,0.24301116795071198,131194.69536675356,4124.411349826394,135319.10671657996,2671,55,762.0,31,3,19,33.21682765632942,0.6438172043010753,43.880208333333336,1024.4791666666672,33.04771505376346,3
4826,4,0,0,34,0.0,0.0,1.0,34,1250,1100,150,0.88,14,11,3,414.26724649236513,0.6870172311348782,0.029583654068920273,0.24243104067965826,131294.76123385952,4078.223843044696,135372.9850769042,2672,56,763.0,31,3,19,33.168302418159485,0.6448252688172043,43.78255208333333,1024.869791666666,33.060315860215034,0
4827,4,1,1,34,0.02857142857142857,0.02857142857142857,0.9714285714285714,35,1150,900,250,0.782608695652174,14,9,5,405.5785654781994,0.7007703081232493,0.015248246234161655,0.23942806550814144,131628.58963012695,3677.1511501736118,135305.74078030058,2673,0,742.1714285714286,31,4,16,33.05219832508565,0.6481854838709677,43.45703125,1026.171875,33.102318548387096,0
4828,4,0,0,34,0.0,0.0,1.0,34,1050,900,150,0.8571428571428571,12,9,3,412.93293226519216,0.6863116458704694,-0.0013198331049748546,0.236108152918224,130399.83171826231,3971.519169943624,134371.35088820593,2674,58,765.0,30,4,18,34.113315348510774,0.6385416666666666,44.657258064516135,1021.3709677419362,34.045698924731205,4
4829,4,0,0,34,0.0,0.0,1.0,34,600,400,200,0.6666666666666666,8,4,4,411.3385949102971,0.687722816399287,0.002039205367714958,0.23561301129714923,130468.48127312413,3933.344353393464,134401.8256265176,2675,59,766.0,30,4,18,34.084056922334774,0.6392361111111111,44.590053763440864,1021.6397849462371,34.054659498207904,0
4830,4,0,0,34,0.0,0.0,1.0,34,450,300,150,0.6666666666666666,6,3,3,409.30349321756006,0.6863859180035651,0.0010082534351831818,0.23460953332930573,130495.30241224507,3882.4366251627657,134377.73903740785,2676,60,767.0,31,3,17,34.10870927318295,0.636760752688172,44.563802083333336,1021.7447916666672,32.959509408602166,0
4831,4,0,0,34,0.0,0.0,1.0,34,1100,800,300,0.7272727272727273,14,8,6,407.8223441596974,0.6849747474747475,0.005167387377935206,0.23416222233426984,130561.83073255757,3849.20637342666,134411.03710598423,2677,61,768.0,31,3,17,34.07878392151865,0.6374327956989246,44.49869791666667,1022.0052083333339,32.96790994623658,0
4832,4,1,1,34,0.02857142857142857,0.02857142857142857,0.9714285714285714,35,750,500,250,0.6666666666666666,10,5,5,399.6531513483631,0.7014705882352941,-0.005775638652350645,0.2311484286492353,130843.25140610657,3458.383551423331,134301.6349575299,2678,0,747.0285714285715,32,3,17,34.001295816364305,0.6376953125,44.22348484848485,1023.106060606061,31.972064393939405,0
4833,4,2,1,35,0.05555555555555555,0.027777777777777776,0.9722222222222222,36,450,300,150,0.6666666666666666,6,3,3,389.97100869922116,0.7195767195767196,0.009228254803476332,0.22803759263936255,131265.32613658198,3037.934328143011,134303.260464725,2679,0,727.2222222222222,33,3,18,33.82065694012597,0.6395202020202021,43.811274509803916,1024.7549019607834,31.053178847296465,0
4834,4,1,1,35,0.027777777777777776,0.027777777777777776,0.9722222222222222,36,800,400,400,0.5,12,4,8,393.945402868663,0.7152777777777778,0.01400180668473383,0.23073945025164538,131328.125,3147.2372404844295,134475.36224048442,2680,0,728.1944444444445,32,4,18,33.65514905149051,0.642578125,43.75,1025.0,32.03125,0
4835,4,0,0,35,0.0,0.0,1.0,35,1000,700,300,0.7,13,7,6,401.29488514569505,0.7050420168067226,0.014143156338548568,0.23484575217935175,131295.77219480166,3537.6643646056627,134833.43655940733,2681,2,750.0,32,3,19,33.49965093835982,0.6422526041666666,43.78156565656566,1024.873737373738,32.027304292929315,0
4836,4,2,2,35,0.05405405405405406,0.05405405405405406,0.9459459459459459,37,550,300,250,0.5454545454545454,8,3,5,381.1537154953499,0.72754004004004,0.009588674265766484,0.2256483869049152,131736.68368235786,2642.389276075976,134379.07295843383,2682,0,710.4054054054054,33,4,17,33.56947097210616,0.6442550505050504,43.35171568627452,1026.593137254903,31.108882947118275,0
4837,4,0,0,35,0.0,0.0,1.0,35,1050,800,250,0.7619047619047619,13,8,5,399.6862081128745,0.703501400560224,0.012727437641723238,0.2347150550998426,131428.24172973647,3506.011115180137,134934.2528449166,2683,4,752.0,31,4,19,33.406481481481485,0.6461693548387096,43.65234375000001,1025.3906250000011,33.07711693548391,0
4838,4,0,0,35,0.0,0.0,1.0,35,1250,900,350,0.72,16,9,7,399.6044684033646,0.7021708683473389,0.02012368740818693,0.23507725150211395,131495.00740898994,3509.198506673196,135004.20591566313,2684,5,753.0,31,4,19,33.34087110151919,0.6468413978494623,43.58723958333334,1025.6510416666679,33.085517473118315,0
4839,4,0,0,35,0.0,0.0,1.0,35,550,400,150,0.7272727272727273,7,4,3,399.15032933791184,0.7021008403361344,0.019625405689627007,0.23522105047519884,131561.79004245342,3502.586364746103,135064.3764071995,2685,6,754.0,31,4,17,33.284813005034486,0.647513440860215,43.52213541666667,1025.911458333334,33.09391801075271,0
4840,4,1,1,35,0.027777777777777776,0.027777777777777776,0.9722222222222222,36,650,400,250,0.6153846153846154,9,4,5,390.57375303778275,0.7128968253968254,0.01390425837124476,0.23169484562044435,131813.89534550064,3096.6095615243576,134910.504907025,2686,0,734.0277777777778,32,4,17,33.24956965449403,0.6474609375,43.27651515151516,1026.8939393939409,32.09043560606065,0
4841,4,0,0,35,0.0,0.0,1.0,35,850,600,250,0.7058823529411765,11,6,5,401.0819532117964,0.7014005602240896,0.021645131476414115,0.2371889750314022,131695.40617201067,3564.1301472981822,135259.53631930886,2687,8,756.0,31,4,17,33.09984037380016,0.6488575268817204,43.391927083333336,1026.432291666667,33.11071908602152,0
4842,4,0,0,35,0.0,0.0,1.0,35,750,400,350,0.5333333333333333,11,4,7,399.5120085856894,0.7030812324929971,0.02369779871365152,0.23667559637101138,131762.23966810445,3528.119405110687,135290.35907321514,2688,9,757.0,31,4,17,33.072421264003374,0.649529569892473,43.32682291666667,1026.692708333334,33.11911962365593,0
4843,4,0,0,35,0.0,0.0,1.0,35,600,300,300,0.5,9,3,6,399.2979563897338,0.7026610644257703,0.02574413908157025,0.23727457087147463,131878.7324794665,3531.7816740638905,135410.51415353038,2689,10,758.0,32,3,17,32.95994673222702,0.6481119791666665,43.21338383838385,1027.1464646464656,32.09832702020205,0
4844,4,0,0,35,0.0,0.0,1.0,35,400,200,200,0.5,6,2,4,397.0608069891488,0.7019607843137254,0.024378423935946136,0.236146690472494,131911.15702479347,3475.3500918273744,135386.50711662084,2690,11,759.0,32,3,17,32.98457472959685,0.6484375,43.18181818181819,1027.272727272728,32.10227272727275,0
4845,4,0,0,35,0.0,0.0,1.0,35,800,500,300,0.625,11,5,6,396.2124724996801,0.7039215686274509,0.030709283344742433,0.23624712920695246,132008.4545741508,3460.6792355372163,135469.133809688,2691,12,760.0,32,3,17,32.9079125199656,0.6494140624999998,43.087121212121225,1027.6515151515168,32.1141098484849,0
4846,4,0,0,35,0.0,0.0,1.0,35,1150,1000,150,0.8695652173913043,13,10,3,390.2683465979846,0.7049719887955181,0.027175476132019538,0.2341035310299842,132235.621684012,3321.475487195205,135557.09717120722,2692,13,761.0,32,3,18,32.83104182011622,0.6516927083333333,42.86616161616163,1028.5353535353547,32.141729797979835,0
4847,4,0,0,35,0.0,0.0,1.0,35,1050,800,250,0.7619047619047619,13,8,5,391.0117806466178,0.7039915966386554,0.028199824715162025,0.2353579034172777,132365.519143455,3351.295467299284,135716.81461075429,2693,14,762.0,32,3,19,32.68072597137014,0.6529947916666665,42.739898989899004,1029.040404040406,32.15751262626269,0
4848,4,0,0,35,0.0,0.0,1.0,35,550,400,150,0.7272727272727273,7,4,3,388.8634347784634,0.7044817927170868,0.030099537361558903,0.2344685444019257,132430.49178655245,3299.4751811039787,135729.96696765642,2694,15,763.0,32,3,19,32.670408079816816,0.6536458333333333,42.67676767676768,1029.2929292929298,32.165404040404056,0
4849,4,0,0,35,0.0,0.0,1.0,35,850,500,350,0.5882352941176471,12,5,7,389.95203264314256,0.7023809523809523,0.03592978030064131,0.2355310277164583,132495.48037190098,3333.3763774104887,135828.85674931147,2695,16,764.0,32,3,20,32.57680279617366,0.654296875,42.613636363636374,1029.5454545454559,32.173295454545496,0
4850,4,0,0,35,0.0,0.0,1.0,35,500,300,200,0.6,7,3,4,390.8080751503385,0.7025910364145658,0.03641587106945798,0.2362520276390669,132527.9806429192,3358.6010037241217,135886.58164664332,2696,17,765.0,32,3,20,32.52197016145513,0.6546223958333333,42.58207070707071,1029.671717171718,32.17724116161619,0
4851,4,2,1,36,0.05405405405405406,0.02702702702702703,0.972972972972973,37,650,300,350,0.46153846153846156,10,3,7,372.18940203979946,0.7271021021021021,0.03637282141955023,0.228291970805304,133072.72002551032,2505.651218820879,135578.3712443312,2697,0,724.5945945945946,34,3,18,32.45307872774125,0.655330882352941,42.05357142857144,1031.7857142857154,30.346638655462215,0
4852,4,0,0,36,0.0,0.0,1.0,36,750,600,150,0.8,9,6,3,383.9433788458777,0.7132605820105821,0.046093884070598,0.23502919416332757,132997.7671598665,3012.722420463296,136010.4895803298,2698,1,745.7222222222222,33,3,19,32.22533266009268,0.6568813131313129,42.126225490196084,1031.4950980392164,31.257427213309587,0
4853,4,0,0,36,0.0,0.0,1.0,36,900,500,400,0.5555555555555556,13,5,8,387.4336919214268,0.714186507936508,0.04297488485040435,0.2375676804287324,133060.9790254952,3110.461270905444,136171.44029640066,2699,2,746.7222222222222,33,3,19,32.07167814863207,0.6575126262626261,42.06495098039217,1031.740196078433,31.26485442661918,0
4854,4,0,0,36,0.0,0.0,1.0,36,1250,900,350,0.72,16,9,7,384.43997895166683,0.7147486772486773,0.03818702340431113,0.23633237246211267,133155.82498317974,3038.0845107651107,136193.90949394484,2700,3,747.7222222222222,33,3,20,32.05345127839783,0.6584595959595958,41.973039215686285,1032.1078431372566,31.275995246583534,0
4855,4,0,0,36,0.0,0.0,1.0,36,650,400,250,0.6153846153846154,9,4,5,382.9401637252218,0.7131944444444445,0.041350110794555084,0.2358105218729001,133219.07439446385,3002.986831987715,136222.06122645157,2701,4,748.7222222222222,33,3,20,32.02852959797404,0.659090909090909,41.91176470588236,1032.352941176472,31.283422459893092,0
4856,4,0,0,36,0.0,0.0,1.0,36,900,700,200,0.7777777777777778,11,7,4,383.7323055180942,0.714186507936508,0.04072404155460596,0.2371038028523829,133345.61827181868,3033.8043060361533,136379.42257785483,2702,5,749.7222222222222,33,3,20,31.880833728840354,0.6603535353535352,41.78921568627452,1032.8431372549032,31.29827688651222,0
4857,4,0,0,36,0.0,0.0,1.0,36,1050,800,250,0.7619047619047619,13,8,5,382.4141519250777,0.7115410052910054,0.028897849462365066,0.23709677419354838,133472.2222222223,3008.3333333333417,136480.55555555565,2703,6,750.7222222222222,33,3,20,31.787634408602134,0.6616161616161615,41.66666666666667,1033.3333333333342,31.31313131313134,0
4858,4,0,0,36,0.0,0.0,1.0,36,1100,800,300,0.7272727272727273,14,8,6,382.24044213413055,0.7117724867724868,0.032308624413887044,0.23780091223034858,133598.8862456748,3013.379469434837,136612.26571510965,2704,7,751.7222222222222,33,3,20,31.664888572783305,0.6628787878787878,41.544117647058826,1033.8235294117653,31.327985739750464,0
4859,4,1,1,36,0.02702702702702703,0.02702702702702703,0.972972972972973,37,750,500,250,0.6666666666666666,10,5,5,376.44784578505954,0.7276651651651651,0.02619370405840704,0.23574097086194062,133841.52494331056,2676.870748299306,136518.39569160988,2705,0,732.3783783783783,34,3,18,31.571176560822206,0.6629901960784315,41.3095238095238,1034.761904761904,30.43417366946776,0
4860,4,0,0,36,0.0,0.0,1.0,36,750,300,450,0.4,12,3,9,384.5061880910132,0.7107804232804233,0.031240126382306332,0.24003196948876854,133725.6103421761,3083.664936562861,136809.27527873896,2706,9,753.7222222222222,33,3,18,31.479067930489727,0.6641414141414141,41.42156862745098,1034.3137254901962,31.342840166369584,0
4861,4,0,0,36,0.0,0.0,1.0,36,1100,800,300,0.7272727272727273,14,8,6,383.69206347567876,0.7107804232804233,0.032409600505289404,0.24034835192794,133852.39451172622,3071.6202902729674,136924.01480199918,2707,10,754.7222222222222,33,3,18,31.372868308858365,0.6654040404040404,41.299019607843135,1034.8039215686272,31.357694592988704,0
4862,4,0,0,36,0.0,0.0,1.0,36,700,500,200,0.7142857142857143,9,5,4,388.57436938735594,0.710978835978836,0.038696819007025596,0.24382608646698423,133915.80912389458,3207.2502162629694,137123.05934015755,2708,11,755.7222222222222,33,3,18,31.182907096061257,0.6660353535353536,41.23774509803921,1035.0490196078426,31.365121806298262,0
4863,4,0,0,36,0.0,0.0,1.0,36,450,400,50,0.8888888888888888,5,4,1,389.525358341942,0.7114748677248678,0.03581386784511764,0.24484451095779217,133979.2387543253,3237.6621972318403,137216.90095155715,2709,12,756.7222222222222,33,3,18,31.09463778409092,0.6666666666666666,41.1764705882353,1035.2941176470592,31.372549019607856,0
4864,4,0,0,36,0.0,0.0,1.0,36,950,800,150,0.8421052631578947,11,8,3,390.43618920906135,0.7104166666666667,0.03852071005917135,0.24584096861524365,134042.68340301808,3267.0228998462167,137309.7063028643,2710,13,757.7222222222222,33,3,18,31.007396449704146,0.6672979797979798,41.115196078431374,1035.5392156862747,31.379976232917414,0
4865,4,0,0,36,0.0,0.0,1.0,36,850,500,350,0.5882352941176471,12,5,7,387.19730558217475,0.7083002645502646,0.03285815686738447,0.24443456490561044,134137.87853529895,3187.565029075356,137325.44356437432,2711,14,758.7222222222222,33,3,18,30.995775661500847,0.6682449494949495,41.02328431372549,1035.9068627450981,31.39111705288176,0
4866,4,0,0,36,0.0,0.0,1.0,36,1000,500,500,0.5,15,5,10,386.84342239841135,0.7068452380952381,0.03715199768764865,0.24505878825643182,134264.85794225777,3187.8954308439024,137452.75337310167,2712,15,759.7222222222222,33,3,20,30.877650664144095,0.6695075757575758,40.900735294117645,1036.3970588235293,31.405971479500888,0
4867,4,0,0,36,0.0,0.0,1.0,36,850,700,150,0.8235294117647058,10,7,3,382.76075985446744,0.7083002645502646,0.033280798529025546,0.24310480693459408,134360.13192041515,3085.557237600915,137445.68915801606,2713,16,760.7222222222222,33,3,20,30.88800236406619,0.6704545454545454,40.80882352941176,1036.7647058823525,31.417112299465227,0
4868,4,0,0,36,0.0,0.0,1.0,36,900,700,200,0.7777777777777778,11,7,4,381.8675432191192,0.7087301587301588,0.03611334328243965,0.2429837961272276,134427.29768990923,3066.684382086156,137493.9820719954,2714,17,761.7222222222222,34,2,20,30.843904258982892,0.6688112745098039,40.74404761904761,1037.023809523809,30.500700280112028,0
4869,4,0,0,36,0.0,0.0,1.0,36,1200,1100,100,0.9166666666666666,13,11,2,358.5010167793917,0.7091600529100529,0.01575352393376095,0.22634528849372862,134142.16739966327,2418.0206811541384,136560.1880808174,2715,18,762.7222222222222,36,0,14,31.734654129071995,0.6617476851851851,41.01914414414415,1035.9234234234243,28.775650650650675,3
4870,4,0,0,36,0.0,0.0,1.0,36,950,700,250,0.7368421052631579,12,7,5,359.44045368620016,0.7098544973544973,0.014076086956521738,0.22711896798853334,134171.333495658,2445.32099667237,136616.6544923304,2716,19,763.7222222222222,36,0,14,31.681159420289845,0.662037037037037,40.990990990991,1036.0360360360376,28.778778778778822,0
4871,4,0,0,36,0.0,0.0,1.0,36,1150,700,450,0.6086956521739131,16,7,9,359.44045368620016,0.7098544973544973,0.014076086956521738,0.22711896798853334,134171.333495658,2445.32099667237,136616.6544923304,2717,20,764.7222222222222,36,0,14,31.681159420289845,0.662037037037037,40.990990990991,1036.0360360360376,28.778778778778822,0
4872,4,0,0,36,0.0,0.0,1.0,36,1000,700,300,0.7,13,7,6,358.57942836485665,0.7089947089947091,0.008263315466705556,0.2272978690544178,134288.02958363795,2430.5849768687917,136718.61456050674,2718,21,765.7222222222222,36,0,15,31.586810082572804,0.6631944444444443,40.87837837837839,1036.4864864864885,28.791291291291348,0
4873,4,0,0,36,0.0,0.0,1.0,36,1050,800,250,0.7619047619047619,13,8,5,357.19300017676284,0.7098875661375662,-0.013428252372976512,0.2263739077553372,134280.73459201402,2393.084493382751,136673.81908539677,2719,22,766.7222222222222,35,1,19,31.630025125628137,0.6651785714285714,40.88541666666667,1036.4583333333344,29.61309523809527,3
4874,4,1,0,37,0.02702702702702703,0.0,1.0,37,950,700,250,0.7368421052631579,12,7,5,349.93855076863633,0.7202827827827828,-0.00013264798540890688,0.22360649377340167,134580.80317911954,2019.2735125171519,136600.0766916367,2720,0,746.972972972973,35,2,20,31.518521100576304,0.6681547619047619,40.59606481481482,1037.615740740741,29.646164021164033,0
4875,4,0,0,37,0.0,0.0,1.0,37,900,800,100,0.8888888888888888,10,8,2,349.48405466456916,0.7203453453453453,-0.0011142747390986418,0.22384951576395634,134667.6421987866,2012.8387255498697,136680.48092433647,2721,1,747.972972972973,36,1,20,31.443709088278908,0.6669560185185186,40.512387387387385,1037.9504504504503,28.83195695695695,0
4876,4,0,0,37,0.0,0.0,1.0,37,1200,900,300,0.75,15,9,6,345.63556460121794,0.71996996996997,-0.005819763165529235,0.2224561627576436,134843.02873397042,1921.309273800824,136764.33800777124,2722,2,748.972972972973,36,1,19,31.368815280638987,0.6686921296296295,40.343468468468465,1038.6261261261259,28.85072572572572,0
4877,4,0,0,37,0.0,0.0,1.0,37,900,600,300,0.6666666666666666,12,6,6,346.10662377626477,0.7192192192192192,-0.007242364315535044,0.22311904991866127,134901.5162755661,1938.0616680870053,136839.5779436531,2723,3,749.972972972973,36,1,19,31.29832881662149,0.6692708333333334,40.28716216216216,1038.8513513513515,28.856981981981985,0
4878,4,0,0,37,0.0,0.0,1.0,37,700,400,300,0.5714285714285714,10,4,6,345.2985758464136,0.7172172172172172,-0.010133670731850453,0.22313832338310272,134989.2713659607,1922.3206314422678,136911.59199740298,2724,4,750.972972972973,36,1,19,31.23193902615229,0.6701388888888888,40.20270270270271,1039.1891891891903,28.866366366366396,0
4879,4,0,0,37,0.0,0.0,1.0,37,900,600,300,0.6666666666666666,12,6,6,348.90969526939,0.7168418418418419,-0.012373114095570958,0.2260200278618766,135077.05498995632,2025.9388188864682,137102.9938088428,2725,5,751.972972972973,36,1,19,31.050716787635864,0.6710069444444444,40.11824324324325,1039.527027027028,28.87575075075078,0
4880,4,0,0,37,0.0,0.0,1.0,37,700,600,100,0.8571428571428571,8,6,2,350.5204661644294,0.7167167167167167,-0.00946077670869161,0.2274318667671242,135135.5932579539,2073.5582288369483,137209.15148679086,2726,6,752.972972972973,36,1,19,30.950575833062572,0.6715856481481481,40.06193693693694,1039.7522522522524,28.88200700700701,0
4881,4,0,0,37,0.0,0.0,1.0,37,800,600,200,0.75,10,6,4,348.1290813788562,0.7151526526526526,-0.00034522506919110185,0.22679946782636637,135281.99440995054,2019.1192882071332,137301.11369815766,2727,7,753.972972972973,36,1,19,30.867070794544276,0.6730324074074073,39.921171171171174,1040.3153153153157,28.89764764764766,0
4882,4,0,0,37,0.0,0.0,1.0,37,800,700,100,0.875,9,7,2,345.37146968137813,0.715965965965966,0.0008774059201503981,0.2255531979735417,135369.87314595006,1950.578407799698,137320.45155374976,2728,8,754.972972972973,36,1,19,30.8514139883851,0.6739004629629629,39.836711711711715,1040.6531531531534,28.90703203203204,0
4883,4,0,0,37,0.0,0.0,1.0,37,500,300,200,0.6,7,3,4,346.2517235351103,0.7153403403403403,0.00481936166852881,0.2263124772921847,135399.17239875026,1976.4393616589725,137375.61176040923,2729,9,755.972972972973,36,1,19,30.79938505374019,0.6741898148148149,39.808558558558566,1040.765765765767,28.910160160160192,0
4884,4,0,1,36,0.0,0.02702702702702703,0.972972972972973,37,850,600,250,0.7058823529411765,11,6,5,346.1612379068901,0.7153403403403403,0.004432865192359081,0.2264379562613862,135428.4748219504,1976.0176984416971,137404.4925203921,2730,10,756.972972972973,36,1,20,30.772611706156013,0.6744791666666666,39.78040540540541,1040.878378378379,28.913288288288307,0
4885,4,0,0,36,0.0,0.0,1.0,36,1200,900,300,0.75,15,9,6,350.58842339889316,0.7114748677248678,0.011590549624357571,0.22910545808160218,135392.66117969816,2293.419924554174,137686.08110425234,2731,11,775.5833333333334,35,1,20,30.693023428232497,0.6761904761904762,39.81481481481481,1040.7407407407402,29.73544973544972,0
4886,4,1,0,37,0.02702702702702703,0.0,1.0,37,850,700,150,0.8235294117647058,10,7,3,340.47066440945713,0.7202202202202203,0.0130636473048924,0.2243614378287963,135692.33929875834,1839.8521832643546,137532.1914820227,2732,0,755.5945945945946,36,1,21,30.658686410145545,0.6770833333333334,39.52702702702703,1041.8918918918928,28.941441441441466,0
4887,4,0,0,37,0.0,0.0,1.0,37,700,300,400,0.42857142857142855,11,3,8,340.54989768551246,0.7195945945945946,0.012335187699855643,0.22496711656526888,135780.35119156312,1847.9969411979498,137628.34813276108,2733,1,756.5945945945946,36,1,21,30.569286871961115,0.677951388888889,39.442567567567565,1042.2297297297291,28.95082582582581,0
4888,4,0,0,37,0.0,0.0,1.0,37,950,600,350,0.631578947368421,13,6,7,339.06713036800545,0.7189064064064064,0.012164498119554334,0.22417181133473274,135809.69482996513,1809.7207004301642,137619.4155303953,2734,2,757.5945945945946,36,1,21,30.578813742437333,0.6782407407407407,39.414414414414416,1042.3423423423426,28.95395395395396,0
4889,4,0,0,37,0.0,0.0,1.0,37,1250,900,350,0.72,16,9,7,343.34174912725746,0.7181556556556556,0.014335034743198305,0.22793461925932115,135956.46057797657,1935.9057959986967,137892.36637397527,2735,3,758.5945945945946,36,1,15,30.321824496994573,0.6796875,39.273648648648646,1042.905405405405,28.969594594594582,0
4890,4,0,0,37,0.0,0.0,1.0,37,550,300,250,0.5454545454545454,8,3,5,343.40295216472526,0.7182807807807807,0.01243675115409082,0.2281634248887866,135985.82323877938,1939.5866305494717,137925.40986932887,2736,4,759.5945945945946,36,1,16,30.291108831785774,0.6799768518518519,39.2454954954955,1043.0180180180184,28.972722722722736,0
4891,4,0,0,37,0.0,0.0,1.0,37,1150,900,250,0.782608695652174,14,9,5,343.5836415050866,0.7154029029029029,0.017240373735842196,0.22941881768509648,136162.0657819981,1956.611679246802,138118.6774612449,2737,5,760.5945945945946,36,1,18,30.111674579197235,0.681712962962963,39.07657657657657,1043.693693693693,28.99149149149147,0
4892,4,0,0,37,0.0,0.0,1.0,37,1100,900,200,0.8181818181818182,13,9,4,341.9615733958436,0.7144019019019019,0.024277972287895633,0.22890438606157854,136250.2298540093,1918.4685952844613,138168.69844929376,2738,6,761.5945945945946,36,1,18,30.066650487182248,0.6825810185185186,38.99211711711711,1044.0315315315306,29.00087587587585,0
4893,4,0,0,37,0.0,0.0,1.0,37,1050,900,150,0.8571428571428571,12,9,3,340.0735752999526,0.7144019019019019,0.03540886496197504,0.20716109860611354,132815.23946544938,1642.2963218317295,134457.53578728111,2739,7,762.5945945945946,35,2,19,33.53965491428999,0.650595238095238,42.30324074074075,1030.787037037038,29.45105820105823,5
4894,4,0,0,37,0.0,0.0,1.0,37,500,400,100,0.8,6,4,2,341.36507720793634,0.7137762762762763,0.03184504666318766,0.20827945943618498,132874.89819101527,1671.7699759945335,134546.6681670098,2740,8,763.5945945945946,35,2,19,33.44652746594821,0.6511904761904761,42.24537037037038,1031.0185185185198,29.457671957671995,0
4895,4,1,0,38,0.02631578947368421,0.0,1.0,38,1050,900,150,0.8571428571428571,12,9,3,333.15525357187454,0.7222913703176861,0.03999609626159639,0.20526662397492945,133239.5909422939,1277.89394123857,134517.48488353248,2741,0,744.4736842105264,36,2,20,33.292884671320536,0.6527777777777777,41.89189189189191,1032.4324324324346,28.678678678678736,0
4896,4,0,0,38,0.0,0.0,1.0,38,650,200,450,0.3076923076923077,11,2,9,334.16115890564515,0.7222913703176861,-0.02000226494153634,0.18835827604778488,129843.17440221999,1077.7091268467302,130920.88352906672,2742,1,745.4736842105264,37,1,18,36.688519813519825,0.6168355855855856,45.202850877192986,1019.1885964912286,27.54563774300618,8
4897,4,0,0,38,0.0,0.0,1.0,38,800,600,200,0.75,10,6,4,336.7509912323495,0.7215801327643433,-0.025846016266604765,0.19036154817444506,129954.95158366051,1152.491752269946,131107.44333593047,2743,2,746.4736842105264,37,1,18,36.509190056278456,0.6179617117117115,45.09320175438597,1019.6271929824574,27.557491702228578,0
4898,4,0,0,38,0.0,0.0,1.0,38,350,200,150,0.5714285714285714,5,2,3,337.1247543068563,0.722321005215742,-0.029564233163554388,0.19070925882322168,129982.90339335184,1164.0908741151156,131146.99426746694,2744,3,747.4736842105264,37,1,18,36.47132616487456,0.6182432432432432,45.06578947368421,1019.7368421052635,27.560455192034148,0
4899,4,1,0,39,0.02564102564102564,0.0,1.0,39,750,300,450,0.4,12,3,9,331.2687102816827,0.7304318488529015,-0.013410578264134498,0.18940962142900059,130398.95171305441,839.4185112134007,131238.37022426783,2745,0,729.2820512820513,38,1,20,36.199442119944216,0.6206140350877192,44.658119658119666,1021.3675213675224,26.878092667566378,0
4900,4,1,1,39,0.025,0.025,0.975,40,700,500,200,0.7142857142857143,9,5,4,321.95982269022215,0.744684829059829,-0.018250127356087553,0.1853393348800316,130661.65500217052,413.5606553819839,131075.2156575525,2746,0,712.025,39,1,17,36.17178213618612,0.6215277777777777,44.401041666666686,1022.3958333333363,26.215277777777853,0
4901,4,0,0,39,0.0,0.0,1.0,39,1200,800,400,0.6666666666666666,16,8,8,333.87272345172767,0.7304318488529015,-0.011179262093672815,0.19211233257423843,130644.58832137137,923.7329014172185,131568.3212227886,2747,2,731.2820512820513,38,1,17,35.88454035601073,0.623081140350877,44.41773504273505,1022.3290598290614,26.90339631129109,0
4902,4,0,0,39,0.0,0.0,1.0,39,950,600,350,0.631578947368421,13,6,7,335.6527074286414,0.7308816914080072,-0.012200575751489584,0.19395743353224165,130808.47447083438,981.2437221491825,131789.71819298356,2748,3,732.2820512820513,38,1,17,35.673411662315054,0.6247258771929824,44.25747863247864,1022.9700854700865,26.92026540710754,0
4903,4,0,0,39,0.0,0.0,1.0,39,1150,1000,150,0.8695652173913043,13,10,3,335.8912237213717,0.7331309041835358,-0.019860957243549526,0.19506119428473845,130999.80481591067,1000.3369493754213,132000.1417652861,2749,4,733.2820512820513,38,1,19,35.47406595700273,0.6266447368421052,44.070512820512825,1023.7179487179494,26.939946018893405,0
4904,4,0,0,39,0.0,0.0,1.0,39,1550,1100,450,0.7096774193548387,20,11,9,336.60361737070735,0.7311628430049483,-0.02237538547124429,0.19617136047008943,131136.55495516476,1028.2077534882046,132164.76270865297,2750,5,734.2820512820513,38,1,19,35.31779145370467,0.628015350877193,43.93696581196581,1024.252136752137,26.954003598740446,0
4905,4,0,0,39,0.0,0.0,1.0,39,1000,700,300,0.7,13,7,6,335.37152654570053,0.7303193882141251,-0.026467292918434415,0.19573204918117598,131191.27498584634,999.5636322960138,132190.83861814236,2751,6,735.2820512820513,38,1,20,35.29413042722565,0.628563596491228,43.88354700854701,1024.4658119658122,26.95962663067927,0
4906,4,1,1,39,0.025,0.025,0.975,40,900,800,100,0.8888888888888888,10,8,2,327.3844992947261,0.7398237179487179,-0.028312845088029892,0.1924411395425644,131465.04635336774,607.9950142450227,132073.04136761275,2752,0,717.875,38,2,21,35.2228530749731,0.6313048245614035,43.616452991452995,1025.5341880341887,26.987741790373388,0
4907,4,0,0,39,0.0,0.0,1.0,39,600,400,200,0.6666666666666666,8,4,4,336.37221337776816,0.7286324786324787,-0.028337049622748967,0.19716262212343283,131356.2240905855,1036.9167676592683,132393.1408582448,2753,8,737.2820512820513,37,2,21,35.102127678539574,0.6320382882882883,43.72258771929824,1025.1096491228066,27.705666192508286,0
4908,4,0,0,39,0.0,0.0,1.0,39,700,500,200,0.7142857142857143,9,5,4,336.2955760816723,0.7294197031039137,-0.028948306595365403,0.1972624615033648,131384.3261869036,1036.7935326254135,132421.11971952903,2754,9,738.2820512820513,37,2,22,35.075757575757564,0.6323198198198199,43.695175438596486,1025.2192982456136,27.70862968231388,0
4909,4,0,0,39,0.0,0.0,1.0,39,800,700,100,0.875,9,7,2,332.1491121197518,0.726889338731444,-0.02200386465485349,0.1955478252913956,131524.88175448202,937.1745392813029,132462.05629376334,2755,10,739.2820512820513,37,2,22,35.04041956173168,0.6337274774774776,43.55811403508771,1025.7675438596482,27.723447131341842,0
4910,4,0,1,38,0.0,0.02564102564102564,0.9743589743589743,39,1150,800,350,0.6956521739130435,15,8,7,336.8441807757564,0.7241340530814215,-0.027336549075679506,0.199191306142884,131693.64762474978,1072.0477695059851,132765.69539425577,2756,11,740.2820512820513,37,2,17,34.75000445109141,0.6354166666666667,43.393640350877185,1026.42543859649,27.741228070175406,0
4911,4,0,0,38,0.0,0.0,1.0,38,1150,900,250,0.782608695652174,14,9,5,340.99692457147415,0.7234767662399242,-0.01762160339449803,0.20224421777149143,131806.21831957888,1389.1030172745218,133195.3213368534,2757,12,747.8157894736842,37,1,17,34.53005428012102,0.6365427927927929,43.283991228070164,1026.8640350877174,27.753082029397767,0
4912,4,0,1,37,0.0,0.02631578947368421,0.9736842105263158,38,800,600,200,0.75,10,6,4,342.61890912453964,0.7227655286865813,-0.010994334510223025,0.20372794132544517,131903.67408366204,1438.5385848126198,133342.21266847468,2758,13,748.8157894736842,38,0,17,34.390275611024435,0.6356907894736842,43.18910256410256,1027.2435897435896,27.032726045883937,0
4913,4,0,0,37,0.0,0.0,1.0,37,800,500,300,0.625,11,5,6,347.6908335240493,0.7169669669669669,-0.004824811999699863,0.20636706887111844,131834.3685076178,1767.5202947060707,133601.88880232387,2759,14,768.4054054054054,37,0,17,34.32984554060787,0.6368243243243243,43.256578947368425,1026.973684210527,27.75604551920343,0
4914,4,0,0,37,0.0,0.0,1.0,37,850,800,50,0.9411764705882353,9,8,1,351.25149181468925,0.7177177177177178,-0.0032885911848445915,0.20894445884519539,131918.83710612892,1867.3376663973668,133786.17477252628,2760,15,769.4054054054054,37,0,17,34.153302558081634,0.6376689189189189,43.174342105263165,1027.3026315789484,27.764935988620227,0
4915,4,0,0,37,0.0,0.0,1.0,37,950,700,250,0.7368421052631579,12,7,5,352.37242076272025,0.7179054054054054,-0.00306869669797849,0.2099225654779055,131975.16453379902,1900.8816414666228,133876.04617526566,2761,16,770.4054054054054,37,0,18,34.06775779888308,0.6382319819819819,43.11951754385966,1027.5219298245627,27.770862968231423,0
4916,4,0,0,37,0.0,0.0,1.0,37,900,700,200,0.7777777777777778,11,7,4,350.8903253333331,0.7173423423423423,0.0019718918918920636,0.20966200127469742,132087.85545792957,1869.6701148430554,133957.52557277263,2762,17,771.4054054054054,37,0,19,33.99233333333335,0.639358108108108,43.009868421052644,1027.9605263157912,27.782716927453816,0
4917,4,0,0,37,0.0,0.0,1.0,37,1200,900,300,0.75,15,9,6,350.5648728638256,0.7175925925925926,0.0013138938512073928,0.2102492651830363,132228.78674207465,1870.9535626346794,134099.74030470932,2763,18,772.4054054054054,37,0,19,33.858830845771145,0.6407657657657657,42.87280701754387,1028.508771929826,27.797534376481785,0
4918,4,0,0,37,0.0,0.0,1.0,37,1250,900,350,0.72,16,9,7,353.0871586648722,0.7173423423423423,-0.0006801111833933948,0.21287708642460013,132426.97934420937,1951.7613798149346,134378.7407240243,2764,19,773.4054054054054,36,1,19,33.59454777534647,0.6446759259259258,42.680180180180194,1029.2792792792816,28.591091091091155,0
4919,4,0,0,37,0.0,0.0,1.0,37,750,500,250,0.6666666666666666,10,5,5,351.1431800100324,0.7165915915915916,-0.0013835756561635382,0.2120311064499154,132484.94059938332,1904.2366691015527,134389.17726848487,2765,20,774.4054054054054,36,1,20,33.58628673521477,0.6452546296296295,42.62387387387388,1029.5045045045058,28.597347347347384,0
4920,4,0,0,37,0.0,0.0,1.0,37,650,600,50,0.9230769230769231,7,6,1,342.90058212257617,0.715965965965966,-0.05360206724493144,0.1988910906772235,130953.25213304508,1580.789277453122,132534.0414104982,2766,21,775.4054054054054,36,1,14,35.34171342648625,0.6299189814814815,44.11599099099099,1023.5360360360351,28.43155655655653,7
4921,4,0,0,37,0.0,0.0,1.0,37,1100,1100,0,1.0,11,11,0,345.7396730548169,0.7140265265265265,-0.049512895345312,0.2012904344917094,131097.37059694823,1665.1124097070015,132762.48300665524,2767,22,776.4054054054054,36,1,14,35.12343303276887,0.6313657407407407,43.97522522522522,1024.0990990990986,28.447197197197184,0
4922,4,0,0,37,0.0,0.0,1.0,37,950,800,150,0.8421052631578947,11,8,3,349.33495407353223,0.7138388388388388,-0.05839667560735806,0.20414892402794266,131241.5683208545,1769.4534483807997,133011.02176923532,2768,23,777.4054054054054,36,1,14,34.88570172546434,0.6328125,43.83445945945945,1024.6621621621612,28.46283783783781,0
4923,4,0,0,37,0.0,0.0,1.0,37,750,300,450,0.4,12,3,9,347.0770105108399,0.7132132132132132,-0.05584714767491539,0.20359465874295649,131385.8453047641,1720.2012823634348,133106.04658712755,2769,24,778.4054054054054,36,1,16,34.797891036906854,0.6342592592592593,43.69369369369369,1025.2252252252244,28.478478478478458,0
4924,4,0,1,36,0.0,0.02702702702702703,0.972972972972973,37,800,500,300,0.625,11,5,6,346.57472512344,0.7113988988988988,-0.06164381529405105,0.20406911255005902,131530.20154867697,1717.008689432672,133247.21023810963,2770,25,779.4054054054054,36,1,17,34.665120576719,0.6357060185185186,43.552927927927925,1025.7882882882877,28.494119119119105,0
4925,4,0,1,35,0.0,0.027777777777777776,0.9722222222222222,36,950,800,150,0.8421052631578947,11,8,3,350.2691322779662,0.7136243386243387,-0.06367020076697483,0.20675673280801937,131624.87809713656,2020.8263674554282,133645.70446459198,2771,26,775.4166666666666,35,1,16,34.47486653131815,0.6386904761904761,43.46064814814815,1026.157407407408,29.318783068783087,0
4926,4,0,0,35,0.0,0.0,1.0,35,1300,1200,100,0.9230769230769231,14,12,2,359.83054999234645,0.709173669467787,-0.06358709164138998,0.21227785834250773,131602.8220663267,2470.9431689342637,134073.76523526097,2772,27,794.1428571428571,34,1,16,34.25184669528562,0.6406249999999998,43.48214285714287,1026.07142857143,30.178571428571473,0
4927,4,0,0,35,0.0,0.0,1.0,35,500,200,300,0.4,8,2,6,359.45102450038735,0.7095238095238094,-0.0620014250915536,0.2123939192746979,131663.90483276662,2465.3450963719033,134129.24992913852,2773,28,795.1428571428571,34,1,16,34.199918802923094,0.6412377450980391,43.42261904761906,1026.3095238095252,30.18557422969192,0
4928,4,0,0,35,0.0,0.0,1.0,35,850,800,50,0.9411764705882353,9,8,1,364.14919639032036,0.7107843137254901,-0.06810408921933142,0.20492915026986663,129779.68606519762,2578.435151608868,132358.1212168065,2774,29,796.1428571428571,32,3,19,35.98900247831471,0.626953125,45.26515151515152,1018.9393939393955,31.84185606060611,7
4929,4,1,0,36,0.027777777777777776,0.0,1.0,36,1250,1000,250,0.8,15,10,5,346.84250429515333,0.7217923280423281,-0.024811188984066757,0.18702863054044014,128087.52745566519,1685.2397583394313,129772.76721400462,2775,0,775.0,36,0,19,38.153808358363946,0.6009837962962963,46.93130630630631,1012.2747747747753,28.11874374374376,8
4930,4,0,0,36,0.0,0.0,1.0,36,650,500,150,0.7692307692307693,8,5,3,344.46077020758037,0.7232142857142858,-0.026825287969418188,0.18614498323323783,128173.82979948989,1630.1839082380407,129804.01370772794,2776,1,776.0,35,1,20,38.12590486531795,0.6038690476190476,46.84606481481482,1012.6157407407408,28.931878306878307,0
4931,4,1,0,37,0.02702702702702703,0.0,1.0,37,1050,800,250,0.7619047619047619,13,8,5,334.44043133206384,0.7352352352352353,-0.02700301367560365,0.18228218182287562,128515.36502718946,1196.1468224981816,129711.51184968764,2777,0,756.0,36,1,15,38.031245372427065,0.6053240740740742,46.50900900900901,1013.9639639639648,28.16566566566569,0
4932,4,3,1,39,0.075,0.025,0.975,40,550,400,150,0.7272727272727273,7,4,3,315.7885650444293,0.7643429487179487,-0.010564194158436457,0.1753603011722797,129255.70371283496,165.32079033159965,129421.02450316655,2778,0,700.225,38,2,19,37.75193493030748,0.6091008771929824,45.77991452991452,1016.8803418803406,26.760008996851067,0
4933,4,0,0,39,0.0,0.0,1.0,39,800,600,200,0.75,10,6,4,322.4481506050036,0.7521367521367521,-0.009729251898686009,0.1785664554630967,129147.08547921674,528.6477737599375,129675.73325297667,2779,1,719.1794871794872,38,1,20,37.69291745497863,0.6080043859649124,45.88675213675213,1016.4529914529902,26.748762932973428,0
4934,4,0,0,39,0.0,0.0,1.0,39,1100,800,300,0.7272727272727273,14,8,6,324.33835848330074,0.7504498425551057,-0.01004077683322957,0.18024195775509957,129285.00987082551,586.4289898744023,129871.43886069991,2780,2,720.1794871794872,37,2,21,37.50482929020664,0.611204954954955,45.75109649122806,1016.9956140350866,27.486367946894234,0
4935,4,0,0,39,0.0,0.0,1.0,39,800,300,500,0.375,13,3,10,325.18571424803406,0.7500562303193883,-0.006578165465736641,0.18096867852903484,129340.77222077937,611.9542792012797,129952.72649998065,2781,3,721.1794871794872,37,2,22,37.426677984980785,0.6117680180180181,45.696271929824555,1017.2149122807009,27.49229492650543,0
4936,4,0,0,39,0.0,0.0,1.0,39,650,500,150,0.7692307692307693,8,5,3,323.93923987848,0.7510121457489879,-0.007155259438723638,0.1807569572256894,129445.89548405634,586.5209976988642,130032.41648175521,2782,4,722.1794871794872,38,1,14,37.35170603674542,0.6110197368421053,45.59294871794871,1017.6282051282035,26.779689608636932,0
4937,4,1,0,40,0.025,0.0,1.0,40,1200,1000,200,0.8333333333333334,14,10,4,320.65300599239595,0.7613782051282051,0.0020645952575639726,0.1807182609809677,129837.58680555545,326.5624999999919,130164.14930555543,2783,0,705.1,39,1,15,37.03836195148543,0.6132478632478633,45.20833333333333,1019.1666666666657,26.13247863247861,0
4938,4,1,1,40,0.024390243902439025,0.024390243902439025,0.975609756097561,41,450,300,150,0.6666666666666666,6,3,3,315.2132423165157,0.7696138211382114,0.01126824895104206,0.17888217861025982,130107.01844346926,2.291026340115309,130109.30946980938,2784,0,688.8780487804878,40,1,17,36.904406149350855,0.6143229166666668,44.9441056910569,1020.2235772357706,25.505589430894265,0
4939,4,1,1,40,0.024390243902439025,0.024390243902439025,0.975609756097561,41,1100,900,200,0.8181818181818182,13,9,4,312.8478938797256,0.7733739837398373,0.02442258840623679,0.17861665135136556,130342.3516167533,-44.44101204900136,130297.91060470429,2785,0,689.7073170731708,39,2,19,36.72695858410691,0.6183226495726497,44.71354166666666,1021.1458333333319,26.18322649572646,0
4940,4,1,1,40,0.024390243902439025,0.024390243902439025,0.975609756097561,41,950,700,250,0.7368421052631579,12,7,5,311.21445030887725,0.7717987804878049,0.023604103850096037,0.17780573839325367,130368.94531250001,-85.46006944444377,130283.48524305558,2786,0,690.4878048780488,39,2,19,36.741806065551465,0.6185897435897436,44.6875,1021.2500000000001,26.185897435897438,0
4941,4,0,0,40,0.0,0.0,1.0,40,700,400,300,0.5714285714285714,10,4,6,317.0345689296129,0.764102564102564,0.027244897959183945,0.18063597532036066,130262.58680555537,259.548611111092,130522.13541666647,2787,2,708.75,38,2,20,36.70068027210884,0.6192434210526316,44.79166666666666,1020.8333333333319,26.86403508771926,0
4942,4,0,0,40,0.0,0.0,1.0,40,700,400,300,0.5714285714285714,10,4,6,320.6515613478563,0.7643696581196581,0.030230672664504965,0.18321029736546046,130371.67302441718,360.77610216229743,130732.44912657948,2788,3,709.75,38,2,21,36.498108240053,0.6203399122807018,44.68482905982905,1021.2606837606818,26.87528115159689,0
4943,4,1,0,41,0.024390243902439025,0.0,1.0,41,600,400,200,0.6666666666666666,8,4,4,313.7181824445385,0.7732215447154471,0.04087739267447699,0.18047070589160014,130635.03146701379,-3.4830729166772016,130631.54839409712,2789,0,693.4146341463414,39,2,17,36.409296243461725,0.6212606837606838,44.42708333333333,1022.2916666666658,26.212606837606817,0
4944,4,1,1,41,0.023809523809523808,0.023809523809523808,0.9761904761904762,42,1000,700,300,0.7,13,7,6,306.7008265670223,0.7818186217576462,0.038309474152159684,0.17758312954015787,130885.78976014604,-371.4440189371452,130514.3457412089,2790,0,677.8809523809524,40,2,18,36.33594862118052,0.6221354166666667,44.18191056910569,1023.272357723577,25.581808943089424,0
4945,4,0,0,41,0.0,0.0,1.0,41,1200,700,500,0.5833333333333334,17,7,10,313.6418765116614,0.7714939024390244,0.03710932649949594,0.1814246472966747,130848.09570312496,7.888454861109892,130855.98415798607,2791,2,695.4146341463414,39,2,19,36.19637887735019,0.6233974358974359,44.21875,1023.1249999999997,26.23397435897435,0
4946,4,0,2,39,0.0,0.04878048780487805,0.9512195121951219,41,1050,700,350,0.6666666666666666,14,7,7,311.74266140886004,0.7720020325203252,0.03701478903655331,0.1808254658207475,130954.6929253474,-35.1671006944253,130919.52582465297,2792,3,696.4146341463414,39,2,19,36.13754325259516,0.624465811965812,44.11458333333334,1023.541666666668,26.244658119658155,0
4947,4,0,0,39,0.0,0.0,1.0,39,700,400,300,0.5714285714285714,10,4,6,323.1916773215976,0.7622019793072425,0.04364196004067433,0.1868264157007746,130822.85534972278,656.1716104955146,131479.0269602183,2793,4,726.974358974359,37,2,19,35.977581279028236,0.6266891891891893,44.24342105263157,1023.0263157894719,27.649359886201943,0
4948,4,0,0,39,0.0,0.0,1.0,39,1250,1100,150,0.88,14,11,3,325.2799416669471,0.7634952766531714,0.04018405646968093,0.1884970696447479,130917.78897518064,716.9861522024772,131634.77512738312,2794,5,727.974358974359,38,1,19,35.82837456937048,0.6258223684210527,44.150641025641015,1023.3974358974345,26.931511470985118,0
4949,4,0,0,39,0.0,0.0,1.0,39,800,300,500,0.375,13,3,10,325.21961887828485,0.7621457489878543,0.037574736166285705,0.18926715524883747,131081.84633875708,726.0776216304721,131807.92396038756,2795,6,728.974358974359,38,1,19,35.664449660928526,0.627467105263158,43.9903846153846,1024.038461538459,26.94838056680155,0
4950,4,1,0,40,0.025,0.0,1.0,40,650,400,250,0.6153846153846154,9,4,5,316.474591781292,0.7717681623931624,0.04309625668449191,0.18563597447647914,131384.32618690346,316.42247739857413,131700.74866430202,2796,0,711.725,37,3,20,35.583778966131895,0.6323198198198199,43.69517543859648,1025.2192982456124,27.70862968231385,0
4951,4,1,1,40,0.024390243902439025,0.024390243902439025,0.975609756097561,41,1100,900,200,0.8181818181818182,13,9,4,308.14496939359816,0.7793191056910569,0.04020771701730563,0.18191348684852518,131629.4461451711,-87.80966926000852,131541.63647591107,2797,0,695.3414634146342,38,3,17,35.550928335936156,0.6329495614035088,43.45619658119657,1026.175213675212,27.00461088618979,0
4952,4,0,0,40,0.0,0.0,1.0,40,700,300,400,0.42857142857142855,11,3,8,315.6492768038767,0.7719017094017094,0.036715660074826184,0.18583379386408214,131524.88175448202,303.1467615035244,131828.02851598556,2798,2,713.725,37,3,21,35.463544450383026,0.6337274774774776,43.55811403508771,1025.7675438596482,27.723447131341842,0
4953,4,0,0,40,0.0,0.0,1.0,40,900,800,100,0.8888888888888888,10,8,2,312.62510044561355,0.7718215811965812,0.033183760683761054,0.18473301389968041,131665.51246537376,232.38881194211643,131897.90127731586,2799,3,714.725,37,3,17,35.39975071225072,0.6351351351351353,43.42105263157894,1026.3157894736826,27.738264580369798,0
4954,4,0,0,40,0.0,0.0,1.0,40,1550,1300,250,0.8387096774193549,18,13,5,341.21996479951014,0.7718215811965812,-0.0067866161616161325,0.18767098063973073,128875.73964497054,853.9074266820505,129729.6470716526,2800,4,715.725,38,2,16,37.49210858585858,0.6052631578947367,46.15384615384616,1015.3846153846164,26.720647773279378,8
4955,4,2,0,42,0.047619047619047616,0.0,1.0,42,950,700,250,0.7368421052631579,12,7,5,328.9859858550679,0.7871902826171119,0.020392772493612377,0.18373332856237942,129480.23069598364,120.66901046933685,129600.89970645298,2801,0,682.5952380952381,37,5,16,37.18846512964157,0.6131756756756757,45.5592105263158,1017.763157894739,27.507112375533488,0
4956,4,1,0,43,0.023255813953488372,0.0,1.0,43,1000,800,200,0.8,12,8,4,364.07115018218224,0.7907899593946105,0.1408781265452832,0.19345500745768232,127496.31461620645,683.5459812623303,128179.86059746878,2802,0,667.6976744186046,38,5,13,38.323812546281616,0.5912828947368421,47.51602564102564,1009.9358974358975,26.577260458839408,4
4957,4,1,0,44,0.022727272727272728,0.0,1.0,44,750,500,250,0.6666666666666666,10,5,5,352.29752516664473,0.8007840028188866,0.15937464532970136,0.17747818720659264,125312.69531249988,123.56976290268008,125436.26507540257,2803,0,653.5,39,5,14,40.86905257317242,0.5673076923076924,49.68749999999999,1001.2499999999991,25.6730769230769,7
4958,4,2,1,45,0.043478260869565216,0.021739130434782608,0.9782608695652174,46,800,600,200,0.75,10,6,4,340.14223349189194,0.8145933977455717,0.16770155620439242,0.17325834371972357,125770.03146455316,-644.0601182602886,125125.97134629288,2804,0,626.0434782608696,41,5,15,40.70144314772692,0.5688516260162603,49.231150793650784,1003.0753968253948,24.46525358110719,0
4959,4,5,4,46,0.1,0.08,0.92,50,950,500,450,0.5263157894736842,14,5,9,317.60783518594116,0.838656462585034,0.17291009463722462,0.16505194058023478,126592.34063995958,-1957.4652777777821,124634.8753621818,2805,0,576.86,41,9,15,40.4220885909569,0.5772357723577236,48.41269841269841,1006.3492063492055,24.545102593883062,0
4960,4,5,4,47,0.09803921568627451,0.0784313725490196,0.9215686274509804,51,1600,1200,400,0.75,20,12,8,314.29937554065765,0.8450000000000001,0.17319059976931928,0.16440275028280524,126858.71056241407,-2225.6772976680613,124633.033264746,2806,0,566.4509803921569,44,7,16,40.23246017156863,0.5757575757575759,48.14814814814814,1007.4074074074058,22.89562289562286,0
4961,4,5,4,48,0.09615384615384616,0.07692307692307693,0.9230769230769231,52,1150,900,250,0.782608695652174,14,9,5,305.56114684209535,0.8520927601809953,0.20324283559577805,0.16179713185245323,127354.73632812449,-2616.639472951005,124738.09685517348,2807,0,556.4615384615385,43,9,15,39.94560543515654,0.582122093023256,47.65624999999998,1009.3749999999958,23.47383720930223,0
4962,4,3,3,48,0.058823529411764705,0.058823529411764705,0.9411764705882353,51,1200,900,300,0.75,15,9,6,318.15342597429986,0.8469934640522877,0.22681067822370693,0.1692056792018417,127532.07439456746,-2085.046721951827,125447.02767261563,2808,0,568.2156862745098,42,9,17,39.44662957278072,0.5853174603174605,47.48062015503875,1010.0775193798436,24.049464747139133,0
4963,4,4,4,48,0.07692307692307693,0.07692307692307693,0.9230769230769231,52,1350,800,550,0.5925925925925926,19,8,11,315.5329683291094,0.8582359225741578,0.24026236728605688,0.17018855168930233,128097.6605366943,-2316.192986968432,125781.46754972587,2809,0,555.7115384615385,44,8,19,38.935828836245,0.5883049242424242,46.921296296296305,1012.3148148148164,23.007154882154918,0
4964,4,1,0,49,0.02040816326530612,0.0,1.0,49,1400,1100,300,0.7857142857142857,17,11,6,335.6803743527604,0.8470804988662132,0.25712364192440407,0.18013668931056567,127893.53820231809,-1213.7298437893526,126679.80835852874,2810,0,590.3061224489796,41,8,20,38.63443180332158,0.5904471544715446,47.12301587301588,1011.5079365079375,24.670925280681402,0
4965,4,1,0,50,0.02,0.0,1.0,50,1750,1400,350,0.8,21,14,7,328.37135260546296,0.8510034013605442,0.2581893004115223,0.1773205304069503,128144.53125000029,-1584.20138888886,126560.32986111143,2811,0,579.48,43,7,21,38.56310013717424,0.5901162790697674,46.875000000000014,1012.5000000000023,23.54651162790703,0
4966,4,2,2,50,0.038461538461538464,0.038461538461538464,0.9615384615384616,52,1150,600,550,0.5217391304347826,17,6,11,312.20189376849663,0.8621794871794871,0.24802442934230418,0.17018749633108318,128521.48216057285,-2375.0699759070026,126146.41218466585,2812,0,558.1538461538462,41,11,17,38.588751100675076,0.5967987804878048,46.502976190476204,1013.9880952380976,24.73141695702677,0
4967,4,1,2,49,0.0196078431372549,0.0392156862745098,0.9607843137254902,51,1200,900,300,0.75,15,9,6,320.2477012572716,0.8582679738562092,0.24963738920225653,0.17446329993866297,128496.33487654333,-1969.868827160478,126526.46604938286,2813,0,570.0784313725491,41,10,17,38.41038812785389,0.5965447154471544,46.527777777777786,1013.8888888888898,24.728997289972924,0
4968,4,1,2,48,0.02,0.04,0.96,50,950,600,350,0.631578947368421,13,6,7,329.1808318808101,0.8506802721088436,0.2499759326113118,0.17879037339408752,128376.15258774572,-1548.2062595015855,126827.94632824413,2814,0,582.42,40,10,17,38.306424655702635,0.5968749999999998,46.64634146341465,1013.414634146344,25.3353658536586,0
4969,4,2,2,48,0.04,0.04,0.96,50,1800,1500,300,0.8333333333333334,21,15,6,325.86048322976796,0.8540816326530613,0.23912279025322514,0.17770348916099654,128537.27357317788,-1622.9563840814649,126914.31718909641,2815,0,583.12,42,8,17,38.22642936773372,0.5954861111111109,46.487403100775204,1014.0503875969007,24.144056847545254,0
4970,4,3,2,49,0.058823529411764705,0.0392156862745098,0.9607843137254902,51,950,600,350,0.631578947368421,13,6,7,319.37707308991327,0.8532679738562092,0.24598963734360457,0.17550187599164335,128840.60890330876,-1970.2526866678008,126870.35621664097,2816,0,572.6274509803922,43,8,18,38.08228787737463,0.597141472868217,46.188446969696976,1015.2462121212129,23.61037702607472,0
4971,4,0,1,48,0.0,0.02040816326530612,0.9795918367346939,49,1450,1200,250,0.8275862068965517,17,12,5,334.9931905097204,0.8441751700680272,0.24271885345513877,0.183305262672173,128672.41753472238,-1179.1232638888796,127493.2942708335,2817,1,597.0,41,8,18,37.85720396988362,0.5983231707317073,46.35416666666667,1014.5833333333346,24.745934959349626,0
4972,4,1,1,48,0.02040816326530612,0.02040816326530612,0.9795918367346939,49,1550,1300,250,0.8387096774193549,18,13,5,332.47104032078397,0.8459821428571429,0.22645446238196731,0.1825865549302667,128816.57483930225,-1234.4438705234036,127582.13096877885,2818,0,597.7755102040817,43,6,18,37.77440920398009,0.5968992248062015,46.21212121212122,1015.1515151515163,23.608174770965494,0
4973,4,1,1,48,0.02040816326530612,0.02040816326530612,0.9795918367346939,49,1100,700,400,0.6363636363636364,15,7,8,336.3160226024959,0.8485331632653061,0.242911744729587,0.18548390614174692,128984.86036680746,-1124.0649570993883,127860.79540970808,2819,0,598.7551020408164,43,6,19,37.50553509834996,0.5985949612403101,46.04640151515152,1015.8143939393955,23.62359055673013,0
4974,4,2,0,50,0.04,0.0,1.0,50,1350,700,650,0.5185185185185185,20,7,13,334.5321245421365,0.8549319727891156,0.2609669363699927,0.18636622697781452,129382.26176754899,-1342.7690497653496,128039.49271778364,2820,0,587.42,40,10,21,37.14684680185128,0.6070312500000001,45.65548780487804,1017.3780487804871,25.434451219512177,0
4975,4,1,1,50,0.0196078431372549,0.0196078431372549,0.9803921568627451,51,1000,400,600,0.4,16,4,12,330.0963877454395,0.8582026143790851,0.2676144101789144,0.18512876388498206,129645.08311549765,-1640.9252749234083,128004.15784057423,2821,0,576.8823529411765,42,9,17,36.992943228671095,0.6066468253968256,45.397286821705414,1018.4108527131766,24.247877445551826,0
4976,4,0,0,50,0.0,0.0,1.0,50,1550,1200,350,0.7741935483870968,19,12,7,336.9005807855117,0.8506122448979592,0.2682766682903075,0.188874083111047,129630.39852804517,-1265.4886896888688,128364.90983835631,2822,1,589.4,41,9,18,36.834611949991874,0.6079776422764229,45.411706349206334,1018.3531746031721,24.83788230739444,0
4977,4,0,1,49,0.0,0.02,0.98,50,1150,800,350,0.6956521739130435,15,8,7,337.9460607809439,0.8502721088435374,0.26703476482617616,0.18994899278377153,129731.44531249972,-1231.5538194444746,128499.89149305524,2823,2,590.4,41,9,18,36.705436264485336,0.6089939024390245,45.312499999999986,1018.7499999999978,24.847560975609703,0
4978,4,0,0,49,0.0,0.0,1.0,49,1600,1100,500,0.6875,21,11,10,343.70642817690936,0.8449192176870749,0.2664220347887709,0.19286818718863286,129666.74619108981,-886.5411626677404,128780.20502842207,2824,3,603.1836734693877,40,9,18,36.62442626222311,0.6098958333333334,45.376016260162594,1018.4959349593485,25.46239837398371,0
4979,4,0,0,49,0.0,0.0,1.0,49,1500,1200,300,0.8,18,12,6,346.434428578691,0.8451672335600907,0.2642742147222912,0.19504199973938977,129796.16057117112,-806.8282561636731,128989.33231500744,2825,4,604.1836734693877,40,9,18,36.42353146504437,0.6111979166666668,45.24898373983739,1019.0040650406493,25.475101626016233,0
4980,4,2,1,50,0.0392156862745098,0.0196078431372549,0.9803921568627451,51,750,500,250,0.6666666666666666,10,5,5,337.9061186663149,0.8505228758169936,0.27363171167430145,0.19267024351124615,130291.32806793295,-1389.733273607126,128901.59479432582,2826,0,581.4509803921569,36,15,20,36.138916464445934,0.6232638888888888,44.76351351351352,1020.9459459459471,28.35960960960964,0
4981,4,0,0,50,0.0,0.0,1.0,50,1150,800,350,0.6956521739130435,15,8,7,344.93653825937497,0.8478571428571429,0.2759574670084499,0.1962839847372229,130213.13252095727,-1016.9465664623528,129196.18595449491,2827,1,593.88,42,8,20,36.03871957973355,0.6123511904761905,44.84011627906977,1020.6395348837209,24.30094130675526,0
4982,4,2,2,50,0.038461538461538464,0.038461538461538464,0.9615384615384616,52,1050,600,450,0.5714285714285714,15,6,9,333.0550627847924,0.8576231774761186,0.2775715275715276,0.19169169169169176,130654.64854570644,-1696.8958388785677,128957.75270682787,2828,0,572.0,37,15,19,35.89527027027028,0.625,44.40789473684211,1022.3684210526321,27.631578947368435,0
4983,4,0,0,50,0.0,0.0,1.0,50,1850,1400,450,0.7567567567567568,23,14,9,350.2654260068423,0.8447108843537414,0.27681921159945655,0.20078851823301302,130498.99798525359,-858.1425754458345,129640.85540980776,2829,3,595.88,35,15,19,35.613011629663205,0.6273809523809524,44.560185185185176,1021.7592592592578,29.19312169312165,0
4984,4,0,0,50,0.0,0.0,1.0,50,1000,600,400,0.6,14,6,8,350.79469911289243,0.8451360544217686,0.27963652384623816,0.20195720185453092,130665.2529852489,-832.6643789059196,129832.58860634298,2830,4,596.88,36,14,20,35.431123104600346,0.6270254629629629,44.39752252252253,1022.409909909911,28.400275275275305,0
4985,4,0,1,49,0.0,0.02,0.98,50,950,400,550,0.42105263157894735,15,4,11,350.61497508002225,0.8453401360544217,0.2787115956392465,0.20215457706042445,130722.82745160708,-833.3238221329403,129889.50362947414,2831,5,597.88,36,14,20,35.37743640568219,0.6276041666666666,44.34121621621622,1022.6351351351357,28.406531531531545,0
4986,4,1,0,50,0.02,0.0,1.0,50,1000,700,300,0.7,13,7,6,351.06015124832163,0.8445408163265306,0.28535476956055783,0.202936258435368,130822.8553497229,-814.6617228378034,130008.1936268851,2832,0,598.76,37,13,21,35.26482672382994,0.6266891891891893,44.243421052631575,1023.0263157894728,27.649359886201967,0
4987,4,0,0,50,0.0,0.0,1.0,50,1500,900,600,0.6,21,9,12,349.80663885674795,0.8438605442176871,0.2780713838447084,0.20314225536517325,130999.80481591058,-835.0797172912613,130164.72509861932,2833,1,599.76,38,12,21,35.11792945105406,0.6266447368421053,44.07051282051282,1023.7179487179487,26.939946018893387,0
4988,4,0,0,50,0.0,0.0,1.0,50,1050,600,450,0.5714285714285714,15,6,9,349.9194502994213,0.8429421768707482,0.24612044068884376,0.20510325647957914,131356.22409058546,-806.769540690504,130549.45454989496,2834,2,600.76,37,13,21,34.754942596356116,0.6320382882882883,43.72258771929824,1025.109649122806,27.70566619250827,1
4989,4,1,2,49,0.0196078431372549,0.0392156862745098,0.9607843137254902,51,1200,700,500,0.5833333333333334,17,7,10,343.65037801030564,0.8481372549019609,0.24561152110052298,0.2029762304650799,131648.63281250012,-1151.7795138888755,130496.85329861124,2835,0,589.9607843137255,39,12,15,34.6207199891731,0.6314102564102564,43.43750000000001,1026.250000000001,26.314102564102587,0
4990,4,0,0,49,0.0,0.0,1.0,49,1350,1000,350,0.7407407407407407,17,10,7,359.560422110685,0.8394982993197279,0.25988547685969166,0.21121916253637738,131440.53939673753,-347.83683441058014,131092.70256232694,2836,10,614.9795918367347,37,12,21,34.42267251211862,0.6328828828828829,43.640350877192986,1025.4385964912287,27.7145566619251,0
4991,4,0,0,49,0.0,0.0,1.0,49,900,600,300,0.6666666666666666,12,6,6,360.10985710982834,0.8392857142857143,0.2636931061084229,0.21228575554485443,131574.63480029578,-323.7354125575379,131250.89938773823,2837,11,615.9795918367347,38,11,17,34.27314380922629,0.6324013157894737,43.50961538461538,1025.9615384615377,26.99898785425099,0
4992,4,0,0,49,0.0,0.0,1.0,49,1700,1200,500,0.7058823529411765,22,12,10,361.0005841196366,0.8396754535147393,0.26511281102427464,0.21342354533152896,131684.26890432087,-292.3804012345814,131391.8885030863,2838,12,616.9795918367347,38,11,17,34.139603067207936,0.6334978070175439,43.40277777777777,1026.388888888888,27.01023391812863,0
4993,4,0,0,49,0.0,0.0,1.0,49,1300,900,400,0.6923076923076923,17,9,8,359.9296605058251,0.839108560090703,0.26518295143239423,0.21325055718008484,131766.52444480962,-314.6639181094424,131451.86052670018,2839,13,617.9795918367347,38,11,17,34.084070412764476,0.6343201754385965,43.32264957264957,1026.709401709401,27.018668466036868,0
4994,4,0,0,49,0.0,0.0,1.0,49,1600,1100,500,0.6875,21,11,10,358.93108695024694,0.8389314058956916,0.2669321525156765,0.21327339122000438,131876.23844875433,-333.1036781357434,131543.13477061858,2840,14,618.9795918367347,38,11,18,33.999029193537204,0.6354166666666667,43.21581196581196,1027.136752136751,27.029914529914503,0
4995,4,0,0,49,0.0,0.0,1.0,49,1250,900,350,0.72,16,9,7,358.0101132174819,0.838718820861678,0.2679948136060084,0.2131878178831281,131958.55391418276,-351.5006346336583,131607.05327954912,2841,15,619.9795918367347,38,11,18,33.93968146684692,0.6362390350877194,43.135683760683754,1027.4572649572638,27.03834907782273,0
4996,4,0,0,49,0.0,0.0,1.0,49,1550,1000,550,0.6451612903225806,21,10,11,365.5397294952853,0.8379039115646258,0.2827956399171554,0.2077184167437559,130158.86423631794,-275.7207502384789,129883.14348607945,2842,16,620.9795918367347,40,9,19,35.568129004415226,0.6148437499999999,44.89329268292684,1020.4268292682948,25.51067073170737,6
4997,4,2,2,49,0.0392156862745098,0.0392156862745098,0.9607843137254902,51,1750,1400,350,0.8,21,14,7,349.33260158485393,0.8473202614379086,0.2778324543030428,0.20106031957883808,130654.64854570634,-1071.4077859311165,129583.24075977522,2843,0,597.5882352941177,37,14,18,35.479229229229226,0.625,44.4078947368421,1022.3684210526313,27.631578947368414,0
4998,4,1,2,48,0.02,0.04,0.96,50,1600,1200,400,0.75,20,12,8,352.72717395226505,0.8453061224489795,0.2678224509488589,0.20345617510530434,130738.73842191813,-776.9788540704951,129961.75956784764,2844,0,607.24,37,13,19,35.30732908044747,0.6258445945945947,44.325657894736835,1022.6973684210514,27.640469416785173,0
4999,4,1,1,48,0.02040816326530612,0.02040816326530612,0.9795918367346939,49,1200,600,600,0.5,18,6,12,361.63160663801546,0.840561224489796,0.27517988036438945,0.20866189653662365,130751.61944038633,-343.21635825014243,130408.4030821362,2845,0,619.795918367347,36,13,19,35.06661528297731,0.6278935185185186,44.31306306306306,1022.7477477477478,28.40965965965966,0
5000,4,0,0,48,0.0,0.0,1.0,48,1150,800,350,0.6956521739130435,15,8,7,370.48549958059635,0.8375443262411347,0.272955574419921,0.21351855112815182,130706.0335889274,84.93803047838935,130790.97161940578,2846,3,633.7083333333334,35,13,19,34.88646010186757,0.6294642857142857,44.357638888888886,1022.5694444444439,29.216269841269824,0
