period,mktsize,entries,exits,surviv,entryrate,exitrate,survivrate,firms,totresinv,totinninv,totimiinv,costshareinn,firmsres,firmsinn,firmsimi,hindex,div,gini,pcm,cs,totprofits,ts,maxage,minage,avgage,actfirms,inactfirms,profitablefirms,wmc,avgproxopt,price,totoutput,avgoutput,magtechshock
1,4,40,24,16,1.0,0.6,0.4,40,0,0,0,0,0,0,0,391.82163546905804,0.5008814102564102,0.0349289911851125,0.1673848911355262,118190.58956916079,2461.9260204081356,120652.51558956892,0,0,0.0,34,6,16,47.379764528240266,0.502450980392157,56.90476190476189,972.3809523809506,28.599439775910312,0
2,4,38,39,15,0.7037037037037037,0.7222222222222222,0.2777777777777778,54,350,200,150,0.5714285714285714,5,2,3,303.87785079709084,0.49981801770323786,-0.19538145500594906,0.14107659838484723,121852.54932117435,-2194.341839626985,119658.20748154736,1,0,0.2962962962962963,48,6,12,45.66682456291447,0.5197482638888888,53.16751700680273,987.3299319727917,20.56937358276649,0
3,4,37,35,17,0.7115384615384616,0.6730769230769231,0.32692307692307687,52,300,100,200,0.3333333333333333,5,1,4,302.2141713651664,0.4966691804927099,-0.21121501898467154,0.14325056476321135,122745.76310123905,-1580.8981831548147,121164.86491808423,2,0,0.46153846153846156,45,7,13,44.777574649603906,0.5324074074074074,52.26449275362318,990.9420289855058,22.020933977455684,0
4,4,32,33,16,0.6530612244897959,0.673469387755102,0.326530612244898,49,300,200,100,0.6666666666666666,4,2,2,302.76667278436105,0.49741354875283444,-0.1585200672696695,0.14705996979681768,123784.00015246976,-1704.4660259795737,122079.53412649018,3,0,0.8163265306122449,46,3,14,43.686711210096504,0.5418931159420289,51.218971631205676,995.1241134751779,21.6331329016343,0
5,4,30,27,19,0.6521739130434783,0.5869565217391305,0.4130434782608695,46,400,100,300,0.25,7,1,6,336.28788115227377,0.49662842190016104,-0.26675977653631366,0.16269062358447814,123614.9691358023,114.04320987652147,123729.01234567881,4,0,0.9130434782608695,41,5,17,43.02839851024207,0.5467479674796749,51.38888888888888,994.4444444444431,24.25474254742544,0
6,4,20,18,21,0.5128205128205128,0.46153846153846156,0.5384615384615384,39,300,200,100,0.6666666666666666,4,2,2,310.81242633968077,0.4955859199280252,-0.1358110835746119,0.1545361317275208,124765.73486328109,-44.251844618070606,124721.48301866301,5,0,1.564102564102564,39,0,16,42.47134900775031,0.5616987179487181,50.23437499999999,999.0624999999987,25.616987179487147,0
7,4,15,17,19,0.4166666666666667,0.4722222222222222,0.5277777777777778,36,300,200,100,0.6666666666666666,4,2,2,325.77217281168294,0.4899966931216931,-0.16470872022355,0.1614657270162767,124634.27690781986,920.4758390146816,125554.75274683454,6,0,2.0277777777777777,36,0,17,42.23360963873541,0.5656828703703705,50.36599099099099,998.5360360360351,27.737112112112086,0
8,4,15,11,23,0.4411764705882353,0.3235294117647059,0.6764705882352942,34,600,400,200,0.6666666666666666,8,4,4,359.94251357060955,0.49075311942959,-0.07709574557355048,0.18152496547697627,125357.39795918352,2224.2913832199324,127581.68934240345,7,0,2.4705882352941178,34,0,18,40.63143921382151,0.5772058823529412,49.64285714285713,1001.4285714285702,29.453781512605005,0
9,4,14,15,22,0.3783783783783784,0.40540540540540543,0.5945945945945945,37,800,400,400,0.5,12,4,8,309.2883545742791,0.48789414414414417,-0.0643848027391778,0.1618303759583412,126870.98434133554,447.94359803014197,127318.92793936568,8,0,2.7567567567567566,37,0,17,40.34610361340882,0.5867117117117118,48.13596491228069,1007.4561403508751,27.228544333807434,0
10,4,13,11,24,0.37142857142857144,0.3142857142857143,0.6857142857142857,35,450,200,250,0.4444444444444444,7,2,5,330.04803193069773,0.48473389355742297,-0.09414083674173335,0.1717790385219195,126654.74597318652,1360.4299286265252,128015.17590181305,9,0,3.3142857142857145,35,0,19,40.04505864091066,0.5883928571428572,48.350694444444436,1006.5972222222206,28.759920634920586,0
11,4,10,8,26,0.29411764705882354,0.23529411764705882,0.7647058823529411,34,1050,900,150,0.8571428571428571,12,9,3,331.2402463520553,0.48412433155080214,-0.05989614068216642,0.1746483265302408,127182.05959467149,1625.5633503401723,128807.62294501167,10,0,4.117647058823529,34,0,22,39.47440890672333,0.5958946078431371,47.82738095238097,1008.6904761904785,29.66736694677878,0
12,4,6,6,26,0.1875,0.1875,0.8125,32,400,0,400,0.0,8,0,8,336.31251023558616,0.4779905913978495,-0.006189047261815128,0.1786074008541976,127474.24529384756,2174.236685032141,129648.4819788797,11,0,5.09375,32,0,18,39.04726181545386,0.603515625,47.53787878787879,1009.8484848484848,31.55776515151515,0
13,4,2,1,27,0.07142857142857142,0.03571428571428571,0.9642857142857143,28,650,500,150,0.7692307692307693,8,5,3,401.62452018451347,0.47765101410934746,0.00939795477459282,0.19790482921512242,124390.1135594199,4391.623934799824,128781.73749421972,12,0,6.428571428571429,28,0,19,40.59454366508235,0.5829613095238096,50.61063218390804,997.5574712643669,35.62705254515596,8
14,4,5,5,27,0.15625,0.15625,0.84375,32,550,400,150,0.7272727272727273,7,4,3,353.91528463595637,0.4788306451612903,0.0010385196374624872,0.18022455263769457,125758.72359963258,2501.5868916436957,128260.31049127626,13,0,6.09375,32,0,18,40.36773036253775,0.5859375,49.242424242424235,1003.0303030303021,31.34469696969694,0
15,4,5,5,27,0.15625,0.15625,0.84375,32,700,500,200,0.7142857142857143,9,5,4,352.37573386755577,0.47927167338709675,-0.013093180389691872,0.18096507184741148,126107.2391369502,2487.426187378827,128594.66532432902,14,0,6.46875,32,0,20,40.046878273622454,0.5895182291666667,48.895202020202014,1004.419191919191,31.38809974747472,0
16,4,5,6,26,0.15625,0.1875,0.8125,32,700,400,300,0.5714285714285714,10,4,6,352.8478433826692,0.4779905913978495,0.0015542577241902666,0.18219030668046768,126329.27284205686,2515.002295684111,128844.27513774097,15,0,7.1875,32,0,15,39.806267269530274,0.591796875,48.67424242424242,1005.3030303030298,31.41571969696968,0
17,4,8,8,26,0.23529411764705882,0.23529411764705882,0.7647058823529411,34,400,200,200,0.5,6,2,4,332.7060400665911,0.4821375519904932,-0.043033982605796384,0.1747738676975119,127032.00113378682,1652.8628117913804,128684.8639455782,16,0,6.588235294117647,34,0,17,39.59120610927414,0.5943627450980392,47.976190476190474,1008.0952380952378,29.649859943977585,0
18,4,3,2,27,0.10344827586206896,0.06896551724137931,0.9310344827586207,29,700,500,200,0.7142857142857143,9,5,4,376.95879282540653,0.4775759441707717,-0.0008575430438970688,0.19460968205922227,126322.92631172856,3723.7075617284145,130046.63387345697,17,0,8.448275862068966,29,0,18,39.206848116422584,0.5998563218390804,48.680555555555564,1005.2777777777792,34.66475095785445,0
19,4,3,1,29,0.1,0.03333333333333333,0.9666666666666667,30,800,300,500,0.375,13,3,10,367.50222222222214,0.47447318007662836,0.0427111111111107,0.1930158730158732,127024.2585848076,3336.3394612094044,130360.598046017,18,0,9.066666666666666,30,0,20,38.72222222222221,0.6041666666666665,47.98387096774194,1008.0645161290331,33.60215053763444,0
20,4,5,6,28,0.14705882352941177,0.17647058823529413,0.8235294117647058,34,700,200,500,0.2857142857142857,12,2,10,330.06486138630646,0.4756573083778966,0.042967804405712906,0.17823502514860529,128144.53124999988,1659.201388888875,129803.73263888876,19,0,8.852941176470589,34,0,18,38.520233196159126,0.6056985294117647,46.87499999999999,1012.4999999999991,29.779411764705856,0
21,4,2,4,26,0.06666666666666667,0.13333333333333333,0.8666666666666667,30,700,500,200,0.7142857142857143,9,5,4,368.28687765196173,0.4744252873563219,0.04454497072911101,0.19603712269349483,127566.80685628406,3396.2361978263516,130963.04305411041,20,0,9.933333333333334,30,0,18,38.14501286145113,0.6097222222222222,47.44623655913979,1010.2150537634416,33.67383512544805,0
22,4,3,2,27,0.10344827586206896,0.06896551724137931,0.9310344827586207,29,750,300,450,0.4,12,3,9,378.3063975054036,0.4734708538587849,0.017646975109226526,0.20057689303185833,127407.31336805547,3839.800347222217,131247.1137152777,21,0,10.068965517241379,29,0,19,38.055870821295926,0.6109913793103449,47.604166666666664,1009.5833333333327,34.81321839080458,0
23,4,3,4,26,0.1,0.13333333333333333,0.8666666666666667,30,650,200,450,0.3076923076923077,11,2,9,364.9278926281166,0.47315613026819925,0.031171650055370703,0.19572932231123158,127872.49835602389,3332.848270031225,131205.3466260551,22,0,10.633333333333333,30,0,20,37.91638981173863,0.6128472222222221,47.14381720430108,1011.4247311827963,33.71415770609321,0
24,4,0,0,26,0.0,0.0,1.0,26,500,500,0,1.0,5,5,0,408.10053958062997,0.47012820512820513,0.029879211697393826,0.21469637082285306,127092.01388888882,5173.263888888882,132265.2777777777,23,1,12.23076923076923,26,0,23,37.62913223140497,0.6177884615384615,47.916666666666664,1008.3333333333327,38.782051282051256,0
25,4,4,2,28,0.13333333333333333,0.06666666666666667,0.9333333333333333,30,1050,800,250,0.7619047619047619,13,8,5,394.78177720101064,0.47236590038314175,0.05509641873278204,0.20768954365792325,127092.01388888907,4034.7222222222454,131126.7361111113,24,0,11.466666666666667,30,0,21,37.96487603305784,0.6048611111111111,47.91666666666668,1008.3333333333348,33.611111111111164,7
26,4,4,7,25,0.125,0.21875,0.78125,32,1000,800,200,0.8,12,8,4,374.1677794791799,0.47698252688172044,0.030638201957753797,0.20007153167192507,127749.32861328125,3159.936523437501,130909.26513671875,25,0,11.34375,31,1,17,37.809119010819174,0.6088709677419355,47.265625,1010.9375,32.61088709677419,0
27,4,5,3,27,0.16666666666666666,0.1,0.9,30,750,600,150,0.8,9,6,3,391.18162057722515,0.4736590038314176,0.01978021978021971,0.20939722042663209,127793.20987654298,3998.070987654291,131791.28086419727,26,0,11.566666666666666,29,1,20,37.33402014652014,0.6149425287356323,47.22222222222221,1011.1111111111093,34.8659003831417,0
28,4,2,4,25,0.06896551724137931,0.13793103448275862,0.8620689655172413,29,800,500,300,0.625,11,5,6,401.049933456812,0.47280377668308704,0.039660806051016406,0.2150030831380426,127853.74812144929,4455.147435262248,132308.89555671153,27,0,12.89655172413793,28,1,20,37.022304304588715,0.6186755952380952,47.16235632183908,1011.3505747126433,36.1196633825944,0
29,4,3,2,26,0.10714285714285714,0.07142857142857142,0.9285714285714286,28,800,600,200,0.75,10,6,4,402.42377439021493,0.47001763668430335,0.004118148253337006,0.21632581826380856,127962.75308825464,4699.050815827703,132661.80390408234,28,0,13.071428571428571,28,0,22,36.87547335037394,0.6197916666666667,47.05459770114942,1011.7816091954016,36.135057471264346,0
30,4,5,6,25,0.16129032258064516,0.1935483870967742,0.8064516129032258,31,1200,900,300,0.75,15,9,6,381.7270812394321,0.47262544802867384,-0.0073899668310792865,0.20183147365814505,127295.38819516715,3562.1008620621,130857.48905722925,29,0,12.64516129032258,30,1,16,38.084654146687974,0.6069444444444445,47.715053763440864,1009.1397849462372,33.63799283154124,4
31,4,4,2,27,0.13793103448275862,0.06896551724137931,0.9310344827586207,29,850,500,350,0.5882352941176471,12,5,7,404.93055201732517,0.46946839080459773,0.017958780323257484,0.2126617906325431,127022.00038580246,4487.017746913573,131509.01813271604,30,0,14.206896551724139,29,0,18,37.78129879673004,0.6070402298850575,47.98611111111111,1008.0555555555554,34.76053639846743,0
32,4,3,4,26,0.1,0.13333333333333333,0.8666666666666667,30,800,600,200,0.75,10,6,4,392.61418422876545,0.4736350574712644,0.00796533223276974,0.2081628377212907,127407.31336805549,4004.4029706790084,131411.7163387345,31,0,14.633333333333333,29,1,17,37.694748245976065,0.6109913793103449,47.604166666666664,1009.5833333333328,34.81321839080458,0
33,4,4,5,25,0.13333333333333333,0.16666666666666666,0.8333333333333334,30,950,700,250,0.7368421052631579,12,7,5,392.58276573533897,0.4720067049808429,0.030477367385234766,0.21069862069642403,127898.5556520062,4042.1537422839533,131940.70939429014,32,0,15.333333333333334,29,1,18,37.190346240102535,0.6160201149425287,47.11805555555556,1011.5277777777779,34.880268199233726,0
34,4,3,3,25,0.10714285714285714,0.10714285714285714,0.8928571428571429,28,500,400,100,0.8,6,4,2,413.6890211499625,0.4692460317460318,0.03630338733431504,0.22048261017333176,127617.73003472228,4958.810763888894,132576.54079861118,33,0,16.464285714285715,27,1,19,36.94587628865978,0.6195987654320987,47.395833333333336,1010.4166666666672,37.422839506172856,0
35,4,1,0,26,0.038461538461538464,0.0,1.0,26,600,300,300,0.5,9,3,6,458.0565392392475,0.4651602564102564,0.050147997028266555,0.2384599206271038,126664.45485158508,6403.89636678859,133068.35121837366,34,0,17.692307692307693,26,0,20,36.81364658388267,0.6133814102564104,48.341049382716044,1006.6358024691355,38.716761633428284,8
36,4,3,4,25,0.10344827586206896,0.13793103448275862,0.8620689655172413,29,850,500,350,0.5882352941176471,12,5,7,422.1717256763582,0.46823686371100165,0.016221600341507214,0.22402835369833024,127442.37075617282,4960.513117283949,132402.88387345677,35,0,16.75862068965517,29,0,16,36.91254011921137,0.6113505747126438,47.56944444444444,1009.7222222222222,34.81800766283525,0
37,4,3,2,26,0.10714285714285714,0.07142857142857142,0.9285714285714286,28,650,400,250,0.6153846153846154,9,4,5,423.35210219167857,0.46651785714285715,-0.0019155336056746464,0.2249238039535378,127490.73368757419,5194.694023318782,132685.42771089298,36,0,17.178571428571427,28,0,17,36.83282354057003,0.6149553571428572,47.52155172413792,1009.9137931034471,36.06834975369454,0
38,4,2,2,26,0.07142857142857142,0.07142857142857142,0.9285714285714286,28,600,400,200,0.6666666666666666,8,4,4,420.22904060265273,0.4664076278659612,0.020464006498121856,0.22447314355654202,127708.48041765741,5133.362440546952,132841.84285820436,37,0,18.107142857142858,28,0,18,36.68710021321962,0.6171875,47.30603448275861,1010.7758620689643,36.09913793103444,0
39,4,3,4,25,0.10344827586206896,0.13793103448275862,0.8620689655172413,29,650,300,350,0.46153846153846156,10,3,7,409.25130223238097,0.4663895730706076,0.008232711306256357,0.22060824635130127,128074.22839506174,4682.9089506172795,132757.13734567902,38,0,18.275862068965516,29,0,19,36.588112879619466,0.617816091954023,46.94444444444444,1012.2222222222224,34.90421455938698,0
40,4,2,1,26,0.07407407407407407,0.037037037037037035,0.962962962962963,27,1250,1100,150,0.88,14,11,3,423.0284686375015,0.46527777777777773,0.03324129893752037,0.22779228940646445,128031.55393016576,5432.198439271536,133463.75236943728,39,0,19.85185185185185,27,0,20,36.28342033034359,0.6238425925925926,46.98660714285714,1012.0535714285709,37.483465608465586,0
41,4,1,0,27,0.037037037037037035,0.0,1.0,27,550,300,250,0.5454545454545454,8,3,5,421.5557136334651,0.4637939221272555,0.04781083245902029,0.22875494344771352,128339.9181717727,5420.534983129791,133760.4531549025,40,0,20.814814814814813,26,1,22,36.00333790232511,0.6306089743589742,46.68209876543211,1013.2716049382725,38.97198480531817,0
42,4,1,1,27,0.03571428571428571,0.03571428571428571,0.9642857142857143,28,900,600,300,0.6666666666666666,12,6,6,408.9488929834843,0.46265983245149916,0.033660897623936537,0.2237731582954573,128672.41753472228,4924.088541666676,133596.50607638896,41,0,21.035714285714285,27,1,19,35.981348391512654,0.6304012345679012,46.35416666666667,1014.5833333333338,37.57716049382718,0
43,4,2,1,28,0.06896551724137931,0.034482758620689655,0.9655172413793104,29,750,600,150,0.8,9,6,3,394.8604553550737,0.46623563218390807,0.044904604525557223,0.21856360416132956,129128.36281212844,4397.536827850443,133525.8996399789,42,0,21.24137931034483,28,1,21,35.87197248138724,0.6316964285714286,45.9051724137931,1016.3793103448278,36.29926108374385,0
44,4,2,3,27,0.06666666666666667,0.1,0.9,30,700,500,200,0.7142857142857143,9,5,4,382.1936745769668,0.4639607279693487,0.031258531258531175,0.21308606240113093,129413.2812500001,3892.1875000000136,133305.46875000012,43,0,21.366666666666667,29,1,21,35.90294840294841,0.6314655172413792,45.62500000000001,1017.5000000000008,35.08620689655175,0
45,4,1,1,27,0.03571428571428571,0.03571428571428571,0.9642857142857143,28,1100,800,300,0.7272727272727273,14,8,6,404.8765748105232,0.4635416666666667,0.030010095911155776,0.22431493866753738,129164.87327008194,4859.166295085219,134024.03956516716,44,0,22.964285714285715,28,0,22,35.58009422850413,0.6320684523809523,45.86925287356322,1016.5229885057473,36.304392446633834,0
46,4,1,0,28,0.03571428571428571,0.0,1.0,28,700,500,200,0.7142857142857143,9,5,4,400.2376617836321,0.4636243386243386,0.034533564768094216,0.2223612378418014,129274.43560906335,4748.099567314055,134022.5351763774,45,0,23.928571428571427,28,0,23,35.585911745314114,0.6331845238095237,45.76149425287357,1016.9540229885064,36.3197865353038,0
47,4,1,3,26,0.034482758620689655,0.10344827586206896,0.896551724137931,29,1400,1200,200,0.8571428571428571,16,12,4,383.76237061226584,0.46264367816091956,0.018336891003638778,0.21550637259344232,129696.07445987652,4154.49459876543,133850.56905864194,46,0,24.06896551724138,29,0,20,35.574606853922376,0.63433908045977,45.34722222222222,1018.611111111111,35.12452107279693,0
48,4,0,0,26,0.0,0.0,1.0,26,700,400,300,0.5714285714285714,10,4,6,419.6117910492156,0.46105769230769234,0.047166945161780216,0.2315427007943827,129005.34705551736,5626.432946578251,134631.78000209562,47,5,27.192307692307693,26,0,23,35.36919590865361,0.6374198717948718,46.02623456790123,1015.8950617283942,39.07288698955362,0
49,4,1,1,26,0.037037037037037035,0.037037037037037035,0.962962962962963,27,750,400,350,0.5333333333333333,11,4,7,404.43862690823016,0.46118233618233617,0.031241536944958792,0.22557514933103415,129428.42306193318,5069.170741213158,134497.59380314633,48,0,27.14814814814815,27,0,21,35.321609632446126,0.6381172839506173,45.61011904761905,1017.5595238095243,37.68738977072312,0
50,4,1,2,25,0.037037037037037035,0.07407407407407407,0.9259259259259259,27,750,400,350,0.5333333333333333,11,4,7,404.83840721444835,0.46064814814814814,0.026991167216346534,0.22601549934200904,129466.28146701383,5082.58463541666,134548.8661024305,49,0,28.11111111111111,27,0,22,35.272731149778224,0.638503086419753,45.572916666666664,1017.7083333333328,37.692901234567884,0
51,4,2,2,25,0.07407407407407407,0.07407407407407407,0.9259259259259259,27,800,600,200,0.75,10,6,4,397.37609888646193,0.4594017094017094,0.004844552581779071,0.22421962746064777,129883.08930342966,4922.487067743759,134805.57637117343,50,0,27.25925925925926,27,0,23,35.037104622871055,0.642746913580247,45.163690476190474,1019.3452380952377,37.75352733686066,0
52,4,1,0,26,0.038461538461538464,0.0,1.0,26,750,600,150,0.8,9,6,3,411.4139627072175,0.4571794871794872,0.01288257884324473,0.23322867011103796,130065.7412170399,5502.172401310751,135567.91361835066,51,0,27.384615384615383,26,0,24,34.492876954109946,0.6482371794871795,44.984567901234556,1020.0617283950603,39.23314339981001,0
53,4,0,0,26,0.0,0.0,1.0,26,800,500,300,0.625,11,5,6,409.2171962542943,0.4566025641025641,0.011936339522546247,0.23245224240836718,130144.46159122082,5451.470336076813,135595.93192729764,52,1,28.384615384615383,26,0,24,34.46857985480943,0.6490384615384617,44.907407407407405,1020.3703703703701,39.24501424501423,0
54,4,2,0,28,0.07142857142857142,0.0,1.0,28,950,700,250,0.7368421052631579,12,7,5,385.1241392942724,0.45596340388007056,0.00785072591641911,0.2234221798316284,130960.20775531768,4487.187458713159,135447.39521403084,53,0,27.285714285714285,28,0,22,34.25422281489799,0.6502976190476191,44.109195402298845,1023.5632183908041,36.555829228243006,0
55,4,0,1,27,0.0,0.03571428571428571,0.9642857142857143,28,900,600,300,0.6666666666666666,12,6,6,382.8003429293964,0.45516424162257496,0.003633065405199254,0.22271167706594336,131070.52873976076,4434.768669903537,135505.2974096643,54,1,28.285714285714285,28,0,23,34.20180300266591,0.6514136904761905,44.001436781609186,1023.9942528735623,36.57122331691294,0
56,4,0,0,27,0.0,0.0,1.0,27,500,400,100,0.8,6,4,2,393.10557846084316,0.4541785375118708,0.015680699600443937,0.2279747191107656,130947.0773986678,4895.205321712021,135842.28272037982,55,2,29.666666666666668,27,0,23,34.063317824949124,0.6535493827160493,44.12202380952381,1023.5119047619047,37.90784832451499,0
57,4,0,0,27,0.0,0.0,1.0,27,1000,800,200,0.8,12,8,4,392.3674498394747,0.45263532763532766,0.014160587083306364,0.22890318005889362,131175.63952664405,4893.810232426309,136069.44975907035,56,3,30.666666666666668,27,0,26,33.85023242300987,0.6558641975308641,43.898809523809526,1024.4047619047624,37.94091710758379,0
58,4,0,0,27,0.0,0.0,1.0,27,600,300,300,0.5,9,3,6,391.5034563323232,0.4518043684710351,0.015359050062114354,0.2290810793339601,131289.99532755814,4880.09739051872,136170.09271807686,57,4,31.666666666666668,27,0,26,33.75638279850928,0.6570216049382716,43.78720238095239,1024.8511904761908,37.95745149911818,0
59,4,0,0,27,0.0,0.0,1.0,27,750,600,150,0.8,9,6,3,392.2738634669113,0.45085470085470086,0.01805898192489397,0.2304483540622751,131442.5472337373,4912.295165462027,136354.84239919935,58,5,32.666666666666664,27,0,26,33.581997049291346,0.6585648148148147,43.63839285714286,1025.4464285714291,37.979497354497376,0
60,4,0,0,27,0.0,0.0,1.0,27,900,800,100,0.8888888888888888,10,8,2,393.8839161767377,0.4499643874643875,0.016539665662473002,0.23278640701550632,131671.54117506373,4972.660457412127,136644.20163247586,59,6,33.666666666666664,27,0,22,33.30871514184911,0.6608796296296295,43.41517857142857,1026.3392857142853,38.012566137566125,0
61,4,0,0,27,0.0,0.0,1.0,27,1000,800,200,0.8,12,8,4,394.87080071789757,0.4495489078822412,0.017136138892914987,0.23383808190152594,131747.91677738816,5004.681078160447,136752.5978555486,60,7,34.666666666666664,27,0,22,33.20605039377687,0.6616512345679012,43.34077380952382,1026.6369047619057,38.02358906525577,0
62,4,0,0,27,0.0,0.0,1.0,27,850,500,350,0.5882352941176471,12,5,7,396.16887208569653,0.44895536562203225,0.015330112721417377,0.23484237262811894,131786.11288265296,5041.911139455772,136828.02402210873,61,8,35.666666666666664,27,0,22,33.1340579710145,0.662037037037037,43.30357142857142,1026.7857142857135,38.0291005291005,0
63,4,0,0,27,0.0,0.0,1.0,27,550,200,350,0.36363636363636365,9,2,7,399.58698603191067,0.4485398860398861,0.013218316810437614,0.23782315099692336,131938.95266439908,5144.217687074833,137083.1703514739,62,9,36.666666666666664,27,0,22,32.89156044804944,0.6635802469135802,43.154761904761905,1027.3809523809523,38.051146384479715,0
64,4,1,1,27,0.03571428571428571,0.03571428571428571,0.9642857142857143,28,800,500,300,0.625,11,5,6,388.99456971621834,0.44827491181657847,0.008535709296988658,0.23342934824798056,132250.17598510376,4688.920060443925,136939.0960455477,63,0,36.32142857142857,28,0,22,32.849094380034465,0.6633184523809523,42.85201149425288,1028.591954022989,36.73542692939247,0
65,4,1,1,27,0.03571428571428571,0.03571428571428571,0.9642857142857143,28,600,400,200,0.6666666666666666,8,4,4,389.1642110759101,0.4475584215167549,0.013161569613182156,0.2339886578937525,132324.07940695604,4699.159193750826,137023.23860070686,64,0,37.285714285714285,28,0,22,32.770097286226324,0.6640625,42.7801724137931,1028.8793103448277,36.74568965517242,0
66,4,0,0,27,0.0,0.0,1.0,27,900,400,500,0.4444444444444444,14,4,10,403.6669592060978,0.4464624881291548,0.032402719513959344,0.24244567237113424,132283.1660333405,5279.668677366792,137562.8347107073,65,12,39.666666666666664,27,0,22,32.43843121654854,0.6670524691358024,42.81994047619048,1028.7202380952388,38.100749559082914,0
67,4,0,0,27,0.0,0.0,1.0,27,550,200,350,0.36363636363636365,9,2,7,403.47510038826505,0.4460470085470085,0.03599781441840988,0.24257624731169267,132321.4396435658,5277.681228741497,137599.1208723073,66,13,40.666666666666664,27,0,22,32.40466203837623,0.6674382716049383,42.782738095238095,1028.869047619048,38.106261022927704,0
68,4,0,0,27,0.0,0.0,1.0,27,850,500,350,0.5882352941176471,12,5,7,402.72746643937734,0.44545346628679966,0.03418803418803362,0.24261874197689345,132398.00347222234,5264.062500000006,137662.06597222234,67,14,41.666666666666664,27,0,23,32.34649122807016,0.6682098765432098,42.708333333333336,1029.1666666666674,38.11728395061731,0
69,4,0,0,27,0.0,0.0,1.0,27,950,600,350,0.631578947368421,13,6,7,431.57557033101943,0.44545346628679966,0.0759358806721877,0.25152706609554665,131137.53199847636,5919.151032808944,137056.6830312853,68,15,42.666666666666664,27,0,18,32.884915734418136,0.6554783950617284,43.9360119047619,1024.2559523809516,37.935405643738946,3
70,4,2,2,27,0.06896551724137931,0.06896551724137931,0.9310344827586207,29,700,300,400,0.42857142857142855,11,3,8,406.4850097322754,0.4477114121510673,0.052914003079650884,0.24031393775372106,131684.2689043208,4905.5362654320725,136589.8051697529,69,0,40.6551724137931,29,0,17,32.97248534055028,0.6544540229885059,43.402777777777764,1026.3888888888875,35.39272030651336,0
71,4,0,0,27,0.0,0.0,1.0,27,1000,700,300,0.7,13,7,6,430.24140235184416,0.44509734093067427,0.07711880362570267,0.25124784183142035,131213.7525908801,5890.717784509632,137104.47037538973,70,17,44.666666666666664,27,0,19,32.841473008956676,0.65625,43.86160714285714,1024.553571428571,37.94642857142856,0
72,4,0,0,27,0.0,0.0,1.0,27,850,700,150,0.8235294117647058,10,7,3,449.1861544430847,0.444681861348528,0.0173092565479096,0.24861762032789841,129125.75511975613,6200.30027636053,135326.05539611666,71,18,45.666666666666664,27,0,22,34.4942654953636,0.6350308641975309,45.90773809523809,1016.3690476190467,37.64329805996469,8
73,4,0,0,27,0.0,0.0,1.0,27,1000,700,300,0.7,13,7,6,451.7300567006077,0.4450379867046534,0.023065500384786608,0.250985626625362,129277.04480229589,6279.66535572562,135556.7101580215,72,19,46.666666666666664,27,0,22,34.27409521022339,0.6365740740740741,45.75892857142857,1016.9642857142854,37.665343915343904,0
74,4,0,0,27,0.0,0.0,1.0,27,1000,700,300,0.7,13,7,6,451.9941129417624,0.4446225071225071,0.028212503859717408,0.2518568663555688,129390.57019292086,6296.755199475613,135687.32539239648,73,20,47.666666666666664,27,0,22,34.15073009604602,0.6377314814814814,45.64732142857142,1017.4107142857138,37.68187830687829,0
75,4,2,2,27,0.06896551724137931,0.06896551724137931,0.9310344827586207,29,350,100,250,0.2857142857142857,6,1,5,428.35305397024297,0.4482758620689655,0.008175500749420639,0.2416359003141901,129872.97694830253,5326.297260802479,135199.274209105,74,0,45.310344827586206,29,0,17,34.25804491983467,0.6361350574712643,45.173611111111114,1019.305555555556,35.148467432950206,0
76,4,3,2,28,0.1,0.06666666666666667,0.9333333333333333,30,850,500,350,0.5882352941176471,12,5,7,416.07705726885416,0.4495689655172414,-0.0008162190626646026,0.23727637590196854,130296.8912591053,4842.7094172737025,135139.600676379,75,0,44.7,30,0,19,34.13803317535545,0.6374999999999998,44.758064516129046,1020.9677419354855,34.032258064516185,0
77,4,0,0,28,0.0,0.0,1.0,28,600,200,400,0.3333333333333333,10,2,8,439.1258743036391,0.44466490299823636,0.023061282009985362,0.24809213408110065,129932.78504425958,5811.36956665347,135744.15461091304,76,1,48.892857142857146,28,0,19,33.92228015783539,0.6398809523809523,45.11494252873564,1019.5402298850584,36.412151067323514,0
78,4,2,1,29,0.06666666666666667,0.03333333333333333,0.9666666666666667,30,900,800,100,0.8888888888888888,10,8,2,415.6707881571682,0.44612068965517243,0.015260196905766188,0.2345570876029737,129885.53590010422,4797.9246155625115,134683.46051566672,77,0,46.56666666666667,30,0,19,34.568389592123765,0.6333333333333333,45.161290322580655,1019.3548387096788,33.97849462365596,7
79,4,1,1,29,0.03333333333333333,0.03333333333333333,0.9666666666666667,30,900,700,200,0.7777777777777778,11,7,4,412.9178112255554,0.4451867816091954,0.01157681999912108,0.23361725829741156,129988.31376821021,4734.898001214018,134723.21176942423,78,0,47.53333333333333,30,0,19,34.533577171477525,0.634375,45.060483870967744,1019.7580645161291,33.99193548387097,0
80,4,0,1,28,0.0,0.034482758620689655,0.9655172413793104,29,950,700,250,0.7368421052631579,12,7,5,422.54312111351715,0.4441194581280788,0.021146417796825023,0.23814296641559066,129837.58680555559,5172.395833333338,135009.98263888893,79,2,50.172413793103445,29,0,20,34.44228672662851,0.6357758620689655,45.208333333333336,1019.166666666667,35.14367816091955,0
81,4,0,0,28,0.0,0.0,1.0,28,850,600,250,0.7058823529411765,11,6,5,430.08952235820044,0.44229497354497355,0.04348307370285398,0.24344301672236912,130006.03819857324,5582.846974501274,135588.88517307452,80,3,52.035714285714285,28,0,20,34.077674462289856,0.640625,45.04310344827587,1019.8275862068974,36.42241379310348,0
82,4,1,0,29,0.034482758620689655,0.0,1.0,29,800,600,200,0.75,10,6,4,416.50472470019736,0.4431444991789819,0.033474764996834994,0.2383962840599185,130439.87509645065,5065.764853395063,135505.6399498457,81,0,51.206896551724135,29,0,21,33.981276909132106,0.641882183908046,44.61805555555556,1021.5277777777779,35.225095785440615,0
83,4,2,3,28,0.06451612903225806,0.0967741935483871,0.9032258064516129,31,1100,800,300,0.7272727272727273,14,8,6,399.011542338615,0.44641577060931903,0.018906787241200984,0.23168602258982215,130994.67807345923,4253.677707248269,135248.3557807075,82,0,48.83870967741935,31,0,18,33.863838717883496,0.6418010752688172,44.075520833333336,1023.697916666667,33.02251344086022,0
84,4,0,0,28,0.0,0.0,1.0,28,900,600,300,0.6666666666666666,12,6,6,422.2601056934622,0.44339726631393295,0.023002931844652297,0.24264607365939342,130592.80659598361,5428.826463205183,136021.63305918878,83,1,52.67857142857143,28,0,18,33.678310373910605,0.6465773809523809,44.4683908045977,1022.1264367816092,36.504515599343186,0
85,4,0,1,27,0.0,0.03571428571428571,0.9642857142857143,28,700,500,200,0.7142857142857143,9,5,4,421.48799892316873,0.44328703703703703,0.022996466714847896,0.24266250811790196,130666.24554102254,5414.850871977799,136081.09641300034,84,2,53.67857142857143,28,0,18,33.623173130972454,0.6473214285714286,44.39655172413793,1022.4137931034479,36.51477832512314,0
86,4,0,0,27,0.0,0.0,1.0,27,950,900,50,0.9473684210526315,10,9,1,431.60376643692877,0.4426044634377968,0.03532780123259127,0.24809090139374584,130604.60789133354,5873.888135983551,136478.4960273171,85,3,54.74074074074074,27,0,19,33.427506429853935,0.6500771604938271,44.456845238095234,1022.1726190476185,37.858245149911795,0
87,4,0,0,27,0.0,0.0,1.0,27,800,500,300,0.625,11,5,6,430.893230339415,0.44201092117758783,0.02957358639011476,0.24865904048050377,130756.76120057398,5868.440644486962,136625.20184506095,86,4,55.74074074074074,27,0,20,33.29044206799554,0.6516203703703705,44.308035714285715,1022.7678571428572,37.88029100529101,0
88,4,1,1,27,0.03571428571428571,0.03571428571428571,0.9642857142857143,28,950,800,150,0.8421052631578947,11,8,3,422.1700890939575,0.44460978835978837,0.020342312008978514,0.2458519930605987,131107.31272294885,5469.917178623331,136577.22990157217,87,0,54.714285714285715,28,0,20,33.156507201646086,0.6517857142857143,43.96551724137931,1024.1379310344826,36.57635467980295,0
89,4,0,1,26,0.0,0.037037037037037035,0.962962962962963,27,800,500,300,0.625,11,5,6,433.87427504208495,0.44112060778727447,0.0331707106932464,0.2516178131314889,130947.07739866771,5962.9136550453395,136909.99105371305,88,6,57.74074074074074,27,0,20,33.020136667635946,0.6535493827160493,44.1220238095238,1023.511904761904,37.907848324514966,0
90,4,0,0,26,0.0,0.0,1.0,26,600,200,400,0.3333333333333333,10,2,8,445.45549878700683,0.4386217948717949,0.03868194842406836,0.2579751451927199,130893.49291742881,6461.445235101363,137354.93815253017,89,7,59.19230769230769,26,0,21,32.77848992107777,0.656650641025641,44.17438271604939,1023.302469135803,39.35778727445396,0
91,4,0,0,26,0.0,0.0,1.0,26,750,500,250,0.6666666666666666,10,5,5,445.2522841332227,0.43846153846153846,0.03977220005567417,0.2581217787038053,130932.97515622628,6459.6412513336545,137392.61640755995,90,8,60.19230769230769,26,0,21,32.74339063128268,0.6570512820512819,44.13580246913581,1023.4567901234575,39.363722697056055,0
92,4,0,0,26,0.0,0.0,1.0,26,1050,900,150,0.8571428571428571,12,9,3,445.8018544712927,0.4383974358974359,0.046960877530669354,0.2589710597690506,131011.95749504653,6481.074721841187,137493.03221688772,91,9,61.19230769230769,26,0,21,32.64872877097779,0.6578525641025641,44.058641975308646,1023.7654320987658,39.375593542260226,0
93,4,0,0,26,0.0,0.0,1.0,26,800,600,200,0.75,10,6,4,441.99565742015415,0.4382692307692308,0.04725970232299326,0.2572879984772057,131090.96364883415,6388.3273319616055,137479.29098079575,92,10,62.19230769230769,26,0,21,32.665574141048815,0.658653846153846,43.98148148148149,1024.074074074075,39.387464387464426,0
94,4,0,0,26,0.0,0.0,1.0,26,700,300,400,0.42857142857142855,11,3,8,438.88946846805766,0.43727564102564104,0.04769323433681216,0.2567986748983588,131288.5832237846,6324.235301402242,137612.81852518686,93,11,63.19230769230769,26,0,21,32.543730863825736,0.6606570512820513,43.78858024691359,1024.8456790123466,39.41714150047487,0
95,4,1,0,27,0.037037037037037035,0.0,1.0,27,700,400,300,0.5714285714285714,10,4,6,426.1674161767661,0.43761870845204176,0.052310318725741434,0.25237158834364887,131747.91677738802,5829.333855938212,137577.25063332624,94,0,61.81481481481482,27,0,19,32.40279388317148,0.6616512345679012,43.34077380952381,1026.6369047619046,38.02358906525573,0
96,4,0,0,27,0.0,0.0,1.0,27,700,500,200,0.7142857142857143,9,5,4,417.6570918852722,0.43761870845204176,0.05313493988894291,0.240310236285747,130642.63791454078,5512.764845521537,136155.4027600623,95,1,62.81481481481482,27,0,17,33.74514798641436,0.650462962962963,44.419642857142854,1022.3214285714283,37.86375661375661,3
97,4,1,1,27,0.03571428571428571,0.03571428571428571,0.9642857142857143,28,850,700,150,0.8235294117647058,10,7,3,409.63433307391114,0.4391809964726631,0.038532119291630584,0.2374145935301438,130923.44441554349,5126.147567380074,136049.59198292356,96,0,61.535714285714285,28,0,17,33.664420422106794,0.6499255952380953,44.14511494252872,1023.4195402298836,36.55069786535299,0
98,4,0,0,27,0.0,0.0,1.0,27,550,300,250,0.5454545454545454,8,3,5,420.9621876698277,0.43720322886989554,0.054326736515328156,0.24268893906602806,130718.71456916089,5605.527210884338,136324.24178004524,97,3,64.81481481481481,27,0,17,33.58313930927435,0.6512345679012346,44.34523809523809,1022.6190476190467,37.87477954144617,0
99,4,1,1,27,0.03571428571428571,0.03571428571428571,0.9642857142857143,28,500,400,100,0.8,6,4,2,407.2729414106144,0.43777557319223986,0.055505451338784484,0.23717659529206367,131107.31272294887,5079.292178623334,136186.6049015722,98,0,63.464285714285715,28,0,18,33.53792555181444,0.6517857142857143,43.96551724137931,1024.1379310344828,36.576354679802954,0
100,4,0,0,27,0.0,0.0,1.0,27,750,500,250,0.6666666666666666,10,5,5,413.70311258164514,0.43595679012345684,0.043994597532299506,0.24111079795931095,131137.53199847645,5450.401032808957,136587.9330312854,99,1,63.666666666666664,27,0,18,33.34256501525499,0.6554783950617283,43.936011904761905,1024.2559523809523,37.935405643738974,0
101,4,0,0,27,0.0,0.0,1.0,27,1000,800,200,0.8,12,8,4,410.0163334901863,0.4352445394112061,0.041559782521013666,0.23991355044578694,131289.99532755802,5366.2085016298015,136656.2038291878,100,2,64.66666666666667,27,0,21,33.28205919364986,0.6570216049382717,43.78720238095237,1024.8511904761897,37.957451499118136,0
102,4,0,0,27,0.0,0.0,1.0,27,950,600,350,0.631578947368421,13,6,7,407.7934239021488,0.43417616334283005,0.046050403908479476,0.23956559966834673,131442.54723373725,5320.281276573123,136762.82851031038,101,3,65.66666666666667,27,0,21,33.18413510375852,0.6585648148148149,43.638392857142854,1025.4464285714284,37.97949735449735,0
103,4,2,3,26,0.06896551724137931,0.10344827586206896,0.896551724137931,29,800,600,200,0.75,10,6,4,385.39382972579557,0.4375,0.020415582962776346,0.2295606724888434,131969.53125,4372.048611111111,136341.57986111112,102,0,62.06896551724138,29,0,18,33.225195998918636,0.6573275862068966,43.125,1027.5,35.43103448275862,0
104,4,0,0,26,0.0,0.0,1.0,26,950,600,350,0.631578947368421,13,6,7,424.34497652576624,0.43054487179487183,0.05018006229808125,0.2488017368985584,131367.67272995738,5949.0424001676665,137316.71513012506,103,5,69.46153846153847,26,0,21,32.835942596216576,0.6614583333333333,43.711419753086425,1025.1543209876547,39.42901234567903,0
105,4,0,0,26,0.0,0.0,1.0,26,500,200,300,0.4,8,2,6,423.96547243552857,0.42964743589743587,0.0470394165653758,0.24909377226649745,131446.78605109738,5945.779749657065,137392.56580075444,104,6,70.46153846153847,26,0,21,32.76523702031603,0.6622596153846153,43.63425925925926,1025.4629629629628,39.440883190883184,0
106,4,0,0,26,0.0,0.0,1.0,26,500,400,100,0.8,6,4,2,417.2369212651262,0.4295833333333334,0.06430732142650153,0.2431256757187571,131130.47565634057,5742.495189376626,136872.97084571718,105,7,71.46153846153847,26,0,23,33.259253678870984,0.6590544871794872,43.942901234567906,1024.2283950617289,39.3933998100665,2
107,4,1,0,27,0.037037037037037035,0.0,1.0,27,950,700,250,0.7368421052631579,12,7,5,406.7078344885531,0.42865622032288697,0.07574879227053177,0.24108969570197722,131786.11288265296,5319.688917233549,137105.8017998865,106,0,69.77777777777777,27,0,19,32.86352657004832,0.662037037037037,43.30357142857142,1026.7857142857135,38.0291005291005,0
108,4,2,2,27,0.06896551724137931,0.06896551724137931,0.9310344827586207,29,650,500,150,0.7692307692307693,8,5,3,383.031647198493,0.4351395730706076,0.044698147820499745,0.2298810680025961,132255.1022376542,4331.577932098748,136586.68016975294,107,0,65.89655172413794,29,0,19,32.997457016833195,0.6602011494252873,42.847222222222214,1028.6111111111102,35.4693486590038,0
109,4,0,0,27,0.0,0.0,1.0,27,750,400,350,0.5333333333333333,11,4,7,402.4652349749183,0.42812203228869894,0.07299058653149904,0.23977760547901722,131977.176450007,5223.2450662556585,137200.42151626266,108,2,71.77777777777777,27,0,21,32.77893434709149,0.6639660493827161,43.11755952380952,1027.5297619047612,38.05665784832449,0
110,4,0,0,27,0.0,0.0,1.0,27,1050,700,350,0.6666666666666666,14,7,7,412.41366082369854,0.4283594491927825,0.08296296296296268,0.23270457797712807,129883.0893034297,5313.112067743759,135196.20137117346,109,3,72.77777777777777,27,0,21,34.653892944038915,0.642746913580247,45.163690476190474,1019.3452380952381,37.75352733686067,4
111,4,2,1,28,0.06896551724137931,0.034482758620689655,0.9655172413793104,29,700,500,200,0.7142857142857143,9,5,4,387.34939923713574,0.4329844006568144,0.07479543729086813,0.22231800932814696,130546.30594135798,4313.406635802463,134859.71257716045,110,0,68.6896551724138,29,0,19,34.6176497236568,0.6429597701149425,44.513888888888886,1021.944444444444,35.23946360153255,0
112,4,2,1,29,0.06666666666666667,0.03333333333333333,0.9666666666666667,30,850,700,150,0.8235294117647058,10,7,3,380.00599334532035,0.4300766283524904,0.0865179352580927,0.22137963832502586,131121.55306971894,3965.395204647925,135086.94827436688,111,0,67.33333333333333,30,0,21,34.22162073490813,0.6458333333333335,43.9516129032258,1024.193548387096,34.13978494623653,0
113,4,1,0,30,0.03333333333333333,0.0,1.0,30,900,600,300,0.6666666666666666,12,6,6,380.964084923408,0.43244731800766284,0.09445683060109333,0.22293562145364398,131293.6850539077,4003.6357165567943,135297.32077046452,112,0,68.3,30,0,22,34.02267759562842,0.6475694444444446,43.78360215053762,1024.8655913978473,34.162186379928244,0
114,4,1,1,30,0.03225806451612903,0.03225806451612903,0.967741935483871,31,700,400,300,0.5714285714285714,10,4,6,371.53237651060334,0.43301971326164873,0.08776813492713287,0.21913735979817014,131595.18771701382,3578.374565972212,135173.56228298604,113,0,67.06451612903226,31,0,16,33.959390862944176,0.6478494623655915,43.48958333333333,1026.041666666666,33.098118279569874,0
115,4,0,0,30,0.0,0.0,1.0,30,900,800,100,0.8888888888888888,10,8,2,385.6420509621823,0.4306273946360153,0.10359061721923712,0.22689548888916047,131500.3924767314,4142.416211411717,135642.8086881431,114,2,70.3,30,0,22,33.69343249028088,0.6496527777777779,43.581989247311824,1025.6720430107523,34.18906810035841,0
116,4,3,1,32,0.09090909090909091,0.030303030303030304,0.9696969696969697,33,1150,800,350,0.6956521739130435,15,8,7,347.44207243352116,0.43383049242424243,0.08672873964396599,0.20740189761565397,132051.3913669019,2576.0418168492624,134627.43318375116,115,0,64.81818181818181,33,0,20,34.11765728707127,0.6474116161616162,43.04534313725489,1027.8186274509785,31.146019013666017,1
117,4,0,0,32,0.0,0.0,1.0,32,900,500,400,0.5555555555555556,13,5,8,354.78520166584036,0.43071656586021506,0.08907344268337636,0.21154554991635696,132008.4545741505,2966.929235537173,134975.3838096877,116,1,67.84375,32,0,22,33.97223246099028,0.6494140625,43.087121212121204,1027.6515151515143,32.11410984848482,0
118,4,0,0,32,0.0,0.0,1.0,32,900,700,200,0.7777777777777778,11,7,4,355.52377344853886,0.4298345094086022,0.08497712759425258,0.21271345240201717,132138.24043783802,2995.6571714621014,135133.89760930013,117,2,68.84375,32,0,23,33.82250603790576,0.6507161458333334,42.96085858585859,1028.156565656566,32.12989267676769,0
119,4,1,1,32,0.030303030303030304,0.030303030303030304,0.9696969696969697,33,1200,1200,0,1.0,12,12,0,347.654317583863,0.4327256944444444,0.07828192608471274,0.2092654698746736,132366.47450800167,2603.5552732122173,134970.0297812139,118,0,67.72727272727273,33,0,23,33.79517982612838,0.6505681818181819,42.73897058823529,1029.0441176470583,31.18315508021389,0
120,4,0,0,32,0.0,0.0,1.0,32,950,600,350,0.631578947368421,13,6,7,363.79600286047616,0.42859543010752693,0.09262269938650314,0.2189761760201541,132365.519143455,3230.8093561881733,135596.32849964316,119,4,70.84375,32,0,23,33.38087934560326,0.6529947916666665,42.739898989899004,1029.040404040406,32.15751262626269,0
121,4,1,1,32,0.030303030303030304,0.030303030303030304,0.9696969696969697,33,1150,700,450,0.6086956521739131,16,7,9,351.62563288261094,0.4296875,0.08188488093306612,0.21307955619166163,132618.81134960122,2726.434694588631,135345.24604418984,120,0,69.66666666666667,33,0,23,33.43929704540946,0.6530934343434343,42.49387254901961,1030.0245098039225,31.212863933452194,0
122,4,0,0,32,0.0,0.0,1.0,32,900,500,400,0.5555555555555556,13,5,8,361.45263284423834,0.42783938172043007,0.09535963944076542,0.21831739023792016,132495.48037190098,3178.1680440771556,135673.64841597812,121,6,72.84375,32,0,23,33.310338484179546,0.654296875,42.613636363636374,1029.5454545454559,32.173295454545496,0
123,4,0,0,32,0.0,0.0,1.0,32,500,400,100,0.8,6,4,2,361.9881653779601,0.42777637768817206,0.09142780502759029,0.21882976194642453,132527.9806429192,3194.712114835234,135722.69275775444,122,7,73.84375,32,0,23,33.26384631105661,0.6546223958333333,42.58207070707071,1029.671717171718,32.17724116161619,0
124,4,0,0,32,0.0,0.0,1.0,32,1200,1000,200,0.8333333333333334,14,10,4,362.37307352223263,0.4273983534946237,0.09342819051121731,0.21944151156056832,132592.9931416439,3209.626090449977,135802.6192320939,123,8,74.84375,32,0,23,33.18851906338115,0.6552734375,42.518939393939405,1029.9242424242439,32.18513257575762,0
125,4,0,0,32,0.0,0.0,1.0,32,900,600,300,0.6666666666666666,12,6,6,364.50854238754323,0.42683131720430106,0.09200367647058827,0.2213087578781513,132690.54178145083,3273.3671946740087,135963.90897612483,124,9,75.84375,32,0,17,33.035386029411754,0.65625,42.42424242424242,1030.30303030303,32.19696969696969,0
126,4,1,0,33,0.030303030303030304,0.0,1.0,33,700,200,500,0.2857142857142857,12,2,10,356.1197282246149,0.4267282196969697,0.08958092625986702,0.21836649613423398,133060.97902549506,2877.1279375720974,135938.10696306717,125,0,74.51515151515152,33,0,18,32.87937502474562,0.6575126262626263,42.06495098039216,1031.7401960784318,31.264854426619145,0
127,4,0,0,33,0.0,0.0,1.0,33,800,500,300,0.625,11,5,6,356.1197282246149,0.4267282196969697,0.08958092625986702,0.21836649613423398,133060.97902549506,2877.1279375720974,135938.10696306717,126,1,75.51515151515152,33,0,18,32.87937502474562,0.6575126262626263,42.06495098039216,1031.7401960784318,31.264854426619145,0
128,4,0,1,32,0.0,0.030303030303030304,0.9696969696969697,33,900,600,300,0.6666666666666666,12,6,6,358.7652116696976,0.426333648989899,0.0919847891235761,0.22073625842906214,133187.4478115388,2956.6045811706954,136144.05239270948,127,2,76.51515151515152,33,0,19,32.684193082433026,0.6587752525252526,41.94240196078431,1032.2303921568623,31.27970885323825,0
129,4,0,1,31,0.0,0.03125,0.96875,32,850,400,450,0.47058823529411764,13,4,9,368.15578932756347,0.4251302083333333,0.102607544976135,0.22567148946703094,133048.52701573828,3396.51709646976,136445.04411220804,128,3,79.4375,32,0,19,32.58143638069597,0.6598307291666666,42.07702020202021,1031.6919191919199,32.240372474747495,0
130,4,0,0,31,0.0,0.0,1.0,31,1000,800,200,0.8,12,8,4,379.6794291156156,0.4240143369175627,0.10688869969733839,0.23181814951168547,132901.00309583882,3891.9553968641544,136792.95849270298,129,4,82.58064516129032,31,0,19,32.43267773708801,0.6609543010752688,42.220052083333336,1031.1197916666672,33.26192876344088,0
131,4,0,0,31,0.0,0.0,1.0,31,600,300,300,0.5,9,3,6,379.6361915701568,0.4234767025089606,0.1128421464113818,0.23241714912046238,133001.71746148012,3898.4530978732705,136900.1705593534,130,5,83.58064516129032,31,0,19,32.33242867962635,0.6619623655913978,42.122395833333336,1031.5104166666672,33.27452956989249,0
132,4,0,0,31,0.0,0.0,1.0,31,650,600,50,0.9230769230769231,7,6,1,379.6361915701568,0.4234767025089606,0.1128421464113818,0.23241714912046238,133001.71746148012,3898.4530978732705,136900.1705593534,131,6,84.58064516129032,31,0,19,32.33242867962635,0.6619623655913978,42.122395833333336,1031.5104166666672,33.27452956989249,0
133,4,0,1,30,0.0,0.03225806451612903,0.967741935483871,31,1250,800,450,0.64,17,8,9,379.1053874633573,0.42267025089605736,0.11565041146736355,0.23292940318097438,133136.0626220703,3894.519721137154,137030.58234320747,132,7,85.58064516129032,31,0,19,32.210972327361425,0.6633064516129032,41.9921875,1032.03125,33.29133064516129,0
134,4,0,1,29,0.0,0.03333333333333333,0.9666666666666667,30,1250,1000,250,0.8,15,10,5,384.97358734372483,0.4220067049808429,0.1035083148799445,0.2362463812979836,133090.55102107173,4247.269373627001,137337.82039469873,133,8,85.26666666666667,30,0,19,32.10536885067952,0.6656249999999999,42.03629032258064,1031.8548387096769,34.39516129032256,0
135,4,0,0,29,0.0,0.0,1.0,29,800,400,400,0.5,12,4,8,424.91055669037564,0.42077175697865354,0.046376757280916614,0.2445478192179713,130652.78018904309,5303.149112654304,135955.92930169738,134,9,86.34482758620689,29,0,18,33.54942150070189,0.6440373563218391,44.409722222222214,1022.3611111111102,35.25383141762449,8
136,4,0,0,29,0.0,0.0,1.0,29,900,700,200,0.7777777777777778,11,7,4,421.6425184896362,0.420309934318555,0.044104220802022365,0.24356056068048404,130794.8133680556,5229.730902777784,136024.5442708334,135,10,87.34482758620689,29,0,18,33.488204344874404,0.6454741379310345,44.270833333333336,1022.9166666666671,35.27298850574714,0
137,4,0,0,29,0.0,0.0,1.0,29,1150,1000,150,0.8695652173913043,13,10,3,425.5807188768553,0.4204638752052545,0.04212635096867201,0.24628854328089503,130865.85889274697,5338.797260802478,136204.65615354944,136,11,88.34482758620689,29,0,18,33.315093208452105,0.646192528735632,44.20138888888889,1023.1944444444449,35.28256704980844,0
138,4,0,0,29,0.0,0.0,1.0,29,1050,800,250,0.7619047619047619,13,8,5,459.5509061233255,0.4202586206896552,0.08973348870782849,0.25235594086065993,128813.3704668209,6039.260223765419,134852.63069058632,137,12,89.34482758620689,29,0,17,34.55257787202992,0.6253591954022989,46.21527777777777,1015.1388888888881,35.00478927203063,5
139,4,1,0,30,0.03333333333333333,0.0,1.0,30,900,800,100,0.8888888888888888,10,8,2,449.13468264040887,0.4244013409961686,0.08475618084961045,0.24928847699851664,129236.69222608024,5609.51967592592,134846.21190200615,138,0,87.33333333333333,29,1,18,34.38154509857486,0.6296695402298851,45.79861111111111,1016.8055555555555,35.06226053639847,0
140,4,1,0,31,0.03225806451612903,0.0,1.0,31,900,800,100,0.8888888888888888,10,8,2,416.5050897435764,0.42974910394265237,0.12421598161391034,0.2247086418325603,128108.16529594395,4492.38355508947,132600.5488510334,139,0,85.48387096774194,28,3,21,36.36963052322831,0.6212797619047619,46.910919540229884,1012.3563218390802,36.155582922824294,8
141,4,1,0,32,0.03125,0.0,1.0,32,550,200,350,0.36363636363636365,9,2,7,407.4096830102712,0.43185063844086025,0.13899445357436258,0.2223397238670405,128566.75347222229,4075.86805555556,132642.62152777784,140,0,83.78125,29,3,18,36.12880032867706,0.6228448275862069,46.458333333333336,1014.1666666666672,34.97126436781611,0
142,4,0,1,31,0.0,0.03125,0.96875,32,850,400,450,0.47058823529411764,13,4,9,408.97528995163253,0.431619623655914,0.14042602355196454,0.22339166361381993,128601.97000385799,4119.005594135795,132720.9755979938,141,1,84.78125,29,3,18,36.05296339403896,0.6232040229885057,46.42361111111111,1014.3055555555553,34.97605363984673,0
143,4,2,2,31,0.06060606060606061,0.06060606060606061,0.9393939393939394,33,700,500,200,0.7142857142857143,9,5,4,386.9927438860523,0.43761837121212116,0.1554893194237461,0.21460506706408344,129201.38888888879,3401.3937114197433,132602.78260030854,142,0,82.36363636363636,30,3,19,35.99726775956286,0.6263888888888889,45.83333333333333,1016.6666666666658,33.888888888888864,0
144,4,0,0,31,0.0,0.0,1.0,31,500,400,100,0.8,6,4,2,395.5463872791915,0.43306451612903224,0.16376514763611527,0.21859142454902683,129064.77627471385,4010.221196092036,133074.9974708059,143,1,85.45161290322581,30,1,19,35.919587742504405,0.625,45.96774193548387,1016.1290322580646,33.87096774193549,0
145,4,1,1,31,0.03125,0.03125,0.96875,32,600,400,200,0.6666666666666666,8,4,4,388.4242493457756,0.43430779569892475,0.16625479846449154,0.21666920118752578,129433.15505981445,3654.995218912761,133088.1502787272,144,0,83.75,31,1,17,35.72416826615483,0.626008064516129,45.60546875,1017.578125,32.825100806451616,0
146,4,1,2,30,0.03125,0.0625,0.9375,32,1000,700,300,0.7,13,7,6,388.6392268295245,0.43527385752688175,0.16275025585262903,0.21715459872240106,129499.41211276574,3665.7102796766394,133165.12239244237,145,0,84.71875,31,1,17,35.65106498656774,0.6266801075268817,45.54036458333333,1017.8385416666658,32.833501344085995,0
147,4,2,1,31,0.0625,0.03125,0.96875,32,750,600,150,0.8,9,6,3,387.72738315181357,0.4381300403225807,0.15999600638977673,0.2181140742748339,129764.60986667202,3662.6585218641444,133427.26838853618,146,0,82.78125,31,1,19,35.40375399361023,0.6293682795698925,45.279947916666664,1018.8802083333327,32.867103494623635,0
148,4,2,1,32,0.06060606060606061,0.030303030303030304,0.9696969696969697,33,950,700,250,0.7368421052631579,12,7,5,377.07240721557724,0.43793402777777773,0.15345688453061035,0.2146657281641356,130230.36552392608,3221.2554841342617,133451.62100806035,147,0,81.21212121212122,32,1,21,35.201220517895415,0.6315104166666667,44.82323232323232,1020.7070707070703,31.897095959595948,0
149,4,1,1,32,0.030303030303030304,0.030303030303030304,0.9696969696969697,33,600,400,200,0.6666666666666666,8,4,4,374.6936190215827,0.4369870580808081,0.15207932422928594,0.21385351967738364,130329.05578613274,3166.697100797059,133495.7528869298,148,0,82.18181818181819,31,2,21,35.161629686304515,0.6350806451612904,44.72656249999999,1021.0937499999994,32.938508064516114,0
150,4,0,0,32,0.0,0.0,1.0,32,1300,900,400,0.6923076923076923,17,9,8,385.6188089496143,0.43386676747311825,0.1668872799183463,0.21933818755784307,130196.13477918843,3641.215684678825,133837.35046386725,149,2,85.75,31,1,21,35.01796801905247,0.6337365591397849,44.856770833333336,1020.5729166666672,32.921706989247326,0
151,4,0,0,32,0.0,0.0,1.0,32,1000,700,300,0.7,13,7,6,381.9784572467397,0.4339507728494623,0.16125065798131333,0.21840890117516737,130399.83171826214,3562.002263205314,133961.83398146744,150,3,86.75,30,2,22,34.903715401149256,0.6385416666666668,44.65725806451612,1021.3709677419348,34.04569892473116,0
152,4,1,1,32,0.030303030303030304,0.030303030303030304,0.9696969696969697,33,550,300,250,0.5454545454545454,8,3,5,372.56386917106806,0.4339094065656566,0.1507666427452523,0.2148396937202325,130728.22570800774,3140.9227159288052,133869.14842393654,151,0,85.0909090909091,31,2,17,34.81081826670062,0.6391129032258065,44.33593749999999,1022.6562499999994,32.98891129032256,0
153,4,0,0,32,0.0,0.0,1.0,32,950,700,250,0.7368421052631579,12,7,5,382.10840884708347,0.432627688172043,0.15908567859021527,0.21945259372154244,130571.48947855241,3578.4928170886724,134149.9822956411,152,5,88.75,30,2,18,34.72596659652814,0.6402777777777778,44.48924731182795,1022.043010752688,34.06810035842293,0
154,4,0,1,31,0.0,0.03125,0.96875,32,700,400,300,0.5714285714285714,10,4,6,383.381914449252,0.4324386760752688,0.15850121598527678,0.22077109941070838,130674.53833174337,3619.6509350791753,134294.18926682256,153,6,89.75,30,2,19,34.58875597037816,0.6413194444444446,44.38844086021504,1022.4462365591384,34.081541218637945,0
155,4,1,0,32,0.03125,0.0,1.0,32,850,600,250,0.7058823529411765,11,6,5,381.4088659966329,0.43338373655913975,0.14155281135049913,0.22061430759622846,130846.37674875697,3581.1936351023064,134427.57038385927,154,0,86.03125,30,2,20,34.4647705377474,0.6430555555555557,44.22043010752687,1023.1182795698916,34.10394265232972,0
156,4,0,0,32,0.0,0.0,1.0,32,800,400,400,0.5,12,4,8,380.4263710434317,0.432606686827957,0.14423424162836485,0.22063570567370372,130949.53399598207,3563.3312015839797,134512.86519756605,155,1,87.03125,30,2,20,34.38525935653314,0.6440972222222223,44.11962365591397,1023.5215053763432,34.11738351254477,0
157,4,0,0,32,0.0,0.0,1.0,32,700,600,100,0.8571428571428571,8,6,2,380.96074826989627,0.4321656586021505,0.14343159138655448,0.2211430685078909,130983.9287778933,3579.9471037113963,134563.8758816047,156,2,88.03125,30,2,20,34.33670343137254,0.6444444444444445,44.08602150537634,1023.6559139784938,34.121863799283126,0
158,4,1,1,32,0.030303030303030304,0.030303030303030304,0.9696969696969697,33,1100,800,300,0.7272727272727273,14,8,6,373.9275384227764,0.43458017676767674,0.13648869648869622,0.2195883195435766,131428.24172973624,3228.927781846773,134657.16951158302,157,0,86.33333333333333,31,2,20,34.066798941798936,0.6461693548387097,43.65234374999999,1025.3906249999993,33.07711693548385,0
159,4,0,0,32,0.0,0.0,1.0,32,900,700,200,0.7777777777777778,11,7,4,386.1621646741271,0.4305275537634408,0.15794605401153627,0.22658807631801878,131397.01844143853,3748.11141461443,135145.12985605295,158,4,90.03125,30,2,20,33.784795053312344,0.648611111111111,43.68279569892474,1025.2688172043026,34.17562724014342,0
160,4,1,1,32,0.030303030303030304,0.030303030303030304,0.9696969696969697,33,1050,800,250,0.7619047619047619,13,8,5,376.7832535629282,0.43012152777777773,0.14174208796910115,0.22321081550290692,131762.23966810448,3329.1610717773538,135091.40073988182,159,0,88.27272727272727,31,2,20,33.65580744028746,0.649529569892473,43.32682291666667,1026.6927083333342,33.11911962365594,0
161,4,0,0,32,0.0,0.0,1.0,32,600,500,100,0.8333333333333334,7,5,2,386.97448138604,0.42893145161290325,0.15152730487166033,0.22871030494301886,131672.77286391502,3790.800598335084,135463.5734622501,160,6,92.03125,30,2,20,33.48475423432862,0.6513888888888888,43.41397849462366,1026.3440860215064,34.21146953405022,0
162,4,0,0,32,0.0,0.0,1.0,32,1150,900,250,0.782608695652174,14,9,5,384.8738125151002,0.4281964045698925,0.15546455687917238,0.2280877466099965,131776.25529324223,3743.445954734679,135519.70124797692,161,7,93.03125,30,2,20,33.43396823318933,0.6524305555555554,43.313172043010766,1026.7473118279588,34.224910394265294,0
163,4,0,0,32,0.0,0.0,1.0,32,750,500,250,0.6666666666666666,10,5,5,384.8738125151002,0.4281964045698925,0.15546455687917238,0.2280877466099965,131776.25529324223,3743.445954734679,135519.70124797692,162,8,94.03125,30,2,20,33.43396823318933,0.6524305555555554,43.313172043010766,1026.7473118279588,34.224910394265294,0
164,4,1,0,33,0.030303030303030304,0.0,1.0,33,1050,800,250,0.7619047619047619,13,8,5,387.2116326897093,0.42889835858585856,0.12148237374380866,0.22232802523639547,130561.83073255746,3511.0119289822014,134072.84266153965,163,0,92.15151515151516,31,2,17,34.60539028326326,0.6374327956989247,44.498697916666664,1022.0052083333329,32.967909946236546,6
165,4,0,1,32,0.0,0.030303030303030304,0.9696969696969697,33,850,400,450,0.47058823529411764,13,4,9,388.6210393930792,0.429095643939394,0.12477900019301291,0.2233290746146171,130595.10125054244,3550.400797526033,134145.50204806848,164,1,93.15151515151516,31,2,17,34.5355626326964,0.6377688172043011,44.46614583333333,1022.1354166666658,32.97211021505374,0
166,4,0,0,32,0.0,0.0,1.0,32,750,500,250,0.6666666666666666,10,5,5,392.4030048745571,0.426789314516129,0.14539365548980965,0.22556499259795965,130605.83457986468,3850.0243886576445,134455.8589685223,165,2,96.75,30,2,17,34.428007889546365,0.640625,44.45564516129032,1022.1774193548383,34.072580645161274,0
167,4,1,0,33,0.030303030303030304,0.0,1.0,33,600,300,300,0.5,9,3,6,390.5585776691154,0.42743844696969696,0.08867852673956844,0.21477967479998308,128870.65463595913,3478.5203100780645,132349.1749460372,166,0,94.78787878787878,31,2,17,36.24487047961018,0.6202956989247312,46.158854166666664,1015.3645833333327,32.75369623655912,8
168,4,1,1,33,0.029411764705882353,0.029411764705882353,0.9705882352941176,34,950,600,350,0.631578947368421,13,6,7,378.7417456337365,0.4307412358882947,0.05905010054093851,0.2120341255205581,129575.43372741248,3038.335505818816,132613.7692332313,167,0,92.97058823529412,33,1,16,35.82540924410206,0.6224747474747474,45.4656862745098,1018.1372549019604,30.852644087938195,8
169,4,1,1,33,0.029411764705882353,0.029411764705882353,0.9705882352941176,34,850,400,450,0.47058823529411764,13,4,9,377.26418724204154,0.42836452762923355,0.055193932275821034,0.2122174866529318,129762.65889321404,2990.9608083429293,132753.61970155698,168,0,93.94117647058823,33,1,17,35.672259642370285,0.6243686868686871,45.28186274509803,1018.872549019607,30.87492572786688,0
170,4,1,1,33,0.029411764705882353,0.029411764705882353,0.9705882352941176,34,1200,800,400,0.6666666666666666,16,8,8,380.1023946005918,0.4289958407605467,0.06624717194570118,0.21484048390468216,129950.01922337548,3078.862697039579,133028.88192041506,169,0,94.91176470588235,33,1,19,35.40915464743589,0.6262626262626263,45.09803921568626,1019.6078431372538,30.89720736779557,0
171,4,1,0,34,0.029411764705882353,0.0,1.0,34,600,300,300,0.5,9,3,6,380.2759918602149,0.43057412358882946,0.07059600590566473,0.21614731632901066,130168.77710796315,3100.012164792372,133268.78927275553,170,0,95.70588235294117,33,1,20,35.182113406188705,0.6284722222222223,44.88357843137254,1020.4656862745087,30.92320261437905,0
172,4,0,0,34,0.0,0.0,1.0,34,950,600,350,0.631578947368421,13,6,7,373.26599692856774,0.43057412358882946,0.05731745317314685,0.20005644441061068,127843.36911848056,2743.9165249432895,130587.28564342385,171,1,96.70588235294117,34,0,16,37.73543260741613,0.6026348039215688,47.17261904761904,1011.3095238095225,29.744397759103602,7
173,4,2,1,35,0.05555555555555555,0.027777777777777776,0.9722222222222222,36,850,700,150,0.8235294117647058,10,7,3,359.33197356371267,0.43614417989417986,0.06740322028091827,0.19532402808798438,128408.33875868037,2028.5986660288877,130436.93742470926,172,0,92.27777777777777,35,1,16,37.509635149023644,0.6062500000000002,46.61458333333332,1013.5416666666652,28.95833333333329,0
174,4,0,0,35,0.0,0.0,1.0,35,850,700,150,0.8235294117647058,10,7,3,367.03208087257553,0.43487394957983194,0.07530636226288401,0.19894541453666342,128295.24518140574,2417.694160997715,130712.93934240346,173,1,95.91428571428571,34,1,18,37.43022914218566,0.6072303921568629,46.72619047619047,1013.0952380952369,29.79691876750697,0
175,4,2,2,35,0.05405405405405406,0.05405405405405406,0.9459459459459459,37,1000,900,100,0.9,11,9,2,354.261276563284,0.439502002002002,0.06558950471945679,0.19405765125299412,128715.26668137734,1719.7669375456571,130435.033618923,174,0,91.67567567567568,36,1,16,37.32475122997817,0.607349537037037,46.31193693693694,1014.7522522522524,28.18756256256257,0
176,4,1,1,35,0.027777777777777776,0.027777777777777776,0.9722222222222222,36,950,700,250,0.7368421052631579,12,7,5,365.09830542777524,0.4359292328042328,0.07683093771389471,0.19977851094755764,128672.41753472207,2195.616319444425,130868.0338541665,175,0,95.19444444444444,35,1,16,37.09360027378508,0.6089285714285715,46.35416666666666,1014.5833333333321,28.9880952380952,0
177,4,0,0,35,0.0,0.0,1.0,35,1050,800,250,0.7619047619047619,13,8,5,375.7809065327066,0.4337885154061625,0.08707227521920657,0.20538993614914633,128627.127621882,2667.123724489785,131294.25134637178,176,4,98.91428571428571,34,1,17,36.86896099831787,0.6106004901960784,46.39880952380952,1014.4047619047612,29.835434173669448,0
178,4,1,0,36,0.027777777777777776,0.0,1.0,36,950,600,350,0.631578947368421,13,6,7,367.16820061506775,0.4360780423280423,0.08858063372703917,0.20255407270889056,128995.54887099192,2272.612713263025,131268.16158425494,177,0,97.13888888888889,35,1,18,36.711124719911886,0.612202380952381,46.035879629629626,1015.8564814814812,29.02447089947089,0
179,4,2,1,37,0.05263157894736842,0.02631578947368421,0.9736842105263158,38,500,300,200,0.6,7,3,4,353.30411280561583,0.4423897581792318,0.08975433938314059,0.19749634357761028,129516.42679419268,1551.9013524637103,131068.3281466564,178,0,92.97368421052632,36,2,17,36.53289449422871,0.6154513888888891,45.52364864864864,1017.9054054054042,28.275150150150115,0
180,4,1,1,37,0.02631578947368421,0.02631578947368421,0.9736842105263158,38,1050,900,150,0.8571428571428571,12,9,3,384.60428602806326,0.4441826695116169,0.1252807165987011,0.20946881226531688,128485.98082768626,2359.6267232978403,130845.6075509841,179,0,93.10526315789474,33,5,18,36.7897326644909,0.6114267676767678,46.53799019607842,1013.8480392156846,30.722667855020745,5
181,4,1,2,36,0.02631578947368421,0.05263157894736842,0.9473684210526316,38,850,600,250,0.7058823529411765,11,6,5,384.17521147962924,0.4437381460407776,0.1249252573057007,0.20939826744284912,128517.04422577846,2274.61252883505,130791.6567546135,180,0,94.02631578947368,33,5,18,36.768793811941016,0.6117424242424243,46.507352941176464,1013.9705882352933,30.726381461675555,0
182,4,1,1,36,0.02702702702702703,0.02702702702702703,0.972972972972973,37,900,600,300,0.6666666666666666,12,6,6,387.2535598658549,0.4434434434434435,0.13376808330452294,0.2116605249273216,128627.12762188188,2562.26261337866,131189.39023526054,181,0,97.16216216216216,34,3,19,36.57801314399718,0.6106004901960785,46.39880952380951,1014.4047619047602,29.83543417366942,0
183,4,2,1,37,0.05263157894736842,0.02631578947368421,0.9736842105263158,38,750,400,350,0.5333333333333333,11,4,7,379.1106565995119,0.4420489568515884,0.12925670121032806,0.20821412454817256,128819.24518014821,2167.3497245798894,130986.5949047281,182,0,95.55263157894737,35,3,20,36.588022080340515,0.6104166666666667,46.20949074074073,1015.1620370370362,29.004629629629605,0
184,4,0,0,37,0.0,0.0,1.0,37,1400,1200,200,0.8571428571428571,16,12,4,383.750563844986,0.4408470970970971,0.13425102908043485,0.21102569690740705,128868.76594387741,2490.6923185940873,131359.4582624715,183,1,99.13513513513513,34,3,20,36.41961738382772,0.6130514705882353,46.16071428571428,1015.3571428571418,29.863445378151226,0
185,4,2,1,38,0.05128205128205128,0.02564102564102564,0.9743589743589743,39,1150,900,250,0.782608695652174,14,9,5,365.78873506479954,0.44379779577148,0.1346445486572878,0.20406183748031195,129436.8355624142,1669.735983385114,131106.57154579932,184,0,95.0,35,4,15,36.296254170457985,0.6166666666666667,45.60185185185185,1017.592592592592,29.07407407407406,0
186,4,0,1,37,0.0,0.02631578947368421,0.9736842105263158,38,1300,1000,300,0.7692307692307693,16,10,6,376.62634714231757,0.4406412991939308,0.1495107547739125,0.20998208669441565,129413.28125000023,2148.0902777778074,131561.37152777804,185,1,98.5,34,4,21,36.044567294567294,0.6185661764705881,45.625000000000014,1017.5000000000018,29.926470588235347,0
187,4,1,1,37,0.02631578947368421,0.02631578947368421,0.9736842105263158,38,750,500,250,0.6666666666666666,10,5,5,377.6332149296053,0.44061166429587484,0.14303344022551978,0.21119304256789143,129534.44054705236,2183.3014455782586,131717.74199263062,186,0,99.05263157894737,34,4,15,35.89541184266948,0.6197916666666665,45.505952380952394,1017.9761904761922,29.94047619047624,0
188,4,1,2,36,0.02631578947368421,0.05263157894736842,0.9473684210526316,38,1050,800,250,0.7619047619047619,13,8,5,379.15014102375346,0.44033013276434324,0.1438832323356607,0.21269701353824327,129655.6565334467,2231.792091836731,131887.44862528343,187,0,100.02631578947368,34,4,16,35.73324566530293,0.6210171568627452,45.38690476190476,1018.4523809523808,29.954481792717083,0
189,4,2,2,36,0.05263157894736842,0.05263157894736842,0.9473684210526316,38,800,600,200,0.75,10,6,4,369.5345712508677,0.44087837837837834,0.11309889623638703,0.20875290687285178,129928.59977324269,2002.621882086171,131931.22165532887,188,0,96.28947368421052,34,4,17,35.700315273236804,0.6237745098039216,45.11904761904762,1019.52380952381,29.985994397759118,0
190,4,1,2,35,0.02702702702702703,0.05405405405405406,0.9459459459459459,37,900,900,0,1.0,9,9,0,378.98709039555274,0.4389702202202202,0.1288876326741457,0.21403894127634754,129918.783115268,2447.508320117242,132366.29143538524,189,0,99.86486486486487,33,4,17,35.4693823376207,0.6259469696969697,45.128676470588225,1019.4852941176457,30.89349376114078,0
191,4,0,1,34,0.0,0.02857142857142857,0.9714285714285714,35,1000,600,400,0.6,14,6,8,402.9318076494145,0.4367997198879552,0.15672042023289134,0.21794183587601842,128210.45769585497,3332.01429578992,131542.47199164488,190,6,106.37142857142857,31,4,17,36.60806119825147,0.6135752688172043,46.80989583333333,1012.7604166666661,32.669690860215034,8
192,4,1,1,34,0.02857142857142857,0.02857142857142857,0.9714285714285714,35,850,400,450,0.47058823529411764,13,4,9,398.2916145612268,0.4348389355742297,0.15346267506103062,0.21632265430076938,128375.34798516151,3226.164923773852,131601.51290893537,191,0,107.0,31,4,16,36.5563032678059,0.6152553763440862,46.64713541666666,1013.411458333332,32.69069220430103,0
193,4,1,1,34,0.02857142857142857,0.02857142857142857,0.9714285714285714,35,1150,900,250,0.782608695652174,14,9,5,398.9491461812725,0.4333683473389356,0.15796477495107664,0.2173379676957677,128496.33487654309,3252.7006172839365,131749.03549382702,192,0,107.97142857142858,32,3,16,36.415525114155244,0.6139322916666667,46.52777777777777,1013.8888888888879,31.684027777777747,0
194,4,3,2,35,0.08108108108108109,0.05405405405405406,0.9459459459459459,37,850,700,150,0.8235294117647058,10,7,3,387.6957593340396,0.43965840840840836,0.14984059847595055,0.2145015358026375,129110.63102324268,2611.128826530619,131721.75984977328,193,0,103.05405405405405,34,3,17,36.072146733825306,0.6155024509803921,45.92261904761905,1016.3095238095241,29.89145658263306,0
195,4,5,5,35,0.125,0.125,0.875,40,1000,700,300,0.7,13,7,6,361.7938545153005,0.4465144230769231,0.1440199977902994,0.20402468393881548,129860.54202428798,1396.5810974377778,131257.12312172574,194,0,96.2,36,4,16,35.966790041616036,0.618923611111111,45.18581081081082,1019.2567567567583,28.312687687687728,0
196,4,1,1,35,0.027777777777777776,0.027777777777777776,0.9722222222222222,36,700,400,300,0.5714285714285714,10,4,6,397.0706799247512,0.4383267195767196,0.17281420765027278,0.22019374068554395,129201.38888888893,3060.41666666667,132261.8055555556,195,0,107.83333333333333,32,4,17,35.74112021857923,0.62109375,45.833333333333336,1016.6666666666671,31.770833333333346,0
197,4,0,0,35,0.0,0.0,1.0,35,1100,900,200,0.8181818181818182,13,9,4,405.4689599570009,0.4356792717086835,0.1789227166276346,0.22485096870342763,129201.38888888883,3477.4305555555457,132678.81944444438,196,2,111.91428571428571,31,4,17,35.52766393442623,0.6236559139784946,45.83333333333333,1016.6666666666662,32.79569892473117,0
198,4,0,0,35,0.0,0.0,1.0,35,700,400,300,0.5714285714285714,10,4,6,406.28282677403854,0.4355392156862745,0.1819824102686003,0.22625001607879985,129366.91496107308,3511.9111802842826,132878.82614135736,197,3,112.91428571428571,31,4,17,35.33760505994283,0.6253360215053764,45.670572916666664,1017.3177083333329,32.81670026881719,0
199,4,1,2,34,0.027777777777777776,0.05555555555555555,0.9444444444444444,36,1100,800,300,0.7272727272727273,14,8,6,397.04416495084683,0.43786375661375665,0.1709547427154372,0.2225268374099084,129618.91842987973,3092.887045964715,132711.80547584445,198,0,110.75,32,4,16,35.315147757801206,0.6253255208333333,45.42297979797981,1018.3080808080819,31.822127525252558,0
200,4,1,1,34,0.02857142857142857,0.02857142857142857,0.9714285714285714,35,750,500,250,0.6666666666666666,10,5,5,405.2250985295082,0.4373949579831933,0.17260519247985662,0.22680422658569976,129565.68611992737,3500.653584798187,133066.33970472554,199,0,109.31428571428572,31,4,16,35.161279149081295,0.6273521505376343,45.47526041666667,1018.0989583333339,32.84190188172045,0
201,4,1,1,34,0.02857142857142857,0.02857142857142857,0.9714285714285714,35,650,400,250,0.6153846153846154,9,4,5,405.01002803081417,0.43606442577030813,0.17428534896889358,0.22706691248953398,129631.97708129884,3500.450134277344,133132.4272155762,200,0,110.28571428571429,31,4,16,35.099012274645176,0.6280241935483871,45.41015625,1018.3593750000001,32.85030241935484,0
202,4,0,0,34,0.0,0.0,1.0,34,900,800,100,0.8888888888888888,10,8,2,413.6547215262366,0.4341391859774213,0.1820780068034611,0.23139001926438066,129543.23657359225,3917.234290091331,133460.4708636836,201,7,114.52941176470588,30,4,16,34.969687967608486,0.6298611111111112,45.497311827956985,1018.0107526881715,33.93369175627238,0
203,4,0,0,34,0.0,0.0,1.0,34,550,100,450,0.18181818181818182,10,1,9,414.95179018051795,0.43358214497920383,0.1893595875520222,0.23252032266328423,129611.66030754999,3956.5180945774073,133568.1784021274,202,8,115.52941176470588,30,4,16,34.86668426610349,0.6305555555555555,45.43010752688172,1018.279569892473,33.9426523297491,0
204,4,1,1,34,0.02857142857142857,0.02857142857142857,0.9714285714285714,35,1000,600,400,0.6,14,6,8,404.7230917353512,0.435609243697479,0.17562542196595055,0.22844823974016334,129897.3104688857,3514.4882202148497,133411.79868910054,203,0,113.2,31,4,16,34.83536105079405,0.6307123655913978,45.149739583333336,1019.4010416666672,32.88390456989249,0
205,4,0,0,34,0.0,0.0,1.0,34,1200,900,300,0.75,15,9,6,413.4444987256678,0.43233808674985147,0.18980131654092425,0.2331731654196347,129864.12896050353,3938.321940104178,133802.4509006077,204,10,117.52941176470588,31,3,17,34.64699369783682,0.6303763440860215,45.18229166666667,1019.2708333333338,32.879704301075286,0
206,4,1,0,35,0.02857142857142857,0.0,1.0,35,1100,700,400,0.6363636363636364,15,7,8,406.9539602046125,0.43392857142857144,0.20461863480731468,0.23266376558636864,130395.54172092004,3613.6067708333258,134009.14849175335,205,0,115.14285714285714,31,4,18,34.27035526092131,0.635752688172043,44.66145833333333,1021.3541666666658,32.94690860215051,0
207,4,2,1,36,0.05405405405405406,0.02702702702702703,0.972972972972973,37,1650,1300,350,0.7878787878787878,20,13,7,387.45680825746473,0.4381256256256256,0.18806697088377078,0.2256429649203926,131108.39468293457,2759.768027921962,133868.16271085653,206,0,109.86486486486487,33,4,18,34.04418950181484,0.6379419191919191,43.96446078431373,1024.1421568627459,31.034610814022603,0
208,4,1,0,37,0.02702702702702703,0.0,1.0,37,1250,800,450,0.64,17,8,9,390.1222725591717,0.4364677177177177,0.1857328482328484,0.2205038931856188,129950.01922337565,2739.2793637062728,132689.29858708192,207,0,110.83783783783784,33,4,19,35.153745993589745,0.6262626262626263,45.09803921568628,1019.6078431372551,30.89720736779561,2
209,4,0,0,37,0.0,0.0,1.0,37,800,700,100,0.875,9,7,2,389.0582342048874,0.4369994994994995,0.1886144224243469,0.22043101996509706,130043.75007509121,2718.918354719326,132762.66842981055,208,1,111.83783783783784,33,4,19,35.085380872281625,0.627209595959596,45.00612745098039,1019.9754901960777,30.90834818775993,0
210,4,1,0,38,0.02631578947368421,0.0,1.0,38,750,500,250,0.6666666666666666,10,5,5,384.5751305647692,0.4394707207207207,0.18850440438228144,0.22000231388176716,130419.01139285348,2431.365640618967,132850.37703347244,209,0,109.86842105263158,33,5,21,34.81791141771646,0.6309974747474748,44.63848039215685,1021.4460784313708,30.952911467617298,0
211,4,1,0,39,0.02564102564102564,0.0,1.0,39,1050,700,350,0.6666666666666666,14,7,7,376.4044265313504,0.4413236617183986,0.18104461669739802,0.21768638234255905,130840.48327664407,2049.787414965997,132890.27069161006,210,0,108.02564102564102,34,5,19,34.59875106663564,0.6329656862745097,44.22619047619048,1023.0952380952388,30.091036414565846,0
212,4,0,0,39,0.0,0.0,1.0,39,800,600,200,0.75,10,6,4,377.03436424940503,0.44129554655870445,0.1788339999343842,0.2185680667196315,130931.84700963723,2073.161139455791,133005.00814909302,211,1,109.02564102564102,34,5,20,34.48998681710675,0.6338848039215685,44.136904761904766,1023.4523809523813,30.10154061624651,0
213,4,0,1,38,0.0,0.02564102564102564,0.9743589743589743,39,700,500,200,0.7142857142857143,9,5,4,373.7603881140504,0.44062078272604593,0.1796571455834164,0.21701320576588254,130992.77388038555,1991.982001133793,132984.75588151935,212,2,110.02564102564102,34,5,20,34.512007210140716,0.6344975490196079,44.077380952380956,1023.6904761904767,30.108543417366963,0
214,4,0,0,38,0.0,0.0,1.0,38,1050,900,150,0.8571428571428571,12,9,3,386.4227473197318,0.4394707207207207,0.18956823195713812,0.22376074480719554,130888.84833958093,2515.6856737793155,133404.53401336024,213,3,113.78947368421052,33,5,20,34.293413173652695,0.6357323232323232,44.17892156862745,1023.2843137254903,31.0086155674391,0
215,4,0,0,38,0.0,0.0,1.0,38,650,200,450,0.3076923076923077,11,2,9,388.9625573150742,0.43877430061640593,0.19791804466282414,0.22615046390866003,131045.64838343431,2594.3701040465294,133640.01848748085,214,4,114.78947368421052,33,5,20,34.06929483343308,0.637310606060606,44.02573529411765,1023.8970588235298,31.027183600713027,0
216,4,0,1,37,0.0,0.02631578947368421,0.9736842105263158,38,600,200,400,0.3333333333333333,10,2,8,389.4430782235981,0.438107515410147,0.20241146722256143,0.22679970764561758,131108.3946829346,2611.851361255308,133720.2460441899,215,5,115.78947368421052,33,5,21,33.99333393163418,0.6379419191919191,43.96446078431374,1024.1421568627463,31.034610814022617,0
217,4,0,0,37,0.0,0.0,1.0,37,850,600,250,0.7058823529411765,11,6,5,397.2466480790714,0.43809434434434436,0.19366425974735657,0.23130420406097285,131101.73906042767,3015.945279818405,134117.68434024608,209,6,114.10810810810811,32,5,21,33.80029178481898,0.6402994791666665,43.970959595959606,1024.1161616161628,32.00363005050509,0
218,4,0,0,37,0.0,0.0,1.0,37,800,500,300,0.625,11,5,6,397.2309267882775,0.4377502502502502,0.19550615704461838,0.2314897469904102,131134.06795224987,3018.101469237842,134152.16942148772,210,7,115.10810810810811,32,5,21,33.76787475345168,0.640625,43.939393939393945,1024.242424242425,32.00757575757578,0
219,4,0,0,37,0.0,0.0,1.0,37,1100,700,400,0.6363636363636364,15,7,8,398.1609367474785,0.4373435935935936,0.1952314651353353,0.2324228662423771,131198.73769258242,3047.6424599530724,134246.38015253548,211,8,116.10810810810811,32,5,21,33.67841590666339,0.6412760416666666,43.87626262626263,1024.4949494949499,32.015467171717184,0
220,4,1,2,36,0.02631578947368421,0.05263157894736842,0.9473684210526316,38,1100,700,400,0.6363636363636364,15,7,8,388.8858676776501,0.4382408724513988,0.18408473382308554,0.22852506606225964,131453.76778162253,2624.1025086505283,134077.87029027307,212,0,114.02631578947368,33,5,21,33.65748486297004,0.6414141414141414,43.62745098039216,1025.490196078432,31.075460487225214,0
221,4,0,0,36,0.0,0.0,1.0,36,1000,800,200,0.8,12,8,4,406.74949581154607,0.43822751322751324,0.19091396938371963,0.2374113525997957,131194.69536675356,3472.675238715282,134667.37060546884,213,10,118.33333333333333,31,5,21,33.46254872055583,0.6438172043010753,43.880208333333336,1024.4791666666672,33.04771505376346,0
222,4,0,0,36,0.0,0.0,1.0,36,900,600,300,0.6666666666666666,12,6,6,406.29067016362956,0.43831018518518516,0.18885994267237116,0.23734976121140317,131228.04641723633,3463.3461846245655,134691.3926018609,214,11,119.33333333333333,31,5,22,33.44042550938281,0.6441532258064516,43.84765625,1024.609375,33.05191532258065,0
223,4,1,1,36,0.02702702702702703,0.02702702702702703,0.972972972972973,37,900,600,300,0.6666666666666666,12,6,6,396.7486485207101,0.43987737737737737,0.18186777546777577,0.23376234729737275,131554.70623214473,3038.8303808284945,134593.53661297323,215,0,117.08108108108108,32,5,15,33.35358974358975,0.6448567708333333,43.52904040404041,1025.8838383838388,32.05886994949496,0
224,4,1,1,36,0.02702702702702703,0.02702702702702703,0.972972972972973,37,800,600,200,0.75,10,6,4,392.17776607071164,0.4413788788788789,0.15715619650360546,0.22453254518993476,130450.30757400989,2834.636281906113,133284.943855916,216,0,118.05405405405405,33,4,20,34.59193058221369,0.6313131313131313,44.607843137254896,1021.5686274509795,30.956625074272107,4
225,4,0,1,35,0.0,0.027777777777777776,0.9722222222222222,36,1250,900,350,0.72,16,9,7,397.37502043289845,0.43900462962962966,0.16758332303382395,0.22754149259183157,130455.99819214873,3167.9909894398515,133623.98918158858,217,1,121.97222222222223,32,4,20,34.45340501792115,0.6337890625,44.60227272727273,1021.5909090909089,31.924715909090903,0
226,4,0,1,34,0.0,0.02857142857142857,0.9714285714285714,35,900,700,200,0.7777777777777778,11,7,4,401.6194175316969,0.43651960784313726,0.17249527577132984,0.2295900684391444,130391.51178770015,3473.552603050697,133865.06439075083,218,2,126.02857142857142,32,3,20,34.41067086990563,0.6331380208333335,44.665404040404034,1021.3383838383832,31.916824494949473,0
227,4,0,0,34,0.0,0.0,1.0,34,1350,1100,250,0.8148148148148148,16,11,5,403.41410343935394,0.43441770647653,0.1714037296875941,0.23143230144678714,130528.5644531249,3731.4127604166524,134259.97721354154,219,3,128.23529411764707,31,3,18,34.22528032619776,0.6370967741935485,44.53124999999999,1021.8749999999992,32.96370967741933,0
228,4,0,1,33,0.0,0.029411764705882353,0.9705882352941176,34,900,700,200,0.7777777777777778,11,7,4,406.0643549726413,0.43447341057635175,0.17586759649740458,0.23395622741013597,130694.93823581276,3814.1111585829053,134509.04939439567,220,4,129.23529411764707,31,3,18,33.98820514453075,0.63877688172043,44.368489583333336,1022.5260416666671,32.98471102150539,0
229,4,0,1,32,0.0,0.030303030303030304,0.9696969696969697,33,1250,900,350,0.72,16,9,7,416.0189714461794,0.430792297979798,0.18048696885997995,0.23871639546455098,130537.14889365812,4261.186083651276,134798.3349773094,221,22,134.03030303030303,30,3,18,33.89451532289887,0.6399305555555556,44.522849462365585,1021.9086021505367,34.063620071684554,0
230,4,0,1,31,0.0,0.03125,0.96875,32,550,200,350,0.36363636363636365,9,2,7,416.3026006911937,0.42909946236559143,0.1776475808572182,0.23951570203155972,130640.18419759507,4477.169687247081,135117.35388484216,222,23,135.03125,30,2,18,33.78226619335613,0.6409722222222223,44.42204301075269,1022.3118279569891,34.07706093189964,0
231,4,1,0,32,0.03125,0.0,1.0,32,750,400,350,0.5333333333333333,11,4,7,407.52878884235497,0.42846942204301075,0.15856981695690897,0.23765967248501146,131161.34855482305,4290.405103895395,135451.75365871846,223,0,129.40625,31,1,20,33.47646815812891,0.643481182795699,43.912760416666664,1024.3489583333328,33.04351478494622,0
232,4,0,0,32,0.0,0.0,1.0,32,700,400,300,0.5714285714285714,10,4,6,403.69027368280064,0.4279233870967742,0.1573613933697453,0.2366532780867228,131361.49300469283,4205.871412489145,135567.364417182,224,1,130.40625,31,1,21,33.371570557601935,0.645497311827957,43.717447916666664,1025.1302083333328,33.06871639784944,0
233,4,1,1,32,0.030303030303030304,0.030303030303030304,0.9696969696969697,33,550,500,50,0.9090909090909091,6,5,1,393.62019640332517,0.42960858585858586,0.14952378821441137,0.23211594455540055,131587.09092184465,3759.0673145597384,135346.1582364044,225,0,127.42424242424242,32,1,17,33.40101731068997,0.6451822916666667,43.49747474747475,1026.0101010101007,32.06281565656565,0
234,4,0,0,32,0.0,0.0,1.0,32,950,800,150,0.8421052631578947,11,8,3,405.0982199717771,0.42752436155913975,0.15688484002031533,0.23810101346997875,131461.62245008672,4250.973849826384,135712.5962999131,226,3,132.40625,31,1,21,33.233875063484,0.646505376344086,43.619791666666664,1025.5208333333328,33.08131720430106,0
235,4,1,1,32,0.030303030303030304,0.030303030303030304,0.9696969696969697,33,1150,900,250,0.782608695652174,14,9,5,396.1713967481689,0.4303977272727273,0.14953667996825515,0.2350154609593623,131813.89534550047,3844.179005968773,135658.07435146923,227,0,129.36363636363637,32,1,18,33.105864994466984,0.6474609375,43.27651515151515,1026.8939393939393,32.0904356060606,0
236,4,0,0,32,0.0,0.0,1.0,32,850,600,250,0.7058823529411765,11,6,5,407.6733414825596,0.4275873655913978,0.15780397691234316,0.24108694305378953,131695.40617201055,4337.74125840928,136033.14743041983,228,5,134.40625,31,1,18,32.930700029599556,0.6488575268817205,43.39192708333333,1026.432291666666,33.11071908602148,0
237,4,0,0,32,0.0,0.0,1.0,32,900,400,500,0.4444444444444444,14,4,10,412.6800541668474,0.42731434811827956,0.17088878326996193,0.24555396888208342,131929.3975830078,4488.926188151043,136418.32377115884,229,6,135.40625,31,1,19,32.564955640050705,0.6512096774193548,43.1640625,1027.34375,33.140120967741936,0
238,4,0,0,32,0.0,0.0,1.0,32,850,600,250,0.7058823529411765,11,6,5,413.721256789857,0.42599126344086025,0.1721144711842939,0.24726187148795775,132096.66146172423,4530.239359537766,136626.900821262,230,7,136.40625,31,1,19,32.36871965378931,0.6528897849462365,43.001302083333336,1027.994791666667,33.16112231182797,0
239,4,1,0,33,0.030303030303030304,0.0,1.0,33,1000,700,300,0.7,13,7,6,403.1190129130272,0.4262941919191919,0.16413020252142774,0.2430775906210993,132432.58794369284,4077.905471383632,136510.49341507646,231,0,133.24242424242425,30,3,20,32.30146034647864,0.6590277777777779,42.674731182795696,1029.3010752688167,34.31003584229389,0
240,4,0,0,33,0.0,0.0,1.0,33,600,300,300,0.5,9,3,6,402.94614743689857,0.424676452020202,0.16475863950743275,0.24409299034062842,132605.57804731742,4086.5813605618887,136692.1594078793,232,1,134.24242424242425,30,3,21,32.1311279307495,0.6607638888888889,42.506720430107514,1029.9731182795683,34.33243727598561,0
241,4,1,3,31,0.029411764705882353,0.08823529411764706,0.9117647058823529,34,950,800,150,0.8421052631578947,11,8,3,394.5434306782583,0.4264705882352941,0.1561667506659945,0.24163566931344604,133015.96297571674,3696.1148734822896,136712.07784919903,233,0,131.26470588235293,32,2,19,31.93364953080374,0.6595052083333334,42.108585858585855,1031.5656565656564,32.23642676767676,0
242,4,0,0,31,0.0,0.0,1.0,31,750,600,150,0.8,9,6,3,417.8980380514748,0.42002688172043007,0.15771575679037064,0.25367984011995404,132684.03742283944,4889.679783950606,137573.71720679005,234,11,137.7741935483871,29,2,20,31.66677900602139,0.6645114942528736,42.43055555555555,1030.2777777777771,35.526819923371626,0
243,4,0,0,31,0.0,0.0,1.0,31,1050,700,350,0.6666666666666666,14,7,7,419.30662560802114,0.41854838709677417,0.1567788875270557,0.2555085201365133,132827.17013888885,4939.062499999996,137766.23263888885,235,12,138.7741935483871,29,2,20,31.48578550255996,0.665948275862069,42.291666666666664,1030.833333333333,35.545977011494244,0
244,4,0,0,31,0.0,0.0,1.0,31,750,400,350,0.5333333333333333,11,4,7,417.141108050199,0.4176075268817205,0.15379602476376708,0.2549195660306771,132934.5703125,4890.494791666667,137825.06510416666,236,13,139.7741935483871,29,2,21,31.43308080808081,0.6670258620689655,42.1875,1031.25,35.560344827586206,0
245,4,0,0,31,0.0,0.0,1.0,31,800,500,300,0.625,11,5,6,413.1652537459665,0.41698028673835125,0.14871656944981426,0.2533112210666165,133055.88073765754,4794.813345473465,137850.694083131,237,14,140.7741935483871,30,1,21,31.413116640611435,0.6652777777777779,42.06989247311828,1031.720430107527,34.39068100358423,0
246,4,1,0,32,0.03125,0.0,1.0,32,1050,1000,50,0.9523809523809523,11,10,1,402.86259614021196,0.41710769489247307,0.1417274223894638,0.25001672876391307,133508.10426311736,4358.385026247426,137866.48928936478,238,0,137.34375,29,3,22,31.223261882363477,0.6727729885057471,41.63194444444445,1033.4722222222229,35.63697318007665,0
247,4,1,1,32,0.030303030303030304,0.030303030303030304,0.9696969696969697,33,700,300,400,0.42857142857142855,11,3,8,387.6404480152697,0.41785037878787884,0.12426225008006586,0.24297841331430325,133876.17323133687,3779.163953993065,137655.33718532993,239,0,134.15151515151516,31,2,17,31.246854554604926,0.6706989247311828,41.27604166666667,1034.895833333334,33.383736559139805,0
248,4,0,1,31,0.0,0.03125,0.96875,32,1150,800,350,0.6956521739130435,15,8,7,394.8277806769056,0.41530157930107525,0.13482398025461162,0.24710441102852193,133819.67026534854,4167.144684356569,137986.81494970512,240,2,139.34375,30,2,18,31.11766043128086,0.6729166666666666,41.33064516129032,1034.6774193548383,34.489247311827945,0
249,4,0,0,31,0.0,0.0,1.0,31,1050,700,350,0.6666666666666666,14,7,7,405.32711083689986,0.4138888888888889,0.14602298696343197,0.2524843290419652,133645.88978855938,4634.060476644702,138279.95026520407,241,18,144.7741935483871,30,1,22,31.020895619394256,0.6711805555555556,41.498655913978496,1034.005376344086,34.4668458781362,0
250,4,0,0,31,0.0,0.0,1.0,31,950,500,450,0.5263157894736842,14,5,9,407.74411961035406,0.412410394265233,0.1468477263490442,0.25542896475834925,133854.4399099605,4715.672151404757,138570.11206136525,242,19,145.7741935483871,30,1,18,30.748582066935107,0.6732638888888889,41.297043010752674,1034.8118279569876,34.49372759856625,0
251,4,0,0,31,0.0,0.0,1.0,31,1000,700,300,0.7,13,7,6,409.4519689921936,0.41182795698924735,0.1436241948048682,0.2572266774207075,133958.7759423054,4769.9369146722,138728.7128569776,243,20,146.7741935483871,30,1,19,30.599465506794775,0.6743055555555557,41.19623655913978,1035.2150537634402,34.507168458781344,0
252,4,0,0,31,0.0,0.0,1.0,31,400,100,300,0.25,7,1,6,407.17502687729456,0.41102150537634413,0.14040317347344655,0.2565235962460794,134063.15262241286,4717.433554457145,138780.58617687,244,21,147.7741935483871,30,1,20,30.553482587064686,0.6753472222222223,41.09543010752687,1035.6182795698912,34.52060931899637,0
253,4,0,1,30,0.0,0.03225806451612903,0.967741935483871,31,1150,900,250,0.782608695652174,14,9,5,410.7853243453278,0.4103942652329749,0.1480464810715587,0.25978212185218447,134202.38475907606,4825.674030234695,139028.05878931074,245,22,148.7741935483871,30,1,21,30.320080425476718,0.6767361111111112,40.96102150537634,1036.1559139784936,34.53853046594978,0
254,4,0,0,30,0.0,0.0,1.0,30,550,400,150,0.7272727272727273,7,4,3,418.242745285126,0.4094348659003832,0.15328330206378982,0.2649344113172841,134262.741126543,5230.883487654292,139493.6246141973,246,23,149.86666666666667,29,1,21,30.06622442598052,0.680316091954023,40.902777777777764,1036.3888888888873,35.73754789272025,0
255,4,0,0,30,0.0,0.0,1.0,30,1100,600,500,0.5454545454545454,16,6,10,417.9556121513059,0.40924329501915707,0.1509714591987139,0.2650129765068134,134298.7292631172,5226.1815200617175,139524.9107831789,247,24,150.86666666666667,29,1,21,30.037490508731974,0.6806752873563219,40.86805555555555,1036.527777777777,35.74233716475093,0
256,4,0,0,30,0.0,0.0,1.0,30,850,600,250,0.7058823529411765,11,6,5,415.09078139678326,0.4087883141762452,0.1443075274578085,0.26397510851008377,134406.72260802466,5158.19830246913,139564.9209104938,248,25,151.86666666666667,29,1,21,30.003236896151435,0.6817528735632185,40.763888888888886,1036.9444444444443,35.75670498084291,0
257,4,0,0,30,0.0,0.0,1.0,30,900,600,300,0.6666666666666666,12,6,6,416.3552743804741,0.40893199233716476,0.14638457418318174,0.26530214923834294,134478.7422839506,5198.186728395059,139676.92901234564,249,26,152.86666666666667,29,1,21,29.898120871273,0.6824712643678161,40.69444444444444,1037.222222222222,35.7662835249042,0
258,4,0,0,30,0.0,0.0,1.0,30,850,700,150,0.8235294117647058,10,7,3,417.2513346558925,0.4084530651340996,0.14631860776439054,0.26639892904953144,134550.78125000003,5228.298611111111,139779.07986111115,250,27,153.86666666666667,29,1,21,29.802543507362778,0.6831896551724138,40.625,1037.5000000000002,35.77586206896552,0
259,4,0,0,30,0.0,0.0,1.0,30,1050,700,350,0.6666666666666666,14,7,7,417.4571505211177,0.408213601532567,0.14678800856531038,0.2670582045114547,134622.83950617287,5239.853395061731,139862.6929012346,251,28,154.86666666666667,29,1,21,29.724861705924333,0.6839080459770115,40.55555555555556,1037.7777777777778,35.78544061302682,0
260,4,0,0,30,0.0,0.0,1.0,30,1150,600,550,0.5217391304347826,17,6,11,412.90395718949134,0.4073994252873563,0.14103798822899982,0.2651950158031474,134767.01388888882,5129.166666666662,139896.18055555547,252,29,155.86666666666667,29,1,21,29.698368111289454,0.6853448275862069,40.416666666666664,1038.3333333333328,35.804597701149405,0
261,4,0,0,30,0.0,0.0,1.0,30,850,700,150,0.8235294117647058,10,7,3,409.6202620445951,0.4064655172413793,0.13626153229041282,0.26387165717756483,134875.19531250003,5049.522569444444,139924.71788194447,253,30,156.86666666666667,29,1,17,29.67517382002941,0.6864224137931034,40.3125,1038.7500000000002,35.81896551724139,0
262,4,0,0,30,0.0,0.0,1.0,30,550,300,250,0.5454545454545454,8,3,5,408.81435412914,0.4066331417624521,0.13442929697941697,0.2641406733673771,134983.42013888893,5036.631944444449,140020.05208333337,254,31,157.86666666666667,29,1,17,29.58767709168672,0.6875,40.208333333333336,1039.166666666667,35.83333333333334,0
263,4,0,0,30,0.0,0.0,1.0,30,600,200,400,0.3333333333333333,10,2,8,408.4338994745885,0.4064655172413793,0.1316353887399464,0.25821329576952773,134190.77932098752,4961.612654320971,139152.3919753085,255,32,158.86666666666667,29,1,17,30.39264968722073,0.6795977011494254,40.972222222222214,1036.1111111111102,35.727969348658974,1
264,4,0,0,30,0.0,0.0,1.0,30,500,400,100,0.8,6,4,2,425.59341336708735,0.4064655172413793,0.1486635220125785,0.2506272323161736,131534.8595213319,5196.073968088794,136730.9334894207,256,33,159.86666666666667,30,0,19,32.633975366876314,0.65,43.54838709677419,1025.806451612903,34.19354838709676,5
265,4,1,0,31,0.03225806451612903,0.0,1.0,31,950,600,350,0.631578947368421,13,6,7,419.3844343299928,0.4085125448028674,0.15770246083182826,0.2504251682754131,132063.20020887576,4877.0501030815785,136940.25031195732,257,0,155.67741935483872,31,0,19,32.25709399543956,0.6525537634408602,43.03385416666666,1027.8645833333323,33.156922043010724,0
266,4,0,0,31,0.0,0.0,1.0,31,1000,900,100,0.9,11,9,2,416.50115202037426,0.407258064516129,0.1625068377952501,0.25047124073554,132331.0089111327,4823.203531901027,137154.21244303373,258,1,156.67741935483872,31,0,19,32.05992153885092,0.655241935483871,42.77343749999999,1028.906249999999,33.190524193548356,0
267,4,0,0,31,0.0,0.0,1.0,31,650,400,250,0.6153846153846154,9,4,5,414.2619986943808,0.40667562724014333,0.16159361072966094,0.24979672330721,132432.58794369284,4772.374668974778,137204.96261266762,259,2,157.67741935483872,30,1,19,32.01472316531732,0.6590277777777778,42.674731182795696,1029.3010752688167,34.31003584229389,0
268,4,0,0,31,0.0,0.0,1.0,31,1150,600,550,0.5217391304347826,17,6,11,410.43020403979375,0.4044354838709678,0.16062546813327372,0.2493152095221123,132709.42630650933,4693.591383396911,137403.01768990624,260,3,158.67741935483872,30,1,18,31.833474649969563,0.6618055555555555,42.40591397849462,1030.3763440860207,34.34587813620069,0
269,4,0,0,31,0.0,0.0,1.0,31,1250,900,350,0.72,16,9,7,403.19109288981747,0.4029569892473119,0.15071142655319747,0.24628041916008583,132917.24476818126,4518.20983639727,137435.45460457852,261,4,159.67741935483872,30,1,19,31.810208116093165,0.663888888888889,42.204301075268816,1031.1827956989243,34.372759856630815,0
270,4,0,0,31,0.0,0.0,1.0,31,800,600,200,0.75,10,6,4,404.8168574732889,0.4021057347670251,0.160092466113271,0.24796244063108472,133021.2149706613,4569.846044340382,137591.06101500167,262,5,160.67741935483872,30,1,19,31.66340933767645,0.6649305555555556,42.10349462365591,1031.586021505376,34.38620071684587,0
271,4,0,0,31,0.0,0.0,1.0,31,600,300,300,0.5,9,3,6,406.0162216909699,0.40138888888888885,0.16243309329546518,0.24939140401146137,133125.22582090422,4610.200239912138,137735.42606081636,263,6,161.67741935483872,30,1,19,31.527578796561603,0.6659722222222222,42.002688172043015,1031.9892473118284,34.39964157706095,0
272,4,0,0,31,0.0,0.0,1.0,31,1100,700,400,0.6363636363636364,15,7,8,406.6518147786458,0.40129928315412183,0.16772513440860237,0.2502472706330129,133194.58896982312,4632.7642646548775,137827.35323447798,264,7,162.67741935483872,30,1,19,31.441243489583332,0.6666666666666666,41.935483870967744,1032.2580645161293,34.40860215053764,0
273,4,1,1,31,0.03125,0.03125,0.96875,32,800,600,200,0.75,10,6,4,395.421436004162,0.4031207997311828,0.15221774193548354,0.24516129032258063,133472.2222222223,4155.555555555566,137627.77777777787,265,0,158.5625,31,1,19,31.451612903225794,0.6666666666666666,41.66666666666667,1033.3333333333342,33.33333333333336,0
274,4,0,0,31,0.0,0.0,1.0,31,1000,500,500,0.5,15,5,10,413.85344227420853,0.4007616487455197,0.1247195661170526,0.24814451336360432,132219.38898533946,4761.250964506169,136980.63994984564,266,9,164.67741935483872,29,2,19,32.24102520819267,0.6598419540229885,42.88194444444444,1028.472222222222,35.46455938697317,7
275,4,0,0,31,0.0,0.0,1.0,31,1150,800,350,0.6956521739130435,15,8,7,412.25493404567385,0.39991039426523295,0.12743829942904905,0.24765387643765668,132290.8203125,4707.508680555556,136998.32899305556,267,10,165.67741935483872,29,2,20,32.209818415012826,0.6605603448275862,42.8125,1028.75,35.474137931034484,0
276,4,0,0,31,0.0,0.0,1.0,31,850,500,350,0.5882352941176471,12,5,7,406.80915646795404,0.39749103942652325,0.12741369858245521,0.24601003964546606,132540.98186728402,4583.777006172851,137124.75887345686,268,11,166.67741935483872,29,2,22,32.09693372898121,0.6630747126436781,42.56944444444445,1029.7222222222229,35.507662835249064,0
277,4,1,1,31,0.03125,0.03125,0.96875,32,1050,700,350,0.6666666666666666,14,7,7,396.9443022632792,0.40081065188172044,0.11071172404799179,0.2415689610916527,132778.68106139434,4141.148181870731,136919.82924326506,269,0,162.4375,30,2,18,32.11099156668405,0.6624999999999999,42.33870967741935,1030.6451612903222,34.35483870967741,0
278,4,0,1,30,0.0,0.03225806451612903,0.967741935483871,31,550,300,250,0.5454545454545454,8,3,5,406.5559355723994,0.39762544802867383,0.1292671152148288,0.24655971988066144,132648.26630015444,4585.788001543226,137234.05430169767,270,13,168.67741935483872,29,2,18,31.995050784234415,0.6641522988505746,42.465277777777786,1030.1388888888898,35.522030651341026,0
279,4,0,0,30,0.0,0.0,1.0,30,400,300,100,0.75,5,3,2,406.5559355723994,0.395522030651341,0.11112758977124582,0.24655971988066144,132648.26630015444,4785.788001543226,137434.05430169767,271,14,167.03333333333333,29,1,18,31.995050784234415,0.6641522988505746,42.465277777777786,1030.1388888888898,35.522030651341026,0
280,4,0,0,30,0.0,0.0,1.0,30,600,400,200,0.6666666666666666,8,4,4,405.5477655640398,0.39530651340996165,0.10098831985624446,0.2466528213512439,132755.59413580253,4767.746913580254,137523.34104938278,272,15,168.03333333333333,29,1,18,31.91262353998204,0.6652298850574712,42.361111111111114,1030.5555555555559,35.53639846743296,0
281,4,0,0,30,0.0,0.0,1.0,30,750,500,250,0.6666666666666666,10,5,5,405.25589003567586,0.3950191570881226,0.09962274319590403,0.24694656944538465,132827.17013888885,4765.798611111106,137592.96874999994,273,16,169.03333333333333,29,1,19,31.847884667205605,0.665948275862069,42.291666666666664,1030.833333333333,35.545977011494244,0
282,4,0,0,30,0.0,0.0,1.0,30,800,500,300,0.625,11,5,6,404.0812162024285,0.39382183908045976,0.1005387205387207,0.24693852101259514,132934.57031249997,4743.272569444443,137677.8428819444,274,17,170.03333333333333,29,1,21,31.76978114478116,0.6670258620689655,42.1875,1031.2499999999998,35.5603448275862,0
283,4,0,0,30,0.0,0.0,1.0,30,850,600,250,0.7058823529411765,11,6,5,406.0695112498403,0.3933189655172414,0.10549273021001615,0.24886834402341695,133042.0138888889,4804.861111111117,137846.87500000003,275,18,171.03333333333333,29,1,21,31.61012385568122,0.6681034482758621,42.083333333333336,1031.6666666666667,35.57471264367816,0
284,4,0,0,30,0.0,0.0,1.0,30,800,400,400,0.5,12,4,8,408.4485097592154,0.39286398467432954,0.10696370081213269,0.250566802559968,133077.83805941363,4871.088927469142,137948.92698688275,276,19,172.03333333333333,29,1,21,31.51262507291246,0.6684626436781609,42.048611111111114,1031.8055555555559,35.579501915708825,0
285,4,0,0,30,0.0,0.0,1.0,30,1250,900,350,0.72,16,9,7,408.10463800573405,0.39140325670498083,0.10866290018832414,0.2515630082035344,133257.03124999985,4876.5624999999845,138133.59374999983,277,20,173.03333333333333,29,1,21,31.340799031477008,0.6702586206896552,41.87499999999999,1032.4999999999989,35.60344827586203,0
286,4,0,0,30,0.0,0.0,1.0,30,900,600,300,0.6666666666666666,12,6,6,404.24450622050074,0.39068486590038315,0.10243793134355128,0.2501473075930184,133400.47260802452,4785.281635802446,138185.75424382696,278,21,174.03333333333333,29,1,21,31.295935287263607,0.6716954022988506,41.7361111111111,1033.055555555554,35.622605363984626,0
287,4,0,0,30,0.0,0.0,1.0,30,1000,900,100,0.9,11,9,2,402.9006243496358,0.390110153256705,0.09919354838709671,0.249798387096774,133472.2222222221,4755.208333333314,138227.43055555542,279,22,175.03333333333333,29,1,21,31.258400537634397,0.6724137931034484,41.66666666666666,1033.3333333333323,35.632183908045945,0
288,4,0,0,30,0.0,0.0,1.0,30,400,200,200,0.5,6,2,4,402.862596140212,0.3898946360153257,0.09582493392465152,0.25001672876391295,133508.10426311716,4757.0842978394885,138265.18856095665,280,23,176.03333333333333,29,1,21,31.223261882363474,0.6727729885057472,41.631944444444436,1033.4722222222213,35.636973180076595,0
289,4,0,0,30,0.0,0.0,1.0,30,750,600,150,0.8,9,6,3,402.50480331878674,0.390205938697318,0.10290088638195027,0.2510092768435248,133687.58680555556,4761.979166666672,138449.56597222225,281,24,177.03333333333333,29,1,21,31.051907064195557,0.6745689655172414,41.458333333333336,1034.1666666666667,35.66091954022989,0
290,4,0,0,30,0.0,0.0,1.0,30,700,400,300,0.5714285714285714,10,4,6,403.45391756980075,0.3896072796934866,0.10408108470935673,0.25233654340700634,133795.33420138888,4796.050347222217,138591.3845486111,282,25,178.03333333333333,29,1,19,30.918999194522748,0.6756465517241379,41.354166666666664,1034.5833333333333,35.67528735632184,0
291,4,0,0,30,0.0,0.0,1.0,30,950,700,250,0.7368421052631579,12,7,5,403.1563494036218,0.3888888888888889,0.10618990115837024,0.25313599596505426,133939.06491126554,4799.676890432116,138738.74180169764,283,26,179.03333333333333,29,1,19,30.78220738852364,0.6770833333333333,41.215277777777786,1035.1388888888896,35.69444444444447,0
292,4,0,0,30,0.0,0.0,1.0,30,1150,900,250,0.782608695652174,14,9,5,401.2441000928867,0.3875478927203065,0.10774009027126086,0.2534191145294532,134154.8056520062,4765.764853395073,138920.5705054013,284,27,180.03333333333333,29,1,20,30.61500089377486,0.6792385057471264,41.00694444444445,1035.9722222222226,35.72318007662837,0
293,4,0,1,29,0.0,0.03333333333333333,0.9666666666666667,30,550,400,150,0.7272727272727273,7,4,3,401.2441000928867,0.38733237547892724,0.10774009027126086,0.2534191145294532,134154.8056520062,4765.764853395073,138920.5705054013,285,28,181.03333333333333,29,1,20,30.61500089377486,0.6792385057471264,41.00694444444445,1035.9722222222226,35.72318007662837,0
294,4,0,0,29,0.0,0.0,1.0,29,750,400,350,0.5333333333333333,11,4,7,408.7306637048388,0.3853653530377668,0.1216627853040615,0.25831348080417116,134178.37406278902,5168.563177103978,139346.937239893,286,29,184.55172413793105,28,1,20,30.397425229972722,0.6826636904761905,40.98419540229885,1036.0632183908046,37.0022577996716,0
295,4,0,0,29,0.0,0.0,1.0,29,550,500,50,0.9090909090909091,6,5,1,409.0224156509964,0.3852114121510673,0.12137816283206138,0.25876049663815665,134215.59155766948,5179.437095389093,139395.02865305857,287,30,185.55172413793105,28,1,20,30.352479663523745,0.6830357142857142,40.94827586206897,1036.2068965517244,37.00738916256159,0
296,4,0,0,29,0.0,0.0,1.0,29,400,200,200,0.5,6,2,4,406.9194414308759,0.3843390804597701,0.12412837240423413,0.258216690406664,134327.27500743163,5132.075942991148,139459.35095042278,288,31,186.55172413793105,28,1,21,30.294814044814036,0.6841517857142856,40.84051724137931,1036.6379310344828,37.02278325123153,0
297,4,0,0,29,0.0,0.0,1.0,29,650,500,150,0.7692307692307693,8,5,3,406.4305237147621,0.3840311986863711,0.12439020894153185,0.2584325189118447,134401.75644487378,5124.995252014786,139526.75169688856,289,32,187.55172413793105,28,1,21,30.23272597108678,0.6848958333333334,40.768678160919535,1036.9252873563214,37.033045977011476,0
298,4,0,0,29,0.0,0.0,1.0,29,750,500,250,0.6666666666666666,10,5,5,407.2698069868455,0.38254310344827586,0.1301589271818473,0.2605588853734263,134625.3246176839,5165.765994517099,139791.090612201,290,33,188.55172413793105,28,1,21,29.986674511975636,0.6871279761904763,40.553160919540225,1037.7873563218384,37.06383415435137,0
299,4,0,0,29,0.0,0.0,1.0,29,800,500,300,0.625,11,5,6,403.8285800828864,0.3817733990147783,0.12459795565820753,0.2591532255487509,134737.17837561094,5082.144685559502,139819.32306117043,291,34,189.55172413793105,28,1,21,29.963845834486577,0.6882440476190477,40.44540229885057,1038.218390804597,37.07922824302132,0
300,4,0,0,29,0.0,0.0,1.0,29,250,200,50,0.8,3,2,1,403.8285800828864,0.3817733990147783,0.12459795565820753,0.2591532255487509,134737.17837561094,5082.144685559502,139819.32306117043,292,35,190.55172413793105,28,1,21,29.963845834486577,0.6882440476190477,40.44540229885057,1038.218390804597,37.07922824302132,0
301,4,0,0,29,0.0,0.0,1.0,29,850,600,250,0.7058823529411765,11,6,5,406.09208256514245,0.3798234811165846,0.13357978142328397,0.2621203511363099,134947.3403742284,5160.209297839509,140107.54967206792,293,36,191.55172413793105,29,0,18,29.694531702535322,0.6871408045977011,40.24305555555556,1039.0277777777778,35.828544061302686,0
302,4,0,0,29,0.0,0.0,1.0,29,850,800,50,0.9411764705882353,9,8,1,406.38079392714627,0.3798747947454844,0.12994972512407443,0.2628303786479548,135019.5047260803,5173.866705246921,140193.37143132722,294,37,192.55172413793105,29,0,18,29.61476569112211,0.6878591954022988,40.173611111111114,1039.3055555555559,35.838122605364,0
303,4,0,0,29,0.0,0.0,1.0,29,750,600,150,0.8,9,6,3,408.97858387219037,0.3798234811165846,0.12989764802343617,0.26530447823806047,135127.78742283952,5252.874228395058,140380.66165123458,295,38,193.55172413793105,29,0,18,29.438841392822145,0.6889367816091954,40.06944444444444,1039.7222222222224,35.85249042145595,0
304,4,0,0,29,0.0,0.0,1.0,29,950,700,250,0.7368421052631579,12,7,5,409.7967003616043,0.37946428571428575,0.13262599469496017,0.26636785523504275,135200.0,5280.902777777778,140480.90277777778,296,39,194.55172413793105,29,0,18,29.345285790598304,0.6896551724137931,40.0,1040.0,35.86206896551724,0
305,4,0,0,29,0.0,0.0,1.0,29,950,600,350,0.631578947368421,13,6,7,414.87743833925856,0.37920771756978655,0.06410019239307396,0.26126065711634394,134046.91358024694,5322.608024691365,139369.52160493832,297,40,195.55172413793105,29,0,21,30.37039520743921,0.6781609195402298,41.111111111111114,1035.5555555555557,35.708812260536405,7
306,4,0,0,29,0.0,0.0,1.0,29,450,400,50,0.8888888888888888,5,4,1,415.6288373757703,0.3786945812807882,0.06020725724036202,0.2619902147346675,134082.87278163573,5345.741705246908,139428.61448688264,298,41,196.55172413793105,29,0,21,30.314776943364176,0.6785201149425288,41.076388888888886,1035.694444444444,35.71360153256703,0
307,4,0,0,29,0.0,0.0,1.0,29,850,600,250,0.7058823529411765,11,6,5,419.1074470455478,0.37751436781609193,0.056854950540815574,0.2649611487254055,134190.77932098752,5448.070987654304,139638.85030864182,299,42,197.55172413793105,29,0,21,30.11617515638963,0.6795977011494253,40.972222222222214,1036.1111111111102,35.727969348658974,0
308,4,0,0,29,0.0,0.0,1.0,29,600,400,200,0.6666666666666666,8,4,4,412.46148040215587,0.37782224958949095,0.039729027657515736,0.257468620666794,133723.49778163576,5231.158371913571,138954.65615354932,300,43,198.55172413793105,29,0,21,30.758331095295638,0.6749281609195403,41.42361111111111,1034.3055555555552,35.665708812260526,2
309,4,1,1,29,0.03333333333333333,0.03333333333333333,0.9666666666666667,30,800,600,200,0.75,10,6,4,403.6137906523021,0.3847461685823755,0.021592039800994778,0.2542799883054775,134063.1526224131,4821.947443346063,138885.10006575915,301,0,192.9,30,0,21,30.645684620376382,0.6753472222222222,41.09543010752689,1035.6182795698933,34.52060931899644,0
310,4,0,0,29,0.0,0.0,1.0,29,700,500,200,0.7142857142857143,9,5,4,416.4423454650979,0.3782840722495895,0.030813789402092118,0.26147807925453886,133939.06491126557,5355.5796682098935,139294.64457947545,302,45,200.55172413793105,29,0,21,30.438386108502165,0.6770833333333333,41.215277777777786,1035.1388888888898,35.69444444444448,0
311,4,0,0,29,0.0,0.0,1.0,29,1050,800,250,0.7619047619047619,13,8,5,415.2261570197444,0.3766933497536946,0.022464638994176056,0.2625073840141772,134190.77932098752,5343.904320987639,139534.68364197516,303,46,201.55172413793105,29,0,21,30.216711349419118,0.6795977011494253,40.972222222222214,1036.1111111111102,35.727969348658974,0
312,4,0,1,28,0.0,0.034482758620689655,0.9655172413793104,29,850,500,350,0.5882352941176471,12,5,7,418.6019738557821,0.37566707717569786,0.01968331123196232,0.26542281485859837,134298.72926311733,5443.542631172844,139742.27189429017,304,47,202.55172413793105,29,0,21,30.020741212202424,0.6806752873563218,40.86805555555556,1036.527777777778,35.742337164750964,0
313,4,0,0,28,0.0,0.0,1.0,28,550,500,50,0.9090909090909091,6,5,1,426.7601923133956,0.3734292328042328,0.024266700996216972,0.27025647648433054,134252.8142134034,5858.751362465328,140111.56557586874,305,48,204.14285714285714,28,0,21,29.85552705762742,0.683407738095238,40.912356321839084,1036.3505747126442,37.01252052545158,0
314,4,0,0,28,0.0,0.0,1.0,28,800,500,300,0.625,11,5,6,426.95239618316515,0.3723820546737213,0.026843876843876346,0.2709288952033015,134327.27500743174,5870.270387435606,140197.54539486734,306,49,205.14285714285714,28,0,22,29.77564102564102,0.6841517857142856,40.84051724137932,1036.6379310344837,37.02278325123156,0
315,4,0,0,28,0.0,0.0,1.0,28,300,200,100,0.6666666666666666,4,2,2,427.6380720868007,0.37296075837742504,0.03242884851363681,0.27219502683620167,134439.0049048751,5898.247374157741,140337.25227903284,307,50,206.14285714285714,28,0,22,29.64550429481851,0.6852678571428571,40.73275862068965,1037.068965517241,37.03817733990146,0
316,4,0,0,28,0.0,0.0,1.0,28,400,400,0,1.0,4,4,0,426.6060224835081,0.3722167107583774,0.03198508318990223,0.27237153743177844,134550.78125000003,5880.034722222225,140430.81597222225,308,51,207.14285714285714,28,0,22,29.559906291834,0.6863839285714286,40.625,1037.5000000000002,37.05357142857144,0
317,4,0,0,28,0.0,0.0,1.0,28,750,300,450,0.4,12,3,9,425.14975613465145,0.37196869488536155,0.0281007751937985,0.2722767587160216,134662.60404280623,5850.3546538512455,140512.95869665747,309,52,208.14285714285714,28,0,22,29.48533822443707,0.6875,40.51724137931035,1037.931034482759,37.068965517241395,0
318,4,0,0,28,0.0,0.0,1.0,28,950,700,250,0.7368421052631579,12,7,5,423.324574002742,0.37196869488536155,-0.014943713334390596,0.2667240847387907,134066.75254326867,5750.750181662052,139817.50272493073,310,53,209.14285714285714,28,0,21,30.131740196078432,0.6815476190476191,41.09195402298851,1035.6321839080465,36.98686371100166,3
319,4,0,0,28,0.0,0.0,1.0,28,550,300,250,0.5454545454545454,8,3,5,424.9418040491724,0.37205136684303347,-0.01422329231317998,0.26801447641211584,134103.95455558857,5797.275275796006,139901.22983138458,311,54,210.14285714285714,28,0,21,30.052422897304293,0.6819196428571428,41.05603448275862,1035.7758620689654,36.99199507389162,0
320,4,0,0,28,0.0,0.0,1.0,28,750,400,350,0.5333333333333333,11,4,7,425.51484876533794,0.3713624338624339,-0.012063227953411415,0.26919413063996644,134215.5915576695,5822.145428722424,140037.73698639194,312,55,211.14285714285714,28,0,21,29.92524034017377,0.6830357142857142,40.94827586206897,1036.2068965517246,37.007389162561594,0
321,4,0,0,28,0.0,0.0,1.0,28,800,500,300,0.625,11,5,6,427.0236945704181,0.3712522045855379,-0.012634163729256631,0.27069850023119457,134290.0420299906,5869.005978332655,140159.04800832327,313,56,212.14285714285714,28,0,21,29.81124665003234,0.6837797619047619,40.876436781609186,1036.4942528735621,37.017651888341504,0
322,4,0,0,28,0.0,0.0,1.0,28,550,400,150,0.7272727272727273,7,4,3,428.16168861018366,0.37174823633156967,-0.012056541019956013,0.27197312896224374,134364.51314572612,5905.947367551873,140270.460513278,314,57,213.14285714285714,28,0,21,29.70684358832225,0.6845238095238095,40.80459770114943,1036.7816091954032,37.02791461412154,0
323,4,0,0,28,0.0,0.0,1.0,28,450,200,250,0.4444444444444444,7,2,5,426.66954116509794,0.3708112874779541,-0.013775086094287792,0.27157854921778446,134439.00490487507,5872.205707491074,140311.21061236615,315,58,214.14285714285714,28,0,21,29.670615128844556,0.6852678571428571,40.73275862068965,1037.0689655172407,37.03817733990145,0
324,4,0,0,28,0.0,0.0,1.0,28,600,300,300,0.5,9,3,6,424.1649465550447,0.37020502645502645,-0.00745943806885685,0.27053629983457783,134513.51730743816,5811.183775928112,140324.70108336626,316,59,215.14285714285714,28,0,21,29.66066481994459,0.6860119047619048,40.66091954022988,1037.3563218390798,37.04844006568142,0
325,4,0,0,28,0.0,0.0,1.0,28,300,200,100,0.6666666666666666,4,2,2,424.1649465550447,0.37020502645502645,-0.00745943806885685,0.27053629983457783,134513.51730743816,5811.183775928112,140324.70108336626,317,60,216.14285714285714,28,0,21,29.66066481994459,0.6860119047619048,40.66091954022988,1037.3563218390798,37.04844006568142,0
326,4,0,0,28,0.0,0.0,1.0,28,550,400,150,0.7272727272727273,7,4,3,422.26201809127963,0.3697641093474427,-0.00831783835107025,0.2698740083765682,134588.05035341525,5766.284350640775,140354.33470405603,318,61,217.14285714285714,28,0,22,29.635142619772918,0.6867559523809523,40.589080459770116,1037.6436781609195,37.058702791461414,0
327,4,0,0,28,0.0,0.0,1.0,28,550,300,250,0.5454545454545454,8,3,5,419.48635672465605,0.37023258377425045,-0.0038704893722196765,0.26892537065977307,134699.88862878192,5700.953106420938,140400.84173520285,319,62,218.14285714285714,28,0,22,29.59486735870819,0.6878720238095237,40.481321839080465,1038.0747126436786,37.07409688013138,0
328,4,0,0,28,0.0,0.0,1.0,28,1100,900,200,0.8181818181818182,13,9,4,418.64652270160445,0.3698192239858906,-0.00028666323988790765,0.26866250204634023,134737.17837561094,5681.450241115059,140418.628616726,320,63,219.14285714285714,28,0,23,29.579239320970565,0.6882440476190477,40.44540229885057,1038.218390804597,37.07922824302132,0
329,4,0,0,28,0.0,0.0,1.0,28,900,500,400,0.5555555555555556,13,5,8,417.498790960209,0.36764219576719576,0.001575557618981538,0.26930720405292363,134923.70452255922,5666.0967020082035,140589.80122456743,321,64,220.14285714285714,28,0,20,29.421933342552894,0.6901041666666665,40.265804597701155,1038.9367816091963,37.10488505747129,0
330,4,0,0,28,0.0,0.0,1.0,28,750,600,150,0.8,9,6,3,421.1962027099892,0.36653990299823636,0.00415144634218545,0.2728159826863719,135073.01833548042,5778.448482296234,140851.46681777664,322,65,221.14285714285714,28,0,20,29.176169085464178,0.6915922619047619,40.12212643678162,1039.5114942528749,37.12541050903125,0
331,4,0,0,28,0.0,0.0,1.0,28,800,800,0,1.0,8,8,0,420.2315295658349,0.36640211640211645,0.002861879761575814,0.27303732594232627,135185.05788413275,5761.804729819014,140946.86261395176,323,66,222.14285714285714,28,0,20,29.08895182831354,0.6927083333333333,40.01436781609196,1039.942528735633,37.14080459770118,0
332,4,0,0,28,0.0,0.0,1.0,28,1050,800,250,0.7619047619047619,13,8,5,417.92756631360453,0.36546516754850084,-0.002002762430939331,0.27210391907468506,135259.776720835,5705.757861012033,140965.53458184705,324,67,223.14285714285714,28,0,20,29.074010128913454,0.6934523809523809,39.94252873563219,1040.2298850574716,37.15106732348113,0
333,4,0,0,28,0.0,0.0,1.0,28,1100,900,200,0.8181818181818182,13,9,4,415.0226638299372,0.3649415784832451,-0.008148476782017022,0.27162052388869884,135446.66412752678,5642.687070616995,141089.35119814376,325,68,224.14285714285714,28,0,22,28.962502875546352,0.6953125,39.76293103448276,1040.9482758620693,37.176724137931046,0
334,4,0,0,28,0.0,0.0,1.0,28,1000,600,400,0.6,14,6,8,413.1200000000002,0.3657958553791887,-0.012285714285714011,0.2717894736842106,135633.68055555556,5606.597222222226,141240.27777777778,326,69,225.14285714285714,28,0,23,28.82500000000001,0.6971726190476191,39.583333333333336,1041.6666666666667,37.202380952380956,0
335,4,0,0,28,0.0,0.0,1.0,28,950,600,350,0.631578947368421,13,6,7,426.31640941705496,0.36541005291005296,-0.008590386666140315,0.2758473082042015,135035.68214096958,5913.5854307041645,140949.26757167376,327,70,226.14285714285714,28,0,17,29.080557091512294,0.6912202380952381,40.15804597701148,1039.3678160919528,37.12027914614117,5
336,4,0,0,28,0.0,0.0,1.0,28,600,200,400,0.3333333333333333,10,2,8,427.3107315214361,0.365354938271605,-0.008588012319355576,0.27706276463164053,135110.35969084408,5946.821327123775,141057.18101796784,328,71,227.14285714285714,28,0,17,28.979811590197155,0.6919642857142858,40.086206896551715,1039.6551724137921,37.130541871921146,0
337,4,0,0,28,0.0,0.0,1.0,28,650,500,150,0.7692307692307693,8,5,3,433.2760832862805,0.365354938271605,-0.041266966524698745,0.264911049900249,132953.09197053776,5921.078989959045,138874.17096049682,329,72,228.14285714285714,28,0,19,30.99836305377542,0.6703869047619048,42.16954022988506,1031.32183908046,36.832922824302145,3
338,4,0,0,28,0.0,0.0,1.0,28,600,300,300,0.5,9,3,6,439.3845708613758,0.365354938271605,-0.034872534872535166,0.2558768971486836,131107.31272294896,5921.306067512232,137028.6187904612,330,73,229.14285714285714,28,0,18,32.71575710811821,0.6517857142857142,43.96551724137932,1024.1379310344835,36.57635467980298,3
339,4,1,0,29,0.034482758620689655,0.0,1.0,29,1150,900,250,0.782608695652174,14,9,5,435.036935220621,0.3745894909688013,0.005356362559964856,0.24540630803875021,129872.97694830265,5499.9083719136015,135372.88532021624,331,0,222.20689655172413,29,0,17,34.087721987555064,0.6361350574712643,45.17361111111112,1019.3055555555569,35.14846743295024,5
340,4,2,2,29,0.06451612903225806,0.06451612903225806,0.935483870967742,31,850,500,350,0.5882352941176471,12,5,7,408.3144044321332,0.38284050179211465,-0.011332767402376431,0.23367390615091957,130434.1542374841,4452.212327252029,134886.36656473612,332,0,208.80645161290323,30,1,17,34.196271929824555,0.6388888888888888,44.623655913978496,1021.505376344086,34.05017921146953,0
341,4,2,2,29,0.06451612903225806,0.06451612903225806,0.935483870967742,31,450,300,150,0.6666666666666666,6,3,3,406.04165807691106,0.3878584229390681,-0.004344063396175102,0.23319794320368847,130571.48947855257,4403.4928170887015,134974.98229564127,333,0,209.74193548387098,30,1,16,34.11444634402946,0.6402777777777777,44.48924731182797,1022.0430107526893,34.068100358422974,0
342,4,2,1,30,0.06451612903225806,0.03225806451612903,0.967741935483871,31,900,700,200,0.7777777777777778,11,7,4,406.3603956184746,0.3850806451612903,-0.0008228881678014055,0.2335881185698036,130605.8345798648,4414.607721990993,135020.44230185577,334,0,210.67741935483872,30,1,17,34.071334648257725,0.640625,44.45564516129033,1022.1774193548393,34.07258064516131,0
343,4,1,1,30,0.03225806451612903,0.03225806451612903,0.967741935483871,31,850,600,250,0.7058823529411765,11,6,5,406.19511092488733,0.3854390681003584,0.005104311956554142,0.23432438203392486,130743.26014929482,4421.454611804848,135164.71476109966,335,0,211.6451612903226,30,1,17,33.93569019143996,0.6420138888888889,44.32123655913979,1022.7150537634416,34.09050179211472,0
344,4,2,2,30,0.0625,0.0625,0.9375,32,800,600,200,0.75,10,6,4,383.45679012345664,0.39054099462365593,0.028518518518518388,0.22122507122507118,130746.38429752071,3627.1177685950456,134373.50206611576,336,0,205.96875,32,0,18,34.51388888888889,0.63671875,44.31818181818182,1022.7272727272731,31.960227272727284,3
345,4,1,0,31,0.03225806451612903,0.0,1.0,31,650,500,150,0.7692307692307693,8,5,3,392.8412858619448,0.38476702508960575,0.04914888811318052,0.22672801619732375,130761.5174187554,4073.704528808589,134835.221947564,337,0,213.58064516129033,31,0,19,34.258566730320396,0.6394489247311828,44.303385416666664,1022.786458333333,32.99311155913978,0
346,4,0,0,31,0.0,0.0,1.0,31,350,300,50,0.8571428571428571,4,3,1,389.2393638901345,0.38476702508960575,0.06751976566669526,0.213875921088892,128837.60452270509,3829.733445909289,132667.3379686144,338,1,214.58064516129033,31,0,18,36.312176691890045,0.6199596774193548,46.19140625,1015.2343750000001,32.749495967741936,4
347,4,3,3,31,0.08823529411764706,0.08823529411764706,0.9117647058823529,34,750,400,350,0.5333333333333333,11,4,7,359.2091023975109,0.40261066547831253,0.05703595675844042,0.20125882884834212,129606.62853529875,2511.689005041043,132118.31754033978,339,0,196.55882352941177,33,1,16,36.290844265254535,0.6227904040404042,45.43504901960783,1018.2598039215673,30.856357694592948,0
348,4,1,0,32,0.03125,0.0,1.0,32,550,300,250,0.5454545454545454,8,3,5,394.908458212597,0.38923891129032256,0.1112372122762153,0.22121662917066656,129598.82948133671,3835.934787326378,133434.7642686631,340,0,209.8125,31,1,17,35.39002557544757,0.6276881720430108,45.44270833333333,1018.2291666666658,32.84610215053761,0
349,4,2,1,33,0.058823529411764705,0.029411764705882353,0.9705882352941176,34,750,600,150,0.8,9,6,3,382.6414323034178,0.40106951871657753,0.10431146522009382,0.21766651968735393,130200.04325259503,3163.986207227972,133364.029459823,341,0,198.41176470588235,33,1,18,35.089957572846615,0.6287878787878789,44.85294117647058,1020.5882352941167,30.92691622103384,0
350,4,1,0,34,0.029411764705882353,0.0,1.0,34,950,600,350,0.631578947368421,13,6,7,382.86174527797965,0.3985071301247772,0.13098396748334662,0.21919886735145852,130450.30757400989,3188.886485966924,133639.1940599768,342,0,199.38235294117646,33,1,19,34.8298544465771,0.6313131313131313,44.607843137254896,1021.5686274509795,30.956625074272107,0
351,4,3,1,36,0.08108108108108109,0.02702702702702703,0.972972972972973,37,500,400,100,0.8,6,4,2,363.55544433681314,0.4086586586586587,0.14030053792665065,0.21245927989856536,131241.56832085463,2142.7173372697025,133384.28565812434,343,0,184.13513513513513,36,1,20,34.52142176795985,0.6328125,43.83445945945946,1024.662162162162,28.462837837837835,0
352,4,0,0,36,0.0,0.0,1.0,36,750,400,350,0.5333333333333333,11,4,7,372.46768170066076,0.4054232804232804,0.15018832391713777,0.21715013063576066,131150.23389274688,2569.844714506165,133720.07860725303,344,1,190.25,35,1,21,34.38559322033897,0.6339285714285714,43.92361111111111,1024.3055555555552,29.265873015873005,0
353,4,0,0,36,0.0,0.0,1.0,36,500,200,300,0.4,8,2,6,374.48883267730105,0.40532407407407406,0.15289702264397276,0.21866590678492528,131209.51753257882,2627.2998113854583,133836.81734396427,345,2,191.25,35,1,21,34.273798764874236,0.6345238095238095,43.86574074074074,1024.5370370370367,29.272486772486765,0
354,4,0,0,36,0.0,0.0,1.0,36,1350,1100,250,0.8148148148148148,16,11,5,378.32897067622974,0.4044808201058201,0.15814413378768544,0.2217799937126577,131360.4817907611,2739.6559237152587,134100.13771447638,346,3,192.25,32,4,21,34.02256024962022,0.6429036458333334,43.71843434343434,1025.1262626262624,32.0351957070707,0
355,4,0,0,36,0.0,0.0,1.0,36,1350,1000,350,0.7407407407407407,17,10,7,378.93286627218896,0.4040839947089947,0.15962735042734977,0.22326537624811735,131554.7062321448,2770.0803808284954,134324.7866129733,347,4,193.25,32,4,18,33.810512820512805,0.6448567708333333,43.52904040404041,1025.8838383838392,32.05886994949498,0
356,4,0,0,36,0.0,0.0,1.0,36,1350,1000,350,0.7407407407407407,17,10,7,383.8307286239687,0.4033895502645503,0.16167071116945841,0.22760917729230223,131799.59518274205,2917.7469302671875,134717.34211300925,348,5,194.25,33,3,19,33.43713947567332,0.6448863636363638,43.29044117647058,1026.8382352941164,31.11631016042777,0
357,4,0,0,36,0.0,0.0,1.0,36,900,600,300,0.6666666666666666,12,6,6,384.00100250055533,0.4034060846560847,0.15974542561654737,0.227898611965627,131831.05656478275,2924.651576316798,134755.70814109955,349,6,195.25,33,3,19,33.400954653937944,0.6452020202020202,43.259803921568626,1026.9607843137253,31.120023767082586,0
358,4,0,0,36,0.0,0.0,1.0,36,800,600,200,0.75,10,6,4,385.3593231801825,0.40424933862433865,0.15440601603392246,0.22965443673531144,131988.4197934689,2972.593623846602,134961.0134173155,350,7,196.25,33,3,19,33.2069916517591,0.646780303030303,43.106617647058826,1027.573529411765,31.13859180035652,0
359,4,0,1,35,0.0,0.027777777777777776,0.9722222222222222,36,1050,600,450,0.5714285714285714,15,6,9,386.13708072354734,0.4041335978835979,0.14929810621109807,0.23107632719476173,132145.8768862936,3005.2846261053296,135151.16151239895,351,8,197.25,33,3,19,33.02791021056813,0.6483585858585859,42.95343137254901,1028.1862745098028,31.157159833630388,0
360,4,0,0,35,0.0,0.0,1.0,35,1300,900,400,0.6923076923076923,17,9,8,391.56655062226343,0.39859943977591034,0.15927022703291493,0.23510798468692978,132271.9101427335,3358.6511197616255,135630.56126249515,352,9,203.65714285714284,33,2,19,32.760999920578186,0.6496212121212122,42.830882352941174,1028.676470588235,31.172014260249544,0
361,4,0,0,35,0.0,0.0,1.0,35,950,800,150,0.8421052631578947,11,8,3,392.24989962097675,0.3985644257703081,0.16361532702647508,0.235911902379493,132334.9492983469,3381.6741157247293,135716.62341407163,353,10,204.65714285714284,33,2,20,32.67974829283786,0.6502525252525253,42.76960784313726,1028.9215686274517,31.179441473559145,0
362,4,0,0,35,0.0,0.0,1.0,35,800,600,200,0.75,10,6,4,392.23721090330923,0.3983893557422969,0.15986119144013866,0.23629900266614018,132398.00347222236,3386.299740484449,135784.3032127068,354,11,205.65714285714284,32,3,21,32.61639676113361,0.6533203125,42.70833333333334,1029.1666666666679,32.16145833333337,0
363,4,0,0,35,0.0,0.0,1.0,35,1100,700,400,0.6363636363636364,15,7,8,390.9347705672423,0.398984593837535,0.1578051087984862,0.23612460142261488,132495.48037190113,3359.4180440771715,135854.8984159783,355,12,206.65714285714284,32,3,22,32.551508462104486,0.6542968749999998,42.61363636363638,1029.545454545457,32.17329545454553,0
364,4,1,1,35,0.027777777777777776,0.027777777777777776,0.9722222222222222,36,950,700,250,0.7368421052631579,12,7,5,380.36410524283,0.401223544973545,0.14619106285772943,0.23158877800228017,132796.49234693887,2902.203798185952,135698.69614512482,356,0,201.88888888888889,34,2,20,32.52026064526064,0.6525735294117647,42.32142857142858,1030.7142857142865,30.31512605042019,0
365,4,0,1,34,0.0,0.02857142857142857,0.9714285714285714,35,1300,900,400,0.6923076923076923,17,9,8,388.84333038740994,0.3986344537815126,0.1511441822537074,0.23642686661082665,132745.06987997412,3323.407012927727,136068.47689290185,357,14,208.65714285714284,33,2,21,32.35360427319935,0.6543560606060606,42.37132352941177,1030.5147058823536,31.22771836007132,0
366,4,0,0,34,0.0,0.0,1.0,34,800,400,400,0.5,12,4,8,396.17555815491016,0.3970959595959596,0.16299349928650675,0.2409526755335602,132755.59413580256,3718.904320987662,136474.49845679023,358,15,212.85294117647058,32,2,22,32.15408805031447,0.6569010416666666,42.361111111111114,1030.555555555556,32.20486111111113,0
367,4,0,0,34,0.0,0.0,1.0,34,650,300,350,0.46153846153846156,10,3,7,397.5633812929832,0.39666889483065954,0.16503868262955446,0.24263845826894626,132885.74667125806,3766.1013544536277,136651.8480257117,359,16,213.85294117647058,32,2,22,31.987049963262294,0.658203125,42.234848484848484,1031.0606060606062,32.220643939393945,0
368,4,0,0,34,0.0,0.0,1.0,34,1000,600,400,0.6,14,6,8,392.53895860523045,0.3961675579322638,0.1625910004104476,0.24019855826562747,132983.402921258,3640.2332988980743,136623.63622015607,360,17,214.85294117647058,32,2,22,32.01814787611704,0.6591796875,42.140151515151516,1031.4393939393938,32.232481060606055,0
369,4,0,0,34,0.0,0.0,1.0,34,950,600,350,0.631578947368421,13,6,7,390.06244713330415,0.39577762923351156,0.16271103498898976,0.23972710096749084,133146.24304917868,3587.069878073665,136733.31292725235,361,18,215.85294117647058,32,2,22,31.918022591958245,0.6608072916666667,41.98232323232323,1032.0707070707072,32.2522095959596,0
370,4,0,0,34,0.0,0.0,1.0,34,650,300,350,0.46153846153846156,10,3,7,385.63568090786777,0.3950906120023767,0.16248725932338304,0.2378745422642528,133282.33882401,3479.68509707805,136762.02392108802,362,19,216.85294117647058,33,1,22,31.895323997151674,0.6597222222222222,41.85049019607843,1032.5980392156864,31.29084967320262,0
371,4,1,0,35,0.02857142857142857,0.0,1.0,35,1000,800,200,0.8,12,8,4,376.8214847263037,0.3986344537815126,0.15363664080761552,0.2340288955951138,133535.54672481734,3063.9477604767335,136599.49448529407,363,0,211.62857142857143,33,2,23,31.86852817959054,0.6622474747474747,41.60539215686274,1033.5784313725487,31.32055852644087,0
372,4,0,0,35,0.0,0.0,1.0,35,1100,800,300,0.7272727272727273,14,8,6,366.2444272976679,0.39905462184873947,0.031283068783068746,0.2197466563786008,132244.89795918373,2690.636058344914,134935.53401752864,364,1,212.62857142857143,34,1,20,33.43942901234567,0.6470588235294117,42.85714285714286,1028.5714285714291,30.25210084033615,7
373,4,0,0,35,0.0,0.0,1.0,35,700,500,200,0.7142857142857143,9,5,4,365.7865139924441,0.398844537815126,0.03413231064237787,0.21982802878461088,132306.12953514754,2679.159580498886,134985.28911564642,365,2,213.62857142857143,34,1,20,33.38950281570625,0.6476715686274509,42.79761904761906,1028.809523809525,30.25910364145662,0
374,4,0,0,35,0.0,0.0,1.0,35,1200,900,300,0.75,15,9,6,363.389008179121,0.3990896358543417,0.034239444765760574,0.21891971956156825,132398.00347222236,2622.3958333333517,135020.3993055557,366,3,214.62857142857143,34,1,21,33.35863697705805,0.6485906862745097,42.70833333333334,1029.1666666666679,30.26960784313729,0
375,4,0,0,35,0.0,0.0,1.0,35,1550,1500,50,0.967741935483871,16,15,1,361.28170002338857,0.3976890756302521,0.029793559042114115,0.21853753183232957,132551.19756235828,2577.664399092971,135128.86196145124,367,4,215.62857142857143,34,1,22,33.258670520231206,0.6501225490196079,42.55952380952381,1029.7619047619048,30.287114845938376,0
376,4,0,0,35,0.0,0.0,1.0,35,550,300,250,0.5454545454545454,8,3,5,363.9074789748745,0.39733893557422967,0.02662968099861307,0.2204851196141887,132612.5,2651.7361111111113,135264.23611111112,368,5,216.62857142857143,34,1,22,33.12938241639697,0.650735294117647,42.5,1030.0,30.294117647058822,0
377,4,0,0,35,0.0,0.0,1.0,35,800,400,400,0.5,12,4,8,363.54808587908434,0.39688375350140054,0.027164977384529276,0.22062728858328165,132673.8166099773,2646.662414965984,135320.47902494328,369,6,217.62857142857143,34,1,17,33.076949002388105,0.6513480392156863,42.44047619047619,1030.2380952380952,30.30112044817927,0
378,4,0,0,35,0.0,0.0,1.0,35,900,700,200,0.7777777777777778,11,7,4,365.4394631014653,0.3970238095238095,0.030241616054924814,0.22213792082909303,132735.1473922902,2701.3321995464826,135436.4795918367,370,7,218.62857142857143,34,1,17,32.96653573629081,0.6519607843137255,42.38095238095238,1030.4761904761904,30.308123249299715,0
379,4,0,0,35,0.0,0.0,1.0,35,700,400,300,0.5714285714285714,10,4,6,366.72602044119816,0.39681372549019606,0.032269450904712116,0.2238346767470908,132888.5363520408,2746.736819727885,135635.2731717687,371,8,219.62857142857143,34,1,18,32.77912481237731,0.6534926470588236,42.232142857142854,1031.0714285714284,30.325630252100837,0
380,4,0,0,35,0.0,0.0,1.0,35,950,700,250,0.7368421052631579,12,7,5,368.6868493096961,0.39586834733893556,0.036070439256034925,0.22558636034033944,132980.6122448979,2805.6405895691532,135786.25283446704,372,9,220.62857142857143,34,1,18,32.636003385657126,0.6544117647058822,42.14285714285714,1031.4285714285709,30.336134453781497,0
381,4,0,0,35,0.0,0.0,1.0,35,500,300,200,0.6,7,3,4,368.23296059753153,0.39551820728291315,0.03841398071057611,0.22549389424576752,133011.31129535142,2795.829790249425,135807.14108560086,373,10,221.62857142857143,34,1,18,32.61684939411424,0.654718137254902,42.113095238095234,1031.5476190476186,30.339635854341722,0
382,4,1,2,34,0.027777777777777776,0.05555555555555555,0.9444444444444444,36,850,500,350,0.5882352941176471,12,5,7,362.177607498952,0.3999007936507937,0.0377604653190351,0.22328862726317558,133263.00643272034,2452.9753675840166,135715.98180030435,374,0,216.44444444444446,35,1,18,32.5202938758734,0.6550595238095238,41.86921296296296,1032.523148148148,29.500661375661373,0
383,4,0,1,33,0.0,0.029411764705882353,0.9705882352941176,34,850,600,250,0.7058823529411765,11,6,5,381.24004560974566,0.3918783422459893,0.04410716033501627,0.2327832905486502,132902.9775206651,3333.5874423298746,136236.56496299498,375,32,229.85294117647058,33,1,18,32.39046034387134,0.6559343434343434,42.21813725490196,1031.127450980392,31.246286393345212,0
384,4,0,0,33,0.0,0.0,1.0,33,800,700,100,0.875,9,7,2,412.82167357314495,0.3882181186868687,0.13594207211228482,0.23140737848916648,129625.34722222219,4169.336913687039,133794.68413590922,376,33,236.78787878787878,29,4,19,34.90691489361703,0.6336206896551724,45.416666666666664,1018.333333333333,35.114942528735625,8
385,4,0,0,33,0.0,0.0,1.0,33,1000,600,400,0.6,14,6,8,411.20366205149764,0.38841540404040403,0.1287651535810792,0.23091635968496813,129696.07445987652,4066.300154320986,133762.3746141975,377,34,237.78787878787878,29,4,19,34.87580674484138,0.63433908045977,45.34722222222222,1018.611111111111,35.12452107279693,0
386,4,2,1,34,0.05714285714285714,0.02857142857142857,0.9714285714285714,35,650,200,450,0.3076923076923077,11,2,9,389.15054097465804,0.39716386554621846,0.11908224445537896,0.22153602692086738,130229.35867309572,3135.765075683595,133365.12374877933,378,0,225.14285714285714,31,4,21,34.894039418293154,0.6340725806451613,44.82421875,1020.7031250000001,32.92590725806452,0
387,4,0,0,34,0.0,0.0,1.0,34,1000,600,400,0.6,14,6,8,401.4575035831643,0.39419934640522875,0.13122380520758292,0.22833459361100875,130193.99144771074,3653.4709576251607,133847.4624053359,379,1,232.76470588235293,30,4,22,34.616038895473906,0.6364583333333333,44.858870967741936,1020.5645161290324,34.01881720430108,0
388,4,0,0,34,0.0,0.0,1.0,34,450,300,150,0.6666666666666666,6,3,3,403.66513952519756,0.39425505050505055,0.13793517406962774,0.2299952539155197,130262.58680555565,3716.493055555565,133979.0798611112,380,2,233.76470588235293,31,3,22,34.48979591836734,0.6344086021505376,44.79166666666667,1020.8333333333342,32.93010752688175,0
389,4,0,0,34,0.0,0.0,1.0,34,1300,1000,300,0.7692307692307693,16,10,6,402.8520705092484,0.394143642305407,0.13712940514509397,0.2304002710579441,130409.29954832204,3707.131267340459,134116.4308156625,381,3,234.76470588235293,28,6,23,34.36107985183102,0.644717261904762,44.64798850574712,1021.408045977011,36.478858784893255,0
390,4,1,1,34,0.02857142857142857,0.02857142857142857,0.9714285714285714,35,500,300,200,0.6,7,3,4,391.02621586787063,0.39989495798319324,0.13037824829700906,0.22504644057884238,130652.78018904311,3217.732445987637,133870.51263503075,382,0,229.02857142857144,29,6,17,34.41547230901598,0.6440373563218391,44.409722222222214,1022.3611111111104,35.2538314176245,0
391,4,1,1,34,0.02857142857142857,0.02857142857142857,0.9714285714285714,35,900,600,300,0.6666666666666666,12,6,6,394.55234671666915,0.3973739495798319,0.12807078821748785,0.22728438001002488,130688.28124999999,3312.6736111111113,134000.9548611111,383,0,230.0,29,6,17,34.28925563705515,0.6443965517241379,44.375,1022.4999999999999,35.25862068965517,0
392,4,1,1,34,0.02857142857142857,0.02857142857142857,0.9714285714285714,35,550,300,250,0.5454545454545454,8,3,5,394.55234671666915,0.3984593837535014,0.12807078821748785,0.22728438001002488,130688.28124999999,3312.6736111111113,134000.9548611111,384,0,230.97142857142856,29,6,17,34.28925563705515,0.6443965517241379,44.375,1022.4999999999999,35.25862068965517,0
393,4,0,0,34,0.0,0.0,1.0,34,700,500,200,0.7142857142857143,9,5,4,406.3072106785128,0.3930295603089721,0.1362433643685197,0.23347895773561683,130592.80659598343,3812.159796538488,134404.96639252192,385,7,238.76470588235293,28,6,17,34.085957267360136,0.646577380952381,44.46839080459769,1022.1264367816077,36.50451559934313,0
394,4,0,0,34,0.0,0.0,1.0,34,850,500,350,0.5882352941176471,12,5,7,404.51562208366647,0.3928995840760547,0.13267654249964056,0.23302378793270345,130688.28124999988,3773.0902777777633,134461.37152777764,386,8,239.76470588235293,29,5,17,34.034569410486284,0.644396551724138,44.37499999999999,1022.4999999999991,35.25862068965514,0
395,4,0,1,33,0.0,0.029411764705882353,0.9705882352941176,34,800,500,300,0.625,11,5,6,403.72322995175875,0.393252376708259,0.1289684916736551,0.23320953636036898,130794.81336805562,3760.9809027777824,134555.7942708334,387,9,240.76470588235293,29,5,18,33.94645281737949,0.6454741379310345,44.270833333333336,1022.9166666666672,35.27298850574714,0
396,4,0,0,33,0.0,0.0,1.0,33,1200,800,400,0.6666666666666666,16,8,8,416.26943575366283,0.38825757575757575,0.13654885229987124,0.23988579548654376,130702.97275482219,4281.530543995227,134984.5032988174,388,45,248.78787878787878,28,5,19,33.719146644185294,0.6476934523809526,44.36063218390804,1022.5574712643668,36.5199096880131,0
397,4,0,0,33,0.0,0.0,1.0,33,800,500,300,0.625,11,5,6,417.42152318734736,0.38809974747474746,0.13050011280099771,0.2410076093731327,130776.4426649822,4317.780378847936,135094.22304383013,389,46,249.78787878787878,28,5,19,33.61485695556492,0.6484375,44.28879310344828,1022.8448275862072,36.53017241379312,0
398,4,0,0,33,0.0,0.0,1.0,33,1100,600,500,0.5454545454545454,16,6,10,428.3064396003022,0.38809974747474746,0.14422211126900653,0.24311782794578307,130115.95663644471,4545.90042442859,134661.8570608733,390,47,250.78787878787878,28,5,19,34.01076139510868,0.6417410714285714,44.935344827586206,1020.2586206896552,36.4378078817734,1
399,4,1,1,33,0.029411764705882353,0.029411764705882353,0.9705882352941176,34,450,300,150,0.6666666666666666,6,3,3,418.9696139219041,0.3911541889483066,0.13529080737528587,0.2393919626814223,130372.61362135017,4124.515292641026,134497.1289139912,391,0,244.38235294117646,28,6,19,33.98693959857437,0.6443452380952381,44.683908045977006,1021.2643678160914,36.473727422003265,0
400,4,0,0,33,0.0,0.0,1.0,33,1150,1000,150,0.8695652173913043,13,10,3,432.98726419170424,0.387823547979798,0.14371775999208314,0.24647741321028943,130227.14361496922,4677.338927469145,134904.48254243837,392,49,252.78787878787878,29,4,19,33.77769651199709,0.6397270114942528,44.82638888888889,1020.694444444445,35.19636015325673,0
401,4,0,0,33,0.0,0.0,1.0,33,750,400,350,0.5333333333333333,11,4,7,431.10512640482716,0.3876657196969697,0.147491530963328,0.2458696818174163,130300.5670041454,4634.658126850276,134935.22513099568,393,50,253.78787878787878,27,6,19,33.75069839187679,0.6469907407407407,44.754464285714285,1020.9821428571428,37.814153439153436,0
402,4,2,1,34,0.05714285714285714,0.02857142857142857,0.9714285714285714,35,750,700,50,0.9333333333333333,8,7,1,409.538930869807,0.3974439775910364,0.14735291837842035,0.23810102510821934,131043.55709876555,3733.4876543210034,134777.04475308655,394,0,240.22857142857143,29,6,18,33.54471875565201,0.6479885057471264,44.027777777777786,1023.8888888888898,35.30651340996172,0
403,4,0,0,34,0.0,0.0,1.0,34,800,500,300,0.625,11,5,6,422.8718540530938,0.392825311942959,0.15643325569486444,0.24485311744440108,130886.68623662305,4269.659135949264,135156.3453725723,395,1,248.2941176470588,28,6,19,33.363170457736594,0.6495535714285714,44.18103448275862,1023.2758620689654,36.545566502463046,0
404,4,0,0,34,0.0,0.0,1.0,34,1000,800,200,0.8,12,8,4,422.9052631578947,0.3928995840760547,0.1588152734778121,0.24557457212713935,130996.97625594535,4279.862143281813,135276.83839922716,396,2,249.2941176470588,28,6,19,33.25,0.6506696428571428,44.07327586206897,1023.7068965517245,36.56096059113302,0
405,4,1,0,35,0.02857142857142857,0.0,1.0,35,650,500,150,0.7692307692307693,8,5,3,409.8151905170504,0.3966036414565826,0.15515071728650764,0.2398117597799614,131292.53713348755,3761.135223765416,135053.67235725297,397,0,243.14285714285714,29,6,20,33.28463093463431,0.6505028735632183,43.784722222222214,1024.8611111111104,35.34003831417622,0
406,4,0,2,33,0.0,0.05714285714285714,0.9428571428571428,35,850,700,150,0.8235294117647058,10,7,3,412.00670422117435,0.39681372549019606,0.15674842326559246,0.24155035617239762,131364.9451091624,3824.6524394551634,135189.59754861754,398,1,244.14285714285714,28,7,20,33.15492875496379,0.6543898809523809,43.714080459770116,1025.1436781609198,36.61227422003285,0
407,4,1,0,34,0.029411764705882353,0.0,1.0,34,550,300,250,0.5454545454545454,8,3,5,399.6247259234271,0.3993426916221034,0.16214667685255968,0.23670079920079926,131755.5555555556,3730.5555555555607,135486.11111111115,399,0,237.5,29,5,18,33.076298701298704,0.6551724137931034,43.333333333333336,1026.666666666667,35.402298850574724,0
408,4,0,1,33,0.0,0.029411764705882353,0.9705882352941176,34,1200,900,300,0.75,15,9,6,398.80847071989604,0.39969548425430773,0.1577973988784156,0.23688262176495026,131862.52170138885,3717.578124999994,135580.09982638885,400,1,238.5,29,5,18,32.98892832995268,0.65625,43.229166666666664,1027.083333333333,35.41666666666666,0
409,4,0,0,33,0.0,0.0,1.0,33,350,200,150,0.5714285714285714,5,2,3,425.24247831387004,0.3961489898989899,0.21725585805228187,0.2497665248521323,131434.9175347223,4578.342013888894,136013.2595486112,401,2,246.63636363636363,29,4,20,32.7445652173913,0.6519396551724137,43.645833333333336,1025.4166666666672,35.359195402298866,2
410,4,1,0,34,0.029411764705882353,0.0,1.0,34,1000,700,300,0.7,13,7,6,391.5281585857034,0.3999368686868687,0.14526177069605817,0.22616508925362405,130794.81336805562,3478.472222222227,134273.28559027784,402,0,240.35294117647058,31,3,16,34.25831636116767,0.6397849462365591,44.270833333333336,1022.9166666666672,32.997311827957006,8
411,4,0,0,34,0.0,0.0,1.0,34,850,500,350,0.5882352941176471,12,5,7,392.50237529600827,0.39963978015448604,0.14700642949634357,0.22731585611284671,130894.7266472711,3475.2982245551257,134370.02487182623,403,1,241.35294117647058,31,3,16,34.131913517411036,0.6407930107526882,44.173177083333336,1023.3072916666671,33.009912634408614,0
412,4,0,0,34,0.0,0.0,1.0,34,1100,900,200,0.8181818181818182,13,9,4,393.9806396805242,0.39989973262032086,0.1497295598895798,0.22896302807154176,131028.00369262685,3524.4993421766344,134552.5030348035,404,2,242.35294117647058,31,3,16,33.958757259739706,0.6421370967741936,44.04296874999999,1023.8281249999992,33.026713709677395,0
413,4,1,1,34,0.02857142857142857,0.02857142857142857,0.9714285714285714,35,900,800,100,0.8888888888888888,10,8,2,387.0802656400846,0.4024159663865546,0.14667628786145492,0.22652707398706312,131295.77219480154,3164.400475716759,134460.1726705183,405,0,236.4,32,3,16,33.863855693811345,0.6422526041666667,43.781565656565654,1024.8737373737372,32.02730429292929,0
414,4,0,0,34,0.0,0.0,1.0,34,800,400,400,0.5,12,4,8,393.3916872133581,0.3991198752228164,0.14507785577059673,0.22981434199568804,131228.04641723644,3524.804517957914,134752.85093519435,406,4,244.35294117647058,31,3,18,33.77083598085315,0.6441532258064515,43.84765625000001,1024.609375000001,33.051915322580676,0
415,4,0,0,34,0.0,0.0,1.0,34,700,500,200,0.7142857142857143,9,5,4,391.1348016199437,0.39893419489007725,0.14253853452977783,0.22929294811271905,131361.49300469286,3476.0103013780335,134837.5033060709,407,5,245.35294117647058,31,3,18,33.69334539988992,0.645497311827957,43.717447916666664,1025.130208333333,33.06871639784945,0
416,4,1,0,35,0.02857142857142857,0.0,1.0,35,900,700,200,0.7777777777777778,11,7,4,382.78808057596893,0.4018207282913165,0.14570690654813157,0.22668972200751655,131749.0741537853,3086.3950425976923,134835.469196383,408,0,239.31428571428572,32,3,15,33.51499405567171,0.6468098958333334,43.339646464646464,1026.641414141414,32.08254419191919,0
417,4,0,0,35,0.0,0.0,1.0,35,550,200,350,0.36363636363636365,9,2,7,383.55815710719037,0.40213585434173665,0.14908298784344054,0.22733928087431995,131781.48275686146,3109.1725334149473,134890.6552902764,409,1,240.31428571428572,32,3,15,33.46245286112476,0.6471354166666667,43.3080808080808,1026.7676767676762,32.08648989898988,0
418,4,1,0,36,0.027777777777777776,0.0,1.0,36,1000,800,200,0.8,12,8,4,372.5978031418145,0.40499338624338627,0.1455841644481528,0.22278852249156664,132114.37795859756,2645.1053981641544,134759.48335676172,410,0,234.61111111111111,33,3,16,33.40771148726506,0.6480429292929294,42.984068627450974,1028.0637254901953,31.153446226975618,0
419,4,0,1,35,0.0,0.027777777777777776,0.9722222222222222,36,750,600,150,0.8,9,6,3,365.71776859719307,0.4050760582010582,0.14467135119308994,0.2115992827455278,130857.49959450695,2371.38255118224,133228.8821456892,411,1,235.61111111111111,33,3,19,34.85484788597436,0.6354166666666666,44.20955882352941,1023.1617647058827,31.004901960784323,3
420,4,0,0,35,0.0,0.0,1.0,35,600,500,100,0.8333333333333334,7,5,2,374.49382716049377,0.4014005602240896,0.16099470899470902,0.21605413105413115,130746.38429752078,2792.7427685950597,133539.12706611585,412,2,243.0857142857143,32,3,19,34.74305555555557,0.63671875,44.31818181818183,1022.7272727272737,31.960227272727302,0
421,4,1,0,36,0.027777777777777776,0.0,1.0,36,500,300,200,0.6,7,3,4,366.1095156184584,0.40500992063492064,0.16414987698650152,0.2128632569931955,131045.64838343424,2395.4117707131836,133441.06015414742,413,0,237.30555555555554,33,3,20,34.65427388789148,0.6373106060606061,44.025735294117645,1023.8970588235293,31.02718360071301,0
422,4,0,1,35,0.0,0.027777777777777776,0.9722222222222222,36,600,200,400,0.3333333333333333,10,2,8,367.9251535904872,0.40509259259259256,0.1707118450267906,0.2142683281223486,131108.39468293454,2447.615250144184,133556.00993307872,414,1,238.30555555555554,33,3,20,34.54426927525827,0.6379419191919191,43.96446078431373,1024.1421568627457,31.034610814022596,0
423,4,1,0,36,0.027777777777777776,0.0,1.0,36,750,500,250,0.6666666666666666,10,5,5,359.08677004534513,0.4080191798941799,0.14766115819755687,0.21082579075668414,131419.65880102038,2238.2121598639437,133657.87096088432,415,0,228.5,34,2,21,34.45590967142691,0.6387867647058822,43.660714285714285,1025.3571428571427,30.157563025210077,0
424,4,1,2,35,0.02702702702702703,0.05405405405405406,0.9459459459459459,37,1300,1200,100,0.9230769230769231,14,12,2,348.40834968673414,0.411255005005005,0.1282161430960893,0.20646162124722905,131773.38023244595,1782.189187885802,133555.56942033177,416,0,223.2972972972973,35,2,15,34.372886371322295,0.6401785714285715,43.31597222222222,1026.7361111111109,29.33531746031745,0
425,4,0,0,35,0.0,0.0,1.0,35,1200,800,400,0.6666666666666666,16,8,8,365.77863572191063,0.40367647058823525,0.13688897988432225,0.21583259456656498,131610.90573637537,2628.091509275269,134238.99724565062,417,4,237.02857142857144,33,2,17,34.091101357538115,0.6429924242424243,43.47426470588235,1026.10294117647,31.09402852049909,0
426,4,0,0,35,0.0,0.0,1.0,35,700,300,400,0.42857142857142855,11,3,8,367.77088128267513,0.4035714285714285,0.13675808432255443,0.21754582638585357,131705.23356401385,2687.4699634755875,134392.70352748944,418,5,238.02857142857144,33,2,18,33.94470312002548,0.6439393939393939,43.38235294117647,1026.4705882352941,31.10516934046346,0
427,4,0,0,35,0.0,0.0,1.0,35,950,700,250,0.7368421052631579,12,7,5,367.694593242351,0.4026960784313725,0.14335157621946015,0.21804055178893536,131799.59518274208,2692.3997080449653,134491.99489078706,419,6,239.02857142857144,33,2,18,33.85136949516648,0.6448863636363638,43.29044117647058,1026.8382352941167,31.116310160427776,0
428,4,0,0,35,0.0,0.0,1.0,35,900,400,500,0.4444444444444444,14,4,10,367.19957737436147,0.40171568627450976,0.14762245628387416,0.21828842961360967,131893.9905925605,2686.2835207612397,134580.27411332174,420,7,240.02857142857144,33,2,18,33.76879026485326,0.6458333333333334,43.1985294117647,1027.2058823529408,31.127450980392144,0
429,4,0,0,35,0.0,0.0,1.0,35,1250,900,350,0.72,16,9,7,367.149031597809,0.40143557422969184,0.14452017448200638,0.21862055972414998,131956.93963860057,2689.5725201845507,134646.51215878513,421,8,241.02857142857144,33,2,19,33.706564090330794,0.6464646464646464,43.13725490196079,1027.4509803921571,31.13487819370173,0
430,4,0,0,35,0.0,0.0,1.0,35,750,400,350,0.5333333333333333,11,4,7,368.7024738686087,0.40136554621848736,0.14721133862560087,0.2199103090940363,132019.90370290264,2735.213019031132,134755.11672193377,422,9,242.02857142857144,33,2,19,33.60312822958901,0.6470959595959596,43.07598039215686,1027.6960784313717,31.142305407011264,0
431,4,0,0,35,0.0,0.0,1.0,35,1000,800,200,0.8,12,8,4,371.3570130739103,0.40094537815126047,0.14726374936148479,0.22223147929316023,132145.87688629364,2814.659626105329,134960.53651239898,423,10,243.02857142857144,33,2,20,33.407826777910216,0.6483585858585859,42.95343137254901,1028.186274509803,31.157159833630395,0
432,4,0,0,35,0.0,0.0,1.0,35,950,600,350,0.631578947368421,13,6,7,376.8005659329035,0.4006302521008403,0.1496306885870864,0.22624205654082896,132271.9101427333,2968.026119761597,135239.9362624949,424,11,244.02857142857144,33,2,20,33.14073544595345,0.6496212121212123,42.83088235294116,1028.6764705882333,31.172014260249494,0
433,4,1,1,35,0.027777777777777776,0.027777777777777776,0.9722222222222222,36,1000,600,400,0.6,14,6,8,370.12599365318783,0.40277777777777773,0.1474289823804391,0.224252807919284,132612.49999999977,2616.666666666639,135229.1666666664,425,0,238.22222222222223,34,2,22,32.96925566343041,0.6507352941176472,42.499999999999986,1029.9999999999982,30.29411764705877,0
434,4,0,0,35,0.0,0.0,1.0,35,950,500,450,0.5263157894736842,14,5,9,382.6437245292542,0.4001050420168067,0.159722482017447,0.23109920415314633,132492.61289227704,3139.493373942717,135632.10626621975,426,13,246.02857142857144,33,2,22,32.76780046026268,0.6518308080808082,42.61642156862745,1029.5343137254904,31.198009506833042,0
435,4,0,0,35,0.0,0.0,1.0,35,900,600,300,0.6666666666666666,12,6,6,377.8849218692123,0.39982492997198876,0.16004623648602645,0.22880006364473057,132587.25610342182,3020.5449826989616,135607.80108612077,427,14,247.02857142857144,33,2,22,32.794899254323326,0.6527777777777778,42.52450980392157,1029.901960784314,31.209150326797396,0
436,4,0,0,35,0.0,0.0,1.0,35,1000,700,300,0.7,13,7,6,374.0250330058376,0.3992647058823529,0.1538989617495623,0.2270345453054206,132681.93310565644,2925.272881824293,135607.20598748073,428,15,248.02857142857144,33,2,17,32.79893243725466,0.6537247474747474,42.432598039215684,1030.269607843137,31.220291146761728,0
437,4,0,0,35,0.0,0.0,1.0,35,1000,700,300,0.7,13,7,6,379.4241285533416,0.3990196078431372,0.16318766241486493,0.23108880124997513,132808.2216725539,3078.1287545655573,135886.35042711944,429,16,249.02857142857144,33,2,18,32.532670510838976,0.6549873737373737,42.310049019607845,1030.759803921569,31.23514557338088,0
438,4,0,0,35,0.0,0.0,1.0,35,1000,600,400,0.6,14,6,8,378.79389734483044,0.3987394957983193,0.16055424428180887,0.2310944929921725,132871.38848339583,3066.174217848907,135937.56270124472,430,17,250.02857142857144,33,2,18,32.485315384920156,0.6556186868686869,42.24877450980392,1031.0049019607845,31.24257278669044,0
439,4,0,0,35,0.0,0.0,1.0,35,1050,700,350,0.6666666666666666,14,7,7,380.41016222834406,0.39796918767507,0.1662337662337665,0.23247287691732135,132934.5703125,3113.932291666667,136048.50260416666,431,18,251.02857142857144,33,2,18,32.3800505050505,0.65625,42.1875,1031.25,31.25,0
440,4,0,1,34,0.0,0.02857142857142857,0.9714285714285714,35,850,500,350,0.5882352941176471,12,5,7,381.3326416159448,0.39793417366946776,0.16521665337157798,0.23343104323501135,132997.76715986637,3143.2779760188373,136141.04513588522,432,19,252.02857142857144,33,2,18,32.292656726466284,0.6568813131313131,42.12622549019608,1031.4950980392155,31.25742721330956,0
441,4,0,0,34,0.0,0.0,1.0,34,1150,900,250,0.782608695652174,14,9,5,390.05118443293577,0.396111853832442,0.1634611228767775,0.23805366009561688,132885.746671258,3566.448576675849,136452.19524793385,433,20,257.47058823529414,32,2,18,32.18068821944647,0.658203125,42.234848484848484,1031.060606060606,32.22064393939394,0
442,4,0,0,34,0.0,0.0,1.0,34,750,500,250,0.6666666666666666,10,5,5,389.90738041362414,0.39587046939988113,0.12887356254870408,0.22069249555717182,130004.92814827568,3337.9761950311163,133342.9043433068,434,21,258.47058823529414,32,2,18,35.103276794189256,0.6292317708333334,45.04419191919192,1019.8232323232322,31.869476010101007,8
443,4,1,0,35,0.02857142857142857,0.0,1.0,35,650,500,150,0.7692307692307693,8,5,3,377.6524995957237,0.40031512605042013,0.12698565085460567,0.21569419322352054,130356.43029423774,2845.8863477989166,133202.31664203666,435,0,252.05714285714285,33,2,19,35.05827733109324,0.6303661616161617,44.69975490196078,1021.2009803921565,30.94548425430777,0
444,4,1,2,34,0.027777777777777776,0.05555555555555555,0.9444444444444444,36,650,400,250,0.6153846153846154,9,4,5,369.5630692321194,0.40534060846560843,0.12342803912436007,0.21272169159285786,130657.8514739228,2457.2633219954523,133115.11479591826,436,0,246.02777777777777,34,2,16,34.95890583760286,0.6311274509803921,44.4047619047619,1022.3809523809515,30.070028011204457,0
445,4,1,1,34,0.02857142857142857,0.02857142857142857,0.9714285714285714,35,750,600,150,0.8,9,6,3,377.48011242092,0.40455182072829127,0.1240185746842819,0.21629221286963626,130481.60750973174,2850.84237432717,133332.4498840589,437,0,253.34285714285716,33,2,19,34.93550337851346,0.631628787878788,44.577205882352935,1021.6911764705874,30.960338680926892,0
446,4,1,0,35,0.02857142857142857,0.0,1.0,35,800,500,300,0.625,11,5,6,377.2522830725996,0.4026960784313725,0.134477149363881,0.21721296050204952,130669.4859699394,2859.0723820165285,133528.55835195593,438,0,254.31428571428572,33,2,17,34.75056434535938,0.6335227272727273,44.393382352941174,1022.4264705882349,30.982620320855602,0
447,4,0,0,35,0.0,0.0,1.0,35,650,300,350,0.46153846153846156,10,3,7,369.4145247781065,0.40280112044817923,0.11563186813186843,0.20879951400501656,129950.01922337545,2601.0849192617998,132551.10414263725,439,1,255.31428571428572,33,2,19,35.681590544871796,0.6262626262626263,45.09803921568626,1019.6078431372536,30.897207367795563,5
448,4,1,1,35,0.027777777777777776,0.027777777777777776,0.9722222222222222,36,1200,800,400,0.6666666666666666,16,8,8,356.3562008615573,0.4063492063492064,0.1155651570918017,0.20336711408071856,130325.14537677796,2088.8101931949027,132413.95556997287,440,0,249.19444444444446,33,3,20,35.63370139222275,0.6300505050505052,44.730392156862735,1021.0784313725474,30.94177064765295,0
449,4,0,0,35,0.0,0.0,1.0,35,850,500,350,0.5882352941176471,12,5,7,363.8646303617077,0.40213585434173665,0.1290254199862213,0.20766219235957184,130327.04132550264,2484.2801436078153,132811.32146911044,441,1,257.25714285714287,32,3,21,35.4401096409876,0.6324869791666665,44.728535353535364,1021.0858585858597,31.908933080808115,0
450,4,0,0,35,0.0,0.0,1.0,35,850,600,250,0.7058823529411765,11,6,5,363.2285734803608,0.40206582633053217,0.13363941373830146,0.2078160650251852,130423.75299714318,2474.726749821454,132898.47974696464,442,2,258.25714285714287,32,3,21,35.35820972393903,0.6334635416666666,44.63383838383839,1021.4646464646468,31.92077020202021,0
451,4,1,1,35,0.027777777777777776,0.027777777777777776,0.9722222222222222,36,750,600,150,0.8,9,6,3,355.9942383412014,0.40563822751322753,0.1270626073754444,0.20497308008838108,130669.4859699394,2103.516826460971,132773.00279640037,443,0,252.05555555555554,33,3,18,35.293934036517626,0.6335227272727273,44.393382352941174,1022.4264705882349,30.982620320855602,0
452,4,0,0,35,0.0,0.0,1.0,35,1200,800,400,0.6666666666666666,16,8,8,368.07060472071134,0.40108543417366943,0.1402430635175418,0.21217109093473616,130714.10323245087,2622.403804458742,133336.5070369096,444,4,260.25714285714287,32,3,18,34.94001317035025,0.6363932291666666,44.34974747474748,1022.601010101011,31.956281565656592,0
453,4,1,0,36,0.027777777777777776,0.0,1.0,36,550,300,250,0.5454545454545454,8,3,5,359.71571528032956,0.40216600529100527,0.15282098322299342,0.2096585738014639,131139.7734645328,2234.6074826989548,133374.38094723175,445,0,254.0,33,3,19,34.7227207465901,0.6382575757575758,43.93382352941176,1024.2647058823525,31.03832442067735,0
454,4,0,0,36,0.0,0.0,1.0,36,1000,800,200,0.8,12,8,4,361.9593342367565,0.40133928571428573,0.16060893587906477,0.2114992525306019,131236.62308673482,2300.4641439909465,133537.08723072577,446,1,255.0,34,2,19,34.56730955423879,0.6369485294117647,43.83928571428572,1024.6428571428582,30.136554621848774,0
455,4,0,0,36,0.0,0.0,1.0,36,550,200,350,0.36363636363636365,9,2,7,364.78625662233753,0.40120701058201064,0.16570191401763035,0.21349047472887175,131297.62081916098,2379.1135204081643,133676.73433956914,447,2,256.0,34,2,19,34.433199752197325,0.6375612745098038,43.779761904761905,1024.8809523809523,30.143557422969185,0
456,4,0,0,36,0.0,0.0,1.0,36,800,400,400,0.5,12,4,8,362.8792385484828,0.4011574074074074,0.16327913279132766,0.21254355400696864,131328.12500000015,2331.2535430839152,133659.37854308405,448,3,257.0,33,3,19,34.45121951219511,0.6401515151515151,43.75000000000001,1025.0000000000011,31.060606060606094,0
457,4,1,0,37,0.02702702702702703,0.0,1.0,37,1500,1200,300,0.8,18,12,6,351.12519103838747,0.40471721721721726,0.17262443935295546,0.2078073110723417,131725.00177154216,1850.393282312946,133575.3950538551,449,0,251.02702702702703,34,3,19,34.351927016892795,0.6418504901960783,43.36309523809525,1026.5476190476206,30.192577030812373,0
458,4,0,0,37,0.0,0.0,1.0,37,1350,1200,150,0.8888888888888888,15,12,3,349.7572028321929,0.40452952952952953,0.16397273490458475,0.2078309329226007,131877.8061224491,1825.0425170068195,133702.84863945594,450,1,252.02702702702703,34,3,19,34.23302039870189,0.6433823529411763,43.21428571428572,1027.1428571428582,30.210084033613477,0
459,4,0,0,37,0.0,0.0,1.0,37,400,100,300,0.25,7,1,6,348.6652588077879,0.4047797797797798,0.16342753693547496,0.2073488985701175,131908.37762188227,1798.3737244898123,133706.7513463721,451,2,253.02702702702703,34,3,19,34.23026036234404,0.643688725490196,43.18452380952382,1027.2619047619062,30.213585434173712,0
460,4,0,0,37,0.0,0.0,1.0,37,1250,800,450,0.64,17,8,9,350.79714362508435,0.40409159159159164,0.1684061904732923,0.2096756547562585,132100.37964034645,1868.0871699245654,133968.46681027103,452,3,254.02702702702703,35,2,19,33.98211739097801,0.6434523809523809,42.99768518518519,1028.00925925926,29.371693121693145,0
461,4,0,0,37,0.0,0.0,1.0,37,1150,900,250,0.782608695652174,14,9,5,351.9748914585426,0.4035598098098098,0.1682925049261681,0.21137519157321144,132278.91375171486,1911.7712620027621,134190.68501371762,453,4,255.02702702702703,35,2,19,33.77212721272129,0.6452380952380952,42.82407407407408,1028.703703703705,29.39153439153443,0
462,4,0,0,37,0.0,0.0,1.0,37,850,700,150,0.8235294117647058,10,7,3,350.65195028349194,0.40371621621621623,0.16489830663058958,0.2109131148863497,132338.4519140092,1880.9472522291073,134219.39916623832,454,5,256.02702702702703,35,2,20,33.74625046869141,0.6458333333333331,42.76620370370372,1028.9351851851873,29.39814814814821,0
463,4,0,0,37,0.0,0.0,1.0,37,750,500,250,0.6666666666666666,10,5,5,348.76339894080866,0.4039039039039039,0.1564181971243701,0.21027477334105873,132427.78427479876,1837.192831575812,134264.97710637457,455,6,257.02702702702703,35,2,20,33.704997376213505,0.6467261904761903,42.67939814814816,1029.2824074074092,29.408068783068835,0
464,4,0,0,37,0.0,0.0,1.0,37,850,700,150,0.8235294117647058,10,7,3,345.5315021797369,0.40377877877877877,0.14191717514089652,0.19672319675423475,130233.05047850203,1599.9243130572477,131832.97479155927,456,7,258.02702702702703,35,2,16,36.00334977510677,0.6247023809523811,44.82060185185184,1020.717592592591,29.16335978835974,5
465,4,1,0,38,0.02631578947368421,0.0,1.0,38,650,400,250,0.6153846153846154,9,4,5,342.1583386693892,0.4067093409198672,0.16169471481324793,0.19698513359412675,130665.25298524847,1341.6411766495926,132006.89416189806,457,0,252.21052631578948,36,2,15,35.65187061717518,0.6270254629629631,44.39752252252251,1022.4099099099076,28.40027527527521,0
466,4,0,0,38,0.0,0.0,1.0,38,800,600,200,0.75,10,6,4,341.3183755383117,0.40656116642958745,0.1626501834367884,0.19679442338180345,130722.8274516068,1323.620622311474,132046.4480739183,458,1,253.21052631578948,36,2,15,35.61511213889807,0.6276041666666667,44.3412162162162,1022.6351351351334,28.406531531531485,0
467,4,0,0,38,0.0,0.0,1.0,38,700,300,400,0.42857142857142855,11,3,8,343.1428008580226,0.40657598387861543,0.164082597510951,0.19828938950345265,130809.21292914523,1377.247940508064,132186.4608696533,459,2,254.21052631578948,36,2,15,35.48111147805667,0.6284722222222223,44.25675675675675,1022.9729729729719,28.415915915915885,0
468,4,0,0,38,0.0,0.0,1.0,38,600,400,200,0.6666666666666666,8,4,4,344.53277893549205,0.40684269796111905,0.1673946036122662,0.1993901165227947,130866.81909950473,1417.581770960128,132284.40087046486,460,3,255.21052631578948,36,2,15,35.3873174847751,0.629050925925926,44.20045045045044,1023.1981981981968,28.422172172172132,0
469,4,0,0,38,0.0,0.0,1.0,38,1000,700,300,0.7,13,7,6,346.8714062728717,0.4069167852062589,0.1670141845203965,0.20089359265784473,130895.62694028478,1480.790038349148,132376.41697863393,461,4,256.2105263157895,36,2,15,35.29836579729285,0.6293402777777779,44.17229729729729,1023.31081081081,28.42530030030028,0
470,4,0,0,38,0.0,0.0,1.0,38,1350,1100,250,0.8148148148148148,16,11,5,345.8731351683023,0.40722795163584635,0.16801574894331495,0.20076544052872705,130982.06948502548,1460.63580472363,132442.7052897491,462,5,257.2105263157895,36,2,15,35.23652365236522,0.6302083333333335,44.08783783783783,1023.648648648648,28.434684684684665,0
471,4,0,1,37,0.0,0.02631578947368421,0.9736842105263158,38,800,600,200,0.75,10,6,4,339.91635777911466,0.4073761261261261,0.10255042893577548,0.1958401350656321,130694.03863322789,1285.0083191299495,131979.04695235784,463,6,258.2105263157895,36,2,16,35.68006607929516,0.6273148148148149,44.36936936936937,1022.522522522523,28.403403403403416,5
472,4,0,0,37,0.0,0.0,1.0,37,1100,800,300,0.7272727272727273,14,8,6,343.2562456582334,0.40343468468468463,0.11992841738172832,0.1978257619302343,130706.03358892743,1573.1324749228343,132279.16606385025,464,7,265.81081081081084,35,2,16,35.58255517826823,0.6294642857142857,44.357638888888886,1022.5694444444441,29.21626984126983,0
473,4,0,0,37,0.0,0.0,1.0,37,1150,700,450,0.6086956521739131,16,7,9,343.92247999934557,0.40315315315315314,0.1209288953998704,0.19851358300158164,130765.21675936629,1594.6195291066401,132359.83628847293,465,8,266.81081081081084,35,2,17,35.50566274376674,0.6300595238095239,44.29976851851851,1022.8009259259248,29.222883597883566,0
474,4,1,0,38,0.02631578947368421,0.0,1.0,38,1050,600,450,0.5714285714285714,15,6,9,338.9993204509084,0.4041311047889995,0.1265564967828543,0.19766268069368328,131155.0401753103,1292.2938986283452,132447.33407393866,466,0,260.7631578947368,36,2,19,35.2377876722369,0.6319444444444444,43.91891891891891,1024.3243243243232,28.453453453453424,0
475,4,0,0,38,0.0,0.0,1.0,38,1000,800,200,0.8,12,8,4,342.77571525276505,0.4040866524419156,0.15247061224027125,0.19197920939910582,129591.85157933198,1284.1879232071287,130876.0395025391,467,1,261.7631578947368,37,1,16,36.72419053772705,0.6143018018018018,45.44956140350877,1018.2017543859639,27.51896633475578,5
476,4,0,0,38,0.0,0.0,1.0,38,1050,900,150,0.8571428571428571,12,9,3,343.13171992422247,0.4040718349928876,0.16246905607577222,0.19286369085395955,129731.44531249997,1302.9947916666652,131034.44010416664,468,2,262.7631578947368,37,1,16,36.57336400817996,0.6157094594594594,45.3125,1018.7499999999998,27.53378378378378,0
477,4,0,0,38,0.0,0.0,1.0,38,800,700,100,0.875,9,7,2,341.0034911015187,0.40383475580844,0.15471464090118747,0.19194097170238716,129787.3038458948,1251.5847424207332,131038.88858831553,469,3,263.7631578947368,37,1,16,36.57087323792101,0.6162725225225225,45.257675438596486,1018.9692982456133,27.539710763394954,0
478,4,1,2,37,0.02564102564102564,0.05128205128205128,0.9487179487179487,39,550,200,350,0.36363636363636365,9,2,7,334.31491801976944,0.40899122807017546,0.15012328965817345,0.18928648917062377,130017.30974687697,893.3452498356239,130910.65499671259,470,0,257.97435897435895,38,1,16,36.508092394720315,0.6167763157894738,45.03205128205128,1019.8717948717941,26.838731443994583,0
479,4,2,1,38,0.05128205128205128,0.02564102564102564,0.9743589743589743,39,1250,800,450,0.64,17,8,9,335.980309840661,0.40817588843904634,0.16077180775673305,0.1910288047379755,130180.8021038788,947.6372452333773,131128.4393491122,471,0,258.05128205128204,38,1,17,36.29998953098827,0.618421052631579,44.87179487179486,1020.5128205128187,26.855600539811018,0
480,4,0,0,38,0.0,0.0,1.0,38,950,800,150,0.8421052631578947,11,8,3,366.28251224315585,0.40625,0.1502109122990818,0.2072416466722537,129990.07100819987,1922.6179551099228,131912.6889633098,472,1,265.8421052631579,38,0,17,35.7207089226471,0.6165021929824562,45.058760683760674,1019.7649572649561,26.835919928025163,2
481,4,0,0,38,0.0,0.0,1.0,38,1150,800,350,0.6956521739130435,15,8,7,369.6540964874629,0.40573138928402086,0.1504231684739492,0.21017475771715716,130180.80210387881,2024.3733563444891,132205.1754602233,473,2,266.8421052631579,38,0,17,35.4408762562814,0.618421052631579,44.87179487179486,1020.5128205128188,26.85560053981102,0
482,4,1,1,38,0.02564102564102564,0.02564102564102564,0.9743589743589743,39,1100,600,500,0.5454545454545454,16,6,10,365.10129956255577,0.4067420152946469,0.15826502788623187,0.20937716988452051,130514.55886667052,1730.2583750450747,132244.8172417156,474,0,260.97435897435895,37,2,13,35.21825929105412,0.6235923423423423,44.54495614035088,1021.8201754385965,27.616761498340445,0
483,4,1,1,38,0.02564102564102564,0.02564102564102564,0.9743589743589743,39,750,400,350,0.5333333333333333,11,4,7,365.63309021929234,0.40598290598290593,0.1571578675204508,0.21013758736277705,130598.60365689448,1750.2342066789834,132348.83786357346,475,0,261.87179487179486,37,2,13,35.1194307373239,0.6244369369369369,44.46271929824562,1022.149122807018,27.625651967757243,0
484,4,1,0,39,0.02564102564102564,0.0,1.0,39,900,600,300,0.6666666666666666,12,6,6,367.88465287600474,0.4063202878992353,0.17337719985377875,0.212507487720139,130794.81336805543,1823.4809027777676,132618.2942708332,476,0,262.84615384615387,37,2,14,34.862949762389675,0.6264076576576577,44.27083333333333,1022.9166666666656,27.64639639639637,0
485,4,0,0,39,0.0,0.0,1.0,39,1250,900,350,0.72,16,9,7,367.99209568036656,0.4065452091767881,0.18096768434208244,0.21349945389535213,130963.11034404793,1838.6778864650396,132801.78823051296,477,1,263.84615384615387,37,2,15,34.68967595072308,0.628096846846847,44.106359649122794,1023.5745614035069,27.664177335229915,0
486,4,1,0,40,0.025,0.0,1.0,40,1500,1200,300,0.8,18,12,6,357.5959619532823,0.40918803418803423,0.17897727272727315,0.209150028479017,131273.37643363263,1388.565864928024,132661.94229856067,478,0,258.225,38,2,16,34.641932513205454,0.6293859649122808,43.80341880341879,1024.7863247863231,26.96806117858745,0
487,4,0,0,40,0.0,0.0,1.0,40,950,700,250,0.7368421052631579,12,7,5,356.6570421545524,0.4083333333333334,0.17263290861159963,0.20921428555251567,131385.8453047641,1371.9602220230147,132757.80552678712,479,1,259.225,36,4,16,34.5523487844171,0.6342592592592593,43.69369369369369,1025.2252252252244,28.478478478478458,0
488,4,0,1,39,0.0,0.025,0.975,40,1000,700,300,0.7,13,7,6,357.9893678462937,0.4076655982905983,0.18488563888277998,0.20842223503163856,131097.37059694825,1386.2929652625571,132483.6635622108,480,2,260.225,36,4,16,34.809810497764104,0.6313657407407407,43.97522522522522,1024.0990990990988,28.447197197197188,1
489,4,1,0,40,0.025,0.0,1.0,40,850,500,350,0.5882352941176471,12,5,7,359.7699577558732,0.40759882478632475,0.19566615367703655,0.20993119343843347,131183.87972009167,1439.2037730297832,132623.08349312146,481,0,261.15,36,4,17,34.67672492763182,0.6322337962962963,43.890765765765764,1024.4369369369367,28.456581581581574,0
490,4,0,0,40,0.0,0.0,1.0,40,800,500,300,0.625,11,5,6,361.79615988407176,0.40713141025641025,0.19708791208791165,0.21159029916099314,131270.41737683633,1498.6265826637416,132769.04395950006,482,1,262.15,36,4,17,34.53731684981684,0.6331018518518519,43.806306306306304,1024.7747747747749,28.465965965965967,0
491,4,0,0,40,0.0,0.0,1.0,40,1400,800,600,0.5714285714285714,20,8,12,363.9121493533013,0.40682425213675216,0.20061801557737935,0.21364464752292198,131417.11576485322,1564.8696935603793,132981.9854584136,483,2,263.15,35,5,17,34.3347866576363,0.6366071428571429,43.663194444444436,1025.347222222221,29.295634920634885,0
492,4,0,1,39,0.0,0.025,0.975,40,1000,700,300,0.7,13,7,6,350.76589753073813,0.4070379273504274,0.21937192381767634,0.2051475643505805,131271.93583602642,1209.14367882425,132481.07951485066,484,3,264.15,37,3,19,34.81837149582709,0.6311936936936937,43.80482456140351,1024.7807017543855,27.696775723091502,8
493,4,1,0,40,0.025,0.0,1.0,40,900,700,200,0.7777777777777778,11,7,4,348.3565884294916,0.40881410256410255,0.22574475287745455,0.20498911598022262,131506.1366705246,1162.229871477542,132668.36654200216,485,0,261.45,35,5,20,34.643703452945154,0.6375,43.576388888888886,1025.694444444444,29.30555555555554,0
494,4,2,3,39,0.047619047619047616,0.07142857142857142,0.9285714285714286,42,1150,900,250,0.782608695652174,14,9,5,332.3691551135602,0.4130250677506775,0.20680649553888975,0.19815290850663392,132003.3327562326,374.76723607262875,132378.09999230521,486,0,249.95238095238096,37,5,16,34.553279271589126,0.6385135135135136,43.09210526315789,1027.6315789473676,27.773826458036964,0
495,4,0,0,39,0.0,0.0,1.0,39,1100,600,500,0.5454545454545454,16,6,10,355.53684259269545,0.40707939721097613,0.21684692018451757,0.20643222886256507,130992.77388038555,1522.678946347707,132515.45282673326,487,2,258.4871794871795,34,5,20,34.97838895995658,0.6344975490196079,44.077380952380956,1023.6904761904767,30.108543417366963,5
496,4,1,2,38,0.025,0.05,0.95,40,550,300,250,0.5454545454545454,8,3,5,346.3585723905193,0.41069711538461534,0.2076079788987797,0.20240954721781243,131241.5683208548,1091.3284483808293,132332.89676923564,488,0,253.0,36,4,20,34.961946367732715,0.6328125,43.83445945945947,1024.6621621621634,28.462837837837874,0
497,4,0,0,38,0.0,0.0,1.0,38,1050,800,250,0.7619047619047619,13,8,5,364.4829467577242,0.4025011853959222,0.2324964347139502,0.21162652661510262,130992.77388038546,1948.9264455782256,132941.7003259637,489,8,267.2368421052632,34,4,20,34.749437919137875,0.6344975490196079,44.07738095238095,1023.690476190476,30.108543417366942,0
498,4,0,0,38,0.0,0.0,1.0,38,800,600,200,0.75,10,6,4,363.7623144149876,0.402619724988146,0.23161762518223195,0.2112592036113305,131002.08340031285,1930.7242101766008,132932.80761048946,490,9,268.2368421052632,35,3,20,34.75845581307706,0.6324404761904763,44.06828703703703,1023.7268518518513,29.24933862433861,0
499,4,0,0,38,0.0,0.0,1.0,38,1000,900,100,0.9,11,9,2,358.48765078856445,0.40254563774300617,0.22044827258018507,0.20867754830113255,131090.96364883386,1798.898319615898,132889.86196844975,491,10,269.2368421052632,35,3,20,34.80353375527428,0.6333333333333333,43.981481481481474,1024.0740740740728,29.25925925925922,0
500,4,0,0,38,0.0,0.0,1.0,38,850,700,150,0.8235294117647058,10,7,3,357.1054151367316,0.4016121384542437,0.22298699522504095,0.2083546492666585,131179.874038173,1769.0086751971835,132948.8827133702,492,11,270.2368421052632,35,3,20,34.74901611870598,0.6342261904761906,43.894675925925924,1024.4212962962963,29.269179894179896,0
501,4,1,0,39,0.02564102564102564,0.0,1.0,39,800,700,100,0.875,9,7,2,351.98706961951905,0.40452091767881243,0.22561324930993165,0.20712545889562914,131506.13667052457,1457.775661222545,132963.91233174712,493,0,264.28205128205127,35,4,21,34.550609343263346,0.6375000000000001,43.57638888888888,1025.6944444444434,29.305555555555525,0
502,4,1,0,40,0.025,0.0,1.0,40,1250,900,350,0.72,16,9,7,340.4479489718631,0.4080261752136752,0.2223841554559045,0.20206815526428792,131834.36850761744,976.5480724838067,132810.91658010124,494,0,258.65,37,3,21,34.51580183642964,0.6368243243243243,43.2565789473684,1026.973684210524,27.75604551920335,0
503,4,0,0,40,0.0,0.0,1.0,40,1100,900,200,0.8181818181818182,13,9,4,341.6275840643623,0.4078659188034188,0.22599274124679747,0.20306898524840994,131890.67790089236,1011.498730378546,132902.1766312709,495,1,259.65,37,3,21,34.42881796185594,0.6373873873873874,43.2017543859649,1027.1929824561385,27.761972498814554,0
504,4,1,1,40,0.024390243902439025,0.024390243902439025,0.975609756097561,41,1200,700,500,0.5833333333333334,17,7,10,337.54202346686895,0.41183943089430897,0.22421383727502464,0.20187488451346644,132123.26189139063,719.4306331725962,132842.69252456323,496,0,254.29268292682926,38,3,21,34.29976791714296,0.6378837719298247,42.97542735042734,1028.0982905982887,27.055218173639176,0
505,4,0,0,40,0.0,0.0,1.0,40,950,800,150,0.8421052631578947,11,8,3,341.03261866666725,0.4076121794871795,0.22523466666666758,0.20377188017845752,132087.85545792905,1009.2534481763298,133097.1089061054,497,3,261.65,37,3,22,34.245666666666686,0.6393581081081082,43.009868421052616,1027.9605263157869,27.7827169274537,0
506,4,1,0,41,0.024390243902439025,0.0,1.0,41,800,700,100,0.875,9,7,2,303.01448222049163,0.4113821138211382,0.14916859895594325,0.1768633491180141,131194.69536675364,-249.22146267359022,130945.47390408005,498,0,256.2439024390244,39,2,19,36.11940772750383,0.626869658119658,43.88020833333334,1024.479166666668,26.268696581196618,7
507,4,1,1,41,0.023809523809523808,0.023809523809523808,0.9761904761904762,42,1250,900,350,0.72,16,9,7,295.9459902606318,0.41370257452574527,0.14130755358291158,0.17443279820927376,131568.46923828137,-612.499999999985,130955.96923828138,499,0,251.11904761904762,39,3,15,35.925072765424574,0.6306089743589742,43.51562500000001,1025.937500000001,26.306089743589766,0
508,4,0,0,41,0.0,0.0,1.0,41,1350,900,450,0.6666666666666666,18,9,9,301.24175031560173,0.41125508130081306,0.13841612014820437,0.17742994958780156,131541.7534722221,-274.82638888889454,131266.9270833332,500,2,258.2439024390244,39,2,19,35.81607094503115,0.6303418803418804,43.541666666666664,1025.8333333333326,26.303418803418783,0
509,4,0,0,41,0.0,0.0,1.0,41,1200,800,400,0.6666666666666666,16,8,8,306.1356257378988,0.4105182926829268,0.15129078238834404,0.18132648601398604,131755.55555555542,-132.9861111111204,131622.5694444443,501,3,259.2439024390244,39,2,17,35.47585227272727,0.6324786324786326,43.33333333333333,1026.6666666666656,26.3247863247863,0
510,4,0,0,41,0.0,0.0,1.0,41,1000,700,300,0.7,13,7,6,309.30397567016945,0.41023882113821136,0.1546998761075522,0.1841077315651707,131942.77479383667,-37.91503906250435,131904.85975477417,502,4,260.2439024390244,39,2,18,35.206601270742524,0.6343482905982907,43.151041666666664,1027.3958333333323,26.34348290598288,0
511,4,0,1,40,0.0,0.024390243902439025,0.975609756097561,41,750,600,150,0.8,9,6,3,312.1192609402115,0.41049288617886176,0.15541621106970438,0.18243120438911836,131248.05908203128,-6.99055989583249,131241.06852213544,503,5,261.2439024390244,39,2,19,35.832507370133165,0.6274038461538461,43.828125,1024.6875000000002,26.274038461538467,1
512,4,1,1,40,0.024390243902439025,0.024390243902439025,0.975609756097561,41,1150,1000,150,0.8695652173913043,13,10,3,310.31149042405264,0.4110264227642277,0.15403775963561972,0.18201400135141876,131382.88498064154,-46.05181502654253,131336.83316561498,504,0,262.0,38,3,19,35.743191607614264,0.6304824561403508,43.6965811965812,1025.2136752136762,26.979307242465165,0
513,4,1,0,41,0.024390243902439025,0.0,1.0,41,1150,900,250,0.782608695652174,14,9,5,312.3537800068648,0.40998475609756097,0.17037101010460276,0.18400128807520935,131547.2334082109,17.855120899988094,131565.0885291109,505,0,262.9756097560976,38,3,21,35.52558494758037,0.6321271929824561,43.53632478632478,1025.8547008547,26.99617633828158,0
514,4,0,0,41,0.0,0.0,1.0,41,450,300,150,0.6666666666666666,6,3,3,312.60830022170694,0.4096798780487805,0.1726289802729324,0.1842834565395367,131574.63480029584,26.26458744246375,131600.89938773832,506,1,263.9756097560976,38,3,18,35.49151306883263,0.6324013157894738,43.50961538461538,1025.961538461538,26.998987854251002,0
515,4,1,0,42,0.023809523809523808,0.0,1.0,42,650,400,250,0.6153846153846154,9,4,5,316.40319219359833,0.41234756097560976,0.20426573224059585,0.18873239989008683,132023.05230034707,-45.49696180557339,131977.5553385415,507,0,258.6666666666667,39,3,20,34.94366173390093,0.6351495726495727,43.07291666666666,1027.7083333333321,26.351495726495695,0
516,4,0,1,41,0.0,0.023809523809523808,0.9761904761904762,42,1500,1300,200,0.8666666666666667,17,13,4,315.7758180458837,0.4111377274487031,0.20288492143869985,0.18942712195534947,132237.24500868042,-48.53515625000841,132188.70985243042,508,1,259.6666666666667,39,3,20,34.74486867868477,0.6372863247863249,42.86458333333333,1028.5416666666656,26.372863247863222,0
517,4,0,0,41,0.0,0.0,1.0,41,1000,600,400,0.6,14,6,8,323.02138082579734,0.4118140243902439,0.19975782017894983,0.19389338245578405,132260.59701219955,344.60013514500594,132605.19714734456,509,2,255.02439024390245,38,3,21,34.53512325162721,0.6392543859649124,42.84188034188034,1028.6324786324785,27.069275753486277,0
518,4,0,0,41,0.0,0.0,1.0,41,800,400,400,0.5,12,4,8,322.4187986822782,0.4118140243902439,0.20211157567914562,0.19395474391686585,132343.0323275075,333.97629940097954,132677.00862690847,510,3,256.0243902439024,38,3,21,34.46790745163188,0.6400767543859649,42.761752136752136,1028.9529914529917,27.077710301394518,0
519,4,0,0,41,0.0,0.0,1.0,41,850,500,350,0.5882352941176471,12,5,7,320.6179860645788,0.41122967479674793,0.20075446600226599,0.19344226562816613,132454.43309479833,293.46613111017973,132747.8992259085,511,4,257.0243902439024,37,4,21,34.402517398096876,0.6430180180180181,42.65350877192982,1029.38596491228,27.82124229492649,0
520,4,0,0,41,0.0,0.0,1.0,41,1350,900,450,0.6666666666666666,18,9,9,321.2524412662625,0.41100101626016255,0.19632666413953914,0.19469970537130765,132623.79410010765,321.14352493074006,132944.9376250384,512,5,258.0243902439024,37,4,21,34.21643247462919,0.6447072072072072,42.489035087719294,1030.0438596491222,27.83902323376006,0
521,4,0,0,41,0.0,0.0,1.0,41,1600,1200,400,0.75,20,12,8,319.295466852647,0.4108231707317073,0.1885689068151173,0.1941481286769044,132746.64849175335,277.08062065971677,133023.72911241307,513,6,259.0243902439024,39,2,17,34.143775902153045,0.6423611111111112,42.369791666666664,1030.5208333333326,26.423611111111093,0
522,4,0,0,41,0.0,0.0,1.0,41,1350,900,450,0.6666666666666666,18,9,9,321.01682886008035,0.4105436991869919,0.1889701677938369,0.19561468832508333,132827.1701388888,327.95138888888397,133155.12152777766,514,7,260.0243902439024,39,2,18,34.01879547291837,0.6431623931623932,42.291666666666664,1030.8333333333326,26.43162393162391,0
523,4,1,0,42,0.023809523809523808,0.0,1.0,42,1200,800,400,0.6666666666666666,16,8,8,316.42881485998436,0.410774777390631,0.19626212044487001,0.19453093484975795,133157.367473065,26.96559587548046,133184.3330689405,515,0,254.8095238095238,40,2,19,33.80678088486281,0.6447916666666667,41.97154471544716,1032.1138211382117,25.802845528455293,0
524,4,0,0,42,0.0,0.0,1.0,42,1200,900,300,0.75,15,9,6,313.51040827081647,0.4103150406504065,0.18811867266591653,0.19328068859414424,133262.27774472875,-44.177779430223666,133218.09996529852,516,1,255.8095238095238,40,2,19,33.777271981627294,0.6458333333333333,41.869918699187,1032.5203252032527,25.813008130081318,0
525,4,0,0,42,0.0,0.0,1.0,42,900,600,300,0.6666666666666666,12,6,6,311.64603792773846,0.41006097560975613,0.18609756211842177,0.1925385217908576,133340.98755907535,-88.9619067684522,133252.0256523069,517,2,256.8095238095238,40,2,19,33.746802125356666,0.6466145833333332,41.79369918699187,1032.8252032520331,25.820630081300827,0
526,4,0,0,42,0.0,0.0,1.0,42,1000,700,300,0.7,13,7,6,309.3299983160969,0.40923828881145957,0.17975499768203096,0.19192048522735744,133498.47690073698,-140.98327301870637,133357.49362771827,518,3,257.8095238095238,40,2,19,33.6494493067165,0.6481770833333333,41.641260162601625,1033.4349593495933,25.835873983739834,0
527,4,0,1,41,0.0,0.023809523809523808,0.9761904761904762,42,1650,1300,350,0.7878787878787878,20,13,7,307.5689545238918,0.40941976384049555,0.10930147110778199,0.18300262279470458,131927.76626222857,-267.68272027228306,131660.0835419563,519,4,258.8095238095238,40,2,15,35.26622316747453,0.6325520833333331,43.165650406504085,1027.3373983739868,25.683434959349672,4
528,4,0,0,41,0.0,0.0,1.0,41,1000,500,500,0.5,15,5,10,305.73745850884063,0.40767276422764226,0.116135288541096,0.18216331425945173,131979.97352972813,-129.75566379134494,131850.21786593678,520,5,265.1951219512195,40,1,15,35.26089572412886,0.6330729166666664,43.11483739837401,1027.5406504065077,25.688516260162693,0
529,4,0,0,41,0.0,0.0,1.0,41,1100,500,600,0.45454545454545453,17,5,12,306.71093062911154,0.40769817073170733,0.11717156127463979,0.18312127227761743,132058.30379569068,-99.2549491043394,131959.04884658635,521,6,266.1951219512195,40,1,15,35.15733142179159,0.6338541666666665,43.038617886178876,1027.8455284552867,25.69613821138217,0
530,4,0,0,41,0.0,0.0,1.0,41,1000,700,300,0.7,13,7,6,330.24098353814134,0.4084603658536585,0.08124153733986073,0.19439875431941714,131519.8348696946,799.9147670815564,132319.74963677616,522,7,267.1951219512195,38,3,16,35.094434607506166,0.6318530701754386,43.56303418803419,1025.7478632478628,26.99336482231218,8
531,4,0,0,41,0.0,0.0,1.0,41,1200,700,500,0.5833333333333334,17,7,10,331.913197991887,0.40797764227642275,0.08303325042382848,0.19645673070330608,131728.82080078125,544.5068359375002,132273.32763671875,523,8,268.1951219512195,39,2,13,34.84113394216134,0.6322115384615385,43.359375,1026.5625,26.322115384615383,0
532,4,0,1,40,0.0,0.024390243902439025,0.975609756097561,41,950,700,250,0.7368421052631579,12,7,5,330.3221426957048,0.40744410569105693,0.08753568972086567,0.1959275380682466,131809.033203125,507.8884548611119,132316.92165798612,524,9,269.1951219512195,39,2,14,34.8012612429837,0.6330128205128205,43.28125,1026.875,26.330128205128204,0
533,4,0,1,39,0.0,0.025,0.975,40,1100,900,200,0.8181818181818182,13,9,4,332.7707092117909,0.4068509615384615,0.09016491520133174,0.19730162160607792,131793.94866544305,771.4331534443708,132565.38181888743,525,10,273.8,38,2,14,34.75358096625394,0.6345942982456141,43.29594017094017,1026.8162393162393,27.021479982006298,0
534,4,0,0,39,0.0,0.0,1.0,39,1150,800,350,0.6956521739130435,15,8,7,336.69136205816494,0.404661493477283,0.10362609209748408,0.20013481470564,131890.67790089242,1081.2903970452282,132971.96829793765,526,11,280.56410256410254,37,2,15,34.55557927697124,0.6373873873873874,43.201754385964904,1027.1929824561391,27.761972498814572,0
535,4,0,1,38,0.0,0.02564102564102564,0.9743589743589743,39,1200,900,300,0.75,15,9,6,357.0721239595719,0.4049707602339181,0.13120026525198947,0.19913637682360738,129424.43828870416,1453.1716489689047,130877.60993767306,527,12,281.56410256410254,37,2,15,36.530621408045974,0.6126126126126126,45.614035087719294,1017.5438596491223,27.501185395922224,8
536,4,1,0,39,0.02564102564102564,0.0,1.0,39,950,400,550,0.42105263157894735,15,4,11,359.61780887896606,0.407557354925776,0.14896030871916333,0.20184228559980144,129675.5988020352,1526.7309412511502,131202.32974328633,528,0,281.79487179487177,37,2,15,36.21028008038183,0.6151463963963963,45.36732456140351,1018.5307017543856,27.527856804172586,0
537,4,0,0,39,0.0,0.0,1.0,39,1300,800,500,0.6153846153846154,18,8,10,355.9530932973137,0.40769793072424654,0.14921023874962747,0.20021284158103148,129759.37307633119,1437.6500461680534,131197.02312249923,529,1,282.79487179487177,37,2,15,36.218431625771274,0.6159909909909909,45.28508771929825,1018.8596491228071,27.53674727358938,0
538,4,0,0,39,0.0,0.0,1.0,39,900,700,200,0.7777777777777778,11,7,4,360.0330281266296,0.40831646423751683,0.15004564472134652,0.2032317584998955,129899.05698147518,1553.5901671668316,131452.64714864202,530,2,283.79487179487177,37,2,16,35.97251353483202,0.6173986486486486,45.14802631578948,1019.407894736843,27.55156472261738,0
539,4,1,0,40,0.025,0.0,1.0,40,1150,1000,150,0.8695652173913043,13,10,3,351.54323890203386,0.4106169871794872,0.17167563206024727,0.19815611919917553,129843.17440221988,1136.9159260541635,130980.09032827405,531,0,277.675,37,3,14,36.24562937062936,0.6168355855855856,45.20285087719298,1019.1885964912278,27.545637743006157,2
540,4,0,0,40,0.0,0.0,1.0,40,950,800,150,0.8421052631578947,11,8,3,351.61607827918516,0.4103632478632479,0.1685456110154906,0.19833877813612283,129871.11418898118,1132.9543705755566,131004.06855955673,532,1,278.675,37,3,15,36.215397303499714,0.617117117117117,45.175438596491226,1019.2982456140348,27.54860123281175,0
541,4,0,1,39,0.0,0.025,0.975,40,850,600,250,0.7058823529411765,11,6,5,353.847474657462,0.41010950854700856,0.1639366734759704,0.20031256006019812,130010.85820877583,1200.8027710449428,131211.66097982076,533,2,279.675,37,3,15,36.0166245564993,0.6185247747747746,45.03837719298246,1019.8464912280706,27.563418681839746,0
542,4,2,1,40,0.04878048780487805,0.024390243902439025,0.975609756097561,41,1450,1000,450,0.6896551724137931,19,10,9,342.4174761887979,0.41763211382113824,0.16861225811881653,0.1961976228156664,130480.80490037616,736.0250453491219,131216.82994572527,534,0,270.7560975609756,38,3,16,35.83189550001742,0.621436403508772,44.57799145299145,1021.6880341880337,26.886527215474572,0
543,4,0,0,40,0.0,0.0,1.0,40,1300,1100,200,0.8461538461538461,15,11,4,347.2905284102746,0.41404914529914527,0.1722088030059048,0.19858878282023973,130402.54122662733,1057.5134897275989,131460.05471635493,535,1,278.525,37,3,16,35.7867015566291,0.6224662162162162,44.65460526315789,1021.3815789473678,27.60490753911805,0
544,4,0,0,40,0.0,0.0,1.0,40,1300,1100,200,0.8461538461538461,15,11,4,346.47843038488384,0.4137820512820513,0.17222073183817987,0.19869738416964494,130514.55886667041,1044.095899699892,131558.6547663703,536,2,279.525,37,3,13,35.69398987731157,0.6235923423423424,44.54495614035087,1021.8201754385957,27.616761498340423,0
545,4,0,1,39,0.0,0.025,0.975,40,1100,800,300,0.7272727272727273,14,8,6,342.95988894139884,0.4128739316239316,0.1676630434782609,0.19720193614130432,130617.28395061727,959.2978395061696,131576.58179012345,537,3,280.525,38,2,13,35.67991394927535,0.6228070175438596,44.44444444444444,1022.2222222222222,26.900584795321635,0
546,4,2,2,39,0.04878048780487805,0.04878048780487805,0.9512195121951219,41,850,500,350,0.5882352941176471,12,5,7,335.1234506419315,0.41562499999999997,0.16720517354130826,0.19417106720162547,130911.78882444312,574.3220801110444,131486.11090455417,538,0,274.5609756097561,40,1,15,35.582588546838785,0.6223958333333334,44.15650406504065,1023.3739837398374,25.584349593495936,0
547,4,1,0,40,0.025,0.0,1.0,40,1100,900,200,0.8181818181818182,13,9,4,335.5414373960587,0.4176148504273504,0.17032044760935938,0.1951699603315535,131061.33355034716,795.3016493055502,131856.63519965272,539,0,272.325,39,1,17,35.420905391658195,0.625534188034188,44.010416666666664,1023.9583333333328,26.255341880341867,0
548,4,0,1,39,0.0,0.025,0.975,40,1150,900,250,0.782608695652174,14,9,5,339.4054776201841,0.41792200854700856,0.17113624809354389,0.1981040280352824,131194.69536675338,905.6396484374906,132100.33501519088,540,1,273.325,39,1,17,35.187362311472626,0.6268696581196582,43.88020833333333,1024.4791666666658,26.26869658119656,0
549,4,0,0,39,0.0,0.0,1.0,39,1350,1100,250,0.8148148148148148,16,11,5,348.33835153147527,0.4176506972559604,0.16860738649729545,0.2037354553591408,131273.37643363274,1345.5103093724836,132618.88674300522,541,2,267.97435897435895,38,1,17,34.87910932721715,0.6293859649122808,43.8034188034188,1024.786324786324,26.968061178587476,0
550,4,1,1,39,0.025,0.025,0.975,40,900,500,400,0.5555555555555556,13,5,8,346.245640338407,0.420579594017094,0.16341632827527253,0.20429802662590255,131609.2511638197,1113.848717283471,132723.09988110315,542,0,262.25,37,3,13,34.593841276626065,0.634572072072072,43.47587719298246,1026.0964912280706,27.732337600758665,0
551,4,1,0,40,0.025,0.0,1.0,40,950,600,350,0.631578947368421,13,6,7,348.1933743253222,0.4203392094017094,0.1775421918393505,0.2060547642499158,131721.78578985843,1172.93061326562,132894.71640312404,543,0,263.225,37,3,14,34.43041016876735,0.6356981981981982,43.36622807017544,1026.5350877192984,27.74419155998104,0
552,4,0,0,40,0.0,0.0,1.0,40,1100,800,300,0.7272727272727273,14,8,6,347.6323683746346,0.4202991452991453,0.17516010246557823,0.2067915974159971,131918.83710612892,1171.851555286256,133090.6886614152,544,1,264.225,37,3,14,34.24625093393105,0.6376689189189189,43.174342105263165,1027.3026315789484,27.764935988620227,0
553,4,0,0,40,0.0,0.0,1.0,40,400,100,300,0.25,7,1,6,347.8227842982307,0.41991185897435895,0.17083866837387918,0.2073661026999378,132003.3327562329,1182.7533471837687,133186.0861034167,545,2,265.225,37,3,14,34.15626333760136,0.6385135135135134,43.092105263157904,1027.6315789473701,27.773826458037032,0
554,4,0,1,39,0.0,0.025,0.975,40,1350,1100,250,0.8148148148148148,16,11,5,347.6523803255033,0.41969818376068374,0.1754157139887751,0.20777088220447193,132095.80342793508,1184.6840985463016,133280.4875264814,546,3,266.225,38,2,14,34.067544862467955,0.6376096491228069,43.002136752136764,1027.991452991455,27.052406657669867,0
555,4,0,0,39,0.0,0.0,1.0,39,900,500,400,0.5555555555555556,13,5,8,353.87412826673443,0.4143049932523617,0.17482492623795798,0.21175990432400604,132144.21895439006,1552.4840575946744,133696.70301198473,547,4,273.87179487179486,37,2,16,33.85888788169636,0.639921171171171,42.95504385964914,1028.1798245614057,27.78864390706502,0
556,4,0,1,38,0.0,0.02564102564102564,0.9743589743589743,39,900,700,200,0.7777777777777778,11,7,4,352.8007408699676,0.41391138101664415,0.16805776473224765,0.21190630927285792,132285.18029586045,1534.0619228993796,133819.24221875984,548,5,274.87179487179486,37,2,17,33.74458182334969,0.6413288288288287,42.81798245614036,1028.7280701754403,27.80346135609298,0
557,4,0,0,38,0.0,0.0,1.0,38,900,400,500,0.4444444444444444,14,4,10,350.95102739320976,0.41262150308202944,0.16954297799321227,0.21111863490468494,132343.03232750762,1689.184632734326,134032.21696024196,549,6,280.2631578947368,38,0,18,33.73394939950852,0.6400767543859648,42.76175213675214,1028.9529914529926,27.077710301394543,0
558,4,0,1,37,0.0,0.02631578947368421,0.9736842105263158,38,1050,600,450,0.5714285714285714,15,6,9,352.49139118334176,0.4118065433854907,0.1724865855914952,0.21251359595619984,132426.21678064414,1735.831690705452,134162.04847134958,550,7,281.2631578947368,37,1,19,33.61064504101416,0.6427364864864864,42.68092105263158,1029.2763157894744,27.81827880512093,0
559,4,0,0,37,0.0,0.0,1.0,37,950,800,150,0.8421052631578947,11,8,3,359.5906838216214,0.40897147147147145,0.17664339531347162,0.2163076267296216,132341.58587257622,2117.760272391507,134459.34614496774,551,8,289.35135135135135,37,0,19,33.513160699062226,0.6418918918918919,42.76315789473684,1028.947368421053,27.809388335704135,0
560,4,0,0,37,0.0,0.0,1.0,37,1250,900,350,0.72,16,9,7,357.6756412527713,0.4085960960960961,0.1655508900585494,0.21564349347297698,132426.97934420913,2073.1929741516396,134500.17231836077,552,9,290.35135135135135,36,1,19,33.47647702407004,0.6446759259259258,42.68018018018019,1029.2792792792798,28.591091091091105,0
561,4,1,1,37,0.02631578947368421,0.02631578947368421,0.9736842105263158,38,900,500,400,0.5555555555555556,13,5,8,345.94650801725027,0.4102358937885254,0.1530705954160858,0.21045639021709608,132765.0109288435,1585.9183835410922,134350.92931238457,553,0,283.6842105263158,37,1,15,33.43873018406215,0.6461148648648647,42.35197368421053,1030.592105263158,27.853840682788054,0
562,4,0,1,36,0.0,0.02702702702702703,0.972972972972973,37,850,700,150,0.8235294117647058,10,7,3,355.90008085471595,0.40790790790790793,0.1534998050083316,0.21590012862459837,132658.90045450866,2042.6626795714822,134701.56313408015,554,11,292.35135135135135,36,1,15,33.28892471942866,0.6469907407407407,42.454954954954964,1030.1801801801812,28.616116116116146,0
563,4,1,1,36,0.02702702702702703,0.02702702702702703,0.972972972972973,37,750,300,450,0.4,12,3,9,353.7222069018628,0.40919044044044045,0.15163245841711892,0.21541046971209274,132803.95418645005,1995.1415520250052,134799.09573847507,555,0,291.1621621621622,36,1,16,33.199269820459584,0.6484375,42.31418918918919,1030.7432432432438,28.631756756756772,0
564,4,0,0,36,0.0,0.0,1.0,36,1250,1100,150,0.88,14,11,3,360.3326774824784,0.40558862433862436,0.1570809158400397,0.21932757983468693,132785.41512613598,2369.3848326045913,135154.79995874056,556,13,300.25,35,1,16,33.04756223095638,0.6502976190476191,42.332175925925924,1030.6712962962963,29.447751322751323,0
565,4,0,0,36,0.0,0.0,1.0,36,850,700,150,0.8235294117647058,10,7,3,361.6340446656544,0.40489417989417986,0.16224130833426953,0.22047052948918427,132845.06715374216,2408.259789737643,135253.3269434798,557,14,301.25,35,1,17,32.95406702593466,0.6508928571428572,42.27430555555555,1030.9027777777767,29.454365079365047,0
566,4,0,0,36,0.0,0.0,1.0,36,450,100,350,0.2222222222222222,8,1,7,356.940007030458,0.40459656084656087,0.15953752540555355,0.21830421432041242,132964.41139671198,2292.0635877486034,135256.47498446057,558,15,302.25,35,1,17,32.955172446040464,0.6520833333333333,42.1585648148148,1031.3657407407395,29.467592592592556,0
567,4,0,0,36,0.0,0.0,1.0,36,800,400,400,0.5,12,4,8,360.99292775897817,0.40385251322751325,0.16513973026201056,0.22131299573889449,133053.95474322676,2406.30733453358,135460.26207776033,559,16,303.25,35,1,17,32.76073218158703,0.6529761904761906,42.071759259259245,1031.7129629629608,29.477513227513164,0
568,4,0,0,36,0.0,0.0,1.0,36,800,600,200,0.75,10,6,4,361.4715360411848,0.40315806878306876,0.16782563182294008,0.22196144733768608,133113.66705246907,2423.360339506167,135537.02739197525,560,17,304.25,35,1,17,32.688425302826374,0.6535714285714285,42.013888888888886,1031.9444444444441,29.484126984126974,0
569,4,0,1,35,0.0,0.027777777777777776,0.9722222222222222,36,1150,800,350,0.6956521739130435,15,8,7,363.0963230120533,0.403207671957672,0.17073102365736115,0.2234959354689095,133203.26063368033,2473.1228298610868,135676.38346354142,561,18,305.25,35,1,17,32.55655062226708,0.6544642857142857,41.92708333333332,1032.291666666665,29.49404761904757,0
570,4,0,0,35,0.0,0.0,1.0,35,900,600,300,0.6666666666666666,12,6,6,374.31490608061665,0.40231092436974786,0.1689300547168573,0.22978481628234995,133103.4297052152,2964.5195578231037,136067.94926303832,562,19,300.2,34,1,17,32.36737617289647,0.6556372549019609,42.02380952380951,1031.9047619047603,30.35014005602236,0
571,4,1,1,35,0.027777777777777776,0.027777777777777776,0.9722222222222222,36,800,400,400,0.5,12,4,8,368.9609693922913,0.40472883597883597,0.16286110799945264,0.22857144856106743,133442.32420535389,2647.001859353544,136089.32606470742,563,0,292.8333333333333,35,1,17,32.16517773794853,0.6568452380952381,41.69560185185184,1033.217592592591,29.5205026455026,0
572,4,0,0,35,0.0,0.0,1.0,35,750,400,350,0.5333333333333333,11,4,7,376.4259563842215,0.4012955182072829,0.17098718666622803,0.23222750680488868,133287.7621882085,3034.5946712017994,136322.3568594103,564,21,302.2,34,1,17,32.127622780723996,0.6574754901960785,41.84523809523809,1032.6190476190466,30.371148459383722,0
573,4,0,0,35,0.0,0.0,1.0,35,700,300,400,0.42857142857142855,11,3,8,375.5323545061196,0.40119047619047615,0.16901222984873177,0.2326370667208147,133441.47002551032,3022.317885487539,136463.78791099787,565,22,303.2,34,1,18,31.996293735837458,0.6590073529411764,41.69642857142858,1033.2142857142865,30.388655462184897,0
574,4,0,0,35,0.0,0.0,1.0,35,900,700,200,0.7777777777777778,11,7,4,371.4960498307025,0.40119047619047615,0.14366499052015524,0.22749210401293535,133011.3112953514,2882.63534580498,135893.94664115636,566,23,304.2,34,1,16,32.532698595883836,0.654718137254902,42.113095238095234,1031.5476190476184,30.339635854341715,1
575,4,0,0,35,0.0,0.0,1.0,35,500,200,300,0.4,8,2,6,373.1678770669003,0.4014705882352941,0.14758773014224702,0.22889214370409236,133072.72002551024,2931.6928854875327,136004.41291099778,567,24,305.2,34,1,16,32.42783931387254,0.6553308823529411,42.05357142857143,1031.7857142857147,30.346638655462197,0
576,4,1,0,36,0.027777777777777776,0.0,1.0,36,750,500,250,0.6666666666666666,10,5,5,363.485064614081,0.40625,0.14605975723622833,0.22481664599311657,133382.53821855705,2496.5121045524675,135879.05032310952,568,0,297.69444444444446,35,1,17,32.366596638655466,0.65625,41.75347222222222,1032.9861111111109,29.513888888888882,0
577,4,1,1,36,0.02702702702702703,0.02702702702702703,0.972972972972973,37,1000,800,200,0.8,12,8,4,353.5514973059378,0.40759509509509506,0.13415506326319782,0.22041163610050418,133675.94103816646,2052.265821564797,135728.20685973126,569,0,290.6216216216216,36,1,17,32.329213401575366,0.6571180555555556,41.46959459459459,1034.121621621621,28.725600600600583,0
578,4,0,0,36,0.0,0.0,1.0,36,1550,1400,150,0.9032258064516129,17,14,3,357.59437576929724,0.4057705026455027,0.1406798000149243,0.22278578473660393,133651.6806520061,2358.617862654309,136010.2985146604,570,2,299.69444444444446,35,1,18,32.2489926124916,0.6589285714285715,41.49305555555555,1034.0277777777771,29.543650793650777,0
579,4,0,0,36,0.0,0.0,1.0,36,850,600,250,0.7058823529411765,11,6,5,356.47325768360946,0.40539021164021166,0.1411265259441581,0.2228082501521749,133771.38658479083,2337.1843921467803,136108.5709769376,571,3,300.69444444444446,35,1,17,32.15810770493025,0.6601190476190476,41.37731481481482,1034.490740740741,29.556878306878318,0
580,4,0,0,36,0.0,0.0,1.0,36,1050,600,450,0.5714285714285714,15,6,9,360.05176922251997,0.4049768518518519,0.14805807148980632,0.22596091032680662,133921.09435281626,2443.7053915895003,136364.79974440575,572,4,301.69444444444446,35,1,17,31.91567427037907,0.6616071428571428,41.232638888888886,1035.069444444444,29.57341269841268,0
581,4,0,1,35,0.0,0.027777777777777776,0.9722222222222222,36,500,200,300,0.4,8,2,6,359.7018698736882,0.4048611111111111,0.15141125024845925,0.2259251070330244,133951.04595336076,2436.4883401920415,136387.5342935528,573,5,302.69444444444446,35,1,17,31.894752534287402,0.6619047619047619,41.2037037037037,1035.1851851851852,29.57671957671958,0
582,4,0,0,35,0.0,0.0,1.0,35,950,600,350,0.631578947368421,13,6,7,368.0763766203228,0.4012254901960784,0.15217712904975578,0.2303061043345735,133810.73022959186,2850.5137471655357,136661.2439767574,574,6,311.34285714285716,34,1,17,31.818595865454682,0.6626838235294117,41.339285714285715,1034.6428571428573,30.430672268907568,0
583,4,0,0,35,0.0,0.0,1.0,35,800,500,300,0.625,11,5,6,368.7517794426878,0.40017507002801117,0.15263287603713183,0.2315015683938029,133933.9303429705,2877.6750283446713,136811.60537131518,575,7,312.34285714285716,34,1,18,31.677688326624487,0.6639093137254901,41.220238095238095,1035.1190476190475,30.444677871148457,0
584,4,0,0,35,0.0,0.0,1.0,35,1050,900,150,0.8571428571428571,12,9,3,371.667228602014,0.3997549019607843,0.15389416286174185,0.2339190705050881,134026.36763038547,2962.6417233560064,136989.00935374148,576,8,313.34285714285716,34,1,18,31.509638231010964,0.664828431372549,41.13095238095238,1035.4761904761904,30.45518207282913,0
585,4,0,0,35,0.0,0.0,1.0,35,950,700,250,0.7368421052631579,12,7,5,366.730920139918,0.39842436974789913,0.15354311321219272,0.23178352926490253,134180.50063775518,2841.627692743773,137022.12833049896,577,9,314.34285714285716,34,1,19,31.483157148875854,0.666360294117647,40.98214285714286,1036.0714285714294,30.472689075630274,0
586,4,0,0,35,0.0,0.0,1.0,35,800,700,100,0.875,9,7,2,367.34419172565833,0.3984943977591036,0.15331090506277212,0.23256226828886212,134242.1786422902,2862.6169217686997,137104.7955640589,578,10,315.34285714285716,34,1,19,31.40556193758377,0.6669730392156863,40.922619047619044,1036.3095238095234,30.47969187675069,0
587,4,0,0,35,0.0,0.0,1.0,35,1200,700,500,0.5833333333333334,17,7,10,369.2115463375657,0.3978991596638655,0.15101150141921993,0.23413874245893512,134303.87081916077,2917.3079648525845,137221.17878401335,579,11,316.34285714285716,34,1,19,31.295461506067916,0.6675857843137256,40.86309523809523,1036.5476190476172,30.486694677871096,0
588,4,0,0,35,0.0,0.0,1.0,35,900,700,200,0.7777777777777778,11,7,4,371.2127752420779,0.3975490196078431,0.148941404135986,0.23620412601415186,134427.29768990917,2980.2260487528224,137407.52373866198,580,12,317.34285714285716,34,1,20,31.120135460911506,0.6688112745098039,40.74404761904761,1037.0238095238085,30.500700280112014,0
589,4,0,0,35,0.0,0.0,1.0,35,950,600,350,0.631578947368421,13,6,7,368.86501830615657,0.3970238095238095,0.15215146299483684,0.23550612707239205,134550.78124999974,2926.2152777777487,137476.9965277775,581,13,318.34285714285716,34,1,20,31.057563587684076,0.6700367647058825,40.624999999999986,1037.499999999998,30.51470588235288,0
590,4,0,0,35,0.0,0.0,1.0,35,1200,900,300,0.75,15,9,6,363.77863470078535,0.39576330532212883,0.1461824495880224,0.23344470001659634,134736.11288265281,2802.8238378684478,137538.93672052128,582,14,319.34285714285716,34,1,21,31.00442418682872,0.6718750000000002,40.446428571428555,1038.2142857142837,30.535714285714228,0
591,4,0,0,35,0.0,0.0,1.0,35,900,600,300,0.6666666666666666,12,6,6,361.5824412143989,0.39544817927170867,0.1402216438311319,0.23322468325780163,134921.57206632633,2757.0542800453277,137678.62634637166,583,15,320.34285714285716,34,1,20,30.87639891524389,0.6737132352941178,40.26785714285713,1038.9285714285697,30.55672268907558,0
592,4,0,1,34,0.0,0.02857142857142857,0.9714285714285714,35,750,600,150,0.8,9,6,3,359.16833921861553,0.395063025210084,0.13609806392484813,0.23206368860394458,134983.4201388887,2696.3541666666424,137679.77430555533,584,16,321.34285714285716,34,1,20,30.87743918738305,0.674325980392157,40.20833333333332,1039.1666666666652,30.563725490196035,0
593,4,0,0,34,0.0,0.0,1.0,34,850,700,150,0.8235294117647058,10,7,3,359.39453819497766,0.3935680332739156,0.1162657502863691,0.23240846803275214,135014.3494897958,2904.6839569160893,137919.0334467119,585,17,314.88235294117646,34,0,20,30.840731195112646,0.6746323529411765,40.17857142857142,1039.2857142857135,30.56722689075628,0
594,4,0,0,34,0.0,0.0,1.0,34,1200,1000,200,0.8333333333333334,14,10,4,359.6111790681408,0.3931409685086156,0.11825678616424273,0.23274760596322702,135045.28238378663,2912.75864512469,137958.0410289113,586,18,315.88235294117646,34,0,20,30.804270224869253,0.6749387254901962,40.14880952380951,1039.40476190476,30.570728291316474,0
595,4,0,0,34,0.0,0.0,1.0,34,950,500,450,0.5263157894736842,14,5,9,360.06119248010094,0.392621063576946,0.12338799286171276,0.2338389974954409,135169.04939058944,2933.825821995451,138102.87521258488,587,19,316.88235294117646,34,0,20,30.669242510971188,0.6761642156862746,40.0297619047619,1039.8809523809514,30.584733893557395,0
596,4,0,0,34,0.0,0.0,1.0,34,900,700,200,0.7777777777777778,11,7,4,357.98302925706776,0.3922311348781937,0.12184200603318263,0.2326889690170939,135199.99999999988,2879.8611111110963,138079.86111111098,588,20,317.88235294117646,34,0,20,30.69244123931624,0.6764705882352942,39.99999999999999,1039.999999999999,30.58823529411762,0
597,4,0,0,34,0.0,0.0,1.0,34,850,500,350,0.5882352941176471,12,5,7,356.18890796310257,0.3918040701128936,0.12026884217470046,0.23212042257192778,135292.87308673456,2837.9641439909137,138130.83723072548,589,21,318.88235294117646,34,0,20,30.6466224205668,0.677389705882353,39.91071428571428,1040.3571428571418,30.598739495798288,0
598,4,0,0,34,0.0,0.0,1.0,34,850,600,250,0.7058823529411765,11,6,5,354.9535448719048,0.3910427807486631,0.12199389021222817,0.23191359411585857,135385.77806122432,2811.1323696144937,138196.91043083882,590,22,319.88235294117646,34,0,20,30.58629794860062,0.6783088235294118,39.82142857142856,1040.7142857142844,30.609243697478952,0
599,4,0,0,34,0.0,0.0,1.0,34,950,800,150,0.8421052631578947,11,8,3,347.01515225283816,0.3911356209150327,0.04946722439689277,0.23049277853579314,135974.9167375282,2637.071286848054,138611.98802437625,591,23,320.88235294117646,34,0,15,30.207738842597884,0.6841299019607844,39.25595238095237,1042.9761904761892,30.675770308123212,4
600,4,0,0,34,0.0,0.0,1.0,34,1050,800,250,0.7619047619047619,13,8,5,347.3045474321749,0.3906899881164587,0.05555182711989559,0.23149234663444945,136099.1089143989,2653.567885487508,138752.67679988642,592,24,321.88235294117646,34,0,17,30.077010838562465,0.6853553921568629,39.13690476190475,1043.4523809523796,30.689775910364105,0
601,4,0,0,34,0.0,0.0,1.0,34,900,600,300,0.6666666666666666,12,6,6,349.1755958129095,0.39007724301841945,0.06128569128381267,0.23335149573838326,136192.29024943296,2711.0048185940827,138903.29506802704,593,25,322.88235294117646,34,0,17,29.935798737834535,0.6862745098039217,39.04761904761904,1043.8095238095227,30.700280112044787,0
602,4,0,0,34,0.0,0.0,1.0,34,700,400,300,0.5714285714285714,10,4,6,347.13813742469017,0.3892416815210933,0.06584197924980062,0.23260111561130273,136285.50347222202,2661.979166666642,138947.48263888864,594,26,323.88235294117646,34,0,18,29.896581537642998,0.6871936274509804,38.95833333333332,1044.166666666665,30.71078431372544,0
603,4,0,0,34,0.0,0.0,1.0,34,500,100,400,0.2,9,1,8,348.2017268314921,0.3884061200237671,0.0699258504404725,0.23392970530011567,136378.7485827664,2697.4631519274253,139076.21173469382,595,27,324.88235294117646,34,0,18,29.776422764227636,0.6881127450980393,38.86904761904761,1044.523809523809,30.721288515406144,0
604,4,0,0,34,0.0,0.0,1.0,34,750,500,250,0.6666666666666666,10,5,5,348.22556167411636,0.38801619132501486,0.0791674764927055,0.23456452454441423,136472.02558106574,2704.609552154196,139176.63513321994,596,28,325.88235294117646,34,0,18,29.68340549162585,0.689031862745098,38.779761904761905,1044.8809523809523,30.731792717086833,0
605,4,0,1,33,0.0,0.029411764705882353,0.9705882352941176,34,750,500,250,0.6666666666666666,10,5,5,347.2791163318749,0.38779337492572785,0.073504290681083,0.23475426639801333,136596.4445153061,2687.4185090702936,139283.8630243764,597,29,326.88235294117646,34,0,18,29.584946665148255,0.6902573529411764,38.660714285714285,1045.3571428571427,30.745798319327726,0
606,4,0,0,33,0.0,0.0,1.0,33,400,200,200,0.5,6,2,4,354.523257816021,0.3830097853535353,0.0913462051025089,0.23897389876657793,136496.7218888168,3078.2525050461404,139574.97439386294,598,55,336.90909090909093,33,0,18,29.494424572925233,0.6916035353535352,38.756127450980394,1044.9754901960785,31.66592394533571,0
607,4,0,0,33,0.0,0.0,1.0,33,850,600,250,0.7058823529411765,11,6,5,352.9505718278426,0.38304924242424243,0.0898857240320654,0.2381299427648611,136528.73894655914,3037.5792964244697,139566.3182429836,599,56,337.90909090909093,33,0,18,29.5037914321451,0.6919191919191918,38.72549019607844,1045.0980392156873,31.669637551990526,0
608,4,0,0,33,0.0,0.0,1.0,33,200,0,200,0.0,4,0,4,352.9505718278426,0.38304924242424243,0.0898857240320654,0.2381299427648611,136528.73894655914,3037.5792964244697,139566.3182429836,600,57,338.90909090909093,33,0,18,29.5037914321451,0.6919191919191918,38.72549019607844,1045.0980392156873,31.669637551990526,0
609,4,0,0,33,0.0,0.0,1.0,33,800,600,200,0.75,10,6,4,351.9702115902867,0.382260101010101,0.08525479833496674,0.23833411470542296,136656.8447231836,3019.827710495991,139676.6724336796,601,58,339.90909090909093,33,0,18,29.402543366150965,0.6931818181818181,38.6029411764706,1045.5882352941194,31.684491978609678,0
610,4,0,0,33,0.0,0.0,1.0,33,600,400,200,0.6666666666666666,8,4,4,353.209616057026,0.3820628156565657,0.08717670079442041,0.2393913942664499,136688.88055375344,3055.965403931192,139744.84595768462,602,59,340.90909090909093,33,0,18,29.338426305715075,0.6934974747474747,38.57230392156863,1045.710784313726,31.688205585264424,0
611,4,0,0,33,0.0,0.0,1.0,33,750,700,50,0.9333333333333333,8,7,1,352.53408676052743,0.382260101010101,0.08958106966075086,0.2391515020997095,136720.92013888908,3039.75694444447,139760.67708333355,603,60,341.90909090909093,33,0,18,29.32436918990704,0.6938131313131313,38.54166666666668,1045.8333333333348,31.691919191919236,0
612,4,0,0,33,0.0,0.0,1.0,33,700,500,200,0.7142857142857143,9,5,4,352.48401684507337,0.3818655303030303,0.08763913298183934,0.23933580618716813,136752.96347859016,3040.646776480224,139793.61025507038,604,61,342.90909090909093,33,0,18,29.29396114040227,0.6941287878787878,38.51102941176472,1045.9558823529426,31.695632798574017,0
613,4,0,0,33,0.0,0.0,1.0,33,900,400,500,0.4444444444444444,14,4,10,356.3993272521325,0.38143150252525254,0.09702080538341962,0.2426584893204712,136849.11602508664,3154.586577277991,140003.70260236462,605,62,343.90909090909093,33,0,18,29.09639259779808,0.6950757575757575,38.41911764705883,1046.3235294117658,31.706773618538357,0
614,4,0,0,33,0.0,0.0,1.0,33,1050,800,250,0.7619047619047619,13,8,5,356.8450438493055,0.3809185606060606,0.09048328720459886,0.24340708262564462,136913.23649557872,3171.361976163033,140084.59847174175,606,63,344.90909090909093,33,0,18,29.021272443403596,0.6957070707070707,38.35784313725491,1046.5686274509812,31.714200831847915,0
615,4,0,0,33,0.0,0.0,1.0,33,900,500,400,0.5555555555555556,13,5,8,356.4194669948865,0.38044507575757575,0.09288529836475057,0.24333962171089743,136945.30236267313,3161.9943351115126,140107.29669778465,607,64,345.90909090909093,33,0,19,29.000678101705503,0.6960227272727272,38.32720588235295,1046.6911764705892,31.717914438502703,0
616,4,0,0,33,0.0,0.0,1.0,33,950,800,150,0.8421052631578947,11,8,3,357.7895703091164,0.3798137626262626,0.09163607993333023,0.245173366342534,137073.60337670604,3208.7011305747756,140282.30450728082,608,65,346.90909090909093,33,0,17,28.837892529744497,0.6972853535353536,38.2046568627451,1047.1813725490192,31.732768865121795,0
617,4,0,0,33,0.0,0.0,1.0,33,850,600,250,0.7058823529411765,11,6,5,357.7895703091164,0.3798137626262626,0.09163607993333023,0.245173366342534,137073.60337670604,3208.7011305747756,140282.30450728082,609,66,347.90909090909093,33,0,17,28.837892529744497,0.6972853535353536,38.2046568627451,1047.1813725490192,31.732768865121795,0
618,4,0,0,33,0.0,0.0,1.0,33,1100,1000,100,0.9090909090909091,12,10,2,355.5239438311354,0.379498106060606,0.09689596869383998,0.24451924342818787,137201.9644637879,3155.7167015090267,140357.68116529693,610,67,348.90909090909093,33,0,18,28.77029964518267,0.6985479797979798,38.08210784313725,1047.6715686274504,31.747623291740922,0
619,4,0,0,33,0.0,0.0,1.0,33,1050,700,350,0.6666666666666666,14,7,7,356.1108528341897,0.3781565656565657,0.10284965375555677,0.24628361729963552,137394.61873137727,3185.5429702518113,140580.16170162908,611,68,349.90909090909093,33,0,18,28.564557763491134,0.7004419191919192,37.89828431372548,1048.4068627450972,31.76990493166961,0
620,4,0,0,33,0.0,0.0,1.0,33,850,600,250,0.7058823529411765,11,6,5,356.1108528341897,0.3781565656565657,0.10284965375555677,0.24628361729963552,137394.61873137727,3185.5429702518113,140580.16170162908,612,69,350.90909090909093,33,0,18,28.564557763491134,0.7004419191919192,37.89828431372548,1048.4068627450972,31.76990493166961,0
621,4,0,0,33,0.0,0.0,1.0,33,800,600,200,0.75,10,6,4,356.1108528341897,0.3781565656565657,0.10284965375555677,0.24628361729963552,137394.61873137727,3185.5429702518113,140580.16170162908,613,70,351.90909090909093,33,0,18,28.564557763491134,0.7004419191919192,37.89828431372548,1048.4068627450972,31.76990493166961,0
622,4,0,0,33,0.0,0.0,1.0,33,900,600,300,0.6666666666666666,12,6,6,356.6255114001449,0.3770517676767677,0.09630125297843506,0.2475553732419984,137523.13000108127,3208.851313196843,140731.98131427812,614,71,352.90909090909093,33,0,19,28.424149043891422,0.7017045454545455,37.775735294117645,1048.897058823529,31.78475935828876,0
623,4,0,0,33,0.0,0.0,1.0,33,900,700,200,0.7777777777777778,11,7,4,356.0432086912828,0.37665719696969696,0.09578617287096614,0.24784080917193194,137619.5528762975,3199.7014369473204,140819.25431324483,615,72,353.90909090909093,33,0,19,28.344234213190074,0.7026515151515151,37.68382352941176,1049.2647058823525,31.795900178253106,0
624,4,0,0,33,0.0,0.0,1.0,33,650,400,250,0.6153846153846154,9,4,5,358.212208485027,0.3763020833333333,0.10152665003803363,0.25004788636302006,137716.00954260383,3266.3111844002347,140982.32072700406,616,73,354.90909090909093,33,0,19,28.192133683596037,0.7035984848484849,37.591911764705884,1049.6323529411766,31.807040998217474,0
625,4,0,0,33,0.0,0.0,1.0,33,750,600,150,0.8,9,6,3,371.4627457972806,0.3763020833333333,0.12335633750816521,0.2524527068571325,136785.0105728564,3562.1071222606465,140347.11769511705,617,74,355.90909090909093,33,0,19,28.765912995938773,0.6944444444444444,38.480392156862735,1046.0784313725476,31.699346405228713,2
626,4,0,0,33,0.0,0.0,1.0,33,450,200,250,0.4444444444444444,7,2,5,373.5258536636756,0.37567077020202017,0.12429282281706744,0.25431927739876103,136849.11602508655,3623.3365772779744,140472.45260236453,618,75,356.90909090909093,33,0,20,28.648395408760834,0.6950757575757576,38.419117647058826,1046.323529411765,31.706773618538335,0
627,4,0,0,33,0.0,0.0,1.0,33,1000,600,400,0.6,14,6,8,374.1678345082073,0.37488162878787884,0.12376664431458972,0.2554570323368982,136945.3023626729,3648.105446222593,140593.40780889548,619,76,357.90909090909093,33,0,20,28.53625160988175,0.6960227272727273,38.327205882352935,1046.6911764705874,31.717914438502646,0
628,4,0,0,33,0.0,0.0,1.0,33,550,300,250,0.5454545454545454,8,3,5,373.59695289505635,0.375,0.12566730160081474,0.2555355299105256,137009.4453605583,3637.262260909249,140646.70762146756,620,77,358.90909090909093,33,0,15,28.4876263217449,0.6966540404040404,38.26593137254901,1046.9362745098028,31.725341651812208,0
629,4,0,0,33,0.0,0.0,1.0,33,900,800,100,0.8888888888888888,10,8,2,375.8230750157746,0.3742897727272727,0.12078666624121204,0.2580048049927568,137137.77641111583,3707.908166330253,140845.68457744608,621,78,359.90909090909093,33,0,16,28.302206427206436,0.6979166666666667,38.143382352941174,1047.4264705882347,31.740196078431353,0
630,4,0,0,33,0.0,0.0,1.0,33,850,600,250,0.7058823529411765,11,6,5,379.0496905030607,0.3732638888888889,0.12532340953393617,0.26094000433181713,137234.06412197236,3803.705906382167,141037.77002835454,622,79,360.90909090909093,33,0,16,28.12231968810916,0.6988636363636365,38.0514705882353,1047.7941176470592,31.751336898395735,0
631,4,1,0,34,0.029411764705882353,0.0,1.0,34,1100,700,400,0.6363636363636364,15,7,8,369.2685295865184,0.37505570409982175,0.12022071341304685,0.2563928301171641,137531.39349489787,3357.2030895691523,140888.596584467,623,0,351.2647058823529,34,0,17,28.08444936253926,0.6994485294117647,37.76785714285714,1048.9285714285706,30.850840336134432,0
632,4,0,1,33,0.0,0.029411764705882353,0.9705882352941176,34,700,400,300,0.5714285714285714,10,4,6,366.103001477719,0.3742758467023173,0.11339294651496479,0.25511446308506663,137656.29428854876,3279.2765022675776,140935.57079081633,624,1,352.2647058823529,34,0,18,28.044053696350918,0.7006740196078431,37.648809523809526,1049.404761904762,30.86484593837535,0
633,4,0,0,33,0.0,0.0,1.0,33,800,600,200,0.75,10,6,4,372.75564528830336,0.3729482323232323,0.10325896507417376,0.2592332314632953,137587.40816332665,3657.2966226932035,141244.70478601984,625,2,345.27272727272725,33,0,18,27.937619242300368,0.7023358585858586,37.71446078431373,1049.1421568627454,31.792186571598346,0
634,4,0,0,33,0.0,0.0,1.0,33,450,0,450,0.0,9,0,9,373.6976690709545,0.3724352904040404,0.10515997296331281,0.2603721025430907,137651.70134383414,3688.023987168403,141339.72533100256,626,3,346.27272727272725,33,0,18,27.849346996769054,0.7029671717171717,37.65318627450981,1049.3872549019611,31.799613784907912,0
635,4,0,0,33,0.0,0.0,1.0,33,750,700,50,0.9333333333333333,8,7,1,371.413919764563,0.37188289141414144,0.10295813611246718,0.25950502746356,137748.16927383697,3632.3174980776644,141380.48677191464,627,4,347.27272727272725,33,0,19,27.813934936570938,0.7039141414141414,37.56127450980392,1049.7549019607843,31.81075460487225,0
636,4,0,0,33,0.0,0.0,1.0,33,1150,900,250,0.782608695652174,14,9,5,371.9450743260269,0.3714488636363636,0.09644059644059677,0.26036155202821876,137812.49999999997,3651.7361111111118,141464.2361111111,628,5,348.27272727272725,33,0,19,27.736441798941804,0.7045454545454546,37.5,1049.9999999999998,31.818181818181813,0
637,4,0,0,33,0.0,0.0,1.0,33,1050,700,350,0.6666666666666666,14,7,7,369.3290585982875,0.3705808080808081,0.08652959078714395,0.25974224933249523,137973.39252030462,3591.516634227215,141564.90915453184,629,6,349.27272727272725,33,0,19,27.646268323029673,0.7061237373737373,37.34681372549019,1050.6127450980387,31.836749851455718,0
638,4,0,0,33,0.0,0.0,1.0,33,300,200,100,0.6666666666666666,4,2,2,369.3290585982875,0.3705808080808081,0.08652959078714395,0.25974224933249523,137973.39252030462,3591.516634227215,141564.90915453184,630,7,350.27272727272725,33,0,19,27.646268323029673,0.7061237373737373,37.34681372549019,1050.6127450980387,31.836749851455718,0
639,4,0,0,33,0.0,0.0,1.0,33,900,700,200,0.7777777777777778,11,7,4,370.3557531300732,0.3697916666666667,0.0901139676649878,0.2609532114289548,138037.7758103855,3624.616884131111,141662.3926945166,631,8,351.27272727272725,33,0,19,27.555758017492714,0.7067550505050505,37.28553921568628,1050.8578431372555,31.84417706476532,0
640,4,0,1,32,0.0,0.030303030303030304,0.9696969696969697,33,950,700,250,0.7368421052631579,12,7,5,370.09308288926536,0.3688052398989899,0.09055233533611018,0.2617500872305858,138166.5874453334,3626.899659986531,141793.48710531992,632,9,352.27272727272725,33,0,17,27.4355742705055,0.7080176767676768,37.162990196078425,1051.3480392156853,31.859031491384403,0
641,4,0,0,32,0.0,0.0,1.0,32,150,0,150,0.0,3,0,3,379.02503588979505,0.3679645497311828,0.08836452950366547,0.2665990975180884,137978.26951650344,4059.443711100907,142037.71322760434,633,10,350.375,32,0,20,27.386782438008243,0.7086588541666667,37.342171717171716,1050.6313131313132,32.832228535353536,0
642,4,0,0,32,0.0,0.0,1.0,32,950,900,50,0.9473684210526315,10,9,1,378.3249441490555,0.3675445228494623,0.0885911029676798,0.2666213810459432,138044.60522204364,4045.1435121416134,142089.74873418524,634,11,351.375,32,0,17,27.339651167447634,0.7093098958333334,37.2790404040404,1050.883838383838,32.84011994949494,0
643,4,0,0,32,0.0,0.0,1.0,32,550,400,150,0.7272727272727273,7,4,3,376.54590248238037,0.3676915322580645,0.08845657135992302,0.2656244145985877,138077.77905315784,3998.5243852668095,142076.30343842466,635,12,352.375,32,0,17,27.35363607240109,0.7096354166666667,37.24747474747475,1051.0101010101012,32.84406565656566,0
644,4,0,0,32,0.0,0.0,1.0,32,750,400,350,0.5333333333333333,11,4,7,374.05063159730594,0.3666834677419355,0.08618515850144104,0.26488891666176567,138210.51423324153,3939.5460284664905,142150.06026170801,636,13,353.375,32,0,18,27.28821445725265,0.7109375,37.121212121212125,1051.5151515151517,32.85984848484849,0
645,4,0,1,31,0.0,0.03125,0.96875,32,1000,700,300,0.7,13,7,6,386.71041329099717,0.3666834677419355,0.04769656767283381,0.24667800897506467,134518.03387409452,4003.904894908693,138521.9387690032,637,14,354.375,32,0,17,30.627484988640063,0.6744791666666666,40.65656565656566,1037.3737373737376,32.4179292929293,7
646,4,0,0,31,0.0,0.0,1.0,31,1250,1100,150,0.88,14,11,3,391.89615438075765,0.3633960573476702,0.06554430676937639,0.2504426988179839,134584.55615573467,4348.633999294716,138933.19015502938,638,95,366.35483870967744,31,0,18,30.42636570878822,0.677755376344086,40.59244791666667,1037.630208333334,33.471942204301094,0
647,4,0,0,31,0.0,0.0,1.0,31,550,500,50,0.9090909090909091,6,5,1,391.8959710718574,0.3627688172043011,0.061376106696016786,0.25114105155826744,134685.9063042534,4356.572808159718,139042.47911241313,639,96,367.35483870967744,31,0,19,30.32488710486703,0.6787634408602151,40.494791666666664,1038.020833333333,33.48454301075268,0
648,4,2,1,32,0.06060606060606061,0.030303030303030304,0.9696969696969697,33,900,600,300,0.6666666666666666,12,6,6,373.7351030896801,0.3708964646464647,0.06018493734899377,0.24391889011025908,135346.6083507544,3516.755724961539,138863.36407571594,640,0,346.030303030303,33,0,16,30.136688847014486,0.680239898989899,39.859068627450974,1040.563725490195,31.53223410576349,0
649,4,0,0,32,0.0,0.0,1.0,32,850,700,150,0.8235294117647058,10,7,3,382.4352282815472,0.36725050403225806,0.06773172878475142,0.24862817485044228,135206.56573627688,3941.5507665034097,139148.1165027803,641,1,357.84375,32,0,16,30.05012949698514,0.6813151041666667,39.993686868686865,1040.0252525252522,32.50078914141413,0
650,4,0,0,32,0.0,0.0,1.0,32,1000,800,200,0.8,12,8,4,384.35408615326605,0.3660534274193548,0.06532918689320377,0.25055994223915434,135305.07091113148,4001.011376390158,139306.08228752163,642,2,358.84375,32,0,16,29.901901294498373,0.6822916666666667,39.898989898989896,1040.4040404040402,32.512626262626256,0
651,4,0,0,32,0.0,0.0,1.0,32,1100,800,300,0.7272727272727273,14,8,6,407.2790449196699,0.366242439516129,0.09624242806663319,0.24978940804515953,133068.88156467,4439.631954707249,137508.51351937727,643,3,359.84375,31,1,16,31.551825677267367,0.6626344086021506,42.05729166666666,1031.7708333333321,33.282930107526845,7
652,4,0,0,32,0.0,0.0,1.0,32,500,200,300,0.4,8,2,6,407.86776662122253,0.36580141129032256,0.09380520504731904,0.25037583659745827,133102.46997409387,4457.64143202039,137560.11140611424,644,4,360.84375,31,1,16,31.50276025236594,0.662970430107527,42.02473958333333,1031.9010416666658,33.28713037634406,0
653,4,0,0,32,0.0,0.0,1.0,32,850,700,150,0.8235294117647058,10,7,3,406.50406504065063,0.36580141129032256,0.10188008130081316,0.238095238095238,131328.12499999988,4277.083333333319,135605.2083333332,645,5,361.84375,31,1,18,33.33333333333334,0.6451612903225807,43.74999999999999,1024.999999999999,33.06451612903223,3
654,4,0,0,32,0.0,0.0,1.0,32,600,400,200,0.6666666666666666,8,4,4,405.63051650289754,0.3655703965053763,0.10239285714285695,0.23820584022821162,131428.24172973633,4262.261115180121,135690.50284491645,646,6,362.84375,31,1,18,33.25410052910054,0.6461693548387097,43.65234375,1025.390625,33.07711693548387,0
655,4,1,1,32,0.030303030303030304,0.030303030303030304,0.9696969696969697,33,900,600,300,0.6666666666666666,12,6,6,395.0855522346605,0.371133207070707,0.09156493612961913,0.23417169903587878,131781.48275686143,3812.9919778593908,135594.47473472083,647,0,352.8181818181818,32,1,15,33.16655394326938,0.6471354166666667,43.3080808080808,1026.767676767676,32.086489898989875,0
656,4,0,0,32,0.0,0.0,1.0,32,1200,900,300,0.75,15,9,6,407.0565564974218,0.36584341397849457,0.09276699644850361,0.24093347533225765,131728.82080078113,4324.216037326376,136053.0368381075,648,8,364.84375,31,1,17,32.912650093015394,0.6491935483870969,43.35937499999999,1026.562499999999,33.11491935483868,0
657,4,0,0,32,0.0,0.0,1.0,32,750,600,150,0.8,9,6,3,407.45387653934137,0.3659064180107527,0.1040033637822495,0.23526613355988632,130778.6693481533,4257.255158912365,135035.92450706568,649,9,365.84375,32,0,16,33.867475208821965,0.6370442708333333,44.286616161616166,1022.8535353535358,31.964172979797993,3
658,4,0,0,32,0.0,0.0,1.0,32,650,500,150,0.7692307692307693,8,5,3,406.87571405824804,0.36643145161290325,0.10615434460627005,0.23512888982167798,130810.95838434853,4244.760419855116,135055.71880420364,650,10,366.84375,32,0,16,33.84940961079568,0.6373697916666666,44.255050505050505,1022.979797979798,31.96811868686869,0
659,4,1,1,32,0.030303030303030304,0.030303030303030304,0.9696969696969697,33,950,600,350,0.631578947368421,13,6,7,395.5080941917938,0.3744870580808081,0.09540071126385286,0.23070845494411762,131171.15600069688,3775.8507845540234,134947.0067852509,651,0,356.6969696969697,33,0,17,33.77435000199386,0.6385732323232323,43.90318627450981,1024.3872549019611,31.042038027332154,0
660,4,0,0,32,0.0,0.0,1.0,32,600,400,200,0.6666666666666666,8,4,4,408.51090355941176,0.36647345430107525,0.09791152897657196,0.23766308664754893,131069.41415416807,4308.6569610244,135378.07111519246,652,12,368.84375,32,0,17,33.54474928072339,0.6399739583333333,44.00252525252526,1023.9898989899,31.999684343434375,0
661,4,0,0,32,0.0,0.0,1.0,32,800,600,200,0.75,10,6,4,407.4238138082727,0.36630544354838707,0.09710069016514677,0.23782998742736158,131198.73769258242,4290.6980155086285,135489.43570809104,653,13,369.84375,32,0,18,33.441171637498975,0.6412760416666666,43.87626262626263,1024.4949494949499,32.015467171717184,0
662,4,1,0,33,0.030303030303030304,0.0,1.0,33,850,700,150,0.8235294117647058,10,7,3,396.36524025470715,0.3727114898989899,0.09847579740052881,0.23330359078283414,131516.61169982704,3825.722678777402,135342.33437860446,654,0,359.6060606060606,33,0,20,33.40203106332139,0.6420454545454545,43.56617647058824,1025.7352941176475,31.082887700534773,0
663,4,0,0,33,0.0,0.0,1.0,33,900,800,100,0.8888888888888888,10,8,2,395.9630126826148,0.3729482323232323,0.10141795448210456,0.23325871774568402,131548.0392907776,3817.631590013463,135365.67088079106,655,1,360.6060606060606,33,0,21,33.38049516186836,0.642361111111111,43.53553921568628,1025.8578431372553,31.086601307189554,0
664,4,0,0,33,0.0,0.0,1.0,33,700,300,400,0.42857142857142855,11,3,8,395.6866274762108,0.3725536616161616,0.10113554942788294,0.23367276576063395,131642.34459102273,3817.8230728565973,135460.1676638793,656,2,361.6060606060606,33,0,16,33.292034869835206,0.6433080808080808,43.443627450980394,1026.2254901960787,31.0977421271539,0
665,4,0,0,33,0.0,0.0,1.0,33,700,500,200,0.7142857142857143,9,5,4,396.8930986856761,0.372238005050505,0.0991551334237899,0.23457866630152,131673.7872002355,3852.083483515957,135525.87068375145,657,3,362.6060606060606,33,0,16,33.22922885572139,0.6436237373737373,43.41299019607843,1026.3480392156864,31.101455733808677,0
666,4,0,0,33,0.0,0.0,1.0,33,950,800,150,0.8421052631578947,11,8,3,394.84956479533713,0.3720012626262626,0.09715199259243179,0.23394976335610573,131768.13755526723,3805.718353517876,135573.8559087851,658,4,363.6060606060606,33,0,17,33.18612238402164,0.6445707070707071,43.32107843137255,1026.7156862745098,31.112596553773024,0
667,4,0,0,33,0.0,0.0,1.0,33,800,700,100,0.875,9,7,2,391.09830319537593,0.372198547979798,0.08580721659577706,0.2277636599166382,131108.39468293454,3655.2541390330725,134763.6488219676,659,5,364.6060606060606,33,0,18,33.95095428981693,0.6379419191919191,43.96446078431373,1024.1421568627457,31.034610814022596,4
668,4,1,2,32,0.029411764705882353,0.058823529411764705,0.9411764705882353,34,550,400,150,0.7272727272727273,7,4,3,382.1099049578619,0.37694964349376114,0.07901999494490619,0.22398559507094282,131358.63272392293,3238.6869331065764,134597.3196570295,660,0,354.8529411764706,34,0,18,33.92753454883289,0.6381740196078431,43.720238095238095,1025.1190476190477,30.150560224089638,0
669,4,0,0,32,0.0,0.0,1.0,32,500,300,200,0.6,7,3,4,400.8883278842152,0.36485635080645157,0.0992980212057697,0.23342463944500136,131101.73906042747,4111.431390929489,135213.17045135697,661,21,377.84375,32,0,18,33.707054206222004,0.6402994791666667,43.97095959595959,1024.1161616161612,32.00363005050504,0
670,4,0,0,32,0.0,0.0,1.0,32,850,700,150,0.8235294117647058,10,7,3,383.157417257204,0.3653813844086022,0.08937329277377715,0.21282412679927726,129265.58036169781,3505.813182328337,132771.39354402616,662,22,378.84375,32,0,19,36.029198741826,0.6217447916666666,45.77020202020202,1016.9191919191921,31.778724747474755,4
671,4,1,1,32,0.030303030303030304,0.030303030303030304,0.9696969696969697,33,1150,1000,150,0.8695652173913043,13,10,3,372.14035499886415,0.37251420454545453,0.08136256023580013,0.20817305919027357,129544.24267409161,3041.728091359087,132585.9707654507,663,0,368.3333333333333,33,0,17,36.02521467838369,0.6221590909090909,45.49632352941176,1018.0147058823524,30.848930481283404,0
672,4,0,0,32,0.0,0.0,1.0,32,700,600,100,0.8571428571428571,8,6,2,381.63312374451334,0.36496135752688175,0.08704692154915605,0.212322958900953,129329.78777675745,3471.3061804917857,132801.09395724925,664,24,380.84375,32,0,19,36.00241021185038,0.6223958333333334,45.707070707070706,1017.171717171717,31.786616161616156,0
673,4,0,0,32,0.0,0.0,1.0,32,550,400,150,0.7272727272727273,7,4,3,382.0809924769173,0.36529737903225806,0.08984084139985082,0.21291899290311223,129394.01113406806,3487.7984389348117,132881.80957300286,665,25,381.84375,32,0,19,35.92547778605112,0.623046875,45.6439393939394,1017.4242424242433,31.794507575757603,0
674,4,0,0,32,0.0,0.0,1.0,32,750,500,250,0.6666666666666666,10,5,5,383.9657769021097,0.36519237231182794,0.08765433056210448,0.2141439582044361,129426.12879106721,3539.040818538924,132965.16960960615,666,26,382.84375,32,0,17,35.84475948215246,0.6233723958333334,45.61237373737374,1017.5505050505049,31.798453282828277,0
675,4,1,2,31,0.030303030303030304,0.06060606060606061,0.9393939393939394,33,950,600,350,0.631578947368421,13,6,7,376.91442934348186,0.3714094065656566,0.08548690366872203,0.21235910531303484,129825.09731833907,3186.590494040751,133011.68781237982,667,0,372.2121212121212,33,0,18,35.61758457591792,0.625,45.220588235294116,1019.1176470588233,30.882352941176464,0
676,4,0,0,31,0.0,0.0,1.0,31,850,500,350,0.5882352941176471,12,5,7,390.2198441925422,0.36258960573476706,0.09662569094959217,0.21859019925398834,129598.82948133671,3914.407009548602,133513.23649088532,668,28,386.7741935483871,31,0,18,35.509377664109124,0.6276881720430108,45.44270833333333,1018.2291666666658,32.84610215053761,0
677,4,3,1,33,0.08823529411764706,0.029411764705882353,0.9705882352941176,34,850,500,350,0.5882352941176471,12,5,7,364.9845421956523,0.38023618538324416,0.10262945150107572,0.20975617665942903,130597.00255102031,2733.177437641711,133330.179988662,669,0,353.55882352941177,34,0,17,35.13762714496467,0.630514705882353,44.46428571428571,1022.1428571428564,30.063025210084014,0
678,4,0,0,33,0.0,0.0,1.0,33,650,400,250,0.6153846153846154,9,4,5,369.7630933777108,0.3736979166666667,0.09860659848666553,0.2120415868351687,130512.91120001924,3051.7715542099204,133564.68275422917,670,1,365.27272727272725,33,0,18,35.10084352762453,0.6319444444444444,44.54656862745098,1021.8137254901962,30.964052287581705,0
679,4,0,0,33,0.0,0.0,1.0,33,450,200,250,0.4444444444444444,7,2,5,373.82373592149446,0.3734217171717172,0.10425317798534484,0.21489068100077086,130606.84479827467,3164.7877318819656,133771.63253015664,671,2,366.27272727272725,33,0,18,34.901765375854225,0.6328914141414141,44.4546568627451,1022.1813725490193,30.97519310754604,0
680,4,1,0,34,0.029411764705882353,0.0,1.0,34,1000,700,300,0.7,13,7,6,367.4211144228527,0.37869503862150916,0.10884439852479288,0.21299523403191262,130931.84700963717,2821.425028344666,133753.27203798183,672,0,356.47058823529414,34,0,19,34.73595440269861,0.6338848039215687,44.13690476190476,1023.4523809523808,30.101540616246496,0
681,4,0,0,34,0.0,0.0,1.0,34,1150,900,250,0.782608695652174,14,9,5,371.33323497108734,0.3785836304218657,0.11472468127285773,0.2166320330119461,131175.6395266439,2941.9749149659756,134117.61444160988,673,1,357.47058823529414,34,0,19,34.38892116986247,0.6363357843137255,43.89880952380952,1024.4047619047612,30.12955182072827,0
682,4,0,0,34,0.0,0.0,1.0,34,850,400,450,0.47058823529411764,13,4,9,372.1329896225792,0.37767379679144386,0.11238641798182725,0.21796360820751065,131328.125,2974.3941326530617,134302.51913265305,674,2,358.47058823529414,33,1,20,34.21409214092141,0.6401515151515151,43.75,1025.0,31.060606060606062,0
683,4,0,0,34,0.0,0.0,1.0,34,1100,800,300,0.7272727272727273,14,8,6,373.9810078392025,0.37780377302436124,0.109384774342286,0.21994708746354788,131485.18786344197,3034.5926146193865,134519.78047806135,675,3,359.47058823529414,33,1,20,34.0078215238778,0.6417297979797979,43.5968137254902,1025.6127450980396,31.07917409387999,0
684,4,1,1,34,0.02857142857142857,0.02857142857142857,0.9714285714285714,35,900,500,400,0.5555555555555556,13,5,8,367.2704640124555,0.3828081232492997,0.10237073607130442,0.21736260886612235,131725.0017715419,2675.740504535139,134400.74227607704,676,0,350.1714285714286,34,1,18,33.93757972863271,0.6418504901960784,43.363095238095234,1026.5476190476186,30.192577030812313,0
685,4,0,0,34,0.0,0.0,1.0,34,600,500,100,0.8333333333333334,7,5,2,374.7698115050989,0.37808229352347,0.10830218374975398,0.22095583534652727,131579.47063629367,3062.4026816608916,134641.87331795457,677,5,361.47058823529414,33,1,19,33.892240006370436,0.6426767676767677,43.50490196078431,1025.9803921568623,31.090314913844313,0
686,4,1,1,34,0.02857142857142857,0.02857142857142857,0.9714285714285714,35,800,400,400,0.5,12,4,8,366.0720002275028,0.38259803921568625,0.10258686363485836,0.2171758647842117,131816.67375283438,2650.8786848072455,134467.55243764163,678,0,352.1142857142857,34,1,19,33.87578251796892,0.6427696078431373,43.27380952380952,1026.9047619047612,30.203081232492977,0
687,4,0,0,34,0.0,0.0,1.0,34,1000,700,300,0.7,13,7,6,375.0208673710946,0.37719102792632203,0.11473959211191676,0.22183437747883375,131705.23356401373,3078.4421856977956,134783.67574971152,679,7,363.47058823529414,33,1,19,33.758655682903544,0.643939393939394,43.382352941176464,1026.4705882352932,31.10516934046343,0
688,4,0,0,34,0.0,0.0,1.0,34,850,600,250,0.7058823529411765,11,6,5,372.4512146050192,0.37648544266191325,0.11353966270203486,0.2206786616662552,131768.1375552671,3015.440575740085,134783.5781310072,680,8,364.47058823529414,33,1,19,33.761040821198364,0.6445707070707072,43.32107843137254,1026.715686274509,31.112596553773,0
689,4,0,0,34,0.0,0.0,1.0,34,750,400,350,0.5333333333333333,11,4,7,373.7948633238588,0.376114081996435,0.11854555664748023,0.22184142738342333,131831.05656478275,3055.554354094576,134886.61091887733,681,9,365.47058823529414,33,1,19,33.66298727128081,0.6452020202020202,43.259803921568626,1026.9607843137253,31.120023767082586,0
690,4,0,0,34,0.0,0.0,1.0,34,800,600,200,0.75,10,6,4,372.56650237045613,0.3759469696969697,0.11872779713485015,0.2212065530591826,131847.2381660997,3024.372874149649,134871.61104024935,682,10,366.47058823529414,34,0,19,33.67818090491094,0.6430759803921569,43.24404761904761,1027.023809523809,30.206582633053205,0
691,4,0,0,34,0.0,0.0,1.0,34,1150,1000,150,0.8695652173913043,13,10,3,370.4624581247383,0.3755756090314914,0.11819569677019293,0.22066676853517,131969.53124999988,2977.9513888888755,134947.48263888876,683,11,367.47058823529414,34,0,19,33.60874560692079,0.6443014705882353,43.12499999999999,1027.499999999999,30.22058823529409,0
692,4,0,0,34,0.0,0.0,1.0,34,650,400,250,0.6153846153846154,9,4,5,371.9679280320829,0.37518568033273914,0.12187891838848652,0.2217422068213354,132000.11337868468,3019.961734693863,135020.07511337855,684,12,368.47058823529414,34,0,19,33.53920489650911,0.644607843137255,43.09523809523809,1027.6190476190466,30.224089635854313,0
693,4,1,1,34,0.02857142857142857,0.02857142857142857,0.9714285714285714,35,500,400,100,0.8,6,4,2,363.5771150722564,0.3790266106442577,0.11483881340943847,0.217827556804922,132189.63162562138,2612.224981781529,134801.8566074029,685,0,358.9142857142857,35,0,19,33.563707559557315,0.6443452380952381,42.91087962962962,1028.35648148148,29.381613756613714,0
694,4,0,0,34,0.0,0.0,1.0,34,850,700,150,0.8235294117647058,10,7,3,370.2759995692023,0.37481431966726086,0.12346267518352572,0.2218061084798035,132183.68055555542,2988.8888888888696,135172.5694444443,686,14,370.47058823529414,34,0,19,33.39748784440842,0.6464460784313726,42.91666666666666,1028.3333333333321,30.24509803921565,0
695,4,0,0,34,0.0,0.0,1.0,34,500,300,200,0.6,7,3,4,370.2759995692023,0.37481431966726086,0.12346267518352572,0.2218061084798035,132183.68055555542,2988.8888888888696,135172.5694444443,687,15,371.47058823529414,34,0,19,33.39748784440842,0.6464460784313726,42.91666666666666,1028.3333333333321,30.24509803921565,0
696,4,0,0,34,0.0,0.0,1.0,34,600,400,200,0.6666666666666666,8,4,4,370.7072358739933,0.37436868686868685,0.12507317205984458,0.2227852526024375,132306.12953514745,3009.3679138322073,135315.49744897967,688,16,372.47058823529414,34,0,20,33.26294067731236,0.647671568627451,42.79761904761905,1028.8095238095243,30.259103641456598,0
697,4,0,0,34,0.0,0.0,1.0,34,1000,600,400,0.6,14,6,8,372.2236817691332,0.3747400475341652,0.123120399487334,0.22442977050818022,132429.5361910083,3058.7137949542603,135488.24998596255,689,17,373.47058823529414,33,1,20,33.09955054173116,0.651199494949495,42.677696078431374,1029.2892156862747,31.190582293523477,0
698,4,0,0,34,0.0,0.0,1.0,34,1150,1000,150,0.8695652173913043,13,10,3,385.1907504761623,0.3747957516339869,0.1646720108388846,0.22053228681107762,130450.30757401002,3253.7390967416413,133704.04667075165,690,18,374.47058823529414,33,1,22,34.770373480486235,0.6313131313131313,44.6078431372549,1021.5686274509807,30.956625074272143,3
699,4,1,1,34,0.02857142857142857,0.02857142857142857,0.9714285714285714,35,900,400,500,0.4444444444444444,14,4,10,379.4927302539047,0.38112745098039214,0.1632491562900038,0.2192993295946068,130810.03578514737,2928.2915249433086,133738.32731009068,691,0,364.74285714285713,34,1,17,34.55065169323868,0.6326593137254901,44.25595238095238,1022.9761904761903,30.087535014005596,0
700,4,0,0,34,0.0,0.0,1.0,34,850,700,150,0.8235294117647058,10,7,3,385.61725986255533,0.37422014260249553,0.16731752017763357,0.2223894978267468,130732.14215986646,3282.514087129958,134014.65624699643,692,20,376.47058823529414,33,1,18,34.47311264230077,0.6341540404040404,44.33210784313726,1022.6715686274515,30.990047534165196,0
701,4,1,1,34,0.02857142857142857,0.02857142857142857,0.9714285714285714,35,1350,1000,350,0.7407407407407407,17,10,7,379.1528963532255,0.37951680672268906,0.1555555555555559,0.22101839567907547,131145.1530612245,2944.812925170074,134089.96598639456,693,0,366.6857142857143,34,1,20,34.21954904695492,0.6360294117647058,43.92857142857143,1024.2857142857144,30.12605042016807,0
702,4,0,0,34,0.0,0.0,1.0,34,750,400,350,0.5333333333333333,11,4,7,386.463673274398,0.3734774212715389,0.16628891594929196,0.22506459355778025,131108.39468293457,3333.7263612552956,134442.12104418987,694,22,378.47058823529414,33,1,20,34.06961728690519,0.6379419191919191,43.96446078431373,1024.1421568627459,31.034610814022603,0
703,4,1,0,35,0.02857142857142857,0.0,1.0,35,700,400,300,0.5714285714285714,10,4,6,380.1803141858679,0.3785364145658263,0.16177426846261045,0.22303221156462505,131389.14399092982,2990.3132086167934,134379.45719954662,695,0,368.62857142857143,34,1,21,33.94609266140271,0.6384803921568627,43.6904761904762,1025.238095238096,30.154061624649884,0
704,4,0,0,35,0.0,0.0,1.0,35,850,600,250,0.7058823529411765,11,6,5,396.4276722149021,0.3785014005602241,0.19250612816621993,0.22446767137244308,130019.64462868466,3308.6770124716404,133328.3216411563,696,1,369.62857142857143,34,1,20,34.92203610754446,0.6246936274509804,45.0297619047619,1019.8809523809513,29.996498599439743,2
705,4,3,3,35,0.07894736842105263,0.07894736842105263,0.9210526315789473,38,800,500,300,0.625,11,5,6,375.4664606639551,0.39527027027027023,0.16941292109731054,0.21638918329850257,130706.03358892754,2215.599878550966,132921.6334674785,697,0,341.36842105263156,35,3,18,34.75912563667233,0.6294642857142856,44.35763888888889,1022.569444444445,29.21626984126986,0
706,4,0,0,35,0.0,0.0,1.0,35,950,600,350,0.631578947368421,13,6,7,399.6637963923382,0.3779411764705882,0.18666255122862996,0.2278986370803949,130293.86421388414,3414.7480836697514,133708.6122975539,698,3,371.62857142857143,33,2,21,34.56005181450807,0.6297348484848484,44.76102941176471,1020.9558823529416,30.938057040998228,0
707,4,0,0,35,0.0,0.0,1.0,35,950,500,450,0.5263157894736842,14,5,9,406.2067970329152,0.3780812324929972,0.18695689433541895,0.2323770523863657,130419.0113928537,3595.417778018075,134014.42917087176,699,4,372.62857142857143,33,2,21,34.26552189562089,0.6309974747474747,44.638480392156865,1021.4460784313725,30.952911467617348,0
708,4,0,0,35,0.0,0.0,1.0,35,1000,700,300,0.7,13,7,6,409.0492591438826,0.3777310924369748,0.19391987942521527,0.23513989459125595,130606.84479827464,3684.926620770855,134291.7714190455,700,5,373.62857142857143,33,2,18,34.00159353394879,0.6328914141414141,44.4546568627451,1022.1813725490191,30.975193107546033,0
709,4,0,0,35,0.0,0.0,1.0,35,750,500,250,0.6666666666666666,10,5,5,407.47856542505656,0.37769607843137254,0.19103782469478348,0.23461654046523434,130669.48596993936,3649.0029375720833,134318.48890751143,701,6,374.62857142857143,33,2,18,33.97796056574376,0.6335227272727273,44.393382352941174,1022.4264705882346,30.98262032085559,0
710,4,1,0,36,0.027777777777777776,0.0,1.0,36,950,600,350,0.631578947368421,13,6,7,397.2249925783571,0.3817460317460317,0.1928302242321458,0.2306930439498073,131002.08340031285,3207.4603212877105,134209.54372160055,702,0,365.19444444444446,35,1,19,33.90203975880911,0.6324404761904763,44.06828703703703,1023.7268518518513,29.24933862433861,0
711,4,1,1,36,0.02702702702702703,0.02702702702702703,0.972972972972973,37,950,600,350,0.631578947368421,13,6,7,388.02791595269235,0.38482232232232233,0.18016235820390158,0.22676082255963684,131241.5683208546,2785.078448380814,134026.6467692354,703,0,356.2972972972973,36,1,19,33.894521375975394,0.6328125,43.83445945945946,1024.6621621621618,28.462837837837828,0
712,4,0,0,36,0.0,0.0,1.0,36,900,700,200,0.7777777777777778,11,7,4,397.47089747701835,0.3808862433862434,0.19467668436711527,0.23190605890369734,131179.87403817294,3228.0364529749604,134407.9104911479,704,2,367.19444444444446,35,1,19,33.71523462508944,0.6342261904761906,43.894675925925924,1024.4212962962958,29.26917989417988,0
713,4,1,0,37,0.02702702702702703,0.0,1.0,37,800,700,100,0.875,9,7,2,389.7758470957021,0.3851038538538538,0.18908604529680462,0.22926496784637151,131489.94880943283,2850.656134330126,134340.60494376294,705,0,358.2432432432432,32,5,21,33.598013870080834,0.6442057291666666,43.59217171717172,1025.631313131314,32.050978535353565,0
714,4,0,0,37,0.0,0.0,1.0,37,950,800,150,0.8421052631578947,11,8,3,372.33120377356704,0.3851038538538538,0.16247367550044944,0.2119717427361614,130231.31315179265,2297.8363189638712,132529.14947075653,706,1,359.2432432432432,33,4,19,35.32124204586385,0.6291035353535352,44.82230392156863,1020.710784313726,30.930629827688666,4
715,4,1,1,37,0.02631578947368421,0.02631578947368421,0.9736842105263158,38,1150,900,250,0.782608695652174,14,9,5,365.68456576786093,0.390054528212423,0.15791006702355292,0.20966403660558128,130505.75573979599,1944.7881235827713,132450.54386337876,707,0,350.7631578947368,34,4,18,35.212289797662024,0.629595588235294,44.55357142857143,1021.7857142857149,30.052521008403378,0
716,4,1,0,38,0.02631578947368421,0.0,1.0,38,1100,800,300,0.7272727272727273,14,8,6,365.8581136597169,0.3892988383119962,0.16400720627975796,0.21075488519271035,130688.2812500001,1962.6736111111263,132650.95486111124,708,0,351.7368421052632,34,4,19,35.02275196957349,0.6314338235294117,44.37500000000001,1022.5000000000008,30.073529411764728,0
717,4,1,1,38,0.02564102564102564,0.02564102564102564,0.9743589743589743,39,950,500,450,0.5263157894736842,14,5,9,356.47341422098634,0.39271255060728744,0.1627980461219578,0.20702608987423662,131002.08340031296,1539.7519879543922,132541.83538826735,709,0,343.6923076923077,35,4,19,34.94500188430374,0.632440476190476,44.06828703703704,1023.7268518518521,29.24933862433863,0
718,4,0,1,37,0.0,0.02631578947368421,0.9736842105263158,38,1150,800,350,0.6956521739130435,15,8,7,362.3110066168683,0.3890321242294927,0.171208726631652,0.21019905768500907,130962.30867346936,1889.817176870743,132852.12585034012,710,2,353.7368421052632,34,4,19,34.83586299139334,0.6341911764705883,44.107142857142854,1023.5714285714284,30.10504201680672,0
719,4,0,0,37,0.0,0.0,1.0,37,800,500,300,0.625,11,5,6,366.95080638096624,0.38488488488488487,0.1747860910456862,0.21289089293276311,130962.30867346936,2211.344954648521,133173.65362811787,711,3,363.18918918918916,34,3,19,34.71713382957277,0.6341911764705883,44.107142857142854,1023.5714285714284,30.10504201680672,0
720,4,0,0,37,0.0,0.0,1.0,37,550,400,150,0.7272727272727273,7,4,3,370.9505137912387,0.3845095095095095,0.18067253299811448,0.21555232558139545,131023.24263038553,2320.6278344671287,133343.87046485266,712,4,364.18918918918916,34,3,19,34.5530523255814,0.6348039215686274,44.04761904761905,1023.8095238095241,30.112044817927178,0
721,4,1,0,38,0.02631578947368421,0.0,1.0,38,1050,900,150,0.8571428571428571,12,9,3,361.8877652191157,0.3869724988146041,0.1799315361574667,0.21196283391405357,131328.12500000012,1905.2083333333478,133233.33333333346,713,0,355.57894736842104,35,3,20,34.47662601626016,0.6357142857142857,43.75000000000001,1025.000000000001,29.285714285714313,0
722,4,0,0,38,0.0,0.0,1.0,38,1150,800,350,0.6956521739130435,15,8,7,365.06841498461836,0.3862908961593172,0.1778439016044875,0.21450882173789249,131450.17715419506,1997.661564625863,133447.83871882092,714,1,356.57894736842104,34,4,20,34.271728194412205,0.6390931372549019,43.63095238095239,1025.476190476191,30.161064425770324,0
723,4,0,1,37,0.0,0.02631578947368421,0.9736842105263158,38,800,400,400,0.5,12,4,8,367.4281395521559,0.38635016595542915,0.1699869306592081,0.21658657364298756,131572.28599773234,2068.672052154189,133640.95804988654,715,2,357.57894736842104,34,4,14,34.08781039684383,0.6403186274509804,43.51190476190476,1025.9523809523803,30.175070028011184,1
724,4,0,1,36,0.0,0.02702702702702703,0.972972972972973,37,1000,700,300,0.7,13,7,6,376.00903377704,0.38319569569569567,0.18222572476874577,0.22095811760156406,131453.76778162253,2485.5608419838627,133939.3286236064,716,8,368.18918918918916,33,4,19,33.98761153601019,0.6414141414141414,43.62745098039216,1025.490196078432,31.075460487225214,0
725,4,1,2,35,0.02702702702702703,0.05405405405405406,0.9459459459459459,37,800,200,600,0.25,14,2,12,374.846941377001,0.3821008508508508,0.1801909423460022,0.22081940508563505,131548.03929077747,2462.076034457893,134010.11532523535,717,0,368.94594594594594,33,4,19,33.92204734599611,0.6423611111111112,43.53553921568627,1025.8578431372541,31.086601307189518,0
726,4,0,0,35,0.0,0.0,1.0,35,500,300,200,0.6,7,3,4,393.63051250750357,0.37331932773109244,0.20161615427917723,0.22955457686408673,131161.34855482308,3325.821770562061,134487.17032538514,718,16,390.6857142857143,31,4,19,33.83238528028474,0.643481182795699,43.912760416666664,1024.348958333333,33.043514784946225,0
727,4,0,0,35,0.0,0.0,1.0,35,950,800,150,0.8421052631578947,11,8,3,390.50707083821646,0.3726190476190476,0.20007393715342014,0.22814721957178735,131231.0785410927,3249.3328168044054,134480.4113578971,719,17,391.6857142857143,32,3,19,33.84165126309304,0.6416015625,43.84469696969697,1024.6212121212118,32.01941287878787,0
728,4,0,0,35,0.0,0.0,1.0,35,550,300,250,0.5454545454545454,8,3,5,391.3777087464318,0.3732843137254902,0.1972368397895068,0.22904202320798764,131295.77219480166,3277.2476979389944,134573.01989274065,720,18,392.6857142857143,32,3,19,33.75374727937251,0.6422526041666666,43.78156565656566,1024.873737373738,32.027304292929315,0
729,4,0,0,35,0.0,0.0,1.0,35,850,500,350,0.5882352941176471,12,5,7,392.12602309859005,0.373109243697479,0.19340603509281262,0.22987402679487723,131361.493004693,3302.0559536074115,134663.5489583004,721,19,393.6857142857143,31,4,20,33.667942122867174,0.645497311827957,43.71744791666667,1025.1302083333342,33.06871639784949,0
730,4,0,0,35,0.0,0.0,1.0,35,400,300,100,0.75,5,3,2,392.12602309859005,0.373109243697479,0.19340603509281262,0.22987402679487723,131361.493004693,3302.051968044714,134663.54497273773,722,20,394.6857142857143,31,4,20,33.667942122867174,0.645497311827957,43.71744791666667,1025.1302083333342,33.06871639784949,0
731,4,0,0,35,0.0,0.0,1.0,35,850,500,350,0.5882352941176471,12,5,7,391.95870845702524,0.37373949579831933,0.14593554593554625,0.22083527232578734,129825.09731833913,3177.2154940407645,133002.3128123799,723,21,395.6857142857143,33,2,19,35.23428731762067,0.625,45.22058823529412,1019.1176470588238,30.882352941176478,8
732,4,0,0,35,0.0,0.0,1.0,35,800,600,200,0.75,10,6,4,396.46819526627246,0.37359943977591037,0.1504258241758245,0.22409071906354525,129950.01922337562,3304.209919261829,133254.22914263746,724,22,396.6857142857143,33,2,19,34.9919871794872,0.6262626262626263,45.09803921568628,1019.6078431372549,30.897207367795602,0
733,4,0,0,35,0.0,0.0,1.0,35,1050,700,350,0.6666666666666666,14,7,7,397.24316033708965,0.37314425770308124,0.15598641089873388,0.22561026964301578,130137.51471789708,3339.247524990402,133476.7622428875,725,23,397.6857142857143,33,2,19,34.78110737448955,0.6281565656565655,44.91421568627452,1020.343137254903,30.919489007724334,0
734,4,0,1,34,0.0,0.02857142857142857,0.9714285714285714,35,500,300,200,0.6,7,3,4,397.06837245225796,0.3726890756302521,0.15520298646756925,0.22570756556105817,130171.45691609987,3337.3937074830046,133508.85062358287,726,24,398.6857142857143,34,1,19,34.750981878985854,0.6262254901960784,44.88095238095239,1020.4761904761912,30.014005602240918,0
735,4,0,0,34,0.0,0.0,1.0,34,1050,900,150,0.8571428571428571,12,9,3,414.33485976083495,0.370803624480095,0.15216343801055565,0.23073401705712085,129366.91496107318,3925.392614524661,133292.30757559784,727,25,403.7647058823529,31,3,20,35.13281816630403,0.6253360215053763,45.67057291666667,1017.3177083333338,32.81670026881722,2
736,4,3,4,33,0.08108108108108109,0.10810810810810811,0.8918918918918919,37,750,500,250,0.6666666666666666,10,5,5,384.32386444493187,0.3897647647647648,0.12243619198796929,0.2178476573305504,130061.48674011865,2597.1466398831426,132658.6333800018,728,0,371.94594594594594,36,1,15,35.18804739824834,0.6209490740740741,44.988738738738746,1020.0450450450462,28.33458458458462,0
737,4,1,0,34,0.029411764705882353,0.0,1.0,34,1200,900,300,0.75,15,9,6,398.2367404539873,0.37615121806298274,0.13459567218306612,0.22527042265925426,129981.2590860487,3552.6625877066563,133533.92167375537,729,0,387.0,33,1,16,34.91504927292392,0.6265782828282829,45.067401960784316,1019.7303921568632,30.9009209744504,0
738,4,2,1,35,0.05555555555555555,0.027777777777777776,0.9722222222222222,36,650,500,150,0.7692307692307693,8,5,3,384.034686467259,0.3838458994708995,0.1275964952035653,0.2198112933048007,130439.87509645052,2818.687307098754,133258.56240354927,730,0,366.44444444444446,35,1,17,34.81050305914344,0.6267857142857143,44.61805555555555,1021.5277777777769,29.186507936507912,0
739,4,2,2,35,0.05405405405405406,0.05405405405405406,0.9459459459459459,37,600,400,200,0.6666666666666666,8,4,4,378.64563065287604,0.3846346346346346,0.13680721672795637,0.21880514687345587,130809.21292914537,2506.067384952523,133315.2803140979,731,0,357.4864864864865,36,1,16,34.57315059445179,0.6284722222222222,44.25675675675676,1022.9729729729731,28.41591591591592,0
740,4,0,0,35,0.0,0.0,1.0,35,950,600,350,0.631578947368421,13,6,7,396.55696582212914,0.3788515406162465,0.14010848224684702,0.22790081047850075,130597.00255102041,3357.8302154195044,133954.8327664399,732,1,378.8857142857143,34,1,16,34.330838962652386,0.630514705882353,44.464285714285715,1022.1428571428572,30.063025210084035,0
741,4,1,0,36,0.027777777777777776,0.0,1.0,36,1000,900,100,0.9,11,9,2,394.57448341690207,0.3837466931216931,0.15265058727466885,0.2291537298635915,131002.08340031294,3138.0158768432802,134140.09927715623,733,0,369.3333333333333,35,1,17,33.96987469380064,0.632440476190476,44.06828703703704,1023.726851851852,29.249338624338627,0
742,4,1,0,37,0.02702702702702703,0.0,1.0,37,900,600,300,0.6666666666666666,12,6,6,385.38224334557026,0.38795045045045046,0.14611050219358868,0.225214709839521,131241.5683208546,2715.6340039363686,133957.20232479097,734,0,360.3243243243243,36,1,18,33.96229439132506,0.6328125,43.83445945945946,1024.6621621621618,28.462837837837828,0
743,4,0,0,37,0.0,0.0,1.0,37,800,300,500,0.375,13,3,10,392.40280631115843,0.3868556056056056,0.14897503169681525,0.23020251825284024,131389.1439909297,2911.5508313746714,134300.6948223044,735,1,361.3243243243243,34,3,18,33.6328185477628,0.6384803921568627,43.69047619047619,1025.2380952380952,30.15406162464986,0
744,4,0,0,37,0.0,0.0,1.0,37,850,400,450,0.47058823529411764,13,4,9,394.12462873139884,0.38707457457457456,0.14963070802402156,0.23158182482211925,131450.17715419494,2961.5504535147356,134411.72760770968,736,2,362.3243243243243,34,3,18,33.52681680984443,0.639093137254902,43.63095238095238,1025.4761904761901,30.1610644257703,0
745,4,1,1,37,0.02631578947368421,0.02631578947368421,0.9736842105263158,38,1250,1000,250,0.8,15,10,5,388.26695001963753,0.39156590801327645,0.14324452619711647,0.22990172541216183,131743.6731074245,2630.342828360763,134374.01593578525,737,0,353.7631578947368,35,3,15,33.379838406614056,0.6398809523809523,43.344907407407405,1026.6203703703698,29.332010582010565,0
746,4,0,0,37,0.0,0.0,1.0,37,800,400,400,0.5,12,4,8,398.0874972459916,0.3868556056056056,0.1477565278470261,0.23484710053136182,131602.82206632636,3077.8876133786644,134680.70967970503,738,4,364.3243243243243,34,3,15,33.27048768225239,0.640625,43.48214285714285,1026.071428571427,30.178571428571384,0
747,4,0,0,37,0.0,0.0,1.0,37,950,700,250,0.7368421052631579,12,7,5,395.18537207236204,0.3860422922922923,0.15019348548097144,0.23399828106020348,131743.6731074244,3012.634495027415,134756.30760245182,739,5,365.3243243243243,35,2,15,33.20227358136038,0.6398809523809523,43.3449074074074,1026.620370370369,29.332010582010543,0
748,4,0,1,36,0.0,0.02702702702702703,0.972972972972973,37,1000,700,300,0.7,13,7,6,397.14004850875835,0.3864802302302302,0.14619940048253843,0.23552316245786772,131803.0907064471,3068.8571673525253,134871.94787379963,740,6,366.3243243243243,35,2,15,33.09193718064322,0.6404761904761905,43.28703703703703,1026.851851851851,29.338624338624317,0
749,4,0,0,36,0.0,0.0,1.0,36,1200,800,400,0.6666666666666666,16,8,8,405.1624311964924,0.3821924603174603,0.14202004973778126,0.23978830776989365,131725.00177154178,3474.004393424013,135199.0061649658,741,8,377.3333333333333,34,2,17,32.96513201128762,0.6418504901960785,43.36309523809523,1026.5476190476177,30.192577030812284,0
750,4,0,0,36,0.0,0.0,1.0,36,1100,900,200,0.8181818181818182,13,9,4,404.8271115526054,0.382093253968254,0.14532217972000083,0.24036087345934762,131847.23816609953,3475.067318594079,135322.3054846936,742,9,378.3333333333333,34,2,17,32.849870561415706,0.643075980392157,43.244047619047606,1027.0238095238076,30.206582633053163,0
751,4,0,0,36,0.0,0.0,1.0,36,900,600,300,0.6666666666666666,12,6,6,400.5268747759375,0.38220899470899466,0.14345950817561537,0.2383825468494025,131938.9526643989,3369.01927437639,135307.9719387753,743,10,379.3333333333333,34,2,17,32.86741985322517,0.6439950980392158,43.15476190476189,1027.3809523809507,30.217086834733845,0
752,4,0,0,36,0.0,0.0,1.0,36,850,600,250,0.7058823529411765,11,6,5,404.1911747653622,0.3820436507936508,0.14161775306353608,0.24095153457006951,132000.11337868482,3470.656179138321,135470.76955782314,744,11,380.3333333333333,34,2,17,32.71137434352795,0.6446078431372548,43.095238095238095,1027.6190476190477,30.224089635854344,0
753,4,0,0,36,0.0,0.0,1.0,36,750,600,150,0.8,9,6,3,403.5408708153132,0.3822420634920635,0.14518183924021333,0.24095241207603113,132061.28826530598,3458.425453514723,135519.7137188207,745,12,381.3333333333333,34,2,17,32.666155123156514,0.6452205882352942,43.03571428571428,1027.8571428571418,30.23109243697476,0
754,4,0,0,36,0.0,0.0,1.0,36,850,500,350,0.5882352941176471,12,5,7,406.599425245546,0.38235780423280424,0.1521007808781345,0.243367930412043,132153.0771683673,3546.6730442176827,135699.750212585,746,13,382.3333333333333,34,2,17,32.494645131411374,0.646139705882353,42.94642857142857,1028.2142857142853,30.24159663865545,0
755,4,0,0,36,0.0,0.0,1.0,36,1000,800,200,0.8,12,8,4,411.45935469069667,0.3814980158730159,0.15760024168562858,0.24747691040999942,132336.7506377551,3690.2388038548675,136026.98944160997,747,14,383.3333333333333,34,2,18,32.18379999228662,0.6479779411764706,42.76785714285714,1028.928571428571,30.262605042016798,0
756,4,0,0,36,0.0,0.0,1.0,36,600,500,100,0.8333333333333334,7,5,2,413.1914853140845,0.3808201058201058,0.1647782143376859,0.2491310326742996,132429.53619100817,3743.765523979189,136173.30171498735,748,15,384.3333333333333,33,3,18,32.045357582251846,0.651199494949495,42.67769607843137,1029.2892156862738,31.19058229352345,0
757,4,0,0,36,0.0,0.0,1.0,36,1200,800,400,0.6666666666666666,16,8,8,410.69539761481906,0.3808201058201058,0.1619494360479723,0.24845741009052014,132555.70461180795,3688.0035623317945,136243.70817413973,749,16,385.3333333333333,33,3,18,31.98200543456702,0.6524621212121213,42.55514705882353,1029.7794117647059,31.2054367201426,0
758,4,1,1,36,0.02702702702702703,0.02702702702702703,0.972972972972973,37,1150,800,350,0.6956521739130435,15,8,7,400.2607268610242,0.38466591591591587,0.15729467634339467,0.24450341439140974,132919.2247732426,3240.469104308382,136159.69387755098,750,0,375.8918918918919,34,3,16,31.8837547140768,0.6537990196078431,42.20238095238095,1031.190476190476,30.329131652661058,0
759,4,0,0,36,0.0,0.0,1.0,36,800,500,300,0.625,11,5,6,411.12449613167286,0.3807043650793651,0.16213886577101433,0.2503959548851194,132808.22167255377,3720.142643454431,136528.3643160082,751,18,387.3333333333333,33,3,16,31.715783894106906,0.6549873737373737,42.31004901960784,1030.7598039215682,31.235145573380855,0
760,4,0,0,36,0.0,0.0,1.0,36,1100,900,200,0.8181818181818182,13,9,4,407.44449664857825,0.38116732804232806,0.16460145206393206,0.24889169463822164,132919.22477324257,3631.441326530605,136550.66609977317,752,19,388.3333333333333,34,2,16,31.698558839375046,0.6537990196078431,42.20238095238095,1031.1904761904757,30.32913165266105,0
761,4,0,0,36,0.0,0.0,1.0,36,800,700,100,0.875,9,7,2,386.99416266391614,0.38116732804232806,0.16225114261368034,0.22594788086062834,131206.12953514743,2956.34920634921,134162.47874149663,753,20,389.3333333333333,34,2,16,33.95692927414983,0.6366421568627452,43.86904761904762,1024.5238095238096,30.13305322128852,3
762,4,0,0,36,0.0,0.0,1.0,36,1000,800,200,0.8,12,8,4,386.5231163022901,0.3801256613756614,0.15926399215200382,0.22603199627242598,131267.1201814058,2947.555272108831,134214.67545351462,754,21,390.3333333333333,34,2,16,33.907169687112756,0.6372549019607843,43.8095238095238,1024.761904761904,30.140056022408938,0
763,4,0,0,36,0.0,0.0,1.0,36,1350,900,450,0.6666666666666666,18,9,9,384.9020910968971,0.3802744708994709,0.15942800025794845,0.22634344810919918,131480.6990504535,2921.439200680269,134402.13825113376,755,22,391.3333333333333,34,2,17,33.73234668214355,0.6393995098039216,43.601190476190474,1025.5952380952378,30.164565826330524,0
764,4,1,1,36,0.02702702702702703,0.02702702702702703,0.972972972972973,37,1150,1000,150,0.8695652173913043,13,10,3,374.41833803433,0.3852915415415415,0.14237321180513218,0.22204809458827385,131803.09070644723,2469.8988340192063,134272.98954046643,756,0,381.72972972972974,35,2,14,33.67523294259092,0.6404761904761904,43.28703703703704,1026.8518518518522,29.33862433862435,0
765,4,0,0,36,0.0,0.0,1.0,36,700,400,300,0.5714285714285714,10,4,6,380.6427221172023,0.3810681216931217,0.15128824476650604,0.22563872702823848,131786.11288265308,2832.6849489795954,134618.79783163266,757,24,393.3333333333333,34,2,14,33.532608695652165,0.6424632352941175,43.30357142857143,1026.7857142857144,30.199579831932777,0
766,4,0,0,36,0.0,0.0,1.0,36,850,700,150,0.8235294117647058,10,7,3,382.44219905886877,0.3812996031746032,0.15191646381515378,0.22707012052862105,131847.23816609988,2884.7895408163436,134732.0277069162,758,25,394.3333333333333,34,2,14,33.42461651404506,0.6430759803921567,43.24404761904763,1027.0238095238105,30.20658263305325,0
767,4,0,0,36,0.0,0.0,1.0,36,1050,700,350,0.6666666666666666,14,7,7,380.7892111513771,0.381547619047619,0.15466074417407039,0.22663523394733703,131938.9526643992,2848.185941043099,134787.1386054423,759,26,395.3333333333333,34,2,15,33.37437234453458,0.6439950980392156,43.15476190476191,1027.3809523809532,30.21708683473392,0
768,4,0,0,36,0.0,0.0,1.0,36,750,300,450,0.4,12,3,9,378.3936384189391,0.3800760582010582,0.1551019751656697,0.22611965866764988,132091.8810232427,2796.5454931972913,134888.42651643997,760,27,396.3333333333333,34,2,16,33.28146110789423,0.6455269607843137,43.00595238095239,1027.976190476191,30.23459383753503,0
769,4,2,0,38,0.05263157894736842,0.0,1.0,38,950,600,350,0.631578947368421,13,6,7,363.38260007806684,0.38722439544807963,0.16035348451995435,0.22095110786142147,132745.92318247317,2047.5117431620997,134793.43492563526,761,0,376.42105263157896,36,2,15,33.008687575128405,0.6478587962962963,42.370495495495504,1030.5180180180193,28.625500500500536,0
770,4,0,0,38,0.0,0.0,1.0,38,650,400,250,0.6153846153846154,9,4,5,361.2390304407718,0.38707622095779987,0.15326295088754338,0.21998808021453012,132803.95418645014,1994.794329802798,134798.74851625293,762,1,377.42105263157896,36,2,15,33.00557194362504,0.6484375,42.3141891891892,1030.7432432432447,28.631756756756797,0
771,4,0,0,38,0.0,0.0,1.0,38,1350,1100,250,0.8148148148148148,16,11,5,358.807837015072,0.3859649122807018,0.1463217670691963,0.2191863484687801,132920.05423920543,1938.55143149907,134858.6056707045,763,2,378.42105263157896,36,2,15,32.95156710713116,0.6495949074074074,42.20157657657658,1031.1936936936938,28.644269269269273,0
772,4,0,0,38,0.0,0.0,1.0,38,950,500,450,0.5263157894736842,14,5,9,357.5279688734555,0.38648352299668093,0.13924792334470748,0.21925510380311908,133065.2506391527,1914.9097577307102,134980.1603968834,764,3,379.42105263157896,36,2,18,32.83876337044315,0.6510416666666666,42.060810810810814,1031.756756756757,28.65990990990992,0
773,4,1,1,38,0.02564102564102564,0.02564102564102564,0.9743589743589743,39,750,400,350,0.5333333333333333,11,4,7,353.4557267641747,0.3889732343679712,0.13789911825796763,0.21830816330437786,133330.6296769198,1625.2949224761464,134955.92459939595,765,0,370.6666666666667,37,2,18,32.677632975899776,0.6517454954954955,41.80372807017544,1032.7850877192982,27.913110478899952,0
774,4,0,0,38,0.0,0.0,1.0,38,900,700,200,0.7777777777777778,11,7,4,365.40448947549544,0.3861723565670934,0.14839946725452346,0.22513631448328925,133239.59094229373,2137.2689412385416,135376.85988353228,766,5,381.42105263157896,36,2,18,32.46050574461896,0.6527777777777778,41.891891891891895,1032.432432432433,28.678678678678693,0
775,4,0,0,38,0.0,0.0,1.0,38,1250,800,450,0.64,17,8,9,366.44585690309344,0.38615753911806544,0.14543268540995902,0.22630807768742572,133326.80389426593,2171.4109802369994,135498.21487450294,767,6,382.42105263157896,36,2,18,32.34607276560172,0.6536458333333334,41.807432432432435,1032.7702702702707,28.688063063063073,0
776,4,0,0,38,0.0,0.0,1.0,38,1000,700,300,0.7,13,7,6,368.05516048544126,0.38605381697486957,0.14926049590949253,0.22783657505353838,133414.04537983934,2220.7455766577436,135634.79095649708,768,7,383.42105263157896,36,2,18,32.21695370975947,0.6545138888888888,41.722972972972975,1033.1081081081084,28.697447447447455,0
777,4,0,0,38,0.0,0.0,1.0,38,1200,900,300,0.75,15,9,6,373.15183493691427,0.3854018492176387,0.14919925917855958,0.2318998437972874,133559.51126379753,2367.5953402726996,135927.10660407023,769,8,384.42105263157896,36,2,18,31.939299851109425,0.6559606481481481,41.582207207207205,1033.6711711711707,28.713088088088075,0
778,4,0,0,38,0.0,0.0,1.0,38,850,600,250,0.7058823529411765,11,6,5,372.4606306496632,0.38513513513513514,0.14425386524802386,0.23183464745725785,133617.71981018168,2353.4680372940356,135971.18784747572,770,9,385.42105263157896,36,2,18,31.898758305195514,0.6565393518518519,41.52590090090089,1033.8963963963952,28.71934434434431,0
779,4,0,0,38,0.0,0.0,1.0,38,800,600,200,0.75,10,6,4,361.33344731633576,0.384631341868184,0.15657852819369245,0.22283412399331587,133274.01369892654,2031.2717615035358,135305.28546043008,771,10,386.42105263157896,37,1,16,32.53103872429294,0.6511824324324325,41.858552631578945,1032.565789473684,27.907183499288756,2
780,4,0,0,38,0.0,0.0,1.0,38,750,500,250,0.6666666666666666,10,5,5,363.87260465828155,0.3850165955429113,0.15665144919842833,0.22474203693615458,133330.62967691995,2103.0727002539384,135433.7023771739,772,11,387.42105263157896,37,1,16,32.40867307215911,0.6517454954954953,41.803728070175445,1032.7850877192993,27.91311047889998,0
781,4,0,0,38,0.0,0.0,1.0,38,1050,700,350,0.6666666666666666,14,7,7,366.3100595890123,0.38449798482693215,0.15633623434514954,0.22676566238158186,133415.57618690372,2174.2935326254287,135589.86971952915,773,12,388.42105263157896,37,1,16,32.26048963418948,0.6525900900900901,41.72149122807018,1033.11403508772,27.922000948316754,0
782,4,0,0,38,0.0,0.0,1.0,38,1050,700,350,0.6666666666666666,14,7,7,368.12094978655347,0.38354966808914176,0.16397908040967502,0.2285936452734093,133530.4117462058,2231.0804224107087,135761.4921686165,774,13,389.42105263157896,36,2,17,32.09849640444542,0.6556712962962963,41.61036036036037,1033.5585585585595,28.70995995995999,0
783,4,0,0,38,0.0,0.0,1.0,38,850,700,150,0.8235294117647058,10,7,3,371.9984241578498,0.3832236842105263,0.16624240339410568,0.2313648735615898,133588.6139517898,2338.9507750994435,135927.56472688925,775,14,390.42105263157896,36,2,17,31.939905591866367,0.65625,41.55405405405406,1033.783783783785,28.716216216216253,0
784,4,0,0,38,0.0,0.0,1.0,38,1000,500,500,0.5,15,5,10,375.6891701089354,0.38266062114746324,0.17161263341220123,0.23495278460114308,133792.4215389377,2452.8727629656814,136245.29430190337,776,15,391.42105263157896,36,2,16,31.640043902616025,0.6582754629629629,41.35698198198199,1034.572072072073,28.73811311311314,0
785,4,0,0,38,0.0,0.0,1.0,38,1000,700,300,0.7,13,7,6,378.8817005895312,0.3813418681839735,0.18107278640465374,0.2378880185668698,133938.09349890446,2549.3385277169236,136487.4320266214,777,16,392.42105263157896,36,2,16,31.411372207716866,0.6597222222222221,41.216216216216225,1035.1351351351364,28.753753753753788,0
786,4,0,0,38,0.0,0.0,1.0,38,450,200,250,0.4444444444444444,7,2,5,384.4424514942838,0.38061581318160265,0.1891159382959846,0.24195402748048886,134025.534719686,2705.0210260936774,136730.55574577968,778,17,393.42105263157896,36,2,16,31.17976255211167,0.6605902777777777,41.131756756756765,1035.4729729729738,28.76313813813816,0
787,4,1,1,38,0.02564102564102564,0.02564102564102564,0.9743589743589743,39,700,500,200,0.7142857142857143,9,5,4,374.0969719356595,0.3843904633378317,0.18029572790496107,0.23758095652248978,134356.87413251534,2252.4999543429185,136609.37408685827,779,0,384.3076923076923,38,1,16,31.11581993679582,0.6600877192982455,40.81196581196582,1036.752136752138,27.28295096716153,0
788,4,0,0,38,0.0,0.0,1.0,38,700,500,200,0.7142857142857143,9,5,4,381.01683647729703,0.38068990042674256,0.19001269572577217,0.24137876262623395,134266.5291243459,2631.5616343490233,136898.09075869492,780,19,395.42105263157896,37,1,16,31.026943151361266,0.661036036036036,40.89912280701754,1036.4035087719294,28.01090564248458,0
789,4,0,0,38,0.0,0.0,1.0,38,850,600,250,0.7058823529411765,11,6,5,378.9677938393445,0.3800972024656235,0.18993231810490707,0.24082792060113156,134380.19390581705,2585.153124038153,136965.3470298552,781,20,396.42105263157896,37,1,16,30.966229554427517,0.6621621621621623,40.78947368421052,1036.842105263157,28.022759601706944,0
790,4,0,0,38,0.0,0.0,1.0,38,850,400,450,0.47058823529411764,13,4,9,377.569355270506,0.38033428165007116,0.18492281666314203,0.24031298533973386,134437.04433094792,2551.8616305016835,136988.9059614496,782,21,397.42105263157896,37,1,16,30.94558398533868,0.6627252252252254,40.734649122807014,1037.0614035087715,28.028686581318148,0
791,4,0,0,38,0.0,0.0,1.0,38,950,700,250,0.7368421052631579,12,7,5,365.36160928271244,0.3807936225699384,0.14704490747038435,0.221331038870446,132606.5394188312,2168.3173478086765,134774.8567666399,783,22,398.42105263157896,35,3,20,33.097937034123674,0.6485119047619048,42.505787037037024,1029.97685185185,29.427910052909997,7
792,4,0,0,38,0.0,0.0,1.0,38,700,400,300,0.5714285714285714,10,4,6,377.1613171088214,0.38006756756756754,0.15873790716250968,0.22775627397711928,132487.35592689048,2407.970571844994,134895.32649873546,784,23,399.42105263157896,35,3,17,32.914207419898815,0.6473214285714286,42.62152777777778,1029.5138888888891,29.41468253968255,2
793,4,0,0,38,0.0,0.0,1.0,38,1150,900,250,0.782608695652174,14,9,5,356.0822150026867,0.38097143195827404,0.09212979262499932,0.21126309164668147,131819.15181651223,1787.6911117198022,133606.842928232,785,24,400.42105263157896,36,2,18,34.12974741382461,0.6385995370370372,43.27139639639638,1026.9144144144125,28.525400400400347,6
794,4,0,0,38,0.0,0.0,1.0,38,650,500,150,0.7692307692307693,8,5,3,356.48669934640026,0.38117887624466573,0.0966162528346961,0.21182509346830708,131876.97991488094,1802.477857925472,133679.4577728064,786,25,401.42105263157896,36,2,18,34.061049592515424,0.6391782407407409,43.21509009009008,1027.1396396396383,28.53165665665662,0
795,4,0,0,38,0.0,0.0,1.0,38,1100,800,300,0.7272727272727273,14,8,6,356.85977657722236,0.3811047889995258,0.0980064145457904,0.21253189304768755,131963.74584043483,1818.510571382171,133782.256411817,787,26,402.42105263157896,36,2,19,33.96399605436212,0.6400462962962965,43.13063063063062,1027.4774774774758,28.541041041040994,0
796,4,0,0,38,0.0,0.0,1.0,38,800,400,400,0.5,12,4,8,355.1780771413422,0.3803787339971551,0.09960902585158005,0.21201506279064908,132050.5402995899,1780.2913978167132,133830.8316974066,788,27,403.42105263157896,36,2,19,33.91973448741829,0.640914351851852,43.04617117117116,1027.8153153153135,28.550425425425374,0
797,4,0,0,38,0.0,0.0,1.0,38,750,600,150,0.8,9,6,3,355.000813731562,0.3800823850165955,0.09193378254529083,0.21255819214314062,132166.31063073207,1783.8295643616598,133950.14019509373,789,28,404.42105263157896,36,2,19,33.80767896907968,0.6420717592592593,42.93355855855856,1028.2657657657658,28.56293793793794,0
798,4,0,0,38,0.0,0.0,1.0,38,1200,900,300,0.75,15,9,6,359.5996200039007,0.3802009246088194,0.10089303719067777,0.2159725528425794,132282.1316882761,1913.7208576820024,134195.8525459581,790,29,405.42105263157896,36,2,20,33.5727969348659,0.6432291666666667,42.820945945945944,1028.716216216216,28.575450450450447,0
799,4,1,0,39,0.02564102564102564,0.0,1.0,39,950,700,250,0.7368421052631579,12,7,5,353.8128937860191,0.3847559604138551,0.11279248984167034,0.21496600120465315,132716.91243608482,1591.4416950734603,134308.3541311583,791,0,396.0,36,3,16,33.28438069216757,0.6475694444444444,42.39864864864865,1030.405405405406,28.622372372372393,0
800,4,0,0,39,0.0,0.0,1.0,39,950,500,450,0.5263157894736842,14,5,9,354.633210976087,0.3841655420602789,0.11040882194728363,0.2157980815726826,132774.93709926138,1617.2804561318057,134392.2175553932,792,1,397.0,36,3,16,33.2049460955711,0.6481481481481481,42.34234234234234,1030.6306306306303,28.62862862862862,0
801,4,0,1,38,0.0,0.02564102564102564,0.9743589743589743,39,500,200,300,0.4,8,2,6,354.633210976087,0.38394062078272606,0.11040882194728363,0.2157980815726826,132774.93709926138,1617.2804561318057,134392.2175553932,793,2,398.0,36,3,16,33.2049460955711,0.6481481481481481,42.34234234234234,1030.6306306306303,28.62862862862862,0
802,4,0,0,38,0.0,0.0,1.0,38,900,700,200,0.7777777777777778,11,7,4,358.69358922858544,0.3850758653390232,0.10816152877984764,0.2186778781149219,132845.06715374222,1930.1347897376431,134775.20194347986,794,3,392.07894736842104,35,3,17,33.029850117884806,0.6508928571428572,42.27430555555555,1030.9027777777771,29.45436507936506,0
803,4,0,0,38,0.0,0.0,1.0,38,650,500,150,0.7692307692307693,8,5,3,358.6164677073768,0.38506104788999523,0.11105794790005308,0.21915450804339695,132934.5703125,1934.5052083333333,134869.07552083334,795,4,393.07894736842104,35,3,17,32.94191919191919,0.6517857142857143,42.1875,1031.25,29.464285714285715,0
804,4,0,0,38,0.0,0.0,1.0,38,1100,800,300,0.7272727272727273,14,8,6,357.8670972725406,0.3850906827880512,0.11340694821870767,0.21929233967316006,133036.2050183629,1921.8561044152234,134958.06112277813,796,5,394.07894736842104,36,2,17,32.859176581886985,0.6507523148148149,42.08896396396396,1031.6441441441439,28.656781781781774,0
805,4,0,0,38,0.0,0.0,1.0,38,1300,900,400,0.6923076923076923,17,9,8,358.3053260810053,0.385209222380275,0.11800623517996445,0.22058998819238237,133210.52629910305,1946.008212604478,135156.53451170752,797,6,395.07894736842104,36,2,17,32.67290280353441,0.652488425925926,41.920045045045036,1032.3198198198188,28.675550550550522,0
806,4,1,1,38,0.02564102564102564,0.02564102564102564,0.9743589743589743,39,800,500,300,0.625,11,5,6,347.1483879523179,0.387342555105713,0.10828632338929789,0.2154009977172698,133501.31539901384,1469.2100884668355,134970.52548748069,798,0,385.9230769230769,36,3,19,32.66953615923866,0.6553819444444444,41.63851351351351,1033.4459459459456,28.70683183183182,0
807,4,0,0,38,0.0,0.0,1.0,38,700,600,100,0.8571428571428571,8,6,2,352.67107328491164,0.3842016358463727,0.1110416140656918,0.21797163639954253,133355.8812190569,1806.1523516760008,135162.0335707329,799,8,397.07894736842104,36,2,19,32.672581407181276,0.6539351851851851,41.77927927927928,1032.882882882883,28.691191191191194,0
808,4,0,0,38,0.0,0.0,1.0,38,750,600,150,0.8,9,6,3,350.0336330361053,0.38433499288762446,0.10495625985945756,0.21685068083094308,133443.13221583073,1741.9168746449152,135185.04909047566,800,9,398.07894736842104,36,2,19,32.6532697547684,0.6548032407407407,41.69481981981982,1033.220720720721,28.70057557557558,0
809,4,0,0,38,0.0,0.0,1.0,38,500,300,200,0.6,7,3,4,350.0336330361053,0.38433499288762446,0.10495625985945756,0.21685068083094308,133443.13221583073,1741.9168746449152,135185.04909047566,801,10,399.07894736842104,36,2,19,32.6532697547684,0.6548032407407407,41.69481981981982,1033.220720720721,28.70057557557558,0
810,4,0,0,38,0.0,0.0,1.0,38,1150,800,350,0.6956521739130435,15,8,7,350.399500321365,0.38442389758179235,0.1085408028079351,0.21741827007769884,133501.3153990138,1755.7588416118724,135257.0742406257,802,11,400.07894736842104,36,2,19,32.58553993679852,0.6553819444444444,41.63851351351351,1033.4459459459454,28.706831831831817,0
811,4,0,0,38,0.0,0.0,1.0,38,850,500,350,0.5882352941176471,12,5,7,347.5883070290279,0.38380156472261734,0.07835910890448439,0.21885099106183745,134040.92084887254,1722.3201886625998,135763.24103753513,803,12,401.07894736842104,35,3,15,32.118424239037296,0.662797619047619,41.116898148148145,1035.532407407407,29.586640211640198,1
812,4,0,0,38,0.0,0.0,1.0,38,1100,800,300,0.7272727272727273,14,8,6,345.5586948774463,0.3832681365576103,0.07656724701197493,0.21817394881109323,134142.16739966313,1670.7984589319017,135812.96585859504,804,13,402.07894736842104,36,2,15,32.06983548936478,0.6617476851851851,41.01914414414414,1035.9234234234232,28.775650650650643,0
813,4,0,0,38,0.0,0.0,1.0,38,1100,1000,100,0.9090909090909091,12,10,2,345.77048987347223,0.3826013513513513,0.07674532996259376,0.21882943932707646,134229.6751988475,1682.5321098125119,135912.20730866,805,14,403.07894736842104,36,2,15,31.97697058610447,0.6626157407407407,40.93468468468468,1036.261261261261,28.78503503503503,0
814,4,0,0,38,0.0,0.0,1.0,38,650,300,350,0.46153846153846156,10,3,7,347.97824278348486,0.38229018492176386,0.07736893575893422,0.2204021863961743,134258.85080604258,1743.8317963233565,136002.68260236594,806,15,404.07894736842104,36,2,15,31.890642544097933,0.6629050925925926,40.906531531531535,1036.3738738738743,28.788163163163176,0
815,4,0,0,38,0.0,0.0,1.0,38,500,300,200,0.6,7,3,4,351.3945288100926,0.38199383594120434,0.08284685096772293,0.22292120177097896,134317.21153163307,1839.6666514487567,136156.87818308183,807,16,405.07894736842104,36,2,15,31.74384392540286,0.6634837962962963,40.85022522522523,1036.5990990991,28.79441941941944,0
816,4,0,1,37,0.0,0.02631578947368421,0.9736842105263158,38,750,700,50,0.9333333333333333,8,7,1,348.3120314633503,0.3814900426742532,0.08409219529762835,0.2213187628490731,134375.5849388241,1760.926593823568,136136.51153264765,808,17,406.07894736842104,36,2,15,31.765459252018402,0.6640625,40.793918918918926,1036.8243243243253,28.800675675675702,0
817,4,0,0,37,0.0,0.0,1.0,37,1150,1000,150,0.8695652173913043,13,10,3,355.441251068945,0.38181931931931934,0.08896346100455066,0.225448430918801,134310.7263803155,2147.9145233196145,136458.6409036351,809,18,396.6216216216216,35,2,15,31.645451838618424,0.6654761904761904,40.85648148148148,1036.574074074074,29.61640211640211,0
818,4,0,0,37,0.0,0.0,1.0,37,500,100,400,0.2,9,1,8,355.2964507374491,0.3814752252252252,0.09274340769260969,0.22554148187493486,134340.72151759686,2146.1563089420456,136486.8778265389,810,19,397.6216216216216,35,2,16,31.619241003312126,0.6657738095238095,40.8275462962963,1036.6898148148148,29.619708994708994,0
819,4,0,0,37,0.0,0.0,1.0,37,700,400,300,0.5714285714285714,10,4,6,358.6814413265304,0.3810685685685686,0.09539092664092697,0.22825182629870144,134430.72702331972,2243.5613854595463,136674.28840877928,811,20,398.6216216216216,35,2,16,31.441592261904763,0.6666666666666665,40.74074074074075,1037.0370370370379,29.629629629629655,0
820,4,0,0,37,0.0,0.0,1.0,37,750,500,250,0.6666666666666666,10,5,5,358.4991497022753,0.38072447447447444,0.09829983984654223,0.22832344566326165,134460.7355565202,2240.8118730710044,136701.5474295912,812,21,399.6216216216216,35,2,17,31.41634583193841,0.6669642857142856,40.711805555555564,1037.1527777777787,29.632936507936535,0
821,4,1,1,37,0.02631578947368421,0.02631578947368421,0.9736842105263158,38,900,700,200,0.7777777777777778,11,7,4,346.19133025647824,0.38349039829302983,0.09521282060062286,0.22263434083858072,134813.78971877307,1734.273039931851,136548.0627587049,813,0,390.07894736842104,36,2,12,31.383512253307302,0.6684027777777777,40.371621621621635,1038.5135135135154,28.847597597597648,0
822,4,0,0,37,0.0,0.0,1.0,37,950,600,350,0.631578947368421,13,6,7,354.1345276934794,0.37941066066066065,0.10549249215767209,0.22703592415173826,134700.92438539528,2140.449647419414,136841.3740328147,814,23,401.6216216216216,35,2,19,31.28983628795481,0.669345238095238,40.480324074074076,1038.0787037037042,29.659391534391546,0
823,4,0,0,37,0.0,0.0,1.0,37,900,600,300,0.6666666666666666,12,6,6,355.56998152870295,0.37941066066066065,0.11073489896494793,0.22852248383062504,134791.0504543897,2185.5302640603722,136976.58071845007,815,24,402.6216216216216,35,2,14,31.162691336008315,0.6702380952380952,40.393518518518526,1038.425925925927,29.6693121693122,0
824,4,0,1,36,0.0,0.02702702702702703,0.972972972972973,37,800,700,100,0.875,9,7,2,355.9434682140698,0.37891016016016016,0.11198718218999004,0.22914179940839782,134851.15124528483,2199.877293381367,137051.0285386662,816,25,403.6216216216216,35,2,14,31.09306515117748,0.6708333333333332,40.33564814814816,1038.657407407409,29.67592592592597,0
825,4,0,0,36,0.0,0.0,1.0,36,650,500,150,0.7692307692307693,8,5,3,355.9434682140698,0.37862103174603173,0.09975113290245896,0.22914179940839782,134851.15124528483,2399.877293381367,137251.0285386662,817,26,397.9166666666667,35,1,14,31.09306515117748,0.6708333333333332,40.33564814814816,1038.657407407409,29.67592592592597,0
826,4,0,0,36,0.0,0.0,1.0,36,550,300,250,0.5454545454545454,8,3,5,358.52481002128775,0.378042328042328,0.10787753889569651,0.23137866423875653,134941.32754897562,2475.962764703381,137417.290313679,818,27,398.9166666666667,35,1,14,30.936119156362555,0.6717261904761904,40.2488425925926,1039.0046296296307,29.685846560846592,0
827,4,1,0,37,0.02702702702702703,0.0,1.0,37,800,400,400,0.5,12,4,8,354.4890065116764,0.38310185185185186,0.11890253712961774,0.23113083494434603,135311.28415155044,2193.272537740473,137504.5566892909,819,0,389.1081081081081,36,1,15,30.672511455063685,0.6733217592592591,39.89301801801803,1040.4279279279299,28.90077577577583,0
828,4,0,0,37,0.0,0.0,1.0,37,1150,800,350,0.6956521739130435,15,8,7,355.76521178587336,0.38144394394394393,0.1276636792535566,0.23329114526043862,135516.40111395184,2242.4042285528867,137758.80534250473,820,1,390.1081081081081,36,1,17,30.435233254019764,0.6753472222222222,39.69594594594595,1041.2162162162165,28.92267267267268,0
829,4,0,0,37,0.0,0.0,1.0,37,550,300,250,0.5454545454545454,8,3,5,354.53985749093044,0.3809121621621621,0.12188464415973077,0.2328682245792704,135575.0344939535,2213.350681762859,137788.38517571636,821,2,391.1081081081081,36,1,18,30.408827133794702,0.6759259259259258,39.63963963963965,1041.4414414414423,28.928928928928954,0
830,4,0,0,37,0.0,0.0,1.0,37,900,600,300,0.6666666666666666,12,6,6,348.28758982237014,0.38063063063063063,0.12106519142075167,0.22970100275312857,135721.6734259599,2054.0349048372887,137775.70833079718,822,3,392.1081081081081,36,1,18,30.42594293742571,0.6773726851851851,39.49887387387388,1042.0045045045056,28.944569569569598,0
831,4,0,0,37,0.0,0.0,1.0,37,1000,700,300,0.7,13,7,6,368.953685230952,0.38063063063063063,0.12554604929069302,0.21593874529176152,131299.26960321798,2288.669877647908,133587.9394808659,823,4,393.1081081081081,36,1,17,34.324753690070686,0.6333912037037038,43.77815315315315,1024.8873873873865,28.46909409409407,8
832,4,0,0,37,0.0,0.0,1.0,37,950,400,550,0.42105263157894735,15,4,11,365.8489068905346,0.37978603603603606,0.12135629197240605,0.21528240457263687,131506.13667052437,2222.278440461823,133728.41511098619,824,5,394.1081081081081,35,2,17,34.19515910629654,0.6375000000000002,43.57638888888887,1025.6944444444418,29.305555555555483,0
833,4,0,0,37,0.0,0.0,1.0,37,800,500,300,0.625,11,5,6,368.3578551366956,0.3801614114114114,0.12621758814652262,0.21726496246086494,131595.18771701364,2294.8242187499754,133890.0119357636,825,6,395.1081081081081,35,2,14,34.040820642978,0.6383928571428572,43.48958333333332,1026.0416666666647,29.315476190476133,0
834,4,0,0,37,0.0,0.0,1.0,37,1150,700,450,0.6086956521739131,16,7,9,368.73490858631635,0.3800988488488488,0.12981264594167796,0.21765670436260176,131624.87809713633,2306.9374785665086,133931.81557570284,826,7,396.1081081081081,35,2,14,34.00114670275959,0.6386904761904763,43.46064814814814,1026.1574074074063,29.318783068783034,0
835,4,0,0,37,0.0,0.0,1.0,37,900,500,400,0.5555555555555556,13,5,8,368.34427166254056,0.3798485985985986,0.13211961275592676,0.21787527814432575,131703.53366457683,2302.448436612295,134005.98210118912,827,8,397.1081081081081,36,1,14,33.93170597915524,0.6374421296296295,43.38400900900901,1026.4639639639645,28.512887887887903,0
836,4,0,0,37,0.0,0.0,1.0,37,1100,1000,100,0.9090909090909091,12,10,2,365.67092759310566,0.38006756756756754,0.13259838786154576,0.2171171132584064,131848.0642804967,2242.6007933609258,134090.66507385764,828,9,398.1081081081081,36,1,14,33.85439510233918,0.638888888888889,43.24324324324324,1027.0270270270269,28.528528528528525,0
837,4,0,1,36,0.0,0.02702702702702703,0.972972972972973,37,1250,1000,250,0.8,15,10,5,363.6410211140449,0.38075575575575576,0.15157185514126037,0.20798003961966582,130410.31867551856,2138.088051589331,132548.40672710788,829,10,399.1081081081081,35,2,17,35.36130783758262,0.6264880952380952,44.64699074074073,1021.412037037036,29.18320105820103,7
838,4,0,1,35,0.0,0.027777777777777776,0.9722222222222222,36,1350,900,450,0.6666666666666666,18,9,9,372.58522815473094,0.380489417989418,0.15086904715649396,0.21295194352694433,130384.14292800442,2515.8411281179065,132899.98405612234,830,11,392.75,34,2,18,35.15949799898979,0.6283700980392157,44.672619047619044,1021.309523809523,30.03851540616244,0
839,4,1,1,35,0.027777777777777776,0.027777777777777776,0.9722222222222222,36,600,200,400,0.3333333333333333,10,2,8,369.3273846210204,0.3865079365079365,0.1363003947453567,0.21208532421213783,130566.58340419496,2444.3629535147275,133010.94635770968,831,0,371.5833333333333,34,2,15,35.0575131042516,0.6302083333333334,44.49404761904761,1022.0238095238091,30.059523809523796,0
840,4,1,1,35,0.027777777777777776,0.027777777777777776,0.9722222222222222,36,850,600,250,0.7058823529411765,11,6,5,369.11778457501987,0.3834490740740741,0.14700556202302506,0.21280011875835017,130718.71456916085,2450.1204648525927,133168.83503401343,832,0,372.55555555555554,34,2,16,34.90856616220412,0.6317401960784315,44.34523809523809,1022.6190476190463,30.077030812324892,0
841,4,2,2,35,0.05405405405405406,0.05405405405405406,0.9459459459459459,37,600,300,300,0.5,9,3,6,359.1239233824414,0.3905467967967968,0.13124532107008058,0.20856540396045253,131002.08340031285,2009.1964323988216,133011.27983271168,833,0,360.64864864864865,35,2,16,34.87716694931222,0.6324404761904763,44.06828703703703,1023.7268518518513,29.24933862433861,0
842,4,1,0,36,0.027777777777777776,0.0,1.0,36,1050,1000,50,0.9523809523809523,11,10,1,369.27873626767763,0.3861937830687831,0.15623627580149346,0.2149212239089691,131084.19075963713,2481.3208616779957,133565.51162131512,834,0,371.6388888888889,34,2,17,34.53411997209951,0.6354166666666667,43.988095238095234,1024.0476190476186,30.119047619047606,0
843,4,1,1,36,0.02702702702702703,0.02702702702702703,0.972972972972973,37,500,300,200,0.6,7,3,4,361.95462936201386,0.3920482982982983,0.14221909750884287,0.212170953943928,131358.63272392293,2109.399801587301,133468.03252551024,835,0,362.56756756756755,34,3,18,34.444073471915765,0.6381740196078431,43.720238095238095,1025.1190476190477,30.150560224089638,0
844,4,0,0,36,0.0,0.0,1.0,36,1100,1000,100,0.9090909090909091,12,10,2,374.77691850089246,0.38546626984126986,0.15831074977416448,0.21951219512195122,131328.12499999997,2643.7499999999995,133971.87499999997,836,2,373.6388888888889,33,3,18,34.14634146341464,0.6401515151515151,43.75,1024.9999999999998,31.060606060606055,0
845,4,0,0,36,0.0,0.0,1.0,36,1100,900,200,0.8181818181818182,13,9,4,371.8774938496488,0.3844246031746032,0.14867133888158857,0.2190701267428157,131548.0392907776,2583.951034457907,134131.99032523553,837,3,374.6388888888889,33,3,20,33.99820312188907,0.642361111111111,43.53553921568628,1025.8578431372553,31.086601307189554,0
846,4,2,1,37,0.05263157894736842,0.02631578947368421,0.9736842105263158,38,1050,600,450,0.5714285714285714,15,6,9,353.64500410093115,0.3930032005689901,0.13659147869674193,0.21154401154401162,132130.12695312512,1745.4318576389032,133875.55881076402,838,0,355.86842105263156,35,3,16,33.87896825396827,0.6437499999999999,42.96875000000001,1028.125000000001,29.375000000000025,0
847,4,0,1,36,0.0,0.02702702702702703,0.972972972972973,37,800,800,0,1.0,8,8,0,363.43201579136723,0.3887324824824825,0.1557966025312021,0.2173544936547262,132122.47732426302,2203.507653061221,134325.98497732423,839,1,366.4864864864865,34,3,16,33.635122356029036,0.6458333333333333,42.976190476190474,1028.0952380952378,30.23809523809523,0
848,4,0,0,36,0.0,0.0,1.0,36,950,800,150,0.8421052631578947,11,8,3,371.31031075181164,0.3838293650793651,0.15926526619297676,0.2213501797244225,132000.11337868482,2602.600623582765,134602.71400226757,840,2,377.52777777777777,34,2,16,33.55609939759036,0.6446078431372548,43.095238095238095,1027.6190476190477,30.224089635854344,0
849,4,0,0,36,0.0,0.0,1.0,36,1000,600,400,0.6,14,6,8,371.49063496877005,0.3842096560846561,0.15918568284489765,0.2216363961081821,132030.6990504536,2609.6336451247294,134640.33269557834,841,3,378.52777777777777,34,2,16,33.52059925093633,0.6449142156862744,43.0654761904762,1027.738095238096,30.22759103641459,0
850,4,1,1,36,0.02702702702702703,0.02702702702702703,0.972972972972973,37,1050,700,350,0.6666666666666666,14,7,7,359.58317812485745,0.3892017017017017,0.12066975123438528,0.21341682538473966,131832.8045294281,2081.4819708425994,133914.2865002707,842,0,369.27027027027026,35,2,21,34.026095082459896,0.6407738095238096,43.25810185185185,1026.9675925925922,29.341931216931204,7
851,4,0,0,36,0.0,0.0,1.0,36,1050,700,350,0.6666666666666666,14,7,7,369.50401803359773,0.3846230158730159,0.1477038582393242,0.21956478426955092,131877.80612244888,2545.8758503401255,134423.681972789,843,1,380.4166666666667,34,2,21,33.725950394065826,0.6433823529411765,43.21428571428571,1027.1428571428564,30.210084033613423,0
852,4,0,0,36,0.0,0.0,1.0,36,1000,700,300,0.7,13,7,6,373.0935368209599,0.38397817460317457,0.15574029016851454,0.2222339762803107,131969.53124999985,2647.3958333333208,134616.92708333317,844,2,381.4166666666667,34,2,21,33.541159772911605,0.6443014705882353,43.12499999999999,1027.4999999999989,30.220588235294084,0
853,4,0,0,36,0.0,0.0,1.0,36,950,600,350,0.631578947368421,13,6,7,372.6471761928979,0.3845568783068783,0.14980825161506184,0.22250592802555166,132061.288265306,2642.453231292502,134703.74149659852,845,3,382.4166666666667,34,2,21,33.46001274032892,0.6452205882352942,43.03571428571428,1027.857142857142,30.231092436974762,0
854,4,0,0,36,0.0,0.0,1.0,36,950,600,350,0.631578947368421,13,6,7,370.2759995692024,0.3845238095238095,0.1558616963803352,0.2218061084798035,132183.68055555542,2588.8888888888723,134772.5694444443,846,4,383.4166666666667,34,2,22,33.39748784440842,0.6464460784313726,42.91666666666666,1028.3333333333321,30.24509803921565,0
855,4,0,0,36,0.0,0.0,1.0,36,1050,800,250,0.7619047619047619,13,8,5,370.70723587399334,0.3845238095238095,0.1585345470441517,0.22278525260243737,132306.12953514722,2609.3679138321786,134915.4974489794,847,5,384.4166666666667,34,2,22,33.26294067731235,0.6476715686274511,42.79761904761904,1028.8095238095225,30.259103641456544,0
856,4,0,0,36,0.0,0.0,1.0,36,900,700,200,0.7777777777777778,11,7,4,371.1187717389526,0.38444113756613757,0.15925861647833206,0.22321360780374136,132336.75063775497,2622.5304705215212,134959.28110827648,848,6,385.4166666666667,34,2,22,33.22148945196497,0.6479779411764707,42.76785714285713,1028.9285714285702,30.26260504201677,0
857,4,0,1,35,0.0,0.027777777777777776,0.9722222222222222,36,800,600,200,0.75,10,6,4,401.94856066299735,0.38445767195767194,0.228325979409012,0.2253841119507088,129637.82709775069,3221.5617742194663,132859.38887197015,849,7,386.4166666666667,33,3,13,35.170978740473316,0.6231060606060608,45.40441176470587,1018.382352941175,30.86007130124773,5
858,4,0,0,35,0.0,0.0,1.0,35,1250,900,350,0.72,16,9,7,407.77738503828004,0.3843837535014005,0.22172250159359708,0.22910500992262156,129715.36705438235,3578.998635343351,133294.3656897257,850,8,379.8857142857143,32,3,15,34.943346141133695,0.6263020833333333,45.32828282828284,1018.68686868687,31.833964646464686,0
859,4,0,0,35,0.0,0.0,1.0,35,800,500,300,0.625,11,5,6,413.87938138972015,0.3832282913165266,0.22981704943557846,0.23368266610773433,129908.37191358028,3753.279320987662,133661.65123456795,851,9,380.8857142857143,32,3,16,34.590712988192564,0.6282552083333333,45.13888888888889,1019.4444444444447,31.857638888888896,0
860,4,0,0,35,0.0,0.0,1.0,35,800,700,100,0.875,9,7,2,401.9436135751532,0.3832282913165266,0.20296747194217235,0.21287704781025368,127363.21576193765,3239.53074215385,130602.7465040915,852,10,381.8857142857143,30,5,15,37.5047159343098,0.6076388888888891,47.64784946236558,1009.4086021505364,33.646953405017875,7
861,4,2,2,35,0.05405405405405406,0.05405405405405406,0.9459459459459459,37,950,800,150,0.8421052631578947,11,8,3,380.6930269846781,0.39417542542542544,0.17929581886119927,0.2036211801647506,127761.29548324145,2327.5668617998094,130088.86234504127,853,0,362.18918918918916,32,5,15,37.6319158236543,0.6064453125,47.253787878787875,1010.984848484848,31.5932765151515,0
862,4,4,4,35,0.10256410256410256,0.10256410256410256,0.8974358974358975,39,850,600,250,0.7058823529411765,11,6,5,368.8608648152889,0.40660143949617633,0.16595081576861315,0.19948502078726374,128204.80619331043,1657.9471371881789,129862.75333049861,854,0,344.5128205128205,34,5,15,37.47648994945338,0.606311274509804,46.815476190476176,1012.7380952380934,29.786414565826277,0
863,4,3,3,35,0.07894736842105263,0.07894736842105263,0.9210526315789473,38,1000,800,200,0.8,12,8,4,377.4062109762034,0.3987671882408725,0.17567223142602262,0.2034840275889971,128082.49831795444,2067.8260765090095,130150.32439446345,855,0,354.5,33,5,15,37.385492332526226,0.6073232323232324,46.93627450980391,1012.2549019607827,30.67439096850857,0
864,4,2,1,36,0.05405405405405406,0.02702702702702703,0.972972972972973,37,550,200,350,0.36363636363636365,9,2,7,385.0130497141622,0.39295545545545546,0.19942756776984072,0.20757563009807928,128080.61876657997,2462.5419281195823,130543.16069469955,856,0,365.02702702702703,32,5,16,37.19491913018169,0.6097005208333334,46.938131313131315,1012.2474747474749,31.632733585858592,0
865,4,4,5,35,0.1,0.125,0.875,40,650,400,250,0.6153846153846154,9,4,5,357.6542436997175,0.4092280982905983,0.17166970802919668,0.1959945255474451,128731.13854595328,1208.2475994512904,129939.38614540457,857,0,338.55,35,5,15,37.22247566909974,0.6095238095238096,46.29629629629629,1014.8148148148142,28.994708994708976,0
866,4,0,0,35,0.0,0.0,1.0,35,600,400,200,0.6666666666666666,8,4,4,404.7138788974886,0.38389355742296916,0.2096905926934256,0.2167591712770965,127815.15333387592,3345.7132975260465,131160.86663140196,858,16,387.8857142857143,31,4,16,36.96937505365267,0.6095430107526882,47.200520833333336,1011.1979166666671,32.619287634408614,0
867,4,1,0,36,0.027777777777777776,0.0,1.0,36,1000,800,200,0.8,12,8,4,394.13009020371857,0.3876818783068783,0.20805834119025168,0.21318107382507145,128210.45769585519,2906.743706597242,131117.20140245243,859,0,378.0833333333333,31,5,18,36.8309119739436,0.6135752688172043,46.80989583333334,1012.760416666668,32.6696908602151,0
868,4,1,1,36,0.02702702702702703,0.02702702702702703,0.972972972972973,37,500,200,300,0.4,8,2,6,383.38349409354237,0.3937374874874875,0.19478447056922388,0.20852321751917086,128432.33471074396,2447.7674471992855,130880.10215794324,860,0,368.8378378378378,32,5,15,36.87562282012955,0.61328125,46.5909090909091,1013.6363636363649,31.676136363636402,0
869,4,0,0,36,0.0,0.0,1.0,36,750,500,250,0.6666666666666666,10,5,5,389.36567599177295,0.38761574074074073,0.20442474085496465,0.2113001178917698,128342.36145019541,2794.422064887168,131136.78351508258,861,2,380.0833333333333,31,5,18,36.81626402809905,0.6149193548387096,46.67968750000001,1013.2812500000008,32.68649193548389,0
870,4,0,0,36,0.0,0.0,1.0,36,950,600,350,0.631578947368421,13,6,7,388.9310663839801,0.3872850529100529,0.20468765139875167,0.21137099999080633,128400.34060618824,2787.7762792062176,131188.11688539447,862,3,381.0833333333333,32,4,15,36.767835638054905,0.6129557291666666,46.622474747474755,1013.5101010101018,31.672190656565682,0
871,4,3,1,38,0.07692307692307693,0.02564102564102564,0.9743589743589743,39,1100,900,200,0.8181818181818182,13,9,4,361.45806822831383,0.400978407557355,0.19840115854691098,0.20014657977181916,129142.5607103052,1535.9241040809302,130678.48481438613,863,0,352.6923076923077,35,4,18,36.70623624079556,0.6136904761904762,45.8912037037037,1016.4351851851851,29.041005291005288,0
872,4,0,0,38,0.0,0.0,1.0,38,750,500,250,0.6666666666666666,10,5,5,369.8084871394087,0.39824857752489334,0.2037978118485808,0.20413619852831263,129019.90504535146,1942.5311791383174,130962.43622448978,864,1,362.86842105263156,34,4,18,36.61920943676272,0.6145833333333333,46.01190476190476,1015.9523809523808,29.88095238095238,0
873,4,2,2,38,0.05,0.05,0.95,40,950,700,250,0.7368421052631579,12,7,5,352.1213079958808,0.40355235042735044,0.18467246673490267,0.19658429594970023,129466.28146701386,1117.6948253259593,130583.97629233982,865,0,345.675,35,5,11,36.61399692937563,0.6169642857142856,45.572916666666664,1017.708333333333,29.077380952380945,0
874,4,2,2,38,0.05,0.05,0.95,40,900,600,300,0.6666666666666666,12,6,6,353.01789989609256,0.40637019230769234,0.18396328293736475,0.19767654139948612,129584.09857521005,1149.1012677897777,130733.19984299983,866,0,346.625,35,5,11,36.47135860710089,0.6181547619047618,45.457175925925924,1018.1712962962963,29.090608465608465,0
875,4,0,2,36,0.0,0.05263157894736842,0.9473684210526316,38,1400,1000,400,0.7142857142857143,18,10,8,367.05217242410083,0.3976410621147463,0.1632475567111984,0.20677507218133123,129819.89354263117,1930.134789737651,131750.02833236882,867,4,365.86842105263156,35,3,15,35.8741482112436,0.6205357142857143,45.22569444444444,1019.0972222222222,29.11706349206349,1
876,4,0,0,36,0.0,0.0,1.0,36,1000,600,400,0.6,14,6,8,383.7026141741644,0.38852513227513225,0.18120610074252452,0.21430061941603462,129481.87183114664,2736.506541955012,132218.37837310164,868,5,386.97222222222223,33,3,15,35.79457656030503,0.6215277777777778,45.557598039215684,1017.769607843137,30.84150326797385,0
877,4,1,1,36,0.02702702702702703,0.02702702702702703,0.972972972972973,37,1000,800,200,0.8,12,8,4,373.57588195331704,0.39514514514514515,0.17239440889826563,0.2100566621390595,129746.60572562349,2294.040532879811,132040.64625850332,869,0,377.4864864864865,34,3,15,35.782552387629515,0.6219362745098039,45.297619047619044,1018.8095238095231,29.964985994397736,0
878,4,2,2,36,0.05263157894736842,0.05263157894736842,0.9473684210526316,38,950,800,150,0.8421052631578947,11,8,3,370.6230094056382,0.3967075628259839,0.16762208448282068,0.21021050224590038,130085.41907793199,2042.5298996913452,132127.94897762334,870,0,368.5,35,3,16,35.513104152484686,0.6232142857142857,44.96527777777777,1020.138888888888,29.14682539682537,0
879,4,0,0,36,0.0,0.0,1.0,36,650,500,150,0.7692307692307693,8,5,3,386.28762532673005,0.38870701058201057,0.18490171639271935,0.21720430338673827,129746.60572562362,2823.901643990937,132570.50736961456,871,8,389.97222222222223,34,2,16,35.458781257303116,0.6219362745098038,45.29761904761905,1018.8095238095241,29.964985994397768,0
880,4,1,1,36,0.02702702702702703,0.02702702702702703,0.972972972972973,37,1000,600,400,0.6,14,6,8,378.6836999878132,0.3935810810810811,0.1798204738313638,0.2151079574157577,130144.46159122078,2456.7172496570593,132601.17884087784,872,0,380.4054054054054,35,2,17,35.24746672716274,0.6238095238095238,44.907407407407405,1020.3703703703698,29.153439153439137,0
881,4,0,0,36,0.0,0.0,1.0,36,700,400,300,0.5714285714285714,10,4,6,386.0793428147286,0.3880952380952381,0.18559264879447013,0.21860817778544475,130019.64462868478,2839.5797902494332,132859.2244189342,873,10,391.97222222222223,34,2,17,35.18588770864948,0.6246936274509804,45.029761904761905,1019.8809523809522,29.99649859943977,0
882,4,0,0,36,0.0,0.0,1.0,36,700,400,300,0.5714285714285714,10,4,6,399.36414526096416,0.3880787037037037,0.19252480098801272,0.21818726272772263,128610.25694744803,3079.0162296536228,131689.27317710166,874,11,392.97222222222223,33,3,16,36.28818311787686,0.6126893939393939,46.41544117647059,1014.338235294117,30.737522281639908,3
883,4,0,0,36,0.0,0.0,1.0,36,700,300,400,0.42857142857142855,11,3,8,399.9381549161009,0.3883597883597884,0.19574610842726825,0.21901375150167413,128703.50346020744,3094.6883410226615,131798.1918012301,875,12,393.97222222222223,33,3,17,36.17803945249597,0.6136363636363638,46.323529411764696,1014.7058823529399,30.748663101604237,0
884,4,1,0,37,0.02702702702702703,0.0,1.0,37,900,600,300,0.6666666666666666,12,6,6,388.788163010506,0.39376876876876876,0.19119998733355503,0.2147771502456096,129050.14349489793,2634.633645124709,131684.77714002263,876,0,384.2972972972973,34,3,18,36.10622925209919,0.614889705882353,45.982142857142854,1016.0714285714283,29.884453781512597,0
885,4,0,0,37,0.0,0.0,1.0,37,1200,800,400,0.6666666666666666,16,8,8,394.1929706067611,0.3938313313313313,0.198191867201003,0.218263267382654,129140.88010204074,2781.2854308389933,131922.16553287974,877,1,385.2972972972973,34,3,18,35.87613219333177,0.6158088235294117,45.89285714285714,1016.4285714285708,29.894957983193258,0
886,4,1,1,37,0.02631578947368421,0.02631578947368421,0.9736842105263158,38,900,500,400,0.5555555555555556,13,5,8,383.19674497884967,0.3986634660976766,0.18977970386421084,0.21435793673665354,129544.24267409173,2328.2147693636343,131872.45744345535,878,0,376.13157894736844,33,5,16,35.7438254885438,0.6221590909090908,45.49632352941177,1018.0147058823533,30.848930481283432,0
887,4,0,0,37,0.0,0.0,1.0,37,1000,600,400,0.6,14,6,8,394.76432996812895,0.39295545545545546,0.194327741347609,0.22047866579591877,129481.87183114672,2822.9648752883595,132304.83670643508,879,3,387.2972972972973,33,4,16,35.51311960666265,0.6215277777777777,45.55759803921569,1017.7696078431377,30.84150326797387,0
888,4,0,0,37,0.0,0.0,1.0,37,950,600,350,0.631578947368421,13,6,7,392.9326236670313,0.3923923923923924,0.19153359578891438,0.2202585624408774,129625.34722222235,2786.8055555555657,132412.15277777793,880,4,388.2972972972973,34,3,16,35.41325695581014,0.6207107843137254,45.41666666666667,1018.3333333333344,29.950980392156893,0
889,4,1,0,38,0.02631578947368421,0.0,1.0,38,1500,1200,300,0.8,18,12,6,386.9717756715713,0.3946627548601233,0.20054817097201805,0.21948321948321944,130085.41907793214,2467.8771219135824,132553.29619984573,881,0,379.05263157894734,35,3,17,35.09615384615384,0.6232142857142856,44.96527777777778,1020.1388888888891,29.146825396825403,0
890,4,2,1,39,0.05,0.025,0.975,40,900,700,200,0.7777777777777778,11,7,4,369.82137143614864,0.40221688034188036,0.19994057724957592,0.21313580017210482,130706.03358892718,1667.8180459104583,132373.85163483763,882,0,361.05,35,5,17,34.90343803056027,0.6294642857142858,44.35763888888887,1022.5694444444421,29.216269841269774,0
891,4,0,0,39,0.0,0.0,1.0,39,850,400,450,0.47058823529411764,13,4,9,377.63785285993737,0.3979419703103914,0.2067709033346774,0.21685758975267966,130566.58340419494,2061.376842403616,132627.96024659855,883,1,371.3076923076923,34,5,17,34.84517569403999,0.6302083333333334,44.49404761904761,1022.023809523809,30.059523809523792,0
892,4,0,0,39,0.0,0.0,1.0,39,1150,900,250,0.782608695652174,14,9,5,379.8608515386015,0.39754835807467387,0.20837065434177737,0.2186491282180634,130657.85147392277,2126.360544217673,132784.21201814045,884,2,372.3076923076923,34,5,17,34.695699425555034,0.6311274509803921,44.4047619047619,1022.3809523809513,30.07002801120445,0
893,4,0,0,39,0.0,0.0,1.0,39,1000,500,500,0.5,15,5,10,386.798437760241,0.39774516419253264,0.16871865025079824,0.212593727821606,128848.62075617274,2179.200522801702,131027.82127897444,885,3,373.3076923076923,35,4,16,36.36285909712721,0.6107142857142858,46.18055555555555,1015.2777777777769,29.007936507936485,8
894,4,2,2,39,0.04878048780487805,0.04878048780487805,0.9512195121951219,41,950,700,250,0.7368421052631579,12,7,5,373.55145094495623,0.4065294715447154,0.17571298935198976,0.20792550363237594,129348.51794249381,1464.6298171724761,130813.14775966629,886,0,356.0487804878049,35,6,17,36.18882030568514,0.6157738095238096,45.6886574074074,1017.2453703703688,29.064153439153397,0
895,4,0,0,39,0.0,0.0,1.0,39,800,400,400,0.5,12,4,8,379.072467727614,0.40117521367521364,0.1398601398601398,0.1994250808480058,127092.01388888898,1838.6350362225753,128930.64892511156,887,1,361.35897435897436,36,3,17,38.360881542699715,0.5908564814814814,47.91666666666667,1008.3333333333342,28.00925925925928,5
896,4,0,0,39,0.0,0.0,1.0,39,550,400,150,0.7272727272727273,7,4,3,381.9528914773926,0.40159694107062527,0.14388984509466485,0.20137443733971402,127179.55789448282,1915.3199749228172,129094.87786940564,888,2,362.35897435897436,35,4,17,38.19814974182445,0.59375,47.8298611111111,1008.6805555555538,28.819444444444397,0
897,4,3,4,38,0.07142857142857142,0.09523809523809523,0.9047619047619048,42,900,600,300,0.6666666666666666,12,6,6,362.17688792240483,0.4135331978319783,0.1476924701658049,0.19452370684839754,127928.27641034762,866.5330055153686,128794.809415863,889,0,337.4047619047619,38,4,17,37.92881156053086,0.5956688596491229,47.08867521367521,1011.6452991452983,26.622244714349954,0
898,4,4,4,38,0.09523809523809523,0.09523809523809523,0.9047619047619048,42,1100,900,200,0.8181818181818182,13,9,4,349.95119752399705,0.41295247773906313,0.16891104818139846,0.18987054675729897,128333.90404704507,582.303309226385,128916.20735627145,890,0,337.3333333333333,38,4,19,37.823351609728654,0.5997807017543859,46.68803418803419,1013.2478632478632,26.664417453891136,0
899,4,3,3,38,0.07317073170731707,0.07317073170731707,0.926829268292683,41,1100,800,300,0.7272727272727273,14,8,6,358.17808641099595,0.41008638211382115,0.17880726562809146,0.19490031835607163,128450.01737313402,1001.5962844336655,129451.61365756768,891,0,346.1463414634146,37,4,16,37.496281773931834,0.602759009009009,46.5734649122807,1013.706140350877,27.397463252726407,0
900,4,2,2,38,0.05,0.05,0.95,40,1200,1000,200,0.8333333333333334,14,10,4,366.00222222222243,0.40678418803418803,0.1806555555555558,0.1989142512077295,128401.20525931333,1399.0252921840745,129800.2305514974,892,0,355.725,36,4,16,37.34791666666668,0.6041666666666667,46.62162162162162,1013.5135135135132,28.153153153153145,0
901,4,0,0,38,0.0,0.0,1.0,38,1200,1000,200,0.8333333333333334,14,10,4,385.4494481473708,0.3986338311996207,0.20065518798760174,0.20845635444308183,128204.80619331037,2283.2943594104,130488.10055272077,893,2,375.44736842105266,34,4,20,37.056492692292636,0.606311274509804,46.815476190476176,1012.7380952380929,29.786414565826263,0
902,4,1,1,38,0.02564102564102564,0.02564102564102564,0.9743589743589743,39,1500,1100,400,0.7333333333333333,19,11,8,375.83960245006045,0.40291835357624833,0.18389432221890578,0.20505022395189448,128555.01570001697,1863.2131987311172,130418.22889874809,894,0,366.79487179487177,35,4,17,36.94124248649471,0.6077380952380953,46.4699074074074,1014.120370370369,28.974867724867686,0
903,4,3,2,39,0.07317073170731707,0.04878048780487805,0.9512195121951219,41,1500,1200,300,0.8,18,12,6,357.87788726031533,0.4065040650406504,0.1846701172805234,0.19804000818005113,129117.79495854468,1041.6807334948896,130159.47569203956,895,0,349.8292682926829,37,4,19,36.822450282303016,0.6095157657657658,45.91557017543858,1016.3377192982434,27.468587008060634,0
904,4,1,0,40,0.025,0.0,1.0,40,1400,1200,200,0.8571428571428571,16,12,4,356.42300456866457,0.4077857905982906,0.17500000000000004,0.19765275707898639,129201.38888888867,1210.0694444444184,130411.4583333331,896,0,347.025,36,4,20,36.774248633879786,0.6122685185185187,45.83333333333332,1016.6666666666649,28.24074074074069,0
905,4,3,3,40,0.06976744186046512,0.06976744186046512,0.9302325581395349,43,750,600,150,0.8,9,6,3,337.37079277702014,0.41675895164267257,0.1894671829346508,0.19091676654838294,129996.88042534716,171.43012152776572,130168.31054687493,897,0,323.74418604651163,39,4,20,36.45088525706503,0.6148504273504274,45.05208333333333,1019.7916666666661,26.14850427350426,0
906,4,2,0,42,0.047619047619047616,0.0,1.0,42,1400,1100,300,0.7857142857142857,17,11,6,344.1952115824242,0.4134364111498258,0.20390317609921804,0.1952893687106693,130099.0430843194,555.8935322156383,130654.93661653504,898,0,332.2857142857143,38,4,22,36.173290396900214,0.6175986842105263,44.95192307692307,1020.1923076923067,26.84716599190281,0
907,4,1,0,43,0.023255813953488372,0.0,1.0,43,1450,1100,350,0.7586206896551724,18,11,7,336.4934868862536,0.41519010705057213,0.20174333480881157,0.19266770788062018,130453.51765103363,179.45453466286023,130632.97218569649,899,0,325.5348837209302,38,5,23,36.010815380324885,0.6211622807017544,44.60470085470085,1021.5811965811963,26.883715699505167,0
908,4,0,0,43,0.0,0.0,1.0,43,750,500,250,0.6666666666666666,10,5,5,338.5142226792928,0.41539774824658543,0.2025487555246539,0.1943713717977262,130562.68376981532,239.46508145228069,130802.1488512676,900,1,326.5348837209302,38,5,16,35.848752526308466,0.6222587719298245,44.49786324786326,1022.0085470085481,26.894961763382845,0
909,4,0,0,43,0.0,0.0,1.0,43,900,600,300,0.6666666666666666,12,6,6,340.25758754463686,0.4151208933185677,0.19990620892084388,0.19606293620648513,130699.20562358461,294.2792798962639,130993.48490348087,901,2,327.5348837209302,38,5,17,35.66611813464285,0.6236293859649124,44.36431623931624,1022.5427350427349,26.909019343229865,0
910,4,0,0,43,0.0,0.0,1.0,43,1100,900,200,0.8181818181818182,13,9,4,338.97074763615535,0.4155131044665928,0.18991317019855525,0.19587476817237107,130808.47447083432,268.0492777047342,131076.52374853907,902,3,328.5348837209302,38,5,17,35.58855526544822,0.6247258771929824,44.25747863247864,1022.970085470086,26.920265407107525,0
911,4,1,1,43,0.022727272727272728,0.022727272727272728,0.9772727272727273,44,450,100,350,0.2222222222222222,8,1,7,334.01418154585855,0.41711812896405914,0.1996074569312285,0.19441642503122197,131088.0004882815,-42.949761284694375,131045.05072699682,903,0,322.04545454545456,39,5,18,35.43309005526737,0.6258012820512819,43.984375000000014,1024.062500000002,26.258012820512874,0
912,4,1,0,44,0.022727272727272728,0.0,1.0,44,1200,600,600,0.5,18,6,12,338.3717613719098,0.4161931818181818,0.20282687634552632,0.19805114575480243,131301.43364800382,85.73947482642728,131387.17312283025,904,0,322.8863636363636,39,5,21,35.106146457973374,0.6279380341880341,43.776041666666686,1024.8958333333362,26.279380341880415,0
913,4,1,1,44,0.022222222222222223,0.022222222222222223,0.9777777777777777,45,1250,900,350,0.72,16,9,7,328.2749536273696,0.41786616161616164,0.19393734276463448,0.19348773299078215,131568.46923828154,-361.8706597221932,131206.59857855935,905,0,316.68888888888887,39,6,14,35.09588536907299,0.6306089743589742,43.515625000000014,1025.9375000000023,26.3060897435898,0
914,4,0,0,44,0.0,0.0,1.0,44,900,800,100,0.8888888888888888,10,8,2,338.0891495692267,0.41592891120507397,0.2039631894870384,0.19916147326157768,131547.2334082111,94.93845423333482,131642.17186244443,906,2,324.8863636363636,38,6,22,34.86556620148579,0.6321271929824561,43.53632478632479,1025.8547008547016,26.99617633828162,0
915,4,0,0,44,0.0,0.0,1.0,44,750,400,350,0.5333333333333333,11,4,7,336.2700637888455,0.4154884601832276,0.20367933815455697,0.1983745511442305,131602.0390459493,50.76521294470001,131652.804258894,907,3,325.8863636363636,38,6,16,34.85700402610023,0.6326754385964912,43.48290598290598,1026.068376068376,27.00179937022042,0
916,4,0,0,44,0.0,0.0,1.0,44,1300,700,600,0.5384615384615384,19,7,12,339.97845252981995,0.41442036645525016,0.21256350580421746,0.20128483982495612,131739.10307774483,157.69128040761865,131896.79435815246,908,4,326.8863636363636,38,6,17,34.623790196690614,0.634046052631579,43.34935897435897,1026.6025641025635,27.015856950067462,0
917,4,1,0,45,0.022222222222222223,0.0,1.0,45,1300,900,400,0.6923076923076923,17,9,8,337.08182709782903,0.4151515151515151,0.22124938071431766,0.20135129962478074,132076.58420138896,-95.87673611110671,131980.70746527787,909,0,320.6,39,6,18,34.35853263072556,0.6356837606837606,43.020833333333336,1027.9166666666672,26.35683760683762,0
918,4,1,1,45,0.021739130434782608,0.021739130434782608,0.9782608695652174,46,950,600,350,0.631578947368421,13,6,7,327.84066495556874,0.41642512077294686,0.21267798087845113,0.19737035505421413,132372.47973552824,-520.5836443373869,131851.89609119084,910,0,314.60869565217394,41,5,19,34.29888090876956,0.6354166666666667,42.73313492063491,1029.0674603174587,25.09920634920631,0
919,4,0,1,44,0.0,0.022222222222222223,0.9777777777777777,45,1050,800,250,0.7619047619047619,13,8,5,333.1353018332825,0.4139309764309764,0.22172186011806816,0.20055458182900193,132371.85723610257,-180.45227708377422,132191.4049590188,911,2,322.6,40,5,20,34.16329251431956,0.6369791666666668,42.73373983739836,1029.0650406504044,25.72662601626011,0
920,4,0,0,44,0.0,0.0,1.0,44,1650,1000,650,0.6060606060606061,23,10,13,339.9627507027336,0.4124603594080338,0.22389251428939594,0.20437079054722454,132317.61203342004,196.61187065971183,132514.22390407976,912,3,330.65909090909093,39,5,20,34.04215601903414,0.6380876068376069,42.78645833333333,1028.8541666666658,26.380876068376047,0
921,4,0,0,44,0.0,0.0,1.0,44,1150,700,450,0.6086956521739131,16,7,9,339.41607511010784,0.4126365398167724,0.22326284404936092,0.204332200244531,132371.2036132811,185.78287760415196,132556.98649088526,913,4,331.65909090909093,39,5,21,34.00236613017512,0.6386217948717949,42.73437499999999,1029.0624999999989,26.38621794871792,0
922,4,0,0,44,0.0,0.0,1.0,44,1100,600,500,0.5454545454545454,16,6,10,340.27883550404454,0.4126585623678647,0.22778595499089693,0.20530447993007545,132454.43309479853,214.2934755165145,132668.72657031505,914,5,332.65909090909093,37,7,23,33.89655233631587,0.6430180180180181,42.65350877192983,1029.3859649122817,27.82124229492653,0
923,4,0,0,44,0.0,0.0,1.0,44,1350,800,550,0.5925925925925926,19,8,11,340.829775748834,0.4123942917547569,0.22697266532445415,0.20625471996346956,132567.32840874107,236.57856263464527,132803.90697137572,915,6,333.65909090909093,37,7,24,33.76898779102782,0.6441441441441442,42.5438596491228,1029.8245614035081,27.83309625414887,0
924,4,0,0,44,0.0,0.0,1.0,44,1250,900,350,0.72,16,9,7,338.1294415724277,0.41231721282593375,0.22388915224394612,0.2053912322208211,132708.5151801516,174.53122595413834,132883.0464061057,916,7,334.65909090909093,37,7,17,33.69681369940763,0.6455518018018018,42.406798245614034,1030.372807017544,27.84791370317686,0
925,4,0,0,44,0.0,0.0,1.0,44,1150,800,350,0.6956521739130435,15,8,7,340.97735722846033,0.4120969873150106,0.22399696357254095,0.2077464766885777,132821.51870046544,257.82608591104116,133079.3447863765,917,8,335.65909090909093,37,7,18,33.51006541857248,0.646677927927928,42.297149122807014,1030.8114035087713,27.859767662399225,0
926,4,2,1,45,0.043478260869565216,0.021739130434782608,0.9782608695652174,46,1350,1100,250,0.8148148148148148,16,11,5,325.1651920862776,0.41581119162640906,0.21622036470165162,0.20072775307243776,133310.8127170137,-530.3927951389088,132780.4199218748,918,0,322.0217391304348,39,7,20,33.42789657723085,0.6479700854700856,41.82291666666666,1032.7083333333317,26.479700854700813,0
927,4,0,0,45,0.0,0.0,1.0,45,1200,900,300,0.75,15,9,6,328.7903242907892,0.41254208754208754,0.21701588582831688,0.2025258486044753,133230.14458550327,-239.04351128474318,132991.10107421852,919,1,330.1777777777778,39,6,20,33.41499764571351,0.6471688034188036,41.90104166666666,1032.3958333333317,26.47168803418799,0
928,4,0,0,45,0.0,0.0,1.0,45,1250,1000,250,0.8,15,10,5,325.3738915930532,0.4117424242424242,0.20722216620169664,0.20129338009534015,133391.5052625866,-319.57736545141006,133071.9278971352,920,2,331.1777777777778,39,6,21,33.341841450707555,0.6487713675213677,41.74479166666666,1033.0208333333317,26.487713675213634,0
929,4,0,0,45,0.0,0.0,1.0,45,850,400,450,0.47058823529411764,13,4,9,324.17018824349395,0.4116161616161616,0.20640969631795314,0.20083973124217464,133445.31385633672,-348.201497395843,133097.11235894088,921,3,332.1777777777778,39,6,21,33.31915599690828,0.6493055555555556,41.69270833333333,1033.229166666666,26.49305555555554,0
930,4,0,0,45,0.0,0.0,1.0,45,750,200,550,0.26666666666666666,13,2,11,323.77958055405327,0.41148989898989896,0.2090198105081822,0.20119251392809664,133555.03420857986,-351.51869593914637,133203.5155126407,922,4,333.1777777777778,38,7,22,33.21963824289406,0.6521381578947368,41.58653846153846,1033.653846153846,27.20141700404858,0
931,4,0,0,45,0.0,0.0,1.0,45,1450,1000,450,0.6896551724137931,19,10,9,326.1992129201322,0.41111111111111115,0.1986911896397323,0.2031503206332717,133637.8718770548,-281.48627547663347,133356.38560157816,923,5,334.1777777777778,38,7,22,33.07436970448441,0.6529605263157894,41.50641025641027,1033.974358974361,27.209851551956866,0
932,4,0,0,45,0.0,0.0,1.0,45,1250,800,450,0.64,17,8,9,330.9196691582953,0.4103956228956229,0.19324589486729304,0.20686217924207725,133775.99172921706,-146.17861512891463,133629.81311408815,924,6,335.1777777777778,38,7,19,32.81438259492582,0.654331140350877,41.37286324786326,1034.5085470085485,27.223909131803907,0
933,4,0,2,43,0.0,0.044444444444444446,0.9555555555555556,45,1000,900,100,0.9,11,9,2,334.4230391168931,0.4102272727272727,0.19098355014109725,0.20952273977271868,133858.89788333717,-46.90011140329557,133811.99777193388,925,7,336.1777777777778,38,7,20,32.64096806387226,0.6551535087719296,41.29273504273505,1034.8290598290612,27.232343679712137,0
934,4,0,0,43,0.0,0.0,1.0,43,700,400,300,0.5714285714285714,10,4,6,346.0796584167662,0.4093069398301956,0.18629967746672116,0.2162644722596204,133763.2966581449,658.5512032302897,134421.8478613752,926,8,341.13953488372096,36,7,20,32.43500072574207,0.6579861111111109,41.38513513513515,1034.4594594594616,28.734984984985047,0
935,4,0,0,43,0.0,0.0,1.0,43,1200,800,400,0.6666666666666666,16,8,8,342.3693633483843,0.40884551495016613,0.1825968253029564,0.21456056117410707,133869.08111149594,566.5344144352196,134435.61552593115,927,9,342.13953488372096,37,6,20,32.42521367521368,0.6570945945945945,41.28289473684211,1034.8684210526321,27.969416785206274,0
936,4,0,0,43,0.0,0.0,1.0,43,1150,800,350,0.6956521739130435,15,8,7,338.2458623964519,0.40884551495016613,0.1776821032201492,0.21263098753310908,133982.57757194526,463.8104993844282,134446.38807132968,928,10,343.13953488372096,37,6,20,32.418537739179556,0.6582207207207207,41.17324561403509,1035.30701754386,27.98127074442865,0
937,4,0,0,43,0.0,0.0,1.0,43,1500,1300,200,0.8666666666666667,17,13,4,336.03248751702574,0.4087993724621632,0.17487316646077433,0.2119606354246953,134107.77043839952,412.9135391555375,134520.68397755505,929,11,344.13953488372096,38,5,20,32.350868145091965,0.6576206140350876,41.05235042735043,1035.790598290599,27.257647323436817,0
938,4,0,2,41,0.0,0.046511627906976744,0.9534883720930233,43,900,600,300,0.6666666666666666,12,6,6,335.03245271840825,0.4084763750461425,0.15027497214334495,0.21293319932103114,134384.56658859274,405.3687038863011,134789.93529247906,930,12,345.13953488372096,38,5,19,32.1007212776919,0.6603618421052634,40.785256410256395,1036.858974358972,27.285762483130846,1
939,4,0,0,41,0.0,0.0,1.0,41,650,400,250,0.6153846153846154,9,4,5,346.68513540122456,0.40609756097560973,0.16811591130145787,0.21958315905694883,134258.85080604232,1109.1095741011059,135367.96038014343,931,22,358.5609756097561,36,5,19,31.92414611177515,0.6629050925925928,40.90653153153152,1036.3738738738723,28.78816316316312,0
940,4,0,0,41,0.0,0.0,1.0,41,1000,500,500,0.5,15,5,10,347.91361048736275,0.40612296747967475,0.17130939888277652,0.22053697458165866,134288.02958363757,1144.126643535415,135432.156227173,932,23,359.5609756097561,36,5,19,31.863184485006528,0.6631944444444446,40.87837837837837,1036.4864864864855,28.791291291291266,0
941,4,0,0,41,0.0,0.0,1.0,41,1100,900,200,0.8181818181818182,13,9,4,348.21149553782044,0.40508130081300814,0.1719236718865882,0.22143173003537622,134404.7763980195,1160.257639396135,135565.0340374156,933,24,360.5609756097561,36,5,19,31.738931726035315,0.6643518518518519,40.76576576576576,1036.9369369369358,28.803803803803774,0
942,4,0,0,41,0.0,0.0,1.0,41,1300,1000,300,0.7692307692307693,16,10,6,348.5427654392671,0.40444613821138214,0.17180918797139766,0.22253115024199355,134550.78125,1179.3402777777774,135730.12152777778,934,25,361.5609756097561,36,5,20,31.584672021418992,0.6657986111111112,40.625,1037.5,28.819444444444443,0
943,4,0,0,41,0.0,0.0,1.0,41,1200,600,600,0.5,18,6,12,346.44162213360846,0.403734756097561,0.16688368055555602,0.22172263816550916,134638.42220598963,1128.870678110528,135767.29288410014,935,26,362.5609756097561,36,5,20,31.551784939236104,0.6666666666666667,40.54054054054053,1037.8378378378366,28.828828828828794,0
944,4,0,0,41,0.0,0.0,1.0,41,900,800,100,0.8888888888888888,10,8,2,346.8399050094869,0.4032520325203252,0.1725333947124046,0.22251336703427,134726.0916955807,1145.6769691989284,135871.7686647796,936,27,363.5609756097561,36,5,20,31.4540622627183,0.6675347222222223,40.45608108108108,1038.1756756756756,28.838213213213212,0
945,4,0,0,41,0.0,0.0,1.0,41,1400,900,500,0.6428571428571429,19,9,10,346.7500973112714,0.4022357723577236,0.18088703813867402,0.2235338677635554,134901.51627556607,1155.4227791981166,136056.9390547642,937,28,364.5609756097561,36,5,20,31.28161698283649,0.6692708333333335,40.28716216216216,1038.8513513513512,28.856981981981978,0
946,4,0,0,41,0.0,0.0,1.0,41,1050,700,350,0.6666666666666666,14,7,7,343.43026238102004,0.4022357723577236,0.17803028301138935,0.22229041527186635,135047.79061155755,1075.8996327408522,136123.6902442984,938,29,365.5609756097561,36,5,20,31.222237269772485,0.6707175925925926,40.1463963963964,1039.4144144144148,28.872622622622632,0
947,4,0,0,41,0.0,0.0,1.0,41,1150,900,250,0.782608695652174,14,9,5,345.37141298069315,0.40091463414634143,0.1831354960723095,0.22427282893556422,135164.86714755304,1136.416230419622,136301.28337797266,939,30,366.5609756097561,36,5,20,31.05529384159988,0.671875,40.03378378378379,1039.8648648648657,28.885135135135158,0
948,4,0,1,40,0.0,0.024390243902439025,0.975609756097561,41,1100,700,400,0.6363636363636364,15,7,8,345.639586458283,0.4009654471544715,0.1518268194730139,0.2206775821233652,134550.78124999988,1101.2152777777637,135651.99652777764,940,31,367.5609756097561,36,5,18,31.659973226238275,0.6657986111111112,40.62499999999999,1037.499999999999,28.819444444444418,2
949,4,0,0,40,0.0,0.0,1.0,40,1200,1000,200,0.8333333333333334,14,10,4,348.69818039882335,0.40189636752136754,0.14781901041666679,0.2231668354552469,134638.42220598977,1389.6345669994314,136028.0567729892,941,32,371.625,36,4,20,31.493236400462962,0.6666666666666666,40.54054054054054,1037.8378378378377,28.828828828828826,0
950,4,0,0,40,0.0,0.0,1.0,40,650,400,250,0.6153846153846154,9,4,5,351.7401233049926,0.40128205128205124,0.14779483562981444,0.22529455986811098,134667.6421987867,1473.6026144387722,136141.24481322546,942,33,372.625,36,4,20,31.38516690173954,0.6669560185185185,40.51238738738739,1037.950450450451,28.831956956956972,0
951,4,0,0,40,0.0,0.0,1.0,40,1050,900,150,0.8571428571428571,12,9,3,352.7521986062551,0.40068108974358974,0.14892624728850312,0.22648852863159308,134755.32119957817,1507.047165408676,136262.36836498685,943,34,373.625,36,4,20,31.271466015907446,0.667824074074074,40.42792792792794,1038.28828828829,28.84134134134139,0
952,4,0,0,40,0.0,0.0,1.0,40,1200,1100,100,0.9166666666666666,13,11,2,350.23986399299235,0.39970619658119655,0.1512535627573106,0.22554875809691477,134863.80575032707,1446.9361967143814,136310.74194704145,944,35,374.625,37,3,15,31.22855747915129,0.6669481981981982,40.323464912280706,1038.7061403508776,28.0731389284021,0
953,4,1,1,40,0.024390243902439025,0.024390243902439025,0.975609756097561,41,950,700,250,0.7368421052631579,12,7,5,341.986931765277,0.40266768292682925,0.1463163989362637,0.22171051519040072,135105.57204918197,1040.868009898473,136146.44005908043,945,0,366.4634146341463,38,3,15,31.202257390470326,0.6674890350877192,40.09081196581197,1039.636752136753,27.358861898335608,0
954,4,0,0,40,0.0,0.0,1.0,40,1300,1100,200,0.8461538461538461,15,11,4,345.32197485963553,0.3989583333333333,0.15390740350137122,0.2239632671422074,135120.1872210684,1331.993978916631,136452.18119998503,946,37,376.625,37,3,15,31.101033537228435,0.6694819819819817,40.07675438596493,1039.6929824561432,28.09981033665252,0
955,4,0,0,40,0.0,0.0,1.0,40,900,700,200,0.7777777777777778,11,7,4,345.7415726119827,0.39818376068376066,0.15420708561788277,0.22458993662000334,135177.1939442908,1347.275123114834,136524.46906740565,947,38,377.625,37,3,15,31.033407141852962,0.6700450450450448,40.02192982456142,1039.9122807017563,28.105737316263685,0
956,4,0,0,40,0.0,0.0,1.0,40,800,500,300,0.625,11,5,6,351.01331160936894,0.39818376068376066,0.14903176675369934,0.2203903251580133,133938.09349890405,1420.3401820720665,135358.43368097613,948,39,378.625,36,4,18,32.132560922541344,0.6597222222222224,41.2162162162162,1035.1351351351332,28.7537537537537,7
957,4,0,0,40,0.0,0.0,1.0,40,800,600,200,0.75,10,6,4,347.90712703776546,0.39738247863247866,0.14320876561507556,0.2193812230973782,134096.12212411483,1330.5993190212057,135426.72144313605,949,40,379.625,37,3,18,32.05501446820522,0.6593468468468471,41.063596491228054,1035.7456140350855,27.99312470365096,0
958,4,0,0,40,0.0,0.0,1.0,40,750,500,250,0.6666666666666666,10,5,5,350.27944269407385,0.39728899572649573,0.14521907080114338,0.22139066582048797,134181.31209843376,1400.1910443597633,135581.50314279352,950,41,380.625,37,3,18,31.908469150174632,0.6601914414414416,40.98135964912279,1036.0745614035059,28.002015173067726,0
959,4,0,0,40,0.0,0.0,1.0,40,500,200,300,0.4,8,2,6,348.35995470819404,0.39608707264957266,0.14809848725272445,0.22086161313591887,134294.94081111453,1356.5958996998606,135651.5367108144,951,42,381.625,37,3,18,31.844718607849362,0.6613175675675678,40.871710526315766,1036.5131578947335,28.013869132290093,0
960,4,0,0,40,0.0,0.0,1.0,40,1050,600,450,0.5714285714285714,15,6,9,350.21225057273057,0.3958199786324786,0.15161514683153055,0.22258087045241287,134384.56658859274,1412.6243014463855,135797.19089003914,952,43,382.625,38,2,18,31.70723853683667,0.6603618421052634,40.785256410256395,1036.858974358972,27.285762483130846,0
961,4,0,0,40,0.0,0.0,1.0,40,1200,1000,200,0.8333333333333334,14,10,4,368.0309409436833,0.395446047008547,0.1775011266336186,0.21894387612708663,131921.96609224967,1710.5812478186067,133632.54734006827,953,44,383.625,35,5,14,33.71920534775423,0.6416666666666666,43.1712962962963,1027.314814814815,29.35185185185186,6
962,4,0,0,40,0.0,0.0,1.0,40,800,600,200,0.75,10,6,4,366.0689557350132,0.395446047008547,0.17236409469530933,0.21801652429022594,131963.74584043506,1661.5661269377551,133625.3119673728,954,45,384.625,36,4,14,33.72744045009499,0.6400462962962963,43.130630630630634,1027.4774774774778,28.54104104104105,0
963,4,0,0,40,0.0,0.0,1.0,40,1200,1100,100,0.9166666666666666,13,11,2,366.6488142925504,0.39528579059829055,0.17682405784399657,0.21902947492554983,132079.47812677556,1685.3568095122303,133764.83493628778,955,46,385.625,36,4,14,33.595804119193694,0.6412037037037037,43.018018018018026,1027.927927927929,28.553553553553584,0
964,4,1,0,41,0.024390243902439025,0.0,1.0,41,1350,900,450,0.6666666666666666,18,9,9,357.8538570167905,0.39939024390243905,0.16862114141325235,0.2159169707584478,132455.95838659612,1280.3587371155033,133736.31712371163,956,0,377.1951219512195,36,5,15,33.442730554643916,0.6449652777777778,42.65202702702703,1029.3918918918923,28.59421921921923,0
965,4,0,0,41,0.0,0.0,1.0,41,1250,800,450,0.64,17,8,9,357.04007664194785,0.39949186991869917,0.16603614515690146,0.21559183491814315,132484.94059938318,1260.486669101538,133745.42726848472,957,1,378.1951219512195,36,5,15,33.4345146940859,0.6452546296296295,42.623873873873876,1029.5045045045047,28.597347347347352,0
966,4,0,0,41,0.0,0.0,1.0,41,900,600,300,0.6666666666666666,12,6,6,355.38628947628257,0.4001270325203252,0.16560506156242671,0.21492408934994253,132542.91453615794,1220.7869186754558,133763.7014548334,958,2,379.1951219512195,36,5,15,33.41877187226597,0.6458333333333333,42.56756756756758,1029.7297297297312,28.603603603603645,0
967,4,0,1,40,0.0,0.024390243902439025,0.975609756097561,41,750,600,150,0.8,9,6,3,358.60735549828007,0.39956808943089434,0.16951566191804468,0.2172068128071043,132600.90115453317,1310.331699943214,133911.2328544764,959,3,380.1951219512195,36,5,15,33.27752569429259,0.646412037037037,42.511261261261275,1029.954954954957,28.609859859859917,0
968,4,0,0,40,0.0,0.0,1.0,40,1150,900,250,0.782608695652174,14,9,5,367.0997554474406,0.3980502136752137,0.17816996402877683,0.22185593916171414,132517.14677640607,1729.402434842254,134246.54921124832,960,4,389.175,35,5,15,33.1431729616307,0.6476190476190475,42.592592592592595,1029.62962962963,29.41798941798943,0
969,4,0,1,39,0.0,0.025,0.975,40,900,700,200,0.7777777777777778,11,7,4,371.7056724303355,0.3980235042735043,0.142530642078039,0.22410701999477775,132427.7842747985,1881.0542856224213,134308.83856042093,961,5,390.175,35,5,19,33.11464541399602,0.6467261904761905,42.679398148148145,1029.2824074074072,29.408068783068774,3
970,4,1,1,39,0.025,0.025,0.975,40,1250,1100,150,0.88,14,11,3,375.4440639679462,0.3987580128205128,0.14192515171948794,0.22725859055692416,132576.73852237652,1955.0298996913566,134531.76842206786,962,0,391.025,35,5,19,32.868341200269725,0.6482142857142856,42.53472222222222,1029.8611111111109,29.424603174603167,0
971,4,1,0,40,0.025,0.0,1.0,40,1400,1000,400,0.7142857142857143,18,10,8,374.000313795034,0.3955662393162393,0.13356437310584823,0.2283734609732662,132904.7325772674,1941.2823377485965,134846.01491501599,963,0,392.0,35,5,16,32.575321771990865,0.6514880952380953,42.21643518518517,1031.134259259257,29.460978835978775,0
972,4,0,1,39,0.0,0.025,0.975,40,900,500,400,0.5555555555555556,13,5,8,371.5629538478619,0.3956730769230769,0.13609412535488064,0.22715444134437376,132949.08717839463,1879.7911086762429,134828.87828707087,964,1,393.0,36,4,16,32.593542986095926,0.6498842592592593,42.17342342342342,1031.3063063063064,28.6473973973974,0
973,4,1,1,39,0.025,0.025,0.975,40,950,600,350,0.631578947368421,13,6,7,366.6040096549971,0.3965411324786325,0.15123308598865148,0.22517152442884683,133123.35139193246,1760.7108797987153,134884.06227173118,965,0,392.3,36,4,17,32.54628619234686,0.6516203703703705,42.0045045045045,1031.9819819819818,28.66616616616616,0
974,4,0,0,39,0.0,0.0,1.0,39,1200,900,300,0.75,15,9,6,377.0179951579928,0.3949336482231219,0.15660665453196598,0.231693277934102,133143.52823055978,2239.5012163494484,135383.02944690923,966,3,403.35897435897436,35,4,17,32.25732215618109,0.6538690476190476,41.9849537037037,1032.0601851851848,29.48743386243385,0
975,4,1,1,39,0.025,0.025,0.975,40,700,600,100,0.8571428571428571,8,6,2,368.61889719541193,0.397542735042735,0.15135194068905378,0.22782833726929386,133355.88121905702,1831.4995738982389,135187.38079295526,967,0,394.25,36,4,17,32.26077554877162,0.6539351851851851,41.77927927927929,1032.882882882884,28.69119119119122,0
976,4,0,0,39,0.0,0.0,1.0,39,550,400,150,0.7272727272727273,7,4,3,376.64943996460806,0.39372469635627527,0.16322869955156927,0.2320243787627283,133233.13185871064,2236.4368998628356,135469.56875857347,968,5,405.35897435897436,35,4,17,32.176756352765324,0.6547619047619048,41.89814814814815,1032.407407407408,29.497354497354518,0
977,4,0,1,38,0.0,0.02564102564102564,0.9743589743589743,39,1000,500,500,0.5,15,5,10,379.24139270640086,0.3940058479532164,0.16549750943656405,0.23475094807887195,133412.4295374657,2319.1031164266137,135731.53265389233,969,6,406.35897435897436,35,4,17,31.92966240944059,0.6565476190476189,41.72453703703704,1033.101851851852,29.51719576719577,0
978,4,0,0,38,0.0,0.0,1.0,38,950,500,450,0.5263157894736842,14,5,9,380.73646717298163,0.39193634423897583,0.1553811074523499,0.2358609420838193,133441.47002551032,2561.2067743764264,136002.67679988674,970,7,405.5263157894737,34,4,17,31.861869647040745,0.6590073529411764,41.69642857142858,1033.2142857142865,30.388655462184897,0
979,4,0,0,38,0.0,0.0,1.0,38,750,600,150,0.8,9,6,3,380.5053203393252,0.39178816974869607,0.15404179727050593,0.23610912693821906,133502.97796201822,2559.718679138331,136062.69664115657,971,8,406.5263157894737,34,4,17,31.80605153016165,0.6596200980392157,41.636904761904766,1033.4523809523816,30.395658263305343,0
980,4,0,0,38,0.0,0.0,1.0,38,1400,1100,300,0.7857142857142857,17,11,6,380.2129675311039,0.3917437174016121,0.15676717709962507,0.23612367554399472,133533.73724489802,2554.2517006802805,136087.98894557828,972,9,407.5263157894737,34,4,18,31.78271135683024,0.6599264705882353,41.60714285714286,1033.5714285714291,30.39915966386556,0
981,4,0,0,38,0.0,0.0,1.0,38,1100,600,500,0.5454545454545454,16,6,10,403.3956265206773,0.3916696301564722,0.19481380135961324,0.23759809389806394,131541.75347222216,3029.0568310657554,134570.81030328793,973,10,408.5263157894737,34,4,19,33.19624966152179,0.6400122549019608,43.541666666666664,1025.833333333333,30.17156862745097,5
982,4,0,0,38,0.0,0.0,1.0,38,750,400,350,0.5333333333333333,11,4,7,405.2221176739756,0.3916844476055002,0.19709677813182935,0.239631351068931,131694.45153061207,3073.100907029456,134767.55243764154,974,11,409.5263157894737,34,4,15,32.99456815897316,0.6415441176470589,43.39285714285713,1026.42857142857,30.18907563025206,0
983,4,0,0,38,0.0,0.0,1.0,38,1200,1000,200,0.8333333333333334,14,10,4,408.30749842470095,0.39180298719772405,0.19043478260869562,0.2420379500971164,131786.11288265296,3161.8516156462492,134947.9644982992,975,12,410.5263157894737,34,4,16,32.82246376811594,0.6424632352941178,43.30357142857142,1026.7857142857135,30.199579831932752,0
984,4,0,0,38,0.0,0.0,1.0,38,600,500,100,0.8333333333333334,7,5,2,407.3520805029566,0.3923215979137032,0.18484493570504856,0.24205466601787243,131877.80612244888,3144.139739229014,135021.9458616779,976,13,411.5263157894737,34,4,17,32.754066218513366,0.6433823529411765,43.21428571428571,1027.1428571428564,30.210084033613423,0
985,4,1,1,38,0.02564102564102564,0.02564102564102564,0.9743589743589743,39,800,600,200,0.75,10,6,4,403.9843923118128,0.39558029689608637,0.18392177568502577,0.24241791319885733,132249.14969403704,2885.3184745798917,135134.46816861694,977,0,401.94871794871796,35,4,18,32.46467218033834,0.6449404761904762,42.85300925925925,1028.5879629629617,29.388227513227477,0
986,4,0,0,38,0.0,0.0,1.0,38,450,300,150,0.6666666666666666,6,3,3,414.6786580770394,0.3914029160739687,0.19114599839106772,0.2480031088056309,132122.4773242629,3357.6743197278743,135480.15164399077,978,15,413.5263157894737,34,4,18,32.31796163347227,0.6458333333333335,42.97619047619047,1028.0952380952372,30.238095238095212,0
987,4,0,0,38,0.0,0.0,1.0,38,1000,700,300,0.7,13,7,6,409.660743697062,0.39135846372688476,0.19491835131167812,0.24599572524574762,132275.5119756234,3237.6169217686866,135513.1288973921,979,16,414.5263157894737,34,4,18,32.292028314624076,0.6473651960784315,42.82738095238094,1028.6904761904748,30.255602240896316,0
988,4,1,0,39,0.02564102564102564,0.0,1.0,39,1150,1000,150,0.8695652173913043,13,10,3,399.40132488551495,0.39439946018893385,0.19266353753374754,0.24195183050756947,132606.53941883138,2792.6455064728966,135399.1849253043,980,0,404.87179487179486,35,4,19,32.221434056260996,0.6485119047619048,42.50578703703703,1029.9768518518513,29.427910052910036,0
989,4,0,0,39,0.0,0.0,1.0,39,700,300,400,0.42857142857142855,11,3,8,403.7435041267904,0.3943432298695457,0.19636514479790512,0.24497075189042647,132666.15125868042,2912.6193576388714,135578.7706163193,981,1,405.87179487179486,35,4,16,32.04941860465116,0.6491071428571429,42.44791666666666,1030.2083333333321,29.434523809523775,0
990,4,1,1,39,0.025,0.025,0.975,40,1250,900,350,0.72,16,9,7,392.4608131042505,0.398303952991453,0.19424672489082973,0.2403035459916399,133007.1625679733,2440.0198340232027,135447.1824019965,982,0,396.7,36,4,16,31.996224526928657,0.650462962962963,42.11711711711711,1031.531531531531,28.65365365365364,0
991,4,0,1,38,0.0,0.02564102564102564,0.9743589743589743,39,1200,900,300,0.75,15,9,6,399.8599653475497,0.3941464237516869,0.19979100275496386,0.24377499735459432,132845.0671537422,2823.8847897376436,135668.95194347983,983,3,407.87179487179486,35,4,16,31.968886830582687,0.6508928571428572,42.27430555555555,1030.902777777777,29.454365079365054,0
992,4,0,0,38,0.0,0.0,1.0,38,1300,1000,300,0.7692307692307693,16,10,6,406.0171530063097,0.3926327643432907,0.21465904947125325,0.24761327781934098,132857.85147392287,3188.5133219954596,136046.36479591834,984,4,417.6578947368421,34,4,17,31.7972959969207,0.6531862745098039,42.26190476190476,1030.9523809523807,30.32212885154061,0
993,4,0,0,38,0.0,0.0,1.0,38,450,100,350,0.2222222222222222,8,1,7,408.30649690998,0.3921437885253675,0.2169510987442056,0.24962308981871245,132949.91673752829,3256.8629535147325,136206.77969104302,985,5,418.6578947368421,34,4,17,31.645359575204886,0.6541053921568627,42.172619047619044,1031.3095238095234,30.332633053221276,0
994,4,0,0,38,0.0,0.0,1.0,38,750,400,350,0.5333333333333333,11,4,7,406.59148504153643,0.3918622569938359,0.22455573505654303,0.24918824677298104,133042.0138888888,3218.7499999999895,136260.7638888888,986,6,419.6578947368421,34,4,17,31.596661281637054,0.6550245098039216,42.08333333333333,1031.6666666666658,30.343137254901936,0
995,4,0,0,38,0.0,0.0,1.0,38,1200,900,300,0.75,15,9,6,405.4445389364568,0.3919956140350877,0.22323038534159823,0.24909983756485768,133134.14292800447,3195.7022392290137,136329.8451672335,987,7,420.6578947368421,34,4,18,31.533337178451944,0.6559436274509804,41.99404761904761,1032.023809523809,30.353641456582615,0
996,4,0,0,38,0.0,0.0,1.0,38,1000,700,300,0.7,13,7,6,405.39318889476067,0.3923364153627311,0.2263837716769146,0.24947937124957195,133195.58000283438,3199.316184807244,136394.89618764163,988,8,421.6578947368421,34,4,18,31.472725175873588,0.6565563725490197,41.9345238095238,1032.2619047619041,30.36064425770306,0
997,4,0,1,37,0.0,0.02631578947368421,0.9736842105263158,38,650,500,150,0.7692307692307693,8,5,3,390.62562372095624,0.3923364153627311,0.23542543144157269,0.22378832461770662,130475.34722222218,2600.549178004525,133075.8964002267,989,9,422.6578947368421,34,4,20,34.6061038607939,0.6292892156862746,44.58333333333333,1021.6666666666662,30.04901960784312,8
998,4,1,1,37,0.02631578947368421,0.02631578947368421,0.9736842105263158,38,800,400,400,0.5,12,4,8,387.83332816297445,0.39455903271692744,0.24147525310715068,0.22323811141177102,130657.8514739229,2534.6938775510203,133192.5453514739,990,0,421.2368421052632,34,4,18,34.49192671945352,0.6311274509803921,44.404761904761905,1022.3809523809523,30.070028011204478,0
999,4,1,0,38,0.02631578947368421,0.0,1.0,38,850,500,350,0.5882352941176471,12,5,7,388.78313194581926,0.3974188003793267,0.2517624504645761,0.22466801969135367,130810.0357851476,2571.3470804988924,133381.3828656465,991,0,422.2105263157895,34,4,19,34.31305519996898,0.6326593137254901,44.255952380952394,1022.9761904761922,30.087535014005653,0
1000,4,0,0,38,0.0,0.0,1.0,38,950,700,250,0.7368421052631579,12,7,5,389.9959104876212,0.396648293029872,0.24858153640876224,0.2264398942797472,130992.77388038555,2617.329223356017,133610.10310374157,992,1,423.2105263157895,34,4,20,34.09650346939567,0.6344975490196079,44.077380952380956,1023.6904761904767,30.108543417366963,0
1001,4,1,1,38,0.02564102564102564,0.02564102564102564,0.9743589743589743,39,650,500,150,0.7692307692307693,8,5,3,378.95705537675616,0.39993814664867294,0.23743363831469555,0.22144599414194216,131239.16437596455,2146.8014564043233,133385.96583236888,993,0,413.3333333333333,35,4,20,34.12932056929853,0.6348214285714285,43.83680555555556,1024.652777777778,29.27579365079366,0
1002,4,1,0,39,0.02564102564102564,0.0,1.0,39,1150,700,450,0.6086956521739131,16,7,9,376.9208598716515,0.3982793522267207,0.24165617269065476,0.22129648030501292,131419.65880102068,2106.9923006818726,133526.65110170256,994,0,414.3076923076923,34,5,21,33.99875188668291,0.6387867647058822,43.6607142857143,1025.357142857145,30.157563025210145,0
1003,4,0,1,38,0.0,0.02564102564102564,0.9743589743589743,39,650,400,250,0.6153846153846154,9,4,5,375.98918594455733,0.3980544309491678,0.24057621620012815,0.22110217316807937,131480.6990504536,2087.0642006802823,133567.7632511339,995,1,415.3076923076923,34,5,21,33.96087250918939,0.6393995098039215,43.60119047619048,1025.5952380952388,30.164565826330552,0
1004,4,1,2,37,0.02564102564102564,0.05128205128205128,0.9487179487179487,39,850,500,350,0.5882352941176471,12,5,7,368.1708135627681,0.40300269905533065,0.22255751237827615,0.21817256426956055,131773.38023244624,1903.0225212191635,133676.4027536654,996,0,403.97435897435895,35,4,16,33.86561548867095,0.6401785714285713,43.315972222222236,1026.7361111111131,29.33531746031752,0
1005,4,0,0,37,0.0,0.0,1.0,37,750,400,350,0.5333333333333333,11,4,7,386.19457199705755,0.3959271771771771,0.23599965122249733,0.22713017379082054,131485.1878634421,2755.7731701749562,134240.96103361703,997,6,426.7567567567568,33,4,20,33.694661847293595,0.6417297979797979,43.59681372549021,1025.6127450980405,31.079174093880013,0
1006,4,0,0,37,0.0,0.0,1.0,37,550,400,150,0.7272727272727273,7,4,3,385.34443478710205,0.3959271771771771,0.2431849255153018,0.22169263965475913,130638.16350682439,2668.1378556324594,133306.30136245684,998,7,427.7567567567568,33,4,16,34.57554143690561,0.6332070707070707,44.42401960784314,1022.3039215686282,30.978906714200853,1
1007,4,0,0,37,0.0,0.0,1.0,37,800,500,300,0.625,11,5,6,382.2972823068673,0.39561436436436437,0.23807750230757985,0.2204748321251423,130732.14215986646,2595.7085315744016,133327.85069144086,999,8,428.7567567567568,33,4,16,34.55799380866785,0.6341540404040404,44.33210784313726,1022.6715686274515,30.990047534165196,0
1008,4,0,0,37,0.0,0.0,1.0,37,900,600,300,0.6666666666666666,12,6,6,382.48159999302015,0.3949261761761762,0.23561558683743633,0.22111886404028638,130826.15460399861,2607.719386774336,133433.87399077296,1000,9,429.7567567567568,33,4,16,34.45785417664911,0.63510101010101,44.24019607843138,1023.0392156862757,31.001188354129567,0
1009,4,1,1,37,0.02631578947368421,0.02631578947368421,0.9736842105263158,38,950,700,250,0.7368421052631579,12,7,5,376.7045518494263,0.39737434803224275,0.22943342897520425,0.21941701148006906,131114.67013888905,2278.298611111131,133392.96875000017,1001,0,419.42105263157896,34,4,17,34.31312720368863,0.6357230392156862,43.95833333333334,1024.166666666668,30.122549019607884,0
1010,4,0,0,37,0.0,0.0,1.0,37,750,600,150,0.8,9,6,3,383.1901055553091,0.39079704704704704,0.23617686074071287,0.22231231629990222,130962.30867346947,2636.692176870756,133599.00085034024,1002,1,431.4864864864865,34,3,17,34.301581763200744,0.6341911764705882,44.10714285714286,1023.5714285714292,30.105042016806742,0
1011,4,2,2,37,0.05128205128205128,0.05128205128205128,0.9487179487179487,39,1150,800,350,0.6956521739130435,15,8,7,366.8845551752254,0.3981668915879442,0.22028879800637347,0.21538968020525695,131417.1157648536,1843.492216041534,133260.60798089515,1003,0,410.3076923076923,35,4,19,34.258592956315624,0.6366071428571427,43.66319444444446,1025.347222222224,29.29563492063497,0
1012,4,0,0,37,0.0,0.0,1.0,37,1100,900,200,0.8181818181818182,13,9,4,380.04739625473536,0.3900462962962963,0.23524756455270035,0.22189198725700524,131206.12953514763,2572.909580498898,133779.03911564653,1004,3,433.4864864864865,34,3,20,34.134857463784975,0.636642156862745,43.869047619047635,1024.5238095238115,30.133053221288574,0
1013,4,0,0,37,0.0,0.0,1.0,37,800,300,500,0.375,13,3,10,377.09035626941613,0.3896396396396396,0.23313557459898915,0.2208672086720869,131328.12500000023,2504.513888888918,133832.63888888914,1005,4,434.4864864864865,34,3,20,34.0870596205962,0.6378676470588234,43.750000000000014,1025.0000000000018,30.147058823529466,0
1014,4,0,0,37,0.0,0.0,1.0,37,800,600,200,0.75,10,6,4,381.66081529723544,0.3897334834834835,0.23749026904279735,0.22409516081347156,131422.35145436853,2631.7523608708293,134054.10381523936,1006,5,435.4864864864865,33,4,20,33.87452193139717,0.6410984848484848,43.65808823529412,1025.3676470588239,31.07174688057042,0
1015,4,1,1,37,0.02631578947368421,0.02631578947368421,0.9736842105263158,38,1200,900,300,0.75,15,9,6,372.2373124808423,0.3935218112849692,0.2277580179729488,0.2210111008102015,131847.23816609988,2215.6923185941223,134062.930484694,1007,0,425.0,34,4,18,33.68663305127315,0.6430759803921567,43.24404761904763,1027.0238095238105,30.20658263305325,0
1016,4,0,0,37,0.0,0.0,1.0,37,800,600,200,0.75,10,6,4,380.2935845263086,0.38932682682682684,0.23802885980536437,0.224953323728274,131705.23356401382,2617.3310745866984,134322.5646386005,1008,7,437.4864864864865,33,4,18,33.62334845590576,0.6439393939393939,43.38235294117647,1026.470588235294,31.10516934046345,0
1017,4,0,0,37,0.0,0.0,1.0,37,750,600,150,0.8,9,6,3,381.5280046410396,0.3892017017017017,0.23913162655556186,0.22661844131088246,131862.52170138882,2661.848958333329,134524.37065972216,1009,8,438.4864864864865,33,4,18,33.43264029749832,0.6455176767676768,43.229166666666664,1027.0833333333328,31.123737373737356,0
1018,4,1,1,37,0.02631578947368421,0.02631578947368421,0.9736842105263158,38,1100,800,300,0.7272727272727273,14,8,6,372.6301310734108,0.39192152678994785,0.23113161551400463,0.2228555271433501,132122.47732426305,2246.563208616776,134369.04053287982,1010,0,427.92105263157896,34,4,18,33.39870889300602,0.6458333333333333,42.976190476190474,1028.095238095238,30.238095238095237,0
1019,4,1,3,35,0.02631578947368421,0.07894736842105263,0.9210526315789473,38,1050,800,250,0.7619047619047619,13,8,5,372.5827251308382,0.3914029160739687,0.22461764293849984,0.22373087754382015,132275.51197562352,2256.7141439909224,134532.22611961444,1011,0,428.89473684210526,34,4,19,33.245573429001276,0.6473651960784315,42.82738095238095,1028.6904761904757,30.255602240896344,0
1020,4,0,0,35,0.0,0.0,1.0,35,750,500,250,0.6666666666666666,10,5,5,396.9004420010252,0.386624649859944,0.24438244991123526,0.23533510418196135,131795.66277398012,3461.9513617621574,135257.61413574227,1012,32,460.0857142857143,31,4,19,33.10560909628877,0.6498655913978495,43.294270833333336,1026.8229166666672,33.123319892473134,0
1021,4,0,0,35,0.0,0.0,1.0,35,1000,700,300,0.7,13,7,6,397.8948241493905,0.386624649859944,0.24181953171685766,0.23654802318873694,131895.957522922,3496.143764919696,135392.10128784168,1013,33,461.0857142857143,31,4,19,32.97854079520007,0.6508736559139785,43.19661458333333,1027.2135416666658,33.13592069892471,0
1022,4,0,0,35,0.0,0.0,1.0,35,750,600,150,0.8,9,6,3,398.17494351542194,0.3862745098039216,0.24165686043775025,0.23713196070039194,131962.84188164596,3508.8594224717835,135471.70130411774,1014,34,462.0857142857143,31,4,19,32.90365078359312,0.6515456989247312,43.131510416666664,1027.4739583333328,33.14432123655912,0
1023,4,2,0,37,0.05405405405405406,0.0,1.0,37,900,700,200,0.7777777777777778,11,7,4,379.58950216532526,0.3922672672672673,0.22826468024611568,0.22963935109396877,132555.70461180786,2663.350784554003,135219.05539636186,1015,0,438.05405405405406,33,4,22,32.782810702526874,0.6524621212121213,42.55514705882352,1029.7794117647052,31.205436720142583,0
1024,4,0,0,37,0.0,0.0,1.0,37,800,400,400,0.5,12,4,8,379.68359162917346,0.3917042042042042,0.23085183684755406,0.23027563284522595,132650.37035034603,2673.0338091118765,135323.40415945792,1016,1,439.05405405405406,33,4,18,32.68498691410897,0.6534090909090909,42.463235294117645,1030.1470588235293,31.216577540106947,0
1025,4,1,2,36,0.02631578947368421,0.05263157894736842,0.9473684210526316,38,750,500,250,0.6666666666666666,10,5,5,372.27707609159944,0.39238086770981506,0.22443140399475126,0.22778309232045302,132980.6122448978,2301.1267006802486,135281.73894557805,1017,0,428.4736842105263,34,4,18,32.54342682363803,0.6544117647058825,42.14285714285713,1031.4285714285702,30.336134453781476,0
1026,4,0,0,36,0.0,0.0,1.0,36,1150,700,450,0.6086956521739131,16,7,9,393.4317450092764,0.3883101851851852,0.24398221895464856,0.2390764312003506,132723.06596584548,3243.4934891847934,135966.55945503028,1018,3,453.22222222222223,32,4,18,32.25758689703058,0.6565755208333333,42.392676767676775,1030.4292929292942,32.200915404040444,0
1027,4,0,0,36,0.0,0.0,1.0,36,1600,1400,200,0.875,18,14,4,389.8785838179776,0.38753306878306876,0.24034792368125713,0.2382591345554309,132934.57031250012,3165.668402777793,136100.2387152779,1019,4,454.22222222222223,33,3,19,32.13594276094276,0.65625,42.18750000000001,1031.250000000001,31.25000000000003,0
1028,4,0,0,36,0.0,0.0,1.0,36,850,600,250,0.7058823529411765,11,6,5,388.30401157031446,0.38700396825396827,0.24014017581373248,0.23789979398827574,133029.371215398,3131.1676999231177,136160.5389153211,1020,5,455.22222222222223,33,3,20,32.08105646630236,0.6571969696969696,42.09558823529412,1031.617647058824,31.261140819964368,0
1029,4,0,0,36,0.0,0.0,1.0,36,850,700,150,0.8235294117647058,10,7,3,387.373571981107,0.38720238095238096,0.23911580780495445,0.23813578271714514,133155.82498317974,3116.209510765111,136272.03449394484,1021,6,456.22222222222223,33,3,20,31.97775666904139,0.6584595959595958,41.973039215686285,1032.1078431372566,31.275995246583534,0
1030,4,0,0,36,0.0,0.0,1.0,36,1150,800,350,0.6956521739130435,15,8,7,385.03426889237807,0.38700396825396827,0.24027052681537753,0.2379082711308626,133345.61827181865,3068.526528258377,136414.14480007702,1022,7,457.22222222222223,33,3,20,31.84721563043823,0.6603535353535352,41.78921568627452,1032.843137254903,31.298276886512213,0
1031,4,0,0,36,0.0,0.0,1.0,36,800,600,200,0.75,10,6,4,386.02066561692163,0.3865740740740741,0.23594965071833385,0.23892468510650902,133408.9127378894,3099.7194588619896,136508.63219675136,1023,8,458.22222222222223,33,3,20,31.75810597073942,0.6609848484848484,41.727941176470594,1033.0882352941187,31.305704099821778,0
1032,4,1,1,36,0.02702702702702703,0.02702702702702703,0.972972972972973,37,1050,1000,50,0.9523809523809523,11,10,1,373.3624040524004,0.3906719219219219,0.22584445023707622,0.23291785617617763,133700.6447843333,2583.7888685313565,136284.43365286465,1024,0,446.81081081081084,32,5,17,31.792261832092137,0.6663411458333334,41.44570707070707,1034.217171717172,32.31928661616163,0
1033,4,0,0,36,0.0,0.0,1.0,36,1000,700,300,0.7,13,7,6,382.27004803025204,0.3863095238095238,0.2348026868178006,0.23787023364891866,133606.80474175353,3014.775933159728,136621.58067491325,1025,10,460.22222222222223,31,5,21,31.65617128463476,0.668010752688172,41.536458333333336,1033.854166666667,33.35013440860216,0
1034,4,0,0,36,0.0,0.0,1.0,36,1050,900,150,0.8571428571428571,12,9,3,380.9257790501263,0.3865079365079365,0.23587720011932878,0.23826762088066678,133798.59995153558,2993.4671844709787,136792.06713600655,1026,11,461.22222222222223,32,4,18,31.49840330323001,0.6673177083333333,41.351010101010104,1034.5959595959598,32.331123737373744,0
1035,4,0,0,36,0.0,0.0,1.0,36,900,700,200,0.7777777777777778,11,7,4,382.77697866402,0.385598544973545,0.24025947616723586,0.2398501618601154,133863.92332415073,3048.005624426097,136911.92894857682,1027,12,462.22222222222223,32,4,18,31.384974377745248,0.66796875,41.287878787878796,1034.848484848486,32.339015151515184,0
1036,4,0,1,35,0.0,0.027777777777777776,0.9722222222222222,36,800,500,300,0.625,11,5,6,381.49375371802523,0.38526785714285716,0.2364972899729001,0.2398963788717642,133994.617896133,3023.6219518416447,137018.23984797462,1028,13,463.22222222222223,32,4,19,31.287093495934954,0.6692708333333334,41.16161616161616,1035.3535353535349,32.354797979797965,0
1037,4,0,0,35,0.0,0.0,1.0,35,1050,800,250,0.7619047619047619,13,8,5,393.29314446366794,0.3831582633053221,0.24829831932773105,0.23878512342436964,132690.5417814507,3437.2560835628838,136127.7978650136,1029,14,466.37142857142857,32,3,19,32.2939644607843,0.65625,42.424242424242415,1030.3030303030291,32.19696969696966,2
1038,4,0,0,35,0.0,0.0,1.0,35,700,200,500,0.2857142857142857,12,2,10,393.5566539630232,0.38172268907563023,0.257853206193684,0.23998432259955807,132853.20255905003,3457.052373482291,136310.25493253232,1030,15,467.37142857142857,32,3,19,32.12313737497448,0.6578776041666667,42.26641414141414,1030.934343434343,32.21669823232322,0
1039,4,0,0,35,0.0,0.0,1.0,35,1350,900,450,0.6666666666666666,18,9,9,395.4763552383373,0.381547619047619,0.2654425266250464,0.24199598096943634,132983.40292125792,3518.358298898058,136501.76122015598,1031,16,468.37142857142857,32,3,19,31.942404211041747,0.6591796875,42.14015151515151,1031.439393939393,32.232481060606034,0
1040,4,0,0,35,0.0,0.0,1.0,35,1050,700,350,0.6666666666666666,14,7,7,399.9243967253627,0.3799719887955182,0.2667254835425861,0.24543465163466127,133092.5905901576,3645.3948000768883,136737.9853902345,1032,17,469.37142857142857,33,2,19,31.717636579572456,0.6578282828282829,42.03431372549019,1031.8627450980389,31.268568033273905,0
1041,4,0,0,35,0.0,0.0,1.0,35,950,700,250,0.7368421052631579,12,7,5,398.5222531619378,0.37958683473389354,0.26046369634165023,0.24519743888845855,133187.44781153864,3615.6323589484587,136803.0801704871,1033,18,470.37142857142857,33,2,19,31.658232419169742,0.6587752525252526,41.9424019607843,1032.2303921568612,31.27970885323822,0
1042,4,0,0,35,0.0,0.0,1.0,35,800,500,300,0.625,11,5,6,399.66483383937896,0.37958683473389354,0.26341860346844315,0.2467381358801793,133313.97667063153,3656.1816669069613,136970.15833753848,1034,19,471.37142857142857,33,2,19,31.501300383687344,0.6600378787878787,41.81985294117647,1032.7205882352944,31.294563279857407,0
1043,4,0,0,35,0.0,0.0,1.0,35,950,700,250,0.7368421052631579,12,7,5,398.71176743634635,0.37976190476190474,0.2580953510838433,0.24656944150557322,133377.26362757114,3635.816903354478,137013.08053092562,1035,20,472.37142857142857,33,2,19,31.46218906948234,0.6606691919191918,41.75857843137255,1032.9656862745098,31.301990493166965,0
1044,4,0,0,35,0.0,0.0,1.0,35,650,200,450,0.3076923076923077,11,2,9,399.0212060165477,0.3798319327731092,0.25784434993307026,0.24718205642362323,133440.56560277296,3649.1230836697387,137089.6886864427,1036,21,473.37142857142857,33,2,20,31.390478590914476,0.661300505050505,41.697303921568626,1033.2107843137253,31.309417706476523,0
1045,4,0,0,35,0.0,0.0,1.0,35,900,600,300,0.6666666666666666,12,6,6,401.53911382120486,0.379656862745098,0.2612100925026095,0.24940668900725538,133539.5050048828,3724.2744090877018,137263.7794139705,1037,22,474.37142857142857,31,4,20,31.225854539346606,0.6673387096774194,41.6015625,1033.59375,33.341733870967744,0
1046,4,0,0,35,0.0,0.0,1.0,35,850,500,350,0.5882352941176471,12,5,7,400.78675710143455,0.3794467787114846,0.26136020151133477,0.24939238647220932,133606.80474175353,3709.567599826394,137316.37234157993,1038,23,475.37142857142857,31,4,21,31.177581863979846,0.668010752688172,41.536458333333336,1033.854166666667,33.35013440860216,0
1047,4,0,0,35,0.0,0.0,1.0,35,1400,1100,300,0.7857142857142857,17,11,6,403.9633135175373,0.3794467787114846,0.26365712846891287,0.25205660638411614,133707.78613620324,3802.608066134973,137510.3942023382,1039,24,476.37142857142857,31,4,19,30.99387825758531,0.6690188172043011,41.43880208333333,1034.2447916666658,33.36273521505374,0
1048,4,0,0,35,0.0,0.0,1.0,35,1150,800,350,0.6956521739130435,15,8,7,402.87789099200165,0.37846638655462184,0.2614997483643682,0.25252945406974975,133876.1732313367,3787.150065104147,137663.32329644085,1040,25,477.37142857142857,31,4,19,30.85262539842307,0.6706989247311829,41.27604166666666,1034.8958333333323,33.383736559139756,0
1049,4,0,0,35,0.0,0.0,1.0,35,1000,700,300,0.7,13,7,6,398.6494419231689,0.3780112044817927,0.2590399540097732,0.2507959147288795,134010.95920138882,3684.6788194444352,137695.63802083326,1041,26,478.37142857142857,31,4,19,30.82662642521797,0.6720430107526882,41.14583333333333,1035.416666666666,33.400537634408586,0
1050,4,0,0,35,0.0,0.0,1.0,35,1050,900,150,0.8571428571428571,12,9,3,396.63759349475487,0.3773109243697479,0.2580408779050971,0.2499885434752201,134078.37761772992,3636.1050075954668,137714.48262532539,1042,27,479.37142857142857,31,4,19,30.811017517391658,0.672715053763441,41.08072916666666,1035.6770833333323,33.40893817204298,0
1051,4,0,0,35,0.0,0.0,1.0,35,750,500,250,0.6666666666666666,10,5,5,397.17440391737273,0.3771358543417367,0.25773181067298756,0.25078726647354094,134145.81298828113,3655.8566623263746,137801.6696506075,1043,28,480.37142857142857,31,4,19,30.729428523546176,0.6733870967741936,41.01562499999999,1035.937499999999,33.41733870967739,0
1052,4,0,0,35,0.0,0.0,1.0,35,650,400,250,0.6153846153846154,9,4,5,397.17440391737273,0.3771358543417367,0.25773181067298756,0.25078726647354094,134145.81298828113,3655.8566623263746,137801.6696506075,1044,29,481.37142857142857,31,4,19,30.729428523546176,0.6733870967741936,41.01562499999999,1035.937499999999,33.41733870967739,0
1053,4,0,0,35,0.0,0.0,1.0,35,1150,1000,150,0.8695652173913043,13,10,3,401.37618031402525,0.37734593837535013,0.2554896194072711,0.2544322057295624,134288.91383851136,3780.0742590041846,138068.98809751554,1045,30,482.37142857142857,32,3,19,30.47696633775938,0.6722005208333334,40.87752525252525,1036.4898989898988,32.39030934343434,0
1054,4,2,2,35,0.05405405405405406,0.05405405405405406,0.9459459459459459,37,1100,800,300,0.7272727272727273,14,8,6,381.71511599394023,0.38404029029029024,0.22965316591378926,0.24499170171974702,134741.56574394458,2886.8335554436335,137628.3992993882,1046,0,457.2432432432432,33,4,19,30.53342382751023,0.6742424242424242,40.44117647058823,1038.2352941176466,31.461675579322623,0
1055,4,1,1,35,0.027777777777777776,0.027777777777777776,0.9722222222222222,36,1150,900,250,0.782608695652174,14,9,5,388.3472922574456,0.38242394179894185,0.2355654218870371,0.24883890020642727,134681.81060924914,3260.6632932864086,137942.47390253554,1047,0,470.9166666666667,32,4,19,30.42107610590764,0.6761067708333333,40.49873737373738,1038.005050505051,32.437657828282845,0
1056,4,0,0,35,0.0,0.0,1.0,35,600,300,300,0.5,9,3,6,397.7770278304941,0.3767857142857143,0.24866707242848451,0.2535095642845238,134485.29048375183,3699.0318271094984,138184.32231086132,1048,33,485.37142857142857,32,3,19,30.3733008723879,0.6741536458333333,40.68813131313132,1037.247474747476,32.413983585858624,0
1057,4,0,0,35,0.0,0.0,1.0,35,1200,700,500,0.5833333333333334,17,7,10,397.0560662181969,0.3759453781512605,0.2442536256565626,0.2537401597187497,134584.55615573446,3687.5388304343655,138272.09498616884,1049,34,486.37142857142857,31,4,20,30.29251369891664,0.677755376344086,40.59244791666666,1037.6302083333321,33.47194220430104,0
1058,4,0,0,35,0.0,0.0,1.0,35,850,700,150,0.8235294117647058,10,7,3,397.9233087776588,0.37563025210084033,0.24945427173503987,0.25476680275234664,134652.1186828612,3716.243320041218,138368.36200290243,1050,35,487.37142857142857,31,4,20,30.202321958767204,0.6784274193548387,40.52734374999999,1037.890624999999,33.48034274193545,0
1059,4,0,0,35,0.0,0.0,1.0,35,950,800,150,0.8421052631578947,11,8,3,398.8225087440881,0.37563025210084033,0.2531226486079765,0.2560556106864216,134753.4942626952,3748.545328776027,138502.03959147123,1051,36,488.37142857142857,31,4,20,30.077439177326312,0.6794354838709677,40.42968749999999,1038.281249999999,33.49294354838707,0
1060,4,0,0,35,0.0,0.0,1.0,35,850,800,50,0.9411764705882353,9,8,1,397.33040646513274,0.3752450980392157,0.2544204040693512,0.25557317112628203,134821.09917534716,3713.7044270833235,138534.80360243047,1052,37,489.37142857142857,31,4,17,30.048478769642255,0.6801075268817205,40.36458333333333,1038.541666666666,33.50134408602148,0
1061,4,0,0,35,0.0,0.0,1.0,35,700,300,400,0.42857142857142855,11,3,8,396.1431154323653,0.3746498599439776,0.25212611677080954,0.25552351803030243,134922.5383334689,3689.726935492612,138612.26526896152,1053,38,490.37142857142857,31,4,18,29.977780214730334,0.6811155913978495,40.26692708333333,1038.932291666666,33.5139448924731,0
1062,4,0,0,35,0.0,0.0,1.0,35,1000,800,200,0.8,12,8,4,395.5150593296845,0.3741596638655462,0.2538815400862766,0.25559560230851913,134990.185631646,3678.130255805117,138668.3158874511,1054,39,491.37142857142857,31,4,18,29.926413774380826,0.6817876344086022,40.201822916666664,1039.192708333333,33.522345430107514,0
1063,4,0,0,35,0.0,0.0,1.0,35,550,400,150,0.7272727272727273,7,4,3,384.09155120401914,0.3741596638655462,0.23113086818885997,0.24913094192774457,135123.54022491357,3379.9620338331506,138503.5022587467,1055,40,492.37142857142857,33,2,17,30.0899732830426,0.678030303030303,40.07352941176471,1039.7058823529417,31.50623885918005,1
1064,4,0,0,35,0.0,0.0,1.0,35,800,700,100,0.875,9,7,2,381.00167768198656,0.3737745098039216,0.22629621527018173,0.24822127719435033,135282.8558276865,3308.5990063917748,138591.45483407826,1056,41,493.37142857142857,33,2,17,30.011264577688777,0.6796085858585859,39.9203431372549,1040.3186274509806,31.524806892453956,0
1065,4,0,0,35,0.0,0.0,1.0,35,750,500,250,0.6666666666666666,10,5,5,378.86596268717165,0.37282913165266107,0.22500462674764887,0.24726755489444852,135346.60835075454,3255.6446138504425,138602.252964605,1057,42,494.37142857142857,33,2,17,30.003214187571153,0.680239898989899,39.85906862745098,1040.5637254901962,31.53223410576352,0
1066,4,0,0,35,0.0,0.0,1.0,35,950,500,450,0.5263157894736842,14,5,9,379.5781481009654,0.3724439775910364,0.22645876436056556,0.24817222569834482,135410.3758920848,3279.7639429546316,138690.13983503942,1058,43,495.37142857142857,33,2,17,29.92108697358609,0.6808712121212122,39.79779411764706,1040.808823529412,31.53966131907309,0
1067,4,0,0,35,0.0,0.0,1.0,35,950,700,250,0.7368421052631579,12,7,5,378.0099464110285,0.37170868347338937,0.22337906914178118,0.24780652042500756,135506.05536332176,3244.5273452518213,138750.58270857358,1059,44,496.37142857142857,33,2,17,29.866505806654114,0.6818181818181819,39.705882352941174,1041.176470588235,31.550802139037422,0
1068,4,1,0,36,0.027777777777777776,0.0,1.0,36,900,700,200,0.7777777777777778,11,7,4,371.0007298838485,0.3750496031746032,0.2209259041573608,0.24561114467874703,135857.16919273834,2880.6818591407123,138737.85105187906,1060,0,483.55555555555554,33,3,18,29.6994386975432,0.6852904040404041,39.368872549019606,1042.5245098039213,31.59165181224004,0
1069,4,0,0,36,0.0,0.0,1.0,36,1400,1000,400,0.7142857142857143,18,10,8,372.561071874378,0.3751984126984127,0.21963171769373324,0.24819913661490256,136080.8418036333,2939.684856785855,139020.52666041916,1061,1,484.55555555555554,33,3,16,29.436320570041495,0.6875,39.154411764705884,1043.3823529411768,31.61764705882354,0
1070,4,0,0,36,0.0,0.0,1.0,36,1000,800,200,0.8,12,8,4,372.73718552775654,0.37453703703703706,0.22190263755185136,0.2492131355043507,136208.73732458657,2954.0122789311645,139162.74960351773,1062,2,485.55555555555554,33,3,16,29.3046098458167,0.6887626262626263,39.03186274509803,1043.8725490196068,31.63250148544263,0
1071,4,0,1,35,0.0,0.027777777777777776,0.9722222222222222,36,950,600,350,0.631578947368421,13,6,7,372.12188660782766,0.3739748677248677,0.22217658869853163,0.24970257619463837,136336.69291858902,2946.773476547476,139283.4663951365,1063,3,486.55555555555554,33,3,16,29.193557850269883,0.6900252525252526,38.90931372549019,1044.362745098039,31.64735591206179,0
1072,4,0,0,35,0.0,0.0,1.0,35,1200,800,400,0.6666666666666666,16,8,8,395.9225071599878,0.37184873949579833,0.2615752783269174,0.25763109115197286,135239.39680899892,3708.864210284648,138948.26101928356,1064,4,496.48571428571427,32,3,17,29.666636319495034,0.681640625,39.962121212121204,1040.1515151515139,32.50473484848481,2
1073,4,0,0,35,0.0,0.0,1.0,35,1050,600,450,0.5714285714285714,15,6,9,392.5363742110184,0.3716386554621849,0.25718444583073485,0.25683094198378037,135436.46694214863,3632.747933884283,139069.21487603293,1065,5,497.48571428571427,32,3,17,29.557860262008735,0.68359375,39.772727272727266,1040.9090909090899,32.52840909090906,0
1074,4,1,1,35,0.027777777777777776,0.027777777777777776,0.9722222222222222,36,500,300,200,0.6,7,3,4,382.6721687260829,0.3746031746031746,0.24562143015854354,0.2519826573462765,135665.59624002778,3183.0895869377046,138848.6858269655,1066,0,484.6388888888889,33,3,17,29.58610261537857,0.6833964646464648,39.55269607843137,1041.7892156862738,31.569370172311327,0
1075,4,0,0,35,0.0,0.0,1.0,35,650,400,250,0.6153846153846154,9,4,5,390.7118710186755,0.3717436974789916,0.2570493166346206,0.25634055690461527,135535.05581381993,3591.031049127628,139126.08686294756,1067,7,499.48571428571427,32,3,18,29.506941918273313,0.6845703125,39.6780303030303,1041.287878787878,32.54024621212119,0
1076,4,0,0,35,0.0,0.0,1.0,35,950,700,250,0.7368421052631579,12,7,5,388.35660940441824,0.37142857142857144,0.2561836660491368,0.2557326723220952,135666.5634405927,3537.401317467587,139203.9647580603,1068,8,500.48571428571427,32,3,19,29.437088433725194,0.6858723958333334,39.55176767676767,1041.7929292929284,32.55602904040401,0
1077,4,0,1,34,0.0,0.02857142857142857,0.9714285714285714,35,700,600,100,0.8571428571428571,8,6,2,376.9948584171609,0.3711484593837535,0.22686918312977955,0.24985742703121291,135896.8552316089,3246.483139475554,139143.33837108445,1069,9,501.48571428571427,32,3,15,29.503713570678944,0.6881510416666667,39.330808080808076,1042.6767676767668,32.58364898989896,1
1078,4,0,0,34,0.0,0.0,1.0,34,900,700,200,0.7777777777777778,11,7,4,387.68633439203575,0.367517082590612,0.24790755777639006,0.2562699510163703,135803.27563815642,3729.814826117616,139533.09046427405,1070,55,516.9705882352941,31,3,18,29.318264626275244,0.6898521505376345,39.420572916666664,1042.317708333333,33.62315188172042,0
1079,4,0,0,34,0.0,0.0,1.0,34,600,500,100,0.8333333333333334,7,5,2,386.5306192288442,0.3675913547237077,0.24547271137754478,0.25599261109721716,135871.14334106445,3703.671434190537,139574.81477525498,1071,56,517.9705882352941,31,3,16,29.280759543732568,0.690524193548387,39.35546875,1042.578125,33.63155241935484,0
1080,4,0,0,34,0.0,0.0,1.0,34,1000,900,100,0.9,11,9,2,384.88441627728366,0.3675913547237077,0.24065660162370017,0.25555830212623487,135962.68875624938,3665.984019487808,139628.67277573718,1072,57,518.9705882352941,32,2,17,29.23249596448748,0.6888020833333334,39.26767676767677,1042.929292929293,32.59154040404041,0
1081,4,0,0,34,0.0,0.0,1.0,34,1250,900,350,0.72,16,9,7,386.22665933247913,0.36610591206179444,0.2430981103875307,0.2576403018065327,136127.34231519743,3715.201733241505,139842.54404843893,1073,58,519.9705882352941,32,2,18,29.033575317604353,0.6904296875,39.109848484848484,1043.560606060606,32.61126893939394,0
1082,4,0,0,34,0.0,0.0,1.0,34,700,600,100,0.8571428571428571,8,6,2,372.98387096774167,0.36610591206179444,0.17030360531309285,0.23124999999999996,133472.2222222223,3156.5972222222313,136628.81944444453,1074,59,520.9705882352941,33,1,20,32.031249999999986,0.6616161616161615,41.66666666666667,1033.3333333333342,31.31313131313134,8
1083,4,0,0,34,0.0,0.0,1.0,34,1050,600,450,0.5714285714285714,15,6,9,375.7673543252851,0.36588309566250743,0.17509842236845863,0.23379810769114276,133602.72548719545,3240.7085373941736,136843.43402458963,1075,60,521.9705882352941,32,2,21,31.828336183032082,0.6653645833333333,41.540404040404056,1033.8383838383859,32.30744949494956,0
1084,4,1,1,34,0.02857142857142857,0.02857142857142857,0.9714285714285714,35,750,500,250,0.6666666666666666,10,5,5,363.4459871820624,0.36904761904761907,0.16310581070794217,0.22786201646269616,133884.09994052773,2731.9277741734018,136616.02771470114,1076,0,508.0285714285714,33,2,19,31.864885533846458,0.6657196969696969,41.26838235294118,1034.9264705882356,31.361408199643503,0
1085,4,0,0,34,0.0,0.0,1.0,34,300,300,0,1.0,3,3,0,373.8394379615783,0.3652517825311943,0.17562327665441213,0.23342169784918082,133733.29252117145,3198.955782573229,136932.24830374468,1077,62,523.9705882352941,32,2,19,31.747182210286468,0.6666666666666665,41.414141414141426,1034.3434343434355,32.32323232323236,0
1086,4,0,0,34,0.0,0.0,1.0,34,750,500,250,0.6666666666666666,10,5,5,375.26134225967996,0.3654374628639334,0.1802881266196672,0.2350672681039126,133852.39451172642,3245.925845828551,137098.32035755497,1078,63,524.9705882352941,33,1,19,31.590971893257553,0.6654040404040402,41.29901960784315,1034.8039215686288,31.35769459298875,0
1087,4,0,0,34,0.0,0.0,1.0,34,800,600,200,0.75,10,6,4,373.01733137247936,0.36521464646464646,0.18143639174826887,0.23406421848231546,133915.80912389493,3190.5835495963447,137106.39267349127,1079,64,525.9705882352941,33,1,20,31.58546451969374,0.6660353535353534,41.237745098039234,1035.0490196078454,31.365121806298344,0
1088,4,0,0,34,0.0,0.0,1.0,34,850,700,150,0.8235294117647058,10,7,3,390.4251941831242,0.36536319073083784,0.21513557293271912,0.2470485403747802,134223.48684126622,3691.794495936263,137915.28133720247,1080,65,526.9705882352941,32,2,19,30.826327119125956,0.6715494791666666,40.94065656565657,1036.237373737374,32.382417929292934,4
1089,4,0,0,34,0.0,0.0,1.0,34,600,400,200,0.6666666666666666,8,4,4,388.1849032910784,0.36471330956625075,0.2121972931996161,0.24612203238650243,134296.61218041147,3626.3834823145035,137922.99566272597,1081,66,527.9705882352941,33,1,19,30.811066445968304,0.6698232323232323,40.87009803921569,1036.519607843138,31.409685086155694,0
1090,4,0,0,34,0.0,0.0,1.0,34,750,600,150,0.8,9,6,3,389.51595633554695,0.3643976530005942,0.21335785762466686,0.24718045571210748,134328.37017313062,3664.6087141964713,137992.9788873271,1082,67,528.9705882352941,33,1,19,30.744744256610314,0.6701388888888888,40.83946078431373,1036.6421568627457,31.413398692810475,0
1091,4,0,0,34,0.0,0.0,1.0,34,750,500,250,0.6666666666666666,10,5,5,389.51595633554695,0.3643976530005942,0.21335785762466686,0.24718045571210748,134328.37017313062,3664.6087141964713,137992.9788873271,1083,68,529.9705882352941,33,1,19,30.744744256610314,0.6701388888888888,40.83946078431373,1036.6421568627457,31.413398692810475,0
1092,4,0,0,34,0.0,0.0,1.0,34,1000,800,200,0.8,12,8,4,395.9468918966455,0.3643976530005942,0.23475201698831327,0.23090542613424084,131161.34855482308,3586.9536068750176,134748.3021616981,1084,69,530.9705882352941,31,3,18,33.77306575992543,0.643481182795699,43.912760416666664,1024.348958333333,33.043514784946225,4
1093,4,0,0,34,0.0,0.0,1.0,34,750,400,350,0.5333333333333333,11,4,7,396.8936126929176,0.3641562685680333,0.23746916809925955,0.23206186715403157,131261.40170627183,3619.3623860677167,134880.76409233955,1085,70,531.9705882352941,31,3,18,33.647289284201584,0.644489247311828,43.81510416666667,1024.7395833333344,33.056115591397884,0
1094,4,0,0,34,0.0,0.0,1.0,34,1150,800,350,0.6956521739130435,15,8,7,398.2841816903405,0.36402629233511585,0.24706703806316233,0.23430056005786506,131495.00740898986,3674.476284450959,135169.48369344082,1086,71,532.9705882352941,31,3,19,33.37472493758199,0.6468413978494623,43.587239583333336,1025.651041666667,33.08551747311829,0
1095,4,0,0,34,0.0,0.0,1.0,34,600,400,200,0.6666666666666666,8,4,4,396.1811921752601,0.36424910873440286,0.24369694571571476,0.23347132484284794,131561.79004245345,3624.4613647461024,135186.25140719954,1087,72,533.9705882352941,31,3,16,33.360964800947656,0.647513440860215,43.52213541666667,1025.9114583333342,33.093918010752716,0
1096,4,0,0,34,0.0,0.0,1.0,34,1050,800,250,0.7619047619047619,13,8,5,397.33514778684935,0.36426767676767674,0.2482105137448969,0.23456167039012435,131628.58963012692,3660.133022732204,135288.72265285914,1088,73,534.9705882352941,31,3,16,33.26367740980418,0.6481854838709677,43.45703125,1026.1718749999998,33.10231854838709,0
1097,4,0,0,34,0.0,0.0,1.0,34,700,500,200,0.7142857142857143,9,5,4,398.71986451259846,0.3641562685680333,0.247839455498007,0.23558545517903318,131661.99578179262,3699.25062391494,135361.24640570756,1089,74,535.9705882352941,31,3,16,33.19430347627505,0.648521505376344,43.42447916666667,1026.3020833333342,33.106518817204325,0
1098,4,0,0,34,0.0,0.0,1.0,34,350,300,50,0.8571428571428571,4,3,1,398.71986451259846,0.3641562685680333,0.247839455498007,0.23558545517903318,131661.99578179262,3699.25062391494,135361.24640570756,1090,75,536.9705882352941,31,3,16,33.19430347627505,0.648521505376344,43.42447916666667,1026.3020833333342,33.106518817204325,0
1099,4,0,0,34,0.0,0.0,1.0,34,800,600,200,0.75,10,6,4,398.19439959886216,0.36454619726678555,0.2464881196613069,0.23589502936416468,131762.2396681045,3693.397182888464,135455.63685099297,1091,76,537.9705882352941,31,3,16,33.106240752483615,0.649529569892473,43.32682291666667,1026.6927083333344,33.11911962365595,0
1100,4,0,0,34,0.0,0.0,1.0,34,700,400,300,0.5714285714285714,10,4,6,397.6524000152617,0.3641377005347594,0.24582595176976718,0.23629673295282352,131878.73247946645,3688.3788962860986,135567.11137575255,1092,77,538.9705882352941,32,2,16,33.00220241753739,0.6481119791666666,43.21338383838384,1027.1464646464651,32.098327020202035,0
1101,4,0,0,34,0.0,0.0,1.0,34,1200,1000,200,0.8333333333333334,14,10,4,392.9731423460547,0.3628565062388592,0.2375698989986561,0.23491830579894102,132105.78799357207,3582.8053259871444,135688.5933195592,1093,78,539.9705882352941,32,2,18,32.892716777204626,0.650390625,42.99242424242424,1028.030303030303,32.12594696969697,0
1102,4,0,0,34,0.0,0.0,1.0,34,950,700,250,0.7368421052631579,12,7,5,393.61091463673506,0.3625408496732026,0.2388911360221886,0.23570347711776266,132170.69686766664,3604.7657764513942,135775.46264411803,1094,79,540.9705882352941,32,2,18,32.8107093156516,0.6510416666666666,42.929292929292934,1028.282828282829,32.13383838383841,0
1103,4,0,0,34,0.0,0.0,1.0,34,950,500,450,0.5263157894736842,14,5,9,396.72990037762344,0.3625779857397504,0.24296110196655962,0.23838902863398814,132300.56244260803,3697.5177915519,135998.08023415992,1095,80,541.9705882352941,32,2,18,32.599257486499745,0.65234375,42.80303030303031,1028.78787878788,32.14962121212125,0
1104,4,1,1,34,0.02857142857142857,0.02857142857142857,0.9714285714285714,35,1050,900,150,0.8571428571428571,12,9,3,390.03972835830416,0.36722689075630255,0.23656358351136464,0.23640000772266312,132625.50536935008,3345.8790875931018,135971.3844569432,1096,0,527.4571428571429,32,3,16,32.4433582577429,0.6555989583333334,42.48737373737374,1030.050505050505,32.189078282828284,0
1105,4,0,0,34,0.0,0.0,1.0,34,400,300,100,0.75,5,3,2,400.72099381238297,0.3630793226381462,0.2518191693575993,0.241839708174099,132465.01498752157,3816.302490234356,136281.31747775592,1097,82,543.9705882352941,31,3,18,32.330403069398756,0.6565860215053765,42.64322916666666,1029.4270833333321,33.207325268817165,0
1106,4,0,0,34,0.0,0.0,1.0,34,400,200,200,0.5,6,2,4,401.17673762471674,0.3633949792038027,0.2512107663351164,0.2423303639723935,132498.52710300006,3831.065368652319,136329.59247165237,1098,83,544.9705882352941,31,3,18,32.284816196619026,0.6569220430107527,42.61067708333332,1029.5572916666654,33.211525537634365,0
1107,4,1,0,35,0.02857142857142857,0.0,1.0,35,700,400,300,0.5714285714285714,10,4,6,389.40441833251407,0.36715686274509807,0.24340385072498205,0.237768416244541,132902.97752066512,3350.601331218762,136253.57885188388,1099,0,530.3714285714286,33,2,17,32.179997623009264,0.6559343434343434,42.21813725490196,1031.1274509803923,31.24628639334522,0
1108,4,0,0,35,0.0,0.0,1.0,35,900,700,200,0.7777777777777778,11,7,4,391.8929224340855,0.36775210084033616,0.2519499032685064,0.24009858959607933,133029.3712153979,3426.6538110342144,136456.02502643212,1100,1,531.3714285714286,33,2,17,31.988496871782672,0.6571969696969697,42.095588235294116,1031.6176470588234,31.261140819964346,0
1109,4,0,0,35,0.0,0.0,1.0,35,1050,800,250,0.7619047619047619,13,8,5,388.8532962340073,0.3680672268907563,0.24405595591352292,0.23965537825687722,133250.704731954,3362.995152104948,136613.69988405894,1101,2,532.3714285714286,33,2,17,31.844090009891183,0.6594065656565657,41.88112745098039,1032.475490196078,31.287136066547816,0
1110,4,0,0,35,0.0,0.0,1.0,35,700,400,300,0.5714285714285714,10,4,6,390.8931040766544,0.367436974789916,0.24907451352634058,0.24152837838402086,133345.61827181853,3424.7765282583623,136770.3948000769,1102,3,533.3714285714286,33,2,18,31.695934187628538,0.6603535353535354,41.78921568627451,1032.843137254902,31.298276886512184,0
1111,4,0,0,35,0.0,0.0,1.0,35,800,400,400,0.5,12,4,8,390.576427012252,0.3671918767507003,0.2459061403657441,0.2415384228383179,133377.26362757114,3418.8030144655895,136796.06664203672,1103,4,534.3714285714286,33,2,19,31.672277257088616,0.6606691919191918,41.75857843137255,1032.9656862745098,31.301990493166965,0
1112,4,0,0,35,0.0,0.0,1.0,35,800,500,300,0.625,11,5,6,393.16653958530935,0.36729691876750703,0.24694579527932636,0.24355526048815154,133440.56560277296,3492.8730836697387,136933.4386864427,1104,5,535.3714285714286,33,2,19,31.54170620329735,0.661300505050505,41.697303921568626,1033.2107843137253,31.309417706476523,0
1113,4,0,0,35,0.0,0.0,1.0,35,1000,600,400,0.6,14,6,8,391.7727679369989,0.36656162464986,0.2448185914156984,0.24331454527103447,133535.54672481734,3463.118151672426,136998.66487648975,1105,6,536.3714285714286,33,2,20,31.482195083392615,0.6622474747474747,41.60539215686274,1033.5784313725487,31.32055852644087,0
1114,4,0,0,35,0.0,0.0,1.0,35,700,500,200,0.7142857142857143,9,5,4,391.66178231836693,0.3659663865546219,0.24654880444354155,0.24366215307063005,133598.88624567474,3465.1155805459484,137064.0018262207,1106,7,537.3714285714286,33,2,20,31.421388493756915,0.6628787878787878,41.544117647058826,1033.8235294117649,31.32798573975045,0
1115,4,0,0,35,0.0,0.0,1.0,35,900,400,500,0.4444444444444444,14,4,10,391.7463428286736,0.36498599439775914,0.24189054221048556,0.2443420093962437,133693.92368620244,3474.821132497117,137168.74481869955,1107,8,538.3714285714286,33,2,20,31.32369060315203,0.6638257575757576,41.45220588235294,1034.1911764705883,31.339126559714796,0
1116,4,0,0,35,0.0,0.0,1.0,35,850,500,350,0.5882352941176471,12,5,7,396.3381452996767,0.364670868347339,0.2525411111863034,0.24826997766398146,133852.3945117263,3610.161956939648,137462.55646866595,1108,9,539.3714285714286,33,2,19,31.045712932259597,0.6654040404040404,41.29901960784314,1034.8039215686279,31.35769459298872,0
1117,4,0,0,35,0.0,0.0,1.0,35,1200,900,300,0.75,15,9,6,395.2157957262558,0.36481092436974794,0.252599171107164,0.24778005901323152,133884.09994052764,3582.622218617832,137466.72215914546,1109,10,540.3714285714286,33,2,19,31.042900138148795,0.665719696969697,41.268382352941174,1034.926470588235,31.36140819964348,0
1118,4,0,0,35,0.0,0.0,1.0,35,1250,900,350,0.72,16,9,7,392.0551801407511,0.3651260504201681,0.25013017751479283,0.2468603779574777,134042.68340301822,3510.425677624008,137553.10908064223,1110,11,541.3714285714286,33,2,19,30.965483234714014,0.6672979797979797,41.11519607843138,1035.5392156862756,31.379976232917443,0
1119,4,0,0,35,0.0,0.0,1.0,35,900,700,200,0.7777777777777778,11,7,4,391.0935768134996,0.36435574229691875,0.2526635813937781,0.2479662273379744,134296.61218041132,3504.5084823144875,137801.12066272582,1111,12,542.3714285714286,33,2,19,30.735694017498233,0.6698232323232323,40.870098039215684,1036.5196078431368,31.409685086155662,0
1120,4,0,0,35,0.0,0.0,1.0,35,1300,1100,200,0.8461538461538461,15,11,4,386.7647788624038,0.36446078431372547,0.23294396596813027,0.24191989297698754,133798.59995153558,3349.95747666629,137148.55742820186,1112,13,543.3714285714286,32,3,17,31.347378162883416,0.6673177083333333,41.351010101010104,1034.5959595959598,32.331123737373744,1
1121,4,0,0,35,0.0,0.0,1.0,35,650,200,450,0.3076923076923077,11,2,9,389.03520271649074,0.3637254901960784,0.23202216838913214,0.2439878773272437,133896.5909888022,3418.0974836751448,137314.68847247734,1113,14,544.3714285714286,32,3,17,31.19027286405597,0.6682942708333333,41.256313131313135,1034.9747474747478,32.34296085858587,0
1122,4,0,0,35,0.0,0.0,1.0,35,1200,800,400,0.6666666666666666,16,8,8,376.7697790849372,0.3637254901960784,0.22255343772466651,0.22620069198268125,132268.09007052862,2966.9238151719333,135235.01388570055,1114,15,545.3714285714286,32,3,21,33.145380712736795,0.6520182291666666,42.834595959595966,1028.6616161616168,32.14567550505053,5
1123,4,0,0,35,0.0,0.0,1.0,35,1050,800,250,0.7619047619047619,13,8,5,377.96816595486325,0.36393557422969186,0.22787721543397121,0.22731089183514233,132333.0388002499,3003.5351941128397,135336.57399436273,1115,16,546.3714285714286,32,3,21,33.0490448725815,0.6526692708333334,42.77146464646464,1028.9141414141409,32.1535669191919,0
1124,4,0,0,35,0.0,0.0,1.0,35,1150,1000,150,0.8695652173913043,13,10,3,379.7800324542279,0.3636204481792717,0.22972816657027173,0.22879431223462038,132398.0034722223,3056.4395533619067,135454.44302558422,1116,17,547.3714285714286,31,4,21,32.93690958164642,0.6559139784946236,42.708333333333336,1029.1666666666672,33.198924731182814,0
1125,4,0,0,35,0.0,0.0,1.0,35,1450,1400,50,0.9655172413793104,15,14,1,378.6974588137892,0.36288515406162464,0.22692391068718876,0.22895561959475877,132532.04345703122,3037.9096137152783,135569.9530707465,1117,18,548.3714285714286,31,4,21,32.82962400944192,0.657258064516129,42.578125,1029.6874999999998,33.21572580645161,0
1126,4,0,0,35,0.0,0.0,1.0,35,950,500,450,0.5263157894736842,14,5,9,379.411136250014,0.3627801120448179,0.22620251336125952,0.23020712500077545,132666.15125868062,3067.0030381944553,135733.1542968751,1118,19,549.3714285714286,31,4,19,32.676103808560846,0.6586021505376343,42.44791666666667,1030.208333333334,33.23252688172045,0
1127,4,0,0,35,0.0,0.0,1.0,35,1050,800,250,0.7619047619047619,13,8,5,383.5765180841031,0.3627450980392157,0.23113372670022891,0.2337779286891337,132833.88137817394,3190.3915405273583,136024.2729187013,1119,20,550.3714285714286,31,4,20,32.399820007578626,0.660282258064516,42.28515625000001,1030.859375000001,33.253528225806484,0
1128,4,1,1,35,0.027777777777777776,0.027777777777777776,0.9722222222222222,36,550,200,350,0.36363636363636365,9,2,7,374.73122856847834,0.36883267195767194,0.21941827426349647,0.2301035560548592,133113.6670524692,2776.369598765441,135890.03665123464,1120,0,536.0555555555555,32,4,20,32.346343651861815,0.6604817708333333,42.01388888888889,1031.944444444445,32.24826388888891,0
1129,4,0,0,35,0.0,0.0,1.0,35,800,400,400,0.5,12,4,8,380.9667875905163,0.3630952380952381,0.2244088949807923,0.23302223355246968,132968.14176771385,3131.2891642252707,136099.43093193913,1121,22,552.3714285714286,31,4,20,32.331907797836976,0.6616263440860215,42.15494791666667,1031.3802083333342,33.27032930107529,0
1130,4,0,0,35,0.0,0.0,1.0,35,750,400,350,0.5333333333333333,11,4,7,380.9667875905163,0.3630952380952381,0.2244088949807923,0.23302223355246968,132968.14176771385,3131.2891642252707,136099.43093193913,1122,23,553.3714285714286,31,4,20,32.331907797836976,0.6616263440860215,42.15494791666667,1031.3802083333342,33.27032930107529,0
1131,4,1,0,36,0.027777777777777776,0.0,1.0,36,1100,700,400,0.6363636363636364,15,7,8,372.0753226046939,0.3660714285714286,0.21936903888481263,0.2294745089186417,133276.5868916439,2717.785812672198,135994.3727043161,1123,0,538.9722222222222,32,4,21,32.25116165321595,0.662109375,41.856060606060616,1032.575757575759,32.26799242424247,0
1132,4,0,0,36,0.0,0.0,1.0,36,750,600,150,0.8,9,6,3,372.36089950375384,0.36633597883597885,0.2218248631318689,0.22985206015405313,133309.1828161668,2727.825445107655,136037.00826127446,1124,1,539.9722222222222,32,4,21,32.211048620450754,0.6624348958333333,41.824494949494955,1032.702020202021,32.271938131313156,0
1133,4,0,0,36,0.0,0.0,1.0,36,650,400,250,0.6153846153846154,9,4,5,372.50509835488526,0.3665178571428571,0.22627583584562316,0.23054740656124614,133406.99450311204,2738.957121722288,136145.95162483433,1125,2,540.9722222222222,32,4,21,32.10910127923083,0.6634114583333333,41.729797979797986,1033.080808080809,32.28377525252528,0
1134,4,0,0,36,0.0,0.0,1.0,36,850,500,350,0.5882352941176471,12,5,7,372.50509835488526,0.3665178571428571,0.22627583584562316,0.23054740656124614,133406.99450311204,2738.957121722288,136145.95162483433,1126,3,541.9722222222222,32,4,21,32.10910127923083,0.6634114583333333,41.729797979797986,1033.080808080809,32.28377525252528,0
1135,4,0,0,36,0.0,0.0,1.0,36,1000,800,200,0.8,12,8,4,375.15845582212484,0.36640211640211645,0.23161949365370238,0.23280302963639812,133504.84206012145,2817.0940784103677,136321.9361385318,1127,4,542.9722222222222,32,4,21,31.942323355732032,0.6643880208333334,41.63510101010101,1033.4595959595963,32.295612373737384,0
1136,4,0,0,36,0.0,0.0,1.0,36,1000,800,200,0.8,12,8,4,374.396610350996,0.3658399470899471,0.2291446100388197,0.23253495085988266,133537.46588358335,2799.1949163350746,136336.66079991843,1128,5,543.9722222222222,32,4,21,31.929259304503617,0.6647135416666666,41.60353535353536,1033.585858585859,32.29955808080809,0
1137,4,0,0,36,0.0,0.0,1.0,36,1000,900,100,0.9,11,9,2,374.0011086535837,0.3656746031746032,0.23291746380646172,0.23290456872731533,133635.36126734508,2795.954653861845,136431.31592120693,1129,6,544.9722222222222,32,4,22,31.84124028167868,0.6656901041666667,41.50883838383838,1033.964646464646,32.311395202020186,0
1138,4,0,0,36,0.0,0.0,1.0,36,1000,600,400,0.6,14,6,8,372.5502824403923,0.36552579365079363,0.22977207977207992,0.23220599795942248,133668.00103305775,2759.610307621656,136427.6113406794,1130,7,545.9722222222222,32,4,22,31.84600122100122,0.666015625,41.47727272727272,1034.0909090909083,32.315340909090885,0
1139,4,0,0,36,0.0,0.0,1.0,36,750,600,150,0.8,9,6,3,373.68703059289135,0.3655753968253968,0.23088009875337412,0.23312037072249622,133700.64478433333,2792.439387562498,136493.08417189584,1131,8,546.9722222222222,32,4,17,31.78386847352785,0.6663411458333334,41.44570707070707,1034.2171717171723,32.319286616161634,0
1140,4,0,0,36,0.0,0.0,1.0,36,900,700,200,0.7777777777777778,11,7,4,375.41116811630894,0.3654927248677249,0.23151764163480104,0.234818252789697,133798.59995153535,2845.8977400265044,136644.49769156185,1132,9,547.9722222222222,32,4,17,31.641038158001788,0.6673177083333335,41.35101010101009,1034.595959595958,32.33112373737369,0
1141,4,0,0,36,0.0,0.0,1.0,36,700,500,200,0.7142857142857143,9,5,4,375.1165290962558,0.36541005291005296,0.23323794487204785,0.23517884842003547,133884.09994052755,2844.427774173375,136728.52771470093,1133,10,548.9722222222222,33,3,17,31.562931715018735,0.665719696969697,41.26838235294117,1034.9264705882342,31.36140819964346,0
1142,4,0,0,36,0.0,0.0,1.0,36,1000,600,400,0.6,14,6,8,374.9475400309919,0.3646660052910053,0.2316130050505052,0.23568131087662336,133979.23875432528,2847.03719723184,136826.27595155712,1134,11,549.9722222222222,33,3,18,31.471946022727284,0.6666666666666666,41.1764705882353,1035.294117647059,31.37254901960785,0
1143,4,0,0,36,0.0,0.0,1.0,36,1100,800,300,0.7272727272727273,14,8,6,374.0430418899762,0.36473214285714284,0.23580049698260575,0.23572242707026023,134074.41135921283,2829.920132881588,136904.3314920944,1135,12,550.9722222222222,33,3,18,31.40000690253618,0.6676136363636364,41.08455882352941,1035.6617647058824,31.383689839572195,0
1144,4,0,1,35,0.0,0.027777777777777776,0.9722222222222222,36,1200,800,400,0.6666666666666666,16,8,8,376.93348643788437,0.36511243386243386,0.23573982072917543,0.23816111317981098,134169.61775519015,2914.604358900408,137084.22211409055,1136,13,551.9722222222222,33,3,18,31.229792603107015,0.6685606060606062,40.99264705882352,1036.0294117647047,31.394830659536506,0
1145,4,0,0,35,0.0,0.0,1.0,35,800,700,100,0.875,9,7,2,383.5442922819152,0.3612394957983193,0.24136273382798623,0.24161522928542759,134059.9890955004,3283.588728190992,137343.5778236914,1137,38,568.3714285714286,32,3,18,31.168465008534508,0.669921875,41.098484848484844,1035.6060606060603,32.362689393939384,0
1146,4,0,0,35,0.0,0.0,1.0,35,550,300,250,0.5454545454545454,8,3,5,381.99278942785406,0.3611344537815126,0.2382600821898726,0.24106683418970093,134125.37623711847,3246.985320375445,137372.36155749392,1138,39,569.3714285714286,32,3,18,31.143090768730694,0.6705729166666667,41.03535353535352,1035.8585858585843,32.37058080808076,0
1147,4,0,1,34,0.0,0.02857142857142857,0.9714285714285714,35,1100,800,300,0.7272727272727273,14,8,6,382.6524614411271,0.36064425770308123,0.23688387635756047,0.24234655891271376,134256.19834710745,3274.692952249765,137530.8912993572,1139,40,570.3714285714286,32,3,18,30.994913499025326,0.671875,40.90909090909091,1036.3636363636363,32.38636363636363,0
1148,4,0,0,34,0.0,0.0,1.0,34,450,200,250,0.4444444444444444,7,2,5,381.9839118666217,0.35912433155080214,0.214144446912643,0.24213945424811542,134288.91383851125,3459.2409256708347,137748.15476418208,1123,41,554.6470588235294,32,2,18,30.97946359686524,0.6722005208333335,40.877525252525245,1036.489898989898,32.39030934343431,0
1149,4,0,0,34,0.0,0.0,1.0,34,750,500,250,0.6666666666666666,10,5,5,383.14933132201276,0.3594399881164587,0.2123148333858631,0.24353113845327914,134387.08422609925,3498.064291908976,137885.14851800824,1124,42,555.6470588235294,32,2,19,30.85093968176652,0.6731770833333335,40.78282828282828,1036.868686868686,32.402146464646435,0
1150,4,0,0,34,0.0,0.0,1.0,34,1100,900,200,0.8181818181818182,13,9,4,384.4063018915222,0.3595328282828283,0.21467495186660313,0.24478785048216345,134455.43968966254,3537.1036680603493,137992.5433577229,1125,43,556.6470588235294,33,1,19,30.74990645555161,0.6714015151515152,40.71691176470588,1037.1323529411757,31.428253119429566,0
1151,4,0,0,34,0.0,0.0,1.0,34,1050,800,250,0.7619047619047619,13,8,5,385.3455858161666,0.358715834818776,0.2162155588756478,0.24581389479531607,134518.99697532173,3567.260338571674,138086.2573138934,1126,44,557.6470588235294,33,1,20,30.661916715888974,0.6720328282828284,40.65563725490195,1037.37745098039,31.43568033273909,0
1152,4,0,0,34,0.0,0.0,1.0,34,1100,700,400,0.6363636363636364,15,7,8,386.09125356363893,0.358938651218063,0.21898459471629028,0.24673305530462197,134584.55615573446,3592.3915084257883,138176.94766416025,1127,45,558.6470588235294,31,3,21,30.576949219893756,0.677755376344086,40.59244791666666,1037.6302083333321,33.47194220430104,0
1153,4,0,0,34,0.0,0.0,1.0,34,800,600,200,0.75,10,6,4,385.5390910836052,0.35905005941770646,0.21776805542234512,0.2472971177159761,134719.69816419802,3587.9419962565,138307.64016045452,1128,46,559.6470588235294,31,3,21,30.456044358041733,0.6790994623655915,40.46223958333333,1038.1510416666658,33.48874327956987,0
1154,4,0,0,34,0.0,0.0,1.0,34,850,600,250,0.7058823529411765,11,6,5,383.21264898963847,0.359607100415924,0.21254120301749913,0.2467221389015615,134854.90798950195,3535.6213039822046,138390.52929348417,1129,47,560.6470588235294,31,3,18,30.381226233755374,0.6804435483870968,40.33203125,1038.671875,33.50554435483871,0
1155,4,0,0,34,0.0,0.0,1.0,34,1300,1000,300,0.7692307692307693,16,10,6,381.0435046342734,0.35969994058229354,0.20566790332611373,0.24592996075572052,134944.06063475672,3483.9115587695214,138427.97219352625,1130,48,561.6470588235294,32,2,20,30.348462753676024,0.6787109375,40.246212121212125,1039.015151515152,32.4692234848485,0
1156,4,0,0,34,0.0,0.0,1.0,34,550,300,250,0.5454545454545454,8,3,5,381.0435046342734,0.35969994058229354,0.20566790332611373,0.24592996075572052,134944.06063475672,3483.9115587695214,138427.97219352625,1131,49,562.6470588235294,32,2,20,30.348462753676024,0.6787109375,40.246212121212125,1039.015151515152,32.4692234848485,0
1157,4,0,0,34,0.0,0.0,1.0,34,1050,700,350,0.6666666666666666,14,7,7,378.2620869252932,0.35780600118835415,0.20827471452342006,0.24591513891110048,135206.5657362771,3428.703544281219,138635.2692805583,1132,50,563.6470588235294,32,2,21,30.158633806806694,0.6813151041666666,39.99368686868688,1040.025252525254,32.50078914141419,0
1158,4,0,0,34,0.0,0.0,1.0,34,1250,1000,250,0.8,15,10,5,382.10864596097616,0.35648767082590616,0.21399200456881773,0.24909614262013038,135305.07091113174,3540.2474875012995,138845.31839863304,1133,51,564.6470588235294,32,2,21,29.960305420711983,0.6822916666666666,39.89898989898991,1040.404040404042,32.51262626262631,0
1159,4,0,0,34,0.0,0.0,1.0,34,650,500,150,0.7692307692307693,8,5,3,380.0382016615497,0.35604203802733214,0.21093415532151738,0.2486535662299856,135436.4669421489,3494.206267217648,138930.67320936653,1134,52,565.6470588235294,32,2,21,29.883096797671037,0.68359375,39.77272727272728,1040.909090909092,32.52840909090912,0
1160,4,0,0,34,0.0,0.0,1.0,34,550,400,150,0.7272727272727273,7,4,3,380.0382016615497,0.35604203802733214,0.21093415532151738,0.2486535662299856,135436.4669421489,3494.206267217648,138930.67320936653,1135,53,566.6470588235294,32,2,21,29.883096797671037,0.68359375,39.77272727272728,1040.909090909092,32.52840909090912,0
1161,4,0,0,34,0.0,0.0,1.0,34,900,700,200,0.7777777777777778,11,7,4,381.97368012561105,0.35500222816399285,0.2158812118445823,0.2508374931270735,135567.92674216928,3556.6759769411383,139124.6027191104,1136,54,567.6470588235294,32,2,21,29.701644843194305,0.6848958333333333,39.64646464646465,1041.4141414141423,32.544191919191945,0
1162,4,0,0,34,0.0,0.0,1.0,34,800,500,300,0.625,11,5,6,379.7187035691079,0.35472370766488415,0.21053063086827262,0.2500446147764334,135666.56344059287,3503.0263174676174,139169.5897580605,1137,55,568.6470588235294,32,2,21,29.66206116430333,0.6858723958333333,39.55176767676768,1041.7929292929298,32.556029040404056,0
1163,4,0,0,34,0.0,0.0,1.0,34,550,300,250,0.5454545454545454,8,3,5,382.8118023295852,0.3541109625668449,0.2167077637936683,0.25277828931427193,135765.23600908084,3594.5069380675577,139359.7429471484,1138,56,569.6470588235294,32,2,21,29.483179872385094,0.6868489583333333,39.45707070707071,1042.1717171717182,32.567866161616195,0
1164,4,0,0,34,0.0,0.0,1.0,34,900,700,200,0.7777777777777778,11,7,4,381.9770495339341,0.35342394533571003,0.21700304198220355,0.25292578171625485,135863.94444763314,3579.3817276298637,139443.326175263,1139,57,570.6470588235294,32,2,19,29.406614589641126,0.6878255208333333,39.36237373737375,1042.550505050507,32.57970328282834,0
1165,4,0,0,34,0.0,0.0,1.0,34,850,600,250,0.7058823529411765,11,6,5,378.3682439327704,0.35294117647058826,0.2049639027724377,0.2516971361813649,136028.53822314067,3493.775826446308,139522.31404958697,1140,58,571.6470588235294,32,2,19,29.33687363834423,0.6894531249999999,39.20454545454547,1043.1818181818196,32.59943181818186,0
1166,4,0,0,34,0.0,0.0,1.0,34,1400,1200,200,0.8571428571428571,16,12,4,379.61810705364167,0.3522912953060012,0.20655832188929701,0.2537027397746532,136193.23163771577,3540.283357565581,139733.51499528135,1141,59,572.6470588235294,32,2,19,29.140458046046536,0.6910807291666666,39.046717171717184,1043.8131313131332,32.61916035353541,0
1167,4,0,1,33,0.0,0.029411764705882353,0.9705882352941176,34,700,500,200,0.7142857142857143,9,5,4,381.57646324582834,0.35188279857397503,0.20926138020814755,0.25548629753682234,136259.13690248455,3598.6559088358404,139857.7928113204,1142,60,573.6470588235294,32,2,19,29.023813842866925,0.6917317708333333,38.98358585858586,1044.0656565656573,32.62705176767679,0
1168,4,0,0,33,0.0,0.0,1.0,33,500,400,100,0.8,6,4,2,391.07194907863425,0.3497869318181818,0.22155428268965394,0.26098598433515835,136142.78369479702,4048.3247545030285,140191.10844930005,1143,61,584.2727272727273,31,2,19,28.891791432730304,0.6932123655913979,39.09505208333333,1043.619791666666,33.66515456989245,0
1169,4,0,0,33,0.0,0.0,1.0,33,750,500,250,0.6666666666666666,10,5,5,390.92821894065867,0.3491556186868687,0.22609734158748895,0.26164127374509183,136244.7187635633,4052.381049262143,140297.09981282544,1144,62,585.2727272727273,31,2,19,28.794067514758456,0.694220430107527,38.99739583333333,1044.010416666666,33.67775537634407,0
1170,4,0,0,33,0.0,0.0,1.0,33,800,400,400,0.5,12,4,8,389.58586339113145,0.34935290404040403,0.22615984007678747,0.2609932363018783,136278.70559692383,4018.451436360677,140297.15703328451,1145,63,586.2727272727273,31,2,19,28.795283077690492,0.6945564516129032,38.96484375,1044.140625,33.68195564516129,0
1171,4,0,0,33,0.0,0.0,1.0,33,950,700,250,0.7368421052631579,12,7,5,389.2805388146465,0.348800505050505,0.22460115170395523,0.26229859983102755,136482.71560668945,4026.013014051649,140508.7286207411,1146,64,587.2727272727273,31,2,19,28.600337487019726,0.6965725806451613,38.76953125,1044.921875,33.70715725806452,0
1172,4,0,0,33,0.0,0.0,1.0,33,900,700,200,0.7777777777777778,11,7,4,389.46646378929364,0.34844539141414144,0.22116531533571937,0.2631849134091287,136584.77783203122,4039.0380859375,140623.81591796872,1147,65,588.2727272727273,31,2,19,28.49402092675637,0.6975806451612903,38.671875,1045.3124999999998,33.71975806451612,0
1173,4,0,0,33,0.0,0.0,1.0,33,1100,800,300,0.7272727272727273,14,8,6,388.34300390192533,0.34738005050505055,0.22122835026060828,0.26267952639667713,136618.80705091686,4010.9915839301166,140629.798634847,1148,66,589.2727272727273,31,2,19,28.48956387262838,0.6979166666666667,38.639322916666664,1045.4427083333333,33.72395833333333,0
1174,4,0,0,33,0.0,0.0,1.0,33,550,400,150,0.7272727272727273,7,4,3,384.9206318770804,0.347064393939394,0.1204392724917378,0.2495619277855023,135108.09643148654,3820.2056322738918,138928.30206376043,1149,67,590.2727272727273,32,1,17,30.083849485871582,0.6803385416666667,40.088383838383834,1039.6464646464642,32.48895202020201,8
1175,4,0,0,33,0.0,0.0,1.0,33,750,500,250,0.6666666666666666,10,5,5,385.94907018099616,0.3467881944444444,0.12196270622691219,0.2506842698746597,135173.73864911744,3834.035748903175,139007.7743980206,1150,68,591.2727272727273,32,1,17,29.991551319410707,0.6809895833333334,40.025252525252526,1039.89898989899,32.49684343434344,0
1176,4,0,0,33,0.0,0.0,1.0,33,750,500,250,0.6666666666666666,10,5,5,385.2937360663102,0.3469065656565657,0.11812335219688719,0.2514018748157134,135337.91394054165,3828.9700987144024,139166.88403925605,1151,69,592.2727272727273,32,1,19,29.844679043805364,0.6826171875,39.867424242424235,1040.530303030302,32.51657196969694,0
1177,4,0,0,33,0.0,0.0,1.0,33,700,500,200,0.7142857142857143,9,5,4,388.1032419818555,0.3463936237373737,0.11964605413592455,0.25369825722890044,135403.6119560504,3910.116155239258,139313.72811128965,1152,70,593.2727272727273,32,1,19,29.706013182902662,0.6832682291666667,39.80429292929293,1040.7828282828282,32.52446338383838,0
1178,4,0,0,33,0.0,0.0,1.0,33,300,100,200,0.3333333333333333,5,1,4,389.33171458294964,0.3463541666666667,0.12319703586079167,0.25473417896998685,135436.46694214863,3945.9423783287284,139382.40932047737,1153,71,594.2727272727273,32,1,19,29.64125424551189,0.68359375,39.772727272727266,1040.9090909090899,32.52840909090906,0
1179,4,0,0,33,0.0,0.0,1.0,33,600,300,300,0.5,9,3,6,389.2680239526245,0.3463147095959596,0.12601944245364516,0.25492572339073755,135469.32591380965,3946.7753609325355,139416.1012747422,1154,72,595.2727272727273,32,1,19,29.610117242773402,0.6839192708333334,39.741161616161605,1041.0353535353522,32.53235479797976,0
1180,4,0,0,33,0.0,0.0,1.0,33,850,600,250,0.7058823529411765,11,6,5,386.8690767673577,0.3458017676767677,0.12268924236912548,0.25381935370727127,135535.05581382007,3886.864382460977,139421.92019628105,1155,73,596.2727272727273,32,1,20,29.606978295137615,0.6845703125,39.678030303030305,1041.2878787878792,32.540246212121225,0
1181,4,0,0,33,0.0,0.0,1.0,33,900,600,300,0.6666666666666666,12,6,6,386.135697828989,0.3455255681818182,0.1187211592158246,0.2535706397845145,135567.9267421691,3869.523199163346,139437.44994133245,1156,74,597.2727272727273,32,1,20,29.593285240866464,0.6848958333333334,39.64646464646464,1041.414141414141,32.54419191919191,0
1182,4,0,0,33,0.0,0.0,1.0,33,500,300,200,0.6,7,3,4,388.03668696607366,0.34477588383838387,0.11821523929147282,0.2555220035241079,135666.56344059276,3928.7207619120463,139595.28420250482,1157,75,598.2727272727273,32,1,20,29.445420757079955,0.6858723958333334,39.551767676767675,1041.7929292929289,32.55602904040403,0
1183,4,0,0,33,0.0,0.0,1.0,33,850,700,150,0.8235294117647058,10,7,3,386.96777132207006,0.344302398989899,0.1181943006512911,0.25552255875938945,135765.2360090808,3907.3541602897803,139672.59016937058,1158,76,599.2727272727273,32,1,20,29.374899038849847,0.6868489583333333,39.45707070707071,1042.171717171718,32.56786616161619,0
1184,4,0,0,33,0.0,0.0,1.0,33,300,200,100,0.6666666666666666,4,2,2,387.2712023391021,0.34363162878787884,0.12504404510218414,0.2561947953935599,135831.03764921956,3920.689853076226,139751.72750229578,1159,77,600.2727272727273,32,1,20,29.30141715116278,0.6875,39.3939393939394,1042.4242424242432,32.5757575757576,0
1185,4,0,0,33,0.0,0.0,1.0,33,650,400,250,0.6153846153846154,9,4,5,386.44945677456985,0.34402619949494945,0.1249555014845074,0.25588718240478125,135863.94444763288,3900.9095054076106,139764.8539530405,1160,78,601.2727272727273,32,1,15,29.29004682895322,0.6878255208333334,39.36237373737374,1042.5505050505049,32.57970328282828,0
1186,4,0,0,33,0.0,0.0,1.0,33,550,300,250,0.5454545454545454,8,3,5,385.29874609946916,0.34398674242424243,0.12317165356642201,0.25536091856255344,135896.85523160896,3872.1775839199995,139769.03281552898,1161,79,602.2727272727273,32,1,15,29.287256801485412,0.6881510416666667,39.330808080808076,1042.6767676767672,32.583648989898975,0
1187,4,0,0,33,0.0,0.0,1.0,33,750,500,250,0.6666666666666666,10,5,5,385.93903202299293,0.34398674242424243,0.11830690392607845,0.2564957637604139,135995.61149691363,3897.202932098772,139892.8144290124,1162,80,603.2727272727273,32,1,15,29.172214824678218,0.6891276041666666,39.236111111111114,1043.0555555555559,32.59548611111112,0
1188,4,0,0,33,0.0,0.0,1.0,33,550,300,250,0.5454545454545454,8,3,5,387.0598384065982,0.3433948863636364,0.1188577044803596,0.2577176023169801,136061.46893493022,3932.786035863705,139994.25497079393,1163,81,604.2727272727273,32,1,16,29.077413368832957,0.6897786458333333,39.17297979797981,1043.3080808080817,32.603377525252554,0
1189,4,0,0,33,0.0,0.0,1.0,33,850,700,150,0.8235294117647058,10,7,3,386.5923328776212,0.3430003156565657,0.12246588801149638,0.25812376603929055,136160.28498367517,3927.704443424145,140087.98942709932,1164,82,605.2727272727273,32,1,16,28.991249294297926,0.6907552083333333,39.07828282828283,1043.686868686869,32.61521464646466,0
1190,4,0,0,33,0.0,0.0,1.0,33,650,600,50,0.9230769230769231,7,6,1,386.5923328776212,0.3430003156565657,0.12246588801149638,0.25812376603929055,136160.28498367517,3927.704443424145,140087.98942709932,1165,83,606.2727272727273,32,1,16,28.991249294297926,0.6907552083333333,39.07828282828283,1043.686868686869,32.61521464646466,0
1191,4,0,0,33,0.0,0.0,1.0,33,500,400,100,0.8,6,4,2,385.38162415397653,0.3420138888888889,0.12277345296213227,0.2577941155748447,136226.18227731876,3899.8134756657646,140125.9957529845,1166,84,607.2727272727273,32,1,16,28.95727503628447,0.69140625,39.01515151515152,1043.939393939395,32.62310606060609,0
1192,4,0,0,33,0.0,0.0,1.0,33,900,600,300,0.6666666666666666,12,6,6,386.4476338310369,0.3414614898989899,0.1225917944997974,0.25931549098488965,136336.69291858908,3937.3984765474906,140274.09139513658,1167,85,608.2727272727273,33,0,16,28.81952593287961,0.6900252525252525,38.9093137254902,1044.3627450980398,31.647355912061812,0
1193,4,0,0,33,0.0,0.0,1.0,33,800,600,200,0.75,10,6,4,386.3019157528331,0.3405539772727273,0.1285764044384734,0.260158778334017,136464.70858564018,3943.3156718569844,140408.02425749716,1168,86,609.2727272727273,33,0,16,28.696047384471036,0.6912878787878787,38.786764705882355,1044.852941176471,31.66221033868094,0
1194,4,0,0,33,0.0,0.0,1.0,33,450,300,150,0.6666666666666666,6,3,3,386.3019157528331,0.3405539772727273,0.1285764044384734,0.260158778334017,136464.70858564018,3943.3156718569844,140408.02425749716,1169,87,610.2727272727273,33,0,16,28.696047384471036,0.6912878787878787,38.786764705882355,1044.852941176471,31.66221033868094,0
1195,4,0,0,33,0.0,0.0,1.0,33,700,600,100,0.8571428571428571,8,6,2,386.00295154449003,0.3400410353535353,0.12590310280001837,0.26019345200157057,136496.72188881683,3937.6275050461404,140434.34939386297,1170,88,611.2727272727273,33,0,17,28.67203686329698,0.6916035353535352,38.756127450980394,1044.9754901960787,31.665923945335717,0
1196,4,0,1,32,0.0,0.030303030303030304,0.9696969696969697,33,850,500,350,0.5882352941176471,12,5,7,386.00295154449003,0.3400410353535353,0.12590310280001837,0.26019345200157057,136496.72188881683,3937.6275050461404,140434.34939386297,1171,89,612.2727272727273,33,0,17,28.67203686329698,0.6916035353535352,38.756127450980394,1044.9754901960787,31.665923945335717,0
1197,4,0,0,32,0.0,0.0,1.0,32,500,200,300,0.4,8,2,6,387.72183322799606,0.33814264112903225,0.10552963030083307,0.26154634177898334,136522.91738406805,4186.583161157032,140709.50054522508,1172,90,600.65625,32,0,17,28.601093391325357,0.6943359375,38.73106060606061,1045.0757575757584,32.65861742424245,0
1198,4,0,0,32,0.0,0.0,1.0,32,900,800,100,0.8888888888888888,10,8,2,391.18257755917625,0.33780661962365593,0.11270151551744934,0.2648718662933394,136654.90327836457,4291.403460106127,140946.30673847068,1173,91,601.65625,32,0,17,28.379473091011544,0.6956380208333333,38.604797979797986,1045.580808080809,32.67440025252528,0
1199,4,0,0,32,0.0,0.0,1.0,32,450,400,50,0.8888888888888888,5,4,1,391.704374435535,0.3377436155913978,0.11206532238589695,0.26547427406506585,136687.90971584548,4308.250433629242,140996.16014947472,1174,92,602.65625,32,0,17,28.333031473879096,0.6959635416666666,38.57323232323233,1045.707070707072,32.678345959596,0
1200,4,0,0,32,0.0,0.0,1.0,32,650,400,250,0.6153846153846154,9,4,5,392.3215156500968,0.33761760752688175,0.1137145213494335,0.26640056933366274,136754.96631198472,4330.387116801869,141085.3534287866,1175,93,603.65625,31,1,17,28.250264533798077,0.699260752688172,38.50911458333334,1045.9635416666679,33.74075940860219,0
1201,4,0,0,32,0.0,0.0,1.0,32,900,700,200,0.7777777777777778,11,7,4,392.77513122105967,0.33700856854838707,0.10684401760945628,0.26846649735810446,136985.14700349458,4360.871817926752,141346.01882142134,1176,94,604.65625,32,0,15,28.00978973183775,0.6988932291666666,38.28914141414142,1046.8434343434346,32.71385732323233,1
1202,4,0,0,32,0.0,0.0,1.0,32,1000,700,300,0.7,13,7,6,392.3405537473989,0.3365885416666667,0.109056583865911,0.26867714386681907,137051.243575273,4354.152159218454,141405.39573449144,1177,95,605.65625,32,0,17,27.955554885646528,0.6995442708333333,38.226010101010104,1047.09595959596,32.72174873737375,0
1203,4,0,0,32,0.0,0.0,1.0,32,900,700,200,0.7777777777777778,11,7,4,390.7212135279834,0.33553847446236557,0.11273276485476691,0.26858441662317156,137183.48454558215,4320.09951152945,141503.58405711158,1178,96,606.65625,32,0,18,27.866749025752288,0.7008463541666666,38.09974747474748,1047.6010101010106,32.73753156565658,0
1204,4,0,0,32,0.0,0.0,1.0,32,1300,1000,300,0.7692307692307693,16,10,6,388.637185235904,0.3345094086021505,0.10707510238496787,0.26842478467790987,137348.8754336293,4275.776068768505,141624.65150239778,1179,97,607.65625,32,0,20,27.757367702561634,0.7024739583333333,37.9419191919192,1048.2323232323238,32.75726010101012,0
1205,4,0,0,32,0.0,0.0,1.0,32,900,700,200,0.7777777777777778,11,7,4,389.47793224572285,0.33549647177419356,0.08443933250155933,0.2599222004121125,136142.78369479722,4213.726084724465,140356.5097795217,1180,98,608.65625,31,1,17,28.93338012060719,0.6932123655913978,39.09505208333334,1043.6197916666679,33.665154569892515,5
1206,4,0,0,32,0.0,0.0,1.0,32,700,400,300,0.5714285714285714,10,4,6,390.34909741583965,0.3354124663978495,0.08684280279406242,0.2610032288559456,136210.73616875548,4233.94758436416,140444.68375311964,1181,99,609.65625,31,1,17,28.84300548833729,0.6938844086021505,39.02994791666667,1043.880208333334,33.6735551075269,0
1207,4,0,0,32,0.0,0.0,1.0,32,800,700,100,0.875,9,7,2,388.58715422042394,0.33402637768817206,0.08939744287268758,0.26066539761209473,136325.05810950414,4194.8332759412315,140519.89138544537,1182,100,610.65625,32,0,17,28.77523878612018,0.6923828125,38.92045454545455,1044.318181818182,32.63494318181819,0
1208,4,1,0,33,0.030303030303030304,0.0,1.0,33,800,600,200,0.75,10,6,4,377.08792088857774,0.34083017676767674,0.0799508388302197,0.2551099962807659,136624.81264717906,3703.9133085832514,140328.72595576232,1183,0,593.1212121212121,33,0,18,28.777766381432436,0.6928661616161615,38.633578431372555,1045.4656862745105,31.680778371954865,0
1209,4,0,0,33,0.0,0.0,1.0,33,1200,900,300,0.75,15,9,6,377.69614582447275,0.3411063762626263,0.08090752816491209,0.25575424731542873,136656.8447231835,3722.952710495976,140379.79743367946,1184,1,594.1212121212121,33,0,18,28.73007501172058,0.6931818181818181,38.602941176470594,1045.5882352941185,31.68449197860965,0
1210,4,0,0,33,0.0,0.0,1.0,33,750,600,150,0.8,9,6,3,378.565419596514,0.34126420454545453,0.0816129421707108,0.2568105954560139,136720.9201388891,3751.5625000000255,140472.48263888914,1185,2,595.1212121212121,33,0,18,28.643758300132802,0.6938131313131313,38.54166666666668,1045.833333333335,31.691919191919244,0
1211,4,0,0,33,0.0,0.0,1.0,33,600,300,300,0.5,9,3,6,379.38754840534267,0.3411063762626263,0.08253222714835462,0.25761036483523464,136753.9345474954,3776.547992551813,140530.4825400472,1186,3,596.1212121212121,32,1,18,28.58949983904716,0.6966145833333333,38.510101010101025,1045.959595959598,32.686237373737434,0
1212,4,0,0,33,0.0,0.0,1.0,33,1250,1000,250,0.8,15,10,5,393.65520213441215,0.3411063762626263,0.1221761078487642,0.25568960920970185,135173.73864911744,4042.3690822365074,139216.10773135396,1187,4,597.1212121212121,32,1,14,29.79121134855107,0.6809895833333334,40.025252525252526,1039.89898989899,32.49684343434344,2
1213,4,0,0,33,0.0,0.0,1.0,33,1050,700,350,0.6666666666666666,14,7,7,395.26050994438685,0.3400015782828283,0.12099882318328947,0.2576698261029863,135305.07091113145,4096.150265279047,139401.2211764105,1188,5,598.1212121212121,32,1,15,29.618224110032358,0.6822916666666667,39.898989898989896,1040.40404040404,32.51262626262625,0
1214,4,0,0,33,0.0,0.0,1.0,33,800,600,200,0.75,10,6,4,394.2733171932342,0.33984375,0.1190058576298112,0.2572609981781031,135337.91394054177,4072.0256542699726,139409.93959481173,1189,6,599.1212121212121,32,1,15,29.61109088702827,0.6826171875,39.86742424242424,1040.530303030303,32.51657196969697,0
1215,4,0,0,33,0.0,0.0,1.0,33,800,600,200,0.75,10,6,4,395.47574759280553,0.33992266414141414,0.1223002804951121,0.2585175723558681,135403.6119560504,4109.768933017035,139513.38088906743,1190,7,600.1212121212121,32,1,16,29.514183751870277,0.6832682291666667,39.80429292929293,1040.7828282828282,32.52446338383838,0
1216,4,0,0,33,0.0,0.0,1.0,33,650,400,250,0.6153846153846154,9,4,5,393.9990101845806,0.33960700757575757,0.11753724487171002,0.25826040047552073,135502.18887103358,4077.5456586062624,139579.73452963983,1191,8,601.1212121212121,32,1,16,29.454179804349575,0.6842447916666667,39.70959595959596,1041.1616161616162,32.536300505050505,0
1217,4,0,0,33,0.0,0.0,1.0,33,750,500,250,0.6666666666666666,10,5,5,394.45973323574464,0.33984375,0.12107250977280093,0.25903693309939635,135567.92674216896,4095.217643607775,139663.14438577674,1192,9,602.1212121212121,32,1,16,29.376566036210786,0.6848958333333334,39.646464646464636,1041.41414141414,32.544191919191874,0
1218,4,0,0,33,0.0,0.0,1.0,33,850,700,150,0.8235294117647058,10,7,3,392.19567866455645,0.3394491792929293,0.124069442455093,0.25826069789794515,135666.56344059264,4041.567984134253,139708.1314247269,1193,10,603.1212121212121,32,1,16,29.337100553468265,0.6858723958333334,39.55176767676767,1041.792929292928,32.556029040404,0
1219,4,0,0,33,0.0,0.0,1.0,33,1000,900,100,0.9,11,9,2,389.6788597147383,0.33972537878787884,0.11645352103367346,0.2570759096103706,135732.34116735533,3978.4047865013686,139710.7459538567,1194,11,604.1212121212121,32,1,16,29.337059251181387,0.6865234375,39.48863636363636,1042.0454545454543,32.563920454545446,0
1220,4,0,0,33,0.0,0.0,1.0,33,950,800,150,0.8421052631578947,11,8,3,391.36697171346384,0.33905460858585856,0.11353545138965315,0.25938270083545617,135896.85523160896,4037.108139475554,139933.9633710845,1195,12,605.1212121212121,32,1,13,29.129076854767078,0.6881510416666667,39.330808080808076,1042.6767676767672,32.583648989898975,0
1221,4,0,0,33,0.0,0.0,1.0,33,400,100,300,0.25,7,1,6,390.6304779883802,0.3382654671717172,0.10834984224814725,0.2593736131980722,135962.68875624926,4022.2340194877947,139984.92277573707,1196,13,606.1212121212121,32,1,14,29.082677562550447,0.6888020833333334,39.26767676767676,1042.9292929292922,32.59154040404038,0
1222,4,0,0,33,0.0,0.0,1.0,33,650,400,250,0.6153846153846154,9,4,5,390.1738753006786,0.33791035353535354,0.10800818643955945,0.2595504474826253,136028.53822314047,4014.956382001834,140043.4946051423,1197,14,607.1212121212121,32,1,16,29.028988138465277,0.689453125,39.20454545454545,1043.1818181818178,32.599431818181806,0
1223,4,0,0,33,0.0,0.0,1.0,33,650,500,150,0.7692307692307693,8,5,3,390.6345909291539,0.3372395833333333,0.10524656047405334,0.2603390531805264,136094.4036322824,4032.6363381287565,140127.03997041116,1198,15,608.1212121212121,32,1,16,28.95137544369151,0.6901041666666667,39.14141414141414,1043.4343434343432,32.607323232323225,0
1224,4,0,0,33,0.0,0.0,1.0,33,800,400,400,0.5,12,4,8,393.7488059850482,0.3370028409090909,0.12656512887347526,0.2545912350402932,135009.66299676057,4031.978720283648,139041.64171704423,1199,16,609.1212121212121,32,1,16,29.952820637427607,0.6793619791666666,40.18308080808081,1039.2676767676771,32.47711489898991,2
1225,4,0,0,33,0.0,0.0,1.0,33,700,400,300,0.5714285714285714,10,4,6,390.0605491935573,0.3357402146464647,0.12227938849265052,0.25289437496533484,135108.09643148666,3940.067658912362,139048.16409039902,1200,17,610.1212121212121,32,1,17,29.950257064205324,0.6803385416666666,40.08838383838384,1039.6464646464651,32.488952020202035,0
1226,4,0,0,33,0.0,0.0,1.0,33,900,800,100,0.8888888888888888,10,8,2,389.45458044266604,0.33526672979797983,0.12247060771650942,0.25273116390428335,135140.91554752062,3926.249713039481,139067.1652605601,1201,18,611.1212121212121,32,1,17,29.933211900425007,0.6806640625,40.05681818181818,1039.772727272727,32.49289772727272,0
1227,4,0,0,33,0.0,0.0,1.0,33,650,400,250,0.6153846153846154,9,4,5,388.5410494454227,0.33601641414141414,0.12037343574124337,0.2528278961557181,135239.39680899907,3909.211432506886,139148.60824150595,1202,19,612.1212121212121,32,1,17,29.858582180140807,0.681640625,39.96212121212121,1040.151515151515,32.504734848484844,0
1228,4,0,0,33,0.0,0.0,1.0,33,900,800,100,0.8888888888888888,10,8,2,388.2167767971893,0.33656881313131315,0.12250677671238419,0.2528472746270391,135272.23186728408,3902.9899691358214,139175.2218364199,1203,20,613.1212121212121,32,1,18,29.834223408989764,0.6819661458333333,39.930555555555564,1040.2777777777787,32.508680555555586,0
1229,4,0,0,33,0.0,0.0,1.0,33,950,500,450,0.5263157894736842,14,5,9,389.7059605929318,0.3363320707070707,0.11793293850797193,0.25474593443041516,135403.61195605036,3953.518933017035,139357.1308890674,1204,21,614.1212121212121,32,1,18,29.66431113267823,0.6832682291666667,39.80429292929293,1040.782828282828,32.52446338383837,0
1230,4,0,0,33,0.0,0.0,1.0,33,450,300,150,0.6666666666666666,6,3,3,389.6521805457563,0.3366871843434343,0.12103568435446199,0.25494385527136626,135436.46694214875,3954.6229338842995,139391.08987603305,1205,22,615.1212121212121,32,1,18,29.63291484716158,0.68359375,39.77272727272727,1040.9090909090908,32.528409090909086,0
1231,4,0,0,33,0.0,0.0,1.0,33,550,300,250,0.5454545454545454,8,3,5,390.5495768793847,0.3366871843434343,0.12243967877685313,0.25576499296032784,135469.32591380988,3981.497583154787,139450.82349696467,1206,23,616.1212121212121,32,1,18,29.5767636951688,0.6839192708333333,39.74116161616162,1041.035353535354,32.532354797979814,0
1232,4,0,0,33,0.0,0.0,1.0,33,750,600,150,0.8,9,6,3,390.5495768793847,0.3366871843434343,0.12243967877685313,0.25576499296032784,135469.32591380988,3981.497583154787,139450.82349696467,1207,24,617.1212121212121,32,1,18,29.5767636951688,0.6839192708333333,39.74116161616162,1041.035353535354,32.532354797979814,0
1233,4,0,0,33,0.0,0.0,1.0,33,800,700,100,0.875,9,7,2,394.45973323574424,0.33716066919191917,0.12373982306087061,0.2590369330993964,135567.9267421691,4095.217643607789,139663.1443857769,1208,25,618.1212121212121,32,1,18,29.37656603621079,0.6848958333333334,39.64646464646464,1041.414141414141,32.54419191919191,0
1234,4,0,0,33,0.0,0.0,1.0,33,950,800,150,0.8421052631578947,11,8,3,396.3939751065043,0.3366477272727273,0.11548417655287868,0.26150595336162913,135732.34116735542,4160.6964531680505,139893.03762052348,1209,26,619.1212121212121,32,1,18,29.162122864412936,0.6865234375,39.48863636363637,1042.045454545455,32.56392045454547,0
1235,4,0,0,33,0.0,0.0,1.0,33,950,700,250,0.7368421052631579,12,7,5,393.0228332882639,0.3373974116161616,0.11024489076814659,0.2599997204830054,135831.03764921954,4076.939853076225,139907.97750229575,1210,27,620.1212121212121,32,1,18,29.15152616279069,0.6875,39.3939393939394,1042.424242424243,32.57575757575759,0
1236,4,0,0,33,0.0,0.0,1.0,33,850,700,150,0.8235294117647058,10,7,3,392.4404892512992,0.3366477272727273,0.11493797400081451,0.2603346185322474,135929.7700011478,4068.869088613403,139998.6390897612,1211,28,621.1212121212121,32,1,17,29.068289139120957,0.6884765625,39.29924242424242,1042.80303030303,32.58759469696969,0
1237,4,0,0,33,0.0,0.0,1.0,33,750,400,350,0.5333333333333333,11,4,7,392.2266062414622,0.33656881313131315,0.11730868002054473,0.26043342182913826,135962.6887562495,4065.6367972656003,140028.32555351508,1212,29,622.1212121212121,32,1,18,29.041061339790147,0.6888020833333333,39.267676767676775,1042.929292929294,32.59154040404044,0
1238,4,0,0,33,0.0,0.0,1.0,33,900,600,300,0.6666666666666666,12,6,6,394.07770407118073,0.33566130050505055,0.11521972722505236,0.2623903359178218,136061.46893493022,4123.758258085926,140185.22719301615,1213,30,623.1212121212121,32,1,18,28.894368469885848,0.6897786458333333,39.17297979797981,1043.3080808080817,32.603377525252554,0
1239,4,0,0,33,0.0,0.0,1.0,33,600,300,300,0.5,9,3,6,395.5176797797923,0.3357796717171717,0.11264838073451666,0.2640831293263136,136160.28498367517,4170.759998979701,140331.04498265486,1214,31,624.1212121212121,32,1,18,28.758367610291153,0.6907552083333333,39.07828282828283,1043.686868686869,32.61521464646466,0
1240,4,0,0,33,0.0,0.0,1.0,33,950,700,250,0.7368421052631579,12,7,5,397.5017132503682,0.33495107323232326,0.10562644947846245,0.26664530983729096,136325.05810950417,4237.888831496789,140562.94694100096,1215,32,625.1212121212121,32,1,19,28.542497884173613,0.6923828125,38.92045454545455,1044.3181818181822,32.634943181818194,0
1241,4,0,0,33,0.0,0.0,1.0,33,750,600,150,0.8,9,6,3,397.8044363965594,0.3345959595959596,0.10678594455190171,0.26709726443769005,136358.0246913581,4248.765432098773,140606.79012345686,1216,33,626.1212121212121,32,1,19,28.50177304964539,0.6927083333333333,38.88888888888889,1044.444444444445,32.63888888888891,0
1242,4,0,0,33,0.0,0.0,1.0,33,650,400,250,0.6153846153846154,9,4,5,401.4584089137424,0.3348721590909091,0.1029629304158064,0.27055942932981514,136489.93087440045,4359.006096316688,140848.93697071713,1217,34,627.1212121212121,32,1,19,28.275032221685198,0.6940104166666667,38.762626262626256,1044.949494949494,32.65467171717169,0
1243,4,0,0,33,0.0,0.0,1.0,33,550,300,250,0.5454545454545454,8,3,5,401.9517817686094,0.33372790404040403,0.10286484072422719,0.2713994167602407,136555.90787929812,4377.778096622806,140933.68597592093,1218,35,628.1212121212121,32,1,19,28.19647459128614,0.6946614583333333,38.699494949494955,1045.202020202021,32.662563131313156,0
1244,4,0,0,33,0.0,0.0,1.0,33,850,700,150,0.8235294117647058,10,7,3,400.1811594202899,0.33384627525252525,0.10324989020641184,0.27071078431372547,136621.90082644636,4334.702134986233,140956.6029614326,1219,36,629.1212121212121,32,1,19,28.177083333333336,0.6953125,38.63636363636364,1045.454545454546,32.67045454545456,0
1245,4,0,0,33,0.0,0.0,1.0,33,1150,700,450,0.6086956521739131,16,7,9,399.5547865003867,0.3333727904040404,0.11362630529800133,0.27155959033270743,136786.95294166417,4330.776355729014,141117.72929739318,1220,37,630.1212121212121,32,1,19,28.0293200563267,0.6969401041666666,38.47853535353536,1046.085858585859,32.69018308080809,0
1246,4,0,0,33,0.0,0.0,1.0,33,850,600,250,0.7058823529411765,11,6,5,400.7783951337727,0.3335306186868687,0.11559679312122295,0.2734199273468184,136919.06637396695,4374.840736914599,141293.90711088156,1221,38,631.1212121212121,32,1,19,27.86599710459645,0.6982421875,38.35227272727273,1046.5909090909092,32.705965909090914,0
1247,4,0,1,32,0.0,0.030303030303030304,0.9696969696969697,33,950,700,250,0.7368421052631579,12,7,5,399.6244270114938,0.3329387626262626,0.11201853333771838,0.2736651835843368,137051.24357527297,4353.804936996231,141405.0485122692,1222,39,632.1212121212121,32,1,18,27.764882029020463,0.6995442708333333,38.226010101010104,1047.0959595959598,32.721748737373744,0
1248,4,0,0,32,0.0,0.0,1.0,32,750,500,250,0.6666666666666666,10,5,5,404.2090390780411,0.3308341733870968,0.09867725690126838,0.27688663477560527,137061.57260470922,4680.305311414936,141741.87791612415,1223,40,624.78125,31,1,18,27.634605819447906,0.7022849462365591,38.216145833333336,1047.1354166666667,33.77856182795699,0
1249,4,0,0,32,0.0,0.0,1.0,32,800,400,400,0.5,12,4,8,397.67179167115785,0.3308341733870968,0.11554723646367404,0.2608844395401352,135531.97436862512,4379.448615180112,139911.42298380524,1224,41,625.78125,31,1,17,29.328836855487488,0.6871639784946237,39.68098958333333,1041.2760416666658,33.58954973118277,3
1250,4,0,0,32,0.0,0.0,1.0,32,300,200,100,0.6666666666666666,4,2,2,397.17793914595194,0.33064516129032256,0.11936577894473643,0.2608069915672677,135565.8721923827,4368.754747178804,139934.6269395615,1225,42,626.78125,31,1,18,29.307847795282157,0.6875,39.64843749999999,1041.406249999999,33.59374999999997,0
1251,4,0,0,32,0.0,0.0,1.0,32,650,600,50,0.9230769230769231,7,6,1,396.9156086460321,0.3302461357526882,0.11631749156355453,0.26137627858246115,135667.5910949707,4369.716898600261,140037.30799357095,1226,43,627.78125,31,1,19,29.21314523184602,0.688508064516129,39.55078125,1041.796875,33.606350806451616,0
1252,4,0,0,32,0.0,0.0,1.0,32,700,500,200,0.7142857142857143,9,5,4,410.0999709983703,0.3297421034946237,0.15945533627629183,0.2576337664461213,133958.77594230545,4591.37127475251,138550.14721705797,1227,44,628.78125,30,2,17,30.582694971003214,0.6743055555555555,41.196236559139784,1035.2150537634407,34.50716845878136,5
1253,4,0,0,32,0.0,0.0,1.0,32,450,400,50,0.8888888888888888,5,4,1,410.0999709983703,0.3297421034946237,0.15945533627629183,0.2576337664461213,133958.77594230545,4587.298025783326,138546.07396808878,1228,45,629.78125,30,2,17,30.582694971003214,0.6743055555555555,41.196236559139784,1035.2150537634407,34.50716845878136,0
1254,4,0,0,32,0.0,0.0,1.0,32,600,400,200,0.6666666666666666,8,4,4,411.18273847842653,0.33016213037634407,0.1608823338525438,0.2588032530423037,134028.3558792924,4622.029280841709,138650.3851601341,1229,46,630.78125,30,2,17,30.48470491519556,0.675,41.12903225806451,1035.4838709677417,34.51612903225806,0
1255,4,1,0,33,0.030303030303030304,0.0,1.0,33,1000,700,300,0.7,13,7,6,399.35422628964875,0.3366477272727273,0.157615615416127,0.25360383233289274,134354.3567780072,4130.996039944885,138485.35281795208,1230,0,612.6363636363636,32,1,19,30.463707222019245,0.6728515625,40.81439393939393,1036.742424242423,32.39820075757572,0
1256,4,0,0,33,0.0,0.0,1.0,33,950,600,350,0.631578947368421,13,6,7,399.2312081550739,0.33660827020202017,0.1567581328935279,0.25398031855752295,134419.81565975404,4132.91708116518,138552.73274091922,1231,1,613.6363636363636,32,1,20,30.401243962823166,0.6735026041666667,40.75126262626262,1036.994949494949,32.406092171717155,0
1257,4,0,0,33,0.0,0.0,1.0,33,600,300,300,0.5,9,3,6,404.121603861555,0.33656881313131315,0.15062276426484833,0.2528464775026706,133808.8056776259,4220.462067581397,138029.2677452073,1232,2,614.6363636363636,31,2,17,30.888182733450787,0.67002688172043,41.341145833333336,1034.635416666667,33.37533602150538,2
1258,4,1,0,34,0.029411764705882353,0.0,1.0,34,550,300,250,0.5454545454545454,8,3,5,383.61477429427447,0.34330436720142604,0.18672720896045902,0.2268593597720755,131695.40617201067,3363.0783081054733,135058.48448011614,1233,0,597.5294117647059,31,3,16,33.54806228593174,0.6488575268817204,43.391927083333336,1026.432291666667,33.11071908602152,8
1259,4,0,1,33,0.0,0.029411764705882353,0.9705882352941176,34,750,600,150,0.8,9,6,3,375.1234325000563,0.3428030303030303,0.15907998076614938,0.2118004611192621,129908.37191357993,2946.3348765431747,132854.7067901231,1234,1,598.5294117647059,32,2,16,35.5784514078111,0.6282552083333335,45.13888888888887,1019.4444444444418,31.857638888888808,4
1260,4,1,0,34,0.029411764705882353,0.0,1.0,34,650,500,150,0.7692307692307693,8,5,3,371.55682087269844,0.34649806892453955,0.16554039293360368,0.21047938281975145,130037.1215309661,2863.2358942964875,132900.3574252626,1235,0,599.3823529411765,32,2,17,35.53839646777255,0.6295572916666667,45.012626262626256,1019.949494949494,31.873421717171688,0
1261,4,1,1,34,0.02857142857142857,0.02857142857142857,0.9714285714285714,35,800,400,400,0.5,12,4,8,361.6847538621064,0.352906162464986,0.15753377683286485,0.20640803898486743,130325.1453767779,2427.3236255286074,132752.46900230652,1236,0,583.2285714285714,33,2,18,35.497679628740585,0.6300505050505052,44.73039215686273,1021.0784313725469,30.941770647652937,0
1262,4,0,0,34,0.0,0.0,1.0,34,950,700,250,0.7368421052631579,12,7,5,371.4577367690943,0.34673945335710044,0.17120536201614134,0.21129436216077327,130198.1482278593,2872.6218944495304,133070.77012230884,1237,2,601.3823529411765,32,2,18,35.37723205080621,0.6311848958333335,44.85479797979797,1020.5808080808073,31.893150252525228,0
1263,4,1,0,35,0.02857142857142857,0.0,1.0,35,550,300,250,0.5454545454545454,8,3,5,361.7072229234045,0.3527310924369748,0.1748890754287089,0.20758957549609536,130544.21864487191,2443.757358948452,132987.97600382037,1238,0,585.1714285714286,33,2,16,35.274888076108255,0.6322601010101011,44.515931372549005,1021.9362745098019,30.967765894236422,0
1264,4,0,0,35,0.0,0.0,1.0,35,750,600,150,0.8,9,6,3,360.97659257512305,0.3530812324929972,0.17507919384942117,0.20784180206033456,130669.48596993925,2433.7251597942895,133103.21112973354,1239,1,586.1714285714286,33,2,16,35.16658176515242,0.6335227272727273,44.39338235294117,1022.4264705882338,30.98262032085557,0
1265,4,0,0,35,0.0,0.0,1.0,35,600,200,400,0.3333333333333333,10,2,8,362.1803209820478,0.3532563025210084,0.17885221202574964,0.2087039087205944,130700.81218762013,2467.452422145322,133168.26460976547,1240,2,587.1714285714286,33,2,16,35.10406679450303,0.6338383838383839,44.36274509803921,1022.5490196078431,30.986333927510398,0
1266,4,0,0,35,0.0,0.0,1.0,35,800,500,300,0.625,11,5,6,362.9078083713057,0.3523109243697479,0.17764391813265767,0.2098029351996995,130826.1546039985,2495.5666089965425,133321.72121299503,1241,3,588.1714285714286,33,2,16,34.958473087366215,0.6351010101010102,44.240196078431374,1023.0392156862748,31.00118835412954,0
1267,4,1,1,35,0.027777777777777776,0.027777777777777776,0.9722222222222222,36,950,600,350,0.631578947368421,13,6,7,355.19978774572985,0.35707671957671955,0.17938268736851648,0.2078800117405156,131297.62081916083,2127.377409297038,133424.99822845787,1242,0,572.8055555555555,34,2,17,34.67882448600302,0.6375612745098039,43.7797619047619,1024.8809523809512,30.143557422969153,0
1268,4,1,0,36,0.027777777777777776,0.0,1.0,36,550,400,150,0.7272727272727273,7,4,3,354.74431706026405,0.35550595238095234,0.18233601692728563,0.20811022197023094,131389.14399092953,2121.910430838986,133511.05442176852,1243,0,573.5833333333334,34,2,19,34.59804149249112,0.6384803921568627,43.69047619047618,1025.2380952380938,30.154061624649817,0
1269,4,2,2,36,0.05263157894736842,0.05263157894736842,0.9473684210526316,38,900,800,100,0.8888888888888888,10,8,2,337.5881745615879,0.3655316500711237,0.1655891758349597,0.20013842494489958,131790.2425229282,1298.1654796688504,133088.40800259705,1244,0,544.3421052631579,36,2,16,34.63364590187907,0.6383101851851853,43.299549549549546,1026.8018018018008,28.522272272272247,0
1270,4,0,0,36,0.0,0.0,1.0,36,750,400,350,0.5333333333333333,11,4,7,355.1924072557651,0.35558862433862437,0.18506158509060455,0.2088725316387997,131480.6990504535,2140.189200680268,133620.88825113376,1245,2,575.5833333333334,34,2,19,34.49409943896306,0.6393995098039216,43.601190476190474,1025.5952380952378,30.164565826330524,0
1271,4,0,0,36,0.0,0.0,1.0,36,900,600,300,0.6666666666666666,12,6,6,356.21229395629916,0.3559358465608466,0.18530337020706078,0.20997520857150392,131572.28599773248,2173.5331632653147,133745.8191609978,1246,3,576.5833333333334,34,2,16,34.37548348418039,0.6403186274509803,43.511904761904766,1025.9523809523814,30.17507002801122,0
1272,4,1,0,37,0.02702702702702703,0.0,1.0,37,950,600,350,0.631578947368421,13,6,7,350.15111353264007,0.35976601601601604,0.198169785013669,0.20863366348609266,131981.42387902958,1842.6885073731235,133824.1123864027,1247,0,561.972972972973,35,2,18,34.118513929563726,0.6422619047619047,43.11342592592593,1027.546296296297,29.35846560846563,0
1273,4,1,1,37,0.02631578947368421,0.02631578947368421,0.9736842105263158,38,800,600,200,0.75,10,6,4,337.706998191393,0.36345720720720726,0.18412985606121723,0.2026685756557284,132253.17166829,1332.5643210778499,133585.73598936782,1248,0,548.1578947368421,36,2,18,34.16493321655355,0.6429398148148149,42.84909909909911,1028.6036036036044,28.572322322322343,0
1274,4,0,0,37,0.0,0.0,1.0,37,900,700,200,0.7777777777777778,11,7,4,344.88308037918773,0.35992242242242245,0.1899986002665579,0.20614074831278237,132100.37964034642,1711.8371699245643,133812.216810271,1249,2,563.972972972973,35,2,18,34.13411018539368,0.6434523809523809,42.99768518518519,1028.0092592592598,29.371693121693138,0
1275,4,0,0,37,0.0,0.0,1.0,37,600,500,100,0.8333333333333334,7,5,2,344.4474213406501,0.3599537037037037,0.19135244667159523,0.2060421847655891,132130.12695312515,1702.3763020833474,133832.5032552085,1250,3,564.972972972973,35,2,18,34.1153748733536,0.6437499999999999,42.96875000000001,1028.1250000000011,29.375000000000032,0
1276,4,0,0,37,0.0,0.0,1.0,37,850,500,350,0.5882352941176471,12,5,7,351.3813700330443,0.3605480480480481,0.19008998546799027,0.2059731094182809,131358.63272392296,1831.6665338010216,133190.299257724,1251,4,565.972972972973,34,3,20,34.71504471025432,0.6381740196078431,43.720238095238095,1025.119047619048,30.150560224089645,2
1277,4,0,0,37,0.0,0.0,1.0,37,850,600,250,0.7058823529411765,11,6,5,349.509203286773,0.36073573573573575,0.18925508580681072,0.2052026426659153,131419.65880102047,1786.4760487528488,133206.1348497733,1252,5,566.972972972973,34,3,21,34.701420333604254,0.6387867647058822,43.66071428571429,1025.3571428571433,30.1575630252101,0
1278,4,0,0,37,0.0,0.0,1.0,37,950,700,250,0.7368421052631579,12,7,5,346.9683004846555,0.360767017017017,0.18543569674791383,0.20468992346866846,131602.82206632657,1732.4015022675696,133335.22356859414,1253,6,567.972972972973,34,3,19,34.58178636346056,0.640625,43.482142857142854,1026.0714285714287,30.17857142857143,0
1279,4,0,0,37,0.0,0.0,1.0,37,550,300,250,0.5454545454545454,8,3,5,346.6214652160573,0.36086086086086083,0.18370226374866783,0.20464911165495983,131633.36167800447,1725.3897392290216,133358.7514172335,1254,7,568.972972972973,34,3,19,34.5598897911833,0.6409313725490196,43.45238095238095,1026.1904761904757,30.182072829131638,0
1280,4,0,0,37,0.0,0.0,1.0,37,1100,800,300,0.7272727272727273,14,8,6,346.51225590294,0.36095470470470475,0.1835505922250682,0.20507722598840408,131725.00177154175,1728.8655045351256,133453.86727607687,1255,8,569.972972972973,34,3,19,34.47031195639569,0.6418504901960785,43.36309523809523,1026.5476190476174,30.192577030812277,0
1281,4,0,0,37,0.0,0.0,1.0,37,800,600,200,0.75,10,6,4,347.3038257401676,0.36173673673673673,0.1807671339319845,0.20604145810417354,131816.67375283426,1756.0870181405649,133572.76077097483,1256,9,570.972972972973,34,3,19,34.35761071180152,0.6427696078431373,43.27380952380951,1026.9047619047603,30.203081232492952,0
1282,4,0,0,37,0.0,0.0,1.0,37,850,700,150,0.8235294117647058,10,7,3,349.09897565881283,0.3621121121121121,0.1805936673808719,0.20743980454436886,131877.8061224489,1807.6814058956807,133685.4875283446,1257,10,571.972972972973,34,3,19,34.24992273218976,0.6433823529411765,43.21428571428571,1027.1428571428567,30.21008403361343,0
1283,4,0,0,37,0.0,0.0,1.0,37,600,300,300,0.5,9,3,6,350.9685199798372,0.3619244244244244,0.18017809210299696,0.20871863259173076,131908.37762188198,1859.1376133786725,133767.51523526065,1258,11,572.972972972973,34,3,19,34.17110905087496,0.6436887254901962,43.1845238095238,1027.261904761904,30.213585434173645,0
1284,4,0,0,37,0.0,0.0,1.0,37,1000,900,100,0.9,11,9,2,349.13682702777743,0.36151776776776773,0.17851675375131926,0.2082998084126328,132030.6990504533,1819.3558673469092,133850.0549178002,1259,12,573.972972972973,34,3,20,34.09494575080117,0.6449142156862746,43.065476190476176,1027.7380952380934,30.22759103641451,0
1285,4,0,0,37,0.0,0.0,1.0,37,1100,900,200,0.8181818181818182,13,9,4,347.9480625917745,0.362205955955956,0.17271891015813234,0.20843102390206275,132183.68055555542,1798.6111111110918,133982.2916666665,1260,13,574.972972972973,34,3,20,33.971501890869796,0.6464460784313726,42.91666666666666,1028.3333333333321,30.24509803921565,0
1286,4,0,0,37,0.0,0.0,1.0,37,1100,700,400,0.6363636363636364,15,7,8,349.1446330579211,0.3619244244244244,0.17765352996175676,0.20999701207512933,132336.75063775494,1840.9332482992968,134177.68388605423,1261,14,575.972972972973,34,3,20,33.78673493000115,0.6479779411764707,42.76785714285713,1028.92857142857,30.262605042016762,0
1287,4,0,0,37,0.0,0.0,1.0,37,1150,800,350,0.6956521739130435,15,8,7,345.83881372046454,0.36123623623623624,0.16923769282696166,0.2088557305205711,132489.9092970521,1764.030612244886,134253.93990929698,1262,15,576.972972972973,34,3,20,33.71781529448041,0.6495098039215687,42.61904761904761,1029.523809523809,30.280112044817912,0
1288,4,1,1,37,0.02631578947368421,0.02631578947368421,0.9736842105263158,38,850,500,350,0.5882352941176471,12,5,7,336.0665911512266,0.3676653627311522,0.1573567146353867,0.20406990412197928,132695.96220207462,1318.935935356637,134014.89813743124,1263,0,562.7631578947369,35,3,14,33.762543997603544,0.6494047619047618,42.418981481481474,1030.324074074073,29.437830687830658,0
1289,4,0,0,37,0.0,0.0,1.0,37,1200,1000,200,0.8333333333333334,14,10,4,360.1926697749794,0.3616428928928929,0.17982601766385553,0.2008197487649543,129413.28125,1922.7430555555559,131336.02430555556,1264,17,578.972972972973,34,3,19,36.46259896259896,0.6185661764705883,45.625,1017.5,29.926470588235293,4
1290,4,4,0,41,0.0975609756097561,0.0,1.0,41,1250,800,450,0.64,17,8,9,334.13439603712493,0.3827997967479675,0.19190137233584292,0.18478409157587955,129092.79348381892,426.8685166922125,129519.66200051113,1265,0,523.390243902439,38,3,18,37.45115818615084,0.6074561403508772,45.94017094017093,1016.2393162393146,26.743139901034596,3
1291,4,2,1,42,0.046511627906976744,0.023255813953488372,0.9767441860465116,43,1300,1100,200,0.8461538461538461,15,11,4,320.68199567410784,0.3925341454411222,0.1887500118992087,0.1792737106251364,129519.2925347223,-293.0533012363892,129226.23923348592,1266,0,500.0,39,4,15,37.36014463091826,0.6100427350427351,45.520833333333336,1017.9166666666673,26.100427350427367,0
1292,4,2,2,42,0.045454545454545456,0.045454545454545456,0.9545454545454546,44,1100,900,200,0.8181818181818182,13,9,4,314.73445323825695,0.3955800739957717,0.18309667591534673,0.17707786914516074,129770.27253123143,-631.3648456606538,129138.90768557077,1267,0,489.59090909090907,40,4,16,37.25729769266571,0.6109375,45.27439024390244,1018.9024390243904,25.47256097560976,0
1293,4,0,0,42,0.0,0.0,1.0,42,850,700,150,0.8235294117647058,10,7,3,333.77742170682,0.38784843205574915,0.21116693492180527,0.1827022578645342,128685.9673483271,190.49407827452842,128876.46142660163,1268,1,513.8571428571429,38,4,17,37.87424098838229,0.6033442982456141,46.340811965811966,1014.636752136752,26.700967161493473,1
1294,4,2,1,43,0.045454545454545456,0.022727272727272728,0.9772727272727273,44,600,200,400,0.3333333333333333,10,2,8,321.6106,0.3992578400281888,0.21343636363636365,0.1778819690265487,129098.08976138546,-496.1371785973904,128601.95258278807,1269,0,491.45454545454544,40,4,18,37.76395833333334,0.6041666666666666,45.9349593495935,1016.2601626016263,25.406504065040657,0
1295,4,1,0,44,0.022727272727272728,0.0,1.0,44,700,400,300,0.5714285714285714,10,4,6,325.1814028486968,0.3970996300211416,0.22224292101341314,0.18032786885245894,129201.38888888879,-397.0982880560591,128804.29060083273,1270,0,492.4318181818182,37,7,19,37.568306010928964,0.6103603603603605,45.83333333333333,1016.6666666666658,27.477477477477454,0
1296,4,1,1,44,0.022222222222222223,0.022222222222222223,0.9777777777777777,45,900,800,100,0.8888888888888888,10,8,2,315.1034668099971,0.4011153198653199,0.1981785063752275,0.17473919523099876,129201.38888888923,-857.6388888888525,128343.75000000038,1271,0,482.46666666666664,42,3,18,37.82445355191259,0.6021825396825395,45.83333333333335,1016.6666666666694,24.20634920634927,3
1297,4,2,3,43,0.043478260869565216,0.06521739130434782,0.9347826086956522,46,750,500,250,0.6666666666666666,10,5,5,306.83131702073644,0.4051731078904992,0.1985485178994053,0.17186479100500573,129595.74619914709,-1247.193302686095,128348.552896461,1272,0,472.32608695652175,42,4,12,37.6352144397919,0.6061507936507934,45.44573643410855,1018.2170542635691,24.243263196751645,0
1298,4,0,0,43,0.0,0.0,1.0,43,900,400,500,0.4444444444444444,14,4,10,328.2047836603061,0.3954641934293097,0.20263057567670573,0.18200447093889738,129201.38888888923,-119.09722222218574,129082.29166666704,1273,2,506.1162790697674,40,3,18,37.491461748633895,0.6052083333333331,45.83333333333335,1016.6666666666694,25.416666666666735,0
1299,4,2,1,44,0.044444444444444446,0.022222222222222223,0.9777777777777777,45,700,300,400,0.42857142857142855,11,3,8,317.53180200790877,0.40290404040404043,0.21000108189981592,0.17858990178648576,129756.71315980122,-759.6234095489775,128997.08975025224,1274,0,484.5777777777778,41,4,14,37.199772801038634,0.6092479674796747,45.287698412698425,1018.8492063492085,24.849980642663624,0
1300,4,1,0,45,0.022222222222222223,0.0,1.0,45,500,200,300,0.4,8,2,6,336.39356536705174,0.40294612794612794,0.22830409356725156,0.1830619647864888,128453.40617563951,-356.83595263462905,128096.57022300488,1275,0,485.55555555555554,40,5,16,38.04490392648287,0.59765625,46.57012195121951,1013.719512195122,25.34298780487805,3
1301,4,2,1,46,0.0425531914893617,0.02127659574468085,0.9787234042553191,47,1050,800,250,0.7619047619047619,13,8,5,334.6771014609123,0.40710761640456367,0.2459142769041014,0.18513151055496008,129102.89345592196,-758.4435655910227,128344.44989033094,1276,0,465.8510638297872,42,5,17,37.427099224510556,0.6011904761904763,45.93023255813953,1016.2790697674405,24.197120708748585,0
1302,4,0,2,44,0.0,0.043478260869565216,0.9565217391304348,46,1400,900,500,0.6428571428571429,19,9,10,337.810916076983,0.40537439613526566,0.245192430146965,0.1866159332502942,129050.14349489775,-481.0905612245118,128569.05293367324,1277,1,476.9782608695652,41,5,17,37.40114235500878,0.6021341463414634,45.98214285714285,1016.0714285714268,24.782229965156752,0
1303,4,0,0,44,0.0,0.0,1.0,44,1250,800,450,0.64,17,8,9,351.18409192487553,0.40216481677237487,0.24894161638955992,0.19331980305904042,128910.32036675327,254.2507595485894,129164.57112630186,1278,2,472.45454545454544,39,5,18,37.20392262454269,0.6038995726495727,46.11979166666666,1015.5208333333317,26.038995726495685,0
1304,4,2,1,45,0.043478260869565216,0.021739130434782608,0.9782608695652174,46,950,700,250,0.7368421052631579,12,7,5,336.8346596688777,0.4096920289855073,0.2397771258798278,0.18758415200527284,129368.65790435509,-483.5174945656487,128885.14040978944,1279,0,452.8695652173913,37,9,19,37.10210533879429,0.6120495495495495,45.6688596491228,1017.3245614035079,27.495258416311025,0
1305,4,2,1,46,0.0425531914893617,0.02127659574468085,0.9787234042553191,47,1150,800,350,0.6956521739130435,15,8,7,328.7817125304648,0.4128314831945729,0.24646557249024892,0.1849812261408777,129770.27253123141,-866.7815123273208,128903.4910189041,1280,0,444.1914893617021,40,7,18,36.89947802380477,0.6109375000000001,45.27439024390244,1018.9024390243903,25.47256097560976,0
1306,4,1,1,46,0.02127659574468085,0.02127659574468085,0.9787234042553191,47,1000,500,500,0.5,15,5,10,330.30490295302417,0.4115787850755473,0.24748151982958433,0.18608413296701812,129822.0511930728,-823.8279959019201,128998.22319717088,1281,0,445.1489361702128,40,7,19,36.808187076186684,0.6114583333333334,45.22357723577235,1019.1056910569097,25.477642276422742,0
1307,4,0,1,45,0.0,0.021739130434782608,0.9782608695652174,46,950,600,350,0.631578947368421,13,6,7,314.2095003590847,0.40865539452495975,0.13384185100432222,0.17558766196537098,129504.14540816339,-1061.7134353741376,128442.43197278924,1282,2,455.82608695652175,41,5,12,37.54020467836257,0.6067073170731706,45.53571428571429,1017.8571428571438,24.825783972125457,7
1308,4,0,0,45,0.0,0.0,1.0,45,1350,1000,350,0.7407407407407407,17,10,7,313.2968410025939,0.4064183501683502,0.1490412660389704,0.1754567384016206,129589.1285465829,-880.0270796152919,128709.10146696761,1283,3,466.06666666666666,40,5,12,37.47733473067838,0.6091145833333333,45.45223577235773,1018.1910569105705,25.45477642276426,0
1309,4,1,1,45,0.021739130434782608,0.021739130434782608,0.9782608695652174,46,950,600,350,0.631578947368421,13,6,7,304.3461026160159,0.4090680354267311,0.1510187242145351,0.17172741374956416,129883.08930342968,-1294.1175949546514,128588.97170847503,1284,0,456.9130434782609,41,5,13,37.40784671532845,0.6105182926829269,45.163690476190474,1019.3452380952378,24.86207897793263,0
1310,4,1,2,44,0.021739130434782608,0.043478260869565216,0.9565217391304348,46,1000,800,200,0.8,12,8,4,305.3377038259474,0.4095008051529791,0.16638470647944525,0.1728453521657895,130009.52695893156,-1260.6379125724548,128748.88904635911,1285,0,457.89130434782606,41,5,14,37.25478274967573,0.6117886178861789,45.03968253968253,1019.8412698412685,24.87417731320167,0
1311,4,2,4,42,0.043478260869565216,0.08695652173913043,0.9130434782608696,46,800,600,200,0.75,10,6,4,305.6564370608608,0.4087761674718196,0.1748979195022362,0.17370066914961377,130161.33334120663,-1243.0701215671688,128918.26321963946,1286,0,458.2391304347826,41,5,16,37.09329833430552,0.6133130081300815,44.890873015873005,1020.4365079365061,24.88869531552454,0
1312,4,1,1,42,0.023255813953488372,0.023255813953488372,0.9767441860465116,43,750,200,550,0.26666666666666666,13,2,11,327.03429040358554,0.40097822074566264,0.18310051506165115,0.18387965762314798,129745.05077069171,-113.78387756593833,129631.26689312578,1287,0,490.4186046511628,38,5,16,36.96955397091723,0.6140350877192983,45.299145299145295,1018.8034188034181,26.810616284300476,0
1313,4,0,0,42,0.0,0.0,1.0,42,750,500,250,0.6666666666666666,10,5,5,332.02820999152055,0.39713995354239257,0.18523180197189038,0.18642856030972654,129690.63321827745,212.18976002629745,129902.82297830375,1288,2,503.0952380952381,38,4,16,36.89755087056848,0.6134868421052632,45.3525641025641,1018.5897435897435,26.804993252361673,0
1314,4,0,0,42,0.0,0.0,1.0,42,1200,600,600,0.5,18,6,12,329.87695181525584,0.3970915602013163,0.1792642190566065,0.18560687253463687,129772.26382725181,161.77576429980323,129934.03959155161,1289,3,504.0952380952381,38,4,17,36.86956065848801,0.6143092105263158,45.2724358974359,1018.9102564102565,26.813427800269906,0
1315,4,0,0,42,0.0,0.0,1.0,42,700,300,400,0.42857142857142855,11,3,8,329.6546813812741,0.39724883855981413,0.18030847559149388,0.18586912886391016,129853.92011834339,161.39053254439546,130015.31065088778,1290,4,505.0952380952381,38,4,17,36.79245283018865,0.6151315789473684,45.1923076923077,1019.2307692307709,26.821862348178183,0
1316,4,0,0,42,0.0,0.0,1.0,42,800,200,600,0.25,14,2,12,329.7923009255584,0.3968495934959349,0.17780804694048613,0.1864655047413228,129962.83512309153,172.1484860106655,130134.9836091022,1291,5,506.0952380952381,38,4,18,36.67858514948308,0.6162280701754386,45.085470085470085,1019.6581196581196,26.83310841205578,0
1317,4,2,2,42,0.045454545454545456,0.045454545454545456,0.9545454545454546,44,1350,1000,350,0.7407407407407407,17,10,7,316.9101229744867,0.4056443798449612,0.17610855702209682,0.18155692091902867,130475.34722222242,-529.8630515377113,129945.48417068471,1292,0,484.04545454545456,39,5,19,36.48892060902665,0.6196581196581196,44.58333333333334,1021.6666666666682,26.196581196581235,0
1318,4,2,1,43,0.045454545454545456,0.022727272727272728,0.9772727272727273,44,900,600,300,0.6666666666666666,12,6,6,321.6170730760421,0.40578752642706134,0.196060050551343,0.18565303001373687,130768.17626953151,-388.5443793402487,130379.63189019126,1293,0,484.52272727272725,39,5,16,36.07302593611028,0.6225961538461537,44.296875000000014,1022.812500000002,26.22596153846159,0
1319,4,0,0,43,0.0,0.0,1.0,43,750,500,250,0.6666666666666666,10,5,5,325.5672172046929,0.40185492801771866,0.193410407152943,0.187333295335641,130644.58832137134,-93.28098747167098,130551.30733389966,1294,1,496.7906976744186,38,5,16,36.09681436583411,0.623081140350877,44.41773504273505,1022.3290598290612,26.903396311291083,0
1320,4,0,0,43,0.0,0.0,1.0,43,1300,1000,300,0.7692307692307693,16,10,6,325.5672172046929,0.40171650055370983,0.193410407152943,0.187333295335641,130644.58832137134,-93.28098747167098,130551.30733389966,1295,2,497.7906976744186,38,5,16,36.09681436583411,0.623081140350877,44.41773504273505,1022.3290598290612,26.903396311291083,0
1321,4,0,0,43,0.0,0.0,1.0,43,1450,1100,350,0.7586206896551724,18,11,7,323.36618158187554,0.4020856404577335,0.18571126642519253,0.18659339700321273,130753.8343400725,-143.72637245231488,130610.10796762018,1296,3,498.7906976744186,38,5,16,36.0427765590724,0.6241776315789472,44.310897435897445,1022.7564102564118,26.91464237516873,0
1322,4,0,0,43,0.0,0.0,1.0,43,1400,1000,400,0.7142857142857143,18,10,8,327.41012017222647,0.4020856404577335,0.21212862088524664,0.18106541064408227,129092.79348381895,-145.4841706845117,128947.30931313444,1297,4,499.7906976744186,38,5,19,37.62199502382955,0.6074561403508772,45.94017094017093,1016.2393162393148,26.7431399010346,3
1323,4,0,1,42,0.0,0.023255813953488372,0.9767441860465116,43,1150,800,350,0.6956521739130435,15,8,7,327.20562902380675,0.4021317829457364,0.2085961229721114,0.1815752753014322,129228.54487407746,-143.13853732927146,129085.40633674819,1298,5,500.7906976744186,38,5,20,37.489273580610124,0.6088267543859651,45.80662393162392,1016.7735042735021,26.757197480881633,0
1324,4,1,0,43,0.023255813953488372,0.0,1.0,43,1000,600,400,0.6,14,6,8,325.54526945470656,0.4047849760059062,0.21500519996679857,0.1817786774223639,129473.07715136216,-170.13044232597935,129302.94670903617,1299,0,499.09302325581393,38,5,16,37.283268598222406,0.611293859649123,45.566239316239304,1017.7350427350408,26.782501124606338,0
1325,4,0,0,43,0.0,0.0,1.0,43,1050,500,550,0.47619047619047616,16,5,11,326.80664762021877,0.4041159099298634,0.21791676532547677,0.18260920421570778,129500.26167223656,-135.6907233910731,129364.57094884549,1300,1,500.09302325581393,38,5,16,37.22359259648017,0.6115679824561404,45.5395299145299,1017.8418803418782,26.785312640575743,0
1326,4,0,0,43,0.0,0.0,1.0,43,1150,700,450,0.6086956521739131,16,7,9,324.276134445336,0.4040236249538575,0.21212601922649887,0.18144611186903115,129554.63927469104,-197.7044753086803,129356.93479938236,1301,2,501.09302325581393,38,5,16,37.23283310595724,0.6121162280701755,45.48611111111109,1018.0555555555529,26.79093567251455,0
1327,4,0,0,43,0.0,0.0,1.0,43,1000,700,300,0.7,13,7,6,326.8146406555713,0.4043927648578811,0.21710630636784334,0.1833739828940292,129663.42872242286,-124.81862718243497,129538.61009524042,1302,3,502.09302325581393,38,5,18,37.05789538095739,0.6132127192982457,45.37927350427349,1018.482905982904,26.80218173639221,0
1328,4,0,0,43,0.0,0.0,1.0,43,1200,800,400,0.6666666666666666,16,8,8,327.6451548248955,0.4042543373938723,0.21587167961996956,0.18298449621448146,129480.23069598347,-113.90482618784728,129366.32586979562,1303,4,503.09302325581393,37,6,18,37.22258134022839,0.6131756756756757,45.559210526315795,1017.7631578947374,27.507112375533445,1
1329,4,3,3,43,0.06521739130434782,0.06521739130434782,0.9347826086956522,46,950,700,250,0.7368421052631579,12,7,5,307.70250250120364,0.4118860708534622,0.20831976795809037,0.17452315682404176,130085.41907793214,-1194.478202160489,128890.94087577164,1304,0,471.2173913043478,41,5,19,37.117795552530055,0.6125508130081301,44.96527777777778,1020.1388888888891,24.88143631436315,0
1330,4,1,0,44,0.022727272727272728,0.0,1.0,44,1250,1000,250,0.8,15,10,5,324.44264536021467,0.40641516913319237,0.2177201598361771,0.18338777807881887,129951.54303200812,-367.63552201069757,129583.90750999743,1305,0,493.6136363636364,40,4,20,36.82638958104922,0.6127604166666667,45.09654471544716,1019.6138211382118,25.490345528455297,0
1331,4,1,1,44,0.022222222222222223,0.022222222222222223,0.9777777777777777,45,1050,900,150,0.8571428571428571,12,9,3,319.36375465897873,0.40904882154882155,0.2114307931570767,0.18172645508471075,130211.95515243118,-683.0042202066128,129528.95093222457,1306,0,483.6222222222222,41,4,20,36.69242483151893,0.6138211382113821,44.841269841269835,1020.6349206349194,24.89353464963218,0
1332,4,1,1,44,0.022222222222222223,0.022222222222222223,0.9777777777777777,45,800,500,300,0.625,11,5,6,322.69148692541546,0.4089436026936027,0.21250741167032872,0.18411716659977279,130317.12420784928,-589.5251578058494,129727.59905004343,1307,0,484.6,38,7,20,36.50116842802832,0.6197916666666667,44.73824786324786,1021.0470085470079,26.8696581196581,0
1333,4,0,1,43,0.0,0.022727272727272728,0.9772727272727273,44,950,600,350,0.631578947368421,13,6,7,332.23583212290845,0.40575449260042284,0.226345282724149,0.189569857152483,130318.55955678668,-140.70098491843757,130177.85857186824,1308,3,496.6136363636364,37,7,20,36.25608533791525,0.6216216216216216,44.73684210526316,1021.0526315789472,27.596017069701276,0
1334,4,2,2,43,0.044444444444444446,0.044444444444444446,0.9555555555555556,45,1350,1000,350,0.7407407407407407,17,10,7,349.5616674076289,0.40845959595959597,0.27222336088907184,0.19358812432256756,129148.44292534716,32.96443977954351,129181.40736512671,1309,0,486.1777777777778,39,6,20,37.00254492040719,0.6063034188034189,45.885416666666664,1016.4583333333328,26.063034188034173,4
1335,4,1,0,44,0.022727272727272728,0.0,1.0,44,950,700,250,0.7368421052631579,12,7,5,353.60950238614026,0.4072740486257928,0.2919075427697977,0.19692610823160914,129368.6579043552,349.20819987881123,129717.86610423401,1310,0,496.5,37,7,21,36.675468851045494,0.6120495495495495,45.66885964912281,1017.3245614035088,27.49525841631105,0
1336,4,1,0,45,0.022222222222222223,0.0,1.0,45,850,700,150,0.8235294117647058,10,7,3,346.41875924038766,0.4076388888888889,0.2909866442906084,0.19450862488797765,129690.63321827762,-14.546351084798545,129676.08686719282,1311,0,486.44444444444446,38,7,18,36.531099223830495,0.613486842105263,45.35256410256411,1018.589743589745,26.80499325236171,0
1337,4,0,1,44,0.0,0.022222222222222223,0.9777777777777777,45,1500,1000,500,0.6666666666666666,20,10,10,349.0943014381385,0.4076178451178451,0.2900967170685189,0.19728262254483267,129943.77170138899,72.52604166667444,130016.29774305566,1312,1,487.44444444444446,39,6,19,36.20589837896744,0.6143162393162394,45.10416666666667,1019.5833333333342,26.143162393162413,0
1338,4,0,0,44,0.0,0.0,1.0,44,900,600,300,0.6666666666666666,12,6,6,350.83874633432634,0.40431201550387597,0.28140989604672617,0.19795106320377345,129881.14458917746,313.46758802688083,130194.61217720434,1313,2,499.45454545454544,38,6,19,36.22502008873981,0.6154057017543859,45.16559829059829,1019.337606837607,26.824673864147552,0
1339,4,0,0,44,0.0,0.0,1.0,44,1100,900,200,0.8181818181818182,13,9,4,352.2590052742915,0.40404774489076817,0.2819777132244392,0.19930718466764144,129990.07100819996,358.0346217766035,130348.10562997656,1314,3,500.45454545454544,38,6,20,36.078225947267335,0.6165021929824561,45.05876068376068,1019.7649572649568,26.83591992802518,0
1340,4,1,1,44,0.022222222222222223,0.022222222222222223,0.9777777777777777,45,1100,800,300,0.7272727272727273,14,8,6,338.9264004309016,0.4080597643097643,0.27432216905901075,0.1914476153785364,129925.63950029755,-192.95413609623222,129732.68536420132,1315,0,490.31111111111113,40,5,15,36.48346125730995,0.6125,45.1219512195122,1019.512195121952,25.4878048780488,4
1341,4,1,0,45,0.022222222222222223,0.0,1.0,45,850,600,250,0.7058823529411765,11,6,5,336.71925746467724,0.4051767676767677,0.2688499180727153,0.1907062340810104,130029.2691189108,-243.32821072112327,129785.94090818967,1316,0,491.2888888888889,40,5,16,36.43466852663743,0.6135416666666667,45.020325203252035,1019.9186991869927,25.49796747967482,0
1342,4,1,1,45,0.021739130434782608,0.021739130434782608,0.9782608695652174,46,1100,700,400,0.6363636363636364,15,7,8,330.69455879562383,0.40829307568438006,0.26499626913207197,0.18855114581449794,130289.85407991841,-582.143421182781,129707.71065873562,1317,0,481.5869565217391,38,8,17,36.32447328031254,0.619517543859649,44.764957264957275,1020.9401709401728,26.86684660368876,0
1343,4,1,0,46,0.021739130434782608,0.0,1.0,46,850,600,250,0.7058823529411765,11,6,5,332.86178903175625,0.4077093397745572,0.2739431843870088,0.190826492613238,130501.95448133702,-512.1771918402533,129989.77728949676,1318,0,482.5652173913044,39,7,16,36.05457997757163,0.6199252136752136,44.55729166666668,1021.7708333333351,26.199252136752182,0
1344,4,0,0,46,0.0,0.0,1.0,46,1400,1100,300,0.7857142857142857,17,11,6,332.39823010240156,0.40783011272141706,0.2695077304771414,0.1911717436592375,130625.94112507465,-516.0336729129153,130109.90745216173,1319,1,483.5652173913044,40,6,17,35.9410726712397,0.6195312499999999,44.43597560975611,1022.2560975609779,25.556402439024446,0
1345,4,1,0,47,0.02127659574468085,0.0,1.0,47,1050,500,550,0.47619047619047616,16,5,11,327.4607896160088,0.4084759481961147,0.26855517070757084,0.19028126964173483,131023.24263038553,-819.0051020408076,130204.23752834472,1320,0,474.25531914893617,41,6,18,35.66618217054265,0.621951219512195,44.04761904761905,1023.8095238095241,24.970963995354246,0
1346,4,0,1,46,0.0,0.02127659574468085,0.9787234042553191,47,850,400,450,0.47058823529411764,13,4,9,328.2683561045251,0.40861085414739434,0.27018514472290156,0.1910025914154967,131074.03175390538,-794.5086136306214,130279.52314027476,1321,1,475.25531914893617,41,6,18,35.59428082412971,0.6224593495934958,43.99801587301588,1024.0079365079375,24.97580332946189,0
1347,4,0,0,46,0.0,0.0,1.0,46,800,400,400,0.5,12,4,8,339.94592743386653,0.4075583735909823,0.25616679675406484,0.18451828211448468,128350.40655570429,-451.81964489367266,127898.58691081061,1322,2,486.4782608695652,40,6,18,38.05995720924012,0.5966145833333334,46.671747967479675,1013.3130081300815,25.332825203252035,8
1348,4,1,0,47,0.02127659574468085,0.0,1.0,47,1100,800,300,0.7272727272727273,14,8,6,331.610441927853,0.41196423065063215,0.25479498214296825,0.18168415696197143,128722.7490099048,-862.8384629314788,127859.91054697332,1323,0,477.1063829787234,41,6,14,37.89175791051586,0.5988313008130082,46.30456349206349,1014.7817460317453,24.750774293457205,0
1349,4,2,1,48,0.04081632653061224,0.02040816326530612,0.9795918367346939,49,1250,900,350,0.72,16,9,7,322.15802203708654,0.4155151643990929,0.26296420207427174,0.17865126676602094,129201.38888888911,-1474.4589907722157,127726.9298981169,1324,0,458.59183673469386,43,6,17,37.645150273224054,0.6007751937984496,45.83333333333334,1016.6666666666684,23.64341085271322,0
1350,4,4,4,48,0.07692307692307693,0.07692307692307693,0.9230769230769231,52,1200,900,300,0.75,15,9,6,304.48695423603857,0.4242945575666164,0.25118224942168577,0.1705516479270947,129595.74619914682,-2503.61691379724,127092.12928534957,1325,0,432.8076923076923,42,10,13,37.6948911940109,0.6061507936507936,45.44573643410853,1018.217054263567,24.243263196751595,2
1351,4,3,3,48,0.058823529411764705,0.058823529411764705,0.9411764705882353,51,1300,1000,300,0.7692307692307693,16,10,6,313.4277672713933,0.42516339869281045,0.2558724191157373,0.17560167048436548,129605.142983119,-2075.6298815822756,127529.51310153672,1326,0,442.1372549019608,41,10,14,37.457781241881,0.6077235772357723,45.43650793650793,1018.2539682539668,24.835462640340655,0
1352,4,0,0,48,0.0,0.0,1.0,48,950,600,350,0.631578947368421,13,6,7,331.2130795775476,0.41873522458628837,0.26035770056607466,0.18343833585684052,129150.96391565869,-1044.702302217203,128106.26161344149,1327,1,470.7291666666667,41,7,20,37.466246990695566,0.6031504065040652,45.8829365079365,1016.4682539682527,24.791908633372017,0
1353,4,0,0,48,0.0,0.0,1.0,48,1300,900,400,0.6923076923076923,17,9,8,326.32119061769123,0.4186151743498818,0.25581040874061145,0.1813072371285609,129277.04480229571,-1162.8321641156642,128114.21263818005,1328,2,471.7291666666667,41,7,20,37.46250365817969,0.6044207317073171,45.75892857142856,1016.9642857142841,24.804006968641076,0
1354,4,0,0,48,0.0,0.0,1.0,48,1200,700,500,0.5833333333333334,17,7,10,327.83608428752876,0.41855976654846333,0.2538822525597273,0.18261591767347082,129377.95380015398,-1117.04764660497,128260.906153549,1329,3,472.7291666666667,41,7,20,37.321530147895324,0.6054369918699187,45.65972222222221,1017.3611111111084,24.813685636856302,0
1355,4,2,1,49,0.04,0.02,0.98,50,1000,800,200,0.8,12,8,4,316.5787957456012,0.4225340136054421,0.2504404385801895,0.1783780628174952,129827.93578541082,-1779.8456869834831,128048.09009842735,1330,0,454.78,43,7,17,37.15193892089449,0.6070736434108528,45.217803030303024,1019.1287878787871,23.70066948555319,0
1356,4,0,0,49,0.0,0.0,1.0,49,1100,600,500,0.5454545454545454,16,6,10,322.37964664456155,0.4204931972789116,0.25378069082738697,0.1817143152951496,129842.52467549998,-1428.2825551349288,128414.24212036506,1331,1,465.0612244897959,42,7,18,36.9893674336059,0.6086309523809526,45.20348837209301,1019.1860465116256,24.266334440752992,0
1357,4,0,1,48,0.0,0.02040816326530612,0.9795918367346939,49,1450,900,550,0.6206896551724138,20,9,11,322.71357110844474,0.4207589285714286,0.2523318072476137,0.18213233734231946,129891.90853915014,-1416.4236674478843,128475.48487170225,1332,2,466.0612244897959,42,7,18,36.930846007604565,0.6091269841269842,45.155038759689916,1019.3798449612391,24.27094868955331,0
1358,4,1,1,48,0.02040816326530612,0.02040816326530612,0.9795918367346939,49,1250,900,350,0.72,16,9,7,322.1366135341045,0.4206703514739229,0.25293237071987584,0.18240858715890115,130021.0243414254,-1423.093506083588,128597.9308353418,1333,0,466.85714285714283,43,6,18,36.814840606623314,0.6090116279069768,45.02840909090908,1019.8863636363618,23.71828752642702,0
1359,4,1,0,49,0.02040816326530612,0.0,1.0,49,1100,700,400,0.6363636363636364,15,7,8,321.3002140090799,0.4210600907029478,0.2642758662485043,0.18261240011402105,130165.93491735513,-1435.5314508723832,128730.40346648275,1334,0,467.83673469387753,43,6,19,36.689557040336545,0.6104651162790699,44.886363636363626,1020.4545454545436,23.731501057082408,0
1360,4,1,0,50,0.02,0.0,1.0,50,1550,1000,550,0.6451612903225806,21,10,11,321.7656644961642,0.42249149659863944,0.27177055373297576,0.1850566506098866,130625.94112507437,-1593.667970433606,129032.27315464076,1335,0,459.46,40,10,18,36.212802796832044,0.61953125,44.4359756097561,1022.2560975609757,25.556402439024392,0
1361,4,1,0,51,0.0196078431372549,0.0,1.0,51,950,500,450,0.5263157894736842,14,5,9,318.06702804606624,0.4238398692810457,0.28365518932202116,0.18445742149248262,130947.07739866781,-1870.0104520975049,129077.06694657031,1336,0,451.4313725490196,41,10,19,35.98338906658912,0.6211890243902438,44.12202380952381,1023.5119047619048,24.9637049941928,0
1362,4,1,0,52,0.019230769230769232,0.0,1.0,52,1050,400,650,0.38095238095238093,17,4,13,310.79530325318746,0.4255200477626948,0.27828781772417077,0.18156627274028747,131228.8220734932,-2242.939689622017,128985.8823838712,1337,0,443.7307692307692,42,10,20,35.88578116133914,0.6225198412698414,43.8468992248062,1024.6124031007753,24.395533407161317,0
1363,4,0,1,51,0.0,0.019230769230769232,0.9807692307692307,52,1150,1000,150,0.8695652173913043,13,10,3,310.8212218612837,0.4254807692307692,0.2765271597742487,0.18182201421528715,131279.59728678834,-2239.1030331726356,129040.4942536157,1338,1,444.7307692307692,43,9,20,35.834026366044476,0.6216085271317829,43.797348484848484,1024.8106060606062,23.832804792107122,0
1364,4,0,0,51,0.0,0.0,1.0,51,1450,1100,350,0.7586206896551724,18,11,7,314.19979450627636,0.423562091503268,0.280492486411003,0.18343646754913628,131204.00221027882,-1955.1458934258708,129248.85631685295,1339,2,454.29411764705884,42,9,20,35.82356001134966,0.6222718253968254,43.87112403100775,1024.515503875969,24.393226282761166,0
1365,4,0,0,51,0.0,0.0,1.0,51,1050,700,350,0.6666666666666666,14,7,7,312.97508097032164,0.42339869281045756,0.28104575163398726,0.18331397599690288,131328.12500000015,-1979.3378365182243,129348.78716348192,1340,3,455.29411764705884,40,11,20,35.7300135501355,0.6265624999999999,43.75000000000001,1025.0000000000011,25.62500000000003,0
1366,4,0,0,51,0.0,0.0,1.0,51,1500,1100,400,0.7333333333333333,19,11,8,318.1146537046933,0.42258169934640527,0.28135593878887066,0.18721464722107742,131510.47992473107,-1832.9178440412034,129677.56208068987,1341,4,456.29411764705884,40,11,20,35.41480894349218,0.6283854166666665,43.572154471544735,1025.7113821138246,25.642784552845615,0
1367,4,1,1,51,0.019230769230769232,0.019230769230769232,0.9807692307692307,52,1800,1200,600,0.6666666666666666,24,12,12,311.7734005368278,0.42376036953242835,0.28124387641794946,0.1851252813607755,131850.08154745822,-2178.530342978167,129671.55120448006,1342,0,448.5,42,10,15,35.23622511557695,0.6287202380952379,43.24127906976745,1027.0348837209315,24.453211517165034,0
1368,4,1,1,51,0.019230769230769232,0.019230769230769232,0.9807692307692307,52,900,600,300,0.6666666666666666,12,6,6,313.81673577122024,0.4245930744092509,0.29014466152540264,0.18682756032466327,131949.61921045932,-2118.400242623618,129831.21896783571,1343,0,449.4807692307692,42,10,16,35.083820616806555,0.6297123015873015,43.14437984496125,1027.4224806201566,24.462440014765633,0
1369,4,0,0,51,0.0,0.0,1.0,51,1000,500,500,0.5,15,5,10,319.2264984176302,0.4229411764705882,0.2947311021743575,0.1899948056099413,131938.95266439908,-1776.3180272108839,130162.6346371882,1344,1,458.4313725490196,41,10,16,34.95558130552338,0.6310975609756098,43.154761904761905,1027.3809523809523,25.058072009291518,0
1370,4,1,1,51,0.019230769230769232,0.019230769230769232,0.9807692307692307,52,1150,800,350,0.6956521739130435,15,8,7,311.0845969586929,0.42515868526897943,0.2931926511937559,0.1865648706553488,132227.50521012698,-2173.2119669708272,130054.29324315615,1345,0,450.59615384615387,43,9,18,34.87526087223401,0.6310562015503876,42.87405303030304,1028.5037878787891,23.918692741367188,0
1371,4,0,1,50,0.0,0.0196078431372549,0.9803921568627451,51,1400,1100,300,0.7857142857142857,17,11,6,316.40553310146356,0.4232516339869281,0.29590707265501215,0.18951173105067845,132178.81159786825,-1835.578530331695,130343.23306753655,1346,1,460.27450980392155,43,8,18,34.787292414893955,0.6305717054263564,42.92140151515153,1028.3143939393967,23.91428823114876,0
1372,4,0,0,50,0.0,0.0,1.0,50,1000,700,300,0.7,13,7,6,322.88392304987815,0.42166666666666663,0.3021868225091904,0.19298453744429064,132098.99612590903,-1469.4715799831572,130629.52454592587,1347,2,470.04,42,8,19,34.70088289816823,0.6312003968253967,42.999031007751945,1028.0038759689935,24.476282761166512,0
1373,4,0,0,50,0.0,0.0,1.0,50,1250,1000,250,0.8,15,10,5,322.70698534285214,0.42137755102040814,0.3071503957783639,0.19325996210261576,132173.71627306074,-1469.3236959918042,130704.39257706894,1348,3,471.04,42,8,19,34.63041054152533,0.6319444444444444,42.9263565891473,1028.2945736434126,24.483204134366968,0
1374,4,0,0,50,0.0,0.0,1.0,50,800,500,300,0.625,11,5,6,324.0026287260869,0.42110544217687074,0.30323285606631467,0.1945481847599628,132273.37599903866,-1428.6156931674657,130844.7603058712,1349,4,472.04,42,8,19,34.4970641798543,0.6329365079365079,42.82945736434109,1028.6821705426366,24.49243263196754,0
1375,4,0,0,50,0.0,0.0,1.0,50,1450,1000,450,0.6896551724137931,19,10,9,320.9089200279469,0.4207908163265306,0.2967269303201505,0.19320026818009065,132373.0732828557,-1504.060002403693,130869.01328045201,1350,5,473.04,42,8,19,34.47661644695542,0.6339285714285714,42.73255813953489,1029.0697674418614,24.501661129568127,0
1376,4,0,1,49,0.0,0.02,0.98,50,700,400,300,0.5714285714285714,10,4,6,321.9240871638282,0.42071428571428576,0.29432520485734015,0.19420899814665968,132450.3036903464,-1472.206683252799,130978.0970070936,1351,6,474.04,40,10,19,34.37304603942475,0.6377604166666667,42.65752032520325,1029.369918699187,25.73424796747968,0
1377,4,0,0,49,0.0,0.0,1.0,49,1150,700,450,0.6086956521739131,16,7,9,328.16854865061254,0.41996173469387754,0.2984829138442231,0.1975677513147302,132372.47973552835,-1111.9030887818162,131260.57664674654,1352,7,483.18367346938777,41,8,19,34.290445547736105,0.6354166666666667,42.73313492063492,1029.0674603174596,25.09920634920633,0
1378,4,1,0,50,0.02,0.0,1.0,50,1400,1200,200,0.8571428571428571,16,12,4,328.12883165432686,0.42249149659863944,0.3167636327778325,0.19961334623914384,132764.3218838819,-1287.234714022708,131477.08716985918,1353,0,474.5,40,10,14,33.89848962955659,0.6408854166666667,42.35264227642276,1030.5894308943086,25.764735772357717,0
1379,4,0,0,50,0.0,0.0,1.0,50,950,400,550,0.42105263157894735,15,4,11,326.53442702124056,0.4222108843537415,0.3094569823593185,0.19947891818088676,132921.47040658674,-1319.3127643928815,131602.15764219387,1354,1,475.5,40,10,14,33.782152360303556,0.6424479166666668,42.20020325203252,1031.1991869918702,25.779979674796756,0
1380,4,1,0,51,0.0196078431372549,0.0,1.0,51,1350,900,450,0.6666666666666666,18,9,9,320.9746727964345,0.4235130718954248,0.30997163882371837,0.19750097400632188,133190.45970529426,-1649.8471552972885,131540.61254999696,1355,0,467.15686274509807,41,10,15,33.656395162582115,0.6435467479674796,41.939484126984134,1032.2420634920643,25.176635694928397,0
1381,4,0,2,49,0.0,0.0392156862745098,0.9607843137254902,51,1350,1200,150,0.8888888888888888,15,12,3,321.0509375930254,0.4229901960784314,0.30823881766881156,0.19839674653411496,133349.9333265181,-1637.5757755107827,131712.35755100733,1356,1,468.15686274509807,43,8,15,33.49502230983161,0.6421996124031008,41.78503787878788,1032.8598484848492,24.019996476391842,0
1382,4,0,0,49,0.0,0.0,1.0,49,1000,500,500,0.5,15,5,10,311.2291932025478,0.4174461451247165,0.24690512930584352,0.17949250847320725,130732.87080854527,-1656.9840201443744,129075.8867884009,1357,2,487.38775510204084,42,7,16,36.374241993556936,0.6175595238095237,44.33139534883721,1022.674418604652,24.34939091915838,8
1383,4,1,0,50,0.02,0.0,1.0,50,1250,1000,250,0.8,15,10,5,305.14442050716167,0.41978741496598637,0.24605976501063975,0.17704272899956594,130964.3857341168,-2007.3896816173003,128956.9960524995,1358,0,478.62,43,7,17,36.296623955345865,0.6184593023255813,44.10511363636364,1023.579545454546,23.804175475687114,0
1384,4,0,0,50,0.0,0.0,1.0,50,1500,1300,200,0.8666666666666667,17,13,4,303.4181572993379,0.41926020408163267,0.2399801067004248,0.17651243564299735,131067.25930212627,-2046.3627400548637,129020.89656207142,1359,1,479.62,44,6,18,36.237265274135694,0.6181344696969697,44.00462962962963,1023.981481481482,23.27230639730641,0
1385,4,0,0,50,0.0,0.0,1.0,50,1300,1000,300,0.7692307692307693,16,10,6,302.4878164721426,0.4191921768707483,0.2380309194467043,0.17618840115841886,131114.67013888908,-2067.881944444423,129046.78819444466,1360,2,480.62,44,6,18,36.21338486574453,0.6186079545454545,43.95833333333334,1024.1666666666683,23.276515151515188,0
1386,4,0,0,50,0.0,0.0,1.0,50,1300,900,400,0.6923076923076923,17,9,8,300.86971187999137,0.4190051020408163,0.23201988251242733,0.1756793330845437,131209.5175325788,-2104.606052812072,129104.91147976671,1361,3,481.62,44,6,18,36.15943666214794,0.6195549242424243,43.86574074074074,1024.5370370370365,23.284932659932647,0
1387,4,1,1,50,0.0196078431372549,0.0196078431372549,0.9803921568627451,51,1250,1100,150,0.88,14,11,3,294.3877726966512,0.42021241830065365,0.23472939438860618,0.17341504848411196,131546.6106824637,-2454.7500877266743,129091.86059473704,1362,0,473.15686274509807,43,8,19,35.98697267608234,0.6242732558139534,43.53693181818181,1025.8522727272716,23.857029598308642,0
1388,4,0,0,50,0.0,0.0,1.0,50,1300,800,500,0.6153846153846154,18,8,10,300.04742665103777,0.41879251700680276,0.2492633169625993,0.17688764773837343,131576.54663181293,-2104.1591550988574,129472.38747671408,1363,1,482.88,42,8,14,35.81176803928977,0.6259920634920635,43.507751937984494,1025.9689922480616,24.42783314876337,0
1389,4,0,0,50,0.0,0.0,1.0,50,1150,800,350,0.6956521739130435,15,8,7,300.3067658381188,0.41841836734693877,0.24614309986784955,0.17773463001614684,131725.71228441797,-2088.3754732287816,129637.33681118919,1364,2,483.88,42,8,15,35.65540242904789,0.6274801587301587,43.36240310077519,1026.5503875968989,24.44167589516426,0
1390,4,0,0,50,0.0,0.0,1.0,50,1200,700,500,0.5833333333333334,17,7,10,306.69494251101366,0.41822278911564625,0.23259141494435598,0.1769826778343374,130755.83316808785,-1956.5652762750092,128799.26789181284,1365,3,484.88,40,10,16,36.46702768945415,0.6208333333333333,44.3089430894309,1022.764227642277,25.569105691056926,3
1391,4,1,1,50,0.0196078431372549,0.0196078431372549,0.9803921568627451,51,1650,1200,450,0.7272727272727273,21,12,9,304.42686776252276,0.4194771241830066,0.23796117943399042,0.1771304469585545,131074.03175390515,-2219.5086136306527,128854.5231402745,1366,0,476.3529411764706,41,10,18,36.20462765613898,0.622459349593496,43.998015873015866,1024.0079365079355,24.97580332946184,0
1392,4,0,1,49,0.0,0.02,0.98,50,1400,1100,300,0.7857142857142857,17,11,6,306.74863544958333,0.41835034013605443,0.2403389830508471,0.1788356669123065,131150.23389274688,-1953.9689429012421,129196.26494984564,1367,1,485.28,41,9,18,36.068502824858754,0.6232215447154472,43.92361111111111,1024.3055555555552,24.983062330623298,0
1393,4,1,2,48,0.02,0.04,0.96,50,1100,700,400,0.6363636363636364,15,7,8,306.59130793519614,0.42,0.24195025063841902,0.17899447260070825,131204.00221027868,-1954.798671203665,129249.20353907501,1368,0,486.08,42,8,18,36.01843532267725,0.6222718253968255,43.871124031007746,1024.5155038759679,24.39322628276114,0
1394,4,0,0,48,0.0,0.0,1.0,48,1500,1000,500,0.6666666666666666,20,10,10,317.2256998250114,0.4155215721040189,0.24164639796154774,0.18417374491857838,130989.80150910484,-1289.333709266988,129700.46779983786,1369,3,506.0208333333333,40,8,18,35.961853469671425,0.6231770833333334,44.08028455284552,1023.6788617886164,25.59197154471541,0
1395,4,0,0,48,0.0,0.0,1.0,48,1050,1000,50,0.9523809523809523,11,10,1,320.137026088823,0.4156693262411348,0.24480200476379554,0.18624137845675423,131067.83743142316,-1208.066461762171,129859.770969661,1370,4,507.0208333333333,40,8,18,35.80868730977902,0.6239583333333333,44.00406504065041,1023.9837398373988,25.599593495934972,0
1396,4,0,0,48,0.0,0.0,1.0,48,950,800,150,0.8421052631578947,11,8,3,324.15987218760233,0.4150321365248227,0.2473247143133841,0.1891115728931742,131175.639526644,-1095.624291383216,130080.01523526078,1371,5,508.0208333333333,41,7,19,35.59703660662406,0.6234756097560975,43.898809523809526,1024.404761904762,24.98548199767712,0
1397,4,1,1,48,0.02040816326530612,0.02040816326530612,0.9795918367346939,49,800,300,500,0.375,13,3,10,319.00863556817086,0.41884566326530615,0.244251002575385,0.18710864071882857,131381.5158420141,-1417.36664717968,129964.14919483443,1372,0,498.6326530612245,39,10,19,35.52165887692203,0.6287393162393162,43.69791666666668,1025.208333333335,26.287393162393208,0
1398,4,0,0,48,0.0,0.0,1.0,48,1050,700,350,0.6666666666666666,14,7,7,330.132692150978,0.4154015218676123,0.250877101570099,0.1936401781100723,131382.88498064133,-925.2428957557247,130457.6420848856,1373,7,510.0208333333333,38,10,19,35.235167430873965,0.6304824561403508,43.69658119658119,1025.2136752136746,26.979307242465122,0
1399,4,0,0,48,0.0,0.0,1.0,48,1000,600,400,0.6,14,6,8,329.8406336838542,0.4144318853427896,0.25469086301465005,0.19430243954799797,131547.23340821094,-922.0754346555672,130625.15797355538,1374,8,511.0208333333333,38,10,19,35.0771106713879,0.6321271929824561,43.53632478632478,1025.8547008547005,26.99617633828159,0
1400,4,0,0,48,0.0,0.0,1.0,48,1000,600,400,0.6,14,6,8,331.3368282853069,0.4148105053191489,0.25493346865133093,0.19588633288227333,131684.26890432084,-873.6304012345806,130810.63850308626,1375,9,512.0208333333334,38,10,16,34.900766801984666,0.6334978070175439,43.40277777777777,1026.3888888888878,27.010233918128627,0
1401,4,2,1,49,0.04,0.02,0.98,50,1000,600,400,0.6,14,6,8,316.33042025203474,0.418469387755102,0.2521188730219992,0.18928686348106735,132142.87682665652,-1639.8376480221812,130503.03917863434,1376,0,492.5,41,9,17,34.825276598481906,0.633130081300813,42.9563492063492,1028.1746031746027,25.077429345722017,0
1402,4,2,1,50,0.0392156862745098,0.0196078431372549,0.9803921568627451,51,1650,1300,350,0.7878787878787878,20,13,7,309.41308098264074,0.4208986928104575,0.24814781754887094,0.1870671746491379,132532.04345703125,-1997.832278527732,130534.21117850352,1377,0,483.80392156862746,39,12,21,34.613155454392185,0.640224358974359,42.578125,1029.6875,26.40224358974359,0
1403,4,1,1,50,0.0196078431372549,0.0196078431372549,0.9803921568627451,51,1550,1000,550,0.6451612903225806,21,10,11,307.20130456260546,0.4211437908496732,0.24881223207515046,0.18623160424919635,132633.43578557717,-2050.967099610039,130582.46868596713,1378,0,484.5686274509804,40,11,14,34.56861681136541,0.6395833333333335,42.47967479674796,1030.0813008130067,25.752032520325166,0
1404,4,0,0,50,0.0,0.0,1.0,50,1250,900,350,0.72,16,9,7,315.30300248565277,0.41991496598639455,0.25210036422501014,0.19049235186847122,132505.23003472207,-1644.1406250000186,130861.08940972206,1379,2,495.26,39,11,21,34.488398758937,0.6399572649572651,42.60416666666666,1029.5833333333321,26.39957264957262,0
1405,4,0,0,50,0.0,0.0,1.0,50,1200,1000,200,0.8333333333333334,14,10,4,317.7776986624633,0.4193707482993197,0.2598463249418659,0.1929490004585897,132692.9809570313,-1566.6259765624977,131126.3549804688,1380,3,496.26,39,11,14,34.23661662117075,0.6418269230769231,42.421875,1030.3125000000005,26.418269230769244,0
1406,4,0,2,48,0.0,0.04,0.96,50,1750,1300,450,0.7428571428571429,22,13,9,320.07070902415927,0.41829081632653065,0.2641632170313428,0.19539334619489282,132895.2725312314,-1492.8231789939798,131402.44935223743,1381,4,497.26,40,10,16,33.975006570733974,0.6421875,42.22560975609756,1031.0975609756097,25.77743902439024,0
1407,4,0,1,47,0.0,0.020833333333333332,0.9791666666666666,48,1400,1200,200,0.8571428571428571,16,12,4,334.6242878657155,0.4134345449172577,0.27005524431995087,0.2024760521492548,132562.98539201173,-728.2410831689737,131834.74430884275,1382,6,518.8125,38,10,21,33.9331102811495,0.6422697368421053,42.54807692307692,1029.8076923076915,27.100202429149775,0
1408,4,0,0,47,0.0,0.0,1.0,47,1150,800,350,0.6956521739130435,15,8,7,338.77734949546016,0.4120027752081406,0.28148517205847456,0.20547535174369566,132652.03145438974,-412.09927573869345,132239.93217865104,1383,7,529.8723404255319,37,10,16,33.736805925137496,0.6449887387387387,42.46162280701754,1030.1535087719292,27.841986723565654,0
1409,4,0,0,47,0.0,0.0,1.0,47,1050,800,250,0.7619047619047619,13,8,5,342.86601397800416,0.4118485969781067,0.29948213282305947,0.19629229416709235,130448.7426757815,-441.21918072144103,130007.52349506006,1384,8,530.8723404255319,39,8,17,35.85289843988989,0.6193910256410255,44.609375000000014,1021.5625000000019,26.193910256410305,6
1410,4,0,0,47,0.0,0.0,1.0,47,1350,800,550,0.5925925925925926,19,8,11,345.43806492291463,0.41165587419056426,0.30820811204097787,0.19830853452069752,130555.17713758703,-380.25444878470216,130174.92268880233,1385,9,531.8723404255319,39,8,13,35.679445690211665,0.6204594017094017,44.50520833333334,1021.9791666666684,26.204594017094063,0
1411,4,0,0,47,0.0,0.0,1.0,47,1350,1000,350,0.7407407407407407,17,10,7,344.02759873422406,0.41152096823928463,0.3058465690722607,0.19786012668196473,130625.94112507453,-412.21422846848657,130213.72689660605,1386,10,532.8723404255319,40,7,13,35.64386784637307,0.6195312499999999,44.435975609756106,1022.256097560977,25.556402439024424,0
1412,4,0,0,47,0.0,0.0,1.0,47,1200,1000,200,0.8333333333333334,14,10,4,348.89971575180886,0.4120220474868948,0.31064717809713716,0.20120216845905178,130729.84959556155,-277.67852716636526,130452.17106839518,1387,11,533.8723404255319,40,7,13,35.41418231806288,0.6205729166666667,44.334349593495936,1022.6626016260167,25.566565040650417,0
1413,4,0,0,47,0.0,0.0,1.0,47,850,400,450,0.47058823529411764,13,4,9,351.3832350437047,0.4113282454517422,0.3144184552168454,0.20304383719574814,130807.80805902582,-207.2658470486997,130600.54221197712,1388,12,534.8723404255319,40,7,13,35.27178952248496,0.6213541666666667,44.25813008130082,1022.9674796747976,25.57418699186994,0
1414,4,1,2,46,0.020833333333333332,0.041666666666666664,0.9583333333333334,48,1300,900,400,0.6923076923076923,17,9,8,349.0204494226208,0.4130743942080379,0.32107308921825073,0.20321139872474417,131099.43000637752,-448.7236040249424,130650.70640235257,1389,0,524.7083333333334,41,7,14,35.037355904291395,0.6227134146341464,43.973214285714285,1024.1071428571424,24.97822299651567,0
1415,4,0,0,46,0.0,0.0,1.0,46,1550,1100,450,0.7096774193548387,20,11,9,361.946108503404,0.4080213365539453,0.32416678096283125,0.21009122316969572,130981.34901258675,281.6379123263848,131262.98692491313,1390,1,546.5652173913044,39,7,14,34.825926020148565,0.6247329059829061,44.088541666666664,1023.6458333333329,26.24732905982905,0
1416,4,1,0,47,0.02127659574468085,0.0,1.0,47,1250,1000,250,0.8,15,10,5,357.60167698256197,0.40785923527597906,0.32265388762631897,0.20902595414580724,131250.0116188281,-12.955148225258199,131237.05647060284,1391,0,535.9148936170212,40,7,16,34.665402162054946,0.62578125,43.826219512195124,1024.6951219512198,25.617378048780495,0
1417,4,0,0,47,0.0,0.0,1.0,47,1300,900,400,0.6923076923076923,17,9,8,357.5791713652008,0.40818686401480114,0.3267295196840363,0.2100553021738289,131440.53939673738,0.14954522454505081,131440.68894196194,1392,1,536.9148936170212,37,10,17,34.473463786712294,0.632882882882883,43.64035087719298,1025.4385964912276,27.71455666192507,0
1418,4,0,0,47,0.0,0.0,1.0,47,1350,1000,350,0.7407407407407407,17,10,7,356.9674107970212,0.40739670058587724,0.32849026878212606,0.21077968439427908,131637.38031173058,-1.9490372037452914,131635.43127452684,1393,2,537.9148936170212,37,10,14,34.29041119065428,0.6348536036036035,43.448464912280706,1026.2061403508776,27.73530109056426,0
1419,4,0,1,46,0.0,0.02127659574468085,0.9787234042553191,47,600,300,300,0.5,9,3,6,359.5288144908646,0.4072039777983349,0.33070415237887474,0.21292019545085192,131749.92696069958,73.57900988767418,131823.50597058726,1394,3,538.9148936170212,37,10,14,34.11110666097049,0.6359797297297296,43.33881578947369,1026.6447368421063,27.74715504978666,0
1420,4,0,0,46,0.0,0.0,1.0,46,1050,600,450,0.5714285714285714,15,6,9,354.0866138391303,0.4037842190016103,0.28026449643947005,0.20595688840465443,131061.33355034761,83.00279292670834,131144.3363432743,1395,4,548.8478260869565,39,7,18,34.94616819260768,0.6255341880341878,44.010416666666686,1023.9583333333364,26.25534188034196,6
1421,4,0,0,46,0.0,0.0,1.0,46,1050,700,350,0.6666666666666666,14,7,7,352.8787347288553,0.40351247987117556,0.27992943735575637,0.20582499865501627,131168.01757812547,57.28081597226756,131225.29839409774,1396,5,549.8478260869565,39,7,18,34.8692461528032,0.6266025641025639,43.90625000000002,1024.3750000000036,26.266025641025735,0
1422,4,0,0,46,0.0,0.0,1.0,46,1750,1300,450,0.7428571428571429,22,13,9,347.6414203430948,0.40289855072463765,0.2734608623158199,0.2039099675802163,131382.88498064148,-65.07579506126618,131317.8091855802,1397,6,550.8478260869565,38,8,19,34.78641274142002,0.6304824561403508,43.6965811965812,1025.2136752136757,26.97930724246515,0
1423,4,0,0,46,0.0,0.0,1.0,46,950,600,350,0.631578947368421,13,6,7,348.60163103877125,0.4030495169082126,0.27551408728271043,0.20461956287945499,131410.26925131504,-38.03316074949112,131372.23609056554,1398,7,551.8478260869565,38,8,19,34.7341617172033,0.6307565789473684,43.6698717948718,1025.3205128205138,26.982118758434574,0
1424,4,0,0,46,0.0,0.0,1.0,46,1400,1000,400,0.7142857142857143,18,10,8,347.40147075043535,0.4025865539452496,0.269770359065858,0.20450039979613302,131519.83486969463,-61.963186682739035,131457.8716830119,1399,8,552.8478260869565,38,8,20,34.654376280248584,0.6318530701754386,43.56303418803419,1025.747863247863,26.993364822312184,0
1425,4,0,0,46,0.0,0.0,1.0,46,1000,600,400,0.6,14,6,8,345.83910891542354,0.4023248792270531,0.26178149085132674,0.2044600811907984,131684.26890432098,-91.6859567901223,131592.58294753087,1400,9,553.8478260869565,38,8,17,34.528642309427156,0.6334978070175439,43.40277777777778,1026.388888888889,27.010233918128655,0
1426,4,0,0,46,0.0,0.0,1.0,46,1350,600,750,0.4444444444444444,21,6,15,346.0952160264898,0.4025966183574879,0.2614079536714471,0.20505394734985,131766.52444480974,-79.24725144275959,131687.277193367,1401,10,554.8478260869565,38,8,18,34.43916926812347,0.6343201754385964,43.322649572649574,1026.709401709402,27.018668466036896,0
1427,4,0,0,46,0.0,0.0,1.0,46,1050,800,250,0.7619047619047619,13,8,5,345.7663869896415,0.40250603864734297,0.2570888468809074,0.20545105343129866,131876.23844875445,-80.32590035794999,131795.9125483965,1402,11,555.8478260869565,38,8,18,34.337077872547,0.6354166666666666,43.215811965811966,1027.136752136752,27.029914529914524,0
1428,4,0,0,46,0.0,0.0,1.0,46,1550,1200,350,0.7741935483870968,19,12,7,347.0518684101506,0.40225442834138486,0.2595836139524579,0.20696168147782007,132013.445158978,-36.89744046315215,131976.54771851483,1403,12,556.8478260869565,38,8,18,34.16588695983642,0.6367872807017544,43.082264957264954,1027.67094017094,27.04397210976158,0
1429,4,0,1,45,0.0,0.021739130434782608,0.9782608695652174,46,1100,800,300,0.7272727272727273,14,8,6,350.85687694588484,0.4022141706924316,0.26139152126462584,0.20953407902522356,132068.34781804713,67.41761176855829,132135.76542981568,1404,13,557.8478260869565,38,8,18,34.01283650348197,0.6373355263157896,43.028846153846146,1027.8846153846137,27.049595141700358,0
1430,4,1,0,46,0.021739130434782608,0.0,1.0,46,900,400,500,0.4444444444444444,14,4,10,354.1966815732198,0.40361312399355875,0.27026697494626295,0.21260633729345094,132260.59701219926,169.25291292275344,132429.84992512202,1405,0,558.5434782608696,38,8,20,33.73342507962887,0.6392543859649125,42.84188034188033,1028.632478632476,27.06927575348621,0
1431,4,0,0,46,0.0,0.0,1.0,46,950,600,350,0.631578947368421,13,6,7,355.76327203217613,0.40319041867954913,0.2704516844634981,0.2140212911774563,132344.40646701373,216.655815972203,132561.06228298592,1406,1,559.5434782608696,39,7,20,33.60877708038065,0.638354700854701,42.76041666666666,1028.958333333332,26.383547008546973,0
1432,4,1,1,46,0.02127659574468085,0.02127659574468085,0.9787234042553191,47,1600,1100,500,0.6875,21,11,10,346.61317434040507,0.4059127351218008,0.2702418878014776,0.21049983963091082,132700.54879830507,-200.8266074722527,132499.7221908328,1407,0,548.6170212765958,38,9,15,33.486278169500906,0.6436403508771931,42.41452991452991,1030.3418803418792,27.114260008996823,0
1433,4,0,0,46,0.0,0.0,1.0,46,1150,700,450,0.6086956521739131,16,7,9,356.613078289703,0.4022745571658615,0.2753993373683532,0.2164558451944473,132680.27181440426,263.10403200983285,132943.3758464141,1408,3,561.5434782608696,37,9,15,33.24907762168297,0.6452702702702704,42.43421052631578,1030.2631578947355,27.84495021337123,0
1434,4,0,0,46,0.0,0.0,1.0,46,1250,800,450,0.64,17,8,9,357.9019429770051,0.4021940418679549,0.2806748891993671,0.21756548901021291,132736.76155163112,301.34897276083615,133038.11052439196,1409,4,562.5434782608696,37,9,15,33.159094133503594,0.6458333333333334,42.379385964912274,1030.4824561403498,27.850877192982427,0
1435,4,0,0,46,0.0,0.0,1.0,46,1600,1200,400,0.75,20,12,8,357.52538956601455,0.40196256038647343,0.27690589019621936,0.21840728228425135,132920.79863393964,304.5120626050067,133225.31069654465,1410,5,563.5434782608696,38,8,17,32.98388071556843,0.6458333333333334,42.2008547008547,1031.196581196581,27.136752136752133,0
1436,4,0,1,45,0.0,0.021739130434782608,0.9782608695652174,46,1300,1200,100,0.9230769230769231,14,12,2,357.0522751499984,0.40174114331723026,0.27773225027916837,0.2187624853330194,133030.99203740235,299.80367448316883,133330.79571188553,1411,6,564.5434782608696,38,8,17,32.885425296879305,0.6469298245614035,42.0940170940171,1031.623931623932,27.147998200629793,0
1437,4,1,0,46,0.021739130434782608,0.0,1.0,46,1200,700,500,0.5833333333333334,17,7,10,356.0372358250806,0.40316022544283414,0.28173093803031146,0.21862451753556614,133113.6670524692,278.68441358025586,133392.35146604944,1412,0,565.3913043478261,38,8,19,32.82862270076267,0.6477521929824561,42.01388888888889,1031.944444444445,27.156432748538027,0
1438,4,0,0,46,0.0,0.0,1.0,46,1450,1000,450,0.6896551724137931,19,10,9,354.09502882145136,0.40392512077294684,0.2751941385513097,0.21795538730562655,133203.2606336807,233.32248263891017,133436.5831163196,1413,1,566.3913043478261,39,7,19,32.78884964682139,0.6469017094017093,41.92708333333334,1032.291666666668,26.46901709401713,0
1439,4,0,0,46,0.0,0.0,1.0,46,1200,800,400,0.6666666666666666,16,8,8,355.7693195982115,0.4030092592592593,0.2810035873731478,0.21961998969468702,133310.8127170141,285.5794270833569,133596.39214409745,1414,2,567.3913043478261,39,7,19,32.6377681393316,0.6479700854700854,41.82291666666668,1032.708333333335,26.479700854700898,0
1440,4,0,1,45,0.0,0.021739130434782608,0.9782608695652174,46,1300,1100,200,0.8461538461538461,15,11,4,346.83638243537985,0.40330112721417066,0.2796210729462416,0.20677802647483323,132003.3327562326,-31.808284760704282,131971.52447147187,1415,3,568.3913043478261,37,9,19,34.18160478019633,0.6385135135135136,43.09210526315789,1027.6315789473676,27.773826458036964,5
1441,4,0,0,45,0.0,0.0,1.0,45,950,500,450,0.5263157894736842,14,5,9,351.8613164336832,0.40225168350168355,0.289244327587886,0.21019568693760873,132079.47812677556,294.7318095122302,132374.20993628778,1416,4,578.6888888888889,36,9,19,33.9758161700263,0.6412037037037036,43.018018018018026,1027.927927927929,28.553553553553584,0
1442,4,0,0,45,0.0,0.0,1.0,45,1000,900,100,0.9,11,9,2,353.544573351104,0.401746632996633,0.2835091305035462,0.21201067553615474,132224.21481870403,349.4307229527015,132573.64554165673,1417,5,579.6888888888889,36,9,19,33.78681703711815,0.6426504629629628,42.87725225225226,1028.4909909909925,28.569194194194235,0
1443,4,0,0,45,0.0,0.0,1.0,45,1450,900,550,0.6206896551724138,20,9,11,355.3342207099068,0.40128367003367,0.28755336617405547,0.21341078936127575,132282.13168827636,400.87363545980713,132683.00532373617,1418,6,580.6888888888889,36,9,19,33.6824940704251,0.6432291666666665,42.82094594594596,1028.716216216218,28.575450450450504,0
1444,4,1,1,45,0.021739130434782608,0.021739130434782608,0.9782608695652174,46,1100,800,300,0.7272727272727273,14,8,6,344.6270924018865,0.40344202898550724,0.25809931297744426,0.20462632731682123,131848.8056674155,-82.31829360878444,131766.4873738067,1419,0,569.0434782608696,38,8,18,34.393963036166305,0.6351425438596492,43.24252136752137,1027.029914529915,27.027103013945133,3
1445,4,1,1,45,0.021739130434782608,0.021739130434782608,0.9782608695652174,46,1250,700,550,0.56,18,7,11,345.05675164243723,0.4022946859903382,0.255936663531795,0.2053258492446585,131931.11257213837,-95.25577105703144,131835.85680108133,1420,0,570.0217391304348,38,8,18,34.30003813089298,0.6359649122807016,43.16239316239317,1027.3504273504286,27.035537561853385,0
1446,4,0,0,45,0.0,0.0,1.0,45,1200,1000,200,0.8333333333333334,14,10,4,356.76533155003324,0.4010942760942761,0.26791915741531414,0.21206710824623867,131890.67790089297,410.8042859341766,132301.48218682714,1421,9,583.6888888888889,37,8,18,34.04008326216908,0.6373873873873872,43.20175438596493,1027.1929824561435,27.76197249881469,0
1447,4,0,0,45,0.0,0.0,1.0,45,1100,900,200,0.8181818181818182,13,9,4,356.51567136386,0.4007154882154882,0.270343093654013,0.2120758936513022,131918.837106129,406.2265552862707,132325.06366141528,1422,10,584.6888888888889,37,8,18,34.018104920482465,0.6376689189189187,43.17434210526317,1027.302631578949,27.764935988620245,0
1448,4,0,0,45,0.0,0.0,1.0,45,950,800,150,0.8421052631578947,11,8,3,353.82105646634864,0.40065235690235695,0.26479861555602957,0.21125596072073605,132059.67821829816,345.0989727608745,132404.77719105902,1423,11,585.6888888888889,37,8,18,33.94539862029726,0.6390765765765765,43.0372807017544,1027.8508771929842,27.77975343764822,0
1449,4,0,0,45,0.0,0.0,1.0,45,1050,800,250,0.7619047619047619,13,8,5,352.8797656350102,0.4005471380471381,0.26405953735305276,0.21100769659399612,132116.03570329354,324.2151431209896,132440.25084641454,1424,12,586.6888888888889,37,8,18,33.91282707622298,0.6396396396396395,42.98245614035089,1028.0701754385984,27.785680417259417,0
1450,4,0,0,45,0.0,0.0,1.0,45,550,100,450,0.18181818181818182,10,1,9,352.888778061,0.40052609427609426,0.26486082968966596,0.2111702662334399,132144.21895439006,326.44239092800916,132470.66134531808,1425,13,587.6888888888889,37,8,19,33.88421581173796,0.639921171171171,42.95504385964914,1028.1798245614057,27.78864390706502,0
1451,4,1,2,44,0.021739130434782608,0.043478260869565216,0.9565217391304348,46,1150,800,350,0.6956521739130435,15,8,7,347.6536248750182,0.4041062801932367,0.26324590741066656,0.209440110595438,132398.00347222242,5.729166666686211,132403.7326388891,1426,0,575.8913043478261,38,8,19,33.763495276653174,0.6406249999999998,42.70833333333334,1029.1666666666683,27.08333333333338,0
1452,4,0,0,44,0.0,0.0,1.0,44,1300,1000,300,0.7692307692307693,16,10,6,359.7754196017049,0.4006893058491896,0.26252974279563346,0.21595497131703376,132260.5970121998,716.8223573672568,132977.41936956707,1427,15,600.4090909090909,38,6,19,33.58996330148179,0.6392543859649121,42.841880341880355,1028.6324786324806,27.06927575348633,0
1453,4,0,0,44,0.0,0.0,1.0,44,1350,800,550,0.5925925925925926,19,8,11,360.76644429510367,0.4006893058491896,0.2654582259845417,0.21733978473387985,132398.0034722224,752.9513888889081,133150.9548611113,1428,16,601.4090909090909,39,5,20,33.426113360323896,0.6388888888888888,42.70833333333334,1029.166666666668,26.388888888888925,0
1454,4,0,0,44,0.0,0.0,1.0,44,900,600,300,0.6666666666666666,12,6,6,359.1139846347491,0.40087649753347426,0.26479072183918007,0.21652536661502172,132429.53619100805,711.4596849769067,133140.99587598495,1429,17,602.4090909090909,33,11,20,33.436892288764525,0.651199494949495,42.67769607843136,1029.2892156862729,31.19058229352342,0
1455,4,0,0,44,0.0,0.0,1.0,44,1050,700,350,0.6666666666666666,14,7,7,359.97999602015074,0.4005571705426357,0.26963812886143,0.218105527000444,132612.49999999977,747.5694444444165,133360.06944444418,1430,18,603.4090909090909,34,10,21,33.230515102481114,0.6507352941176472,42.499999999999986,1029.9999999999982,30.29411764705877,0
1456,4,0,0,44,0.0,0.0,1.0,44,1300,900,400,0.6923076923076923,17,9,8,357.6411893591818,0.40059020436927417,0.26749818658770486,0.21712403725594914,132687.90486009658,690.9320215485757,133378.83688164514,1431,19,604.4090909090909,36,8,18,33.214923306736615,0.6472800925925927,42.4268018018018,1030.2927927927926,28.61924424424424,0
1457,4,0,1,43,0.0,0.022727272727272728,0.9772727272727273,44,1350,800,550,0.5925925925925926,19,8,11,356.2127659574468,0.4000506518675124,0.26513539651837537,0.2168652849740932,132793.26331178815,660.5311249615165,133453.79443674965,1432,20,605.4090909090909,37,7,18,33.145833333333336,0.6463963963963963,42.32456140350877,1030.7017543859643,27.856804172593627,0
1458,4,0,0,43,0.0,0.0,1.0,43,1000,600,400,0.6,14,6,8,339.7957205199596,0.39966315983757844,0.19966181347036493,0.19039347514848504,129609.02829141995,267.0911031341291,129876.11939455407,1433,21,607.8139534883721,38,5,15,36.78260413387893,0.6126644736842106,45.4326923076923,1018.2692307692294,26.796558704453403,7
1459,4,2,1,44,0.044444444444444446,0.022222222222222223,0.9777777777777777,45,1050,800,250,0.7619047619047619,13,8,5,326.8501450702316,0.40635521885521886,0.20082599789625255,0.18499386383416638,130003.35784131454,-501.67672598983387,129501.68111532471,1434,0,581.7555555555556,40,5,17,36.71254774954326,0.61328125,45.04573170731707,1019.8170731707305,25.49542682926826,0
1460,4,1,0,45,0.022222222222222223,0.0,1.0,45,1250,1000,250,0.8,15,10,5,326.5249068799003,0.40625,0.197408403324149,0.1855481941132471,130158.86423631763,-499.97779512856465,129658.88644118907,1435,0,582.7333333333333,40,5,19,36.56342329781231,0.6148437500000001,44.89329268292683,1020.4268292682923,25.510670731707307,0
1461,4,1,0,46,0.021739130434782608,0.0,1.0,46,1700,1400,300,0.8235294117647058,20,14,6,318.5607047923528,0.40859500805152976,0.19887902414375436,0.1826278172593913,130501.95448133661,-885.3584579517386,129616.59602338487,1436,0,571.0434782608696,39,7,15,36.419890746593246,0.6199252136752138,44.55729166666666,1021.7708333333318,26.199252136752097,0
1462,4,0,2,44,0.0,0.043478260869565216,0.9565217391304348,46,950,500,450,0.5263157894736842,14,5,9,319.3695984076464,0.4084138486312399,0.19881745207768864,0.1833971907912807,130566.58340419516,-857.5936592084574,129708.9897449867,1437,1,572.0434782608696,41,5,14,36.33396427878083,0.6173780487804876,44.49404761904763,1022.0238095238107,24.927409988385627,5
1463,4,2,1,45,0.043478260869565216,0.021739130434782608,0.9782608695652174,46,1100,900,200,0.8181818181818182,13,9,4,317.92857267527756,0.40706521739130436,0.22509022835362757,0.18377126913831085,130820.18455530377,-881.705089443165,129938.47946586061,1438,0,572.8913043478261,41,5,15,36.114882337729505,0.6199186991869918,44.246031746031754,1023.0158730158744,24.951606658923765,0
1464,4,1,0,46,0.021739130434782608,0.0,1.0,46,900,600,300,0.6666666666666666,12,6,6,321.0501034056694,0.4077999194847021,0.22732214875406154,0.18618740398180383,130947.07739866781,-791.885452097504,130155.19194657031,1439,0,573.8695652173913,41,5,16,35.90705873800523,0.6211890243902438,44.12202380952381,1023.5119047619048,24.9637049941928,0
1465,4,1,1,46,0.02127659574468085,0.02127659574468085,0.9787234042553191,47,1050,800,250,0.7619047619047619,13,8,5,314.9898339564857,0.4113282454517422,0.23065238167094249,0.18413584820839335,131253.6442840724,-1131.2872761552828,130122.3570079171,1440,0,562.6382978723404,42,5,17,35.753349093774645,0.6227678571428572,43.82267441860465,1024.709302325581,24.39784053156145,0
1466,4,2,1,47,0.041666666666666664,0.020833333333333332,0.9791666666666666,48,1150,900,250,0.782608695652174,14,9,5,309.53839712817023,0.41449652777777773,0.23661534371072213,0.18263295159707146,131607.91175555854,-1452.4173365908005,130155.49441896773,1441,0,551.7916666666666,41,7,16,35.536816365335646,0.6277947154471545,43.47718253968253,1026.0912698412685,25.026616337591914,0
1467,4,0,0,47,0.0,0.0,1.0,47,850,500,350,0.5882352941176471,12,5,7,314.85510345804727,0.41059589885908104,0.2417319747564386,0.18542283630720702,131536.54095611075,-1117.0097577500137,130419.53119836074,1442,1,564.531914893617,40,7,19,35.47218644739449,0.6286458333333333,43.546747967479675,1025.8130081300812,25.645325203252032,0
1468,4,0,0,47,0.0,0.0,1.0,47,1350,1000,350,0.7407407407407407,17,10,7,315.24170655840203,0.4102104532839963,0.23794972519135404,0.18590422134425408,131588.67076475653,-1103.552572873281,130485.11819188326,1443,2,565.531914893617,40,7,16,35.40985703909138,0.6291666666666667,43.4959349593496,1026.0162601626025,25.650406504065064,0
1469,4,0,0,47,0.0,0.0,1.0,47,800,400,400,0.5,12,4,8,316.90383295755294,0.41028754239901327,0.24058141984411163,0.18739629466459537,131692.96136558952,-1053.1991539427352,130639.76221164678,1444,3,566.531914893617,40,7,16,35.26237623762376,0.6302083333333333,43.39430894308944,1026.4227642276442,25.660569105691103,0
1470,4,1,1,47,0.020833333333333332,0.020833333333333332,0.9791666666666666,48,850,600,250,0.7058823529411765,11,6,5,319.4020334000424,0.4107842050827423,0.2019968010561588,0.18799472940168685,131515.0404188369,-1183.0622418683638,130331.97817696854,1445,0,555.7083333333334,39,9,18,35.3772087945567,0.6300747863247864,43.567708333333336,1025.7291666666674,26.30074786324788,3
1471,4,0,0,47,0.0,0.0,1.0,47,1150,800,350,0.6956521739130435,15,8,7,323.6565302892644,0.4070112550107925,0.2152200352989717,0.19076559945056645,131568.46923828128,-883.4011501736107,130685.06808810767,1446,1,568.4042553191489,39,8,16,35.21434071140892,0.6306089743589745,43.515625,1025.9375000000002,26.306089743589748,0
1472,4,1,1,47,0.020833333333333332,0.020833333333333332,0.9791666666666666,48,950,600,350,0.631578947368421,13,6,7,317.0639997003258,0.4092881944444444,0.21464415305954088,0.18813456940527287,131823.3827107709,-1240.7102047392295,130582.67250603168,1447,0,557.5416666666666,40,8,17,35.127206003628544,0.6315104166666666,43.26727642276423,1026.9308943089445,25.67327235772361,0
1473,4,0,0,47,0.0,0.0,1.0,47,1700,1400,300,0.8235294117647058,20,14,6,323.50519499966504,0.4072039777983349,0.21528711640285914,0.1917492908666085,131782.29302300353,-873.5487196180446,130908.74430338548,1448,3,570.4042553191489,39,8,17,35.00314920022996,0.6327457264957265,43.30729166666667,1026.770833333334,26.327457264957282,0
1474,4,0,1,46,0.0,0.02127659574468085,0.9787234042553191,47,500,200,300,0.4,8,2,6,326.4773769898251,0.4068763490595128,0.21863536316947907,0.1939196950072095,131862.5217013891,-789.9739583333068,131072.5477430558,1449,4,571.4042553191489,39,8,17,34.84617985125085,0.6335470085470085,43.22916666666668,1027.083333333335,26.33547008547013,0
1475,4,0,0,46,0.0,0.0,1.0,46,1450,1000,450,0.6896551724137931,19,10,9,334.85835275926706,0.40504227053140096,0.22145608767995406,0.19925729703794015,131931.11257213826,-364.35299327926873,131566.759578859,1450,5,584.5869565217391,38,8,17,34.561971367165846,0.6359649122807017,43.162393162393165,1027.3504273504277,27.03553756185336,0
1476,4,0,0,46,0.0,0.0,1.0,46,650,300,350,0.46153846153846156,10,3,7,334.6573472859429,0.40527375201288246,0.22045426803079704,0.19928171571819897,131958.55391418294,-367.82007907808963,131590.73383510485,1451,6,585.5869565217391,38,8,17,34.539530692177046,0.6362390350877192,43.13568376068376,1027.4572649572651,27.038349077822765,0
1477,4,0,0,46,0.0,0.0,1.0,46,1350,900,450,0.6666666666666666,18,9,9,332.28598880269794,0.40421698872785833,0.21867672108038239,0.19873139031997283,132123.26189139095,-419.45825571626307,131703.8036356747,1452,7,586.5869565217391,38,8,17,34.43486092348194,0.6378837719298245,42.97542735042735,1028.098290598291,27.055218173639236,0
1478,4,0,0,46,0.0,0.0,1.0,46,1250,900,350,0.72,16,9,7,330.02004260695725,0.404176731078905,0.2133746740892113,0.19769161775581828,132183.68055555577,-475.3472222221975,131708.33333333358,1453,8,587.5869565217391,39,7,17,34.43240140464615,0.6367521367521367,42.91666666666668,1028.333333333335,26.367521367521412,0
1479,4,0,0,46,0.0,0.0,1.0,46,1300,900,400,0.6923076923076923,17,9,8,329.19905905294235,0.40321054750402574,0.21148005669163794,0.1980407006897056,132344.40646701396,-486.469184027767,131857.93728298618,1454,9,588.5869565217391,39,7,19,34.292113788216234,0.6383547008547008,42.76041666666667,1028.958333333334,26.383547008547023,0
1480,4,0,0,46,0.0,0.0,1.0,46,1450,1100,350,0.7586206896551724,18,11,7,329.7006813844253,0.40281803542673106,0.21557372873899538,0.19907136318446125,132482.65241468546,-464.05414406354714,132018.5982706219,1455,10,589.5869565217391,37,9,19,34.140461355486906,0.6432995495495495,42.626096491228076,1029.495614035089,27.824205784732133,0
1481,4,0,0,46,0.0,0.0,1.0,46,1050,700,350,0.6666666666666666,14,7,7,329.7006813844253,0.40281803542673106,0.21557372873899538,0.19907136318446125,132482.65241468546,-464.07584545243583,132018.57656923303,1456,11,590.5869565217391,37,9,19,34.140461355486906,0.6432995495495495,42.626096491228076,1029.495614035089,27.824205784732133,0
1482,4,0,0,46,0.0,0.0,1.0,46,1300,1100,200,0.8461538461538461,15,11,4,326.9517975998875,0.4026268115942029,0.2109827392276391,0.1980050441557539,132595.5597515581,-529.5286770929613,132066.03107446514,1457,12,591.5869565217391,37,9,21,34.09797632989104,0.6444256756756757,42.51644736842105,1029.9342105263152,27.836059743954465,0
1483,4,0,0,46,0.0,0.0,1.0,46,1100,900,200,0.8181818181818182,13,9,4,328.6343754576011,0.4022846215780998,0.20684221486914867,0.19932343172525246,132652.03145438977,-481.19649796091596,132170.83495642885,1458,13,592.5869565217391,37,9,14,33.998026432499564,0.6449887387387387,42.46162280701754,1030.1535087719294,27.84198672356566,0
1484,4,0,0,46,0.0,0.0,1.0,46,950,600,350,0.631578947368421,13,6,7,328.39052317260104,0.4018921095008052,0.20930505097855323,0.199726039503336,132755.59413580247,-480.86419753087074,132274.7299382716,1459,14,593.5869565217391,38,8,15,33.900494159928115,0.6441885964912281,42.36111111111111,1030.5555555555554,27.11988304093567,0
1485,4,0,0,46,0.0,0.0,1.0,46,1400,1000,400,0.7142857142857143,18,10,8,332.70902414380976,0.4009259259259259,0.21208039784500565,0.20324731019215536,132920.79863393976,-355.21015961719934,132565.58847432258,1460,15,594.5869565217391,38,8,16,33.623644495095995,0.6458333333333333,42.200854700854705,1031.1965811965822,27.136752136752165,0
1486,4,0,1,45,0.0,0.021739130434782608,0.9782608695652174,46,1250,900,350,0.72,16,9,7,330.77479179770353,0.40029186795491145,0.2108239095315021,0.20272237239879087,133042.01388888908,-398.61111111109085,132643.40277777798,1461,16,595.5869565217391,39,7,17,33.5521001615509,0.6452991452991452,42.08333333333334,1031.6666666666683,26.452991452991494,0
1487,4,0,0,45,0.0,0.0,1.0,45,1000,700,300,0.7,13,7,6,337.0975759507558,0.4000841750841751,0.21792188956800995,0.20607998104196643,132948.34270445263,-36.687189531719724,132911.65551492092,1462,21,609.4666666666667,38,7,17,33.482898235436316,0.6461074561403508,42.17414529914531,1031.30341880342,27.13956365272158,0
1488,4,0,0,45,0.0,0.0,1.0,45,1100,1000,100,0.9090909090909091,12,10,2,337.209212607538,0.4000841750841751,0.21769496204278793,0.20721634820539578,133141.23109796207,-20.710059171578223,133120.5210387905,1463,22,610.4666666666667,38,7,19,33.28674948240164,0.6480263157894736,41.987179487179496,1032.0512820512836,27.159244264507464,0
1489,4,0,0,45,0.0,0.0,1.0,45,1200,800,400,0.6666666666666666,16,8,8,334.84811250393284,0.39957912457912453,0.2228409383861818,0.20655565272255694,133283.9206271703,-74.02615017359167,133209.8944769967,1464,23,611.4666666666667,39,6,20,33.20481942903258,0.6477029914529913,41.84895833333334,1032.604166666668,26.47702991452995,0
1490,4,0,0,45,0.0,0.0,1.0,45,800,500,300,0.625,11,5,6,361.6831081463054,0.39957912457912453,0.21720969089390163,0.2091471886237334,130835.79881656822,484.88482212567783,131320.6836386939,1465,24,612.4666666666667,38,7,15,34.98002819548873,0.6249999999999998,44.23076923076924,1023.0769230769243,26.923076923076955,7
1491,4,0,1,44,0.0,0.022222222222222223,0.9777777777777777,45,1250,900,350,0.72,16,9,7,364.2217828830677,0.39957912457912453,0.22276031245407601,0.2117052574782778,131034.669325087,545.1361762152974,131579.8055013023,1466,25,613.4666666666667,39,6,15,34.713708583443555,0.6252670940170939,44.03645833333334,1023.8541666666682,26.25267094017098,0
1492,4,0,0,44,0.0,0.0,1.0,44,1000,600,400,0.6,14,6,8,368.0292062959314,0.3979805320648344,0.2343598793191779,0.21372459725621895,130999.80481591054,842.3508382642934,131842.15565417483,1467,27,627.8409090909091,38,6,15,34.65156021707368,0.6266447368421053,44.07051282051282,1023.7179487179484,26.93994601889338,0
1493,4,0,0,44,0.0,0.0,1.0,44,1250,900,350,0.72,16,9,7,367.75866579156366,0.39717670894996476,0.231738536807373,0.21448114888135716,131163.9135437212,847.3331689677823,132011.24671268897,1468,28,628.8409090909091,38,6,15,34.492334167709636,0.6282894736842106,43.91025641025641,1024.3589743589741,26.956815114709844,0
1494,4,0,0,44,0.0,0.0,1.0,44,1650,1200,450,0.7272727272727273,21,12,9,376.5801757477952,0.39774929527836506,0.2049309520324012,0.21533728281710965,130402.54122662758,1027.1808549478783,131429.72208157546,1469,29,629.8409090909091,37,7,16,35.03880390051888,0.622466216216216,44.654605263157904,1021.3815789473698,27.604907539118102,2
1495,4,1,1,44,0.022222222222222223,0.022222222222222223,0.9777777777777777,45,1400,1100,300,0.7857142857142857,17,11,6,370.8239336282884,0.4006313131313131,0.20577197563098348,0.2142811807176139,130808.47447083434,701.3826110380694,131509.8570818724,1470,0,616.8222222222222,38,7,15,34.77393385552656,0.6247258771929824,44.25747863247864,1022.9700854700861,26.92026540710753,0
1496,4,0,0,44,0.0,0.0,1.0,44,1500,1100,400,0.7333333333333333,19,11,8,378.63234931979497,0.3980355884425652,0.21150559279867798,0.21863848687501306,130781.15297866901,1103.5950398129894,131884.748018482,1471,31,631.8409090909091,38,6,15,34.601960169904594,0.6244517543859649,44.284188034188034,1022.8632478632479,26.917453891138102,0
1497,4,1,2,43,0.022222222222222223,0.044444444444444446,0.9555555555555556,45,1200,800,400,0.6666666666666666,16,8,8,369.19025168617134,0.40048400673400675,0.2044923751709793,0.2145931983337303,131034.66932508687,675.3445095486164,131710.0138346355,1472,0,618.7777777777778,39,6,15,34.586533896293275,0.625267094017094,44.036458333333336,1023.8541666666672,26.252670940170955,0
1498,4,0,0,43,0.0,0.0,1.0,43,1100,700,400,0.6363636363636364,15,7,8,395.31895618926825,0.39765596160945,0.21273383269932133,0.2150680192846202,128442.17985243622,1562.18135805037,130004.36121048659,1473,33,645.3488372093024,38,5,13,36.56307089657111,0.6008771929824561,46.58119658119658,1013.6752136752134,26.675663517768772,7
1499,4,1,0,44,0.022727272727272728,0.0,1.0,44,850,500,350,0.5882352941176471,12,5,7,385.8657437303889,0.40306774136715995,0.20897663137273148,0.21184572803676852,128804.55864800356,1140.2533637152828,129944.81201171884,1474,0,631.6590909090909,39,5,14,36.431610227467075,0.6028311965811965,46.223958333333336,1015.1041666666673,26.028311965811984,0
1500,4,1,0,45,0.022222222222222223,0.0,1.0,45,950,700,250,0.7368421052631579,12,7,5,378.0921999999998,0.4065867003367003,0.21341777777777748,0.20912179203539827,129098.08976138548,762.1961547359426,129860.28591612141,1475,0,618.6,40,5,16,36.328958333333325,0.6041666666666666,45.9349593495935,1016.2601626016265,25.40650406504066,0
1501,4,1,1,45,0.021739130434782608,0.021739130434782608,0.9782608695652174,46,1400,1000,400,0.7142857142857143,18,10,8,369.48084692968564,0.4094605475040258,0.20860613672898354,0.20561930515697002,129340.77222077936,357.95285808950695,129698.72507886887,1476,0,606.1304347826087,37,9,16,36.30023624735008,0.6117680180180181,45.696271929824555,1017.2149122807008,27.492294926505426,0
1502,4,3,3,45,0.0625,0.0625,0.9375,48,1500,1300,200,0.8666666666666667,17,13,4,354.60144773331785,0.41413637706855794,0.19946559359563976,0.19998704127207595,129864.12896050354,-389.99837239582257,129474.13058810771,1477,0,581.8125,39,9,15,36.146418838358024,0.6135149572649572,45.18229166666667,1019.2708333333339,26.13514957264959,0
1503,4,0,0,45,0.0,0.0,1.0,45,1400,1200,200,0.8571428571428571,16,12,4,376.172642466295,0.4064183501683502,0.20791560621150085,0.20997357442667763,129459.11864144566,739.7957501420528,130198.9143915877,1478,3,621.6,36,9,15,36.009368890856095,0.6148726851851851,45.579954954954964,1017.6801801801814,28.268893893893928,0
1504,4,1,0,46,0.021739130434782608,0.0,1.0,46,1300,1000,300,0.7692307692307693,16,10,6,365.43083090746273,0.4080012077294686,0.2105127797469304,0.20642623728903933,129927.0027797014,295.8665166204988,130222.86929632191,1479,0,609.0652173913044,37,9,16,35.80653545565356,0.6176801801801801,45.12061403508772,1019.5175438596489,27.55452821242294,0
1505,4,0,0,46,0.0,0.0,1.0,46,1250,1100,150,0.88,14,11,3,357.00958387531347,0.4080012077294686,0.2149226958230117,0.18968463276882497,127492.46110481207,-96.79390274630782,127395.66720206576,1480,1,610.0652173913044,41,5,15,38.506057629338564,0.5863821138211383,47.51984126984126,1009.9206349206331,24.63221060782032,7
1506,4,2,0,48,0.041666666666666664,0.0,1.0,48,1100,500,600,0.45454545454545453,17,5,12,345.87169224425406,0.41497672872340424,0.2254709331337328,0.1863244277573885,128048.66850321395,-742.3180670339777,127306.35043617997,1481,0,585.6041666666666,43,5,17,38.218095059880234,0.5891472868217055,46.96969696969697,1012.121212121212,23.537702607470045,0
1507,4,3,0,51,0.058823529411764705,0.0,1.0,51,1100,700,400,0.6363636363636364,15,7,8,327.1863029219062,0.42426470588235293,0.24223572724955544,0.1794875638173737,128773.09032698722,-1773.2623816954856,126999.82794529173,1482,0,552.0980392156863,41,10,18,37.95277017561008,0.599339430894309,46.254960317460316,1014.9801587301582,24.755613627564834,0
1508,4,0,0,51,0.0,0.0,1.0,51,1300,800,500,0.6153846153846154,18,8,10,326.4796211856776,0.42419934640522877,0.24165631850863845,0.1792134916293913,128798.26467624084,-1789.998267825654,127008.26640841519,1483,1,553.0980392156863,41,10,18,37.945090565545996,0.5995934959349594,46.23015873015873,1015.0793650793648,24.758033294618656,0
1509,4,3,3,51,0.05555555555555555,0.05555555555555555,0.9444444444444444,54,1550,1000,550,0.6451612903225806,21,10,11,305.3316461041149,0.4291215350570696,0.24315258912646298,0.17040761837519103,129453.66138353494,-2892.850450365328,126560.81093316962,1484,0,523.3148148148148,41,13,14,37.81723207902777,0.6061991869918699,45.58531746031746,1017.6587301587306,24.82094463801782,0
1510,4,0,0,51,0.0,0.0,1.0,51,1550,1200,350,0.7741935483870968,19,12,7,324.58042567297605,0.4247058823529412,0.24399045332418656,0.1795662677513402,129107.2702331963,-1818.8614540466297,127288.40877914967,1485,3,555.0980392156863,44,7,19,37.67917881438289,0.5984848484848484,45.92592592592593,1016.2962962962973,23.09764309764312,0
1511,4,0,0,51,0.0,0.0,1.0,51,700,200,500,0.2857142857142857,12,2,10,328.2047836603066,0.4249019607843137,0.24943747990999743,0.18200447093889704,129201.38888888877,-1718.8914609053604,127482.49742798341,1486,4,556.0980392156863,38,13,19,37.4914617486339,0.6085526315789473,45.83333333333333,1016.6666666666657,26.754385964912256,0
1512,4,1,0,52,0.019230769230769232,0.0,1.0,52,1600,1100,500,0.6875,21,11,10,322.3398449423787,0.42580285319255906,0.2500076777200242,0.18052112389478436,129589.12854658274,-2045.6520796153072,127543.47646696743,1487,0,546.3846153846154,40,12,19,37.247147087201,0.6091145833333333,45.452235772357724,1018.1910569105692,25.45477642276423,0
1513,4,1,0,53,0.018867924528301886,0.0,1.0,53,1200,900,300,0.75,15,9,6,319.02656321910194,0.4275822447992259,0.2549725347149365,0.18016524270682613,129916.6039920227,-2310.6304646655867,127605.97352735711,1488,0,537.0566037735849,42,11,20,36.99980990400152,0.609375,45.13081395348837,1019.4767441860464,24.273255813953487,0
1514,4,0,0,53,0.0,0.0,1.0,53,1350,1100,250,0.8148148148148148,16,11,5,319.44159666883996,0.42684143686502174,0.2544962831659998,0.18110657259561846,130069.31889921968,-2290.0898186409345,127779.22908057875,1489,1,538.0566037735849,43,10,20,36.8346948879812,0.6094961240310077,44.981060606060616,1020.0757575757593,23.722692036645565,0
1515,4,1,2,52,0.018518518518518517,0.037037037037037035,0.962962962962963,54,1300,900,400,0.6923076923076923,17,9,8,312.4781886261676,0.4287648497554158,0.2539466601779954,0.1781586766707426,130288.52390276971,-2656.9616893886,127631.56221338111,1490,0,529.074074074074,40,14,20,36.79076249253433,0.6161458333333333,44.76626016260163,1020.934959349595,25.523373983739877,0
1516,4,0,0,52,0.0,0.0,1.0,52,1350,800,550,0.5925925925925926,19,8,11,321.318068641285,0.42428670186023126,0.25130774344849716,0.18238048219536906,130114.25212014033,-2038.3879612102337,128075.8641589301,1491,3,550.25,42,10,21,36.74138094785831,0.6113591269841269,44.93701550387598,1020.2519379844987,24.29171280915473,0
1517,4,0,0,52,0.0,0.0,1.0,52,950,500,450,0.5263157894736842,14,5,9,317.5155152205366,0.424137443438914,0.2433839587764246,0.18068543944281676,130214.25637769766,-2130.9906594352387,128083.26571826242,1492,4,551.25,43,9,21,36.73725799468052,0.6109496124031006,44.83901515151516,1020.6439393939412,23.735905567300957,0
1518,4,1,0,53,0.018867924528301886,0.0,1.0,53,1100,600,500,0.5454545454545454,16,6,10,295.8933960101574,0.4260099177552008,0.21148535723438866,0.16027303429482828,128267.19867345713,-2853.828836426177,125413.36983703094,1493,0,541.8301886792453,42,11,17,39.26049040239779,0.5927579365079365,46.75387596899225,1012.984496124031,24.118678479143597,7
1519,4,2,3,52,0.03636363636363636,0.05454545454545454,0.9454545454545454,55,1150,900,250,0.782608695652174,14,9,5,285.7232142857146,0.4306116722783389,0.2135844155844162,0.15625488281249994,128649.44339424472,-3648.3735034656743,125001.06989077905,1494,0,523.0909090909091,45,10,13,39.13020833333334,0.5925925925925926,46.37681159420289,1014.4927536231869,22.544283413848596,0
1520,4,1,2,51,0.018867924528301886,0.03773584905660377,0.9622641509433962,53,1450,1100,350,0.7586206896551724,18,11,7,291.22055588660214,0.4252237542331882,0.21777647031882297,0.1590649349363279,128600.36914779876,-3109.7858019111804,125490.58334588759,1495,0,543.5849056603773,43,10,13,39.04056966358573,0.5947189922480621,46.425189393939384,1014.2992424242403,23.588354474982335,0
1521,4,2,1,52,0.03773584905660377,0.018867924528301886,0.9811320754716981,53,1550,1200,350,0.7741935483870968,19,12,7,310.50522371756654,0.4242864054184809,0.22604081163759804,0.16528356994856122,127567.61508133328,-2611.9841661077303,124955.63091522554,1496,0,544.3018867924528,41,12,13,39.60348538413697,0.5871443089430894,47.4454365079365,1010.2182539682525,24.63946960898177,5
1522,4,4,2,54,0.07142857142857142,0.03571428571428571,0.9642857142857143,56,1650,1200,450,0.7272727272727273,21,12,9,292.9958015927975,0.4323119588744589,0.2448308270676689,0.15905486372180455,128355.55555555568,-3678.4722222222126,124677.08333333346,1497,0,515.8035714285714,44,12,17,39.244106359649116,0.5909090909090909,46.66666666666667,1013.3333333333344,23.030303030303056,0
1523,4,3,3,54,0.05263157894736842,0.05263157894736842,0.9473684210526316,57,1300,600,700,0.46153846153846156,20,6,14,290.2993224240945,0.43464129072681706,0.2618970424006628,0.1588491797983524,128672.4175347219,-3929.2968750000346,124743.12065972187,1498,0,507.70175438596493,45,12,11,38.9908453114305,0.5928240740740742,46.35416666666665,1014.5833333333308,22.54629629629624,0
1524,4,1,0,55,0.01818181818181818,0.0,1.0,55,2300,1800,500,0.782608695652174,28,18,10,311.3627065659529,0.4297979797979798,0.28243340716037424,0.17027200997657216,128648.39916386864,-2988.7372481921675,125659.66191567648,1499,0,527.1272727272727,43,12,12,38.48099271912628,0.5952034883720931,46.3778409090909,1014.4886363636351,23.592758985200817,0
1525,4,1,2,54,0.017857142857142856,0.03571428571428571,0.9642857142857143,56,1600,1200,400,0.75,20,12,8,309.77388952037484,0.4309726731601731,0.2962027952007915,0.17157909985644157,129154.32527434833,-3198.2724622771007,125956.05281207123,1500,0,518.6964285714286,44,12,14,38.00764407603086,0.5989583333333335,45.879629629629626,1016.4814814814807,23.101851851851833,0
1526,4,1,2,53,0.01818181818181818,0.03636363636363636,0.9636363636363636,55,1550,1000,550,0.6451612903225806,21,10,11,310.3825755430995,0.42960157126823795,0.2164800716524864,0.17029098063580805,128778.12499999949,-2987.7614883402357,125790.36351165925,1501,0,528.9636363636364,44,11,15,38.37404214559389,0.5951704545454547,46.24999999999998,1014.9999999999959,23.068181818181724,6
1527,4,1,3,51,0.018518518518518517,0.05555555555555555,0.9444444444444444,54,1450,1200,250,0.8275862068965517,17,12,5,319.2491716093928,0.43139995341253207,0.21912726503607183,0.17529767105470184,128810.30545217652,-2575.4833379279594,126234.82211424856,1502,0,539.4814814814815,45,9,16,38.11633725945093,0.594212962962963,46.218297101449274,1015.1268115942028,22.558373590982285,0
1528,4,0,1,50,0.0,0.0196078431372549,0.9803921568627451,51,1750,1300,450,0.7428571428571429,22,13,9,334.5416774799166,0.4246732026143791,0.21670564250164914,0.1823252142265545,128512.70957274197,-1601.4285124091134,126911.28106033285,1503,3,571.5882352941177,42,9,16,38.03138538481143,0.5952380952380952,46.51162790697674,1013.9534883720926,24.14174972314506,0
1529,4,1,0,51,0.0196078431372549,0.0,1.0,51,1450,1200,250,0.8275862068965517,17,12,5,330.12243038032364,0.42379084967320263,0.23390893350180209,0.1811436594150808,128783.04268260635,-1697.165791568997,127085.87689103735,1504,0,572.2745098039215,42,9,18,37.86813842482102,0.5979662698412698,46.2451550387597,1015.0193798449623,24.167128091546722,0
1530,4,0,0,51,0.0,0.0,1.0,51,1050,500,550,0.47619047619047616,16,5,11,331.80015915025,0.4237091503267974,0.23260713771146402,0.1825162135294211,128881.41605259605,-1647.4251284478028,127233.99092414824,1505,1,573.2745098039215,42,9,18,37.725450901803605,0.5989583333333333,46.14825581395349,1015.4069767441864,24.176356589147296,0
1531,4,0,0,51,0.0,0.0,1.0,51,1100,700,400,0.6363636363636364,15,7,8,334.06647519351617,0.4235294117647059,0.23420541656845884,0.18410540446784643,128955.22072742032,-1584.0767907577597,127371.14393666257,1506,2,574.2745098039215,42,9,18,37.59281784646696,0.5997023809523809,46.07558139534884,1015.6976744186055,24.183277962347752,0
1532,4,0,0,51,0.0,0.0,1.0,51,1850,1400,450,0.7567567567567568,23,14,9,333.418566175312,0.42307189542483664,0.23579520489420114,0.18432053260308381,129078.27546609289,-1592.5812939426617,127485.69417215022,1507,3,575.2745098039215,42,9,19,37.48410730746003,0.6009424603174602,45.95445736434109,1016.1821705426365,24.194813584348488,0
1533,4,1,1,51,0.019230769230769232,0.019230769230769232,0.9807692307692307,52,1500,1200,300,0.8,18,12,6,329.8693724911377,0.4267769607843137,0.24675896436734224,0.1849322287614161,129630.39852804547,-1828.2831431471668,127802.1153848983,1508,0,565.1923076923077,41,11,15,37.013618282188666,0.6079776422764227,45.41170634920635,1018.3531746031746,24.8378823073945,2
1534,4,0,0,51,0.0,0.0,1.0,51,1300,1000,300,0.7692307692307693,16,10,6,334.69829115767357,0.42493464052287583,0.24690502885117716,0.18768951179020965,129640.87106095908,-1521.8843983409413,128118.98666261813,1509,5,577.2745098039215,40,11,16,36.88005189102881,0.6096354166666667,45.40142276422764,1018.3943089430894,25.459857723577237,0
1535,4,0,0,51,0.0,0.0,1.0,51,1050,700,350,0.6666666666666666,14,7,7,336.2454543500958,0.4245751633986928,0.25085286767808124,0.18923709926738805,129781.98346757678,-1472.2796004976112,128309.70386707917,1510,6,578.2745098039215,41,10,16,36.69747752571968,0.6095020325203253,45.26289682539682,1018.9484126984121,24.852400309717368,0
1536,4,0,0,51,0.0,0.0,1.0,51,1250,900,350,0.72,16,9,7,332.0241445106877,0.4243954248366013,0.24223967516161782,0.18746594005449585,129908.3719135802,-1573.4567901234639,128334.91512345673,1511,7,579.2745098039215,41,10,16,36.67688465031789,0.6107723577235773,45.138888888888886,1019.444444444444,24.86449864498644,0
1537,4,0,1,50,0.0,0.0196078431372549,0.9803921568627451,51,1100,800,300,0.7272727272727273,14,8,6,330.79996400835034,0.42455882352941177,0.23963954683926314,0.18713774518667203,129984.23450688134,-1600.2439806941452,128383.9905261872,1512,8,580.2745098039215,41,10,17,36.63121817945974,0.6115345528455285,45.06448412698412,1019.7420634920626,24.871757646147866,0
1538,4,1,0,51,0.0196078431372549,0.0,1.0,51,1500,1300,200,0.8666666666666667,17,13,4,334.0000012854225,0.4247222222222222,0.25450164510680806,0.18980795653159405,130161.33334120666,-1505.2228993449453,128656.11044186172,1513,0,581.0980392156863,41,10,19,36.370228141810856,0.6133130081300815,44.890873015873005,1020.4365079365064,24.888695315524544,0
1539,4,1,0,52,0.019230769230769232,0.0,1.0,52,1350,900,450,0.6666666666666666,18,9,9,327.12074669187155,0.42841880341880345,0.2473871237458194,0.18809442934782608,130617.28395061725,-1854.4359410430875,128762.84800957415,1514,0,570.9038461538462,41,11,15,36.08469202898552,0.6178861788617886,44.44444444444444,1022.222222222222,24.932249322493217,0
1540,4,0,1,51,0.0,0.019230769230769232,0.9807692307692307,52,1650,1100,550,0.6666666666666666,22,11,11,324.58672193636085,0.4282616892911011,0.23753516344941294,0.18725039263804943,130744.07837498422,-1912.4416375346464,128831.63673744957,1515,1,571.9038461538462,41,11,15,36.021417369935655,0.6191565040650406,44.320436507936506,1022.7182539682537,24.944347657762286,0
1541,4,1,1,51,0.019230769230769232,0.019230769230769232,0.9807692307692307,52,1650,1400,250,0.8484848484848485,19,14,5,328.1160177623473,0.4281359979889392,0.23866102390096566,0.19003462791794581,130896.3128798974,-1810.1646156147567,129086.14826428264,1516,0,572.8461538461538,41,11,15,35.77748828566812,0.620680894308943,44.17162698412699,1023.3134920634927,24.958865660085188,0
1542,4,0,0,51,0.0,0.0,1.0,51,1300,1000,300,0.7692307692307693,16,10,6,338.4428123086219,0.4249019607843137,0.24676351764627968,0.19556632311702585,130807.80805902585,-1345.807513715367,129462.00054531048,1517,3,585.0784313725491,40,11,16,35.60273031326579,0.6213541666666667,44.25813008130082,1022.9674796747978,25.574186991869944,0
1543,4,0,1,50,0.0,0.0196078431372549,0.9803921568627451,51,1400,1100,300,0.7857142857142857,17,11,6,338.06345863891386,0.4240849673202614,0.24911370267932686,0.19579587736442441,130896.3128798974,-1349.7479489480902,129546.56493094932,1518,4,586.0784313725491,41,10,16,35.523004524155766,0.620680894308943,44.17162698412699,1023.3134920634927,24.958865660085188,0
1544,4,0,0,50,0.0,0.0,1.0,50,1450,1200,250,0.8275862068965517,17,12,5,347.328309090393,0.4212159863945579,0.25270885070030746,0.20083596137926452,130833.79937743771,-911.5435380725436,129922.25583936517,1519,5,598.08,40,10,16,35.34920201317837,0.6216145833333332,44.23272357723579,1023.0691056910596,25.576727642276488,0
1545,4,0,0,50,0.0,0.0,1.0,50,1300,1000,300,0.7692307692307693,16,10,6,332.2321800243125,0.4214880952380953,0.18763945792625258,0.18461868777883467,129282.8654051614,-1270.469854224052,128012.39555093735,1520,6,599.08,38,12,15,37.30630843576005,0.6093749999999998,45.753205128205146,1016.9871794871821,26.762820512820582,8
1546,4,0,0,50,0.0,0.0,1.0,50,1000,600,400,0.6,14,6,8,333.19223667358267,0.4208248299319728,0.19382207751286584,0.1854075561291166,129337.19735051894,-1381.1699859375879,127956.02736458134,1521,7,600.08,38,12,15,37.22670062668488,0.6099232456140349,45.69978632478634,1017.2008547008569,26.768443544759393,0
1547,4,1,0,51,0.0196078431372549,0.0,1.0,51,1300,1000,300,0.7692307692307693,16,10,6,325.81830955875887,0.4252941176470588,0.20297525963350593,0.18313236020026807,129731.44531250013,-1746.2239583333176,127985.22135416682,1522,0,589.2941176470588,39,12,14,37.014314928425364,0.6121794871794872,45.31250000000001,1018.750000000001,26.121794871794897,0
1548,4,1,0,52,0.019230769230769232,0.0,1.0,52,1400,1000,400,0.7142857142857143,18,10,8,319.21635713356613,0.42749183006535946,0.22020849456350988,0.18115392929699664,130107.01844346954,-2093.5423069931885,128013.47613647635,1523,0,578.9423076923077,40,12,15,36.80230434638244,0.6143229166666667,44.94410569105691,1020.2235772357727,25.505589430894318,0
1549,4,0,0,52,0.0,0.0,1.0,52,1150,800,350,0.6956521739130435,15,8,7,321.32956341382516,0.4272404474610357,0.2249015672636463,0.18271752411107772,130184.79100568444,-2033.5555886046684,128151.23541707978,1524,1,579.9423076923077,40,12,15,36.66973710416251,0.6151041666666668,44.86788617886179,1020.5284552845528,25.51321138211382,0
1550,4,0,1,51,0.0,0.019230769230769232,0.9807692307692307,52,1450,1100,350,0.7586206896551724,18,11,7,330.1851048146545,0.42754682001005534,0.24915875900127915,0.18776197751400464,130186.64301658135,-1802.861926020434,128383.78109056092,1525,2,580.9423076923077,41,11,17,36.44192913385828,0.6135670731707318,44.866071428571416,1020.5357142857121,24.891114982578344,1
1551,4,1,1,51,0.019230769230769232,0.019230769230769232,0.9807692307692307,52,1150,800,350,0.6956521739130435,15,8,7,323.4795178337172,0.427593954248366,0.2541714504401076,0.184924297737705,130392.29811124314,-1964.1081670002077,128428.18994424294,1526,0,578.7884615384615,40,12,17,36.40505804311774,0.6171875000000002,44.664634146341456,1021.3414634146328,25.53353658536582,0
1552,4,0,0,51,0.0,0.0,1.0,51,1300,800,500,0.6153846153846154,18,8,10,328.2582382197536,0.42715686274509806,0.2673626553685551,0.18790727850711603,130444.2007072507,-1636.1232979708088,128808.07740927988,1527,4,591.1372549019608,40,11,17,36.23055942432684,0.6177083333333335,44.61382113821137,1021.5447154471523,25.538617886178805,0
1553,4,0,0,51,0.0,0.0,1.0,51,1050,700,350,0.6666666666666666,14,7,7,332.065962427207,0.4263562091503268,0.2720537066601172,0.190980647001445,130625.94112507426,-1524.714228468516,129101.22689660575,1528,5,592.1372549019608,40,11,15,35.94956423766445,0.6195312500000001,44.43597560975609,1022.2560975609748,25.55640243902437,0
1554,4,0,1,50,0.0,0.0196078431372549,0.9803921568627451,51,2050,1500,550,0.7317073170731707,26,15,11,333.0007896578882,0.4256699346405229,0.2734458124335013,0.19190457878222605,130703.86860499684,-1495.1017086390536,129208.76689635779,1529,6,593.1372549019608,40,11,15,35.84691578877626,0.6203125000000002,44.35975609756097,1022.5609756097546,25.564024390243866,0
1555,4,0,0,50,0.0,0.0,1.0,50,1100,800,300,0.7272727272727273,14,8,6,330.9263874952295,0.4255187074829932,0.25668918918918937,0.19096577773807252,130755.83316808756,-1345.8888971511878,129409.94427093636,1530,7,576.44,40,10,15,35.8474513116057,0.6208333333333333,44.30894308943088,1022.7642276422747,25.56910569105687,0
1556,4,0,0,50,0.0,0.0,1.0,50,850,400,450,0.47058823529411764,13,4,9,334.1300920603678,0.4255187074829932,0.28678783240864814,0.18098424779269848,128267.19867345694,-1427.1641502735918,126840.03452318335,1531,8,577.44,42,8,19,38.29216089535107,0.5927579365079365,46.75387596899224,1012.9844961240295,24.11867847914356,7
1557,4,5,4,51,0.09090909090909091,0.07272727272727272,0.9272727272727272,55,750,500,250,0.6666666666666666,10,5,5,309.8110652882754,0.4378787878787879,0.2816876903001313,0.17103909000631934,129024.94454089485,-3005.328896604955,126019.6156442899,1532,0,525.8545454545455,47,8,13,38.137958532695365,0.5939716312056739,46.006944444444436,1015.9722222222205,21.616430260047245,0
1558,4,1,0,52,0.019230769230769232,0.0,1.0,52,1850,1100,750,0.5945945945945946,26,11,15,321.0262540760576,0.4307755153343389,0.2841432099458374,0.17633927102654784,128825.12002743481,-2128.750857338824,126696.36917009599,1533,0,557.1730769230769,44,8,16,38.056176273865994,0.5956439393939394,46.2037037037037,1015.1851851851849,23.072390572390564,0
1559,4,0,0,52,0.0,0.0,1.0,52,1300,1000,300,0.7692307692307693,16,10,6,327.4395795355978,0.43039058572146804,0.28495164694909425,0.18039601948397663,128942.64510459545,-1955.814900548684,126986.83020404677,1534,1,558.1730769230769,44,8,16,37.77387789831951,0.5968276515151515,46.08796296296297,1015.6481481481491,23.082912457912478,0
1560,4,1,2,51,0.018867924528301886,0.03773584905660377,0.9622641509433962,53,1350,1000,350,0.7407407407407407,17,10,7,320.3128574769287,0.43093855829704886,0.2816026314587239,0.17784485333956884,129249.53099890958,-2319.423989650991,126930.10700925859,1535,0,548.622641509434,43,10,17,37.64318308809835,0.6012596899224807,45.78598484848485,1016.8560606060609,23.64781536293165,0
1561,4,1,0,52,0.019230769230769232,0.0,1.0,52,1450,1100,350,0.7586206896551724,18,11,7,324.854721567987,0.4321581196581197,0.2869832122275118,0.18113980193295404,129418.09900317102,-1991.5838964933332,127426.51510667769,1536,0,547.3461538461538,43,9,19,37.35661935784086,0.602955426356589,45.620265151515156,1017.5189393939403,23.663231148696287,0
1562,4,2,1,53,0.037037037037037035,0.018518518518518517,0.9814814814814815,54,1150,600,550,0.5217391304347826,17,6,11,313.25884214380767,0.43717971115769855,0.28752332711276907,0.1766968296062292,129869.89935314294,-2663.421139860307,127206.47821328264,1537,0,528.0370370370371,45,9,15,37.19406306466423,0.6048611111111111,45.176630434782616,1019.2934782608713,22.65096618357492,0
1563,4,0,0,53,0.0,0.0,1.0,53,1150,700,450,0.6086956521739131,16,7,9,316.63150924128644,0.434461175616836,0.28395326309653335,0.17823681632738433,129790.40745027464,-2380.8534807955903,127409.55396947905,1538,1,539.0,44,9,16,37.188588520369514,0.6053503787878787,45.25462962962964,1018.9814814814838,23.158670033670088,0
1564,4,1,2,52,0.018518518518518517,0.037037037037037035,0.962962962962963,54,1350,1100,250,0.8148148148148148,16,11,5,314.3828716952333,0.43494496855345915,0.28280002762730794,0.1781713899426282,130054.61960624087,-2622.6110421917574,127432.00856404912,1539,0,530.0,45,9,16,36.978565402717344,0.6067129629629628,44.99547101449276,1020.0181159420295,22.66706924315621,0
1565,4,0,1,51,0.0,0.019230769230769232,0.9807692307692307,52,1400,800,600,0.5714285714285714,20,8,12,319.7255732989255,0.43025703871292104,0.27446675479652716,0.18048483463885345,129900.32717982387,-2093.508684142558,127806.8184956813,1540,3,551.2692307692307,43,9,16,36.998471125561224,0.6078003875968991,45.146780303030305,1019.4128787878793,23.707276250880913,0
1566,4,1,1,51,0.019230769230769232,0.019230769230769232,0.9807692307692307,52,1250,1000,250,0.8,15,10,5,320.57505803199376,0.4307990824534942,0.27320196149654996,0.18122035621397903,129955.57270233182,-2067.8969478738095,127887.675754458,1541,0,552.0961538461538,44,8,16,36.92089690035113,0.6070075757575758,45.09259259259259,1019.6296296296284,23.173400673400646,0
1567,4,1,0,52,0.019230769230769232,0.0,1.0,52,1100,700,400,0.6363636363636364,15,7,8,321.121429905696,0.43003707893413773,0.2848961108151318,0.18209816433020828,130077.71886814697,-2045.8513836379334,128031.86748450904,1542,0,553.0769230769231,45,7,18,36.78335701178002,0.6069444444444445,44.9728260869565,1020.1086956521701,22.66908212560378,0
1568,4,0,0,52,0.0,0.0,1.0,52,1350,900,450,0.6666666666666666,18,9,9,322.8948924167105,0.43003707893413773,0.2866518247377632,0.183320971178519,130123.92354547321,-1996.7299411888619,128127.19360428434,1543,1,554.0769230769231,45,7,18,36.69137665719698,0.6074074074074076,44.92753623188404,1020.2898550724603,22.673107890499118,0
1569,4,0,0,52,0.0,0.0,1.0,52,850,700,150,0.8235294117647058,10,7,3,322.34938514816196,0.43025703871292104,0.2857649982250625,0.18344610463886274,130216.35751417743,-2004.967443814351,128211.39007036308,1544,2,555.0769230769231,45,7,18,36.61179150396401,0.6083333333333334,44.83695652173912,1020.6521739130415,22.68115942028981,0
1570,4,0,0,52,0.0,0.0,1.0,52,1500,1200,300,0.8,18,12,6,321.18598290375974,0.4297542735042735,0.28879685515745623,0.18322895596128752,130310.92620092958,-2029.1750076432588,128281.75119328631,1545,3,556.0769230769231,43,9,18,36.545863476163966,0.6119186046511629,44.74431818181817,1021.0227272727259,23.74471458773781,0
1571,4,0,0,52,0.0,0.0,1.0,52,1100,700,400,0.6363636363636364,15,7,8,320.1922173798199,0.42989567621920566,0.28757355301166143,0.18300334204776644,130383.45210808348,-2050.4466719754532,128333.00543610803,1546,4,557.0769230769231,43,9,19,36.49793308607636,0.6126453488372094,44.673295454545446,1021.3068181818165,23.7513213530655,0
1572,4,0,0,52,0.0,0.0,1.0,52,1450,900,550,0.6206896551724138,20,9,11,321.48570090905554,0.42944004524886875,0.2921964988310428,0.1845464725643897,130552.75769054178,-2005.8310376492177,128546.92665289257,1547,5,558.0769230769231,43,9,15,36.293859649122815,0.6143410852713178,44.50757575757576,1021.9696969696969,23.76673713883016,0
1573,4,3,4,51,0.05454545454545454,0.07272727272727272,0.9272727272727272,55,950,500,450,0.5263157894736842,14,5,9,305.54503554381614,0.4356200897867564,0.28799710375331555,0.1778010431015928,131078.35468694972,-2989.931891630211,128088.42279531951,1548,0,528.5818181818182,46,9,15,36.17165180503853,0.6157155797101449,43.99379432624113,1024.0248226950343,22.261409189022487,0
1574,4,0,0,51,0.0,0.0,1.0,51,1450,900,550,0.6206896551724138,20,9,11,318.9609223928651,0.4288398692810458,0.2843657356841942,0.18418771864218172,130782.42368247098,-1857.1035018929188,128925.32018057806,1549,7,566.0392156862745,42,9,16,36.12657098648478,0.6180555555555556,44.28294573643411,1022.8682170542634,24.35400516795865,0
1575,4,0,0,51,0.0,0.0,1.0,51,1100,800,300,0.7272727272727273,14,8,6,320.70368942637447,0.4289052287581699,0.2888048296314447,0.18555124693989536,130856.77059859695,-1806.7501765218394,129050.02042207512,1550,8,567.0392156862745,42,9,16,36.00700034725507,0.6187996031746031,44.21027131782946,1023.158914728683,24.36092654115912,0
1576,4,0,1,50,0.0,0.0196078431372549,0.9803921568627451,51,1750,1400,350,0.8,21,14,7,322.67288861272306,0.4281535947712418,0.28959989902814565,0.18729210963213244,130980.72907277223,-1747.2139594976088,129233.51511327463,1551,9,568.0392156862745,42,9,18,35.831597879591065,0.6200396825396824,44.089147286821714,1023.6434108527145,24.37246216315987,0
1577,4,1,2,49,0.0196078431372549,0.0392156862745098,0.9607843137254902,51,1400,1000,400,0.7142857142857143,18,10,8,319.43022711758533,0.4278921568627451,0.28861642678155075,0.18591595673033193,131085.57610910243,-1825.4609303259776,129260.11517877645,1552,0,568.7450980392157,43,8,18,35.808905122988726,0.6196705426356588,43.98674242424243,1024.0530303030307,23.815186751233274,0
1578,4,0,0,49,0.0,0.0,1.0,49,1300,1000,300,0.7692307692307693,16,10,6,326.5476610590613,0.42571924603174605,0.28218602103114665,0.1896255100995194,130997.85175933823,-1244.591580845277,129753.26017849296,1553,11,567.7551020408164,41,8,18,35.715165390703234,0.6216971544715446,44.07242063492065,1023.7103174603194,24.968544328300474,0
1579,4,0,0,49,0.0,0.0,1.0,49,800,500,300,0.625,11,5,6,326.5842326765773,0.42545351473922904,0.28193628388322867,0.18980687582292213,131030.32889399707,-1241.5121161588584,129788.8167778382,1554,12,568.7551020408164,42,7,18,35.68147043977535,0.6205357142857141,44.04069767441862,1023.8372093023281,24.377076411960193,0
1580,4,0,0,49,0.0,0.0,1.0,49,700,500,200,0.7142857142857143,9,5,4,327.5334256020889,0.4254180839002268,0.2838293261849074,0.19048132682098398,131055.13232565671,-1215.0127133285027,129840.11961232821,1555,13,569.7551020408164,42,7,18,35.63215671429923,0.62078373015873,44.016472868217065,1023.9341085271335,24.379383536360322,0
1581,4,0,0,49,0.0,0.0,1.0,49,1350,1000,350,0.7407407407407407,17,10,7,326.61479255448535,0.4253826530612245,0.28492274783340643,0.19043822239897762,131154.36952594502,-1232.608560933828,129921.76096501118,1556,14,570.7551020408164,42,7,18,35.555608110238715,0.6217757936507936,43.91957364341086,1024.321705426357,24.388612033960882,0
1582,4,0,0,49,0.0,0.0,1.0,49,1200,1000,200,0.8333333333333334,14,10,4,327.1096920267046,0.4254180839002268,0.2839235542931233,0.19134469595544437,131278.46884201697,-1211.5080974700813,130066.96074454689,1557,15,571.7551020408164,42,7,18,35.41784858799798,0.6230158730158729,43.79844961240311,1024.8062015503897,24.40014765596166,0
1583,4,1,1,49,0.02,0.02,0.98,50,1250,1000,250,0.8,15,10,5,323.31344491194704,0.4271938775510204,0.28242600116076577,0.19012596094992668,131480.69905045367,-1498.0856711938281,129982.61337925984,1558,0,561.3,41,9,18,35.311472238343974,0.6265243902439024,43.60119047619048,1025.5952380952392,25.01451800232291,0
1584,4,0,0,49,0.0,0.0,1.0,49,1750,1400,350,0.8,21,14,7,327.5843377931521,0.4256838151927438,0.28201327106999785,0.19252495938676156,131458.3656078557,-1187.2596709961094,130271.10593685959,1559,17,573.7551020408164,40,9,18,35.22445743732039,0.6278645833333334,43.62296747967479,1025.5081300813001,25.6377032520325,0
1585,4,0,0,49,0.0,0.0,1.0,49,1300,900,400,0.6923076923076923,17,9,8,326.47532886368776,0.4255952380952381,0.28164397071960057,0.19279227315003022,131640.81090124918,-1204.50459382644,130436.30630742274,1560,18,574.7551020408164,40,9,17,35.06923813296361,0.6296875000000001,43.445121951219505,1026.2195121951213,25.65548780487803,0
1586,4,0,0,49,0.0,0.0,1.0,49,1450,1000,450,0.6896551724137931,19,10,9,330.39638920244806,0.4252940759637189,0.2888701664211868,0.19550872450696685,131719.04047070185,-1096.1009278538047,130622.93954284803,1561,19,575.7551020408164,40,9,17,34.88990363990362,0.6304687500000001,43.36890243902438,1026.5243902439015,25.663109756097537,0
1587,4,0,0,49,0.0,0.0,1.0,49,1150,800,350,0.6956521739130435,15,8,7,328.205423597711,0.4249397675736961,0.2873701204619781,0.19494611305261592,131862.5217013886,-1144.4010416666997,130718.12065972191,1562,20,576.7551020408164,41,8,17,34.80180865449626,0.6303353658536587,43.22916666666665,1027.083333333331,25.050813008130024,0
1588,4,1,1,49,0.02,0.02,0.98,50,1300,1000,300,0.7692307692307693,16,10,6,320.9125479879629,0.4270408163265306,0.2875765859176169,0.19180626600587583,132098.9961259088,-1521.5549133165196,130577.44121259228,1563,0,566.2,42,8,17,34.75154742828416,0.631200396825397,42.99903100775193,1028.0038759689915,24.476282761166463,0
1589,4,0,0,49,0.0,0.0,1.0,49,1050,600,450,0.5714285714285714,15,6,9,326.8809349890434,0.425187783446712,0.29481522338665234,0.19507410636442876,132040.89506172802,-1167.669753086459,130873.22530864156,1564,22,578.7551020408164,41,8,17,34.65653153153151,0.6321138211382116,43.055555555555536,1027.7777777777749,25.067750677506705,0
1590,4,0,0,49,0.0,0.0,1.0,49,1500,1200,300,0.8,18,12,6,331.2157936424348,0.42483347505668934,0.29788474301232615,0.19806054642334364,132117.37769471185,-1048.1275785777586,131069.25011613409,1565,23,579.7551020408164,41,8,17,34.46828058155616,0.6328760162601628,42.98115079365078,1028.0753968253944,25.075009678668156,0
1591,4,0,0,49,0.0,0.0,1.0,49,850,500,350,0.5882352941176471,12,5,7,332.0961836693569,0.42467403628117917,0.30133350136658366,0.19872083415411107,132142.8768266561,-1023.1709813555548,131119.70584530054,1566,24,580.7551020408164,41,8,17,34.420027659848174,0.6331300813008132,42.95634920634918,1028.1746031745993,25.077429345721935,0
1592,4,0,0,49,0.0,0.0,1.0,49,1350,800,550,0.5925925925925926,19,8,11,331.9240826474628,0.42417800453514737,0.29660336356764994,0.1991544495884772,132244.89795918332,-1020.9467120181771,131223.95124716515,1567,25,581.7551020408164,41,8,17,34.32195216049383,0.6341463414634148,42.85714285714284,1028.5714285714257,25.08710801393721,0
1593,4,0,0,49,0.0,0.0,1.0,49,1400,1300,100,0.9285714285714286,15,13,2,330.7860369803102,0.4243551587301588,0.29103113412644,0.19875242527560522,132298.296798945,-1047.5141405264487,131250.78265841855,1568,26,582.7551020408164,42,7,18,34.297588772722975,0.633184523809524,42.805232558139515,1028.7790697674388,24.49473975636759,0
1594,4,0,1,48,0.0,0.02040816326530612,0.9795918367346939,49,1400,1200,200,0.8571428571428571,16,12,4,329.55848530117277,0.42400085034013607,0.2848409988513527,0.19880807229563735,132449.05832703423,-1070.0202337961298,131379.0380932381,1569,27,583.7551020408164,41,8,18,34.17783024929324,0.6361788617886179,42.658730158730144,1029.365079365077,25.10646535036773,0
1595,4,0,0,48,0.0,0.0,1.0,48,1400,1100,300,0.7857142857142857,17,11,6,334.7452553370897,0.42178265366430256,0.2852967409121594,0.20125466916527257,132321.43964356548,-741.2051799886908,131580.23446357678,1570,34,596.3541666666666,41,7,18,34.17251229389642,0.634908536585366,42.78273809523808,1028.8690476190454,25.09436701509867,0
1596,4,0,0,48,0.0,0.0,1.0,48,1750,1500,250,0.8571428571428571,20,15,5,343.46516798397954,0.42304779846335694,0.24093772133967395,0.20735896488611327,132478.41932508696,-462.408820950235,132016.01050413674,1571,35,597.3541666666666,39,9,16,33.790452460454,0.6396901709401709,42.63020833333334,1029.479166666668,26.396901709401746,2
1597,4,0,0,48,0.0,0.0,1.0,48,650,200,450,0.3076923076923077,11,2,9,345.1093749080534,0.4228815750591017,0.239957427078064,0.2086486954719334,132532.04345703142,-452.38986545137345,132079.65359158005,1572,36,598.3541666666666,39,9,16,33.69425476310908,0.6402243589743589,42.57812500000001,1029.6875000000014,26.402243589743623,0
1598,4,0,0,48,0.0,0.0,1.0,48,1300,1000,300,0.7692307692307693,16,10,6,344.16102887291896,0.4226599438534279,0.24245806610754794,0.2084920518605521,132607.26631180203,-472.34935802099835,132134.91695378104,1573,37,599.3541666666666,40,8,16,33.643109685906936,0.6393229166666665,42.50508130081302,1029.9796747967494,25.749491869918735,0
1599,4,0,0,48,0.0,0.0,1.0,48,1500,1200,300,0.8,18,12,6,339.65575115106896,0.4218288268321513,0.24556306739806888,0.20700075719711195,132832.28344868042,-576.5501976253486,132255.73325105506,1574,38,600.3541666666666,41,7,12,33.53332611554872,0.639989837398374,42.28670634920635,1030.8531746031747,25.142760356174993,0
1600,4,0,0,48,0.0,0.0,1.0,48,850,500,350,0.5882352941176471,12,5,7,342.828012253803,0.4210346483451537,0.25311818648198026,0.20964941267003145,132960.1481796422,-483.50733812043643,132476.64084152176,1575,39,601.3541666666666,41,7,13,33.32331345389252,0.641260162601626,42.16269841269841,1031.349206349206,25.15485869144405,0
1601,4,0,0,48,0.0,0.0,1.0,48,900,700,200,0.7777777777777778,11,7,4,342.207948709864,0.4201296542553192,0.2564597154119801,0.2099884881729378,133088.07442247728,-491.2406108276673,132596.83381164962,1576,40,602.3541666666666,41,7,14,33.21104941832515,0.6425304878048781,42.038690476190474,1031.8452380952378,25.166957026713117,0
1602,4,0,0,48,0.0,0.0,1.0,48,1300,900,400,0.6923076923076923,17,9,8,346.0236641712961,0.4192154255319149,0.25820682808096374,0.21335392752931567,133267.2745023935,-377.2738725119774,132890.0006298815,1577,41,603.3541666666666,41,7,16,32.93300025621316,0.6443089430894309,41.86507936507936,1032.539682539682,25.183894696089805,0
1603,4,0,0,48,0.0,0.0,1.0,48,1550,1100,450,0.7096774193548387,20,11,9,348.97660515130696,0.4184212470449173,0.25982251456372896,0.21606672806454863,133420.97052941532,-287.84052973042367,133133.1299996849,1578,42,604.3541666666666,41,7,16,32.70277190960886,0.6458333333333334,41.716269841269835,1033.1349206349194,25.198412698412668,0
1604,4,0,0,48,0.0,0.0,1.0,48,1250,800,450,0.64,17,8,9,353.1163238242009,0.4176547724586288,0.26578491677866234,0.21909520207514405,133499.82336410624,-171.77710279815759,133328.04626130807,1579,43,605.3541666666666,38,10,17,32.5168424135911,0.6515899122807017,41.63995726495727,1033.4401709401711,27.195793972109765,0
1605,4,0,0,48,0.0,0.0,1.0,48,1100,600,500,0.5454545454545454,16,6,10,351.1796079142419,0.4172392139479906,0.2572802290050702,0.2188424336324347,133660.6567382815,-212.22059461802658,133448.43614366348,1580,44,606.3541666666666,39,9,17,32.40583341727949,0.6514423076923076,41.484375000000014,1034.062500000002,26.51442307692313,0
1606,4,0,0,48,0.0,0.0,1.0,48,1200,900,300,0.75,15,9,6,353.90696662879566,0.4164727393617021,0.2628742489846603,0.22118628606611562,133768.39328342045,-131.6867404513552,133636.7065429691,1581,45,607.3541666666666,39,9,14,32.227473735441215,0.6525106837606836,41.38020833333335,1034.4791666666692,26.525106837606902,0
1607,4,0,0,48,0.0,0.0,1.0,48,1350,1100,250,0.8148148148148148,16,11,5,350.6612812166854,0.4160848847517731,0.26393432310015097,0.21979935828944944,133876.173231337,-210.96191406247698,133665.21131727452,1582,46,608.3541666666666,39,9,14,32.20359419560478,0.6535790598290598,41.27604166666668,1034.8958333333348,26.53579059829064,0
1608,4,0,0,48,0.0,0.0,1.0,48,1350,1100,250,0.8148148148148148,16,11,5,349.09659162216724,0.4158263150118204,0.25934775318578085,0.21962152662812323,134010.95920138908,-243.44618055553602,133767.51302083355,1583,47,609.3541666666666,39,9,15,32.10932260228035,0.6549145299145298,41.14583333333334,1035.4166666666683,26.54914529914534,0
1609,4,0,1,47,0.0,0.020833333333333332,0.9791666666666666,48,1200,900,300,0.75,15,9,6,362.93122340843775,0.4157709072104019,0.23597233949401142,0.22425993682959622,133347.09006557585,80.24957653534736,133427.33964211118,1584,48,610.3541666666666,42,6,16,32.41646339556555,0.6436011904761905,41.78779069767441,1032.848837209301,24.591638981173837,2
1610,4,0,0,47,0.0,0.0,1.0,47,1450,1000,450,0.6896551724137931,19,10,9,363.2284079084289,0.4143732654949121,0.24330816746739936,0.22520161290322585,133472.22222222213,296.4739761733017,133768.69619839542,1585,49,619.9148936170212,37,10,16,32.283266129032256,0.6531531531531531,41.666666666666664,1033.3333333333328,27.927927927927914,0
1611,4,0,0,47,0.0,0.0,1.0,47,950,700,250,0.7368421052631579,12,7,5,361.3915279390298,0.4138529139685476,0.2412024469551839,0.22492149946779583,133613.88991083775,257.3855657509763,133871.27547658872,1586,50,620.9148936170212,37,10,17,32.18870417506274,0.6545608108108109,41.52960526315788,1033.8815789473667,27.94274537695586,0
1612,4,0,0,47,0.0,0.0,1.0,47,1100,700,400,0.6363636363636364,15,7,8,359.4707147911737,0.4135445575084798,0.2489820940846097,0.22470980834880158,133775.99172921694,217.71027375995936,133993.7020029769,1587,51,621.9148936170212,38,9,14,32.075975076594716,0.6543311403508771,41.37286324786325,1034.5085470085476,27.223909131803882,0
1613,4,0,0,47,0.0,0.0,1.0,47,1050,800,250,0.7619047619047619,13,8,5,356.70781601273507,0.41335183472093745,0.24706848593646535,0.22321095727262785,133813.73443593428,146.48099263004792,133960.21542856432,1588,52,622.9148936170212,40,7,14,32.10964869200799,0.6513020833333334,41.33638211382114,1034.6544715447153,25.866361788617883,0
1614,4,0,0,47,0.0,0.0,1.0,47,1150,700,450,0.6086956521739131,16,7,9,354.3150492832897,0.41331329016342894,0.243243469104645,0.22218869839292,133892.60691387395,88.03312347147329,133980.64003734544,1589,53,623.9148936170212,40,7,14,32.0926207776905,0.6520833333333333,41.260162601626014,1034.9593495934955,25.87398373983739,0
1615,4,0,1,46,0.0,0.02127659574468085,0.9787234042553191,47,1050,800,250,0.7619047619047619,13,8,5,352.74018355606495,0.4132554733271662,0.24187679267091933,0.2219137610472964,134010.9592013888,54.21006944443329,134065.16927083323,1590,54,624.9148936170212,41,6,14,32.01500670690811,0.6516768292682927,41.14583333333333,1035.4166666666658,25.254065040650385,0
1616,4,0,1,45,0.0,0.021739130434782608,0.9782608695652174,46,1050,800,250,0.7619047619047619,13,8,5,355.9978944079099,0.4123892914653784,0.23305963375332084,0.2247478847283793,134139.38984158478,350.66806815319126,134490.05790973798,1591,55,607.6086956521739,41,5,15,31.802256911192,0.6529471544715446,41.0218253968254,1035.9126984126985,25.266163375919476,0
1617,4,0,0,45,0.0,0.0,1.0,45,1150,700,450,0.6086956521739131,16,7,9,363.7353721172025,0.4107323232323232,0.25233579665598493,0.22973472015878343,134155.68300118993,759.4334556150608,134915.116456805,1592,56,620.6,40,5,16,31.58557321300112,0.6546874999999999,41.00609756097562,1035.9756097560987,25.899390243902467,0
1618,4,0,0,45,0.0,0.0,1.0,45,1100,900,200,0.8181818181818182,13,9,4,366.5125575707598,0.4105008417508418,0.2540205466766894,0.23232203695861928,134287.31786841518,843.5976642541018,135130.91553266929,1593,57,621.6,40,5,18,31.381957381442632,0.6559895833333333,40.87906504065042,1036.4837398374,25.912093495935,0
1619,4,0,0,45,0.0,0.0,1.0,45,1050,600,450,0.5714285714285714,15,6,9,361.15490293230033,0.4103324915824916,0.25563012677106633,0.22610117872652408,133831.2596450617,667.2795096429925,134498.53915470472,1594,58,622.6,38,7,13,31.97706935123042,0.6548793859649124,41.31944444444444,1034.7222222222222,27.22953216374269,1
1620,4,0,0,45,0.0,0.0,1.0,45,1150,800,350,0.6956521739130435,15,8,7,369.68467852362033,0.409469696969697,0.265217590681891,0.2326612924838265,134024.78723792822,909.382076850022,134934.16931477824,1595,59,623.6,38,7,15,31.56254299078277,0.6567982456140351,41.13247863247863,1035.4700854700852,27.24921277552856,0
1621,4,0,0,45,0.0,0.0,1.0,45,950,600,350,0.631578947368421,13,6,7,370.1270604589689,0.409280303030303,0.26696929055332075,0.23311511351713993,134052.44545118336,923.287516436546,134975.7329676199,1596,60,624.6,38,7,15,31.523393170329093,0.6570723684210527,41.105769230769226,1035.5769230769224,27.252024291497957,0
1622,4,0,1,44,0.0,0.022222222222222223,0.9777777777777777,45,1050,700,350,0.6666666666666666,14,7,7,371.72558143809454,0.40902777777777777,0.27186468646864714,0.23465177328279685,134135.43721236012,972.3146778435009,135107.75189020362,1597,61,625.6,38,7,15,31.398901608910872,0.6578947368421053,41.025641025641015,1035.8974358974344,27.26045883940617,0
1623,4,0,1,43,0.0,0.022727272727272728,0.9772727272727273,44,950,600,350,0.631578947368421,13,6,7,370.51557734042973,0.4075383192389006,0.25492654710454055,0.23406446602411365,134163.10683988954,1141.9041977134796,135305.01103760302,1598,62,613.4545454545455,38,6,15,31.402538585816924,0.6581688596491229,40.99893162393162,1036.0042735042725,27.263270355375592,0
1624,4,0,0,43,0.0,0.0,1.0,43,1300,800,500,0.6153846153846154,18,8,10,370.6594632057045,0.4060077519379845,0.25556389097274335,0.23508172838495628,134307.72705078122,1356.486002604166,135664.21305338538,1599,63,613.953488372093,39,4,17,31.25408250427093,0.6578525641025641,40.859375,1036.5624999999998,26.578525641025635,0
1625,4,0,0,43,0.0,0.0,1.0,43,1000,700,300,0.7,13,7,6,369.8515344029934,0.40589239571797714,0.24903558352162158,0.23491591077938678,134361.72010633672,1338.7776692708283,135700.49777560754,1600,64,614.953488372093,39,4,17,31.22100957835158,0.6583867521367521,40.807291666666664,1036.7708333333328,26.58386752136751,0
1626,4,0,0,43,0.0,0.0,1.0,43,700,400,300,0.5714285714285714,10,4,6,369.70867881353735,0.40526947212993725,0.24971268932138657,0.23534652213987067,134442.73003472216,1340.9288194444393,135783.6588541666,1601,65,615.953488372093,39,4,18,31.14369894201152,0.6591880341880343,40.729166666666664,1037.083333333333,26.591880341880334,0
1627,4,0,0,43,0.0,0.0,1.0,43,1050,700,350,0.6666666666666666,14,7,7,370.90127716729484,0.40490033222591365,0.2544831969286243,0.23700142193904458,134580.80317911942,1383.4119673782475,135964.21514649768,1602,66,616.953488372093,35,8,19,30.974739728574082,0.6681547619047619,40.59606481481481,1037.61574074074,29.646164021163997,0
1628,4,0,2,41,0.0,0.046511627906976744,0.9534883720930233,43,800,500,300,0.625,11,5,6,372.43731503269413,0.40499261720191954,0.2550671120054768,0.23857270294380017,134670.88906035668,1431.2928669410164,136102.1819272977,1603,67,617.953488372093,35,8,19,30.844855783526615,0.669047619047619,40.50925925925926,1037.962962962963,29.65608465608466,0
1629,4,0,0,41,0.0,0.0,1.0,41,1000,600,400,0.6,14,6,8,378.7953103656956,0.40444613821138214,0.2631450205743424,0.24385287770600797,134851.15124528456,2016.1967378257837,136867.34798311035,1604,68,625.219512195122,35,6,16,30.49968427308521,0.6708333333333334,40.335648148148145,1038.657407407407,29.675925925925913,0
1630,4,0,0,41,0.0,0.0,1.0,41,1300,1000,300,0.7692307692307693,16,10,6,377.5150099704381,0.40447154471544716,0.2612514437122089,0.24323023793859871,134881.2066642018,1983.9360157321662,136865.14267993398,1605,69,626.219512195122,35,6,16,30.502901578458687,0.6711309523809523,40.30671296296296,1038.7731481481478,29.679232804232793,0
1631,4,0,0,41,0.0,0.0,1.0,41,800,500,300,0.625,11,5,6,376.547799479539,0.404369918699187,0.25798878309638695,0.24280840862990963,134911.2654320988,1960.1080246913612,136871.37345679014,1606,70,627.219512195122,35,6,16,30.49799465240641,0.6714285714285715,40.27777777777778,1038.8888888888891,29.68253968253969,0
1632,4,0,0,41,0.0,0.0,1.0,41,750,400,350,0.5333333333333333,11,4,7,404.91829059762773,0.404369918699187,0.3100188154974457,0.23912452506802065,131642.3445910226,2586.2644308812723,134228.60902190386,1607,71,628.219512195122,33,8,16,33.05519066953268,0.6433080808080809,43.44362745098039,1026.2254901960775,31.097742127153865,8
1633,4,0,0,41,0.0,0.0,1.0,41,900,600,300,0.6666666666666666,12,6,6,408.6838399128864,0.404395325203252,0.31029001624463604,0.24214662028219,131768.13755526743,2570.3016868512377,134338.43924211868,1608,72,629.219512195122,33,8,16,32.83102570223602,0.644570707070707,43.32107843137256,1026.7156862745114,31.112596553773074,0
1634,4,0,0,41,0.0,0.0,1.0,41,700,400,300,0.5714285714285714,10,4,6,407.37635351815004,0.40401422764227646,0.3090401071075146,0.24177151858938398,131831.05656478298,2540.9710207612698,134372.02758554425,1609,73,630.219512195122,33,8,17,32.80081543357199,0.6452020202020201,43.25980392156864,1026.9607843137271,31.12002376708264,0
1635,4,1,0,42,0.023809523809523808,0.0,1.0,42,1400,900,500,0.6428571428571429,19,9,10,396.4181556153507,0.408415602013163,0.3003771150697163,0.23727398545043565,132153.07716836745,2077.5758219954746,134230.65299036293,1610,0,616.1904761904761,34,8,18,32.75635830342325,0.6461397058823529,42.94642857142858,1028.2142857142865,30.241596638655484,0
1636,4,0,1,41,0.0,0.023809523809523808,0.9761904761904762,42,700,500,200,0.7142857142857143,9,5,4,395.716441300159,0.40847609368950827,0.27438616913492453,0.2282343652303005,130735.62349965701,1953.3982986198564,132689.02179827687,1611,1,617.1904761904761,35,7,15,34.21137015240683,0.6297619047619047,44.3287037037037,1022.6851851851848,29.219576719576708,3
1637,4,0,0,41,0.0,0.0,1.0,41,1300,1000,300,0.7692307692307693,16,10,6,401.02826393774507,0.40421747967479676,0.2848877651293489,0.2312980248142242,130735.62349965704,2285.7360253772245,133021.35952503426,1612,76,633.219512195122,35,6,15,34.07556209446205,0.6297619047619047,44.3287037037037,1022.685185185185,29.219576719576715,0
1638,4,1,0,42,0.023809523809523808,0.0,1.0,42,1200,700,500,0.5833333333333334,17,7,10,402.1173283640672,0.40730255516840885,0.31109355008655126,0.2358910791158215,131387.44882758908,2167.973572530858,133555.42240011995,1613,0,619.1190476190476,35,7,16,33.38554602242794,0.6363095238095239,43.692129629629626,1025.2314814814808,29.292328042328023,0
1639,4,0,0,42,0.0,0.0,1.0,42,1550,1300,250,0.8387096774193549,18,13,5,398.37151176273585,0.40719367015098723,0.3064297800338416,0.23496762819538583,131595.18771701367,2084.7547743055334,133679.9424913192,1614,1,620.1190476190476,35,7,15,33.27093908629441,0.6383928571428572,43.48958333333332,1026.041666666665,29.31547619047614,0
1640,4,0,0,42,0.0,0.0,1.0,42,1100,900,200,0.8181818181818182,13,9,4,400.9696301509724,0.40681862175764616,0.3126740328605391,0.23717314593290786,131703.53366457668,2161.82343661228,133865.35710118897,1615,2,621.1190476190476,36,6,15,33.09448710916072,0.6374421296296298,43.384009009009006,1026.4639639639634,28.51288788788787,0
1641,4,0,0,42,0.0,0.0,1.0,42,1700,1400,300,0.8235294117647058,20,14,6,401.26048895238256,0.40641937669376693,0.3145300216118019,0.23861135464300098,131905.89871966562,2185.7250831913016,134091.62380285692,1616,3,622.1190476190476,36,6,17,32.882043411532564,0.6394675925925927,43.18693693693694,1027.2522522522524,28.53478478478479,0
1642,4,0,0,42,0.0,0.0,1.0,42,1300,900,400,0.6923076923076923,17,9,8,409.31660980648815,0.40604432830042586,0.3167691657668652,0.24470539167802424,132108.41912436084,2414.8340485755994,134523.25317293644,1617,4,623.1190476190476,36,6,17,32.470013144922774,0.6414930555555556,42.98986486486486,1028.0405405405404,28.556681681681678,0
1643,4,0,0,42,0.0,0.0,1.0,42,850,300,550,0.35294117647058826,14,3,11,411.406042625522,0.40629839334107626,0.3107912764753935,0.23916264319381425,131039.71370018701,2382.1060080350976,133421.81970822212,1618,5,624.1190476190476,36,6,15,33.50083406657868,0.6307870370370369,44.03153153153155,1023.8738738738766,28.44094094094102,3
1644,4,0,0,42,0.0,0.0,1.0,42,800,300,500,0.375,13,3,10,411.406042625522,0.4062620983352691,0.3107912764753935,0.23916264319381425,131039.71370018701,2382.1060080350976,133421.81970822212,1619,6,625.1190476190476,36,6,15,33.50083406657868,0.6307870370370369,44.03153153153155,1023.8738738738766,28.44094094094102,0
1645,4,0,0,42,0.0,0.0,1.0,42,1200,900,300,0.75,15,9,6,411.5523605361643,0.40615321331784743,0.3132778344982856,0.23978659315031503,131126.20380092945,2393.059740483748,133519.2635414132,1620,7,626.1190476190476,36,6,15,33.40915338097857,0.6316550925925926,43.94707207207208,1024.211711711713,28.45032532532536,0
1646,4,0,0,42,0.0,0.0,1.0,42,1000,800,200,0.8,12,8,4,409.4784850287526,0.4057781649245064,0.3081687959736741,0.23983739837398382,131328.12500000012,2355.208333333348,133683.33333333346,1621,8,627.1190476190476,36,6,16,33.25711382113821,0.6336805555555556,43.75000000000001,1025.000000000001,28.472222222222246,0
1647,4,0,0,42,0.0,0.0,1.0,42,1050,700,350,0.6666666666666666,14,7,7,406.4442874699347,0.40519744483159115,0.3107167037431082,0.23917060262673084,131506.13667052487,2289.9836033950837,133796.12027391995,1622,9,628.1190476190476,35,7,16,33.154197698036576,0.6374999999999998,43.5763888888889,1025.694444444446,29.3055555555556,0
1648,4,0,0,42,0.0,0.0,1.0,42,1250,1000,250,0.8,15,10,5,401.2610672834284,0.40541521486643434,0.3045951779899758,0.2366271575417035,131587.9662390432,2160.2255549468528,133748.19179399003,1623,10,629.1190476190476,36,6,13,33.204139684630306,0.6362847222222221,43.49662162162163,1026.0135135135142,28.500375375375395,0
1649,4,0,0,42,0.0,0.0,1.0,42,850,500,350,0.5882352941176471,12,5,7,403.44146320731613,0.40541521486643434,0.30689543457018464,0.23827362632587645,131645.7436110097,2222.2702854881954,133868.0138964979,1624,11,630.1190476190476,36,6,13,33.08963385639562,0.6368634259259258,43.44031531531532,1026.2387387387391,28.50663163163164,0
1650,4,0,0,42,0.0,0.0,1.0,42,800,600,200,0.75,10,6,4,407.628236982996,0.40518534649632215,0.3124699638521491,0.2412947408011033,131732.43344696047,2339.5719198928687,134072.00536685332,1625,12,631.1190476190476,36,6,14,32.894315854907134,0.6377314814814814,43.35585585585586,1026.5765765765766,28.516016016016017,0
1651,4,0,0,42,0.0,0.0,1.0,42,850,600,250,0.7058823529411765,11,6,5,407.73594491005053,0.40541521486643434,0.3105160906213762,0.241725380083865,131790.24252292843,2347.123813002199,134137.36633593062,1626,13,632.1190476190476,36,6,14,32.83294947722453,0.6383101851851851,43.29954954954955,1026.8018018018026,28.522272272272296,0
1652,4,0,0,42,0.0,0.0,1.0,42,1450,1300,150,0.896551724137931,16,13,3,409.80343441675325,0.4054757065427797,0.3145410121070684,0.24350600164919917,131876.97991488117,2408.7278579255,134285.70777280667,1627,14,633.1190476190476,36,6,14,32.691956291342336,0.6391782407407407,43.215090090090094,1027.13963963964,28.53165665665667,0
1653,4,0,0,42,0.0,0.0,1.0,42,1050,700,350,0.6666666666666666,14,7,7,380.04378647054693,0.40533052651955087,0.27638728222385867,0.20974093822103473,129011.37689248657,1407.0216440419513,130418.39853652852,1628,15,634.1190476190476,38,4,17,36.36795842535143,0.6066337719298246,46.02029914529914,1015.9188034188027,26.734705353126387,6
1654,4,2,2,42,0.045454545454545456,0.045454545454545456,0.9545454545454546,44,1000,600,400,0.6,14,6,8,362.9031262297897,0.4105443974630021,0.2620699858730098,0.20235886265881242,129418.71667031923,593.5710241799985,130012.28769449923,1629,0,606.25,38,6,17,36.38811598768024,0.6107456140350876,45.61965811965812,1017.5213675213674,26.776878092667562,0
1655,4,0,0,42,0.0,0.0,1.0,42,850,500,350,0.5882352941176471,12,5,7,375.8587188511939,0.40520954316686025,0.2706747158024354,0.20800139572026816,129119.9380547338,1306.1708990795578,130426.10895381335,1630,17,636.1190476190476,38,4,17,36.36339745611268,0.6077302631578947,45.91346153846154,1016.3461538461544,26.74595141700406,0
1656,4,1,1,42,0.023255813953488372,0.023255813953488372,0.9767441860465116,43,1350,1000,350,0.7407407407407407,17,10,7,367.36487341429546,0.408937799926172,0.2633687091744914,0.20458651233720482,129368.6579043552,905.1514911962015,130273.8093955514,1631,0,622.3023255813954,37,6,17,36.32562693109149,0.6120495495495495,45.66885964912281,1017.3245614035088,27.49525841631105,0
1657,4,2,1,43,0.045454545454545456,0.022727272727272728,0.9772727272727273,44,1400,1200,200,0.8571428571428571,16,12,4,363.1385000660195,0.4093772022551092,0.2726891477153588,0.2044636962000998,129799.47973738021,627.0376762363777,130426.51741361659,1632,0,609.1136363636364,38,6,12,35.99461801915146,0.6145833333333335,45.24572649572649,1019.0170940170927,26.816239316239283,0
1658,4,0,0,43,0.0,0.0,1.0,43,1300,800,500,0.6153846153846154,18,8,10,369.4475696983114,0.40653839055001845,0.27540491150774815,0.20750712953429912,129703.52055440108,983.7300900276721,130687.25064442876,1633,1,624.2790697674419,37,6,13,35.93155722999639,0.615427927927928,45.33991228070174,1018.6403508771908,27.53082029397813,0
1659,4,1,0,44,0.022727272727272728,0.0,1.0,44,1750,1200,550,0.6857142857142857,23,12,11,328.43390699621017,0.4106434989429175,0.21275021075538603,0.18238898523849428,129257.13320444764,-191.46179593720285,129065.67140851045,1634,0,611.0681818181819,37,7,17,37.42901301128603,0.6109234234234233,45.77850877192983,1016.8859649122817,27.483404457088692,7
1660,4,0,1,43,0.0,0.022727272727272728,0.9772727272727273,44,1300,1000,300,0.7692307692307693,16,10,6,327.5346985569092,0.40986169837914027,0.20913157662645587,0.18227590872900123,129340.77222077965,-327.28183190980474,129013.49038886985,1635,1,612.0681818181819,37,7,17,37.36694243828823,0.611768018018018,45.69627192982457,1017.2149122807032,27.49229492650549,0
1661,4,1,0,44,0.022727272727272728,0.0,1.0,44,1050,800,250,0.7619047619047619,13,8,5,329.1598598564411,0.4089807963354475,0.2339154816547433,0.18474718659857903,129675.59880203531,-263.19961430439344,129412.39918773092,1636,0,612.9772727272727,37,7,17,36.98583898517962,0.6151463963963963,45.367324561403514,1018.5307017543865,27.527856804172607,0
1662,4,1,0,45,0.022222222222222223,0.0,1.0,45,1750,1300,450,0.7428571428571429,22,13,9,325.157449357698,0.4105218855218855,0.23802812106356264,0.1841305139769358,130023.43885633672,-544.3820529513946,129479.05680338533,1637,0,600.3333333333334,39,6,18,36.735373472236404,0.6151175213675215,45.026041666666664,1019.8958333333327,26.1511752136752,0
1663,4,1,0,46,0.021739130434782608,0.0,1.0,46,1150,600,550,0.5217391304347826,17,6,11,316.36344076271405,0.41392914653784224,0.2332799541424222,0.1805065912459257,130317.12420784927,-954.0457859355711,129363.0784219137,1638,0,588.2608695652174,38,8,19,36.66269924313765,0.6197916666666667,44.73824786324786,1021.0470085470077,26.869658119658098,0
1664,4,0,0,46,0.0,0.0,1.0,46,1050,800,250,0.7619047619047619,13,8,5,318.3211513945564,0.4134259259259259,0.23364050269038517,0.18187877383027867,130371.67302441732,-899.9877867265755,129471.68523769075,1639,1,589.2608695652174,38,8,19,36.55760714161175,0.6203399122807018,44.684829059829056,1021.2606837606829,26.87528115159692,0
1665,4,1,1,46,0.02127659574468085,0.02127659574468085,0.9787234042553191,47,700,400,300,0.5714285714285714,10,4,6,310.7816567239354,0.41620413197656486,0.2298817677809073,0.1786584884260092,130608.41064453125,-1281.8603515625005,129326.55029296875,1640,0,577.7021276595744,39,8,14,36.51119688168757,0.6209935897435898,44.453125,1022.1875,26.209935897435898,0
1666,4,1,2,45,0.02127659574468085,0.0425531914893617,0.9574468085106383,47,1200,600,600,0.5,18,6,12,310.0003535838996,0.41489361702127664,0.2277651015291675,0.17894729405292817,130768.17626953115,-1292.3638237847363,129475.81244574641,1641,0,578.6808510638298,39,8,14,36.37006908374917,0.622596153846154,44.29687499999999,1022.8124999999992,26.22596153846152,0
1667,4,0,0,45,0.0,0.0,1.0,45,850,600,250,0.7058823529411765,11,6,5,322.7066329089604,0.40902777777777777,0.23667042116654624,0.18597217298567895,130703.86860499681,-564.198930861275,130139.66967413554,1642,5,605.3333333333334,40,5,13,36.110075862982846,0.6203125000000002,44.35975609756097,1022.5609756097543,25.56402439024386,1
1668,4,2,1,46,0.0425531914893617,0.02127659574468085,0.9787234042553191,47,1500,1100,400,0.7333333333333333,19,11,8,312.2122158206156,0.413640918902251,0.2480912803512476,0.1825201721985346,131255.33679300075,-1204.0960923152284,130051.24070068552,1643,0,580.531914893617,43,4,17,35.82280211317497,0.6213662790697676,43.82102272727271,1024.7159090909067,23.83060253699783,0
1669,4,0,2,44,0.0,0.043478260869565216,0.9565217391304348,46,1250,900,350,0.72,16,9,7,295.06219113421344,0.4138486312399356,0.14595243150561443,0.17604782629904428,132032.7845661873,-1408.4032799586953,130624.3812862286,1644,1,589.7391304347826,43,3,15,35.48222073773765,0.6291182170542636,43.06344696969696,1027.7462121212109,23.901074700493275,6
1670,4,0,0,44,0.0,0.0,1.0,44,1450,1000,450,0.6896551724137931,19,10,9,306.24054312895134,0.4066574171952079,0.1703459442382116,0.1826336088815661,132015.40577168346,-714.3060870181655,131301.0996846653,1645,2,617.1590909090909,41,3,15,35.21243604595038,0.6318597560975611,43.08035714285713,1027.6785714285697,25.06533101045292,0
1671,4,0,0,44,0.0,0.0,1.0,44,1200,700,500,0.5833333333333334,17,7,10,306.58080192040615,0.40574348132487664,0.16803623734937712,0.18370038108132516,132193.88247197008,-694.3787005543118,131499.50377141577,1646,3,618.1590909090909,41,3,15,35.02476043475465,0.633638211382114,42.906746031746025,1028.3730158730143,25.082268679829617,0
1672,4,0,0,44,0.0,0.0,1.0,44,1150,800,350,0.6956521739130435,15,8,7,316.431840798832,0.405831571529246,0.18925699567011667,0.18624652339187658,131515.04041883667,-476.5757927158212,131038.46462612084,1647,4,619.1590909090909,39,5,16,35.45337412409872,0.6300747863247864,43.56770833333333,1025.7291666666656,26.300747863247835,1
1673,4,0,0,44,0.0,0.0,1.0,44,700,400,300,0.5714285714285714,10,4,6,315.71027339019327,0.4061068534178999,0.19439317028149583,0.18621234687984442,131595.18771701376,-490.8094618055651,131104.3782552082,1648,5,620.1590909090909,39,5,15,35.391285956006776,0.6308760683760685,43.48958333333333,1026.0416666666656,26.308760683760656,0
1674,4,0,0,44,0.0,0.0,1.0,44,1050,600,450,0.5714285714285714,15,6,9,314.1918282549335,0.4056884249471459,0.18948927062383603,0.18583711138199957,131702.08875868045,-524.0559895833375,131178.0327690971,1649,6,621.1590909090909,39,5,15,35.32279615722888,0.6319444444444444,43.385416666666664,1026.4583333333326,26.319444444444425,0
1675,4,0,0,44,0.0,0.0,1.0,44,1150,800,350,0.6956521739130435,15,8,7,313.2952792344544,0.4056553911205074,0.1846611083955101,0.18569762882826343,131782.29302300359,-542.6459418402682,131239.6470811633,1650,7,622.1590909090909,39,5,15,35.26523029319265,0.6327457264957265,43.30729166666667,1026.7708333333344,26.327457264957292,0
1676,4,0,0,44,0.0,0.0,1.0,44,1050,700,350,0.6666666666666666,14,7,7,312.54073619385946,0.40590865045806906,0.1849582249764845,0.18538066049332536,131809.033203125,-560.8615451388889,131248.17165798612,1651,8,623.1590909090909,39,5,15,35.25774328802328,0.6330128205128205,43.28125,1026.875,26.330128205128204,0
1677,4,0,0,44,0.0,0.0,1.0,44,750,400,350,0.5333333333333333,11,4,7,317.3376863543918,0.40544617688513035,0.19223004738113225,0.18875659003781747,131916.0210503473,-427.6150173611062,131488.4060329862,1652,9,624.1590909090909,39,5,15,35.02712431555464,0.6340811965811965,43.177083333333336,1027.2916666666672,26.34081196581198,0
1678,4,0,0,44,0.0,0.0,1.0,44,1750,1500,250,0.8571428571428571,20,15,5,317.3894467231262,0.4048075229034531,0.19378305659473294,0.18932069415782135,132023.05230034728,-419.45529513887743,131603.5970052084,1653,10,625.1590909090909,39,5,16,34.91832218393135,0.6351495726495726,43.07291666666667,1027.708333333334,26.35149572649574,0
1679,4,0,0,44,0.0,0.0,1.0,44,1050,800,250,0.7619047619047619,13,8,5,315.82105457869716,0.40421291402396053,0.19623810507965866,0.18895101177839632,132136.6572993094,-453.69230864563576,131682.96499066375,1654,11,626.1590909090909,40,4,16,34.84460973279299,0.6346354166666666,42.962398373983746,1028.150406504066,25.70376016260165,0
1680,4,0,0,44,0.0,0.0,1.0,44,1200,800,400,0.6666666666666666,16,8,8,316.1562112902123,0.4038385306553911,0.19775355092580127,0.1894129486113474,132188.90587819752,-441.53126859012036,131747.3746096074,1655,12,627.1590909090909,40,4,16,34.78357545211978,0.63515625,42.91158536585366,1028.3536585365855,25.708841463414636,0
1681,4,0,0,44,0.0,0.0,1.0,44,650,400,250,0.6153846153846154,9,4,5,318.4275327327989,0.40386055320648345,0.20258283856248505,0.1910376442672589,132241.16478493286,-378.15443436446844,131863.0103505684,1656,13,628.1590909090909,40,4,16,34.672751375028824,0.6356770833333334,42.860772357723576,1028.5569105691054,25.713922764227636,0
1682,4,0,0,44,0.0,0.0,1.0,44,1150,800,350,0.6956521739130435,15,8,7,318.93099222679473,0.40423493657505283,0.20211223344556672,0.19187024933430163,132345.71358194525,-358.1700500694047,131987.54353187585,1657,14,629.1590909090909,40,4,17,34.55493827160493,0.63671875,42.75914634146341,1028.9634146341461,25.724085365853654,0
1683,4,0,0,44,0.0,0.0,1.0,44,1000,700,300,0.7,13,7,6,319.56122014968963,0.40476347780126853,0.2048029873808912,0.19306498166011785,132505.23003472204,-331.28307493061607,132173.9469597914,1658,15,630.1590909090909,39,5,18,34.37879401052205,0.6399572649572651,42.60416666666666,1029.583333333332,26.39957264957261,0
1684,4,0,1,43,0.0,0.022727272727272728,0.9772727272727273,44,550,300,250,0.5454545454545454,8,3,5,318.8933706829319,0.40431201550387597,0.19667469680112548,0.19307402057208484,132585.67843967007,-343.8612196180595,132241.817220052,1659,16,631.1590909090909,39,5,18,34.31536782306733,0.6407585470085471,42.526041666666664,1029.8958333333328,26.407585470085458,0
1685,4,0,0,43,0.0,0.0,1.0,43,1600,1100,500,0.6875,21,11,10,317.3337098544437,0.4046926910299003,0.19205498837561863,0.1929552791389068,132746.64849175356,-175.0027126736021,132571.64577907996,1660,17,636.9302325581396,39,4,14,34.19431668856766,0.642361111111111,42.36979166666667,1030.5208333333342,26.423611111111132,0
1686,4,0,0,43,0.0,0.0,1.0,43,1250,1100,150,0.88,14,11,3,321.0279158423195,0.4044619785898856,0.20236951348151178,0.19604289567693547,132907.7162000869,-66.5825737847137,132841.13362630218,1661,18,637.9302325581396,39,4,14,33.93787672155436,0.6439636752136751,42.21354166666667,1031.1458333333342,26.439636752136774,0
1687,4,0,0,43,0.0,0.0,1.0,43,1100,900,200,0.8181818181818182,13,9,4,322.9218549419128,0.4039544112218531,0.2088373032462314,0.19762498193045874,132988.28667534742,-11.03515624997641,132977.25151909745,1662,19,638.9302325581396,39,4,15,33.80840570928434,0.6447649572649572,42.13541666666668,1031.458333333335,26.447649572649617,0
1688,4,0,0,43,0.0,0.0,1.0,43,1450,1200,250,0.8275862068965517,17,12,5,323.0885334431038,0.4037236987818383,0.21151225768037252,0.19848542390288712,133131.14636005374,2.629366613807008,133133.77572666755,1663,20,639.9302325581396,40,3,15,33.66116855407844,0.64453125,41.996951219512205,1032.0121951219528,25.80030487804882,0
1689,4,0,0,43,0.0,0.0,1.0,43,950,500,450,0.5263157894736842,14,5,9,324.59709924403273,0.4041851236618679,0.21962298016914072,0.19983377782550865,133209.81744497357,47.9040666931391,133257.7215116667,1664,21,640.9302325581396,40,3,15,33.54355352103432,0.6453124999999998,41.92073170731709,1032.3170731707344,25.80792682926836,0
1690,4,0,0,43,0.0,0.0,1.0,43,1050,700,350,0.6666666666666666,14,7,7,323.7511920688854,0.40374677002583975,0.220221869757371,0.19973502505233456,133288.51176754935,30.46291476637049,133318.97468231572,1665,22,641.9302325581396,40,3,16,33.48669750352656,0.6460937499999999,41.844512195121965,1032.6219512195144,25.81554878048786,0
1691,4,0,0,43,0.0,0.0,1.0,43,1350,1000,350,0.7407407407407407,17,10,7,327.825410969858,0.4029854189737911,0.226710440522083,0.20282077312894758,133393.47367844882,145.95406586689222,133539.4277443157,1666,23,642.9302325581396,40,3,16,33.27656173143138,0.6471354166666666,41.742886178861795,1033.028455284554,25.825711382113848,0
1692,4,0,0,43,0.0,0.0,1.0,43,700,500,200,0.7142857142857143,9,5,4,324.7700066700595,0.402547065337763,0.22085589263943284,0.20121490906852527,133445.97012566947,67.84972156126128,133513.81984723074,1667,24,643.9302325581396,40,3,16,33.30300645880463,0.6476562499999999,41.69207317073172,1033.2317073170748,25.83079268292687,0
1693,4,0,0,43,0.0,0.0,1.0,43,1100,700,400,0.6363636363636364,15,7,8,323.54481565061235,0.40275470653377626,0.2261755353317827,0.20131017795802356,133603.52143441432,45.34534255406396,133648.86677696838,1668,25,644.9302325581396,40,3,18,33.177283004030286,0.6492187499999998,41.53963414634148,1033.8414634146363,25.84603658536591,0
1694,4,0,0,43,0.0,0.0,1.0,43,950,600,350,0.631578947368421,13,6,7,324.95074583078605,0.40132428940568476,0.2256812361062559,0.20304933344454112,133761.16569378367,93.15811107808275,133854.32380486175,1669,26,645.9302325581396,40,3,16,32.98355273929987,0.6507812499999999,41.38719512195123,1034.4512195121968,25.86128048780492,0
1695,4,1,1,43,0.022727272727272728,0.022727272727272728,0.9772727272727273,44,1250,1000,250,0.8,15,10,5,322.4798520280087,0.40455426356589147,0.22048066875653016,0.2033025154089622,134088.01020408177,-151.86366213150956,133936.14654195026,1670,0,632.2272727272727,41,3,17,32.72150383141762,0.6524390243902438,41.07142857142858,1035.7142857142867,25.26132404181187,0
1696,4,0,0,43,0.0,0.0,1.0,43,1000,600,400,0.6,14,6,8,331.04143862175533,0.40155500184569953,0.22484728956090594,0.2081882825110152,133997.80636525888,271.76531826294735,134269.57168352182,1671,28,647.9302325581396,40,3,18,32.589811542991754,0.653125,41.15853658536586,1035.3658536585374,25.884146341463435,0
1697,4,0,0,43,0.0,0.0,1.0,43,1100,700,400,0.6363636363636364,15,7,8,328.9192960248636,0.4007475083056478,0.22016477336247586,0.20759593711340182,134129.36377363026,223.54718173707477,134352.91095536735,1672,29,648.9302325581396,40,3,18,32.51353052748618,0.6544270833333332,41.03150406504066,1035.8739837398386,25.896849593495965,0
1698,4,0,0,43,0.0,0.0,1.0,43,1050,900,150,0.8571428571428571,12,9,3,325.3061436893305,0.39991694352159474,0.21791778597718636,0.20605416480396233,134260.98573104636,135.18470321898423,134396.17043426534,1673,30,649.9302325581396,40,3,18,32.47593482382167,0.6557291666666667,40.90447154471545,1036.3821138211383,25.90955284552846,0
1699,4,0,0,43,0.0,0.0,1.0,43,1350,1000,350,0.7407407407407407,17,10,7,323.43591706029076,0.39883259505352525,0.21810274679813735,0.20560851475178488,134392.67223750753,93.48343826426776,134486.1556757718,1674,31,650.9302325581396,40,3,18,32.3932503512039,0.65703125,40.77743902439025,1036.8902439024396,25.92225609756099,0
1700,4,0,0,43,0.0,0.0,1.0,43,1000,600,400,0.6,14,6,8,323.21702010663967,0.3984865263935031,0.22344446697546805,0.206063468096719,134498.06791798866,94.41294451054881,134592.48086249921,1675,32,651.9302325581396,40,3,18,32.29401391202117,0.6580729166666666,40.675813008130085,1037.29674796748,25.932418699187004,0
1701,4,0,0,43,0.0,0.0,1.0,43,1250,900,350,0.72,16,9,7,325.2933203860514,0.398140457733481,0.2249678425480086,0.20859204442834364,134708.9832131171,163.98648704474175,134872.96970016186,1676,33,652.9302325581396,40,3,19,32.03030673845652,0.66015625,40.47256097560975,1038.1097560975604,25.95274390243901,0
1702,4,0,0,43,0.0,0.0,1.0,43,800,500,300,0.625,11,5,6,323.39930490455527,0.3979789590254707,0.2191039490961888,0.2079809626695814,134814.5028277645,119.78330111044437,134934.28612887493,1677,34,653.9302325581396,40,3,16,31.974549042633,0.6611979166666667,40.37093495934959,1038.5162601626012,25.962906504065028,0
1703,4,1,0,44,0.022727272727272728,0.0,1.0,44,800,400,400,0.5,12,4,8,319.0750237950854,0.4006782945736434,0.22394789579158347,0.20677719074512652,135091.6883680554,-179.12326388890858,134912.56510416648,1678,0,640.0454545454545,41,3,17,31.81153974615896,0.6623475609756098,40.10416666666666,1039.583333333332,25.355691056910533,0
1704,4,0,0,44,0.0,0.0,1.0,44,1500,1100,400,0.7333333333333333,19,11,8,320.77163510867376,0.39979739252995067,0.2278602586005054,0.20847173284837095,135194.84131905058,-126.66593836610457,135068.17538068446,1679,1,641.0454545454545,41,3,18,31.665056917549048,0.6633638211382115,40.00496031746031,1039.9801587301572,25.365369725125785,0
1705,4,0,0,44,0.0,0.0,1.0,44,700,500,200,0.7142857142857143,9,5,4,322.8556634145246,0.39940098661028894,0.2343672779295103,0.21012673065805623,135246.43255739773,-66.98465844673606,135179.44789895098,1680,2,642.0454545454545,41,3,18,31.559668574153548,0.6638719512195121,39.95535714285713,1040.1785714285695,25.370209059233403,0
1706,4,0,0,44,0.0,0.0,1.0,44,700,300,400,0.42857142857142855,11,3,8,321.7997828880877,0.3994119978858351,0.23070154144920507,0.20958959772450222,135272.23186728384,-93.88503086420931,135178.34683641963,1681,3,643.0454545454545,41,3,18,31.56152647975077,0.6641260162601625,39.93055555555555,1040.277777777777,25.372628726287243,0
1707,4,0,0,44,0.0,0.0,1.0,44,900,600,300,0.6666666666666666,12,6,6,320.70817820049257,0.39958817829457366,0.22805702400554706,0.20947875400517826,135375.45371157696,-116.79697341902124,135258.65673815794,1682,4,644.0454545454545,41,3,19,31.487527804258026,0.6651422764227644,39.831349206349195,1040.6746031746013,25.382307394502472,0
1708,4,0,1,43,0.0,0.022727272727272728,0.9772727272727273,44,1200,1000,200,0.8333333333333334,14,10,4,321.8927954303884,0.3989605355884425,0.23284897570271568,0.2110096744560851,135504.53637762953,-76.41319838122877,135428.1231792483,1683,5,645.0454545454545,41,3,19,31.32870811497538,0.6664126016260163,39.70734126984126,1041.1706349206331,25.394405729771538,0
1709,4,0,0,43,0.0,0.0,1.0,43,800,500,300,0.625,11,5,6,333.4430655238572,0.39846345514950166,0.2480682350910659,0.21463917406961788,134848.14588758678,392.897340866318,135241.0432284531,1684,6,656.7674418604652,39,4,13,31.680310400160458,0.6631944444444444,40.338541666666664,1038.6458333333333,26.631944444444443,1
1710,4,0,0,43,0.0,0.0,1.0,43,1150,700,450,0.6086956521739131,16,7,9,334.6025650012315,0.3977482465854559,0.2506480669886797,0.21619139821582162,134983.42013888893,433.1597222222278,135416.57986111115,1685,7,657.7674418604652,39,4,14,31.51563753007218,0.6645299145299146,40.208333333333336,1039.166666666667,26.645299145299152,0
1711,4,0,0,43,0.0,0.0,1.0,43,900,500,400,0.5555555555555556,13,5,8,336.34403074686435,0.3977251753414544,0.253530316446847,0.21796840434114995,135091.68836805565,487.4565972222327,135579.14496527787,1686,8,658.7674418604652,39,4,15,31.362725450901802,0.6655982905982906,40.10416666666667,1039.5833333333342,26.655982905982928,0
1712,4,0,0,43,0.0,0.0,1.0,43,1000,700,300,0.7,13,7,6,333.4566074950691,0.39703303802141016,0.24877012522361386,0.21674679487179488,135200.0,416.66666666666697,135616.66666666666,1687,9,659.7674418604652,39,4,16,31.330128205128215,0.6666666666666666,40.0,1040.0,26.666666666666668,0
1713,4,0,0,43,0.0,0.0,1.0,43,1250,1000,250,0.8,15,10,5,331.9317591714485,0.396640826873385,0.24479588986024736,0.21661244628148263,135342.7205718323,384.90946609162,135727.63003792393,1688,10,660.7674418604652,40,3,16,31.228025197773235,0.6664062499999999,39.862804878048784,1040.5487804878053,26.01371951219513,0
1714,4,0,0,43,0.0,0.0,1.0,43,1250,700,550,0.56,18,7,11,329.7884992972827,0.3960179032853452,0.2409140656575972,0.21568925988523463,135422.04231112453,332.12642111179093,135754.1687322363,1689,11,661.7674418604652,40,3,16,31.205046214931983,0.6671874999999999,39.78658536585367,1040.853658536587,26.02134146341468,0
1715,4,0,0,43,0.0,0.0,1.0,43,900,500,400,0.5555555555555556,13,5,8,329.27786333227783,0.3959256183093392,0.24455147556164847,0.21599110036507796,135527.84077764562,325.263566660062,135853.10434430567,1690,12,662.7674418604652,40,3,16,31.11336131173142,0.6682291666666667,39.6849593495935,1041.2601626016262,26.031504065040657,0
1716,4,0,0,43,0.0,0.0,1.0,43,700,500,200,0.7142857142857143,9,5,4,328.90710374033324,0.3960179032853452,0.2454388961630234,0.21591856585129932,135556.18666737524,317.0785501700672,135873.2652175453,1691,13,663.7674418604652,41,2,16,31.09489616080786,0.6669207317073171,39.657738095238095,1041.3690476190473,25.399245063879203,0
1717,4,0,0,43,0.0,0.0,1.0,43,1150,800,350,0.6956521739130435,15,8,7,325.7676101148459,0.394702842377261,0.23909106337866004,0.21480905761231425,135715.07297092033,242.35928420849558,135957.43225512884,1692,14,664.7674418604652,39,4,18,31.019131760471854,0.6717414529914529,39.50520833333334,1041.9791666666683,26.717414529914574,0
1718,4,0,0,43,0.0,0.0,1.0,43,1250,800,450,0.64,17,8,9,324.33845090194825,0.3944259874492433,0.2403658468573977,0.21468116512081337,135850.78125000003,212.32638888889022,136063.1076388889,1693,15,665.7674418604652,39,4,21,30.921929123367974,0.6730769230769231,39.375,1042.5000000000002,26.730769230769237,0
1719,4,0,0,43,0.0,0.0,1.0,43,1350,1100,250,0.8148148148148148,16,11,5,323.2631504359776,0.39421834625323,0.2403178217131705,0.21429563813669786,135905.08355034728,186.62109375001063,136091.70464409728,1694,16,666.7674418604652,39,4,14,30.89618714618715,0.673611111111111,39.32291666666667,1042.708333333334,26.736111111111125,0
1720,4,0,0,43,0.0,0.0,1.0,43,1100,800,300,0.7272727272727273,14,8,6,324.24254574762466,0.3934339239571798,0.2427349652805313,0.21570639871026354,136030.94765227378,221.4041534470262,136252.3518057208,1695,17,667.7674418604652,40,3,15,30.74606267251177,0.6731770833333333,39.202235772357724,1043.1910569105692,26.07977642276423,0
1721,4,0,0,43,0.0,0.0,1.0,43,1000,600,400,0.6,14,6,8,327.307353200092,0.3925110741971207,0.24907980184877654,0.21807038256361755,136083.96049185353,308.25618431490227,136392.21667616843,1696,18,668.7674418604652,40,3,15,30.613657024122585,0.6736979166666666,39.15142276422765,1043.3943089430904,26.08485772357726,0
1722,4,0,0,43,0.0,0.0,1.0,43,850,600,250,0.7058823529411765,11,6,5,331.3145677448783,0.3920035068290882,0.25518456132724787,0.2215666171793873,136216.53777513385,426.10466653446946,136642.64244166831,1697,19,669.7674418604652,40,3,15,30.37788811007269,0.675,39.02439024390244,1043.90243902439,26.097560975609753,0
1723,4,1,0,44,0.022727272727272728,0.0,1.0,44,700,400,300,0.5714285714285714,10,4,6,326.05442378686877,0.3943027660324172,0.25573036229007373,0.2198884315090187,136513.49226033,102.1656116150061,136615.657871945,1698,0,655.5227272727273,41,3,16,30.221584076957154,0.6763211382113821,38.74007936507936,1045.039682539682,25.488772744870293,0
1724,4,0,0,44,0.0,0.0,1.0,44,1250,600,650,0.48,19,6,13,326.9761530728601,0.39379624735729385,0.25449455649683417,0.22116012202065458,136617.18651580997,134.11241811538787,136751.29893392537,1699,1,656.5227272727273,41,3,16,30.09505282469792,0.6773373983739838,38.64087301587301,1045.4365079365075,25.498451413085547,0
1725,4,0,0,44,0.0,0.0,1.0,44,1000,700,300,0.7,13,7,6,327.10758599934906,0.3937191684284707,0.2552273374220433,0.22141212902036858,136643.11623086725,139.3999787414873,136782.51620960873,1700,2,657.5227272727273,41,3,17,30.066004839168798,0.6775914634146343,38.61607142857142,1045.5357142857135,25.500871080139355,0
1726,4,0,0,44,0.0,0.0,1.0,44,1600,1500,100,0.9375,17,15,2,326.16802414558174,0.3927611874559549,0.24825296678826536,0.22178100653311275,136802.63807508672,124.1735203195806,136926.8115954063,1701,3,658.5227272727273,39,5,19,29.933058681005008,0.6824252136752137,38.463541666666664,1046.1458333333328,26.824252136752122,0
1727,4,0,0,44,0.0,0.0,1.0,44,1550,1000,550,0.6451612903225806,21,10,11,323.7580632074326,0.3917591613812544,0.23979444122756255,0.22100006923289947,136938.88888888876,67.01388888887942,137005.90277777764,1702,4,659.5227272727273,39,5,20,29.861664012738856,0.6837606837606838,38.33333333333333,1046.6666666666656,26.83760683760681,0
1728,4,0,0,44,0.0,0.0,1.0,44,1550,1300,250,0.8387096774193549,18,13,5,328.01230229646325,0.3921555673009161,0.24119301227914747,0.2249546853539318,137102.47938368047,194.2599826388794,137296.73936631935,1703,5,660.5227272727273,39,5,13,29.588969564352492,0.6853632478632479,38.17708333333333,1047.291666666666,26.853632478632463,0
1729,4,0,0,44,0.0,0.0,1.0,44,1100,900,200,0.8181818181818182,13,9,4,327.5841647665835,0.39197938689217754,0.23783960942091276,0.22483677656846388,137129.75396050338,184.30718315971836,137314.0611436631,1704,6,661.5227272727273,39,5,13,29.573284435604187,0.6856303418803419,38.151041666666664,1047.3958333333328,26.856303418803407,0
1730,4,0,0,44,0.0,0.0,1.0,44,950,700,250,0.7368421052631579,12,7,5,328.9575231087545,0.39174815010570824,0.2603173160628698,0.21693846926457264,135719.3574585448,132.57157550879157,135851.9290340536,1705,7,662.5227272727273,37,7,19,30.931789084148857,0.6753941441441442,39.50109649122806,1041.9956140350866,28.16204362256991,3
1731,4,0,0,44,0.0,0.0,1.0,44,950,500,450,0.5263157894736842,14,5,9,328.1933745422805,0.3921335447498238,0.2570305325987148,0.21660762719790505,135747.92243767309,110.3137503847338,135858.2361880578,1706,8,663.5227272727273,37,7,19,30.923383136924812,0.6756756756756757,39.473684210526315,1042.1052631578943,28.165007112375523,0
1732,4,0,0,44,0.0,0.0,1.0,44,850,600,250,0.7058823529411765,11,6,5,326.78157983796007,0.39214455602536996,0.25483477595523896,0.21584843060179348,135776.49042253377,73.85120902584111,135850.3416315596,1707,9,664.5227272727273,37,7,19,30.93185604068033,0.6759572072072072,39.446271929824555,1042.214912280701,28.167970602181107,0
1733,4,0,0,44,0.0,0.0,1.0,44,750,500,250,0.6666666666666666,10,5,5,327.2048442416691,0.39170410500352365,0.2553155310406521,0.2164432315434551,135828.50652211616,88.74906402950279,135917.25558614568,1708,10,665.5227272727273,38,6,19,30.86929042396912,0.6746162280701755,39.396367521367516,1042.4145299145289,27.431961313540235,0
1734,4,0,0,44,0.0,0.0,1.0,44,1400,1100,300,0.7857142857142857,17,11,6,331.7216501349199,0.39153893587033123,0.2631027546516176,0.2202902550079651,135967.75353385927,220.689513477971,136188.44304733723,1709,11,666.5227272727273,38,6,14,30.613603769719326,0.6759868421052632,39.26282051282051,1042.9487179487176,27.446018893387304,0
1735,4,0,0,44,0.0,0.0,1.0,44,750,500,250,0.6666666666666666,10,5,5,334.77316004445487,0.39106545102184637,0.2673718754363916,0.22283980285167704,136051.33598372777,309.26713510847696,136360.60311883624,1710,12,667.5227272727273,38,6,14,30.451228878648237,0.6768092105263158,39.18269230769231,1043.2692307692305,27.454453441295538,0
1736,4,0,0,44,0.0,0.0,1.0,44,1300,1000,300,0.7692307692307693,16,10,6,333.62873795171953,0.3912085976039465,0.2626580511904433,0.2231270635541582,136218.5779298159,289.2864480604867,136507.86437787637,1711,13,668.5227272727273,38,6,16,30.315474362910653,0.678453947368421,39.0224358974359,1043.9102564102564,27.47132253711201,0
1737,4,0,0,44,0.0,0.0,1.0,44,1200,800,400,0.6666666666666666,16,8,8,337.3948115089215,0.39099938336856943,0.2451999156029112,0.21830480670942445,135034.6996792283,312.92596530043454,135347.62564452874,1712,14,669.5227272727273,37,7,16,31.392090410380835,0.6686373873873873,40.15899122807018,1039.36403508772,28.090919867235673,2
1738,4,0,0,44,0.0,0.0,1.0,44,800,500,300,0.625,11,5,6,334.77768911725985,0.3904818534178999,0.24295869162999795,0.21729615509233252,135148.68907981314,248.9531634733911,135397.64224328654,1713,15,670.5227272727273,37,7,17,31.346774051812005,0.6697635135135135,40.049342105263165,1039.8026315789484,28.102773826458066,0
1739,4,0,0,44,0.0,0.0,1.0,44,1200,1000,200,0.8333333333333334,14,10,4,334.52703292864,0.3895128611698379,0.24763320791358145,0.21787891101178392,135272.2318672841,250.44367283952397,135522.67554012363,1714,16,671.5227272727273,38,6,17,31.230529595015575,0.6691337719298245,39.930555555555564,1040.277777777779,27.37573099415208,0
1740,4,0,0,44,0.0,0.0,1.0,44,950,700,250,0.7368421052631579,12,7,5,334.6496447726149,0.38924859055673006,0.24402122674532567,0.21829557203218342,135327.8079685332,257.4805729052615,135585.28854143847,1715,17,672.5227272727273,38,6,19,31.17213437382347,0.6696820175438596,39.87713675213676,1040.4914529914536,27.381354026090882,0
1741,4,0,0,44,0.0,0.0,1.0,44,1100,700,400,0.6363636363636364,15,7,8,337.8779885397508,0.38874207188160675,0.24843511172574373,0.22094743857913565,135416.7534722223,350.86805555556543,135767.62152777787,1716,18,673.5227272727273,39,5,20,30.9997998398719,0.6688034188034189,39.79166666666667,1040.8333333333342,26.68803418803421,0
1742,4,0,0,44,0.0,0.0,1.0,44,950,800,150,0.8421052631578947,11,8,3,336.41597806392423,0.38897330866807606,0.2509187330580156,0.220323806341472,135470.96896701408,314.9197048611319,135785.8886718752,1717,19,674.5227272727273,39,5,20,30.984007070909207,0.6693376068376068,39.73958333333334,1041.0416666666683,26.69337606837611,0
1743,4,0,0,44,0.0,0.0,1.0,44,800,400,400,0.5,12,4,8,335.8830527008721,0.38912746652572233,0.25231001491505656,0.22030754559041463,135525.19531250003,304.1232638888881,135829.3185763889,1718,20,675.5227272727273,39,5,20,30.944044284380414,0.6698717948717949,39.6875,1041.2500000000002,26.698717948717956,0
1744,4,0,0,44,0.0,0.0,1.0,44,1000,700,300,0.7,13,7,6,335.6630292492194,0.38886319591261453,0.25248661229759306,0.2206636837253745,135606.55517578128,303.6214192708339,135910.17659505212,1719,21,676.5227272727273,39,5,20,30.869024402440235,0.6706730769230769,39.609375,1041.5625000000002,26.706730769230774,0
1745,4,0,0,44,0.0,0.0,1.0,44,1450,1000,450,0.6896551724137931,19,10,9,334.51132666527917,0.3891605003523608,0.2468810393984049,0.22042487003976977,135690.79548514917,278.0270281480783,135968.82251329726,1720,22,677.5227272727273,37,7,20,30.815442363011307,0.6751126126126126,39.52850877192982,1041.8859649122799,28.15908013276432,0
1746,4,0,0,44,0.0,0.0,1.0,44,950,700,250,0.7368421052631579,12,7,5,322.0427345804365,0.38912746652572233,0.20170269790907103,0.20777386498175587,134930.7648019643,-97.6192167404883,134833.14558522383,1721,23,678.5227272727273,36,8,15,31.894239106871883,0.6695601851851851,40.25900900900902,1038.9639639639654,28.86011011011015,6
1747,4,0,0,44,0.0,0.0,1.0,44,1000,600,400,0.6,14,6,8,321.1353479615318,0.38866499295278367,0.1993531828526951,0.20735590312393679,134960.0164987624,-131.91362815516493,134828.10287060722,1722,24,679.5227272727273,36,8,15,31.88875040641598,0.669849537037037,40.230855855855864,1039.0765765765775,28.863238238238264,0
1748,4,0,0,44,0.0,0.0,1.0,44,750,400,350,0.5333333333333333,11,4,7,321.82706032731625,0.3885218463706836,0.19955570004334588,0.20797059612748453,134989.27136596083,-111.35992411327521,134877.91144184757,1723,25,680.5227272727273,36,8,15,31.841722655685608,0.6701388888888888,40.202702702702716,1039.1891891891912,28.86636636636642,0
1749,4,0,0,44,0.0,0.0,1.0,44,550,200,350,0.36363636363636365,9,2,7,332.8827973364387,0.3885218463706836,0.2007848981619469,0.2022495083418604,132716.91243608494,46.871575967882904,132763.7840120528,1724,26,681.5227272727273,36,8,19,33.823542805100175,0.6475694444444444,42.39864864864866,1030.405405405407,28.622372372372418,7
1750,4,0,0,44,0.0,0.0,1.0,44,800,600,200,0.75,10,6,4,335.81167800988726,0.3889402748414376,0.20324448328599476,0.20466179097886245,132832.97444403885,121.37280861944845,132954.3472526583,1725,27,682.5227272727273,36,8,19,33.631700167504164,0.6487268518518519,42.286036036036045,1030.8558558558575,28.63488488488493,0
1751,4,0,0,44,0.0,0.0,1.0,44,1950,1400,550,0.717948717948718,25,14,11,348.0742123799999,0.3891164552501762,0.14988726042841072,0.20610268783782368,131743.6731074245,428.9307321429235,132172.60383956743,1726,28,683.5227272727273,35,9,15,34.411405486659156,0.6398809523809523,43.344907407407405,1026.6203703703698,29.332010582010565,5
1752,4,0,1,43,0.0,0.022727272727272728,0.9772727272727273,44,1100,700,400,0.6363636363636364,15,7,8,348.3330450307478,0.38869802677942217,0.14880665813060157,0.20706334726375666,131892.2422223294,388.4852698473917,132280.72749217678,1727,29,684.5227272727273,35,9,15,34.255046948356814,0.6413690476190477,43.20023148148148,1027.1990740740741,29.348544973544975,0
1753,4,1,1,43,0.022727272727272728,0.022727272727272728,0.9772727272727273,44,900,600,300,0.6666666666666666,12,6,6,341.1441650363221,0.39200140944326994,0.13636363636363646,0.2044178815690089,132195.261139518,219.52839663989343,132414.78953615788,1728,0,657.8636363636364,36,8,17,34.13477332457292,0.6423611111111112,42.90540540540541,1028.3783783783792,28.56606606606609,0
1754,4,0,0,43,0.0,0.0,1.0,43,1300,1000,300,0.7692307692307693,16,10,6,348.66581470172935,0.38828903654485053,0.1473862726316284,0.20905832857217052,132219.3889853395,620.0761959876511,132839.46518132713,1729,31,674.1627906976744,35,8,19,33.9171168129642,0.6446428571428571,42.88194444444444,1028.4722222222222,29.384920634920633,0
1755,4,0,0,43,0.0,0.0,1.0,43,1400,1000,400,0.7142857142857143,18,10,8,346.5865795932801,0.3888658176448874,0.14275628722786737,0.20912761457955442,132457.56842635456,581.6031164266088,133039.17154278117,1730,32,675.1627906976744,35,8,20,33.73107338280489,0.6470238095238094,42.65046296296296,1029.3981481481478,29.41137566137565,0
1756,4,1,0,44,0.022727272727272728,0.0,1.0,44,650,300,350,0.46153846153846156,10,3,7,337.63493936133824,0.393047480620155,0.146654481881755,0.20545445246243124,132774.93709926135,165.89156724291672,132940.82866650427,1731,0,660.7954545454545,36,8,16,33.64291958041959,0.6481481481481481,42.34234234234234,1030.63063063063,28.628628628628615,0
1757,4,0,0,44,0.0,0.0,1.0,44,1300,900,400,0.6923076923076923,17,9,8,336.30509612590396,0.3924088266384778,0.14003653040560637,0.20559960416028236,132949.08717839463,142.29110867624067,133091.37828707087,1732,1,661.7954545454545,36,8,18,33.50258426148356,0.6498842592592593,42.17342342342342,1031.3063063063064,28.6473973973974,0
1758,4,0,0,44,0.0,0.0,1.0,44,1300,1000,300,0.7692307692307693,16,10,6,329.6806569929836,0.3930695031712474,0.12252761879409002,0.18247316752529,129125.75511975627,-285.94724348072543,128839.80787627555,1733,2,662.7954545454545,41,3,20,37.53080771107857,0.6028963414634145,45.907738095238095,1016.3690476190479,24.789488966318242,8
1759,4,1,0,45,0.022222222222222223,0.0,1.0,45,1700,1300,400,0.7647058823529411,21,13,8,322.7547071372675,0.39619107744107745,0.12685010151928933,0.17972341060590988,129364.36760355023,-649.3197069261696,128715.04789662406,1734,0,649.0444444444445,38,7,22,37.46455576559548,0.6101973684210527,45.67307692307692,1017.3076923076917,26.77125506072873,0
1760,4,1,2,44,0.021739130434782608,0.043478260869565216,0.9565217391304348,46,1000,800,200,0.8,12,8,4,311.09772876493474,0.4001207729468599,0.11660887347737159,0.17485837858167022,129731.44531250003,-1128.1684027777767,128603.27690972225,1735,0,635.9130434782609,39,7,15,37.38922972051805,0.6121794871794872,45.3125,1018.7500000000002,26.12179487179488,0
1761,4,1,1,44,0.022222222222222223,0.022222222222222223,0.9777777777777777,45,1350,1000,350,0.7407407407407407,17,10,7,317.44208441706985,0.3961279461279461,0.12483420166206272,0.17811509068557557,129663.42872242318,-767.874182737961,128895.55453968522,1736,0,651.0,38,7,16,37.29654008881429,0.6132127192982456,45.379273504273506,1018.4829059829065,26.802181736392274,0
1762,4,0,1,43,0.0,0.022727272727272728,0.9772727272727273,44,1100,800,300,0.7272727272727273,14,8,6,322.4478244692712,0.3918582628611698,0.1226171017816986,0.18644929632005483,130833.79937743742,-351.9670761323293,130481.83230130508,1737,1,666.6818181818181,40,4,15,35.98556339194066,0.6216145833333333,44.232723577235774,1023.0691056910573,25.57672764227643,7
1763,4,1,0,44,0.022727272727272728,0.0,1.0,44,900,600,300,0.6666666666666666,12,6,6,319.4747312249059,0.3911865750528541,0.14944151719657883,0.1858560849781844,131067.83743142313,-425.4275728732831,130642.40985854984,1738,0,667.6363636363636,40,4,16,35.82564178906975,0.6239583333333333,44.00406504065041,1023.9837398373986,25.599593495934965,0
1764,4,1,1,44,0.022222222222222223,0.022222222222222223,0.9777777777777777,45,1350,1000,350,0.7407407407407407,17,10,7,308.62316168143343,0.3928872053872054,0.14728472153390326,0.18113432682978378,131406.26161882808,-888.7386187124096,130517.52300011567,1739,0,653.7777777777778,40,5,16,35.76295965903457,0.62734375,43.673780487804876,1025.3048780487807,25.632621951219516,0
1765,4,0,0,44,0.0,0.0,1.0,44,1200,600,600,0.5,18,6,12,319.6988410413707,0.3893917371388302,0.15850904657670895,0.187644346593334,131408.21533203125,-397.7891710069444,131010.42616102431,1740,2,669.6363636363636,39,5,16,35.477094551119244,0.6290064102564104,43.671875,1025.3125,26.290064102564102,0
1766,4,0,0,44,0.0,0.0,1.0,44,650,500,150,0.7692307692307693,8,5,3,317.09574656700806,0.3893917371388302,0.1507257215666722,0.186506853088337,131488.330078125,-461.1219618055555,131027.20811631944,1741,3,670.6363636363636,39,5,16,35.463216873180315,0.6298076923076923,43.59375,1025.625,26.298076923076923,0
1767,4,0,0,44,0.0,0.0,1.0,44,1050,600,450,0.5714285714285714,15,6,9,316.0691205195198,0.3899533121916843,0.15014676155401085,0.1862935229202125,131568.46923828125,-483.053927951389,131085.41531032987,1742,4,671.6363636363636,39,5,14,35.408945916675115,0.6306089743589745,43.515625,1025.9375,26.306089743589745,0
1768,4,0,0,44,0.0,0.0,1.0,44,1050,700,350,0.6666666666666666,14,7,7,318.5393229319054,0.38922656800563776,0.15085160956976584,0.18827642164655467,131675.35942925359,-411.24403211805026,131264.11539713552,1743,5,672.6363636363636,39,5,15,35.238104299874806,0.6316773504273505,43.411458333333336,1026.3541666666674,26.316773504273524,0
1769,4,1,0,45,0.022222222222222223,0.0,1.0,45,1100,900,200,0.8181818181818182,13,9,4,311.7640239113894,0.3921085858585858,0.15967566498566188,0.18601000435491918,132032.19112507434,-767.4225618018406,131264.7685632725,1744,0,658.6666666666666,40,5,16,35.05368502587429,0.63359375,43.0640243902439,1027.7439024390242,25.693597560975604,0
1770,4,0,0,45,0.0,0.0,1.0,45,1150,900,250,0.782608695652174,14,9,5,312.54448190654165,0.3928872053872054,0.16262915747054496,0.18724911855608614,132188.90587819752,-737.0173797012317,131451.8884984963,1745,1,659.6666666666666,40,5,18,34.87642883025332,0.63515625,42.91158536585366,1028.3536585365855,25.708841463414636,0
1771,4,1,1,45,0.021739130434782608,0.021739130434782608,0.9782608695652174,46,1500,1000,500,0.6666666666666666,20,10,10,314.6232768365793,0.39499798711755235,0.17526892775899938,0.19247206971756742,132973.87390318266,-826.4655215149728,132147.4083816677,1746,0,646.304347826087,40,6,17,34.03680986632509,0.6429687500000001,42.14939024390244,1031.4024390243903,25.78506097560976,1
1772,4,0,1,44,0.0,0.022222222222222223,0.9777777777777777,45,1550,1300,250,0.8387096774193549,18,13,5,338.39485405593774,0.392739898989899,0.146772121949571,0.20128166771409245,131916.02105034702,40.74644902791874,131956.76749937492,1747,3,661.6666666666666,39,6,18,34.486327992969656,0.6340811965811968,43.17708333333332,1027.291666666665,26.34081196581192,8
1773,4,0,0,44,0.0,0.0,1.0,44,800,500,300,0.625,11,5,6,339.89646805666337,0.39124163143058494,0.1709303826053299,0.20231737262781324,131942.77479383664,169.37662760414796,132112.1514214408,1748,4,676.5909090909091,39,5,18,34.42083629051336,0.6343482905982908,43.15104166666666,1027.395833333332,26.34348290598287,0
1774,4,1,1,44,0.022222222222222223,0.022222222222222223,0.9777777777777777,45,1050,800,250,0.7619047619047619,13,8,5,332.396811385899,0.3929292929292929,0.17417654808959204,0.19928055279770707,132215.0340405841,-210.42885352636026,132004.60518705775,1749,0,662.5333333333333,40,5,20,34.339797430830025,0.6354166666666667,42.88617886178861,1028.455284552844,25.7113821138211,0
1775,4,0,0,44,0.0,0.0,1.0,44,1200,700,500,0.5833333333333334,17,7,10,337.1100537626845,0.39051488724453837,0.1827618907323183,0.2022250711332164,132237.24500868033,115.70095486108747,132352.94596354142,1750,6,678.5909090909091,39,5,21,34.1962899196543,0.637286324786325,42.86458333333332,1028.541666666665,26.372863247863204,0
1776,4,0,0,44,0.0,0.0,1.0,44,1100,700,400,0.6363636363636364,15,7,8,339.7091160834109,0.3901735377026075,0.18092962220479047,0.2048072879046228,132426.21678064394,197.47392226453522,132623.69070290847,1751,7,679.5909090909091,37,7,22,33.9395573665708,0.6427364864864864,42.680921052631575,1029.2763157894728,27.818278805120887,0
1777,4,0,0,44,0.0,0.0,1.0,44,1500,1300,200,0.8666666666666667,17,13,4,341.9118828677738,0.38984319943622264,0.17726424166996613,0.20734052670509906,132645.51487508218,270.6155489809275,132916.1304240631,1752,8,680.5909090909091,38,6,18,33.662621862684084,0.6430921052631579,42.467948717948715,1030.128205128205,27.10863697705803,0
1778,4,0,0,44,0.0,0.0,1.0,44,1650,1300,350,0.7878787878787878,20,13,7,346.7503898418359,0.3896449964763918,0.17950022614201777,0.21120251017639075,132810.65088757378,410.42899408282415,133221.0798816566,1753,9,681.5909090909091,38,6,18,33.37220149253733,0.6447368421052633,42.3076923076923,1030.7692307692294,27.125506072874458,0
1779,4,1,0,45,0.022222222222222223,0.0,1.0,45,1100,700,400,0.6363636363636364,15,7,8,340.21844506542396,0.39446548821548827,0.17943782668192143,0.20881065159963386,133095.751953125,56.325954861111654,133152.07790798612,1754,0,667.4222222222222,39,6,20,33.25467729995289,0.6458333333333334,42.03125,1031.875,26.458333333333332,0
1780,4,0,0,45,0.0,0.0,1.0,45,1250,1000,250,0.8,15,10,5,342.24848075301367,0.39412878787878786,0.18264428521770348,0.21051149570338998,133176.37939453125,115.8827039930564,133292.2620985243,1755,1,668.4222222222222,39,6,21,33.12150990681872,0.6466346153846154,41.953125,1032.1875,26.466346153846153,0
1781,4,0,0,45,0.0,0.0,1.0,45,1150,900,250,0.782608695652174,14,9,5,343.54946613328855,0.3936868686868687,0.1817236122320871,0.21177004404932556,133257.03125,156.07638888888982,133413.10763888888,1756,2,669.4222222222222,39,6,21,33.00712940543449,0.6474358974358975,41.875,1032.5,26.474358974358974,0
1782,4,1,0,46,0.021739130434782608,0.0,1.0,46,900,500,400,0.5555555555555556,13,5,8,337.2342546314095,0.3964170692431562,0.1941981623567297,0.20974325592929136,133588.61395178968,-189.17422490057157,133399.4397268891,1757,0,655.8478260869565,36,10,22,32.83837145969498,0.65625,41.554054054054056,1033.7837837837842,28.716216216216228,0
1783,4,0,0,46,0.0,0.0,1.0,46,1250,700,550,0.56,18,7,11,340.68111182605116,0.39704106280193235,0.19432188304802311,0.2125553893349494,133705.0564077592,-89.84254524793758,133615.21386251127,1758,1,656.8478260869565,36,10,14,32.63283972125437,0.6574074074074073,41.44144144144145,1034.234234234235,28.728728728728747,0
1784,4,0,0,46,0.0,0.0,1.0,46,1350,1000,350,0.7407407407407407,17,10,7,337.5212689842458,0.39525966183574884,0.18118933618132615,0.21194060759483846,133941.8297195742,-158.35673259550697,133783.47298697868,1759,2,657.8478260869565,38,8,15,32.47798190387724,0.6559758771929824,41.21260683760684,1035.1495726495732,27.240778227620346,0
1785,4,0,0,46,0.0,0.0,1.0,46,750,600,150,0.8,9,6,3,338.9197433659988,0.39520933977455713,0.1825530693175903,0.21329936056514687,134024.78723792834,-115.27070092774224,133909.5165370006,1760,3,658.8478260869565,38,8,15,32.35894724171138,0.656798245614035,41.13247863247864,1035.4700854700861,27.249212775528584,0
1786,4,0,0,46,0.0,0.0,1.0,46,1750,1300,450,0.7428571428571429,22,13,9,335.1533638006163,0.39463566827697266,0.17925145674585385,0.2122054588032624,134246.1328438893,-201.39140002921522,134044.74144386008,1761,4,659.8478260869565,38,8,15,32.23560996563574,0.6589912280701754,40.91880341880342,1036.3247863247866,27.271704903283858,0
1787,4,1,2,45,0.02127659574468085,0.0425531914893617,0.9574468085106383,47,1200,900,300,0.75,15,9,6,327.77235725636183,0.3970474868948504,0.18328758705865322,0.20912236362597794,134525.05083341216,-581.2813956601119,133943.76943775205,1762,0,646.7872340425532,41,6,16,32.14901899843805,0.6567581300813007,40.64980158730159,1037.4007936507942,25.302458381726687,0
1788,4,0,0,45,0.0,0.0,1.0,45,1300,1000,300,0.7692307692307693,16,10,6,337.9207595767781,0.3904882154882155,0.1830932439977664,0.21415997183369093,134280.7345920141,75.24956597224696,134355.98415798636,1763,1,675.8222222222222,39,6,16,32.12939698492464,0.65758547008547,40.88541666666668,1036.458333333335,26.575854700854745,0
1789,4,0,0,45,0.0,0.0,1.0,45,1650,1200,450,0.7272727272727273,21,12,9,339.69929932704815,0.3905513468013468,0.18599242127270288,0.2161029707190277,134419.0172846853,132.40919756761184,134551.42648225292,1764,2,676.8222222222222,40,5,16,31.94539722984451,0.6572916666666666,40.752032520325216,1036.9918699187012,25.92479674796753,0
1790,4,0,1,44,0.0,0.022222222222222223,0.9777777777777777,45,800,700,100,0.875,9,7,2,343.547237799189,0.39023569023569027,0.18759674733026377,0.21902477552881472,134498.06791798866,241.2879445105507,134739.35586249921,1765,3,677.8222222222222,40,5,16,31.76680219457236,0.6580729166666666,40.675813008130085,1037.29674796748,25.932418699187004,0
1791,4,0,0,44,0.0,0.0,1.0,44,1300,1100,200,0.8461538461538461,15,11,4,344.56543996195916,0.38940274841437633,0.17156617943645203,0.22068040965357974,134664.56626077276,480.1717598802882,135144.73802065305,1766,4,657.4318181818181,37,7,16,31.574406648355524,0.6649774774774774,40.51535087719299,1037.9385964912296,28.052394499762965,0
1792,4,0,0,44,0.0,0.0,1.0,44,1400,1000,400,0.7142857142857143,18,10,8,342.8253535720735,0.38928162438336855,0.16752211029701214,0.21973782141278417,134693.02002779712,435.2364429439927,135128.25647074112,1767,5,658.4318181818181,37,7,16,31.591207175803667,0.6652590090090089,40.48793859649123,1038.048245614036,28.05535798956854,0
1793,4,0,1,43,0.0,0.022727272727272728,0.9772727272727273,44,1000,700,300,0.7,13,7,6,352.5857679717753,0.3891494890768146,0.09402054902105728,0.20637069429353347,131301.43364800353,459.0033637152879,131760.4370117188,1768,6,659.4318181818181,39,5,17,34.74194955449403,0.6279380341880341,43.77604166666667,1024.895833333334,26.27938034188036,8
1794,4,0,0,43,0.0,0.0,1.0,43,900,500,400,0.5555555555555556,13,5,8,357.9158949159504,0.38983480989294944,0.09135017567341475,0.20918777258615961,131246.0064308021,795.0063691650216,132041.01279996714,1769,7,649.8139534883721,38,5,17,34.66140131373162,0.6291118421052632,43.830128205128204,1024.679487179487,26.96524966261808,0
1795,4,0,1,42,0.0,0.023255813953488372,0.9767441860465116,43,1050,700,350,0.6666666666666666,14,7,7,358.53581724613696,0.3898578811369509,0.09227161958697794,0.20985329600742098,131301.43364800367,815.2533637153018,132116.68701171898,1770,8,650.8139534883721,39,4,17,34.5894950367585,0.6279380341880341,43.77604166666668,1024.895833333335,26.279380341880387,0
1796,4,1,0,43,0.023255813953488372,0.0,1.0,43,1150,600,550,0.5217391304347826,17,6,11,355.05859374999994,0.3899270948689553,0.1063808139534883,0.20885799632352944,131492.4391847469,737.506821812338,132229.94600655924,1771,0,651.6046511627907,38,5,18,34.48567708333333,0.631578947368421,43.58974358974359,1025.6410256410259,26.990553306342786,0
1797,4,0,0,43,0.0,0.0,1.0,43,600,400,200,0.6666666666666666,8,4,4,357.5556470587063,0.38971945367294203,0.10849968272113863,0.21062879282562552,131547.23340821092,807.0912320110976,132354.324640222,1772,1,652.6046511627907,38,5,19,34.36632125251684,0.6321271929824561,43.53632478632478,1025.8547008547002,26.996176338281586,0
1798,4,1,0,44,0.022727272727272728,0.0,1.0,44,1050,800,250,0.7619047619047619,13,8,5,352.6802701553212,0.39282725510923183,0.12692102036489006,0.2096311117541666,131889.27001953125,502.94867621527817,132392.21869574653,1773,0,638.75,39,5,16,34.14640587499577,0.6338141025641026,43.203125,1027.1875,26.338141025641026,0
1799,4,1,0,45,0.022222222222222223,0.0,1.0,45,1050,900,150,0.8571428571428571,12,9,3,354.20234449789314,0.3958333333333333,0.14811009013162946,0.21250041070913908,132241.16478493286,368.02612119108835,132609.19090612396,1774,0,625.5333333333333,40,5,17,33.75284062839641,0.6356770833333334,42.860772357723576,1028.5569105691054,25.713922764227636,0
1800,4,0,0,45,0.0,0.0,1.0,45,1500,1000,500,0.6666666666666666,20,10,10,357.72669460589634,0.39602272727272725,0.1442227928105868,0.21535912660994647,132371.85723610254,470.58938958289286,132842.44662568544,1775,1,626.5333333333333,40,5,18,33.53063894923958,0.6369791666666668,42.73373983739836,1029.0650406504042,25.726626016260106,0
1801,4,0,0,45,0.0,0.0,1.0,45,1350,1100,250,0.8148148148148148,16,11,5,356.66964252233765,0.39589646464646466,0.1366745938782996,0.21567833953169804,132539.10007165652,454.5424344433907,132993.64250609992,1776,2,627.5333333333333,37,8,20,33.38957068824761,0.6438626126126126,42.571271929824555,1029.7149122807007,27.83013276434326,0
1802,4,0,0,45,0.0,0.0,1.0,45,850,700,150,0.8235294117647058,10,7,3,323.36747901452304,0.395959595959596,0.03162608452280957,0.18081251995600808,129527.44904667995,-589.4300295914798,128938.01901708847,1777,3,628.5333333333333,38,7,17,37.283532745591934,0.6118421052631577,45.51282051282052,1017.948717948719,26.788124156545237,8
1803,4,0,0,45,0.0,0.0,1.0,45,1150,800,350,0.6956521739130435,15,8,7,321.6536279748948,0.39551767676767674,0.03886441507586835,0.18060339747424323,129690.63321827761,-656.9074621959105,129033.7257560817,1778,4,629.5333333333333,38,7,17,37.16173694147261,0.613486842105263,45.35256410256411,1018.5897435897449,26.804993252361708,0
1804,4,1,0,46,0.021739130434782608,0.0,1.0,46,900,700,200,0.7777777777777778,11,7,4,332.03821435997435,0.39893317230273756,0.09481236499870027,0.17719663122774865,127670.36132812499,-665.7765886957602,127004.58473942922,1779,0,616.8260869565217,39,7,14,38.95459699031128,0.591346153846154,47.34375,1010.6249999999999,25.913461538461537,7
1805,4,1,2,45,0.02127659574468085,0.0425531914893617,0.9574468085106383,47,650,300,350,0.46153846153846156,10,3,7,327.34107514198496,0.40275208140610547,0.10063896056144728,0.17563480975138407,127887.41949443115,-1027.4389211117798,126859.98057331936,1780,0,604.6808510638298,40,7,14,38.85156066847517,0.5919270833333334,47.1290650406504,1011.4837398373977,25.287093495934943,0
1806,4,3,0,48,0.0625,0.0,1.0,48,1000,800,200,0.8,12,8,4,313.8945417815669,0.40733045212765956,0.11581223223991288,0.16714323251351476,127581.01695360872,-1590.6030286641262,125990.41392494459,1781,0,592.875,42,6,15,39.50420423300723,0.5858134920634919,47.43217054263567,1010.2713178294587,24.05407899593949,2
1807,4,0,0,48,0.0,0.0,1.0,48,750,300,450,0.4,12,3,9,313.3472714942756,0.4072935135933806,0.11735232067510548,0.1670544656003227,127629.9689021095,-1601.4994967249313,126028.46940538456,1782,1,593.875,42,6,15,39.468058752077745,0.5863095238095237,47.38372093023257,1010.4651162790718,24.058693244739807,0
1808,4,1,0,49,0.02040816326530612,0.0,1.0,49,1700,1500,200,0.8823529411764706,19,15,4,304.9938254669853,0.4117949263038549,0.12426403446363454,0.1641200156833426,128003.94483024713,-1991.9174382715814,126012.02739197554,1783,0,582.734693877551,44,5,17,39.29796870710955,0.5873579545454545,47.0138888888889,1011.9444444444463,22.998737373737416,0
1809,4,0,0,49,0.0,0.0,1.0,49,1150,800,350,0.6956521739130435,15,8,7,307.6583219282139,0.4119897959183674,0.12086395044775244,0.16594543464622227,128098.67937408133,-1917.8750525099542,126180.80432157137,1784,1,583.734693877551,45,4,18,39.13408196134576,0.5870370370370368,46.920289855072475,1012.3188405797122,22.495974235104715,0
1810,4,0,0,49,0.0,0.0,1.0,49,1600,1000,600,0.625,22,10,12,307.05986476818333,0.41190121882086167,0.12119957988935015,0.16632144177650732,128267.19867345724,-1922.8336501752267,126344.36502328202,1785,2,584.734693877551,42,7,18,38.977703909189465,0.5927579365079365,46.753875968992254,1012.9844961240319,24.118678479143618,0
1811,4,3,1,51,0.057692307692307696,0.019230769230769232,0.9807692307692307,52,1050,500,550,0.47619047619047616,16,5,11,317.2572921160986,0.4208380467571644,0.19872047542524518,0.16527345997916654,126692.19655454758,-2272.1199003182733,124420.07665422931,1786,0,551.9423076923077,41,11,16,40.32855406648272,0.5782520325203253,48.313492063492056,1006.7460317460304,24.554781262098302,6
1812,4,6,4,53,0.10526315789473684,0.07017543859649122,0.9298245614035088,57,1150,800,350,0.6956521739130435,15,8,7,305.248712520457,0.43353174603174605,0.2738631814435417,0.1645515852588571,128075.75651287808,-3580.3781622898273,124495.37835058826,1787,0,504.3333333333333,45,12,13,39.2184004474273,0.5868055555555556,46.942934782608695,1012.2282608695652,22.493961352657006,0
1813,4,3,2,54,0.05357142857142857,0.03571428571428571,0.9642857142857143,56,1400,900,500,0.6428571428571429,19,9,10,312.81056477046764,0.42941017316017316,0.28705675612114256,0.16881889018757607,128121.09482167347,-3184.4735939643397,124936.62122770913,1788,0,514.2678571428571,44,12,14,38.98085482592524,0.5885416666666667,46.898148148148145,1012.4074074074069,23.00925925925925,0
1814,4,3,3,54,0.05263157894736842,0.05263157894736842,0.9473684210526316,57,1650,1200,450,0.7272727272727273,21,12,9,311.8393471032357,0.4312734962406015,0.29749886224512667,0.16968276203211857,128449.39986282584,-3388.8824588477305,125060.51740397811,1789,0,506.1929824561403,44,13,13,38.671256546096686,0.5918560606060606,46.574074074074076,1013.7037037037042,23.03872053872055,0
1815,4,0,0,54,0.0,0.0,1.0,54,1200,700,500,0.5833333333333334,17,7,10,325.3322681904074,0.4274400186349872,0.2923637239688506,0.1762188358374364,128267.19867345727,-2454.108264226898,125813.09040923037,1790,1,511.22222222222223,42,12,15,38.51496237484854,0.5927579365079365,46.753875968992254,1012.9844961240321,24.11867847914362,0
1816,4,2,3,53,0.03571428571428571,0.05357142857142857,0.9464285714285714,56,1350,900,450,0.6666666666666666,18,9,9,326.1652702948006,0.4303841991341992,0.3194987297244476,0.17926828013947313,128848.62075617288,-2794.810956790118,126053.80979938277,1791,0,493.92857142857144,44,12,15,37.90184678522572,0.5958806818181819,46.18055555555556,1015.277777777778,23.074494949494955,0
1817,4,0,0,53,0.0,0.0,1.0,53,1150,1000,150,0.8695652173913043,13,10,3,342.41405917299477,0.4254807692307692,0.3292394715431406,0.18736589530027922,128672.41753472229,-1788.151041666657,126884.26649305563,1792,1,522.2830188679245,41,12,15,37.66897672826832,0.5983231707317073,46.35416666666667,1014.5833333333339,24.745934959349608,0
1818,4,0,0,53,0.0,0.0,1.0,53,1600,1200,400,0.75,20,12,8,337.5570835418651,0.4251632801161103,0.31614698284683884,0.185411789365749,128823.4414859693,-1902.946960034024,126920.49452593528,1793,2,523.2830188679245,41,12,15,37.638339196716494,0.5998475609756098,46.20535714285714,1015.1785714285708,24.760452961672456,0
1819,4,3,1,55,0.05357142857142857,0.017857142857142856,0.9821428571428571,56,2150,1600,550,0.7441860465116279,27,16,11,333.4830668956706,0.43184523809523806,0.30511767925560984,0.1790927581476752,127923.87777176869,-2617.886666480397,125305.9911052883,1794,0,496.19642857142856,42,14,17,38.65900383141764,0.5892857142857142,47.09302325581396,1011.6279069767455,24.08637873754156,6
1820,4,0,1,54,0.0,0.01818181818181818,0.9818181818181818,55,1500,1100,400,0.7333333333333333,19,11,8,338.5097307478118,0.42927890011223346,0.3106225111466592,0.1819234387982708,127952.8416264923,-2337.343606519733,125615.49801997257,1795,1,506.0181818181818,43,12,17,38.50227754898291,0.5881782945736433,47.064393939393945,1011.742424242425,23.528893587033142,0
1821,4,0,0,54,0.0,0.0,1.0,54,1550,1000,550,0.6451612903225806,21,10,11,340.36812261004013,0.4270978919170743,0.3116586521412259,0.18323735425460078,128021.92251066629,-2085.083716423304,125936.83879424298,1796,2,516.2222222222222,42,12,18,38.384678603344824,0.5902777777777779,46.996124031007746,1012.015503875968,24.095607235142094,0
1822,4,5,4,55,0.0847457627118644,0.06779661016949153,0.9322033898305084,59,1600,1500,100,0.9375,17,15,2,318.7383205549395,0.4346751412429379,0.34165056741370203,0.17644611223221376,129132.33109017265,-3567.9981635477016,125564.33292662495,1797,0,473.3898305084746,45,14,15,37.80216781035557,0.5974537037037038,45.901268115942024,1016.3949275362311,22.58655394524958,0
1823,4,2,2,55,0.03508771929824561,0.03508771929824561,0.9649122807017544,57,1750,1200,550,0.6857142857142857,23,12,11,327.2604275745752,0.4328921261487051,0.34420112610668263,0.18083363203441027,129060.2237654321,-2952.7391975308674,126107.48456790124,1798,0,490.7719298245614,44,13,16,37.65889830508473,0.5980113636363636,45.97222222222222,1016.1111111111112,23.093434343434346,0
1824,4,1,0,56,0.017857142857142856,0.0,1.0,56,1750,1400,350,0.8,21,14,7,334.9396868379052,0.4313582251082251,0.3522645566754994,0.18494945445619584,129032.96212300562,-2556.34801495064,126476.61410805499,1799,0,500.44642857142856,43,13,17,37.49155326684687,0.5990794573643411,45.99905303030303,1016.0037878787879,23.627995066948554,0
1825,4,0,0,56,0.0,0.0,1.0,56,1550,1100,450,0.7096774193548387,20,11,9,336.26713249126595,0.4307359307359307,0.3565573770491808,0.18647540983606553,129201.38888888879,-2510.544184745188,126690.8447041436,1800,1,501.44642857142856,41,15,18,37.28654371584699,0.603658536585366,45.83333333333333,1016.6666666666658,24.796747967479654,0
1826,4,0,1,55,0.0,0.017857142857142856,0.9821428571428571,56,1800,1100,700,0.6111111111111112,25,11,14,335.7744306892812,0.43037743506493503,0.35351709437432133,0.18691807884299058,129352.72285997719,-2513.3326247165637,126839.39023526062,1801,2,502.44642857142856,41,15,18,37.14526038619074,0.6051829268292683,45.6845238095238,1017.2619047619037,24.81126596980253,0
1827,4,0,0,55,0.0,0.0,1.0,55,1600,1200,400,0.75,20,12,8,333.8301533821826,0.43037317620650956,0.34888955848207237,0.18631282445018624,129453.66138353462,-2356.892872889923,127096.7685106447,1802,3,507.3636363636364,41,14,15,37.092188210827324,0.6061991869918699,45.58531746031745,1017.658730158728,24.820944638017757,0
1828,4,0,0,55,0.0,0.0,1.0,55,1450,1100,350,0.7586206896551724,18,11,7,320.14243482934694,0.43083613916947255,0.2648286140089422,0.17753353204172867,129201.38888888882,-2652.533698664663,126548.85519022416,1803,4,508.3636363636364,43,12,16,37.69637978142076,0.6007751937984498,45.83333333333333,1016.6666666666661,23.643410852713163,8
1829,4,2,3,54,0.03508771929824561,0.05263157894736842,0.9473684210526316,57,950,800,150,0.8421052631578947,11,8,3,316.74844007754155,0.4341191520467836,0.2633170722572311,0.17751176287894882,129616.12335249911,-3188.8590238395614,126427.26432865956,1804,0,491.49122807017545,45,12,15,37.36212417719265,0.602314814814815,45.42572463768114,1018.2971014492724,22.628824476650497,0
1830,4,1,1,54,0.01818181818181818,0.01818181818181818,0.9818181818181818,55,1450,900,550,0.6206896551724138,20,9,11,331.3443431810214,0.4330246913580247,0.28063902624572123,0.1852899139843409,129531.07424554157,-2416.122256515802,127114.95198902578,1805,0,487.1090909090909,44,11,15,37.07685252562001,0.6027462121212123,45.509259259259245,1017.9629629629608,23.135521885521836,0
1831,4,0,1,53,0.0,0.018518518518518517,0.9814814814814815,54,1100,600,500,0.5454545454545454,16,6,10,334.88495018509633,0.4302498252969951,0.27267444798140583,0.18738218968372156,129554.63927469114,-2122.820216049405,127431.81905864173,1806,7,497.1296296296296,44,10,15,36.96282401091406,0.6029829545454547,45.4861111111111,1018.0555555555537,23.13762626262622,0
1832,4,0,1,52,0.0,0.018867924528301886,0.9811320754716981,53,1750,1200,550,0.6857142857142857,23,12,11,342.98591242382383,0.42844400096758584,0.28072072768003764,0.19148413510747186,129466.28146701383,-1718.9778645833385,127747.30360243049,1807,9,507.37735849056605,43,10,15,36.84642613442511,0.6034399224806202,45.572916666666664,1017.7083333333328,23.667635658914715,0
1833,4,1,2,51,0.018867924528301886,0.03773584905660377,0.9622641509433962,53,1150,800,350,0.6956521739130435,15,8,7,339.7467062015421,0.4281869859700049,0.27948738191100264,0.19060906756377582,129659.10099754647,-1789.7495014061064,127869.35149614036,1808,0,508.0188679245283,43,10,15,36.73301177746785,0.6053779069767442,45.38352272727273,1018.4659090909089,23.68525369978858,0
1834,4,2,1,52,0.03773584905660377,0.018867924528301886,0.9811320754716981,53,1250,800,450,0.64,17,8,9,340.07270059812333,0.4280055636187712,0.2884948430477552,0.19185233486573397,129876.19447314065,-1766.5303604223864,128109.66411271827,1809,0,508.60377358490564,43,10,16,36.5043973739626,0.6075581395348837,45.170454545454554,1019.3181818181831,23.705073995771702,0
1835,4,0,0,52,0.0,0.0,1.0,52,2000,1400,600,0.7,26,14,12,339.76181362017144,0.4252843765711413,0.2823584477891372,0.1915120447833317,129842.52467550054,-1576.8936662459969,128265.63100925453,1810,1,519.3846153846154,42,10,16,36.54647588261393,0.6086309523809523,45.203488372093034,1019.18604651163,24.266334440753095,0
1836,4,0,0,52,0.0,0.0,1.0,52,1650,1300,350,0.7878787878787878,20,13,7,338.74290468344947,0.42558289341377575,0.28040519295401656,0.19114406138698595,129884.77473422502,-1600.4908264746205,128284.2839077504,1811,2,520.3846153846154,44,8,17,36.5295818572683,0.6062973484848484,45.16203703703704,1019.3518518518523,23.167087542087554,0
1837,4,1,0,53,0.018867924528301886,0.0,1.0,53,1200,700,500,0.5833333333333334,17,7,10,334.6084689763161,0.42826257861635225,0.2775234697552118,0.1900839335863944,130147.02896089319,-1890.340379515856,128256.68858137734,1812,0,511.54716981132077,45,8,18,36.36919292794794,0.6076388888888888,44.90489130434783,1020.3804347826086,22.67512077294686,0
1838,4,0,0,53,0.0,0.0,1.0,53,1300,900,400,0.6923076923076923,17,9,8,335.75157714871955,0.42830793420416063,0.26997767077736845,0.19154382070471332,130312.05047961352,-1849.3508681743133,128462.69961143921,1813,1,512.5471698113207,42,11,18,36.17293030906961,0.613343253968254,44.74321705426356,1021.027131782945,24.310169804355834,0
1839,4,1,0,54,0.018518518518518517,0.0,1.0,54,1250,400,850,0.32,21,4,17,337.66708705116446,0.42922344514325644,0.2914316687936547,0.19432056885950813,130649.5530589991,-1976.7891988062447,128672.76386019285,1814,0,504.037037037037,43,11,15,35.7825429171298,0.6153100775193798,44.41287878787879,1022.348484848485,23.775546159267094,0
1840,4,0,0,54,0.0,0.0,1.0,54,1650,1400,250,0.8484848484848485,19,14,5,337.6043736337582,0.4292744001863498,0.29761635362450045,0.19501617347550018,130794.81336805545,-1968.619791666677,128826.19357638877,1815,1,505.037037037037,43,11,15,35.63730482009503,0.616763565891473,44.27083333333333,1022.9166666666657,23.788759689922458,0
1841,4,1,2,53,0.01818181818181818,0.03636363636363636,0.9636363636363636,55,1350,1100,250,0.8148148148148148,16,11,5,334.8773020990648,0.4308080808080808,0.3002408568915491,0.19481368142627856,131067.2593021261,-2221.7099622770993,128845.54933984899,1816,0,496.8363636363636,44,11,16,35.43192573168159,0.6181344696969697,44.004629629629626,1023.9814814814806,23.272306397306377,0
1842,4,0,0,53,0.0,0.0,1.0,53,1250,1000,250,0.8,15,10,5,341.27623809629665,0.42729499274310595,0.30162238067078473,0.19770808285984576,130906.34694617205,-1664.9548742563597,129241.39207191569,1817,1,515.8490566037735,42,11,16,35.43067260044819,0.6192956349206349,44.161821705426355,1023.3527131782942,24.365540789959386,0
1843,4,0,1,52,0.0,0.018867924528301886,0.9811320754716981,53,1600,1100,500,0.6875,21,11,10,341.9158123931472,0.42729499274310595,0.2994396603309166,0.19833370270778775,130955.93268320718,-1644.81917778378,129311.1135054234,1818,2,516.8490566037735,42,11,16,35.364203666887555,0.6197916666666666,44.11337209302326,1023.5465116279073,24.370155038759698,0
1844,4,1,0,53,0.018867924528301886,0.0,1.0,53,1500,1000,500,0.6666666666666666,20,10,10,341.71904843496526,0.42714380745041125,0.29805536114721565,0.19885941100554588,131079.9381046812,-1641.4976563908394,129438.44044829036,1819,0,517.6603773584906,42,11,17,35.24397552359324,0.621031746031746,43.992248062015506,1024.031007751938,24.381690660760427,0
1845,4,1,1,53,0.018518518518518517,0.018518518518518517,0.9814814814814815,54,1800,1400,400,0.7777777777777778,22,14,8,333.57201607565776,0.42831353365944563,0.28894463768413403,0.19599844612497533,131449.48351591182,-2030.4261542986835,129419.05736161314,1820,0,509.05555555555554,43,11,17,35.0798973435528,0.6233042635658916,43.63162878787878,1025.4734848484836,23.84822057787171,0
1846,4,1,1,53,0.018518518518518517,0.018518518518518517,0.9814814814814815,54,1450,1100,350,0.7586206896551724,18,11,7,334.2663470916937,0.4279131726065688,0.29235404085454864,0.19740841435600467,131643.77371908,-1999.1833283115182,129644.59039076848,1821,0,510.037037037037,43,11,13,34.866372150964295,0.6252422480620154,43.44223484848485,1026.2310606060607,23.8658386187456,0
1847,4,0,0,53,0.0,0.0,1.0,53,1600,1100,500,0.6875,21,11,10,336.9718488255266,0.4265844218674408,0.29011104123650755,0.19904455387122988,131651.11889497325,-1727.4558132023312,129923.66308177091,1822,3,520.6603773584906,42,11,13,34.78956189217261,0.6267361111111112,43.435077519379846,1026.2596899224804,24.43475452196382,0
1848,4,1,1,53,0.018518518518518517,0.018518518518518517,0.9814814814814815,54,1700,1400,300,0.8235294117647058,20,14,6,334.52189009850406,0.42703237829023993,0.29727885586397007,0.19997630170205724,132105.78799357204,-1961.5444214876052,130144.24357208444,1823,0,512.0,43,11,14,34.39495824121838,0.6298449612403101,42.99242424242424,1028.0303030303028,23.907681465820996,0
1849,4,0,0,53,0.0,0.0,1.0,53,1700,1200,500,0.7058823529411765,22,12,10,343.9119237103085,0.42452830188679247,0.30360836384913514,0.20555276612071335,132098.9961259089,-1513.9160244276188,130585.08010148128,1824,1,522.5849056603773,42,11,15,34.16046124359821,0.6312003968253969,42.99903100775194,1028.0038759689921,24.47628276116648,0
1850,4,0,0,53,0.0,0.0,1.0,53,750,200,550,0.26666666666666666,13,2,11,342.871279828661,0.42467948717948717,0.30305692387032557,0.2050656301568259,132123.90049426112,-1539.7018283156074,130584.19866594551,1825,2,523.5849056603773,42,11,15,34.16215048696198,0.6314484126984128,42.974806201550386,1028.1007751937982,24.478589885566624,0
1851,4,0,1,52,0.0,0.018867924528301886,0.9811320754716981,53,1250,800,450,0.64,17,8,9,344.2147525396468,0.4240596274794388,0.3008522030355065,0.20641216855682568,132223.54144131974,-1497.3412805720682,130726.20016074767,1826,3,524.5849056603773,42,11,15,34.027385214496576,0.632440476190476,42.87790697674419,1028.4883720930243,24.487818383167244,0
1852,4,0,0,52,0.0,0.0,1.0,52,1400,1000,400,0.7142857142857143,18,10,8,380.9293023454431,0.42180429864253394,0.3547618697795376,0.20850552665233324,128684.70687045551,-596.0448778619061,128088.66199259361,1827,4,535.4807692307693,42,10,16,36.67947983319008,0.5969742063492063,46.34205426356589,1014.6317829457365,24.15789959394611,8
1853,4,2,1,53,0.037037037037037035,0.018518518518518517,0.9814814814814815,54,1300,800,500,0.6153846153846154,18,8,10,371.966348779204,0.42425168879571395,0.3600406911420839,0.20590391379472173,129130.79668209908,-1193.537808641942,127937.25887345715,1828,0,516.6111111111111,44,10,17,36.45121617928396,0.5987215909090908,45.90277777777779,1016.3888888888915,23.099747474747534,0
1854,4,0,0,53,0.0,0.0,1.0,53,1450,1000,450,0.6896551724137931,19,10,9,376.7201305445259,0.42363630865989355,0.37125245977543764,0.20132911894674654,127727.90096748987,-939.3514971389317,126788.54947035093,1829,1,527.3584905660377,42,11,13,37.76660755368099,0.5873015873015873,47.286821705426355,1010.852713178294,24.067921742340335,8
1855,4,2,0,55,0.03636363636363636,0.0,1.0,55,1550,1300,250,0.8387096774193549,18,13,5,368.06332961617585,0.4284652076318743,0.38495478392608273,0.19888513769865745,128170.89979383687,-1561.6064300546243,126609.29336378224,1830,0,509.1454545454545,39,16,15,37.53139680416967,0.5964209401709402,46.848958333333336,1012.6041666666672,25.964209401709414,0
1856,4,2,2,55,0.03508771929824561,0.03508771929824561,0.9649122807017544,57,1350,700,650,0.5185185185185185,20,7,13,353.48297573329296,0.4328399122807018,0.3820796243764062,0.19293414099954354,128571.78411005597,-2310.4126314877885,126261.37147856818,1831,0,492.2456140350877,41,16,13,37.49093139652417,0.5973069105691058,46.45337301587301,1014.1865079365073,24.736256291134325,0
1857,4,0,2,53,0.0,0.03636363636363636,0.9636363636363636,55,1450,900,550,0.6206896551724138,20,9,11,364.88742151516277,0.4278198653198653,0.38690823663415674,0.19828137756377148,128395.7703451751,-1629.9996850592079,126765.77066011589,1832,2,511.1454545454545,41,14,14,37.3817214826416,0.5955284552845528,46.62698412698413,1013.4920634920635,24.719318621757647,0
1858,4,3,1,55,0.05357142857142857,0.017857142857142856,0.9821428571428571,56,1500,1000,500,0.6666666666666666,20,10,10,362.7825589240546,0.4290787337662338,0.40256533475113465,0.1995589729640509,128881.41605259603,-1848.814017336696,127032.60203525933,1833,0,502.2142857142857,42,14,16,36.93895727963865,0.5989583333333333,46.14825581395349,1015.4069767441863,24.176356589147293,0
1859,4,2,0,57,0.03508771929824561,0.0,1.0,57,1350,1200,150,0.8888888888888888,15,12,3,362.8068535746782,0.43222639933166246,0.4167427078782382,0.20133136008572655,129228.5448740776,-2021.0161250643669,127207.52874901323,1834,0,494.36842105263156,38,19,18,36.58431403453469,0.6088267543859649,45.806623931623925,1016.7735042735034,26.75719748088167,0
1860,4,2,2,57,0.03389830508474576,0.03389830508474576,0.9661016949152542,59,1550,1100,450,0.7096774193548387,20,11,9,350.1870600233527,0.4342002727449834,0.4193537480516756,0.19702443680101767,129770.27253123141,-2711.225956771764,127059.04657445964,1835,0,478.5762711864407,40,19,15,36.35422900458808,0.6109375000000001,45.27439024390244,1018.9024390243903,25.47256097560976,0
1861,4,0,0,57,0.0,0.0,1.0,57,2050,1500,550,0.7317073170731707,26,15,11,357.64127922083173,0.42985066833751046,0.4139604329973874,0.20047598312286977,129625.34722222215,-2128.125000000005,127497.22222222215,1836,1,496.3333333333333,39,18,16,36.311715766503,0.6111111111111112,45.416666666666664,1018.3333333333327,26.111111111111093,0
1862,4,0,1,56,0.0,0.017543859649122806,0.9824561403508771,57,1550,1100,450,0.7096774193548387,20,11,9,352.9292479524386,0.4296287593984962,0.40877105481909304,0.1984361026765671,129744.38707325314,-2241.882208837356,127502.50486441578,1837,2,497.3333333333333,40,17,16,36.31068162926018,0.6106770833333335,45.29979674796747,1018.8008130081283,25.47002032520321,0
1863,4,1,0,57,0.017543859649122806,0.0,1.0,57,1150,800,350,0.6956521739130435,15,8,7,353.19718701454,0.42889776524644946,0.4113305405944536,0.1987180133000998,129770.27253123141,-2233.1009567717624,127537.17157445966,1838,0,498.2456140350877,40,17,17,36.27755336126072,0.6109375000000001,45.27439024390244,1018.9024390243903,25.47256097560976,0
1864,4,1,0,58,0.017241379310344827,0.0,1.0,58,1800,1500,300,0.8333333333333334,21,15,6,352.4830611481383,0.4301207400685622,0.4275040651769395,0.20018157282764235,130136.02612630701,-2425.851029069039,127710.17509723798,1839,0,490.63793103448273,41,17,19,35.9243842164965,0.6130589430894309,44.9156746031746,1020.3373015873017,24.88627564847077,0
1865,4,1,0,59,0.01694915254237288,0.0,1.0,59,1450,900,550,0.6206896551724138,20,9,11,340.5912243242795,0.43172852133255407,0.376448513340756,0.1932704048088663,130104.26097781806,-2932.0909036299263,127172.17007418814,1840,0,483.3050847457627,46,13,18,36.25992063492062,0.6059782608695652,44.9468085106383,1020.2127659574472,22.178538390379288,4
1866,4,0,3,56,0.0,0.05084745762711865,0.9491525423728814,59,1650,800,850,0.48484848484848486,25,8,17,341.23304001428625,0.4318137541398792,0.37988883201522716,0.19387116410671476,130151.84284728226,-2917.57820035207,127234.26464693018,1841,1,484.3050847457627,47,12,18,36.1953246845314,0.6052748226950355,44.9001736111111,1020.3993055555535,21.710623522458587,0
1867,4,1,2,55,0.017543859649122806,0.03508771929824561,0.9649122807017544,57,1500,800,700,0.5333333333333333,22,8,14,347.2164707365215,0.43426274018379285,0.39322507101666626,0.1974879452133811,130194.72109048827,-2358.849686886988,127835.87140360128,1842,0,493.1578947368421,46,11,19,35.999210968265004,0.6068840579710145,44.85815602836879,1020.5673758865238,22.18624730188095,0
1868,4,0,1,54,0.0,0.01818181818181818,0.9818181818181818,55,1550,1000,550,0.6451612903225806,21,10,11,345.4915253654426,0.4348625140291807,0.3785223584945425,0.19746296243064623,130383.45210808351,-1990.6713997305974,128392.78070835292,1843,1,490.9818181818182,43,12,19,35.85197419255138,0.6126453488372094,44.673295454545446,1021.3068181818168,23.751321353065507,0
1869,4,0,0,54,0.0,0.0,1.0,54,1650,1400,250,0.8484848484848485,19,14,5,340.7563582153158,0.4346901933379921,0.3651651833058134,0.19545671357922165,130522.65089163228,-1904.7153635116715,128617.93552812061,1844,2,493.0925925925926,44,10,15,35.831974145221686,0.612689393939394,44.53703703703703,1021.8518518518512,23.22390572390571,0
1870,4,0,0,54,0.0,0.0,1.0,54,850,600,250,0.7058823529411765,11,6,5,340.7563582153158,0.43447909387374795,0.3651651833058134,0.19545671357922165,130522.65089163228,-1904.7153635116715,128617.93552812061,1845,3,494.0925925925926,44,10,15,35.831974145221686,0.612689393939394,44.53703703703703,1021.8518518518512,23.22390572390571,0
1871,4,0,0,54,0.0,0.0,1.0,54,2100,1400,700,0.6666666666666666,28,14,14,321.00442931529153,0.43477026554856746,0.2875304564584218,0.17585391792758964,128718.37196918963,-2434.820470779509,126283.55149841012,1846,4,495.0925925925926,45,9,13,38.16527938944925,0.5932870370370371,46.308876811594196,1014.764492753622,22.5503220611916,8
1872,4,1,0,55,0.01818181818181818,0.0,1.0,55,1600,1300,300,0.8125,19,13,6,289.2940264287061,0.4366442199775533,0.18254302802168354,0.15838678571077958,128694.43634409962,-3423.086390951226,125271.3499531484,1847,0,487.07272727272726,47,8,15,38.99401502837428,0.5906471631205673,46.33246527777778,1014.6701388888888,21.58872635933806,6
1873,4,0,1,54,0.0,0.01818181818181818,0.9818181818181818,55,1500,1100,400,0.7333333333333333,19,11,8,288.80755532696463,0.43616722783389456,0.1858174655285616,0.1587920241021545,128862.72222222252,-3556.6944444444207,125306.0277777781,1848,1,488.07272727272726,49,6,16,38.835768220617204,0.5901360544217686,46.16666666666668,1015.3333333333358,20.7210884353742,0
1874,4,1,1,54,0.01818181818181818,0.01818181818181818,0.9818181818181818,55,1200,600,600,0.5,18,6,12,288.6280326334266,0.43670033670033676,0.19255723767618727,0.15920252116748773,128989.67013888918,-3553.9930555555297,125435.67708333365,1849,0,488.72727272727275,49,6,17,38.71171725458026,0.5914115646258502,46.04166666666668,1015.8333333333358,20.731292517006853,0
1875,4,0,0,54,0.0,0.0,1.0,54,1850,1200,650,0.6486486486486487,25,12,13,291.3634285564418,0.4346392382948987,0.1999125841609939,0.16086923495343655,129028.54424082556,-3281.160193669308,125747.38404715626,1850,1,498.51851851851853,48,6,17,38.60286937841759,0.5928819444444444,46.00340136054422,1015.986394557823,21.166383219954646,0
1876,4,1,1,54,0.01818181818181818,0.01818181818181818,0.9818181818181818,55,1050,900,150,0.8571428571428571,12,9,3,288.7319367817278,0.43584455667788996,0.20642277306098422,0.16029411883702174,129245.51881389854,-3536.306821429734,125709.2119924688,1851,0,490.43636363636364,47,8,19,38.45007398554439,0.5961879432624112,45.78993055555556,1016.8402777777777,21.63489952718676,0
1877,4,2,1,55,0.03571428571428571,0.017857142857142856,0.9821428571428571,56,1600,1200,400,0.75,20,12,8,289.622283730062,0.439745670995671,0.22657041540020217,0.16319337425974612,129828.92056695148,-3679.730306238126,126149.19026071335,1852,0,478.39285714285717,48,8,15,37.83774857460715,0.6009114583333333,45.216836734693885,1019.1326530612262,21.23193027210888,0
1878,4,1,0,56,0.017857142857142856,0.0,1.0,56,1400,800,600,0.5714285714285714,20,8,12,294.54774157266405,0.43726325757575757,0.24100221483942463,0.16707750617717476,130089.03354071201,-3536.5137934425575,126552.51974726946,1853,0,479.375,48,8,16,37.449640187824734,0.603515625,44.961734693877546,1020.1530612244883,21.25318877551017,0
1879,4,0,2,54,0.0,0.03571428571428571,0.9642857142857143,56,1600,1000,600,0.625,22,10,12,295.53316401007686,0.43785173160173163,0.2462302397480025,0.1679259208029415,130156.27170138876,-3506.901041666675,126649.37065972209,1854,1,480.375,49,7,16,37.35665918061794,0.6031037414965986,44.89583333333333,1020.4166666666656,20.82482993197277,0
1880,4,1,0,55,0.01818181818181818,0.0,1.0,55,1250,900,350,0.72,16,9,7,302.33388956577744,0.4356060606060606,0.25393202842867346,0.17236470870487375,130286.21827846348,-3121.8385631001483,127164.37971536333,1855,0,489.6909090909091,44,11,17,37.05200586492533,0.6103219696969697,44.76851851851851,1020.9259259259245,23.20286195286192,0
1881,4,0,0,55,0.0,0.0,1.0,55,1550,1100,450,0.7096774193548387,20,11,9,296.439920908718,0.4354517396184063,0.24573190046122906,0.16957746958351383,130417.70746678459,-3267.797022690022,127149.91044409457,1856,1,490.6909090909091,47,8,18,37.06985991898246,0.6079343971631206,44.639756944444436,1021.4409722222204,21.732786643025964,0
1882,4,1,1,55,0.017857142857142856,0.017857142857142856,0.9821428571428571,56,1450,1100,350,0.7586206896551724,18,11,7,297.7245130570591,0.4369791666666667,0.2614115188974635,0.1717899834860972,130752.19531250001,-3414.373263888888,127337.82204861112,1857,0,482.9107142857143,49,7,12,36.70005635677232,0.6090561224489794,44.3125,1022.7500000000001,20.872448979591837,0
1883,4,0,1,54,0.0,0.01818181818181818,0.9818181818181818,55,1000,600,400,0.6,14,6,8,298.9318350664528,0.4367704826038159,0.2546089480487088,0.172434205292289,130740.45482351097,-3183.503184437045,127556.95163907393,1858,1,491.3090909090909,48,7,12,36.68100939552673,0.6100260416666666,44.32397959183673,1022.7040816326526,21.306335034013596,0
1884,4,0,0,54,0.0,0.0,1.0,54,850,500,350,0.5882352941176471,12,5,7,306.5493296744793,0.43532349173072443,0.2561340627554549,0.17667079763039958,130706.03358892754,-2786.4306037808565,127919.60298514669,1859,2,501.35185185185185,47,7,14,36.520939445387654,0.6108156028368794,44.35763888888889,1022.569444444445,21.75679669030734,0
1885,4,0,0,54,0.0,0.0,1.0,54,1900,1400,500,0.7368421052631579,24,14,10,309.2606931600431,0.4349376892615886,0.2617054570477837,0.17895217428951518,130861.41798231327,-2705.9414333767404,128155.47654893654,1860,3,502.35185185185185,47,7,15,36.29501781623823,0.6123670212765957,44.205729166666664,1023.1770833333326,21.76972517730495,0
1886,4,0,0,54,0.0,0.0,1.0,54,1750,1100,650,0.6285714285714286,24,11,13,311.1152757749902,0.4346392382948987,0.26576500183724927,0.18064906190125293,130994.67807345874,-2649.1109212239976,128345.56715223474,1861,4,503.35185185185185,47,7,16,36.11331934198253,0.6136968085106385,44.075520833333314,1023.697916666663,21.780806737588573,0
1887,4,0,0,54,0.0,0.0,1.0,54,1250,800,450,0.64,17,8,9,312.70762179110375,0.4342679944095038,0.2653654651080546,0.1820172976911676,131088.5447397494,-2601.522586075267,128487.02215367413,1862,5,504.35185185185185,48,6,16,35.97802319466356,0.613498263888889,43.983843537414955,1024.0646258503382,21.33467970521538,0
1888,4,0,0,54,0.0,0.0,1.0,54,1600,900,700,0.5625,23,9,14,311.03256193047645,0.434180642907058,0.26489519646628135,0.1816592990160109,131219.19776626615,-2637.31134885929,128581.88641740686,1863,6,505.35185185185185,48,6,17,35.88938916092622,0.6148003472222222,43.85629251700679,1024.5748299319712,21.345308956916067,0
1889,4,0,1,53,0.0,0.018518518518518517,0.9814814814814815,54,1200,700,500,0.5833333333333334,17,7,10,309.66205924116576,0.4342243186582809,0.2628314008096637,0.18148345543408964,131351.33707631004,-2664.9593181838145,128686.37775812623,1864,7,506.35185185185185,45,9,17,35.7915635769197,0.6196759259259259,43.727355072463766,1025.0905797101443,22.77979066022543,0
1890,4,0,0,53,0.0,0.0,1.0,53,1200,700,500,0.5833333333333334,17,7,10,309.84162253840236,0.43365989356555396,0.2519122896481387,0.1821405425950048,131467.42822542533,-2453.1837455366485,129014.24447988869,1865,8,512.7358490566038,45,8,20,35.67022905258198,0.6208333333333333,43.61413043478261,1025.5434782608697,22.789855072463773,0
1891,4,0,0,53,0.0,0.0,1.0,53,1350,900,450,0.6666666666666666,18,9,9,307.0898081629171,0.4335087082728592,0.24768233106509396,0.18074246297488972,131513.87904326836,-2522.6856227683174,128991.19342050004,1866,9,513.7358490566038,45,8,20,35.69410102437301,0.6212962962962962,43.56884057971015,1025.7246376811604,22.79388083735912,0
1892,4,0,0,53,0.0,0.0,1.0,53,1700,1400,300,0.8235294117647058,20,14,6,307.2013584053663,0.4332516932752782,0.24826439545213752,0.18132869574411623,131623.61460848316,-2513.009358809899,129110.60524967326,1867,10,514.7358490566038,46,7,15,35.58099352051836,0.6211503623188405,43.46187943262412,1026.152482269505,22.30766265803272,0
1893,4,0,1,52,0.0,0.018867924528301886,0.9811320754716981,53,1700,1100,600,0.6470588235294118,23,11,12,311.5569652514285,0.43329704886308656,0.24793514985843323,0.18467004972067808,131782.861934762,-2388.4262926914985,129394.43564207052,1868,11,515.7358490566038,46,7,16,35.30928020491568,0.6227355072463767,43.30673758865249,1026.7730496453914,22.321153253160684,0
1894,4,0,1,51,0.0,0.019230769230769232,0.9807692307692307,52,550,300,250,0.5454545454545454,8,3,5,312.573328139428,0.43264517345399695,0.251146687836288,0.18543400424472525,131816.00934841702,-2159.5662511814535,129656.44309723556,1869,12,525.9807692307693,45,7,17,35.24990076739879,0.6243055555555554,43.27445652173914,1026.902173913045,22.82004830917878,0
1895,4,0,0,51,0.0,0.0,1.0,51,850,700,150,0.8235294117647058,10,7,3,318.0075396662134,0.43269607843137253,0.24892359324467428,0.18847598115225264,131779.32205932811,-1818.6364026062831,129960.68565672183,1870,13,504.19607843137254,44,7,17,35.14725553852168,0.6252367424242422,43.3101851851852,1026.7592592592614,23.33543771043776,0
1896,4,1,0,52,0.019230769230769232,0.0,1.0,52,1700,1300,400,0.7647058823529411,21,13,8,319.28695441263625,0.43350930115636,0.2736772388186104,0.19128574107897992,132188.33790334265,-1958.7976363946295,130229.54026694801,1871,0,495.4807692307692,45,7,19,34.70365762353564,0.6280092592592591,42.912137681159436,1028.3514492753654,22.852254428341453,0
1897,4,1,0,53,0.018867924528301886,0.0,1.0,53,2050,1600,450,0.7804878048780488,25,16,9,314.6880650974018,0.4335843009192066,0.28025801854985444,0.19048261246508044,132576.73852237655,-2255.1058112499722,130321.63271112657,1872,0,487.1132075471698,41,12,20,34.432597212856805,0.6374491869918699,42.53472222222222,1029.861111111111,25.118563685636857,0
1898,4,0,1,52,0.0,0.018867924528301886,0.9811320754716981,53,1450,1000,450,0.6896551724137931,19,10,9,315.3458478467716,0.4335087082728592,0.2835529686188596,0.19153110969219714,132704.48022959192,-2230.438633786833,130474.04159580509,1873,1,488.1132075471698,41,12,14,34.287743115732724,0.6387195121951219,42.41071428571429,1030.3571428571436,25.13066202090594,0
1899,4,0,0,52,0.0,0.0,1.0,52,1400,1000,400,0.7142857142857143,18,10,8,317.0358344168692,0.4321424082453494,0.29098828802776167,0.19342094485065883,132872.1230695271,-1974.955118382308,130897.16795114479,1874,2,496.9807692307692,42,10,14,34.0764019423559,0.6388888888888888,42.248062015503876,1031.0077519379847,24.547803617571066,0
1900,4,0,1,51,0.0,0.019230769230769232,0.9807692307692307,52,1700,1300,400,0.7647058823529411,21,13,8,315.84532190592785,0.43237022373051787,0.2883838383838384,0.19301658560917817,132934.57031250003,-2002.6475694444425,130931.92274305559,1875,3,497.9807692307692,43,9,15,34.04461279461279,0.6380813953488372,42.1875,1031.2500000000002,23.982558139534888,0
1901,4,1,1,51,0.019230769230769232,0.019230769230769232,0.9807692307692307,52,1250,800,450,0.64,17,8,9,317.7256172899403,0.4305319884364002,0.29074889867841436,0.19492895979680128,133081.09504132232,-1943.345385674927,131137.74965564738,1876,0,498.09615384615387,43,9,16,33.849577826725415,0.6395348837209303,42.04545454545455,1031.818181818182,23.99577167019028,0
1902,4,0,0,51,0.0,0.0,1.0,51,1000,600,400,0.6,14,6,8,281.78789092692296,0.430375816993464,0.19811659370766965,0.17008973693873317,132471.10778416286,-2710.0010222968076,129761.10676186605,1877,5,508.8627450980392,43,8,18,35.38514166130071,0.6334786821705425,42.637310606060616,1029.4507575757593,23.94071529245952,6
1903,4,0,0,51,0.0,0.0,1.0,51,1350,1000,350,0.7407407407407407,17,10,7,283.05533556765283,0.43016339869281045,0.2036445992780036,0.17118708114364106,132544.2322730147,-2696.5295712809557,129847.70270173374,1878,6,509.8627450980392,43,8,18,35.27948930169824,0.634205426356589,42.5662878787879,1029.7348484848521,23.947322057787257,0
1904,4,0,0,51,0.0,0.0,1.0,51,1150,700,450,0.6086956521739131,16,7,9,283.43673998074735,0.4300980392156863,0.19847939175670248,0.17186314701842687,132641.76297778965,-2680.8902232552414,129960.87275453442,1879,7,510.8627450980392,43,8,12,35.17228963657537,0.635174418604651,42.47159090909093,1030.1136363636394,23.956131078224175,0
1905,4,1,1,51,0.019230769230769232,0.019230769230769232,0.9807692307692307,52,1500,900,600,0.6,21,9,12,279.58748546523185,0.4298328305681247,0.20609575842133965,0.17080448851488172,132922.63481652972,-2967.298954046617,129955.3358624831,1880,0,502.0192307692308,44,8,13,34.991282811050255,0.6366003787878787,42.19907407407408,1031.2037037037055,23.436447811447852,0
1906,4,0,0,51,0.0,0.0,1.0,51,1350,900,450,0.6666666666666666,18,9,9,282.3862602648245,0.42820261437908497,0.20103441817579326,0.17234426018853202,132885.74667125818,-2694.978191000901,130190.76848025728,1881,1,512.0392156862745,43,8,13,34.955914768552546,0.6375968992248062,42.23484848484849,1031.0606060606071,23.978153629316445,0
1907,4,0,0,51,0.0,0.0,1.0,51,1600,1300,300,0.8125,19,13,6,286.74252470561333,0.42754901960784314,0.2143186202527998,0.1759204138058764,133081.09504132238,-2567.9981634527076,130513.09687786967,1882,2,513.0392156862745,43,8,14,34.64880078316201,0.6395348837209303,42.04545454545455,1031.8181818181824,23.99577167019029,0
1908,4,0,0,51,0.0,0.0,1.0,51,1250,1000,250,0.8,15,10,5,286.77571142088294,0.4271895424836601,0.2122929553542836,0.17617146015021315,133129.95455262848,-2564.312514348036,130565.64203828044,1883,3,514.0392156862745,43,8,15,34.59923839236556,0.6400193798449614,41.998106060606055,1032.007575757575,24.000176180408722,0
1909,4,1,0,52,0.019230769230769232,0.0,1.0,52,1250,700,550,0.56,18,7,11,284.99031990618715,0.4276882227249874,0.217102405526713,0.17635257899020132,133400.47260802466,-2796.4313271605024,130604.04128086416,1884,0,505.13461538461536,44,8,16,34.375840279645054,0.6413352272727273,41.73611111111111,1033.0555555555552,23.478535353535346,0
1910,4,0,0,52,0.0,0.0,1.0,52,1600,1300,300,0.8125,19,13,6,284.0012385972339,0.4273425716440422,0.21265206298191464,0.1763133969311836,133521.15347365686,-2815.9461167865693,130705.20735687029,1885,1,506.13461538461536,43,9,17,34.28127481522204,0.6438953488372094,41.61931818181817,1033.522727272726,24.035412262156417,0
1911,4,0,0,52,0.0,0.0,1.0,52,1200,900,300,0.75,15,9,6,280.1022685250234,0.42720116892911014,0.20001303303345663,0.17446872048058895,133643.5208351265,-2913.2293280819863,130730.2915070445,1886,2,507.13461538461536,43,9,18,34.260329853161174,0.6451065891472869,41.500946969696955,1033.9962121212093,24.04642353770254,0
1912,4,1,0,53,0.018867924528301886,0.0,1.0,53,1500,1100,400,0.7333333333333333,19,11,8,276.15505449570514,0.42767295597484273,0.21377461409585696,0.1737896440306959,134022.94345850463,-3197.7773491083813,130825.16610939625,1887,0,498.54716981132077,44,9,15,33.98555098512624,0.6474905303030304,41.13425925925925,1035.4629629629615,23.533249158249124,0
1913,4,0,1,52,0.0,0.018867924528301886,0.9811320754716981,53,1400,900,500,0.6428571428571429,19,9,10,273.77469830157634,0.4273403483309144,0.21265617886590138,0.1730812923160811,134190.77932098747,-3252.3919753086557,130938.38734567881,1888,1,499.54716981132077,44,9,15,33.88069705093833,0.6491477272727274,40.972222222222214,1036.1111111111097,23.547979797979767,0
1914,4,0,1,51,0.0,0.019230769230769232,0.9807692307692307,52,1300,1100,200,0.8461538461538461,15,11,4,278.8750631457156,0.42636060834590245,0.21300111808842082,0.17603083183791013,134133.55075076036,-2918.6995128845347,131214.85123787582,1889,2,510.0769230769231,43,9,15,33.805363835816806,0.649951550387597,41.02746212121212,1035.8901515151508,24.090468639887227,0
1915,4,0,0,51,0.0,0.0,1.0,51,1400,800,600,0.5714285714285714,20,8,12,276.97635080784534,0.42651960784313725,0.20811226802701377,0.1753008795193897,134231.6643440798,-2764.2006894226542,131467.46365465713,1890,3,516.9411764705883,43,8,15,33.75721541929392,0.650920542635659,40.93276515151514,1036.2689393939377,24.09927766032413,0
1916,4,1,1,51,0.019230769230769232,0.019230769230769232,0.9807692307692307,52,1100,500,600,0.45454545454545453,17,5,12,272.2374256567351,0.4279003267973856,0.20782003213711842,0.1734700592836603,134478.74228395062,-3077.9706790123473,131400.77160493826,1891,0,507.9807692307692,44,8,15,33.63517675415103,0.6519886363636365,40.69444444444444,1037.2222222222222,23.57323232323232,0
1917,4,0,0,51,0.0,0.0,1.0,51,1050,700,350,0.6666666666666666,14,7,7,277.78397607466144,0.4263888888888889,0.2089796006081679,0.17652099559149526,134378.90199042967,-2734.338860910254,131644.56312951943,1892,5,518.9411764705883,43,8,15,33.590301245167,0.652374031007752,40.79071969696969,1036.8371212121197,24.112491190979526,0
1918,4,0,1,50,0.0,0.0196078431372549,0.9803921568627451,51,1500,1100,400,0.7333333333333333,19,11,8,286.0038572488748,0.4266666666666667,0.12780408773678964,0.16874227577683618,131606.8052930057,-2553.5955782883616,129053.20971471732,1893,6,519.9411764705883,45,6,15,36.14164018361582,0.6222222222222221,43.47826086956522,1026.0869565217395,22.801932367149767,7
1919,4,0,0,50,0.0,0.0,1.0,50,1600,1100,500,0.6875,21,11,10,291.96830174693673,0.42570578231292516,0.14023459352160916,0.17239662697183278,131636.7551868999,-2313.2480281207095,129323.5071587792,1894,7,530.28,44,6,16,35.9586002586544,0.6238162878787878,43.449074074074076,1026.2037037037042,23.322811447811457,0
1920,4,0,0,50,0.0,0.0,1.0,50,1300,900,400,0.6923076923076923,17,9,8,289.0238995566909,0.4258078231292517,0.1353106682297771,0.17129802363357305,131779.3220593281,-2382.5252914951716,129396.79676783292,1895,8,531.28,44,6,16,35.891236059758945,0.6252367424242424,43.3101851851852,1026.7592592592612,23.335437710437755,0
1921,4,0,1,49,0.0,0.02,0.98,50,1150,800,350,0.6956521739130435,15,8,7,289.9594221722002,0.42533163265306123,0.13956721666215843,0.17206741312530113,131826.86149691383,-2355.1118827160253,129471.7496141978,1896,9,532.28,44,6,16,35.81958344603732,0.6257102272727272,43.2638888888889,1026.9444444444464,23.33964646464651,0
1922,4,0,0,49,0.0,0.0,1.0,49,1200,800,400,0.6666666666666666,16,8,8,294.7142345782122,0.42485119047619047,0.13544728236122006,0.17505315379163733,131862.52170138917,-2027.6475694444202,129834.87413194474,1897,10,541.9183673469388,43,6,16,35.66176470588235,0.6274224806201549,43.22916666666668,1027.0833333333355,23.885658914728733,0
1923,4,0,0,49,0.0,0.0,1.0,49,1350,1000,350,0.7407407407407407,17,10,7,293.97235023041486,0.42483347505668934,0.13521677795542209,0.17506037321624596,131959.80131571402,-2041.4934142561854,129918.30790145784,1898,11,542.9183673469388,43,6,17,35.58333333333334,0.6283914728682171,43.1344696969697,1027.4621212121217,23.894467935165622,0
1924,4,0,1,48,0.0,0.02040816326530612,0.9795918367346939,49,1400,900,500,0.6428571428571429,19,9,10,296.7058275204482,0.42439058956916104,0.1338856744208785,0.1770284962110734,132032.78456618742,-1965.0206790920586,130067.76388709535,1899,12,543.9183673469388,43,6,18,35.439989710986204,0.6291182170542636,43.06344696969697,1027.746212121212,23.901074700493304,0
1925,4,0,0,48,0.0,0.0,1.0,48,950,300,650,0.3157894736842105,16,3,13,307.4504134656671,0.4231586140661938,0.12721013127316128,0.18436602760025922,132223.54144131948,-1461.7595219345856,130761.7819193849,1900,20,556.0,42,6,17,34.97267759562842,0.6324404761904763,42.87790697674418,1028.488372093022,24.48781838316719,2
1926,4,0,0,48,0.0,0.0,1.0,48,950,400,550,0.42105263157894735,15,4,11,313.40978785969355,0.4231586140661938,0.13653381642512108,0.1857841525972409,131786.11288265293,-1339.2734428366734,130446.83943981626,1901,21,557.0,41,7,15,35.25845410628018,0.6295731707317074,43.30357142857142,1026.7857142857133,25.043554006968616,1
1927,4,2,0,50,0.04,0.0,1.0,50,1000,800,200,0.8,12,8,4,311.68363275507926,0.42460884353741496,0.17623617693522897,0.1879007043180622,132424.15229030346,-1740.8601292489939,130683.29216105447,1902,0,535.68,40,10,17,34.66277481569248,0.6375,42.6829268292683,1029.2682926829275,25.731707317073187,0
1928,4,1,1,50,0.0196078431372549,0.0196078431372549,0.9803921568627451,51,1300,1000,300,0.7692307692307693,16,10,6,306.73078292786596,0.42491830065359476,0.17727121665307144,0.18604511973849058,132653.37616528093,-2062.2252141597337,130591.1509511212,1903,0,526.156862745098,41,10,15,34.56078261427839,0.6382113821138211,42.46031746031746,1030.1587301587304,25.1258226867983,0
1929,4,0,0,50,0.0,0.0,1.0,50,1300,1000,300,0.7692307692307693,16,10,6,312.1344463955122,0.4233503401360544,0.18215427105938065,0.1894861687160303,132685.78247901396,-1716.8393482715146,130968.94313074244,1904,2,537.68,40,10,16,34.38917932531072,0.6401041666666667,42.428861788617894,1030.2845528455296,25.75711382113824,0
1930,4,0,0,50,0.0,0.0,1.0,50,1900,1500,400,0.7894736842105263,23,15,8,311.6852342047389,0.42241496598639455,0.17625788643533147,0.19000811392865832,132842.88452640641,-1718.9668847907742,131123.91764161564,1905,3,538.68,40,10,16,34.24355941114619,0.6416666666666666,42.276422764227654,1030.894308943091,25.772357723577272,0
1931,4,0,0,50,0.0,0.0,1.0,50,1500,1100,400,0.7333333333333333,19,11,8,311.6856697071938,0.42244897959183675,0.16555916839097407,0.19067497660387647,132973.87390318266,-1710.7898117853133,131263.08409139735,1906,4,539.68,40,10,16,34.11255624527869,0.64296875,42.14939024390244,1031.4024390243903,25.78506097560976,0
1932,4,0,0,50,0.0,0.0,1.0,50,1150,700,450,0.6086956521739131,16,7,9,311.2951183431953,0.4220578231292517,0.16339230769230806,0.19088851596516676,133062.4842529603,-1715.6596434870385,131346.82460947326,1907,5,540.68,41,9,16,34.03405448717948,0.6422764227642277,42.063492063492056,1031.7460317460307,25.164537359659285,0
1933,4,0,1,49,0.0,0.02,0.98,50,1150,800,350,0.6956521739130435,15,8,7,309.569222093858,0.42125850340136056,0.1586679481018738,0.19048301335816634,133190.4597052942,-1753.6665997417485,131436.79310555244,1908,6,541.68,41,9,17,33.950724811789215,0.6435467479674797,41.93948412698413,1032.2420634920636,25.17663569492838,0
1934,4,0,0,49,0.0,0.0,1.0,49,650,300,350,0.46153846153846156,10,3,7,316.28778763753337,0.4211840986394558,0.15378743287845653,0.1948555266591695,133236.0463038702,-1371.8131361953788,131864.2331676748,1909,7,534.1020408163265,40,9,17,33.73178954621517,0.6455729166666667,41.895325203252035,1032.4186991869929,25.81046747967482,0
1935,4,1,1,49,0.02,0.02,0.98,50,1450,1200,250,0.8275862068965517,17,12,5,312.33273677382215,0.4227210884353742,0.16524082325482725,0.19394258081884358,133528.88028047085,-1658.0753211096473,131870.8049593612,1910,0,524.4,37,13,18,33.5415340547422,0.6537162162162162,41.61184210526316,1033.552631578947,27.93385490753911,0
1936,4,0,0,49,0.0,0.0,1.0,49,1200,800,400,0.6666666666666666,16,8,8,321.3831392603854,0.4212549603174603,0.18834990009251462,0.19778368735884372,133196.3677496531,-1238.5866389071393,131957.78111074594,1911,1,533.5918367346939,38,11,18,33.6399468709032,0.6485745614035088,41.93376068376069,1032.264957264958,27.16486729644626,1
1937,4,1,0,50,0.02,0.0,1.0,50,950,700,250,0.7368421052631579,12,7,5,318.3824728204341,0.4214540816326531,0.19473641769982852,0.1975404948625096,133499.1333007814,-1499.2431640624834,131999.89013671892,1912,0,523.9,39,11,19,33.414915331115814,0.6498397435897435,41.64062500000001,1033.4375000000011,26.498397435897466,0
1938,4,0,0,50,0.0,0.0,1.0,50,900,600,300,0.6666666666666666,12,6,6,320.3649537780201,0.4212329931972789,0.19642317380352625,0.1993493521157902,133606.80474175367,-1439.4124348958117,132167.39230685786,1913,1,524.9,39,11,19,33.25619227539882,0.6509081196581196,41.53645833333334,1033.8541666666683,26.50908119658124,0
1939,4,0,0,50,0.0,0.0,1.0,50,1150,900,250,0.782608695652174,14,9,5,320.3013347999226,0.4211224489795919,0.19740531829170016,0.19974570677723844,133687.58680555577,-1435.9374999999775,132251.6493055558,1914,2,525.9,39,11,19,33.17720923986032,0.6517094017094016,41.45833333333334,1034.1666666666683,26.51709401709406,0
1940,4,0,0,50,0.0,0.0,1.0,50,800,500,300,0.625,11,5,6,319.76060935547656,0.4209268707482993,0.19140499115739829,0.19966401730184333,133734.88519565103,-1447.3703235507637,132287.51487210026,1915,3,526.9,40,10,17,33.14399521844502,0.6505208333333332,41.412601626016276,1034.3495934959374,25.858739837398435,0
1941,4,0,0,50,0.0,0.0,1.0,50,1300,900,400,0.6923076923076923,17,9,8,320.05601857532736,0.4208248299319728,0.18940968470680652,0.2002759880218448,133813.73443593454,-1434.4217851477015,132379.31265078683,1916,4,527.9,40,10,17,33.05769734472711,0.6513020833333332,41.33638211382115,1034.6544715447176,25.86636178861794,0
1942,4,2,3,49,0.038461538461538464,0.057692307692307696,0.9423076923076923,52,1150,600,550,0.5217391304347826,17,6,11,304.2515421782317,0.42512726244343896,0.1846844255221214,0.1927887734086712,134274.45766480404,-2229.357836067522,132045.0998287365,1917,0,508.5576923076923,42,10,17,33.00805597107953,0.6527777777777777,40.891472868217065,1036.4341085271337,24.677002583979373,0
1943,4,1,2,48,0.02,0.04,0.96,50,1000,700,300,0.7,13,7,6,315.81782705012273,0.42024659863945574,0.1820219866509618,0.19861432234485504,133997.80636525888,-1536.2207928481619,132461.58557241072,1918,0,529.78,40,10,17,32.9838617327575,0.653125,41.15853658536586,1035.3658536585374,25.884146341463435,0
1944,4,0,0,48,0.0,0.0,1.0,48,1200,700,500,0.5833333333333334,17,7,10,322.3593964334705,0.41796875,0.18001878690284512,0.2022072577628133,133903.125,-967.0138888888862,132936.11111111112,1919,9,544.6041666666666,39,9,17,32.90895061728395,0.6538461538461539,41.25,1035.0,26.53846153846154,0
1945,4,0,0,48,0.0,0.0,1.0,48,1300,700,600,0.5384615384615384,19,7,12,322.5388548595393,0.4175162529550827,0.18238598256203864,0.20291368463948248,134010.95920138896,-955.2517361111059,133055.70746527787,1920,10,545.6041666666666,39,9,19,32.79678068410462,0.65491452991453,41.145833333333336,1035.4166666666672,26.549145299145312,0
1946,4,0,0,48,0.0,0.0,1.0,48,1450,1200,250,0.8275862068965517,17,12,5,320.62096137211074,0.4171006944444444,0.1861304618001045,0.20221341821191535,134103.04712803222,-1000.7504213761683,133102.29670665605,1921,11,546.6041666666666,40,8,19,32.75465234170589,0.6541666666666668,41.05691056910569,1035.772357723577,25.894308943089424,0
1947,4,1,1,48,0.02040816326530612,0.02040816326530612,0.9795918367346939,49,1500,1100,400,0.7333333333333333,19,11,8,314.5841558214692,0.41659580498866217,0.182826625977494,0.1998842320243302,134374.9061054024,-1345.5567198485567,133029.34938555383,1922,0,536.4285714285714,42,7,19,32.6403816199377,0.6537698412698413,40.79457364341086,1036.821705426357,24.68623108157993,0
1948,4,0,0,48,0.0,0.0,1.0,48,1600,1300,300,0.8125,19,13,6,324.73285867997515,0.41630651595744683,0.1890789473684209,0.20616393518868412,134345.00681059458,-874.7523778029779,133470.2544327916,1923,13,548.6041666666666,41,7,19,32.407097288676226,0.654979674796748,40.823412698412696,1036.7063492063492,25.285520712349978,0
1949,4,0,0,48,0.0,0.0,1.0,48,1400,1100,300,0.7857142857142857,17,11,6,331.4146122055551,0.41669437056737585,0.17433880475339403,0.20098509654063074,132647.43447096032,-807.425448157848,131840.00902280246,1924,14,549.6041666666666,42,6,15,33.93103502335936,0.636656746031746,42.46608527131783,1030.135658914729,24.52703949796974,4
1950,4,0,0,48,0.0,0.0,1.0,48,1300,1000,300,0.7692307692307693,16,10,6,332.02768441677836,0.41648197399527187,0.16985612187323706,0.2017589940621725,132722.309544198,-786.5037783186191,131935.8057658794,1925,15,550.6041666666666,42,6,15,33.84015892420538,0.6374007936507937,42.393410852713174,1030.4263565891467,24.53396087117016,0
1951,4,0,0,48,0.0,0.0,1.0,48,1750,1200,550,0.6857142857142857,23,12,11,330.1018641528635,0.41602024231678486,0.16527647243107824,0.2013924217079395,132872.12306952692,-827.7328961601011,132044.39017336682,1926,16,551.6041666666666,42,6,16,33.73962249373433,0.638888888888889,42.24806201550387,1031.0077519379834,24.54780361757103,0
1952,4,0,1,47,0.0,0.020833333333333332,0.9791666666666666,48,1150,800,350,0.6956521739130435,15,8,7,314.4212286873878,0.4160664154846336,0.15572959953212107,0.18474592975885634,131449.48351591194,-1332.5462943142907,130116.93722159765,1927,17,552.6041666666666,43,5,18,35.57086296056885,0.6233042635658915,43.63162878787879,1025.4734848484848,23.84822057787174,5
1953,4,1,2,46,0.020833333333333332,0.041666666666666664,0.9583333333333334,48,1300,800,500,0.6153846153846154,18,8,10,316.1637764436086,0.41729462174940896,0.16444585448392557,0.1864798322137451,131595.1877170138,-1278.8736979166763,130316.31401909712,1928,0,552.0208333333334,43,5,14,35.379653130287636,0.6247577519379846,43.48958333333333,1026.0416666666658,23.861434108527114,0
1954,4,0,0,46,0.0,0.0,1.0,46,1600,1200,400,0.75,20,12,8,326.9528106650447,0.4145128824476651,0.16999066701420107,0.19277913157912727,131582.4642935878,-595.7486929957171,130986.71560059208,1929,19,575.3913043478261,41,5,15,35.11570940501516,0.627540650406504,43.50198412698413,1025.9920634920634,25.02419667053813,0
1955,4,0,0,46,0.0,0.0,1.0,46,850,400,450,0.47058823529411764,13,4,9,324.53364307326547,0.4140499194847021,0.16269046368054663,0.19182256403080503,131675.98101075648,-653.3428354666208,131022.63817528986,1930,20,576.3913043478261,42,4,16,35.083671638972824,0.626984126984127,43.41085271317829,1026.3565891472863,24.437061646363958,0
1956,4,0,0,46,0.0,0.0,1.0,46,1200,900,300,0.75,15,9,6,323.16660161223786,0.41396940418679545,0.1570444958721089,0.19151416726416537,131775.4529475394,-682.9149390060547,131092.53800853333,1931,21,577.3913043478261,42,4,16,35.018717755127696,0.6279761904761905,43.3139534883721,1026.744186046513,24.446290143964596,0
1957,4,1,1,46,0.02127659574468085,0.02127659574468085,0.9787234042553191,47,1050,700,350,0.6666666666666666,14,7,7,316.7051088995879,0.41531760715386984,0.16020878554187545,0.18871867856504296,131984.12682399293,-1039.9905482380505,130944.13627575488,1932,0,566.0851063829788,43,4,17,34.97498310447577,0.6286337209302325,43.11079545454546,1027.5568181818194,23.896670190274868,0
1958,4,0,0,46,0.0,0.0,1.0,46,1350,900,450,0.6666666666666666,18,9,9,321.61279713765055,0.4129830917874396,0.1463005770870216,0.19209845450654278,132074.09410492165,-704.6562330989665,131369.43787182268,1933,23,579.3913043478261,42,4,17,34.75855486425338,0.6309523809523809,43.02325581395349,1027.9069767441865,24.473975636766347,0
1959,4,0,0,46,0.0,0.0,1.0,46,1100,700,400,0.6363636363636364,15,7,8,319.4232176618326,0.41264090177133655,0.14877333289631123,0.191293407778068,132173.7162730604,-756.1292515473918,131417.587021513,1934,24,580.3913043478261,42,4,17,34.71482755371279,0.6319444444444444,42.92635658914728,1028.2945736434099,24.4832041343669,0
1960,4,0,0,46,0.0,0.0,1.0,46,800,400,400,0.5,12,4,8,316.35106488747635,0.41220813204508855,0.14635879291210596,0.19007918822356157,132298.2967989452,-829.4585849708656,131468.83821397435,1935,25,581.3913043478261,42,4,18,34.668848701767615,0.633184523809524,42.80523255813953,1028.7790697674407,24.494739756367636,0
1961,4,0,0,46,0.0,0.0,1.0,46,1000,800,200,0.8,12,8,4,316.35106488747635,0.41220813204508855,0.14635879291210596,0.19007918822356157,132298.2967989452,-829.4585849708656,131468.83821397435,1936,26,582.3913043478261,42,4,18,34.668848701767615,0.633184523809524,42.80523255813953,1028.7790697674407,24.494739756367636,0
1962,4,0,0,46,0.0,0.0,1.0,46,1000,600,400,0.6,14,6,8,317.9579800043267,0.4116747181964573,0.15459346597887436,0.19142368183933955,132373.07328285556,-782.185002403707,131590.88828045185,1937,27,583.3913043478261,42,4,18,34.55253452605147,0.6339285714285714,42.73255813953488,1029.0697674418602,24.5016611295681,0
1963,4,0,0,46,0.0,0.0,1.0,46,1150,900,250,0.782608695652174,14,9,5,319.49872545122776,0.41147342995169084,0.16078508160149174,0.19261543051760754,132424.80604383704,-738.0816080787592,131686.72443575828,1938,28,584.3913043478261,39,7,18,34.46102368181358,0.6391559829059827,42.68229166666668,1029.2708333333353,26.39155982905988,0
1964,4,0,0,46,0.0,0.0,1.0,46,1700,1300,400,0.7647058823529411,21,13,8,314.9803928792648,0.4116747181964573,0.15076642255503514,0.1904330999150785,132532.04345703122,-846.8750000000014,131685.16845703122,1939,29,585.3913043478261,39,7,18,34.46984066767832,0.640224358974359,42.578125,1029.6874999999998,26.402243589743584,1
1965,4,0,0,46,0.0,0.0,1.0,46,1000,600,400,0.6,14,6,8,314.9803928792648,0.4116747181964573,0.15076642255503514,0.1904330999150785,132532.04345703122,-851.0009765625014,131681.04248046872,1940,30,586.3913043478261,39,7,18,34.46984066767832,0.640224358974359,42.578125,1029.6874999999998,26.402243589743584,0
1966,4,0,0,46,0.0,0.0,1.0,46,1250,1000,250,0.8,15,10,5,314.64951713953394,0.41170491143317234,0.14661488798388578,0.1903687347883373,132558.85959201382,-858.0837673611219,131700.7758246527,1941,31,587.3913043478261,39,7,18,34.45149706655876,0.6404914529914532,42.55208333333333,1029.791666666666,26.404914529914514,0
1967,4,0,0,46,0.0,0.0,1.0,46,1350,900,450,0.6666666666666666,18,9,9,309.92476482418874,0.41120169082125607,0.137697264106607,0.18926250752588825,132907.71620008704,-961.7214626735854,131945.99473741345,1942,32,588.3913043478261,39,7,14,34.22410091928478,0.6439636752136751,42.21354166666668,1031.1458333333353,26.439636752136803,1
1968,4,1,0,47,0.02127659574468085,0.0,1.0,47,1450,1300,150,0.896551724137931,16,13,3,309.4900847664609,0.4125038544557509,0.1624339554707055,0.19134168014393624,133367.22932778124,-1144.8329780553797,132222.39634972587,1943,0,576.8510638297872,40,7,17,33.7762773842319,0.6468749999999999,41.768292682926834,1032.926829268294,25.823170731707346,0
1969,4,0,1,46,0.0,0.02127659574468085,0.9787234042553191,47,950,600,350,0.631578947368421,13,6,7,307.3792894187935,0.4119256860931237,0.16074720207221316,0.19071018877972637,133498.47690073718,-1193.0666063520243,132305.41029438516,1944,1,577.8510638297872,40,7,17,33.69984757596617,0.6481770833333333,41.64126016260163,1033.434959349595,25.835873983739873,0
1970,4,0,0,46,0.0,0.0,1.0,46,1400,1300,100,0.9285714285714286,15,13,2,311.55502524982126,0.40996376811594204,0.1469850952963192,0.19330440309590236,133499.1333007814,-881.5348307291513,132617.59847005224,1945,2,589.3478260869565,39,7,18,33.591308839834696,0.6498397435897435,41.64062500000001,1033.4375000000011,26.498397435897466,0
1971,4,0,0,46,0.0,0.0,1.0,46,1150,900,250,0.782608695652174,14,9,5,311.25219770041826,0.4104770531400966,0.14512764782696297,0.19325684014915853,133526.04709201408,-887.944878472203,132638.1022135419,1946,3,590.3478260869565,39,7,18,33.57228045420949,0.6501068376068375,41.61458333333334,1033.5416666666683,26.501068376068417,0
1972,4,1,1,46,0.02127659574468085,0.02127659574468085,0.9787234042553191,47,1300,900,400,0.6923076923076923,17,9,8,303.2106085044692,0.4123689485044712,0.14812306521770968,0.18946475039699154,133761.1656937835,-1288.439111144154,132472.72658263933,1947,0,578.7659574468086,40,7,14,33.54578052853915,0.65078125,41.38719512195122,1034.4512195121954,25.861280487804883,0
1973,4,0,0,46,0.0,0.0,1.0,46,1200,600,600,0.5,18,6,12,311.6470797057267,0.41001409017713364,0.15496311673223206,0.19473637963932414,133761.16569378338,-862.7446666997241,132898.42102708365,1948,5,592.3478260869565,40,6,15,33.32760258047614,0.6507812500000001,41.387195121951216,1034.4512195121945,25.861280487804862,0
1974,4,0,0,46,0.0,0.0,1.0,46,900,600,300,0.6666666666666666,12,6,6,312.5714625904394,0.409561191626409,0.1580623948485389,0.19573201919408711,133840.02267995258,-833.0856715579188,133006.93700839466,1949,6,593.3478260869565,40,6,16,33.22509493878085,0.6515624999999999,41.310975609756106,1034.756097560977,25.868902439024424,0
1975,4,0,0,46,0.0,0.0,1.0,46,1300,1200,100,0.9230769230769231,14,12,2,313.93915785777085,0.409561191626409,0.1650498787409056,0.19709032329049228,133933.93034297053,-790.5789399092985,133143.35140306124,1950,7,594.3478260869565,41,5,16,33.096128042936535,0.6509146341463414,41.220238095238095,1035.1190476190477,25.24680603948897,0
1976,4,0,0,46,0.0,0.0,1.0,46,1150,800,350,0.6956521739130435,15,8,7,315.45716656250454,0.4098128019323672,0.1678857352316372,0.1985972198178179,134036.6404084781,-743.4362402368484,133293.20416824124,1951,8,595.3478260869565,41,5,16,32.95450916522961,0.6519308943089431,41.12103174603174,1035.515873015872,25.256484707704196,0
1977,4,0,1,45,0.0,0.021739130434782608,0.9782608695652174,46,800,400,400,0.5,12,4,8,317.5630400882245,0.40994363929146543,0.17320304984946455,0.20034294269251682,134113.69879259582,-682.0892187893605,133431.60957380646,1952,9,596.3478260869565,41,5,16,32.82322494652491,0.6526930894308942,41.04662698412699,1035.8134920634927,25.263743708865675,0
1978,4,0,0,45,0.0,0.0,1.0,45,950,700,250,0.7368421052631579,12,7,5,336.61776882840167,0.4098274410774411,0.16773159928376247,0.20998537007866933,133698.92659279765,11.785017882687043,133710.71161068033,1953,10,600.0888888888888,37,8,19,32.74402742437092,0.6554054054054055,41.44736842105262,1034.2105263157882,27.951635846372653,3
1979,4,0,0,45,0.0,0.0,1.0,45,1800,1300,500,0.7222222222222222,23,13,10,337.42610093493875,0.409280303030303,0.17188953659541917,0.2109751664891413,133783.9903263502,28.442044667564346,133812.43237101776,1954,11,601.0888888888888,37,8,16,32.638116057233695,0.6562500000000002,41.365131578947356,1034.5394736842088,27.960526315789426,0
1980,4,0,0,45,0.0,0.0,1.0,45,1150,800,350,0.6956521739130435,15,8,7,337.341223908318,0.4088804713804714,0.17067933099318644,0.21135104105924735,133858.8978833368,31.224888596662367,133890.12277193344,1955,12,602.0888888888888,38,7,16,32.56547250326932,0.65515350877193,41.29273504273503,1034.8290598290582,27.23234367971206,0
1981,4,0,0,45,0.0,0.0,1.0,45,1600,1200,400,0.75,20,12,8,342.67311051731724,0.40765993265993267,0.17485639596876856,0.2154993584700402,133997.13187824152,183.44279622323006,134180.57467446476,1956,13,603.0888888888888,38,7,17,32.28940941767275,0.6565241228070176,41.15918803418803,1035.363247863247,27.24640125955913,0
1982,4,0,1,44,0.0,0.022222222222222223,0.9777777777777777,45,1150,800,350,0.6956521739130435,15,8,7,346.0653596370584,0.40692340067340066,0.17551315110881904,0.21828911266631607,134107.77043839928,282.010761377731,134389.781199777,1957,14,604.0888888888888,38,7,18,32.091069279697436,0.6576206140350878,41.05235042735042,1035.790598290597,27.257647323436764,0
1983,4,0,0,44,0.0,0.0,1.0,44,1150,800,350,0.6956521739130435,15,8,7,351.41468494566516,0.40545718816067655,0.16987583618075974,0.22142172777263538,134067.73147747366,622.6739237072761,134690.40540118093,1958,15,614.2727272727273,37,7,18,31.99256661372861,0.6590653153153154,41.091008771929815,1035.6359649122792,27.990161213845383,0
1984,4,0,1,43,0.0,0.022727272727272728,0.9772727272727273,44,950,600,350,0.631578947368421,13,6,7,351.24361621513964,0.4048075229034531,0.16953209245628043,0.22155542350070107,134107.77043839928,620.8996502666196,134728.6700886659,1959,16,615.2727272727273,38,6,18,31.95697954271962,0.6576206140350878,41.05235042735042,1035.790598290597,27.257647323436764,0
1985,4,0,0,43,0.0,0.0,1.0,43,1100,800,300,0.7272727272727273,14,8,6,358.80065033929714,0.4036314138058324,0.1704539857963221,0.22590088945362133,134039.34383656504,1018.6807479224299,135058.02458448746,1960,17,608.2325581395348,37,6,18,31.82973316391359,0.6587837837837838,41.118421052631575,1035.526315789473,27.987197724039813,0
1986,4,0,0,43,0.0,0.0,1.0,43,750,400,350,0.5333333333333333,11,4,7,348.5728152513122,0.4036314138058324,0.1603932674430948,0.21529228503948228,133330.62967691958,704.512566366546,134035.14224328613,1961,18,609.2325581395348,37,6,19,32.8037079307782,0.6517454954954955,41.803728070175424,1032.7850877192964,27.913110478899902,3
1987,4,1,0,44,0.022727272727272728,0.0,1.0,44,1150,700,450,0.6086956521739131,16,7,9,342.91012703260566,0.4055232558139535,0.16271383939020767,0.2134645410998093,133621.76254125926,364.27654340874585,133986.039084668,1962,0,596.3636363636364,35,9,20,32.65851804171797,0.6586309523809525,41.521990740740726,1033.9120370370356,29.540343915343875,0
1988,4,0,1,43,0.0,0.022727272727272728,0.9772727272727273,44,1750,1300,450,0.7428571428571429,22,13,9,344.1843284296258,0.40561134601832277,0.1689321079278583,0.2158272275468241,133891.14610125154,416.646840706424,134307.79294195795,1963,1,597.3636363636364,35,9,16,32.35620293744874,0.6613095238095239,41.26157407407406,1034.9537037037023,29.57010582010578,0
1989,4,0,0,43,0.0,0.0,1.0,43,1450,1100,350,0.7586206896551724,18,11,7,351.3120497058626,0.4023624953857512,0.16487048591416142,0.20576848625629116,131328.12500000015,627.4305555555698,131955.5555555557,1964,21,612.2325581395348,40,3,18,34.74762872628727,0.6265624999999999,43.75000000000001,1025.0000000000011,25.62500000000003,6
1990,4,1,1,43,0.022727272727272728,0.022727272727272728,0.9772727272727273,44,800,600,200,0.75,10,6,4,346.4165407812259,0.40550123326286114,0.15665766544599746,0.20454967855971573,131637.38031173058,320.2731850184754,131957.65349674906,1965,0,599.2954545454545,37,7,14,34.56109538056061,0.6348536036036035,43.448464912280706,1026.2061403508776,27.73530109056426,0
1991,4,0,0,43,0.0,0.0,1.0,43,1000,600,400,0.6,14,6,8,350.6837292040886,0.4019241417497232,0.15737502827133487,0.2067641874078551,131581.12502164143,628.6719230917386,132209.79694473319,1966,23,614.2325581395348,37,6,14,34.508367176089195,0.6342905405405403,43.50328947368422,1025.9868421052645,27.729374110953096,0
1992,4,1,1,43,0.022727272727272728,0.022727272727272728,0.9772727272727273,44,750,500,250,0.6666666666666666,10,5,5,338.0122225169813,0.4041138125440451,0.15236845837469803,0.20098871487327047,131903.67408366245,117.01080703488554,132020.68489069733,1967,0,601.25,38,6,14,34.50858034321374,0.6356907894736841,43.18910256410258,1027.2435897435928,27.032726045884022,0
1993,4,0,0,43,0.0,0.0,1.0,43,1350,1100,250,0.8148148148148148,16,11,5,342.8526757978842,0.40104743447766705,0.15095051653379854,0.20364622791368317,131862.521701389,441.88368055556555,132304.40538194455,1968,25,616.2325581395348,37,6,15,34.42570993914807,0.6371058558558558,43.22916666666667,1027.0833333333342,27.75900900900903,0
1994,4,0,0,43,0.0,0.0,1.0,43,1300,1100,200,0.8461538461538461,15,11,4,342.99770898996655,0.4007705795496493,0.15204050544763392,0.20439603253193953,131985.99810979643,454.1789940828662,132440.1771038793,1969,26,617.2325581395348,38,5,15,34.2976710334789,0.6365131578947367,43.10897435897437,1027.5641025641046,27.041160593792227,0
1995,4,0,0,43,0.0,0.0,1.0,43,1050,700,350,0.6666666666666666,14,7,7,345.42607546312456,0.4001015134736065,0.15138633458115125,0.2065901258037073,132123.26189139107,527.7639665059734,132651.02585789704,1970,27,618.2325581395348,38,5,15,34.0971284076345,0.6378837719298245,42.97542735042736,1028.098290598292,27.05521817363926,0
1996,4,0,0,43,0.0,0.0,1.0,43,1500,1200,300,0.8,18,12,6,332.8642018632491,0.40021686969361386,0.03863723009739073,0.1922133213857489,130781.8193225759,106.80253826245018,130888.62186083835,1971,28,619.2325581395348,40,3,14,35.771650935585384,0.62109375,44.28353658536586,1022.865853658537,25.571646341463428,5
1997,4,0,0,43,0.0,0.0,1.0,43,1450,1200,250,0.8275862068965517,17,12,5,331.80669808550294,0.4003322259136213,0.04093448357122065,0.1917317005125528,130807.80805902556,80.58137517349326,130888.38943419905,1972,29,620.2325581395348,40,3,14,35.772443539307226,0.6213541666666667,44.258130081300806,1022.9674796747955,25.574186991869887,0
1998,4,0,0,43,0.0,0.0,1.0,43,1050,900,150,0.8571428571428571,12,9,3,330.57660411114483,0.3998477297895902,0.041384216349052316,0.191407465600639,130885.78976014587,53.555981062840715,130939.34574120872,1973,30,621.2325581395348,40,3,14,35.725163041679075,0.6221354166666667,44.18191056910568,1023.2723577235756,25.581808943089392,0
1999,4,1,1,43,0.022727272727272728,0.022727272727272728,0.9772727272727273,44,900,700,200,0.7777777777777778,11,7,4,322.75393109813194,0.40207672656800564,0.038119474481350224,0.1880424144840355,131124.83071932453,-335.7890841521988,130789.04163517233,1974,0,608.0909090909091,41,3,14,35.68424706186234,0.6229674796747968,43.94841269841269,1024.2063492063473,24.980642663569448,0
2000,4,0,0,43,0.0,0.0,1.0,43,1650,1400,250,0.8484848484848485,19,14,5,331.0648913434557,0.39901716500553713,0.03719637729996195,0.19259872085315566,131067.83743142289,78.39187157113315,131146.229302994,1975,32,623.2325581395348,40,3,15,35.52893840148206,0.6239583333333335,44.004065040650396,1023.9837398373967,25.59959349593492,0
2001,4,2,2,43,0.044444444444444446,0.044444444444444446,0.9555555555555556,45,650,300,350,0.46153846153846156,10,3,7,318.7291846259594,0.4042718855218855,0.04101313829066777,0.18720585283161953,131434.91753472216,-620.7965920169969,130814.12094270517,1976,0,596.4888888888889,39,6,15,35.47507788161993,0.6292735042735043,43.64583333333333,1025.416666666666,26.29273504273503,0
2002,4,1,2,42,0.022727272727272728,0.045454545454545456,0.9545454545454546,44,1300,1000,300,0.7692307692307693,16,10,6,323.3478317355873,0.4021207716701903,0.0421350844953694,0.19016470383890102,131484.42147531215,-296.95948178996224,131187.46199352219,1977,0,611.0227272727273,40,4,16,35.30684370458449,0.6281250000000002,43.597560975609746,1025.6097560975595,25.64024390243899,0
2003,4,1,2,41,0.023255813953488372,0.046511627906976744,0.9534883720930233,43,950,500,450,0.5263157894736842,14,5,9,325.30596719573083,0.3998477297895902,0.05955037342948266,0.19173779000064348,131568.46923828122,-39.99837239583292,131528.47086588538,1978,0,623.7674418604652,39,4,12,35.17203523200326,0.6306089743589745,43.515625,1025.9374999999998,26.306089743589737,0
2004,4,0,0,41,0.0,0.0,1.0,41,750,500,250,0.6666666666666666,10,5,5,331.29296875,0.3962906504065041,0.07067073170731719,0.19487821691176477,131492.4391847469,512.5041091387278,132004.94329388565,1979,36,650.780487804878,38,3,17,35.095052083333336,0.631578947368421,43.58974358974359,1025.6410256410259,26.990553306342786,0
2005,4,0,0,41,0.0,0.0,1.0,41,750,600,150,0.8,9,6,3,328.9347283899565,0.3959095528455285,0.06654631273696254,0.19387660921081287,131568.46923828137,455.4877387152925,132023.95697699665,1980,37,651.780487804878,39,2,12,35.07896317731073,0.6306089743589742,43.51562500000001,1025.937500000001,26.306089743589766,0
2006,4,0,1,40,0.0,0.024390243902439025,0.975609756097561,41,1150,900,250,0.782608695652174,14,9,5,352.35219087635085,0.39560467479674793,0.059940561590489994,0.19593416221628837,129310.02995105545,1038.8446924623436,130348.87464351779,1981,38,652.780487804878,38,3,18,36.767113095238095,0.6096491228070176,45.72649572649572,1017.094017094016,26.765632028789895,8
2007,4,1,0,41,0.024390243902439025,0.0,1.0,41,900,500,400,0.5555555555555556,13,5,8,330.9121081661938,0.40010162601626015,0.046528131315468624,0.17978420722019006,128388.03624260373,307.51801172476274,128695.5542543285,1982,0,641.9512195121952,38,3,17,38.25044802867384,0.600328947368421,46.634615384615394,1013.4615384615399,26.670040485829997,4
2008,4,1,0,42,0.023809523809523808,0.0,1.0,42,950,600,350,0.631578947368421,13,6,7,326.6995546492936,0.40447154471544716,0.06204049315688276,0.17220641195803546,127170.8021375869,-90.67111545137894,127080.13102213552,1983,0,627.6428571428571,39,3,19,39.60043805294504,0.5862713675213675,47.83854166666667,1008.6458333333342,25.862713675213698,2
2009,4,4,2,44,0.08695652173913043,0.043478260869565216,0.9565217391304348,46,700,200,500,0.2857142857142857,12,2,10,304.9156670650476,0.41776368760064414,0.0836718412933577,0.1636738269140122,127904.94163940554,-1399.9558798209268,126504.98575958461,1984,0,573.9782608695652,43,3,16,39.40078324907946,0.5876937984496123,47.11174242424243,1011.5530303030314,23.524489076814685,0
2010,4,1,1,44,0.022222222222222223,0.022222222222222223,0.9777777777777777,45,1100,900,200,0.8181818181818182,13,9,4,311.5080156865218,0.41412037037037036,0.08948080014478443,0.16698557574320638,127850.36886492705,-1034.717058019339,126815.65180690771,1985,0,587.7111111111111,42,3,17,39.28970649292583,0.5885416666666666,47.16569767441861,1011.3372093023261,24.079457364341096,0
2011,4,0,1,43,0.0,0.022727272727272728,0.9772727272727273,44,700,300,400,0.42857142857142855,11,3,8,318.5656051393622,0.410610465116279,0.08791461163186853,0.17063264388783606,127818.28826727447,-656.2979300516545,127161.99033722281,1986,2,602.0681818181819,41,3,17,39.143999967297795,0.5896849593495934,47.19742063492063,1011.2103174603172,24.663666279519934,0
2012,4,0,0,43,0.0,0.0,1.0,43,1200,800,400,0.6666666666666666,16,8,8,328.9634722216144,0.40769195275009223,0.0868790636887129,0.17583018045074691,127733.27637525625,-196.0835770705121,127537.19279818573,1987,3,616.9767441860465,40,3,17,38.96798867330185,0.5903645833333333,47.28150406504066,1010.8739837398383,25.271849593495958,0
2013,4,1,1,43,0.022727272727272728,0.022727272727272728,0.9772727272727273,44,1200,800,400,0.6666666666666666,16,8,8,325.32672076990116,0.41288979915433405,0.09460411132307578,0.17479883553274247,127943.71712805488,-475.2980127236129,127468.41911533127,1988,0,603.9318181818181,41,3,17,38.845034974177956,0.5909552845528455,47.073412698412696,1011.7063492063489,24.675764614789,0
2014,4,1,0,44,0.022727272727272728,0.0,1.0,44,450,400,50,0.8888888888888888,5,4,1,345.48641162650256,0.41100687103594086,0.1382754140954856,0.18695125859367306,128227.80957842777,60.82304197774579,128288.63262040551,1989,0,604.9090909090909,37,7,18,38.04479719245065,0.6005067567567568,46.792763157894726,1012.8289473684194,27.373755334281608,0
2015,4,0,0,44,0.0,0.0,1.0,44,1450,1000,450,0.6896551724137931,19,10,9,341.07712516419605,0.41144732205778717,0.1369240348692402,0.1858106726640768,128496.3348765431,-34.56790123458063,128461.76697530852,1990,1,605.9090909090909,38,6,16,37.8824200913242,0.6014254385964912,46.52777777777777,1013.888888888888,26.68128654970758,0
2016,4,0,0,44,0.0,0.0,1.0,44,1050,600,450,0.5714285714285714,15,6,9,338.33147489097973,0.4113592318534179,0.1382429845449875,0.18451859428928225,128540.34423828126,-102.15115017361131,128438.19308810766,1991,2,606.9090909090909,39,5,16,37.90714346858415,0.6001602564102564,46.484375,1014.0625000000001,26.001602564102566,0
2017,4,0,0,44,0.0,0.0,1.0,44,1200,900,300,0.75,15,9,6,333.4750804593628,0.4110729386892178,0.1359204043451432,0.18610837172239,129452.3329894775,-139.86163410857716,129312.47135536892,1992,3,607.9090909090909,37,7,15,37.10257066408074,0.6128941441441441,45.58662280701754,1017.6535087719295,27.504148885727826,4
2018,4,2,0,46,0.043478260869565216,0.0,1.0,46,1500,1000,500,0.6666666666666666,20,10,10,323.6818959122159,0.41250000000000003,0.14990895767642254,0.18317027520119025,129996.88042534713,-784.4726562500091,129212.40776909712,1993,0,582.4347826086956,39,7,17,36.799880830779706,0.6148504273504274,45.05208333333333,1019.7916666666658,26.14850427350425,0
2019,4,0,0,46,0.0,0.0,1.0,46,1350,1000,350,0.7407407407407407,17,10,7,323.5243108296376,0.4118860708534622,0.15390523035398784,0.18358036502117434,130103.13042534716,-781.6948784722264,129321.43554687493,1994,1,583.4347826086956,39,7,18,36.69636171805868,0.6159188034188035,44.947916666666664,1020.2083333333328,26.15918803418802,0
2020,4,1,0,47,0.02127659574468085,0.0,1.0,47,850,500,350,0.5882352941176471,12,5,7,317.0756631202917,0.41381436941103916,0.18021229908620562,0.17839509531111367,129770.2725312314,-1170.4056442717647,128599.86688695963,1995,0,572.0,40,7,17,37.197661081188905,0.6109375000000001,45.27439024390244,1018.9024390243902,25.472560975609756,1
2021,4,2,1,48,0.04081632653061224,0.02040816326530612,0.9795918367346939,49,750,400,350,0.5333333333333333,11,4,7,315.081835007937,0.41879251700680276,0.2107811832738471,0.166964524776841,127385.30305420373,-1762.4138414569475,125622.88921274678,1996,0,549.6122448979592,42,7,13,39.67412171242083,0.5838293650793649,47.625968992248076,1009.4961240310099,24.035622000738332,6
2022,4,1,0,49,0.02040816326530612,0.0,1.0,49,1300,700,600,0.5384615384615384,19,7,12,314.60877915147455,0.4208652210884354,0.22656523477326096,0.16757668820604504,127593.81030654561,-1771.5734224345665,125822.23688411104,1997,0,550.5714285714286,43,6,15,39.47310353985066,0.5845445736434108,47.41950757575758,1010.32196969697,23.49585976039465,0
2023,4,1,1,49,0.02,0.02,0.98,50,1200,1000,200,0.8333333333333334,14,10,4,311.0515521095398,0.4247108843537415,0.23319247985675906,0.16720143585483957,127961.17297442789,-2039.4957073093642,125921.67726711852,1998,0,540.54,45,5,17,39.188301999403166,0.5856481481481481,47.056159420289866,1011.7753623188426,22.483896940418724,0
2024,4,3,2,50,0.057692307692307696,0.038461538461538464,0.9615384615384616,52,1300,900,400,0.6923076923076923,17,9,8,300.4344432250408,0.4303277400703871,0.23667878883706162,0.1633087783564052,128408.33875868081,-2683.8173481476874,125724.52141053313,1999,0,520.5961538461538,43,9,15,39.002012675573816,0.5927810077519379,46.61458333333334,1013.5416666666687,23.570736434108575,0
2025,4,2,2,50,0.038461538461538464,0.038461538461538464,0.9615384615384616,52,1350,600,750,0.4444444444444444,21,6,15,302.76890719009253,0.4320324283559578,0.25197892498760943,0.16517331773299565,128552.3480992455,-2615.6692098542003,125936.6788893913,2000,0,521.5576923076923,43,9,16,38.7965146138762,0.5942344961240309,46.47253787878789,1014.1098484848501,23.583949964763956,0
2026,4,1,0,51,0.0196078431372549,0.0,1.0,51,1350,800,550,0.5925925925925926,19,8,11,304.70402261851814,0.4318464052287582,0.2449004814417406,0.1667828447903036,128684.70687045569,-2357.850433417446,126326.85643703824,2001,0,527.7450980392157,42,9,17,38.61299462006176,0.5969742063492063,46.3420542635659,1014.6317829457379,24.15789959394614,0
2027,4,2,1,52,0.03773584905660377,0.018867924528301886,0.9811320754716981,53,1850,1500,350,0.8108108108108109,22,15,7,296.02483870135154,0.43547411707789063,0.25006912533410497,0.16378517137414558,129111.2745837735,-2955.971153362505,126155.30343041099,2002,0,508.79245283018867,46,7,18,38.40064549895325,0.5960144927536231,45.92198581560284,1016.312056737589,22.093740363860633,0
2028,4,1,3,50,0.018867924528301886,0.05660377358490566,0.9433962264150944,53,1600,900,700,0.5625,23,9,14,297.9247587442101,0.4351415094339623,0.24090537272915236,0.16552251683538838,129275.28511094594,-2897.012626144686,126378.27248480126,2003,0,509.77358490566036,42,11,19,38.18623947911703,0.6029265873015872,45.76065891472869,1016.957364341086,24.213270579549665,0
2029,4,1,0,51,0.0196078431372549,0.0,1.0,51,950,500,450,0.5263157894736842,14,5,9,305.40519253781076,0.43223856209150324,0.2441817681709233,0.1691593442825473,129154.32527434849,-2311.1196844993037,126843.20558984918,2004,0,530.4313725490196,44,7,20,38.11866156555538,0.5989583333333333,45.87962962962963,1016.481481481482,23.101851851851862,0
2030,4,1,1,51,0.019230769230769232,0.019230769230769232,0.9807692307692307,52,1150,800,350,0.6956521739130435,15,8,7,300.14784580498866,0.43482905982905984,0.24278021978022046,0.1672798503690225,129398.4924283397,-2632.238529279527,126766.25389906018,2005,0,521.2115384615385,42,10,20,38.00496031746032,0.6041666666666666,45.639534883720934,1017.4418604651167,24.2248062015504,0
2031,4,3,3,51,0.05555555555555555,0.05555555555555555,0.9444444444444444,54,1350,900,450,0.6666666666666666,18,9,9,288.86209745116577,0.43558554623806195,0.24580276535310697,0.16293559812621397,129869.89935314274,-3297.101695415877,126572.79765772686,2006,0,502.85185185185185,45,9,15,37.815749133564374,0.6048611111111111,45.17663043478261,1019.2934782608697,22.650966183574884,0
2032,4,1,1,51,0.019230769230769232,0.019230769230769232,0.9807692307692307,52,1500,900,600,0.6,21,9,12,299.64575099171736,0.43362713675213677,0.2529067126896174,0.16908252550834527,129884.77473422488,-2616.1158264746355,127268.65890775024,1893,0,484.59615384615387,44,8,16,37.52592575771336,0.6062973484848486,45.16203703703703,1019.3518518518512,23.167087542087526,0
2033,4,1,0,52,0.019230769230769232,0.0,1.0,52,1250,900,350,0.72,16,9,7,302.02490764358186,0.4336035696329814,0.25700094277034813,0.17104392584545247,130026.38996056223,-2545.7583161865805,127480.63164437565,1894,0,485.4807692307692,44,8,20,37.322212134967465,0.6077178030303031,45.02314814814814,1019.9074074074059,23.17971380471377,0
2034,4,0,3,49,0.0,0.057692307692307696,0.9423076923076923,52,550,200,350,0.36363636363636365,9,2,7,303.7951126643196,0.433642848164907,0.2565614965796459,0.1725681516268452,130144.46159122064,-2492.5497256515973,127651.91186556904,1895,1,486.4807692307692,44,8,20,37.1578191167574,0.6089015151515154,44.9074074074074,1020.3703703703686,23.19023569023565,0
2035,4,0,0,49,0.0,0.0,1.0,49,1300,1000,300,0.7692307692307693,16,10,6,320.72033672545206,0.4269593253968254,0.2544316996871747,0.1809665820897316,129883.08930342937,-1468.7703727324592,128414.31893069691,1896,2,516.7142857142857,41,8,20,36.99057177615573,0.610518292682927,45.16369047619046,1019.3452380952353,24.86207897793257,0
2036,4,1,1,49,0.02,0.02,0.98,50,1550,1100,450,0.7096774193548387,20,11,9,314.4906136120788,0.42863945578231294,0.25086386937535643,0.17907265533998,130237.85848957363,-1808.2831936182047,128429.57529595542,1897,0,507.36,42,8,21,36.79059078539333,0.6125992063492065,44.8158914728682,1020.7364341085246,24.303248431155346,0
2037,4,0,0,49,0.0,0.0,1.0,49,1250,900,350,0.72,16,9,7,322.4773455538809,0.42752621882086167,0.25737811979791436,0.1832708540759803,130163.68762581857,-1405.0319053843134,128758.65572043425,1898,4,518.7142857142857,42,7,22,36.6618000822967,0.6118551587301588,44.88856589147286,1020.445736434107,24.296327057954926,0
2038,4,0,0,49,0.0,0.0,1.0,49,1400,800,600,0.5714285714285714,20,8,12,322.89936911510557,0.42646329365079366,0.2515411222616717,0.18473460989164137,130422.14084201425,-1377.2419271771873,129044.89891483706,1899,5,519.7142857142857,39,10,22,36.38971038139914,0.6191239316239315,44.635416666666686,1021.4583333333363,26.191239316239393,0
2039,4,0,0,49,0.0,0.0,1.0,49,900,500,400,0.5555555555555556,13,5,8,325.55905356748406,0.4260026927437642,0.2577487765089719,0.18651186900641883,130475.34722222252,-1304.5138888888532,129170.83333333368,1900,6,520.7142857142857,39,10,22,36.26801250679719,0.6196581196581195,44.58333333333335,1021.666666666669,26.196581196581256,0
2040,4,0,0,49,0.0,0.0,1.0,49,1350,1000,350,0.7407407407407407,17,10,7,328.7753508312569,0.42605583900226757,0.2588417348186718,0.18887258444709032,130581.79253472261,-1213.5850694444057,129368.2074652782,1901,7,521.7142857142857,39,10,18,36.078271504280465,0.6207264957264955,44.479166666666686,1022.0833333333364,26.207264957265036,0
2041,4,1,1,49,0.02,0.02,0.98,50,1700,1100,600,0.6470588235294118,23,11,12,321.5302219123531,0.4281292517006803,0.25873286991062505,0.18629512857637529,130911.78882444353,-1581.5806976666888,129330.20812677684,1902,0,512.26,40,10,19,35.930362462760684,0.6223958333333331,44.15650406504067,1023.3739837398407,25.584349593496018,0
2042,4,0,0,49,0.0,0.0,1.0,49,1350,800,550,0.5925925925925926,19,8,11,326.776616373477,0.427703373015873,0.25837320574162614,0.18915301724435324,130874.74093967059,-1246.6389973957816,129628.1019422748,1903,1,516.1020408163265,39,10,19,35.833524211883685,0.6236645299145296,44.19270833333336,1023.2291666666704,26.236645299145394,0
2043,4,0,1,48,0.0,0.02040816326530612,0.9795918367346939,49,1350,1000,350,0.7407407407407407,17,10,7,323.7261260911854,0.42779195011337867,0.25212205191784864,0.18807479782252653,131015.81090124966,-1317.3518160486044,129698.45908520106,1904,2,517.1020408163265,40,9,20,35.76926576666006,0.6234374999999999,44.05487804878051,1023.7804878048812,25.59451219512203,0
2044,4,0,1,47,0.0,0.020833333333333332,0.9791666666666666,48,1150,800,350,0.6956521739130435,15,8,7,328.8241495233457,0.4248300827423168,0.25300397219463644,0.19052124198504627,130911.7888244437,-990.6084754444514,129921.18034899926,1905,3,528.6666666666666,40,8,21,35.743752068851386,0.622395833333333,44.15650406504068,1023.3739837398421,25.58434959349605,0
2045,4,1,0,48,0.020833333333333332,0.0,1.0,48,1300,1100,200,0.8461538461538461,15,11,4,328.76525986765375,0.42600288120567376,0.2662482635443535,0.19152001670209376,131119.87428944441,-978.4680910833206,130141.40619836109,1906,0,529.375,40,8,22,35.53532446914068,0.6244791666666665,43.95325203252034,1024.1869918699213,25.604674796748032,0
2046,4,0,0,48,0.0,0.0,1.0,48,1150,600,550,0.5217391304347826,17,6,11,333.0025668116956,0.42586436170212766,0.2691347616213715,0.1945151725721621,131223.97898902782,-860.4156338819346,130363.56335514589,1907,1,530.375,40,8,22,35.321819414137416,0.6255208333333333,43.85162601626017,1024.5934959349604,25.61483739837401,0
2047,4,0,0,48,0.0,0.0,1.0,48,1200,600,600,0.5,18,6,12,335.76817872127606,0.42605828900709225,0.26666015285739153,0.19680486712465742,131355.50356353633,-778.917737913622,130576.58582562271,1908,2,531.375,38,10,22,35.118334201841236,0.6302083333333334,43.723290598290596,1025.106837606837,26.97649572649571,0
2048,4,0,0,48,0.0,0.0,1.0,48,1700,1300,400,0.7647058823529411,21,13,8,335.9100078644073,0.4263815011820331,0.26782842390384265,0.1974348673089604,131461.62245008667,-768.1450737847417,130693.47737630192,1909,3,532.375,39,9,22,35.00772388691382,0.6295405982905984,43.61979166666666,1025.5208333333321,26.29540598290595,0
2049,4,2,1,49,0.04,0.02,0.98,50,1250,1000,250,0.8,15,10,5,329.1818845872903,0.429812925170068,0.2885405405405408,0.1964472537053181,132040.89506172814,-1306.905864197555,130733.98919753058,1910,0,512.04,41,9,21,34.5974099099099,0.6321138211382115,43.05555555555554,1027.7777777777758,25.067750677506726,0
2050,4,0,0,49,0.0,0.0,1.0,49,1050,600,450,0.5714285714285714,15,6,9,336.22459976107024,0.4271364795918367,0.28703043294939246,0.2003805756228514,131989.9189421135,-924.3484662383801,131065.57047587511,1911,1,523.4897959183673,41,8,21,34.467722211495136,0.6316056910569108,43.10515873015871,1027.579365079362,25.062911343399076,0
2051,4,0,1,48,0.0,0.02040816326530612,0.9795918367346939,49,1150,600,550,0.5217391304347826,17,6,11,282.90902666416486,0.42697704081632654,0.10994105569905255,0.16169442779931192,130383.45210808367,-2398.0641448905344,127985.38796319313,1912,2,524.4897959183673,43,6,15,37.44987250811313,0.6126453488372093,44.67329545454545,1021.306818181818,23.751321353065535,7
2052,4,0,0,48,0.0,0.0,1.0,48,1450,1100,350,0.7586206896551724,18,11,7,290.67418238642716,0.4251348256501182,0.11159076533839363,0.16614457062651508,130386.26359593753,-2020.0158869659508,128366.24770897158,1913,3,536.2083333333334,42,6,15,37.24877450980392,0.6140873015873016,44.670542635658904,1021.3178294573627,24.317091177556254,0
2053,4,2,0,50,0.04,0.0,1.0,50,1400,1000,400,0.7142857142857143,18,10,8,283.3188197411862,0.4292602040816327,0.12008141112618809,0.16441414972382176,130972.46334876503,-2578.607253086452,128393.85609567858,1914,0,515.72,44,6,16,36.84701492537317,0.6171875000000002,44.09722222222221,1023.6111111111079,23.263888888888815,0
2054,4,0,0,50,0.0,0.0,1.0,50,750,400,350,0.5333333333333333,11,4,7,283.5879584969706,0.4295833333333334,0.11441229656419538,0.16507804320928887,131090.96364883368,-2564.8362482853527,128526.12740054833,1915,1,516.72,44,6,18,36.721104581072936,0.6183712121212124,43.98148148148147,1024.0740740740714,23.274410774410715,0
2055,4,0,0,50,0.0,0.0,1.0,50,650,400,250,0.6153846153846154,9,4,5,283.61915493554574,0.42931972789115647,0.11529698942229505,0.16519807650037188,131114.67013888844,-2562.6736111111504,128551.99652777729,1916,2,517.72,44,6,18,36.69650122050448,0.6186079545454548,43.958333333333314,1024.166666666663,23.27651515151507,0
2056,4,0,0,50,0.0,0.0,1.0,50,900,700,200,0.7777777777777778,11,7,4,286.3080459457737,0.42967687074829936,0.10865714802096482,0.16728008640105202,131233.23473936864,-2485.373799725692,128747.86093964294,1917,3,518.72,44,6,19,36.508599915657534,0.6197916666666669,43.842592592592574,1024.6296296296266,23.287037037036967,0
2057,4,1,0,51,0.0196078431372549,0.0,1.0,51,1550,1200,350,0.7741935483870968,19,12,7,278.55054722558043,0.4297712418300654,0.10790196259432427,0.1640858117506637,131546.6106824636,-2871.4553346402695,128675.15534782333,1918,0,509.52941176470586,43,8,20,36.39313901966214,0.6242732558139537,43.536931818181806,1025.8522727272707,23.85702959830862,0
2058,4,0,1,50,0.0,0.0196078431372549,0.9803921568627451,51,1350,900,450,0.6666666666666666,18,9,9,276.05500198004074,0.42900326797385624,0.10670516591947776,0.16313435722244685,131668.0700829313,-2930.474130509665,128737.59595242165,1919,1,510.52941176470586,43,8,10,36.33550163006705,0.6254844961240311,43.418560606060595,1026.3257575757555,23.868040873854778,0
2059,4,0,0,50,0.0,0.0,1.0,50,1000,600,400,0.6,14,6,8,281.3084479431627,0.42813775510204083,0.09795201209144189,0.16562465127510095,131526.84352653055,-2600.0775569377115,128926.76596959283,1920,6,521.72,42,8,19,36.34222085773664,0.6254960317460319,43.556201550387584,1025.7751937984472,24.42321889996303,0
2060,4,0,0,50,0.0,0.0,1.0,50,1600,1000,600,0.625,22,10,12,282.90428285797793,0.42754251700680274,0.10061184024171488,0.16710759953981275,131651.11889497313,-2551.066924313456,129100.05197065967,1921,7,522.72,42,8,11,36.176745979290594,0.6267361111111112,43.43507751937984,1026.2596899224795,24.4347545219638,0
2061,4,0,0,50,0.0,0.0,1.0,50,900,400,500,0.4444444444444444,14,4,10,279.95924390959175,0.42683673469387756,0.09404592824863989,0.16597037078795537,131789.5855303747,-2620.857455951568,129168.72807442312,1922,8,523.72,43,7,11,36.11364090503857,0.6266957364341086,43.30018939393939,1026.7992424242418,23.879052149400973,0
2062,4,0,1,49,0.0,0.02,0.98,50,1400,900,500,0.6428571428571429,19,9,10,278.47189701886754,0.42701530612244903,0.09001622498647999,0.16556094456202092,131898.1867283948,-2654.0123456790297,129244.17438271576,1923,9,524.72,44,6,12,36.04313142239049,0.6264204545454547,43.194444444444436,1027.2222222222201,23.34595959595955,0
2063,4,1,0,50,0.02,0.0,1.0,50,1350,1200,150,0.8888888888888888,15,12,3,277.9189517764712,0.42681972789115646,0.10246735704637588,0.16637681722251832,132159.87761488341,-2654.0530692729726,129505.82454561045,1924,0,523.16,44,6,15,35.7956250938016,0.6290246212121211,42.93981481481482,1028.2407407407409,23.369107744107747,0
2064,4,1,2,49,0.0196078431372549,0.0392156862745098,0.9607843137254902,51,700,400,300,0.5714285714285714,10,4,6,272.2549132095263,0.42764705882352944,0.10954989283162653,0.16401698429939782,132398.00347222242,-2990.5842764060167,129407.4191958164,1925,0,513.8823529411765,44,7,16,35.703441295546554,0.6313920454545454,42.70833333333334,1029.1666666666683,23.390151515151555,0
2065,4,0,0,49,0.0,0.0,1.0,49,1400,900,500,0.6428571428571429,19,9,10,281.2144669014007,0.4229202097505669,0.10795412907820356,0.16865103948183968,132227.50521012695,-2363.1425225263833,129864.36268760057,1926,1,535.4081632653061,43,6,16,35.64329941994294,0.6310562015503876,42.87405303030304,1028.503787878789,23.918692741367185,0
2066,4,0,0,49,0.0,0.0,1.0,49,1050,700,350,0.6666666666666666,14,7,7,281.3388341925511,0.42284934807256236,0.10318096865989834,0.1691613964306627,132324.9193371933,-2354.372291810113,129970.5470453832,1927,2,536.4081632653061,43,6,16,35.542740450989434,0.6320251937984496,42.77935606060608,1028.8825757575785,23.92750176180415,0
2067,4,0,0,49,0.0,0.0,1.0,49,1850,1300,550,0.7027027027027027,24,13,11,279.13914340507125,0.42277848639455784,0.10195819218375601,0.1681643132220799,132398.00347222254,-2408.5069444444102,129989.49652777813,1928,3,537.4081632653061,43,6,17,35.52631578947369,0.6327519379844959,42.70833333333335,1029.1666666666692,23.934108527131844,0
2068,4,0,0,49,0.0,0.0,1.0,49,950,700,250,0.7368421052631579,12,7,5,279.68932866254175,0.423203656462585,0.10183335382345726,0.1688306493017525,132472.80812451182,-2389.7538459227126,130083.05427858912,1929,4,538.4081632653061,42,7,18,35.43745293674698,0.6349206349206348,42.63565891472869,1029.4573643410858,24.510889627168712,0
2069,4,0,1,48,0.0,0.02040816326530612,0.9795918367346939,49,1050,800,250,0.7619047619047619,13,8,5,281.9497470766604,0.4231327947845805,0.10370373215149797,0.17064703370904039,132572.58052400697,-2324.2388903912065,130248.34163361577,1930,5,539.4081632653061,42,7,20,35.2796465311755,0.6359126984126984,42.53875968992248,1029.84496124031,24.52011812476929,0
2070,4,0,0,48,0.0,0.0,1.0,48,1200,800,400,0.6666666666666666,16,8,8,282.33400470920765,0.41964021867612294,0.0938548427554633,0.17122035391121435,132647.43447096032,-2109.8237222823136,130537.61074867801,1931,6,550.6875,42,6,11,35.19502712193898,0.636656746031746,42.46608527131783,1030.135658914729,24.52703949796974,0
2071,4,1,2,47,0.02040816326530612,0.04081632653061224,0.9591836734693877,49,1200,900,300,0.75,15,9,6,277.7127746119361,0.4210069444444444,0.10192276341259121,0.16982424639520483,132958.98549593965,-2415.118245666881,130543.86725027277,1932,0,540.4285714285714,43,6,13,35.00338582315675,0.6383236434108527,42.163825757575765,1031.344696969698,23.984760394644137,0
2072,4,0,1,46,0.0,0.02127659574468085,0.9787234042553191,47,950,700,250,0.7368421052631579,12,7,5,285.3923745413586,0.4190178846746839,0.09691138450833492,0.17423179905304623,132897.10020619252,-1814.4362004987702,131082.66400569375,1933,1,551.2127659574468,42,5,14,34.86710208940262,0.6391369047619048,42.223837209302324,1031.1046511627906,24.550110741971203,0
2073,4,0,0,46,0.0,0.0,1.0,46,1500,1100,400,0.7333333333333333,19,11,8,290.649355624635,0.4162942834138486,0.09068185526211181,0.17737632137444673,132883.42195964014,-1475.503806846836,131407.9181527933,1934,2,563.6086956521739,41,5,15,34.745241187979076,0.6404979674796749,42.23710317460316,1031.0515873015856,25.147599690282576,0
2074,4,0,0,46,0.0,0.0,1.0,46,1000,800,200,0.8,12,8,4,290.649355624635,0.4162942834138486,0.09068185526211181,0.17737632137444673,132883.42195964014,-1475.503806846836,131407.9181527933,1935,3,564.6086956521739,41,5,15,34.745241187979076,0.6404979674796749,42.23710317460316,1031.0515873015856,25.147599690282576,0
2075,4,0,1,45,0.0,0.021739130434782608,0.9782608695652174,46,1150,1100,50,0.9565217391304348,12,11,1,291.0307140147913,0.4163546698872786,0.0958147171013406,0.17826887119686213,133022.02109999378,-1457.3012439156491,131564.71985607813,1936,4,565.6086956521739,42,4,17,34.59711002567476,0.6403769841269842,42.102713178294564,1031.58914728682,24.561646363971903,0
2076,4,1,0,46,0.021739130434782608,0.0,1.0,46,1100,700,400,0.6363636363636364,15,7,8,289.32971853027396,0.41724033816425116,0.09191263523167992,0.1777025087858947,133122.00006760395,-1496.769838050615,131625.23022955333,1937,0,566.3478260869565,42,4,18,34.541275430359946,0.6413690476190477,42.005813953488364,1031.9767441860452,24.570874861572502,0
2077,4,0,0,46,0.0,0.0,1.0,46,1450,1100,350,0.7586206896551724,18,11,7,290.37129491775363,0.4167773752012882,0.09962866994470843,0.17894194027464788,133247.0265928279,-1461.7776688600495,131785.24892396785,1938,1,567.3478260869565,42,4,20,34.38976223994995,0.642609126984127,41.88468992248062,1032.461240310077,24.582410483573263,0
2078,4,0,0,46,0.0,0.0,1.0,46,1450,1000,450,0.6896551724137931,19,10,9,292.07425206371056,0.41678743961352654,0.10341282726998302,0.18035500454779976,133322.07067634142,-1412.011184724491,131910.05949161694,1939,2,568.3478260869565,42,4,20,34.27100925752172,0.6433531746031746,41.81201550387596,1032.751937984495,24.58933185677369,0
2079,4,0,0,46,0.0,0.0,1.0,46,1350,900,450,0.6666666666666666,18,9,9,292.9322166517632,0.41544887278582926,0.10687692169672047,0.18137301358542954,133422.16231746878,-1383.270048374511,132038.89226909427,1940,3,569.3478260869565,42,4,20,34.14911992746826,0.6443452380952381,41.71511627906976,1033.13953488372,24.598560354374285,0
2080,4,0,0,46,0.0,0.0,1.0,46,1100,600,500,0.5454545454545454,16,6,10,280.4397023009673,0.4149557165861513,0.07583912924043457,0.17491045053277338,133692.48347286767,-1701.4639469984093,131991.01952586925,1941,4,570.3478260869565,43,3,18,34.20293089765896,0.6455910852713179,41.45359848484848,1034.1856060606044,24.050828047921033,4
2081,4,0,0,46,0.0,0.0,1.0,46,1200,800,400,0.6666666666666666,16,8,8,280.82584021126416,0.41398953301127217,0.07932016967902666,0.17573328351364667,133814.92930010316,-1684.2620092975344,132130.66729080564,1942,5,571.3478260869565,43,3,15,34.07125205930808,0.6468023255813955,41.335227272727266,1034.6590909090896,24.0618393234672,0
2082,4,0,0,46,0.0,0.0,1.0,46,1300,600,700,0.46153846153846156,20,6,14,278.91084759136226,0.41366747181964575,0.07358456050489304,0.17534975829306274,133986.44761715154,-1725.9452658689265,132260.5023512826,1943,6,572.3478260869565,43,3,15,33.95044437330406,0.6484980620155039,41.16950757575757,1035.321969696969,24.07725510923184,0
2083,4,0,0,46,0.0,0.0,1.0,46,750,300,450,0.4,12,3,9,281.398775463242,0.4126610305958132,0.07983073015014885,0.17738665171420598,134084.50740537464,-1653.7567615071232,132430.7506438675,1944,7,573.3478260869565,43,3,15,33.788687482856375,0.6494670542635659,41.0748106060606,1035.7007575757566,24.08606412966876,0
2084,4,0,0,46,0.0,0.0,1.0,46,1000,400,600,0.4,16,4,12,278.58464997777094,0.4121074879227053,0.08388952453597764,0.17643694498592155,134256.19834710742,-1719.6567952249816,132536.54155188243,1945,8,574.3478260869565,43,3,17,33.69121588693957,0.6511627906976745,40.90909090909091,1036.363636363636,24.101479915433398,0
2085,4,0,1,45,0.0,0.021739130434782608,0.9782608695652174,46,1150,600,550,0.5217391304347826,17,6,11,278.7989431289029,0.4119464573268921,0.07964130831916894,0.17704703186631246,134354.35677800715,-1708.429465105619,132645.92731290153,1946,9,575.3478260869565,43,3,17,33.58832663500182,0.6521317829457365,40.81439393939393,1036.7424242424227,24.110288935870294,0
2086,4,0,0,45,0.0,0.0,1.0,45,650,300,350,0.46153846153846156,10,3,7,285.11391167004996,0.40925925925925927,0.08156804088373693,0.18078621891728058,134299.56625390603,-1341.865065951561,132957.70118795446,1947,15,588.9333333333333,42,3,17,33.47901280732917,0.6530257936507936,40.867248062015506,1036.5310077519382,24.67930970837948,0
2087,4,0,0,45,0.0,0.0,1.0,45,1150,900,250,0.782608695652174,14,9,5,285.83736570879563,0.40917508417508414,0.08640913811007334,0.1816187537460875,134374.9061054024,-1318.1261642930035,133056.7799411094,1948,16,589.9333333333333,42,3,17,33.38551401869161,0.6537698412698413,40.79457364341086,1036.821705426357,24.68623108157993,0
2088,4,0,0,45,0.0,0.0,1.0,45,1300,800,500,0.6153846153846154,18,8,10,288.46374607445665,0.40852272727272726,0.08879541108986633,0.18443342200115,134602.24946460058,-1234.311156996407,133367.93830760417,1949,17,590.9333333333333,41,4,18,33.0919375398343,0.6575203252032521,40.57539682539682,1037.698412698412,25.3097173828881,0
2089,4,0,0,45,0.0,0.0,1.0,45,1100,600,500,0.5454545454545454,16,6,10,295.14080210304877,0.40860690235690234,0.05378322470660457,0.186121535910294,134098.76326730644,-1084.3966896520783,133014.36657765435,1950,18,591.9333333333333,42,3,14,33.418701468799725,0.6510416666666667,41.0610465116279,1035.7558139534867,24.660852713178254,3
2090,4,0,0,45,0.0,0.0,1.0,45,1300,800,500,0.6153846153846154,18,8,10,293.321758189207,0.40795454545454546,0.0556106176302531,0.1857357136668777,134249.3514230663,-1124.348840965106,133125.0025821012,1951,19,592.9333333333333,42,3,15,33.31619136668224,0.652529761904762,40.915697674418595,1036.337209302324,24.674695459579144,0
2091,4,0,1,44,0.0,0.022222222222222223,0.9777777777777777,45,1000,900,100,0.9,11,9,2,292.47145260097375,0.4075126262626263,0.053218670156415016,0.18557886120552894,134324.67719037324,-1142.773308394927,133181.90388197833,1952,20,593.9333333333333,42,3,15,33.263421511809035,0.6532738095238095,40.843023255813954,1036.6279069767447,24.681616832779635,0
2092,4,0,0,44,0.0,0.0,1.0,44,850,500,350,0.5882352941176471,12,5,7,292.3015251233587,0.40618393234672306,0.06711159997621707,0.18610965041019087,134450.26708318316,-939.9963756685306,133510.27070751463,1953,21,604.7045454545455,42,2,16,33.14316079603848,0.654513888888889,40.7218992248062,1037.1124031007755,24.693152454780368,0
2093,4,1,1,44,0.022222222222222223,0.022222222222222223,0.9777777777777777,45,900,700,200,0.7777777777777778,11,7,4,286.4544510614704,0.40812289562289567,0.06345471521942159,0.18326924557158591,134626.1915224446,-1287.1080839492768,133339.08343849532,1954,0,592.2444444444444,42,3,16,33.120331465919705,0.65625,40.55232558139535,1037.7906976744189,24.7093023255814,0
2094,4,0,0,44,0.0,0.0,1.0,44,1350,1100,250,0.8148148148148148,16,11,5,291.4576962148277,0.40563336856941506,0.0676215417787922,0.18634152052325906,134601.05241759805,-953.8974708551232,133647.15494674293,1955,23,606.7045454545455,42,2,17,33.01545429078346,0.6560019841269842,40.576550387596896,1037.6937984496121,24.70699520118124,0
2095,4,0,0,44,0.0,0.0,1.0,44,1150,700,450,0.6086956521739131,16,7,9,290.8671429296728,0.40491763565891475,0.06457990394895341,0.1866078185238631,134726.7714154798,-962.4817844480576,133764.28963103174,1956,24,607.7045454545455,42,2,17,32.90612749673323,0.6572420634920635,40.45542635658914,1038.1782945736431,24.71853082318198,0
2096,4,0,1,43,0.0,0.022727272727272728,0.9772727272727273,44,1550,1300,250,0.8387096774193549,18,13,5,290.9657239082539,0.4054131430584919,0.06036149892279763,0.18718911337627042,134827.38886635416,-953.9702391683263,133873.41862718583,1957,25,608.7045454545455,42,2,12,32.80385022081233,0.658234126984127,40.35852713178294,1038.5658914728679,24.727759320782567,0
2097,4,0,0,43,0.0,0.0,1.0,43,1150,900,250,0.782608695652174,14,9,5,295.87925513919527,0.40358527131782945,0.06218730838613351,0.19024963407844553,134808.22074200038,-622.6088120433512,134185.61192995703,1958,26,622.3720930232558,41,2,13,32.69527767163419,0.6595528455284554,40.37698412698412,1038.4920634920625,25.329074719318598,0
2098,4,0,0,43,0.0,0.0,1.0,43,750,400,350,0.5333333333333333,11,4,7,312.2847307011833,0.4038621262458472,0.07309224776489298,0.1963255090119003,133985.28045477427,-231.68855505167153,133753.5918997226,1959,27,623.3720930232558,41,2,14,33.087789063498136,0.6514227642276424,41.17063492063491,1035.3174603174587,25.251645373596553,2
2099,4,0,0,43,0.0,0.0,1.0,43,1500,1200,300,0.8,18,12,6,310.69882978516966,0.40330841638981174,0.07158033522937335,0.19614976908202797,134139.38984158478,-264.6097096245854,133874.7801319602,1960,28,624.3720930232558,41,2,15,32.975403817914845,0.6529471544715446,41.0218253968254,1035.9126984126985,25.266163375919476,0
2100,4,0,1,42,0.0,0.023255813953488372,0.9767441860465116,43,1200,800,400,0.6666666666666666,16,8,8,306.3215400624348,0.40344684385382057,0.027569392348086863,0.18991935483870978,133472.2222222223,-414.63962899973706,133057.58259322256,1961,29,625.3720930232558,41,2,17,33.75336021505376,0.646341463414634,41.66666666666667,1033.3333333333342,25.203252032520346,3
2101,4,0,0,42,0.0,0.0,1.0,42,750,400,350,0.5333333333333333,11,4,7,311.66252252738326,0.4037456445993031,0.022624434389140413,0.19295744238814735,133419.7206110782,-83.61466389052316,133336.10594718767,1962,30,639.0952380952381,40,2,17,33.66778149386847,0.6473958333333333,41.717479674796756,1033.1300813008143,25.828252032520357,0
2102,4,1,1,42,0.023255813953488372,0.023255813953488372,0.9767441860465116,43,1250,1000,250,0.8,15,10,5,302.8744566944776,0.40716131413805834,0.02856875169956874,0.1889854902378726,133708.60727947994,-500.6053151232585,133208.0019643567,1963,0,625.2093023255813,40,3,15,33.606825849136946,0.6502604166666666,41.43800813008131,1034.247967479676,25.856199186991898,0
2103,4,0,0,42,0.0,0.0,1.0,42,1000,700,300,0.7,13,7,6,309.64715148307295,0.40305603948896634,0.027916930577148502,0.19253999569661762,133579.88281250015,-127.47395833331814,133452.40885416683,1964,32,641.0952380952381,39,3,18,33.560056428859326,0.6506410256410255,41.56250000000001,1033.7500000000011,26.506410256410284,0
2104,4,0,0,42,0.0,0.0,1.0,42,1150,900,250,0.782608695652174,14,9,5,306.140941929584,0.40301974448315914,0.010085831863609895,0.18417570035870692,132345.71358194522,-296.71171673607216,132049.00186520914,1965,33,642.0952380952381,40,2,21,34.88395061728395,0.63671875,42.75914634146341,1028.963414634146,25.724085365853647,2
2105,4,0,0,42,0.0,0.0,1.0,42,1350,1000,350,0.7407407407407407,17,10,7,307.6595256437571,0.40254790940766555,0.013977250819355636,0.18534610447319047,132398.00347222236,-253.2882832639243,132144.71518895845,1966,34,643.0952380952381,39,3,21,34.79251012145747,0.638888888888889,42.708333333333336,1029.1666666666677,26.388888888888914,0
2106,4,0,0,42,0.0,0.0,1.0,42,850,300,550,0.35294117647058826,14,3,11,310.70301849661905,0.40252371273712734,0.01024606948921436,0.1875795926574273,132478.4193250867,-167.71104600695367,132310.70827907973,1967,35,644.0952380952381,39,3,21,34.6336512192654,0.639690170940171,42.63020833333333,1029.4791666666658,26.39690170940169,0
2107,4,0,0,42,0.0,0.0,1.0,42,950,400,550,0.42105263157894735,15,4,11,311.3723400265421,0.40280197444831595,0.014270297354069372,0.18811761667618213,132505.2300347221,-148.307291666671,132356.92274305545,1968,36,645.0952380952381,39,3,21,34.589572372858505,0.639957264957265,42.604166666666664,1029.5833333333326,26.39957264957263,0
2108,4,0,1,41,0.0,0.023809523809523808,0.9761904761904762,42,1050,700,350,0.6666666666666666,14,7,7,310.44880302400094,0.4031649245063879,0.020699133131298675,0.18806925395387014,132607.26631180177,-166.44658024325093,132440.81973155853,1969,37,646.0952380952381,40,2,21,34.5111823713205,0.6393229166666667,42.505081300813,1029.9796747967473,25.749491869918682,0
2109,4,1,2,40,0.023809523809523808,0.047619047619047616,0.9523809523809523,42,850,600,250,0.7058823529411765,11,6,5,311.48022742846337,0.40368515292295776,0.030559234938797752,0.18908901471076386,132685.7824790135,-134.2004593826701,132551.58201963082,1970,0,645.6666666666666,40,2,18,34.40603011770895,0.6401041666666668,42.42886178861787,1030.284552845526,25.757113821138148,0
2110,4,1,1,40,0.024390243902439025,0.024390243902439025,0.975609756097561,41,1450,1100,350,0.7586206896551724,18,11,7,313.9937879627958,0.4033790650406504,0.023961306926592485,0.19106116470503695,132773.486328125,138.00998263888883,132911.49631076388,1971,0,655.390243902439,39,2,19,34.25350380702108,0.6426282051282051,42.34375,1030.625,26.42628205128205,0
2111,4,0,0,40,0.0,0.0,1.0,40,700,500,200,0.7142857142857143,9,5,4,319.4661083472494,0.3999332264957265,0.019633969307341292,0.1940132965302815,132700.54879830507,478.66558002774525,133179.2143783328,1972,40,672.775,38,2,20,34.18554714502973,0.6436403508771931,42.41452991452991,1030.3418803418792,27.114260008996823,0
2112,4,0,0,40,0.0,0.0,1.0,40,900,800,100,0.8888888888888888,10,8,2,319.0006711589572,0.39977297008547014,0.021984455958549143,0.19458637652869396,132865.71905361972,476.8507104244315,133342.56976404414,1973,41,673.775,38,2,21,34.03216753022453,0.6452850877192982,42.254273504273506,1030.9829059829062,27.131129104813322,0
2113,4,0,0,40,0.0,0.0,1.0,40,1050,800,250,0.7619047619047619,13,8,5,320.5863846194552,0.3992387820512821,0.022607209446861454,0.19613060564741575,132975.88962853389,526.0519395134781,133501.94156804736,1974,42,674.775,38,2,21,33.88103376838616,0.6463815789473684,42.1474358974359,1031.4102564102566,27.14237516869096,0
2114,4,1,0,41,0.024390243902439025,0.0,1.0,41,950,500,450,0.5263157894736842,14,5,9,314.74676569923537,0.4008384146341464,0.03355688186698269,0.1942963533712467,133310.81271701402,191.82942708334272,133502.64214409736,1975,0,659.2926829268292,39,2,22,33.69687647098379,0.6479700854700854,41.82291666666667,1032.7083333333344,26.479700854700884,0
2115,4,0,0,41,0.0,0.0,1.0,41,1200,800,400,0.6666666666666666,16,8,8,316.34071275843354,0.4006859756097561,0.006067740881533945,0.1934655880497937,132962.84072983998,223.7919960949551,133186.63272593493,1976,1,660.2926829268292,37,4,17,34.00356155645331,0.6480855855855856,42.16008771929825,1031.3596491228072,27.874585111427223,3
2116,4,0,1,40,0.0,0.024390243902439025,0.975609756097561,41,1150,600,550,0.5217391304347826,17,6,11,319.8627638537699,0.4003556910569106,0.006096265000907097,0.1962130774357219,133075.95245652506,313.20839104339393,133389.16084756845,1977,2,661.2926829268292,37,4,19,33.79959263195183,0.6492117117117117,42.050438596491226,1031.7982456140348,27.88643907064959,0
2117,4,0,0,40,0.0,0.0,1.0,40,1100,900,200,0.8181818181818182,13,9,4,326.8377084042673,0.3980502136752137,0.009024896265560578,0.19981173121270246,132949.08717839472,690.5549975651447,133639.64217595986,1978,46,678.775,36,4,19,33.746678678022846,0.6498842592592593,42.17342342342343,1031.306306306307,28.64739739739742,0
2118,4,1,0,41,0.024390243902439025,0.0,1.0,41,700,500,200,0.7142857142857143,9,5,4,318.34557212853537,0.40099085365853654,0.007868489006648494,0.19632352670166445,133274.01369892654,285.4384281702025,133559.45212709674,1979,0,663.1951219512196,37,4,21,33.64073395632012,0.6511824324324325,41.858552631578945,1032.565789473684,27.907183499288756,0
2119,4,0,0,41,0.0,0.0,1.0,41,1000,800,200,0.8,12,8,4,319.19298151643784,0.4010416666666667,0.002386987037262145,0.1974469519938518,133387.2576778432,315.2552948984337,133702.51297274165,1980,1,664.1951219512196,37,4,21,33.505709761879494,0.6523085585585585,41.74890350877193,1033.0043859649127,27.919037458511152,0
2120,4,0,0,41,0.0,0.0,1.0,41,1500,1100,400,0.7333333333333333,19,11,8,320.8143777630371,0.400635162601626,0.00296074225861509,0.19906109159779514,133501.31539901387,365.855337649115,133867.17073666299,1981,2,665.1951219512196,36,5,21,33.349905561003936,0.6553819444444444,41.63851351351351,1033.4459459459458,28.706831831831828,0
2121,4,0,0,41,0.0,0.0,1.0,41,1350,900,450,0.6666666666666666,18,9,9,320.98931560036254,0.3997967479674797,0.004564535841436568,0.19963969628803027,133588.61395178956,376.103552877192,133964.71750466677,1982,3,666.1951219512196,36,5,21,33.25821532316629,0.65625,41.55405405405405,1033.7837837837833,28.716216216216203,0
2122,4,0,0,41,0.0,0.0,1.0,41,1150,800,350,0.6956521739130435,15,8,7,320.3862332118258,0.39865345528455287,0.009102381100146273,0.1998599835749961,133698.9265927977,367.0590951061695,134065.98568790389,1983,4,667.1951219512196,37,4,22,33.16369804919421,0.6554054054054055,41.44736842105262,1034.2105263157887,27.951635846372668,0
2123,4,0,0,41,0.0,0.0,1.0,41,1200,800,400,0.6666666666666666,16,8,8,318.28506707399475,0.3986026422764228,0.006126643142425392,0.19900726360789506,133783.99032635015,316.289266889787,134100.27959323995,1984,5,668.1951219512196,37,4,16,33.13316993464053,0.6562500000000002,41.365131578947356,1034.5394736842084,27.960526315789416,0
2124,4,0,0,41,0.0,0.0,1.0,41,1000,800,200,0.8,12,8,4,315.9771808537523,0.39781504065040646,0.005060516855036168,0.19786839122208744,133840.71451071464,258.1223309094894,134098.8368416241,1985,6,669.1951219512196,37,4,16,33.13630302709195,0.6568130630630632,41.31030701754385,1034.7587719298228,27.96645329540062,0
2125,4,0,0,41,0.0,0.0,1.0,41,750,600,150,0.8,9,6,3,317.9626903188741,0.3973323170731707,0.003462174452253164,0.19957232690227164,133925.8233302552,316.68301785161657,134242.5063481068,1986,7,670.1951219512196,37,4,17,33.000088276836166,0.6576576576576578,41.22807017543858,1035.0877192982434,27.97534376481739,0
2126,4,0,1,40,0.0,0.024390243902439025,0.975609756097561,41,1100,900,200,0.8181818181818182,13,9,4,318.7144538251998,0.3973577235772358,0.007052787401086613,0.20019848027702644,133954.19894823382,338.62787107568727,134292.8268193095,1987,8,671.1951219512196,37,4,17,32.95234879779683,0.6579391891891893,41.20065789473683,1035.1973684210507,27.97830725462299,0
2127,4,0,1,39,0.0,0.025,0.975,40,1150,700,450,0.6086956521739131,16,7,9,317.4222274285303,0.3964342948717949,0.028118051879301387,0.20000353155853667,134067.73147747366,511.2155903739414,134578.9470678476,1988,9,684.0,37,3,18,32.872661902241056,0.6590653153153154,41.091008771929815,1035.6359649122792,27.990161213845383,0
2128,4,0,2,37,0.0,0.05128205128205128,0.9487179487179487,39,850,600,250,0.7058823529411765,11,6,5,317.89944657184986,0.3960582546108862,0.04154454069780056,0.20076965048200784,134152.91243459514,729.4273237919224,134882.33975838707,1989,10,699.5128205128206,37,2,18,32.775455122777295,0.6599099099099099,41.008771929824555,1035.964912280701,27.999051683262188,0
2129,4,0,0,37,0.0,0.0,1.0,37,450,200,250,0.4444444444444444,7,2,5,331.20756629175895,0.39176676676676675,0.05457990697843118,0.20785889581383846,133921.09435281626,1471.1359471450558,135392.23029996132,1990,58,731.4054054054054,35,2,18,32.6620680979537,0.6616071428571428,41.232638888888886,1035.069444444444,29.57341269841268,0
2130,4,0,0,37,0.0,0.0,1.0,37,1050,700,350,0.6666666666666666,14,7,7,334.9600117098557,0.391234984984985,0.05909877688127363,0.2108998750716452,134040.92084887257,1579.669683427635,135620.5905323002,1991,59,732.4054054054054,35,2,18,32.445349465370136,0.662797619047619,41.116898148148145,1035.5324074074072,29.586640211640205,0
2131,4,0,0,37,0.0,0.0,1.0,37,1300,1100,200,0.8461538461538461,15,11,4,338.0251125507792,0.39142267267267267,0.05019389210405367,0.20891956417221974,133355.88121905664,1615.527351675973,134971.4085707326,1992,60,733.4054054054054,36,1,17,33.050770460822804,0.6539351851851853,41.779279279279265,1032.8828828828807,28.69119119119113,2
2132,4,0,0,37,0.0,0.0,1.0,37,950,700,250,0.7368421052631579,12,7,5,339.81529656607717,0.3910785785785786,0.04141238012205739,0.21068548387096744,133472.22222222196,1671.1805555555227,135143.4027777775,1993,61,734.4054054054054,36,1,17,32.888104838709666,0.6550925925925928,41.66666666666665,1033.3333333333312,28.703703703703646,0
2133,4,0,0,37,0.0,0.0,1.0,37,850,700,150,0.8235294117647058,10,7,3,340.6461632142245,0.3912037037037037,0.0422148202468573,0.21136645299641188,133501.31539901363,1695.3421749451923,135196.65757395883,1994,62,735.4054054054054,36,1,17,32.837528604118994,0.6553819444444446,41.6385135135135,1033.445945945944,28.706831831831778,0
2134,4,0,0,37,0.0,0.0,1.0,37,1050,800,250,0.7619047619047619,13,8,5,337.054377762707,0.3908596096096096,0.03213451988095306,0.20979635540606134,133617.71981018138,1607.2874817384518,135225.00729191984,1995,63,736.4054054054054,36,1,17,32.8139182369386,0.6565393518518521,41.52590090090088,1033.896396396393,28.719344344344247,0
2135,4,0,0,37,0.0,0.0,1.0,37,950,600,350,0.631578947368421,13,6,7,334.8380268972552,0.3905155155155155,0.03084094547509153,0.20890981243372192,133705.05640775888,1553.907454752021,135258.9638625109,1996,64,737.4054054054054,36,1,16,32.78391768292681,0.6574074074074076,41.44144144144143,1034.2342342342324,28.72872872872868,0
2136,4,0,0,37,0.0,0.0,1.0,37,1050,700,350,0.6666666666666666,14,7,7,334.81428394501063,0.38995245245245247,0.03390219434630071,0.20938998138889092,133792.4215389374,1559.1227629656541,135351.54430190305,1997,65,738.4054054054054,36,1,16,32.697244294474096,0.658275462962963,41.356981981981974,1034.5720720720706,28.738113113113073,0
2137,4,0,0,37,0.0,0.0,1.0,37,1050,700,350,0.6666666666666666,14,7,7,337.07911711928745,0.3897647647647648,0.03551854726789472,0.21164147845358522,133938.09349890417,1629.5468610502294,135567.6403599544,1998,66,739.4054054054054,36,1,16,32.49315527995359,0.6597222222222223,41.21621621621621,1035.135135135134,28.753753753753724,0
2138,4,0,0,37,0.0,0.0,1.0,37,650,400,250,0.6153846153846154,9,4,5,337.14329492676393,0.38942067067067065,0.031683412801533084,0.21201747288349282,133996.38447569177,1635.1965140816287,135631.58098977339,1999,67,740.4054054054054,36,1,16,32.43328982669857,0.660300925925926,41.1599099099099,1035.3603603603592,28.760010010009978,0
2139,4,0,0,37,0.0,0.0,1.0,37,1050,1000,50,0.9523809523809523,11,10,1,335.1788752362952,0.3888888888888889,0.028448883666275515,0.21178884973721915,134171.3334956576,1594.2793300056599,135765.61282566327,2000,68,741.4054054054054,36,1,17,32.30955615942028,0.6620370370370372,40.99099099099098,1036.0360360360344,28.778778778778733,0
2140,4,0,0,37,0.0,0.0,1.0,37,1150,800,350,0.6956521739130435,15,8,7,338.86382562160964,0.3888263263263263,0.031002971680937907,0.21480045805931777,134288.02958363772,1701.071087979873,135989.1006716176,2001,69,742.4054054054054,36,1,17,32.09768397798057,0.6631944444444444,40.87837837837838,1036.4864864864867,28.791291291291298,0
2141,4,0,0,37,0.0,0.0,1.0,37,1200,1000,200,0.8333333333333334,14,10,4,338.46907352916446,0.38876376376376376,0.03223864820823019,0.21472142121543483,134317.21153163293,1692.4444292265202,136009.65596085944,2002,70,743.4054054054054,36,1,17,32.07880680789427,0.6634837962962963,40.85022522522522,1036.5990990990988,28.794419419419413,0
2142,4,0,0,37,0.0,0.0,1.0,37,650,500,150,0.7692307692307693,8,5,3,340.8831232331587,0.3884196696696696,0.031233579620676855,0.21659840687423665,134375.58493882383,1761.2738160457625,136136.85875486958,2003,71,744.4054054054054,36,1,17,31.958021070924303,0.6640625,40.79391891891891,1036.8243243243232,28.800675675675645,0
2143,4,0,0,37,0.0,0.0,1.0,37,1100,800,300,0.7272727272727273,14,8,6,340.13834908035255,0.3885447947947948,0.03290323338107881,0.21629792253673236,134404.77639801957,1743.24375050726,136148.02014852685,2004,72,745.4054054054054,36,1,17,31.948215320011577,0.6643518518518519,40.765765765765764,1036.9369369369365,28.803803803803792,0
2144,4,0,0,37,0.0,0.0,1.0,37,1150,900,250,0.782608695652174,14,9,5,339.0087199595611,0.387794044044044,0.03523606107192756,0.21627065985231844,134521.57393880372,1720.7973175878633,136242.37125639158,2005,73,746.4054054054054,36,1,18,31.86106889564338,0.6655092592592593,40.653153153153156,1037.3873873873877,28.816316316316325,0
2145,4,0,0,37,0.0,0.0,1.0,37,750,600,150,0.8,9,6,3,336.9300495153306,0.38748123123123124,0.03364810593726286,0.21511687776748017,134550.78124999997,1666.8402777777783,136217.62152777775,2006,74,747.4054054054054,36,1,18,31.88587684069614,0.6657986111111112,40.625,1037.4999999999998,28.81944444444444,0
2146,4,0,1,36,0.0,0.02702702702702703,0.972972972972973,37,950,700,250,0.7368421052631579,12,7,5,337.69383729071376,0.3864802302302302,0.034826104038514494,0.21647161280568875,134696.86536198377,1697.2602670238005,136394.12562900758,2007,75,748.4054054054054,36,1,18,31.720546756346277,0.6672453703703702,40.48423423423424,1038.0630630630644,28.835085085085122,0
2147,4,0,0,36,0.0,0.0,1.0,36,1000,700,300,0.7,13,7,6,348.33464173453274,0.38558201058201064,0.03513026350020465,0.22331761270314698,134700.9243853954,2184.1996474194298,136885.1240328148,2008,76,762.6944444444445,35,1,18,31.44035474040212,0.669345238095238,40.48032407407408,1038.078703703705,29.659391534391574,0
2148,4,0,0,36,0.0,0.0,1.0,36,850,600,250,0.7058823529411765,11,6,5,347.1564656354831,0.38525132275132273,0.03343179875896429,0.2229306122559712,134761.00508241166,2156.630845979079,136917.63592839075,2009,77,763.6944444444445,35,1,18,31.411051350648375,0.6699404761904761,40.4224537037037,1038.310185185185,29.666005291005284,0
2149,4,0,0,36,0.0,0.0,1.0,36,950,700,250,0.7368421052631579,12,7,5,348.8398998399411,0.3846230158730159,0.03039674579293461,0.22438282589704592,134821.09917534716,2206.1957465277687,137027.29492187494,2010,78,764.6944444444445,35,1,17,31.307464058843195,0.6705357142857142,40.36458333333333,1038.541666666666,29.67261904761903,0
2150,4,0,0,36,0.0,0.0,1.0,36,600,400,200,0.6666666666666666,8,4,4,347.25333105781806,0.38447420634920637,0.02754253027263953,0.22354744568958815,134851.1512452846,2165.502293381339,137016.65353866594,2011,79,765.6944444444445,35,1,17,31.318717034395657,0.6708333333333334,40.335648148148145,1038.6574074074072,29.67592592592592,0
2151,4,0,0,36,0.0,0.0,1.0,36,650,500,150,0.7692307692307693,8,5,3,361.9464961884794,0.38506944444444446,0.08838093412561498,0.22722922630749623,133933.9303429703,2508.256839901569,136442.18718287186,2012,80,766.6944444444445,34,2,16,31.853795284646345,0.6639093137254903,41.22023809523808,1035.119047619046,30.444677871148407,5
2152,4,0,0,36,0.0,0.0,1.0,36,1100,900,200,0.8181818181818182,13,9,4,366.54776060245763,0.3855489417989418,0.08745210727969366,0.23108445777111428,134088.01020408137,2629.9319727890825,136717.94217687045,2013,81,767.6944444444445,34,2,16,31.580459770114928,0.6654411764705884,41.071428571428555,1035.7142857142835,30.462184873949514,0
2153,4,0,0,36,0.0,0.0,1.0,36,1300,900,400,0.6923076923076923,17,9,8,368.56520937775844,0.38483796296296297,0.08910136161198512,0.2337288622033604,134303.87081916083,2699.946853741474,137003.8176729023,2014,82,768.6944444444445,34,2,16,31.312210481987666,0.6675857843137256,40.86309523809523,1036.5476190476177,30.486694677871107,0
2154,4,0,0,36,0.0,0.0,1.0,36,850,500,350,0.5882352941176471,12,5,7,366.83991485401975,0.3845403439153439,0.08453260356463943,0.2330276308142711,134365.57716836728,2658.1313775510102,137023.70854591829,2015,83,769.6944444444445,34,2,17,31.295211849810528,0.6681985294117647,40.80357142857142,1036.7857142857138,30.49369747899158,0
2155,4,0,0,36,0.0,0.0,1.0,36,500,300,200,0.6,7,3,4,368.8284765733539,0.3837797619047619,0.08366811739761215,0.2349020596001293,134460.73555651982,2718.58965084874,137179.32520736856,2016,84,770.6944444444445,35,1,17,31.148518580515574,0.6669642857142859,40.71180555555554,1037.1527777777758,29.63293650793645,0
2156,4,0,0,36,0.0,0.0,1.0,36,1100,800,300,0.7272727272727273,14,8,6,372.9489311239737,0.38334986772486773,0.08418870169957993,0.23791752808997677,134520.7626698601,2833.8749303412023,137354.6376002013,2017,85,771.6944444444445,35,1,17,30.981651418795796,0.6675595238095239,40.653935185185176,1037.384259259258,29.639550264550227,0
2157,4,0,1,35,0.0,0.027777777777777776,0.9722222222222222,36,750,600,150,0.8,9,6,3,372.1250511526754,0.3831845238095238,0.08261307429503861,0.23778899896236938,134581.66099773243,2816.244845578406,137397.90584331084,2018,86,772.6944444444445,34,2,17,30.942137065932396,0.6703431372549019,40.595238095238095,1037.6190476190475,30.51820728291316,0
2158,4,0,0,35,0.0,0.0,1.0,35,700,500,200,0.7142857142857143,9,5,4,375.6391025951191,0.38361344537815123,0.0771084337349397,0.23983111934919163,134550.78125000015,3108.5069444444594,137659.2881944446,2019,87,774.5428571428571,34,1,17,30.881860776439094,0.6700367647058822,40.62500000000001,1037.5000000000011,30.514705882352974,0
2159,4,0,1,34,0.0,0.02857142857142857,0.9714285714285714,35,600,300,300,0.5,9,3,6,375.35006542698346,0.3832633053221288,0.07864026748836306,0.23984979254117209,134581.66099773243,3103.047052154194,137684.70804988663,2020,88,775.5428571428571,34,1,18,30.85847865993576,0.6703431372549019,40.595238095238095,1037.6190476190475,30.51820728291316,0
2160,4,0,0,34,0.0,0.0,1.0,34,750,500,250,0.6666666666666666,10,5,5,384.67121498040314,0.38265002970885326,0.0802031656035902,0.24559777571825767,134550.78125000017,3551.5625000000146,138102.34375000017,2021,89,790.7647058823529,33,1,18,30.647590361445772,0.6723484848484848,40.62500000000001,1037.5000000000014,31.43939393939398,0
2161,4,0,1,33,0.0,0.029411764705882353,0.9705882352941176,34,750,500,250,0.6666666666666666,10,5,5,381.80203888798695,0.3821672608437314,0.07663863562187978,0.24483308640576396,134709.7589418735,3486.4921244233233,138196.25106629683,2022,90,791.7647058823529,33,1,20,30.562974658639284,0.6739267676767676,40.47181372549021,1038.1127450980407,31.4579619726679,0
2162,4,0,0,33,0.0,0.0,1.0,33,950,700,250,0.7368421052631579,12,7,5,391.71506207043507,0.3783933080808081,0.08860871488608679,0.25077085749368994,134649.0472910928,3948.811983471077,138597.85927456387,2023,91,812.1212121212121,32,1,20,30.366484184914828,0.67578125,40.53030303030303,1037.8787878787882,32.43371212121213,0
2163,4,1,2,32,0.029411764705882353,0.058823529411764705,0.9411764705882353,34,550,300,250,0.5454545454545454,8,3,5,380.16962231967864,0.38032902554961373,0.0799637774184816,0.24507208276835862,134900.65607278454,3457.0262939734744,138357.682366758,2024,0,789.2058823529412,33,1,17,30.41452852817427,0.6758207070707071,40.28799019607843,1038.8480392156866,31.480243612596563,0
2164,4,0,0,32,0.0,0.0,1.0,32,750,200,550,0.26666666666666666,13,2,11,400.47741165465084,0.37527301747311825,0.09048694779116473,0.2556894243641232,134550.78125,4376.9097222222235,138927.69097222222,2025,93,828.15625,31,1,20,30.2376171352075,0.6774193548387096,40.625,1037.5,33.46774193548387,0
2165,4,0,0,32,0.0,0.0,1.0,32,800,700,100,0.875,9,7,2,395.7629928533106,0.3748109879032258,0.09343640240842954,0.25361917837834363,134685.90630425353,4260.739474826399,138946.64577907993,2026,94,829.15625,31,1,20,30.22453587556447,0.678763440860215,40.49479166666667,1038.020833333334,33.48454301075271,0
2166,4,0,0,32,0.0,0.0,1.0,32,1050,800,250,0.7619047619047619,13,8,5,393.6690657981807,0.3741809475806452,0.09729276398294462,0.2527469509399914,134753.4942626953,4209.656439887154,138963.15070258247,2027,95,830.15625,31,1,20,30.211207256918325,0.6794354838709677,40.4296875,1038.28125,33.492943548387096,0
2167,4,0,0,32,0.0,0.0,1.0,32,500,400,100,0.8,6,4,2,394.3783571309245,0.3738659274193548,0.10110109717868365,0.2534381465043613,134787.29459974504,4231.438361273882,139018.73296101892,2028,96,831.15625,31,1,18,30.158960292580993,0.679771505376344,40.39713541666667,1038.4114583333337,33.49714381720431,0
2168,4,0,0,32,0.0,0.0,1.0,32,700,300,400,0.42857142857142855,11,3,8,393.51178388650857,0.37378192204301075,0.09893678701266118,0.2533529862843164,134854.90798950198,4213.399081759983,139068.30707126195,2029,97,832.15625,31,1,18,30.113790689900128,0.6804435483870968,40.33203125,1038.6718750000002,33.50554435483872,0
2169,4,0,0,32,0.0,0.0,1.0,32,1100,900,200,0.8181818181818182,13,9,4,391.0101067204352,0.3738869287634408,0.10383771929824581,0.2524482727855237,134956.35986328125,4153.860134548612,139110.21999782987,2030,98,833.15625,31,1,18,30.077276524644947,0.6814516129032258,40.234375,1039.0625,33.51814516129032,0
2170,4,0,0,32,0.0,0.0,1.0,32,450,300,150,0.6666666666666666,6,3,3,391.0101067204352,0.3738869287634408,0.10383771929824581,0.2524482727855237,134956.35986328125,4153.860134548612,139110.21999782987,2031,99,834.15625,31,1,18,30.077276524644947,0.6814516129032258,40.234375,1039.0625,33.51814516129032,0
2171,4,0,0,32,0.0,0.0,1.0,32,500,300,200,0.6,7,3,4,390.3470560774039,0.3743699596774193,0.10372432043091595,0.2527283494457352,135057.8498840332,4143.886820475262,139201.73670450845,2032,100,835.15625,31,1,18,29.99303206814481,0.6824596774193548,40.13671875,1039.453125,33.530745967741936,0
2172,4,0,0,32,0.0,0.0,1.0,32,700,400,300,0.5714285714285714,10,4,6,388.6760123572337,0.373991935483871,0.10682138384470874,0.25211843693521624,135125.53109063048,4104.010518391933,139229.54160902242,2033,101,836.15625,31,1,18,29.968821749112912,0.6831317204301075,40.071614583333336,1039.713541666667,33.53914650537635,0
2173,4,0,0,32,0.0,0.0,1.0,32,550,400,150,0.7272727272727273,7,4,3,398.013571027844,0.373991935483871,0.10639824627807215,0.24454694294315438,133136.0626220703,4197.991943359375,137334.0545654297,2034,102,837.15625,31,1,18,31.723126419379255,0.6633064516129032,41.9921875,1032.03125,33.29133064516129,5
2174,4,1,1,32,0.030303030303030304,0.030303030303030304,0.9696969696969697,33,800,500,300,0.625,11,5,6,390.6390134185935,0.37918244949494945,0.0963638585537645,0.2419832737929108,133439.60636988573,3825.3432366595307,137264.94960654527,2035,0,812.7575757575758,32,1,18,31.607957554279192,0.6637369791666666,41.698232323232325,1033.207070707071,32.287720959595966,0
2175,4,0,0,32,0.0,0.0,1.0,32,950,800,150,0.8421052631578947,11,8,3,400.75429294090753,0.37266885080645157,0.10284406127852774,0.2473449258610379,133304.08944023983,4284.4372219509605,137588.5266621908,2036,104,839.15625,31,1,19,31.483130542596577,0.6649865591397849,41.829427083333336,1032.6822916666667,33.31233198924731,0
2176,4,0,0,32,0.0,0.0,1.0,32,800,500,300,0.625,11,5,6,400.7988624127037,0.37245883736559143,0.1036926446489348,0.24782052809976465,133371.3298373753,4291.015455457909,137662.3452928332,2037,105,840.15625,31,1,19,31.41426635572924,0.6656586021505376,41.76432291666667,1032.942708333334,33.32073252688174,0
2177,4,0,0,32,0.0,0.0,1.0,32,1000,800,200,0.8,12,8,4,406.4776274713837,0.3717237903225807,0.10962701612903203,0.252016129032258,133472.2222222222,4450.694444444441,137922.91666666663,2038,106,841.15625,31,1,19,31.1659946236559,0.6666666666666667,41.666666666666664,1033.3333333333333,33.33333333333333,0
2178,4,0,0,32,0.0,0.0,1.0,32,200,200,0,1.0,2,2,0,406.4776274713837,0.3717237903225807,0.10962701612903203,0.252016129032258,133472.2222222222,4450.694444444441,137922.91666666663,2039,107,842.15625,31,1,19,31.1659946236559,0.6666666666666667,41.666666666666664,1033.3333333333333,33.33333333333333,0
2179,4,0,0,32,0.0,0.0,1.0,32,850,400,450,0.47058823529411764,13,4,9,406.52953325093273,0.3709677419354838,0.11303769366418948,0.25273594083626894,133573.15275404192,4460.286288791244,138033.43904283317,2040,108,843.15625,31,1,19,31.063027459377754,0.6676747311827957,41.56901041666667,1033.7239583333337,33.34593413978496,0
2180,4,0,0,32,0.0,0.0,1.0,32,1050,600,450,0.5714285714285714,15,6,9,405.33472073295303,0.37136676747311825,0.11534949622166235,0.25222238892003507,133606.80474175353,4431.0953776041715,138037.90011935768,2041,109,844.15625,31,1,19,31.0600335852225,0.668010752688172,41.536458333333336,1033.854166666667,33.35013440860216,0
2181,4,0,0,32,0.0,0.0,1.0,32,1050,900,150,0.8571428571428571,12,9,3,402.0794098467723,0.37021169354838707,0.12005916414904316,0.25110997105524835,133741.455078125,4354.937065972223,138096.39214409722,2042,110,845.15625,31,1,16,31.008727760993622,0.6693548387096775,41.40625,1034.375,33.36693548387097,0
2182,4,0,0,32,0.0,0.0,1.0,32,850,400,450,0.47058823529411764,13,4,9,396.69488985391433,0.3699386760752688,0.1174224550144709,0.24842665797234506,133842.48733520508,4218.926154242621,138061.4134894477,2043,111,846.15625,31,1,16,31.04643785915021,0.6703629032258065,41.30859375,1034.765625,33.379536290322584,0
2183,4,0,0,32,0.0,0.0,1.0,32,1150,800,350,0.6956521739130435,15,8,7,399.6493809580315,0.3699596774193548,0.11856132075471693,0.25096465865847956,133943.55773925784,4306.0919867621515,138249.64972602,2044,112,847.15625,31,1,16,30.868448637316547,0.6713709677419355,41.2109375,1035.1562500000002,33.3921370967742,0
2184,4,0,0,32,0.0,0.0,1.0,32,650,400,250,0.6153846153846154,9,4,5,399.26745538500893,0.36989667338709675,0.11768750785866966,0.2514152076545508,134044.66629028323,4303.9345635308155,138348.60085381404,2045,113,848.15625,31,1,16,30.7767771071713,0.6723790322580645,41.11328125,1035.5468750000002,33.404737903225815,0
2185,4,0,0,32,0.0,0.0,1.0,32,700,300,400,0.42857142857142855,11,3,8,398.14505168067404,0.36924563172043007,0.1155574409250879,0.25140016120408276,134145.81298828125,4281.898328993056,138427.7113172743,2046,114,849.15625,31,1,16,30.704290263113784,0.6733870967741935,41.015625,1035.9375,33.417338709677416,0
2186,4,0,0,32,0.0,0.0,1.0,32,850,700,150,0.8235294117647058,10,7,3,395.92964875464065,0.36924563172043007,0.1490963855421683,0.23507239145768255,131846.31191970228,4040.372793592519,135886.6847132948,2047,115,850.15625,32,0,18,33.07925579870504,0.6477864583333333,43.24494949494951,1027.0202020202037,32.094381313131365,7
2187,4,0,0,32,0.0,0.0,1.0,32,700,500,200,0.7142857142857143,9,5,4,397.8208660498268,0.36773353494623656,0.1500368640943719,0.23700338271694682,131976.01807213566,4100.562761452934,136076.58083358858,2048,116,851.15625,32,0,18,32.89941222249529,0.6490885416666665,43.11868686868688,1027.5252525252538,32.11016414141418,0
2188,4,0,0,32,0.0,0.0,1.0,32,450,200,250,0.4444444444444444,7,2,5,397.8966345238019,0.3675025201612903,0.14884151209925056,0.23765785045181764,132073.33953486907,4110.307462248772,136183.64699711784,2049,117,852.15625,32,0,18,32.79900094173525,0.6500651041666665,43.02398989898991,1027.9040404040418,32.122001262626306,0
2189,4,0,0,32,0.0,0.0,1.0,32,1050,900,150,0.8571428571428571,12,9,3,399.5380739489172,0.36674647177419356,0.15311080068770733,0.23904765144496934,132138.240437838,4158.851615906545,136297.09205374453,2050,118,853.15625,32,0,19,32.69116623684964,0.6507161458333333,42.96085858585859,1028.1565656565658,32.12989267676768,0
2190,4,0,0,32,0.0,0.0,1.0,32,300,100,200,0.3333333333333333,5,1,4,399.5380739489172,0.36674647177419356,0.15311080068770733,0.23904765144496934,132138.240437838,4158.851615906545,136297.09205374453,2051,119,854.15625,32,0,19,32.69116623684964,0.6507161458333333,42.96085858585859,1028.1565656565658,32.12989267676768,0
2191,4,1,0,33,0.030303030303030304,0.0,1.0,33,1000,800,200,0.8,12,8,4,385.81068125522404,0.3723563762626263,0.1446813728141827,0.2334029628932791,132555.70461180795,3628.281340109572,136183.9859519175,2052,0,829.2424242424242,33,0,20,32.622649648934896,0.6524621212121213,42.55514705882353,1029.7794117647059,31.2054367201426,0
2192,4,1,2,32,0.029411764705882353,0.058823529411764705,0.9411764705882353,34,900,700,200,0.7777777777777778,11,7,4,376.115227120078,0.37563131313131315,0.13078689549277778,0.22900180284146518,132796.49234693876,3189.356575963713,135985.84892290249,2053,0,805.8235294117648,34,0,18,32.629745129745125,0.6525735294117647,42.32142857142857,1030.7142857142856,30.31512605042016,0
2193,4,1,1,32,0.030303030303030304,0.030303030303030304,0.9696969696969697,33,550,300,250,0.5454545454545454,8,3,5,384.9187405594806,0.37192234848484845,0.13408892638014702,0.23345071667698375,132650.37035034606,3611.922698000779,136262.29304834682,2054,0,831.1818181818181,33,0,18,32.5501625822825,0.6534090909090908,42.46323529411765,1030.1470588235297,31.21657754010696,0
2194,4,0,0,32,0.0,0.0,1.0,32,700,500,200,0.7142857142857143,9,5,4,391.224763780427,0.36599042338709675,0.09767034847542,0.21398849400787828,128656.40503838896,3666.714333996531,132323.1193723855,2055,123,858.15625,32,0,19,36.44731383530388,0.6155598958333334,46.369949494949495,1014.5202020202021,31.703756313131315,8
2195,4,1,0,33,0.030303030303030304,0.0,1.0,33,1000,700,300,0.7,13,7,6,383.20277813737073,0.37133049242424243,0.11032305449283686,0.21200137685745238,129107.96215698267,3294.9059556420398,132402.8681126247,2056,0,833.1212121212121,33,0,21,36.189029904738945,0.6177398989898991,45.925245098039206,1016.2990196078414,30.796939988116407,0
2196,4,0,0,33,0.0,0.0,1.0,33,600,400,200,0.6666666666666666,8,4,4,379.95018289383756,0.37156723484848486,0.11225671199155607,0.21086599782409154,129232.53864198859,3220.385338571692,132452.92398056027,2057,1,834.1212121212121,33,0,21,36.14446486681933,0.6190025252525253,45.80269607843137,1016.789215686274,30.811794414735576,0
2197,4,1,2,32,0.029411764705882353,0.058823529411764705,0.9411764705882353,34,850,500,350,0.5882352941176471,12,5,7,371.26024841012554,0.3757984254307784,0.10321819145348554,0.20699030288071374,129413.2812499999,2809.201388888874,132222.48263888876,2058,0,810.5588235294117,34,0,21,36.181067431067426,0.6185661764705883,45.62499999999999,1017.4999999999992,29.926470588235272,0
2198,4,0,0,32,0.0,0.0,1.0,32,800,500,300,0.625,11,5,6,383.56853805786767,0.37052671370967744,0.12127079970197485,0.2128792168835291,129233.48263251194,3513.979600295884,132747.46223280783,2059,3,855.0625,32,0,21,36.051523241856046,0.6214192708333334,45.801767676767675,1016.7929292929289,31.774779040404027,0
2199,4,1,1,32,0.030303030303030304,0.030303030303030304,0.9696969696969697,33,700,400,300,0.5714285714285714,10,4,6,376.5846800525225,0.375591856060606,0.11387168093163735,0.21049208294187433,129513.0553753364,3154.526504229136,132667.58187956552,2060,0,830.1212121212121,33,0,18,35.94389597881048,0.6218434343434345,45.52696078431372,1017.892156862745,30.845216874628637,0
2200,4,1,1,32,0.030303030303030304,0.030303030303030304,0.9696969696969697,33,850,600,250,0.7058823529411765,11,6,5,380.5213442404075,0.37681502525252525,0.11059329759690772,0.21336925577852803,129637.8270977509,3265.992046328339,132903.81914407923,2061,0,831.0909090909091,33,0,18,35.71650621740875,0.6231060606060606,45.404411764705884,1018.3823529411767,30.86007130124778,0
2201,4,1,1,32,0.030303030303030304,0.030303030303030304,0.9696969696969697,33,1150,900,250,0.782608695652174,14,9,5,381.77324450801063,0.3764993686868687,0.11253640701493439,0.21458289260277835,129731.44531250001,3305.598958333334,133037.04427083334,2062,0,832.060606060606,33,0,18,35.5892126789366,0.6240530303030303,45.3125,1018.7500000000001,30.871212121212125,0
2202,4,0,0,32,0.0,0.0,1.0,32,1000,900,100,0.9,11,9,2,390.6014351819134,0.37082073252688175,0.12847480476013406,0.21927500192153762,129683.21352731863,3730.889864554638,133414.10339187327,2063,7,859.0625,32,0,18,35.41356762117268,0.6259765625,45.359848484848484,1018.560606060606,31.830018939393938,0
2203,4,3,2,33,0.08571428571428572,0.05714285714285714,0.9428571428571428,35,1100,900,200,0.8181818181818182,13,9,4,362.9693926896724,0.3859593837535014,0.10119880119880076,0.20761849261849244,130414.5408163264,2468.588657914935,132883.12947424132,2064,0,786.3428571428572,34,1,20,35.37417443667443,0.6286764705882353,44.64285714285713,1021.4285714285703,30.042016806722657,0
2204,4,2,1,34,0.05714285714285714,0.02857142857142857,0.9714285714285714,35,750,500,250,0.6666666666666666,10,5,5,362.69009553307535,0.38623949579831934,0.11618293170017324,0.208110413105342,130536.16780045332,2468.835034013581,133005.0028344669,2065,0,787.2857142857143,34,1,15,35.25794113078595,0.6299019607843138,44.52380952380951,1021.9047619047603,30.05602240896354,0
2205,4,1,2,33,0.02857142857142857,0.05714285714285714,0.9428571428571428,35,750,500,250,0.6666666666666666,10,5,5,365.52600448081705,0.3845238095238095,0.1173128420072187,0.21056357159528746,130688.28124999991,2553.9930555555425,133242.27430555545,2066,0,788.2571428571429,34,1,15,35.03124151045911,0.6314338235294118,44.37499999999999,1022.4999999999993,30.073529411764685,0
2206,4,0,0,33,0.0,0.0,1.0,33,1050,600,450,0.5714285714285714,15,6,9,382.7361977747836,0.37401357323232326,0.12552667947551166,0.21915913490415945,130455.99819214873,3386.046544995407,133842.04473714414,2067,2,836.969696969697,32,1,22,34.827277221604255,0.6337890625,44.60227272727273,1021.5909090909089,31.924715909090903,0
2207,4,1,0,34,0.029411764705882353,0.0,1.0,34,800,500,300,0.625,11,5,6,372.4955358743591,0.3783979500891266,0.1344064811553365,0.21569609740297488,130888.84833958093,2951.102340445984,133839.9506800269,2068,0,813.3235294117648,33,1,17,34.6497005988024,0.6357323232323232,44.17892156862745,1023.2843137254903,31.0086155674391,0
2208,4,0,0,34,0.0,0.0,1.0,34,850,700,150,0.8235294117647058,10,7,3,370.3089457534795,0.3783793820558527,0.132027161241697,0.21460444177566323,130920.20083922049,2896.1843101211075,133816.3851493416,2069,1,814.3235294117648,33,1,17,34.67386640322517,0.6360479797979798,44.14828431372549,1023.406862745098,31.01232917409388,0
2209,4,1,1,34,0.02857142857142857,0.02857142857142857,0.9714285714285714,35,700,400,300,0.5714285714285714,10,4,6,363.83827463331465,0.38396358543417364,0.1263039075727901,0.2124282355152177,131206.12953514748,2547.5623582766607,133753.69189342414,2070,0,792.0285714285715,34,1,18,34.5500232396003,0.636642156862745,43.86904761904763,1024.5238095238103,30.133053221288538,0
2210,4,1,0,35,0.02857142857142857,0.0,1.0,35,1000,700,300,0.7,13,7,6,361.95462936201386,0.38098739495798317,0.1376445410355529,0.2121709539439282,131358.6327239231,2509.173044217716,133867.80576814082,2071,0,793.0,34,1,19,34.444073471915765,0.6381740196078429,43.72023809523811,1025.1190476190493,30.150560224089684,0
2211,4,1,2,34,0.027777777777777776,0.05555555555555555,0.9444444444444444,36,700,600,100,0.8571428571428571,8,6,2,348.22494493145643,0.3854993386243386,0.10225995052844628,0.21011619133109713,132457.56842635447,2025.005894204373,134482.57432055884,2072,0,771.9444444444445,35,1,19,33.68891012667714,0.6470238095238096,42.650462962962955,1029.3981481481471,29.411375661375633,1
2212,4,0,0,34,0.0,0.0,1.0,34,1000,800,200,0.8,12,8,4,362.6342271090534,0.3751485442661913,0.12414896514161189,0.21758053626543195,132244.89795918367,2791.305272108837,135036.20323129251,2073,5,818.3235294117648,34,0,19,33.53226273148146,0.6470588235294117,42.857142857142854,1028.5714285714284,30.25210084033613,0
2213,4,0,0,34,0.0,0.0,1.0,34,1100,900,200,0.8181818181818182,13,9,4,366.7227283937479,0.3739973262032086,0.12834904954348159,0.22110772034116757,132428.63520408154,2912.918083900216,135341.55328798175,2074,6,819.3235294117648,34,0,19,33.242009792582316,0.6488970588235294,42.67857142857142,1029.2857142857135,30.27310924369746,0
2214,4,0,0,34,0.0,0.0,1.0,34,800,600,200,0.75,10,6,4,366.4771779136906,0.3737373737373737,0.1254625346901017,0.22131945772329562,132489.90929705207,2910.9056122448856,135400.81490929695,2075,7,820.3235294117648,34,0,20,33.186623111316685,0.6495098039215687,42.61904761904761,1029.5238095238087,30.280112044817905,0
2215,4,0,0,34,0.0,0.0,1.0,34,1400,1100,300,0.7857142857142857,17,11,6,362.82356046343966,0.37340314913844325,0.12035174513428304,0.220547804731147,132735.14739229012,2831.8877551020237,135567.03514739213,2076,8,821.3235294117648,34,0,16,33.03392637091804,0.6519607843137256,42.38095238095237,1030.4761904761895,30.30812324929969,0
2216,4,0,0,34,0.0,0.0,1.0,34,850,500,350,0.5882352941176471,12,5,7,365.00277664518853,0.3731803327391563,0.12389085918497722,0.22223586780548807,132796.4923469386,2894.2176870748112,135690.71003401343,2077,9,822.3235294117648,34,0,16,32.91608916608915,0.6525735294117647,42.32142857142856,1030.7142857142844,30.31512605042013,0
2217,4,0,0,34,0.0,0.0,1.0,34,600,400,200,0.6666666666666666,8,4,4,364.5280523124023,0.3731431966726084,0.12148485260154884,0.22231076993136648,132857.85147392287,2886.0827664399044,135743.93424036278,2078,10,823.3235294117648,34,0,17,32.86662817551962,0.6531862745098039,42.26190476190476,1030.9523809523807,30.32212885154061,0
2218,4,0,0,34,0.0,0.0,1.0,34,1500,1200,300,0.8,18,12,6,365.15981532567275,0.37247474747474746,0.12377648959422238,0.22379596602632798,133042.0138888888,2916.319444444435,135958.33333333323,2079,11,824.3235294117648,34,0,18,32.66525309639204,0.6550245098039216,42.08333333333333,1031.6666666666658,30.343137254901936,0
2219,4,0,0,34,0.0,0.0,1.0,34,750,400,350,0.5333333333333333,11,4,7,354.210034585061,0.373681669637552,0.09585615622767318,0.2133899476646589,132398.0034722223,2587.8472222222267,134985.85069444453,2080,12,825.3235294117648,33,1,22,33.59480431848852,0.6508838383838383,42.708333333333336,1029.1666666666672,31.186868686868703,8
2220,4,0,0,34,0.0,0.0,1.0,34,750,700,50,0.9333333333333333,8,7,1,356.1092263164491,0.3738116458704694,0.09616852335506265,0.2150735880865916,132492.61289227704,2636.368373942716,135128.98126621975,2081,13,826.3235294117648,33,1,22,33.45075487045193,0.6518308080808082,42.61642156862745,1029.5343137254904,31.198009506833042,0
2221,4,0,0,34,0.0,0.0,1.0,34,1050,800,250,0.7619047619047619,13,8,5,355.68707724097743,0.37422014260249553,0.100184807946742,0.21517915839135565,132555.70461180783,2629.6702289984473,135185.37484080627,2082,14,827.3235294117648,33,1,22,33.39816632948551,0.6524621212121213,42.55514705882352,1029.779411764705,31.205436720142576,0
2222,4,0,0,34,0.0,0.0,1.0,34,650,500,150,0.7692307692307693,8,5,3,354.6428900722913,0.3737373737373737,0.10147828765013789,0.21472758272100412,132587.25610342182,2604.2255382545163,135191.48164167634,2083,15,828.3235294117648,33,1,22,33.39332460732983,0.6527777777777778,42.52450980392157,1029.901960784314,31.209150326797396,0
2223,4,0,0,34,0.0,0.0,1.0,34,800,500,300,0.625,11,5,6,353.50784697763845,0.37340314913844325,0.10668150200837001,0.21440021368643772,132650.37035034588,2578.5893646674176,135228.9597150133,2084,16,829.3235294117648,33,1,19,33.35910857324133,0.653409090909091,42.46323529411764,1030.1470588235281,31.216577540106915,0
2224,4,0,0,34,0.0,0.0,1.0,34,1200,800,400,0.6666666666666666,16,8,8,358.50842210990686,0.3719362745098039,0.11480414303398234,0.21835006070719934,132808.22167255374,2722.5731990099866,135530.79487156373,2085,17,830.3235294117648,33,1,20,33.071647247651875,0.6549873737373737,42.31004901960784,1030.759803921568,31.235145573380848,0
2225,4,0,1,33,0.0,0.029411764705882353,0.9705882352941176,34,700,500,200,0.7142857142857143,9,5,4,361.79981634527087,0.37219622697563876,0.12210338680926935,0.22109988776655443,132934.5703125,2819.1406250000005,135753.7109375,2086,18,831.3235294117648,33,1,20,32.859848484848484,0.65625,42.1875,1031.25,31.25,0
2226,4,0,0,33,0.0,0.0,1.0,33,850,600,250,0.7058823529411765,11,6,5,367.42087285018994,0.3680950126262626,0.13521126760563384,0.2240471565961017,132853.20255905014,3162.607929037862,136015.810488088,2087,19,856.8787878787879,32,1,20,32.796744233517046,0.6578776041666666,42.266414141414145,1030.9343434343439,32.216698232323246,0
2227,4,0,0,33,0.0,0.0,1.0,33,850,600,250,0.7058823529411765,11,6,5,386.30285321967756,0.3680950126262626,0.1154751579729898,0.21757504035841033,129811.85154894924,3429.3377270176725,133241.18927596693,2088,20,857.8787878787879,32,1,20,35.39188658984845,0.6272786458333333,45.23358585858587,1019.0656565656577,31.845801767676804,8
2228,4,1,0,34,0.029411764705882353,0.0,1.0,34,1050,700,350,0.6666666666666666,14,7,7,377.6759683465221,0.37093360071301246,0.12040816326530601,0.21518747033697205,130262.58680555565,3039.4097222222317,133301.99652777787,2089,0,833.6176470588235,34,0,22,35.1530612244898,0.6271446078431373,44.79166666666667,1020.8333333333342,30.024509803921593,0
2229,4,0,0,34,0.0,0.0,1.0,34,950,700,250,0.7368421052631579,12,7,5,378.3184088673996,0.37136066547831253,0.12527442274161515,0.21607452372118194,130356.43029423797,3063.247458910055,133419.67775314802,2090,1,834.6176470588235,33,1,22,35.041276651066035,0.6303661616161615,44.699754901960794,1021.2009803921584,30.94548425430783,0
2230,4,1,1,34,0.02857142857142857,0.02857142857142857,0.9714285714285714,35,1200,800,400,0.6666666666666666,16,8,8,355.024083651502,0.37485994397759104,0.09828021647624796,0.19986630030888525,129793.87622849371,2231.8534337754554,132025.72966226918,2091,0,811.7428571428571,33,2,20,36.20703046702746,0.6246843434343434,45.25122549019607,1018.9950980392146,30.878639334521655,3
2231,4,2,1,35,0.05555555555555555,0.027777777777777776,0.9722222222222222,36,700,600,100,0.8571428571428571,8,6,2,345.32974524444484,0.3808201058201058,0.09467914057130988,0.1958392181998444,130080.35891439914,1784.1234410430848,131864.48235544222,2092,0,790.1388888888889,34,2,21,36.1633018244058,0.6253063725490196,44.970238095238095,1020.119047619048,30.003501400560236,0
2232,4,1,1,35,0.027777777777777776,0.027777777777777776,0.9722222222222222,36,1100,900,200,0.8181818181818182,13,9,4,346.8310641746475,0.3819444444444444,0.1003441035810102,0.19730475867081954,130201.83000283432,1831.6078514739056,132033.43785430823,2093,0,791.1111111111111,34,2,21,36.00183716318674,0.6265318627450981,44.85119047619047,1020.5952380952369,30.017507002801086,0
2233,4,0,0,35,0.0,0.0,1.0,35,750,500,250,0.6666666666666666,10,5,5,356.76209156273285,0.3757002801120448,0.11195167158646258,0.2022947990577783,130075.00120146078,2281.165897731614,132356.1670991924,2094,2,814.7142857142857,33,2,21,35.877182444337635,0.6275252525252526,44.97549019607842,1020.0980392156847,30.912061794414686,0
2234,4,2,1,36,0.05405405405405406,0.02702702702702703,0.972972972972973,37,1150,1000,150,0.8695652173913043,13,10,3,340.28570688442414,0.3857294794794795,0.10898918478380581,0.19602373819116814,130688.28124999988,1494.4059976931806,132182.68724769307,2095,0,771.6216216216217,34,3,18,35.67644661776691,0.6314338235294118,44.37499999999999,1022.4999999999991,30.073529411764678,0
2235,4,0,1,35,0.0,0.027777777777777776,0.9722222222222222,36,1050,700,350,0.6666666666666666,14,7,7,377.2121919059684,0.38125000000000003,0.13189508626805302,0.21000928269694452,129357.17520004316,2650.8609969723025,132008.03619701546,2096,1,794.0555555555555,33,3,21,36.08689214150905,0.6202651515151516,45.68014705882352,1017.2794117647052,30.826648841354704,8
2236,4,1,1,35,0.027777777777777776,0.027777777777777776,0.9722222222222222,36,650,400,250,0.6153846153846154,9,4,5,375.9929334692802,0.38138227513227513,0.14404642451000038,0.20999470830278216,129481.87183114664,2536.853764177233,132018.72559532386,2097,0,794.9166666666666,33,3,20,35.990743527995186,0.6215277777777778,45.557598039215684,1017.769607843137,30.84150326797385,0
2237,4,2,3,34,0.05405405405405406,0.08108108108108109,0.9189189189189189,37,950,700,250,0.7368421052631579,12,7,5,330.2010789849938,0.3845407907907908,0.09314655396977689,0.18799504942341239,130233.05047850215,1202.9653609715251,131436.01583947366,2098,0,774.3783783783783,35,2,20,36.39455059152587,0.6247023809523811,44.82060185185185,1020.7175925925919,29.16335978835977,5
2238,4,0,0,34,0.0,0.0,1.0,34,950,700,250,0.7368421052631579,12,7,5,356.21122480987054,0.37232620320855614,0.10639034451595086,0.20062671287093278,129811.85154894914,2448.087727017658,132259.9392759668,2099,1,823.7352941176471,32,2,20,36.158520216412676,0.6272786458333333,45.23358585858586,1019.0656565656569,31.84580176767678,0
2239,4,0,0,34,0.0,0.0,1.0,34,800,500,300,0.625,11,5,6,357.08187008590164,0.3722147950089127,0.10859112037185459,0.2016139174177321,129908.37191358021,2477.5848765432042,132385.95679012343,2100,2,824.7352941176471,32,2,20,36.03826067211626,0.6282552083333334,45.138888888888886,1019.4444444444441,31.85763888888888,0
2240,4,2,0,36,0.05555555555555555,0.0,1.0,36,800,400,400,0.5,12,4,8,338.94336154081344,0.3817956349206349,0.10496641074856017,0.19405438611292736,130450.30757401003,1643.5354057200254,132093.84297973005,2101,0,779.8611111111111,33,3,23,35.95149552143313,0.6313131313131313,44.6078431372549,1021.5686274509808,30.956625074272146,0
2241,4,0,0,36,0.0,0.0,1.0,36,900,700,200,0.7777777777777778,11,7,4,338.502882616965,0.38172949735449735,0.1010700674289069,0.1941153394264274,130512.91120001924,1635.7993319876985,132148.71053200692,2102,1,780.8611111111111,33,3,18,35.8993963380507,0.6319444444444444,44.54656862745098,1021.8137254901962,30.964052287581705,0
2242,4,0,1,35,0.0,0.027777777777777776,0.9722222222222222,36,1150,700,450,0.6086956521739131,16,7,9,339.828022155927,0.38207671957671957,0.09758517808146205,0.19550657660860302,130638.16350682438,1678.9017445213487,132317.06525134572,2103,2,781.8611111111111,33,3,19,35.73883161512029,0.6332070707070707,44.42401960784314,1022.3039215686281,30.97890671420085,0
2243,4,0,0,35,0.0,0.0,1.0,35,1100,800,300,0.7272727272727273,14,8,6,349.3816082088099,0.37640056022408963,0.10725405061950721,0.20055991041433377,130552.75769054178,2122.5464876033066,132675.30417814507,2104,3,805.1428571428571,32,3,20,35.5811403508772,0.634765625,44.50757575757576,1021.9696969696969,31.936553030303028,0
2244,4,0,0,35,0.0,0.0,1.0,35,650,500,150,0.7692307692307693,8,5,3,348.22477520457545,0.37598039215686274,0.10805258978205279,0.2000624240795626,130585.01882779812,2094.587765279045,132679.60659307716,2105,4,806.1428571428571,32,3,20,35.57803170681488,0.6350911458333334,44.4760101010101,1022.0959595959591,31.940498737373723,0
2245,4,1,1,35,0.027777777777777776,0.027777777777777776,0.9722222222222222,36,1400,1000,400,0.7142857142857143,18,10,8,338.2498735698667,0.3785383597883598,0.09883615731586004,0.19608456932435228,130931.84700963716,1657.5361394557772,132589.38314909293,2106,0,784.7222222222222,34,2,22,35.482338800356715,0.6338848039215685,44.13690476190476,1023.4523809523807,30.101540616246492,0
2246,4,1,1,35,0.027777777777777776,0.027777777777777776,0.9722222222222222,36,900,700,200,0.7777777777777778,11,7,4,339.81029159988896,0.3833664021164021,0.10170115477020825,0.19777050936009777,131084.19075963713,1708.751417233551,132792.94217687068,2107,0,785.6944444444445,34,2,22,35.28854723707664,0.6354166666666667,43.988095238095234,1024.0476190476186,30.119047619047606,0
2247,4,1,2,34,0.027777777777777776,0.05555555555555555,0.9444444444444444,36,750,600,150,0.8,9,6,3,342.74815363790225,0.37781084656084657,0.10501575494602,0.19979709443770402,131145.15306122453,1789.9518140589614,132935.1048752835,2108,0,786.6666666666666,34,2,22,35.15177049434371,0.6360294117647058,43.92857142857143,1024.2857142857147,30.126050420168077,0
2248,4,0,0,34,0.0,0.0,1.0,34,900,600,300,0.6666666666666666,12,6,6,352.50530030089624,0.37355169340463457,0.08887373400272836,0.20473588644983273,131004.7762983368,2435.97560197938,133440.7519003162,2109,8,787.8529411764706,32,2,22,35.04383530669298,0.6393229166666667,44.06565656565656,1023.7373737373729,31.991792929292902,0
2249,4,0,0,34,0.0,0.0,1.0,34,650,500,150,0.7692307692307693,8,5,3,352.87880423462207,0.37329174093879974,0.09286284180749993,0.2052974965812616,131069.41415416799,2450.3236276910525,133519.73778185903,2110,9,788.8529411764706,32,2,22,34.96891697492808,0.6399739583333334,44.00252525252525,1023.9898989898993,31.999684343434353,0
2250,4,0,0,34,0.0,0.0,1.0,34,1100,800,300,0.7272727272727273,14,8,6,353.533572949337,0.37267899584076053,0.09316070925978037,0.2063925048782444,131202.54229142642,2476.9007112649033,133679.44300269132,2111,10,789.8529411764706,33,1,22,34.817583732057415,0.6388888888888888,43.872549019607845,1024.509803921569,31.045751633986942,0
2251,4,0,0,34,0.0,0.0,1.0,34,900,700,200,0.7777777777777778,11,7,4,353.2869832612686,0.37384878193701726,0.09389045585949307,0.2067557061591315,131296.7236910083,2477.084684976934,133773.80837598522,2112,11,790.8529411764706,33,1,23,34.728740683167906,0.6398358585858586,43.78063725490196,1024.8774509803925,31.05689245395129,0
2252,4,2,3,33,0.05555555555555555,0.08333333333333333,0.9166666666666666,36,800,500,300,0.625,11,5,6,338.60436709931463,0.3830522486772487,0.08281791590964738,0.20039708013022584,131725.0017715419,1720.5359257673576,133445.53769730925,2113,0,747.8611111111111,34,2,20,34.67325756697203,0.6418504901960784,43.363095238095234,1026.5476190476186,30.192577030812313,0
2253,4,0,0,33,0.0,0.0,1.0,33,950,700,250,0.7368421052631579,12,7,5,366.84035945271705,0.3740924873737374,0.0919055435377325,0.2146876085446516,131296.7236910082,3032.9874627546974,134329.7111537629,2114,13,771.060606060606,33,0,24,34.38147694208616,0.6398358585858586,43.780637254901954,1024.8774509803916,31.05689245395126,0
2254,4,0,0,33,0.0,0.0,1.0,33,850,500,350,0.5882352941176471,12,5,7,367.67589329197483,0.3740924873737374,0.09800276356862159,0.21554075263497505,131361.4930046928,3059.6983660646792,134421.19137075747,2115,14,772.060606060606,31,2,24,34.29455628942801,0.6454973118279571,43.71744791666666,1025.1302083333323,33.06871639784943,0
2255,4,0,0,33,0.0,0.0,1.0,33,1200,1000,200,0.8333333333333334,14,10,4,369.70812602428134,0.3740530303030303,0.09467879235321064,0.21820028614374246,131619.47959710742,3132.1582300275395,134751.63782713495,2116,15,773.060606060606,32,1,20,33.98163528977483,0.6455078125,43.465909090909086,1026.1363636363633,32.06676136363635,0
2256,4,0,0,33,0.0,0.0,1.0,33,900,600,300,0.6666666666666666,12,6,6,368.4299709270768,0.3735006313131313,0.09815924285838351,0.21793569466703355,131705.23356401385,3104.831074586698,134810.06463860054,2117,16,774.060606060606,33,0,21,33.92778971665075,0.6439393939393939,43.38235294117647,1026.4705882352941,31.10516934046346,0
2257,4,0,0,33,0.0,0.0,1.0,33,1050,900,150,0.8571428571428571,12,9,3,368.6825198983687,0.3725931186868687,0.09443522225477152,0.2186263860034275,131799.59518274214,3118.441374711646,134918.03655745377,2118,17,775.060606060606,33,0,21,33.826008473564876,0.6448863636363636,43.29044117647059,1026.838235294117,31.11631016042779,0
2258,4,0,0,33,0.0,0.0,1.0,33,900,700,200,0.7777777777777778,11,7,4,368.6825198983687,0.3725931186868687,0.09443522225477152,0.2186263860034275,131799.59518274214,3118.441374711646,134918.03655745377,2119,18,776.060606060606,33,0,21,33.826008473564876,0.6448863636363636,43.29044117647059,1026.838235294117,31.11631016042779,0
2259,4,0,0,33,0.0,0.0,1.0,33,1100,700,400,0.6363636363636364,15,7,8,369.3599925693562,0.37247474747474746,0.09411067507895554,0.22030248205452488,132019.90370290267,3152.5741301422427,135172.47783304492,2120,19,777.060606060606,33,0,22,33.58623499483265,0.6470959595959596,43.07598039215686,1027.696078431372,31.14230540701127,0
2260,4,0,0,33,0.0,0.0,1.0,33,950,900,50,0.9473684210526315,10,9,1,368.40099954398306,0.3732244318181818,0.0930833965398925,0.22046250971284004,132145.87688629373,3136.534626105344,135282.41151239906,2121,20,778.060606060606,33,0,23,33.483810091378636,0.6483585858585859,42.95343137254902,1028.1862745098038,31.157159833630416,0
2261,4,0,0,33,0.0,0.0,1.0,33,700,400,300,0.5714285714285714,10,4,6,369.17564596906044,0.3733822601010101,0.08643152208452487,0.22129443006945387,132208.88600538252,3161.6601787773916,135370.5461841599,2122,21,779.060606060606,33,0,23,33.40036145535431,0.648989898989899,42.8921568627451,1028.4313725490194,31.16458704693998,0
2262,4,0,0,33,0.0,0.0,1.0,33,750,600,150,0.8,9,6,3,368.92537409857806,0.3731060606060606,0.07978281745258142,0.2215135615295753,132271.91014273342,3159.692786428278,135431.60292916172,2123,22,780.060606060606,33,0,23,33.34326105948693,0.6496212121212122,42.83088235294117,1028.6764705882342,31.172014260249522,0
2263,4,0,0,33,0.0,0.0,1.0,33,600,400,200,0.6666666666666666,8,4,4,368.92537409857806,0.3731060606060606,0.07978281745258142,0.2215135615295753,132271.91014273342,3159.692786428278,135431.60292916172,2124,23,781.060606060606,33,0,23,33.34326105948693,0.6496212121212122,42.83088235294117,1028.6764705882342,31.172014260249522,0
2264,4,0,0,33,0.0,0.0,1.0,33,700,600,100,0.8571428571428571,8,6,2,365.3608403926904,0.37251420454545453,0.0760733450979969,0.21992365424927746,132366.47450800164,3072.305273212219,135438.77978121387,2125,24,782.060606060606,33,0,24,33.33965999761821,0.6505681818181819,42.73897058823529,1029.044117647058,31.183155080213883,0
2265,4,0,0,33,0.0,0.0,1.0,33,800,500,300,0.625,11,5,6,365.7111638486725,0.3718434343434343,0.0745423328204784,0.22088954296459826,132495.48037190086,3091.0190208649165,135586.49939276578,2126,25,783.060606060606,32,1,24,33.20072970321314,0.654296875,42.61363636363637,1029.545454545455,32.17329545454547,0
2266,4,1,0,34,0.029411764705882353,0.0,1.0,34,800,500,300,0.625,11,5,6,359.1947443865388,0.37548276886512183,0.08494906342425246,0.21913744630340476,132871.38848339583,2745.340884515574,135616.7293679114,2127,0,761.0,33,1,19,32.99048595427711,0.6556186868686869,42.24877450980392,1031.0049019607845,31.24257278669044,0
2267,4,0,0,34,0.0,0.0,1.0,34,950,700,250,0.7368421052631579,12,7,5,357.5096643928062,0.37548276886512183,0.08177777467170788,0.21884791601412723,132997.7671598664,2709.597420463282,135707.36458032968,2128,1,762.0,33,1,19,32.906988832125464,0.6568813131313131,42.12622549019608,1031.4950980392157,31.257427213309565,0
2268,4,0,0,34,0.0,0.0,1.0,34,650,500,150,0.7692307692307693,8,5,3,358.72922519934895,0.3749628639334522,0.08601342900861475,0.21996659482544212,133060.9790254951,2746.572382016542,135807.55140751164,2129,2,763.0,33,1,19,32.81206695173615,0.6575126262626263,42.06495098039216,1031.740196078432,31.264854426619152,0
2269,4,0,0,34,0.0,0.0,1.0,34,800,500,300,0.625,11,5,6,358.60397355128623,0.37459150326797386,0.08953456694398465,0.2202628782841271,133124.2059093859,2747.7738429930896,135871.97975237897,2130,3,764.0,33,1,19,32.75182579266121,0.6581439393939392,42.00367647058824,1031.9852941176478,31.27228163992872,0
2270,4,0,0,34,0.0,0.0,1.0,34,1150,900,250,0.782608695652174,14,9,5,357.38573212460886,0.3747957516339869,0.08796988279994977,0.21970092233236904,133155.82498317957,2717.598399653987,135873.42338283354,2131,4,765.0,33,1,19,32.751523786907306,0.6584595959595959,41.97303921568628,1032.1078431372553,31.27599524658349,0
2271,4,0,0,34,0.0,0.0,1.0,34,900,400,500,0.4444444444444444,14,4,10,359.15676189497026,0.37487002376708256,0.09220155298586685,0.2211649533774292,133219.0743944638,2769.306276432162,135988.38067089595,2132,5,766.0,33,1,19,32.64235121874011,0.659090909090909,41.91176470588236,1032.3529411764716,31.283422459893078,0
2272,4,0,0,34,0.0,0.0,1.0,34,1000,700,300,0.7,13,7,6,359.909695944684,0.3747214795008913,0.09809273816338782,0.22200579048535213,133282.33882401013,2793.9212081891756,136076.26003219932,2133,6,767.0,33,1,19,32.559439037898564,0.6597222222222221,41.85049019607844,1032.5980392156873,31.290849673202647,0
2273,4,0,0,34,0.0,0.0,1.0,34,950,700,250,0.7368421052631579,12,7,5,359.66841577206173,0.3752413844325609,0.1008513013746426,0.22261415161222337,133408.91273788936,2796.5944588619886,136205.50719675134,2134,7,768.0,33,1,21,32.43871095294584,0.6609848484848484,41.727941176470594,1033.0882352941185,31.30570409982177,0
2274,4,0,0,34,0.0,0.0,1.0,34,1000,800,200,0.8,12,8,4,360.7987713700073,0.3744243909685086,0.10119097425598977,0.22446153652488082,133598.8862456749,2840.462802768186,136439.34904844308,2135,8,769.0,33,1,21,32.21906116642959,0.6628787878787878,41.54411764705883,1033.823529411766,31.327985739750485,0
2275,4,0,0,34,0.0,0.0,1.0,34,850,700,150,0.8235294117647058,10,7,3,361.13744075829374,0.3736073975044563,0.09659882910510165,0.2254437869822486,133725.61034217622,2858.664936562877,136584.2752787391,2136,9,770.0,33,1,18,32.08333333333334,0.6641414141414141,41.42156862745099,1034.3137254901972,31.342840166369612,0
2276,4,0,0,34,0.0,0.0,1.0,34,850,700,150,0.8235294117647058,10,7,3,359.6254801847307,0.37412730243612596,0.09631812924174632,0.2248858002755184,133788.99491782018,2822.7863081507244,136611.78122597092,2137,10,771.0,33,1,18,32.05895127536919,0.6647727272727272,41.360294117647065,1034.5588235294126,31.35026737967917,0
2277,4,0,0,34,0.0,0.0,1.0,34,900,700,200,0.7777777777777778,11,7,4,360.2041699836756,0.37340314913844325,0.10039703270295774,0.22582956314121286,133884.0999405276,2845.1222186178343,136729.22215914543,2138,11,772.0,33,1,18,31.948761594631932,0.665719696969697,41.268382352941174,1034.9264705882347,31.361408199643474,0
2278,4,0,0,34,0.0,0.0,1.0,34,1000,500,500,0.5,15,5,10,345.75203949441527,0.37230763517528226,0.06466411416637641,0.2177052707695835,134042.6834030181,2469.10623317955,136511.78963619765,2139,12,773.0,33,1,19,32.16420118343195,0.6672979797979798,41.115196078431374,1035.539215686275,31.37997623291742,4
2279,4,0,0,34,0.0,0.0,1.0,34,750,600,150,0.8,9,6,3,347.4978738620333,0.37232620320855614,0.06807756826550238,0.2189936265479527,134074.41135921289,2518.1145773260314,136592.5259365389,2140,13,774.0,33,1,19,32.087302291642004,0.6676136363636364,41.08455882352941,1035.661764705883,31.38368983957221,0
2280,4,0,0,34,0.0,0.0,1.0,34,950,700,250,0.7368421052631579,12,7,5,353.92719291589844,0.37232620320855614,0.06995813222427816,0.22440151406916534,134296.6121804112,2706.2445934255857,137002.8567738368,2141,14,775.0,33,1,22,31.69878615906046,0.6698232323232324,40.87009803921568,1036.5196078431359,31.409685086155633,1
2281,4,0,0,34,0.0,0.0,1.0,34,1500,1200,300,0.8,18,12,6,351.426543489317,0.3717691622103387,0.06566541510221091,0.22320334518916074,134360.13192041515,2643.5433487120267,137003.67526912718,2142,15,776.0,33,1,22,31.700157604412922,0.6704545454545455,40.80882352941176,1036.7647058823525,31.417112299465227,0
2282,4,0,0,34,0.0,0.0,1.0,34,700,500,200,0.7142857142857143,9,5,4,353.0865614072588,0.372140522875817,0.0632655331099592,0.22464800621264797,134423.66667868104,2692.6380478661813,137116.3047265472,2143,16,777.0,33,1,22,31.593693374300802,0.6710858585858587,40.74754901960783,1037.0098039215668,31.42453951277475,0
2283,4,0,0,34,0.0,0.0,1.0,34,550,300,250,0.5454545454545454,8,3,5,353.99495737827857,0.37115641711229946,0.06778218550913917,0.22620945691485908,134582.56927924347,2728.3101751729946,137310.87945441646,2144,17,778.0,33,1,22,31.411533994724604,0.6726641414141415,40.59436274509803,1037.622549019607,31.443107546048697,0
2284,4,0,0,34,0.0,0.0,1.0,34,800,400,400,0.5,12,4,8,352.72443313796657,0.37076648841354726,0.07016886074543116,0.22638495435945832,134741.5657439445,2705.3284794309675,137446.89422337545,2145,18,779.0,33,1,23,31.28590258105129,0.6742424242424243,40.441176470588225,1038.235294117646,31.461675579322606,0
2285,4,0,0,34,0.0,0.0,1.0,34,700,600,100,0.8571428571428571,8,6,2,353.71345533018325,0.3706736482471777,0.0707027589796978,0.2276174285439107,134837.00867755193,2738.732849144564,137575.74152669648,2146,19,780.0,33,1,18,31.165068829891844,0.6751893939393939,40.349264705882355,1038.602941176471,31.472816399286998,0
2286,4,0,0,34,0.0,0.0,1.0,34,300,200,100,0.6666666666666666,4,2,2,353.82156767263365,0.3693367498514557,0.07652470116481558,0.22848842896391938,134964.31848627928,2750.6573493367937,137714.9758356161,2147,20,781.0,33,1,19,31.0353766167394,0.6764520202020202,40.22671568627451,1039.0931372549019,31.487670825906118,0
2287,4,0,0,34,0.0,0.0,1.0,34,1050,500,550,0.47619047619047616,16,5,11,352.61315583973027,0.3698009506833036,0.07607399395401715,0.22871330383365984,135123.54022491348,2729.267589388691,137852.80781430216,2148,21,782.0,33,1,19,30.908180103724654,0.678030303030303,40.0735294117647,1039.705882352941,31.50623885918003,0
2288,4,0,0,34,0.0,0.0,1.0,34,900,600,300,0.6666666666666666,12,6,6,351.16450202038845,0.3693738859180036,0.0735034265797263,0.2287824602955547,135282.8558276865,2701.307339725109,137984.1631674116,2149,22,783.0,33,1,21,30.787268818470967,0.6796085858585859,39.9203431372549,1040.3186274509806,31.524806892453956,0
2289,4,0,0,34,0.0,0.0,1.0,34,500,300,200,0.6,7,3,4,351.8724308096131,0.3691325014854427,0.07101087784937299,0.22944676939889522,135314.73021193777,2722.7046088043085,138037.43482074208,2150,23,784.0,33,1,21,30.737141735374948,0.6799242424242424,39.88970588235294,1040.4411764705885,31.528520499108744,0
2290,4,0,0,34,0.0,0.0,1.0,34,750,500,250,0.6666666666666666,10,5,5,349.4485433034532,0.36837121212121215,0.0680110263815874,0.22847316999816986,135410.37589208476,2663.7917207324094,138074.16761281717,2151,24,785.0,33,1,21,30.70506593665372,0.6808712121212122,39.79779411764706,1040.8088235294117,31.539661319073083,0
2291,4,0,0,34,0.0,0.0,1.0,34,1150,900,250,0.782608695652174,14,9,5,349.8111028131659,0.3670528817587641,0.07509725471737316,0.22972911527869283,135569.86045030763,2684.768478469827,138254.62892877747,2152,25,786.0,33,1,22,30.53708715776263,0.6824494949494949,39.64460784313726,1041.4215686274513,31.55822935234701,0
2292,4,0,0,34,0.0,0.0,1.0,34,700,500,200,0.7142857142857143,9,5,4,349.67017045707655,0.3670157456922163,0.0721975452142749,0.2304570379245011,135697.51567906578,2689.874687620149,138387.39036668593,2153,26,787.0,33,1,22,30.413922214380932,0.6837121212121212,39.52205882352941,1041.9117647058824,31.573083778966133,0
2293,4,0,0,34,0.0,0.0,1.0,34,700,400,300,0.5714285714285714,10,4,6,350.2502987198977,0.3667000891265597,0.07394276068653993,0.23104563925642277,135729.43887266915,2707.855302047292,138437.29417471646,2154,27,788.0,33,1,22,30.367100827159042,0.6840277777777778,39.49142156862745,1042.0343137254902,31.576797385620914,0
2294,4,0,0,34,0.0,0.0,1.0,34,950,600,350,0.631578947368421,13,6,7,352.68225110291957,0.36707144979203804,0.07749108105865798,0.23369319255324292,135889.11115916952,2785.1355247981514,138674.24668396768,2155,28,789.0,33,1,17,30.145157498824645,0.6856060606060606,39.338235294117645,1042.647058823529,31.59536541889482,0
2295,4,0,0,34,0.0,0.0,1.0,34,1050,900,150,0.8571428571428571,12,9,3,353.8949318540698,0.36660724896019015,0.08389489034951292,0.2351287872763455,135984.95958585633,2824.877601163007,138809.83718701932,2156,29,790.0,33,1,17,30.018383072886067,0.6865530303030303,39.24632352941176,1043.0147058823525,31.606506238859165,0
2296,4,0,0,34,0.0,0.0,1.0,34,800,600,200,0.75,10,6,4,353.42850782972454,0.3664401366607249,0.08187748783724014,0.23502995770676696,136016.91657054983,2814.4511726259198,138831.36774317574,2157,30,791.0,33,1,17,29.998825187969913,0.6868686868686869,39.21568627450981,1043.1372549019613,31.61021984551398,0
2297,4,0,0,34,0.0,0.0,1.0,34,1000,800,200,0.8,12,8,4,353.2480590191948,0.366198752228164,0.0833442713550483,0.23554480990982338,136112.8100520233,2816.317191705117,138929.1272437284,2158,31,792.0,33,1,19,29.908372479937366,0.6878156565656566,39.12377450980392,1043.5049019607845,31.62136066547832,0
2298,4,0,0,34,0.0,0.0,1.0,34,1450,1000,450,0.6896551724137931,19,10,9,353.6182455991018,0.36608734402852044,0.08692319379031255,0.23643015824279046,136208.73732458678,2833.1789455978605,139041.91627018465,2159,32,793.0,33,1,21,29.803553259763643,0.6887626262626263,39.031862745098046,1043.8725490196086,31.632501485442685,0
2299,4,0,0,34,0.0,0.0,1.0,34,1050,800,250,0.7619047619047619,13,8,5,355.8116033864902,0.3662173202614379,0.08463174026798836,0.2385421457479375,136304.69838824018,2899.758656526347,139204.45704476652,2160,33,794.0,33,1,21,29.651131518209915,0.6897095959595959,38.93995098039216,1044.240196078432,31.64364230540703,0
2300,4,0,0,34,0.0,0.0,1.0,34,800,600,200,0.75,10,6,4,354.61264000168296,0.366198752228164,0.08402473873848959,0.23795345811766505,136336.69291858922,2869.34292099195,139206.03583958116,2161,34,795.0,33,1,21,29.65070797152468,0.6900252525252524,38.90931372549021,1044.362745098041,31.647355912061848,0
2301,4,0,0,34,0.0,0.0,1.0,34,750,600,150,0.8,9,6,3,354.5667621803005,0.36601307189542487,0.08400488073050072,0.23820587835910867,136378.74858276657,2871.074263038567,139249.82284580515,2162,35,796.0,34,0,21,29.610211989970374,0.6881127450980391,38.86904761904763,1044.5238095238105,30.721288515406194,0
2302,4,0,0,34,0.0,0.0,1.0,34,800,700,100,0.875,9,7,2,356.0359487967699,0.36499183006535946,0.08055654201537088,0.24024900803127158,136534.22796201817,2922.2186791383215,139456.44664115648,2163,36,797.0,34,0,21,29.41773930212248,0.6896446078431373,38.720238095238095,1045.1190476190477,30.738795518207287,0
2303,4,0,0,34,0.0,0.0,1.0,34,700,500,200,0.7142857142857143,9,5,4,355.22273044492647,0.36510323826500296,0.07749016928260932,0.24012400277420332,136596.44451530618,2904.432397959197,139500.87691326538,2164,37,798.0,34,0,21,29.377348821318776,0.6902573529411764,38.66071428571429,1045.3571428571433,30.745798319327747,0
2304,4,0,0,34,0.0,0.0,1.0,34,1050,700,350,0.6666666666666666,14,7,7,355.36311052385383,0.36482471776589426,0.0810966463087972,0.24085721935505636,136689.7959183673,2914.90221088435,139604.69812925166,2165,38,799.0,34,0,21,29.28122153916211,0.6911764705882353,38.57142857142857,1045.7142857142853,30.756302521008394,0
2305,4,0,0,34,0.0,0.0,1.0,34,1150,900,250,0.782608695652174,14,9,5,355.0230639954233,0.3643048128342246,0.07865536372721338,0.24105981314247704,136752.96347858993,2910.0947640085387,139663.05824259846,2166,39,800.0,33,1,22,29.227567857840263,0.6941287878787878,38.5110294117647,1045.9558823529408,31.695632798573964,0
2306,4,0,0,34,0.0,0.0,1.0,34,400,200,200,0.5,6,2,4,354.3215561195838,0.3643048128342246,0.08498745469751867,0.22118890041784695,133725.61034217622,2680.461991782022,136406.07233395823,2167,40,801.0,33,1,16,32.25957740916272,0.6641414141414141,41.42156862745099,1034.3137254901972,31.342840166369612,8
2307,4,0,0,34,0.0,0.0,1.0,34,500,200,300,0.4,8,2,6,352.69292098455014,0.36402629233511585,0.08338616744814686,0.2207402766399228,133820.6928374905,2639.522209006163,136460.21504649665,2168,41,802.0,33,1,16,32.20653697342967,0.6650883838383839,41.329656862745104,1034.6813725490204,31.35398098633395,0
2308,4,0,0,34,0.0,0.0,1.0,34,700,600,100,0.8571428571428571,8,6,2,352.56324667814545,0.3636363636363636,0.0818262880708891,0.22084896550076127,133852.39451172634,2638.286956939649,136490.68146866598,2169,42,803.0,33,1,17,32.17817385125533,0.6654040404040404,41.29901960784314,1034.803921568628,31.35769459298873,0
2309,4,0,0,34,0.0,0.0,1.0,34,850,500,350,0.5882352941176471,12,5,7,352.4163087174961,0.363543523469994,0.08823529411764719,0.22171000687670334,134010.95920138893,2645.5295138888932,136656.48871527784,2170,43,804.0,33,1,18,32.02339034205231,0.6669823232323232,41.145833333333336,1035.416666666667,31.376262626262637,0
2310,4,0,0,34,0.0,0.0,1.0,34,650,400,250,0.6153846153846154,9,4,5,355.259532529652,0.36367349970291146,0.09156125189607422,0.22446667324407177,134169.61775519038,2733.0071366782136,136902.6248918686,2171,44,805.0,33,1,19,31.791163946061044,0.668560606060606,40.992647058823536,1036.0294117647065,31.394830659536563,0
2311,4,0,0,34,0.0,0.0,1.0,34,900,500,400,0.5555555555555556,13,5,8,354.1939218311014,0.36447192513368987,0.08404802147890056,0.22437587991952251,134264.8579422578,2711.159319732805,136976.0172619906,2172,45,806.0,33,1,19,31.72359682314454,0.6695075757575757,40.90073529411765,1036.3970588235297,31.405971479500902,0
2312,4,0,0,34,0.0,0.0,1.0,34,1100,700,400,0.6363636363636364,15,7,8,350.187695870155,0.36482471776589426,0.08260591571222076,0.22319191700639998,134487.21645520953,2619.1536908881235,137106.37014609764,2173,46,807.0,33,1,20,31.605426906112164,0.6717171717171717,40.68627450980392,1037.2549019607843,31.431966726084372,0
2313,4,0,0,34,0.0,0.0,1.0,34,700,300,400,0.42857142857142855,11,3,8,350.47821809325677,0.36460190136660725,0.08114812189936238,0.22376686232107929,134550.78124999997,2631.423611111111,137182.2048611111,2174,47,808.0,33,1,21,31.53447121820618,0.6723484848484849,40.625,1037.4999999999998,31.439393939393934,0
2314,4,0,0,34,0.0,0.0,1.0,34,1150,900,250,0.782608695652174,14,9,5,352.8045109383932,0.36387774806892453,0.0870686841611863,0.2262382295351349,134709.7589418734,2705.2421244233083,137415.0010662967,2175,48,809.0,33,1,21,31.315542242159534,0.6739267676767677,40.4718137254902,1038.11274509804,31.457961972667878,0
2315,4,0,0,34,0.0,0.0,1.0,34,550,400,150,0.7272727272727273,7,4,3,352.85708373177624,0.3638591800356506,0.08854072665176527,0.22686729344029385,134805.190611784,2713.3932862360693,137518.58389802006,2176,49,810.0,33,1,16,31.219022893556765,0.6748737373737373,40.379901960784316,1038.4803921568632,31.469102792632217,0
2316,4,0,0,34,0.0,0.0,1.0,34,1050,800,250,0.7619047619047619,13,8,5,353.00502456408407,0.3626522578728461,0.09388313003899351,0.22776077612285428,134932.48540224918,2726.3690647827775,137658.85446703195,2177,50,811.0,33,1,17,31.088306990642447,0.6761363636363636,40.25735294117647,1038.9705882352944,31.483957219251344,0
2317,4,0,0,34,0.0,0.0,1.0,34,1050,800,250,0.7619047619047619,13,8,5,353.1832939896482,0.36213235294117646,0.09491197693142084,0.2285873491344415,135045.28238378678,2739.1475340135953,137784.4299178004,2178,51,812.0,34,0,19,30.97129958385828,0.6749387254901962,40.14880952380952,1039.4047619047612,30.570728291316506,0
2318,4,0,0,34,0.0,0.0,1.0,34,1100,700,400,0.6363636363636364,15,7,8,351.72398714411696,0.36064691027926327,0.09626066290084778,0.2288170123364222,135230.95415249435,2712.7940759637195,137943.74822845808,2179,52,813.0,34,0,20,30.824367631910267,0.6767769607843137,39.970238095238095,1040.1190476190477,30.591736694677873,0
2319,4,0,0,34,0.0,0.0,1.0,34,450,200,250,0.4444444444444444,7,2,5,352.6600409602599,0.36034982174688057,0.09741658421006583,0.22982073810229023,135292.87308673467,2742.4780328798165,138035.3511196145,2180,53,814.0,34,0,20,30.738404470381813,0.677389705882353,39.910714285714285,1040.3571428571427,30.598739495798313,0
2320,4,0,0,34,0.0,0.0,1.0,34,900,800,100,0.8888888888888888,10,8,2,346.3895815357886,0.35955139631610217,0.06345365827357541,0.22361599612754154,134952.4943310657,2549.2276077097417,137501.72193877544,2181,54,815.0,34,0,19,31.24021348915367,0.6740196078431373,40.238095238095234,1039.0476190476186,30.56022408963584,2
2321,4,0,0,34,0.0,0.0,1.0,34,750,500,250,0.6666666666666666,10,5,5,344.82704338760783,0.35867869875222813,0.05812621692818709,0.22317901525702008,135045.28238378678,2513.4530895691505,137558.73547335592,2182,55,816.0,34,0,19,31.18843775054404,0.6749387254901962,40.14880952380952,1039.4047619047612,30.570728291316506,0
2322,4,0,0,34,0.0,0.0,1.0,34,800,500,300,0.625,11,5,6,347.6780519046795,0.358065953654189,0.053745336009375366,0.22560327677083727,135138.10232426293,2596.91043083899,137735.01275510192,2183,56,817.0,34,0,19,31.02196397221586,0.6758578431372548,40.0595238095238,1039.761904761904,30.581232492997174,0
2323,4,0,0,34,0.0,0.0,1.0,34,900,700,200,0.7777777777777778,11,7,4,351.8759612306287,0.35773172905525846,0.05654813997010999,0.2291126787804197,135261.91184807246,2719.083049886606,137980.99489795906,2184,57,818.0,34,0,19,30.789606698710603,0.6770833333333334,39.94047619047618,1040.2380952380945,30.595238095238074,0
2324,4,0,0,34,0.0,0.0,1.0,34,650,400,250,0.6153846153846154,9,4,5,350.0302551868247,0.35786170528817585,0.06347705539142812,0.22849995971531234,135354.8061933105,2675.655470521524,138030.46166383201,2185,58,819.0,34,0,19,30.745195057773714,0.6780024509803921,39.85119047619047,1040.595238095237,30.605742296918734,0
2325,4,0,0,34,0.0,0.0,1.0,34,800,600,200,0.75,10,6,4,351.3066390211686,0.3575460487225193,0.06404391582799662,0.22992703979050136,135447.7324263038,2716.7375283446668,138164.46995464846,2186,59,820.0,34,0,20,30.619567703568165,0.678921568627451,39.76190476190476,1040.9523809523805,30.616246498599427,0
2326,4,0,0,34,0.0,0.0,1.0,34,1100,700,400,0.6363636363636364,15,7,8,353.5142084341339,0.35706327985739755,0.06307324027004535,0.23217284499863364,135571.6836734692,2785.303287981837,138356.98696145104,2187,60,821.0,34,0,20,30.43886221612558,0.6801470588235294,39.64285714285713,1041.42857142857,30.630252100840295,0
2327,4,0,0,34,0.0,0.0,1.0,34,1000,600,400,0.6,14,6,8,352.37105271655156,0.3568590314913844,0.059612994255383356,0.2328308352100685,135788.73476473914,2769.603883219942,138558.33864795908,2188,61,822.0,34,0,22,30.252950694841036,0.6822916666666667,39.4345238095238,1042.2619047619041,30.654761904761887,0
2328,4,0,0,34,0.0,0.0,1.0,34,750,600,150,0.8,9,6,3,352.28887524542205,0.3570261437908497,0.05876979702591245,0.23338471780630912,135881.80980725627,2773.929988662133,138655.7397959184,2189,62,823.0,34,0,17,30.162660805358904,0.6832107843137255,39.345238095238095,1042.6190476190477,30.66526610644258,0
2329,4,0,1,33,0.0,0.029411764705882353,0.9705882352941176,34,750,500,250,0.6666666666666666,10,5,5,351.8031064012001,0.35756461675579326,0.0522872086855517,0.2336730110068928,135974.91673752846,2767.2796201814194,138742.19635770988,2190,63,824.0,34,0,17,30.08289578815203,0.6841299019607843,39.25595238095239,1042.9761904761915,30.67577030812328,0
2330,4,0,0,33,0.0,0.0,1.0,33,1100,900,200,0.8181818181818182,13,9,4,357.82996842193893,0.3545217803030303,0.052256464146061,0.23087385633799065,134932.48540224903,3056.577398116096,137989.06280036512,2191,64,847.2727272727273,33,0,18,30.9629826216875,0.6761363636363638,40.257352941176464,1038.9705882352932,31.48395721925131,5
2331,4,0,0,33,0.0,0.0,1.0,33,800,500,300,0.625,11,5,6,357.52158241367056,0.354876893939394,0.05491709548313328,0.23108102277956744,134996.15532487503,3052.80781430219,138048.9631391772,2192,65,848.2727272727273,33,0,18,30.90752751572327,0.6767676767676767,40.19607843137255,1039.2156862745096,31.491384432560896,0
2332,4,0,0,33,0.0,0.0,1.0,33,600,300,300,0.5,9,3,6,360.38812457255136,0.3545612373737374,0.05587590119540131,0.23334443302476188,135059.84026576314,3134.792507689346,138194.6327734525,2193,66,849.2727272727273,33,0,18,30.7695708559302,0.6773989898989898,40.134803921568626,1039.4607843137253,31.498811645870465,0
2333,4,0,0,33,0.0,0.0,1.0,33,750,600,150,0.8,9,6,3,358.0736938110865,0.35448232323232326,0.05149086337205144,0.23225513901324593,135123.54022491345,3076.8370338331347,138200.3772587466,2194,67,850.2727272727273,33,0,18,30.7662462674839,0.678030303030303,40.0735294117647,1039.7058823529408,31.506238859180023,0
2334,4,1,0,34,0.029411764705882353,0.0,1.0,34,750,500,250,0.6666666666666666,10,5,5,349.28823763574496,0.35986705288175874,0.05098196204022032,0.22840890513457876,135416.7534722222,2659.895833333329,138076.64930555553,2195,0,826.2352941176471,34,0,20,30.702895649853215,0.6786151960784315,39.791666666666664,1040.8333333333333,30.612745098039213,0
2335,4,0,0,34,0.0,0.0,1.0,34,800,500,300,0.625,11,5,6,350.2549581454107,0.3602384135472371,0.05048789837187884,0.229833467284164,135540.6905470521,2694.759778911557,138235.45032596367,2196,1,827.2352941176471,34,0,20,30.554523455660988,0.6798406862745099,39.672619047619044,1041.3095238095234,30.6267507002801,0
2336,4,1,1,34,0.02857142857142857,0.02857142857142857,0.9714285714285714,35,850,500,350,0.5882352941176471,12,5,7,342.4135894190666,0.3656512605042017,0.041809989211144316,0.22603313483352455,135754.27061899856,2296.821416323722,138051.09203532228,2197,0,804.5714285714286,35,0,20,30.546608914556494,0.6797619047619048,39.46759259259259,1042.129629629629,29.77513227513226,0
2337,4,0,0,34,0.0,0.0,1.0,34,1000,700,300,0.7,13,7,6,353.65849139026074,0.35984848484848486,0.04468545471649965,0.23347861490424868,135757.71683673444,2802.3738662131236,138560.09070294758,2198,3,829.2352941176471,34,0,20,30.250218947528744,0.6819852941176472,39.4642857142857,1042.1428571428553,30.651260504201627,0
2338,4,0,0,34,0.0,0.0,1.0,34,600,200,400,0.3333333333333333,10,2,8,351.7139249134084,0.35940285204991085,0.039737457340177196,0.23259872556962222,135819.7562358274,2753.9399092970243,138573.6961451244,2199,4,830.2352941176471,34,0,21,30.239264504339896,0.6825980392156864,39.40476190476189,1042.3809523809502,30.658263305322066,0
2339,4,0,0,34,0.0,0.0,1.0,34,850,500,350,0.5882352941176471,12,5,7,348.7753030003015,0.3596628045157457,0.03455664065123676,0.23105704263817228,135881.80980725607,2678.443877551005,138560.25368480707,2200,5,831.2352941176471,34,0,15,30.254243739057614,0.6832107843137256,39.34523809523809,1042.6190476190463,30.66526610644254,0
2340,4,0,0,34,0.0,0.0,1.0,34,900,600,300,0.6666666666666666,12,6,6,352.50248344672247,0.3596628045157457,0.028343359555761394,0.2121888208157009,132367.3752834465,2531.965702947823,134899.34098639432,2201,6,832.2352941176471,34,0,21,33.66954920561469,0.6482843137254903,42.73809523809523,1029.0476190476174,30.266106442576984,7
2341,4,0,0,34,0.0,0.0,1.0,34,350,200,150,0.5714285714285714,5,2,3,353.2851974085004,0.35888294711824126,0.030003673919255958,0.2130058449647066,132428.63520408154,2557.0153061224396,134985.65051020397,2202,7,833.2352941176471,34,0,21,33.58778625954198,0.6488970588235294,42.67857142857142,1029.2857142857135,30.27310924369746,0
2342,4,0,0,34,0.0,0.0,1.0,34,700,400,300,0.5714285714285714,10,4,6,353.37345461640416,0.3582144979203803,0.02856831909452029,0.21340598013426423,132489.9092970521,2563.6833900226643,135053.59268707476,2203,8,834.2352941176471,34,0,21,33.52388798951588,0.6495098039215687,42.61904761904761,1029.523809523809,30.280112044817912,0
2343,4,0,0,34,0.0,0.0,1.0,34,800,500,300,0.625,11,5,6,353.4334624967802,0.3581959298871064,0.028915392304187604,0.2139645125304159,132581.84700963701,2571.7722505668667,135153.61926020388,2204,9,835.2352941176471,34,0,21,33.429902130774835,0.6504289215686276,42.52976190476189,1029.880952380951,30.29061624649856,0
2344,4,0,0,34,0.0,0.0,1.0,34,650,400,250,0.6153846153846154,9,4,5,353.0980792115503,0.3577502970885324,0.02224661966947905,0.21411055917431965,132643.1565334466,2567.2087585033864,135210.36529194997,2205,10,836.2352941176471,34,0,17,33.37691166840018,0.6510416666666667,42.47023809523809,1030.1190476190466,30.297619047619015,0
2345,4,0,0,34,0.0,0.0,1.0,34,900,500,400,0.5555555555555556,13,5,8,350.67828095747024,0.3582330659536542,0.02984663889813799,0.21333955574482183,132765.81809807237,2511.6177721088266,135277.4358701812,2206,11,837.2352941176471,34,0,17,33.31600631473567,0.6522671568627452,42.35119047619047,1030.5952380952367,30.311624649859905,0
2346,4,0,0,34,0.0,0.0,1.0,34,650,400,250,0.6153846153846154,9,4,5,351.2095722760035,0.35838161021984555,0.034595082980646064,0.21401292655439225,132827.17013888885,2530.0347222222185,135357.20486111107,2207,12,838.2352941176471,34,0,17,33.24070331447049,0.6528799019607843,42.291666666666664,1030.833333333333,30.318627450980383,0
2347,4,0,0,34,0.0,0.0,1.0,34,900,600,300,0.6666666666666666,12,6,6,354.87236320329725,0.35940285204991085,0.03541499721569563,0.2167774619229165,132919.22477324243,2633.8718820861477,135553.09665532858,2208,13,839.2352941176471,34,0,17,33.053855922419764,0.6537990196078433,42.20238095238094,1031.1904761904748,30.329131652661022,0
2348,4,0,0,34,0.0,0.0,1.0,34,600,400,200,0.6666666666666666,8,4,4,354.85429474153193,0.35882724301841945,0.03457112793184236,0.21730123420037953,133011.31129535128,2639.9270124716327,135651.2383078229,2209,14,840.2352941176471,34,0,18,32.96186766685901,0.654718137254902,42.11309523809523,1031.5476190476174,30.33963585434169,0
2349,4,0,0,34,0.0,0.0,1.0,34,600,300,300,0.5,9,3,6,355.0465731115642,0.3590686274509804,0.03231017770597733,0.2175978502535228,133042.0138888887,2647.2222222221994,135689.2361111109,2210,15,841.2352941176471,34,0,18,32.92609046849757,0.6550245098039217,42.08333333333332,1031.6666666666652,30.343137254901915,0
2350,4,0,0,34,0.0,0.0,1.0,34,850,700,150,0.8235294117647058,10,7,3,352.7855269932115,0.359142899584076,0.023983988058891237,0.2169255687256127,133164.8596938773,2595.7270408162994,135760.5867346936,2211,16,842.2352941176471,34,0,19,32.86115916955017,0.6562500000000002,41.9642857142857,1032.1428571428553,30.357142857142804,0
2351,4,0,0,34,0.0,0.0,1.0,34,950,500,450,0.5263157894736842,14,5,9,357.05482681755836,0.359142899584076,0.026450163398692883,0.21423289609053503,132244.8979591837,2643.7358276644068,134888.6337868481,2212,17,843.2352941176471,34,0,19,33.675733024691354,0.6470588235294117,42.85714285714286,1028.571428571429,30.252100840336144,1
2352,4,0,0,34,0.0,0.0,1.0,34,850,700,150,0.8235294117647058,10,7,3,356.3600218785582,0.358715834818776,0.022510566184127834,0.21433678977706197,132336.75063775512,2631.9054705215485,134968.65610827666,2213,18,844.2352941176471,34,0,22,33.601131937213175,0.6479779411764706,42.767857142857146,1028.9285714285716,30.262605042016812,0
2353,4,0,0,34,0.0,0.0,1.0,34,750,600,150,0.8,9,6,3,356.141723356009,0.3590871954842543,0.02595238095238117,0.2149131089217297,132461.07266436,2634.9971115897515,135096.06977594976,2214,19,845.2352941176471,33,1,22,33.48164682539684,0.6515151515151514,42.64705882352942,1029.4117647058833,31.194295900178282,0
2354,4,0,0,34,0.0,0.0,1.0,34,850,700,150,0.8235294117647058,10,7,3,356.764399111827,0.3592543077837196,0.029936912272348515,0.21546928231045717,132492.61289227704,2653.7294850538265,135146.34237733088,2215,20,846.2352941176471,33,1,22,33.433891798595404,0.651830808080808,42.61642156862745,1029.5343137254904,31.198009506833042,0
2355,4,0,0,34,0.0,0.0,1.0,34,950,500,450,0.5263157894736842,14,5,9,353.9694423597298,0.35867869875222813,0.03472882968601354,0.21504155139888803,132713.49961553258,2595.304690503661,135308.80430603624,2216,21,847.2352941176471,33,1,17,33.283777354900096,0.654040404040404,42.40196078431373,1030.3921568627457,31.224004753416533,0
2356,4,0,0,34,0.0,0.0,1.0,34,1250,1000,250,0.8,15,10,5,372.16095980320813,0.3590686274509804,-0.014343530532079374,0.22476809657129745,132492.61289227675,3061.71559616491,135554.32848844165,2217,22,848.2352941176471,33,1,20,33.03760960996706,0.6518308080808082,42.61642156862744,1029.5343137254883,31.19800950683298,4
2357,4,0,0,34,0.0,0.0,1.0,34,1250,1100,150,0.88,14,11,3,368.1368914803607,0.3585115864527629,-0.017307006066373143,0.22346042214262718,132681.93310565618,2969.022881824264,135650.95598748044,2218,23,849.2352941176471,33,1,16,32.95059176876412,0.6537247474747476,42.43259803921567,1030.269607843135,31.220291146761667,0
2358,4,0,0,34,0.0,0.0,1.0,34,950,600,350,0.631578947368421,13,6,7,371.58073863705357,0.35795454545454547,-0.00945190821543207,0.2263117735464342,132808.22167255377,3069.795421232208,135878.01709378598,2219,24,850.2352941176471,33,1,18,32.7347867871438,0.6549873737373737,42.31004901960784,1030.7598039215682,31.235145573380855,0
2359,4,0,0,34,0.0,0.0,1.0,34,750,400,350,0.5333333333333333,11,4,7,373.0756728869769,0.35708184789067143,-0.016044687425718962,0.22779816485275925,132902.97752066507,3116.5735534409705,136019.55107410604,2220,25,851.2352941176471,33,1,19,32.60092306473338,0.6559343434343434,42.218137254901954,1031.1274509803916,31.2462863933452,0
2360,4,0,0,34,0.0,0.0,1.0,34,550,400,150,0.7272727272727273,7,4,3,373.0756728869769,0.35708184789067143,-0.016044687425718962,0.22779816485275925,132902.97752066507,3116.5735534409705,136019.55107410604,2221,26,852.2352941176471,33,1,19,32.60092306473338,0.6559343434343434,42.218137254901954,1031.1274509803916,31.2462863933452,0
2361,4,0,0,34,0.0,0.0,1.0,34,1200,900,300,0.75,15,9,6,371.4505229511792,0.358288770053476,-0.014669200617650091,0.22776707594508205,133060.97902549495,3085.1140486831937,136146.09307417815,2222,27,853.2352941176471,33,1,20,32.48394009581502,0.6575126262626263,42.064950980392155,1031.740196078431,31.26485442661912,0
2362,4,0,0,34,0.0,0.0,1.0,34,1000,800,200,0.8,12,8,4,370.5745284668899,0.3577502970885324,-0.018052256532066213,0.22742256047312037,133092.59059015758,3064.144800076886,136156.73539023445,2223,28,854.2352941176471,33,1,20,32.4747624703088,0.6578282828282829,42.03431372549019,1031.8627450980387,31.268568033273898,0
2363,4,0,0,34,0.0,0.0,1.0,34,600,400,200,0.6666666666666666,8,4,4,372.1261846302045,0.35778743315508016,-0.019411136174759536,0.2289568190752528,133187.44781153876,3112.507358948471,136299.95517048723,2224,29,855.2352941176471,33,1,20,32.3394030234675,0.6587752525252526,41.94240196078431,1032.230392156862,31.279708853238244,0
2364,4,0,0,34,0.0,0.0,1.0,34,800,600,200,0.75,10,6,4,369.35341194382744,0.3585115864527629,-0.017208639924044533,0.22783102848013834,133282.33882401,3045.6573193002723,136327.99614331027,2225,30,856.2352941176471,33,1,20,32.31564997230793,0.6597222222222222,41.85049019607843,1032.5980392156864,31.29084967320262,0
2365,4,0,0,34,0.0,0.0,1.0,34,900,800,100,0.8888888888888888,10,8,2,368.4313215400622,0.35882724301841945,-0.0275142314990513,0.2284274193548387,133472.2222222223,3035.069444444455,136507.29166666677,2226,31,857.2352941176471,33,1,20,32.14885752688171,0.6616161616161615,41.66666666666667,1033.3333333333342,31.31313131313134,0
2366,4,0,0,34,0.0,0.0,1.0,34,900,700,200,0.7777777777777778,11,7,4,367.7557500870169,0.3589572192513369,-0.028518913791058864,0.22820340253744031,133503.88259623697,3019.3640967416322,136523.2466929786,2227,32,858.2352941176471,33,1,20,32.134545831851064,0.6619318181818181,41.6360294117647,1033.4558823529408,31.316844919786085,0
2367,4,0,0,34,0.0,0.0,1.0,34,850,600,250,0.7058823529411765,11,6,5,367.2318023149611,0.35854872251931075,-0.02826834182766369,0.22865938864437826,133630.56163795167,3014.678398933094,136645.24003688476,2228,33,859.2352941176471,33,1,21,32.02103334518589,0.6631944444444444,41.51348039215686,1033.946078431372,31.33169934640521,0
2368,4,0,0,34,0.0,0.0,1.0,34,700,400,300,0.5714285714285714,10,4,6,359.34671140948694,0.35880867498514557,0.0007132667617686383,0.21904525625917412,132839.80320069197,2747.1092848904154,135586.91248558238,2229,34,860.2352941176471,33,1,17,33.01830718021873,0.6553030303030304,42.27941176470588,1030.882352941176,31.238859180035632,3
2369,4,0,0,34,0.0,0.0,1.0,34,700,300,400,0.42857142857142855,11,3,8,359.6861016216366,0.35860442661913255,0.006061326360827346,0.2196225587114986,132902.9775206651,2760.6707756632068,135663.6482963283,2230,35,861.2352941176471,33,1,17,32.94608192694715,0.6559343434343434,42.21813725490196,1031.127450980392,31.246286393345212,0
2370,4,0,0,34,0.0,0.0,1.0,34,1050,900,150,0.8571428571428571,12,9,3,355.57348469033656,0.35919860368389783,0.0023752969121138,0.2182163805461106,133092.59059015784,2664.8392445213613,135757.4298346792,2231,36,862.2352941176471,33,1,17,32.861737925574026,0.6578282828282828,42.03431372549021,1031.862745098041,31.26856803327397,0
2371,4,0,0,34,0.0,0.0,1.0,34,1000,600,400,0.6,14,6,8,355.3436515473885,0.35880867498514557,0.00611566322289514,0.21826031288698472,133124.2059093859,2660.9682874375317,135785.17419682344,2232,37,863.2352941176471,33,1,18,32.835940901713954,0.6581439393939392,42.00367647058824,1031.9852941176478,31.27228163992872,0
2372,4,0,0,34,0.0,0.0,1.0,34,400,200,200,0.5,6,2,4,355.4300034383151,0.35932857991681516,0.009855141296604142,0.21849864882901415,133155.82498317971,2665.5150663206664,135821.34004950037,2233,38,864.2352941176471,33,1,18,32.8019868598116,0.6584595959595958,41.973039215686285,1032.1078431372564,31.275995246583527,0
2373,4,0,0,34,0.0,0.0,1.0,34,600,400,200,0.6666666666666666,8,4,4,353.2252960519261,0.3595328282828283,0.00931971981479296,0.2173277332830809,133187.44781153902,2609.0351367262783,135796.4829482653,2234,39,865.2352941176471,33,1,18,32.82715481419922,0.6587752525252524,41.94240196078432,1032.2303921568641,31.279708853238308,0
2374,4,0,0,34,0.0,0.0,1.0,34,850,700,150,0.8235294117647058,10,7,3,353.61816146874696,0.3598856209150327,0.012583095916429476,0.21775434153601808,133219.07439446382,2621.7368319877155,135840.81122645154,2235,40,866.2352941176471,33,1,18,32.785295979740425,0.659090909090909,41.91176470588236,1032.3529411764719,31.283422459893085,0
2375,4,0,0,34,0.0,0.0,1.0,34,1150,900,250,0.782608695652174,14,9,5,355.7617262746205,0.3589943553178847,0.021171865733602413,0.22038406423374923,133440.56560277307,2694.609194780865,136135.17479755395,2236,41,867.2352941176471,33,1,20,32.50788261574348,0.661300505050505,41.69730392156863,1033.2107843137262,31.30941770647655,0
2376,4,0,0,34,0.0,0.0,1.0,34,700,400,300,0.5714285714285714,10,4,6,372.96353540777716,0.3589943553178847,0.010084735648645093,0.22116500093289188,131799.59518274208,3031.2885969338554,134830.88377967593,2237,42,868.2352941176471,33,1,19,33.716110713291165,0.6448863636363638,43.29044117647058,1026.8382352941167,31.116310160427776,4
2377,4,0,0,34,0.0,0.0,1.0,34,950,600,350,0.631578947368421,13,6,7,373.26568602815195,0.3584744503862151,0.016282953596564953,0.22207851284414445,131925.46323829767,3048.6497080449767,134974.11294634265,2238,43,869.2352941176471,33,1,19,33.58123086405026,0.6461489898989898,43.16789215686274,1027.3284313725483,31.131164587046918,0
2378,4,0,0,34,0.0,0.0,1.0,34,900,900,0,1.0,9,9,0,372.41169111648503,0.35877153891859775,0.014074427480915919,0.22175423425572513,131956.93963860048,3028.461409073425,134985.4010476739,2239,44,870.2352941176471,33,1,19,33.57138597328243,0.6464646464646465,43.13725490196078,1027.4509803921565,31.13487819370171,0
2379,4,1,0,35,0.02857142857142857,0.0,1.0,35,900,500,400,0.5555555555555556,13,5,8,364.379623678134,0.36334033613445377,0.02223948947707788,0.21880502628233184,132275.5119756235,2639.7002551020346,134915.21223072553,2240,0,846.3428571428572,34,1,20,33.4565347374918,0.6473651960784315,42.82738095238095,1028.6904761904755,30.255602240896337,0
2380,4,0,0,35,0.0,0.0,1.0,35,700,600,100,0.8571428571428571,8,6,2,366.0115720631378,0.363375350140056,0.023134759976864983,0.22049965438925645,132398.00347222234,2691.9536564625896,135089.95712868494,2241,1,847.3428571428572,32,3,20,33.291160593792156,0.6533203125,42.708333333333336,1029.1666666666674,32.16145833333336,0
2381,4,1,2,34,0.027777777777777776,0.05555555555555555,0.9444444444444444,36,750,500,250,0.6666666666666666,10,5,5,357.5668951956404,0.3712962962962963,0.020707791521302088,0.21722705598301628,132713.49961553252,2290.7908016147576,135004.29041714728,2242,0,824.7777777777778,33,3,17,33.19110767522992,0.6540404040404041,42.40196078431372,1030.3921568627452,31.224004753416523,0
2382,4,0,0,34,0.0,0.0,1.0,34,950,900,50,0.9473684210526315,10,9,1,380.61005106154283,0.3629679144385027,0.055448408871745514,0.2110655737704917,129201.3888888887,3035.06944444442,132236.4583333331,1929,3,808.3529411764706,33,1,20,36.15949453551912,0.6186868686868687,45.83333333333332,1016.6666666666652,30.808080808080764,8
2383,4,3,2,35,0.08108108108108109,0.05405405405405406,0.9459459459459459,37,950,600,350,0.631578947368421,13,6,7,357.78314175209726,0.3801926926926927,0.0512053319477912,0.20176294180674342,129860.54202428774,1892.382543015982,131752.92456730374,1930,0,743.7297297297297,36,1,16,36.068988693698664,0.6189236111111112,45.18581081081081,1019.2567567567563,28.312687687687674,0
2384,4,0,0,35,0.0,0.0,1.0,35,1050,700,350,0.6666666666666666,14,7,7,370.8997254536509,0.3671918767507003,0.06744566487497061,0.2085518955606009,129746.60572562365,2624.5960884353817,132371.20181405902,1931,1,787.2285714285714,34,1,18,35.850714730856126,0.6219362745098038,45.29761904761905,1018.8095238095243,29.964985994397775,0
2385,4,0,0,35,0.0,0.0,1.0,35,900,700,200,0.7777777777777778,11,7,4,370.8997254536509,0.3671918767507003,0.06744566487497061,0.2085518955606009,129746.60572562365,2624.5960884353817,132371.20181405902,1932,2,788.2285714285714,34,1,18,35.850714730856126,0.6219362745098038,45.29761904761905,1018.8095238095243,29.964985994397775,0
2386,4,1,1,35,0.027777777777777776,0.027777777777777776,0.9722222222222222,36,1200,800,400,0.6666666666666666,16,8,8,357.4800469343853,0.3748181216931217,0.06740719732778766,0.20290963385232477,130114.93866008645,2102.6988758144626,132217.63753590093,1933,0,767.3055555555555,35,1,18,35.81832577046703,0.6235119047619049,44.93634259259259,1020.2546296296285,29.150132275132243,0
2387,4,0,0,35,0.0,0.0,1.0,35,650,400,250,0.6153846153846154,9,4,5,367.5402622922809,0.36663165266106446,0.0690009337068167,0.20827281529895914,130049.99999999997,2559.7222222222217,132609.7222222222,1934,4,790.2285714285714,34,1,18,35.627723311546845,0.625,45.0,1019.9999999999998,29.999999999999993,0
2388,4,0,0,35,0.0,0.0,1.0,35,1450,1100,350,0.7586206896551724,18,11,7,366.0595904276782,0.36635154061624653,0.06495566962202548,0.20808108813965903,130171.45691609984,2530.102040816338,132701.55895691618,1935,5,791.2285714285714,34,1,18,35.54207497277961,0.6262254901960784,44.88095238095239,1020.4761904761909,30.01400560224091,0
2389,4,1,0,36,0.027777777777777776,0.0,1.0,36,700,600,100,0.8571428571428571,8,6,2,360.6442904481792,0.37458664021164023,0.0785196511496209,0.206895935046587,130528.56445312497,2214.876302083333,132743.4407552083,1936,0,770.2222222222222,35,1,15,35.31791539245669,0.6276785714285715,44.53125,1021.8749999999998,29.196428571428566,0
2390,4,2,1,37,0.05263157894736842,0.02631578947368421,0.9736842105263158,38,650,500,150,0.7692307692307693,8,5,3,348.8998424973064,0.38313477951635844,0.09534155014906376,0.20301405788675042,131075.36844269387,1546.435080986454,132621.8035236803,1937,0,730.6315789473684,37,1,16,35.064759788699725,0.629222972972973,43.99671052631579,1024.0131578947364,27.676031294452336,0
2391,4,0,0,37,0.0,0.0,1.0,37,850,300,550,0.35294117647058826,14,3,11,358.813587953779,0.3786286286286286,0.10051270460601458,0.20796542648749647,130924.43795146508,1995.4934664394245,132919.9314179045,1938,1,751.3783783783783,36,1,16,34.9636883802817,0.6296296296296295,44.14414414414415,1023.4234234234242,28.42842842842845,0
2392,4,0,0,37,0.0,0.0,1.0,37,600,400,200,0.6666666666666666,8,4,4,360.4667531397348,0.37825325325325326,0.1044981608299902,0.20907991826975433,130953.25213304527,2040.85872189758,132994.11085494285,1939,2,752.3783783783783,36,1,16,34.89222320020537,0.6299189814814814,44.115990990990994,1023.5360360360366,28.431556556556572,0
2393,4,0,1,36,0.0,0.02702702702702703,0.972972972972973,37,750,300,450,0.4,12,3,9,357.74864517357776,0.3784096596596596,0.1058905363788778,0.2079699924500109,131039.71370018672,1975.8560080350685,133015.5697082218,1940,3,753.3783783783783,36,1,17,34.8742942513565,0.630787037037037,44.031531531531535,1023.8738738738742,28.44094094094095,0
2394,4,0,0,36,0.0,0.0,1.0,36,800,600,200,0.75,10,6,4,366.74413722162456,0.3746031746031746,0.11724451981659456,0.21299093195832353,131002.08340031283,2408.849210176599,133410.93261048943,1941,4,775.0277777777778,35,1,17,34.68214151121161,0.6324404761904763,44.06828703703703,1023.726851851851,29.249338624338602,0
2395,4,0,0,36,0.0,0.0,1.0,36,800,500,300,0.625,11,5,6,364.8560758402757,0.3744874338624338,0.10755178907721286,0.21271253433375753,131150.23389274688,2370.1919367283867,133520.42582947528,1942,5,776.0277777777778,35,1,17,34.58050847457628,0.6339285714285714,43.92361111111111,1024.3055555555552,29.265873015873005,0
2396,4,1,1,36,0.02702702702702703,0.02702702702702703,0.972972972972973,37,800,500,300,0.625,11,5,6,360.7152138354846,0.3785660660660661,0.10700994448172785,0.21193214818185618,131446.7860510973,2083.0916709533462,133529.87772205065,1943,0,756.027027027027,35,2,17,34.38675696012039,0.6369047619047619,43.63425925925925,1025.4629629629621,29.298941798941776,0
2397,4,0,0,36,0.0,0.0,1.0,36,800,500,300,0.625,11,5,6,369.2237451506803,0.37374338624338627,0.11484341733441727,0.21643197205531042,131358.63272392293,2500.145266439909,133858.77799036284,1944,7,778.0277777777778,34,2,18,34.257780745557994,0.6381740196078431,43.720238095238095,1025.1190476190477,30.150560224089638,0
2398,4,0,0,36,0.0,0.0,1.0,36,950,700,250,0.7368421052631579,12,7,5,369.38703397986154,0.37339616402116405,0.1216386148191142,0.21721974728576837,131480.6990504535,2513.453089569158,133994.15214002266,1945,8,779.0277777777778,34,2,18,34.13015089959374,0.6393995098039216,43.601190476190474,1025.5952380952378,30.164565826330524,0
2399,4,0,0,36,0.0,0.0,1.0,36,950,800,150,0.8421052631578947,11,8,3,371.0567954802272,0.3734126984126984,0.11612645367576957,0.2187255446955264,131572.28599773234,2564.1581632653006,134136.44416099763,1946,9,780.0277777777778,34,2,14,33.99473969211729,0.6403186274509804,43.51190476190476,1025.9523809523803,30.175070028011184,0
2400,4,0,0,36,0.0,0.0,1.0,36,650,500,150,0.7692307692307693,8,5,3,369.7021979855837,0.3737103174603174,0.12042407837071423,0.2182762292216254,131633.36167800447,2533.0286281179074,134166.39030612237,1947,10,781.0277777777778,34,2,14,33.96775908739367,0.6409313725490196,43.45238095238095,1026.1904761904757,30.182072829131638,0
2401,4,0,0,36,0.0,0.0,1.0,36,750,400,350,0.5333333333333333,11,4,7,369.5769315801796,0.3732308201058201,0.1201019237955343,0.21872765140809114,131725.00177154198,2536.5043934240416,134261.50616496603,1948,11,782.0277777777778,34,2,14,33.87838725888129,0.6418504901960784,43.36309523809524,1026.5476190476193,30.19257703081233,0
2402,4,0,1,35,0.0,0.027777777777777776,0.9722222222222222,36,900,600,300,0.6666666666666666,12,6,6,368.3768637610352,0.3729166666666666,0.11955457660303481,0.21854324806070757,131816.67375283438,2511.6425736961346,134328.3163265305,1949,12,783.0277777777778,34,2,16,33.8166106345158,0.6427696078431373,43.27380952380952,1026.9047619047612,30.203081232492977,0
2403,4,0,0,35,0.0,0.0,1.0,35,1050,800,250,0.7619047619047619,13,8,5,377.7456268761286,0.37314425770308124,0.12853733378793053,0.22418614399588938,131831.05656478283,2959.721020761257,134790.7775855441,1950,13,789.8571428571429,33,2,16,33.56155529037392,0.6452020202020201,43.25980392156863,1026.960784313726,31.120023767082607,0
2404,4,0,0,35,0.0,0.0,1.0,35,800,700,100,0.875,9,7,2,375.7571761807092,0.37373949579831933,0.12519372143850638,0.22328050386275197,131877.80612244896,2910.8064058956948,134788.61252834465,1951,14,790.8571428571429,34,1,16,33.56537822593108,0.6433823529411764,43.214285714285715,1027.142857142857,30.210084033613445,0
2405,4,0,0,35,0.0,0.0,1.0,35,800,500,300,0.625,11,5,6,377.88648355452176,0.3737044817927171,0.12807493711108187,0.22527045069355192,132000.11337868482,2976.2117346938776,134976.3251133787,1952,15,791.8571428571429,34,1,16,33.38715438677787,0.6446078431372548,43.095238095238095,1027.6190476190477,30.224089635854344,0
2406,4,0,0,35,0.0,0.0,1.0,35,950,500,450,0.5263157894736842,14,5,9,376.0935769610287,0.37349439775910365,0.12374886260236595,0.22474519287601968,132091.88102324272,2935.781604308402,135027.66262755112,1953,16,792.8571428571429,34,1,16,33.34057131827833,0.6455269607843137,43.00595238095239,1027.9761904761913,30.234593837535037,0
2407,4,0,0,35,0.0,0.0,1.0,35,1200,1000,200,0.8333333333333334,14,10,4,366.75813167619407,0.37349439775910365,0.13162066501603542,0.21261090074310435,130931.84700963704,2604.0639172335414,133535.9109268706,1954,17,793.8571428571429,34,1,15,34.75291768446356,0.6338848039215688,44.13690476190475,1023.4523809523798,30.101540616246467,3
2408,4,0,0,35,0.0,0.0,1.0,35,1350,900,450,0.6666666666666666,18,9,9,363.53231829933964,0.3724089635854342,0.12877481840193772,0.21194077845514822,131150.2338927466,2535.469714506137,133685.70360725274,1955,18,794.8571428571429,35,0,15,34.614406779661024,0.6339285714285715,43.92361111111109,1024.305555555553,29.26587301587294,0
2409,4,1,1,35,0.027777777777777776,0.027777777777777776,0.9722222222222222,36,550,400,150,0.7272727272727273,7,4,3,355.1236389728325,0.3775628306878307,0.12725273165886186,0.20849897085705554,131419.65880102038,2134.2866197404874,133553.94542076087,1956,0,773.75,34,2,16,34.55750029025891,0.6387867647058822,43.660714285714285,1025.3571428571427,30.157563025210077,0
2410,4,0,0,35,0.0,0.0,1.0,35,900,600,300,0.6666666666666666,12,6,6,363.8661788133963,0.37230392156862746,0.13357014772436226,0.21329646711801395,131359.53006355726,2559.4580509900034,133918.98811454728,1957,20,796.8571428571429,33,2,17,34.39417712691771,0.6404671717171717,43.71936274509804,1025.1225490196075,31.064319667260833,0
2411,4,0,0,35,0.0,0.0,1.0,35,300,200,100,0.6666666666666666,4,2,2,365.1729685327993,0.37265406162464987,0.1331102079847002,0.21423822263291714,131390.9388816801,2596.0838379469415,133987.02271962704,1958,21,797.8571428571429,33,2,17,34.328930592079054,0.6407828282828283,43.68872549019608,1025.2450980392155,31.06803327391562,0
2412,4,2,2,35,0.05405405405405406,0.05405405405405406,0.9459459459459459,37,400,200,200,0.5,6,2,4,349.7208266490823,0.38153778778778774,0.1233641215606951,0.2074012816865413,131803.0907064471,1818.8571673525262,133621.94787379963,1959,0,755.6756756756756,35,2,14,34.309250075142764,0.6404761904761905,43.28703703703703,1026.851851851851,29.338624338624317,0
2413,4,3,2,36,0.07894736842105263,0.05263157894736842,0.9473684210526316,38,500,300,200,0.6,7,3,4,338.6807087482984,0.38488323850165956,0.11508437541438199,0.20247650230276462,132108.41912436084,1348.514604131155,133456.933728492,1960,0,736.7105263157895,36,2,15,34.28542739255851,0.6414930555555556,42.98986486486486,1028.0405405405404,28.556681681681678,0
2414,4,0,0,36,0.0,0.0,1.0,36,950,600,350,0.631578947368421,13,6,7,352.49855995617446,0.3747023809523809,0.13138921076348709,0.20979741878770922,131938.95266439897,2101.658163265293,134040.61082766426,1961,1,778.6388888888889,34,2,17,34.1010042487447,0.6439950980392157,43.1547619047619,1027.3809523809514,30.217086834733863,0
2415,4,0,0,36,0.0,0.0,1.0,36,850,600,250,0.7058823529411765,11,6,5,350.89630674630575,0.37438822751322753,0.12370666466489033,0.2095702824622688,132070.6356765473,2068.6196577074543,134139.25533425476,1962,2,779.6388888888889,35,1,17,34.009519385955016,0.643154761904762,43.02662037037036,1027.893518518517,29.368386243386205,0
2416,4,0,0,36,0.0,0.0,1.0,36,1000,800,200,0.8,12,8,4,350.44362578296005,0.37356150793650794,0.1303163884199341,0.20995897606753855,132189.63162562138,2065.002759559307,134254.6343851807,1963,3,780.6388888888889,35,1,18,33.901355280435205,0.6443452380952381,42.91087962962962,1028.35648148148,29.381613756613714,0
2417,4,0,1,35,0.0,0.027777777777777776,0.9722222222222222,36,300,200,100,0.6666666666666666,4,2,2,350.44362578296005,0.37356150793650794,0.1303163884199341,0.20995897606753855,132189.63162562138,2065.002759559307,134254.6343851807,1964,4,781.6388888888889,35,1,18,33.901355280435205,0.6443452380952381,42.91087962962962,1028.35648148148,29.381613756613714,0
2418,4,1,0,36,0.027777777777777776,0.0,1.0,36,700,500,200,0.7142857142857143,9,5,4,351.9638222949918,0.3778769841269842,0.13120234970628708,0.21170219081207536,132338.45191400874,2115.669474451286,134454.12138846001,1965,0,778.4166666666666,35,1,19,33.71250468691414,0.6458333333333335,42.766203703703695,1028.9351851851839,29.39814814814811,0
2419,4,1,1,36,0.02702702702702703,0.02702702702702703,0.972972972972973,37,900,600,300,0.6666666666666666,12,6,6,345.83655805365595,0.38238238238238237,0.12423141037903451,0.20983580117488682,132666.15125868042,1776.1744202246027,134442.325678905,1966,0,758.3513513513514,35,2,14,33.54082406471181,0.6491071428571429,42.44791666666666,1030.2083333333321,29.434523809523775,0
2420,4,0,0,36,0.0,0.0,1.0,36,550,200,350,0.36363636363636365,9,2,7,353.7505429516521,0.37655423280423284,0.12774566473988447,0.21398197178544004,132551.19756235828,2178.011621315194,134729.2091836735,1967,2,780.4166666666666,34,2,22,33.452552986512515,0.6501225490196079,42.55952380952381,1029.7619047619048,30.287114845938376,0
2421,4,0,0,36,0.0,0.0,1.0,36,850,500,350,0.5882352941176471,12,5,7,353.42529381433917,0.37690145502645506,0.1294252475056823,0.2143089745883305,132643.15653344672,2175.889314058956,134819.04584750568,1968,3,781.4166666666666,34,2,15,33.36848491852538,0.6510416666666667,42.470238095238095,1030.1190476190475,30.297619047619044,0
2422,4,0,0,36,0.0,0.0,1.0,36,850,500,350,0.5882352941176471,12,5,7,352.14797916318537,0.3767361111111111,0.13237496256364212,0.21417524634351104,132755.5941358024,2149.922839506164,134905.51697530856,1969,4,782.4166666666666,35,1,17,33.288409703504044,0.65,42.36111111111111,1030.555555555555,29.44444444444443,0
2423,4,0,1,35,0.0,0.027777777777777776,0.9722222222222222,36,600,300,300,0.5,9,3,6,350.5308759416475,0.37640542328042326,0.13028046011428018,0.2135313256591185,132815.23946544924,2111.1684456447183,134926.40791109396,1970,5,783.4166666666666,35,1,17,33.270173665693534,0.6505952380952381,42.30324074074074,1030.787037037037,29.4510582010582,0
2424,4,0,0,35,0.0,0.0,1.0,35,550,500,50,0.9090909090909091,6,5,1,357.67908365059685,0.371218487394958,0.13251225834145086,0.21688837497047048,132643.15653344672,2488.736536281178,135131.8930697279,1971,11,806.6571428571428,34,1,17,33.25893717015294,0.6510416666666666,42.470238095238095,1030.1190476190475,30.297619047619044,0
2425,4,0,0,35,0.0,0.0,1.0,35,800,600,200,0.75,10,6,4,354.43654143750774,0.37041316526610646,0.1307662687716593,0.21556714241527117,132755.59413580253,2410.686728395068,135166.2808641976,1972,12,807.6571428571428,35,0,18,33.2294474393531,0.6499999999999999,42.361111111111114,1030.5555555555559,29.444444444444454,0
2426,4,0,0,35,0.0,0.0,1.0,35,1250,900,350,0.72,16,9,7,357.96347311498823,0.3705532212885154,0.13621933621933624,0.21875545579249284,132934.5703125,2517.1440972222217,135451.71440972222,1973,13,808.6571428571428,35,0,18,32.9587542087542,0.6517857142857143,42.1875,1031.25,29.464285714285715,0
2427,4,0,0,35,0.0,0.0,1.0,35,700,600,100,0.8571428571428571,8,6,2,359.82388339688447,0.36999299719887957,0.13618876635034627,0.22024384950776318,132994.25582990394,2570.9019204389497,135565.15775034289,1974,14,809.6571428571428,35,0,18,32.85083782166368,0.6523809523809523,42.129629629629626,1031.481481481481,29.470899470899457,0
2428,4,0,0,35,0.0,0.0,1.0,35,550,400,150,0.7272727272727273,7,4,3,363.2763581540441,0.3697478991596639,0.13615821019904528,0.2227128924749069,133053.9547432269,2667.071223422483,135721.02596664938,1975,15,810.6571428571428,35,0,18,32.70183606312169,0.6529761904761905,42.07175925925925,1031.712962962962,29.477513227513196,0
2429,4,0,0,35,0.0,0.0,1.0,35,850,500,350,0.5882352941176471,12,5,7,361.912460397066,0.36876750700280114,0.13909588953320706,0.22258864288420938,133173.39275763032,2639.4220464677655,135812.8148040981,1976,16,811.6571428571428,35,0,18,32.61708529565672,0.6541666666666666,41.95601851851852,1032.175925925926,29.490740740740744,0
2430,4,0,0,35,0.0,0.0,1.0,35,950,900,50,0.9473684210526315,10,9,1,360.2234517760873,0.36859243697478994,0.14366102454881746,0.2220838571730805,133263.0064327203,2600.8920342506835,135863.898466971,1977,17,812.6571428571428,35,0,19,32.570736651347005,0.6550595238095238,41.86921296296296,1032.5231481481478,29.500661375661366,0
2431,4,0,0,35,0.0,0.0,1.0,35,850,600,250,0.7058823529411765,11,6,5,360.23105712873394,0.36817226890756305,0.1482064825930376,0.22280403221579687,133382.53821855705,2609.706548996912,135992.24476755396,1978,18,813.6571428571428,35,0,19,32.450630252100844,0.65625,41.75347222222222,1032.9861111111109,29.513888888888882,0
2432,4,0,1,34,0.0,0.02857142857142857,0.9714285714285714,35,950,700,250,0.7368421052631579,12,7,5,334.9213534817881,0.36817226890756305,0.11347517730496492,0.2003438641736513,132130.12695312488,1850.6401909722076,133980.7671440971,1979,19,814.6571428571428,35,0,17,34.36022458628841,0.64375,42.96874999999999,1028.124999999999,29.374999999999975,5
2433,4,0,0,34,0.0,0.0,1.0,34,700,500,200,0.7142857142857143,9,5,4,339.7797193518262,0.3672014260249554,0.11562406342805787,0.20320897896969317,132122.4773242629,2178.507653061207,134300.98497732411,1980,20,824.1176470588235,34,0,18,34.24304268951675,0.6458333333333335,42.97619047619047,1028.0952380952372,30.238095238095212,0
2434,4,1,0,35,0.02857142857142857,0.0,1.0,35,650,500,150,0.7692307692307693,8,5,3,336.0764228796106,0.371218487394958,0.13225645883845272,0.20326797650305198,132546.94097490128,1909.1803572959332,134456.12133219722,1981,0,801.5428571428571,35,0,19,33.91182889363455,0.6479166666666668,42.5636574074074,1029.7453703703693,29.421296296296266,0
2435,4,0,0,35,0.0,0.0,1.0,35,800,700,100,0.875,9,7,2,335.08533798291234,0.3704481792717087,0.12270757775138863,0.20347405721172446,132695.96220207447,1892.8942686899568,134588.85647076444,1982,1,802.5428571428571,35,0,13,33.78781921665544,0.649404761904762,42.41898148148147,1030.3240740740719,29.437830687830626,0
2436,4,0,0,35,0.0,0.0,1.0,35,1150,800,350,0.6956521739130435,15,8,7,335.80110577516905,0.3710434173669468,0.12383519445514057,0.20423313154522527,132755.59413580218,1915.8950617283585,134671.48919753055,1983,2,803.5428571428571,35,0,14,33.70956873315363,0.6500000000000001,42.36111111111109,1030.5555555555532,29.444444444444375,0
2437,4,0,0,35,0.0,0.0,1.0,35,1250,1000,250,0.8,15,10,5,339.05725998374646,0.3703781512605042,0.12653656815740155,0.20703640364600362,132904.7325772674,2012.4628933041517,134917.19547057155,1984,3,804.5428571428571,35,0,15,33.47609626968982,0.6514880952380953,42.21643518518517,1031.134259259257,29.460978835978775,0
2438,4,0,0,35,0.0,0.0,1.0,35,1000,700,300,0.7,13,7,6,337.34324308168317,0.36887254901960786,0.12505287444722213,0.20714547901627287,133113.66705246884,1980.9992283950273,135094.66628086386,1985,4,805.5428571428571,35,0,15,33.31090174966352,0.6535714285714287,42.01388888888887,1031.944444444442,29.484126984126917,0
2439,4,0,0,35,0.0,0.0,1.0,35,1250,900,350,0.72,16,9,7,337.8833276357861,0.3685574229691877,0.12499679692504873,0.208143596858509,133233.1318587105,2003.4507887517095,135236.5826474622,1986,5,806.5428571428571,35,0,16,33.17731689088191,0.6547619047619049,41.898148148148145,1032.407407407407,29.497354497354483,0
2440,4,0,0,35,0.0,0.0,1.0,35,1100,900,200,0.8181818181818182,13,9,4,335.6550313431493,0.3688025210084034,0.12312421942549756,0.20710333261712163,133292.8843557099,1948.085455246916,135240.9698109568,1987,6,807.5428571428571,35,0,16,33.17501681237392,0.6553571428571429,41.84027777777778,1032.638888888889,29.503968253968253,0
2441,4,0,0,35,0.0,0.0,1.0,35,1450,1000,450,0.6896551724137931,19,10,9,337.5390218522374,0.3692226890756303,0.1230414746543782,0.20927419354838714,133472.22222222213,2010.4166666666615,135482.6388888888,1988,7,808.5428571428571,35,0,20,32.94690860215054,0.6571428571428571,41.666666666666664,1033.3333333333328,29.523809523809508,0
2442,4,1,1,35,0.027777777777777776,0.027777777777777776,0.9722222222222222,36,1050,800,250,0.7619047619047619,13,8,5,330.8293572764696,0.3738095238095238,0.11568933401069259,0.20673459020011226,133763.29665814465,1650.5650921191504,135413.8617502638,1989,0,787.0555555555555,36,0,14,32.8293961825967,0.6579861111111112,41.38513513513514,1034.4594594594598,28.734984984984994,0
2443,4,0,0,35,0.0,0.0,1.0,35,850,600,250,0.7058823529411765,11,6,5,340.8221119205187,0.36964285714285716,0.1231615296073667,0.2126806139749828,133711.52692043895,2114.3689986282548,135825.8959190672,1990,9,810.5428571428571,35,0,16,32.622724559832875,0.6595238095238095,41.43518518518518,1034.2592592592591,29.550264550264547,0
2444,4,0,0,35,0.0,0.0,1.0,35,1000,900,100,0.9,11,9,2,342.5507921634065,0.3693977591036415,0.11662433507451975,0.21497766556612932,133921.09435281626,2174.9553915895,136096.04974440575,1991,10,811.5428571428571,35,0,17,32.36854243542435,0.6616071428571428,41.232638888888886,1035.069444444444,29.57341269841268,0
2445,4,0,0,35,0.0,0.0,1.0,35,850,700,150,0.8235294117647058,10,7,3,343.75265678578523,0.3696078431372549,0.1133659097441797,0.21625958281333563,134010.95920138882,2213.3246527777683,136224.2838541666,1992,11,812.5428571428571,35,0,17,32.24765258215962,0.6625,41.14583333333333,1035.416666666666,29.583333333333314,0
2446,4,0,0,35,0.0,0.0,1.0,35,750,300,450,0.4,12,3,9,347.1352751073829,0.3692577030812325,0.11907475695608416,0.21892273269457155,134100.85419077936,2310.2273823302494,136411.0815731096,1993,12,813.5428571428571,35,0,18,32.07027321488434,0.6633928571428571,41.05902777777778,1035.7638888888891,29.593253968253975,0
2447,4,1,1,35,0.027777777777777776,0.027777777777777776,0.9722222222222222,36,1050,800,250,0.7619047619047619,13,8,5,338.2007939305603,0.3742063492063492,0.11273409595520834,0.21506580873705786,134404.77639801957,1891.1604171739275,136295.9368151935,1994,0,791.9166666666666,36,0,18,31.998443382565878,0.6643518518518519,40.765765765765764,1036.9369369369365,28.803803803803792,0
2448,4,0,0,35,0.0,0.0,1.0,35,1650,1500,150,0.9090909090909091,18,15,3,347.3812181122447,0.3689075630252101,0.11204081632653051,0.22106077516233757,134430.72702331966,2339.7419410150897,136770.46896433475,1995,14,815.5428571428571,35,0,18,31.73456101190476,0.6666666666666666,40.74074074074074,1037.0370370370374,29.62962962962964,0
2449,4,0,0,35,0.0,0.0,1.0,35,1050,700,350,0.6666666666666666,14,7,7,346.6898174697891,0.36869747899159666,0.11155673159690149,0.2209839362847974,134490.74743870032,2325.3145361797065,136816.06197488002,1996,15,816.5428571428571,35,0,18,31.69260953656178,0.6672619047619047,40.682870370370374,1037.268518518519,29.636243386243397,0
2450,4,1,1,35,0.027777777777777776,0.027777777777777776,0.9722222222222222,36,650,500,150,0.7692307692307693,8,5,3,340.19085172759384,0.3728835978835979,0.10656784767413807,0.21842337415936053,134755.32119957806,1968.505498741995,136723.82669832004,1997,0,794.8333333333334,36,0,19,31.597523499638466,0.6678240740740741,40.42792792792793,1038.288288288289,28.841341341341362,0
2451,4,0,0,35,0.0,0.0,1.0,35,900,600,300,0.6666666666666666,12,6,6,349.389910251079,0.3684873949579832,0.11586628851852976,0.22344008097797255,134610.82845721877,2406.33305469821,137017.161511917,1998,17,818.5428571428571,35,0,19,31.502806900141266,0.668452380952381,40.567129629629626,1037.7314814814813,29.649470899470895,0
2452,4,0,0,35,0.0,0.0,1.0,35,700,400,300,0.5714285714285714,10,4,6,343.00911319014057,0.3684873949579832,0.15311017099103985,0.2048597131299017,132070.63567654745,2060.2863243741363,134130.9220009216,1999,18,819.5428571428571,35,0,18,34.212199264347106,0.643154761904762,43.02662037037037,1027.8935185185182,29.368386243386237,7
2453,4,1,1,35,0.027777777777777776,0.027777777777777776,0.9722222222222222,36,700,300,400,0.42857142857142855,11,3,8,332.9242430399856,0.37447089947089945,0.14219692547188134,0.2001049923956124,132311.09487866238,1609.9142216540763,133921.00910031644,2000,0,797.75,36,0,18,34.22974131640396,0.6435185185185186,42.79279279279279,1028.8288288288284,28.578578578578565,0
2454,4,0,0,35,0.0,0.0,1.0,35,1100,700,400,0.6363636363636364,15,7,8,339.80270461633995,0.3681372549019608,0.1456158965949652,0.20374405082461505,132219.38898533935,1985.7011959876368,134205.090181327,2001,20,821.5428571428571,35,0,19,34.14500337609723,0.6446428571428573,42.881944444444436,1028.472222222221,29.3849206349206,0
2455,4,0,0,35,0.0,0.0,1.0,35,1100,900,200,0.8181818181818182,13,9,4,337.5332301685012,0.36869747899159666,0.15272376667202314,0.20302235562909157,132338.45191400877,1933.725030006842,134272.1769440156,2002,21,822.5428571428571,35,0,20,34.083708286464194,0.6458333333333335,42.766203703703695,1028.935185185184,29.398148148148117,0
2456,4,0,0,35,0.0,0.0,1.0,35,1200,900,300,0.75,15,9,6,339.3777721053034,0.36705182072829134,0.1586687654598613,0.20477787687276544,132457.5684263543,1990.6308942043584,134448.19932055866,2003,22,823.5428571428571,35,0,21,33.916591709766884,0.6470238095238097,42.65046296296295,1029.3981481481458,29.411375661375594,0
2457,4,0,0,35,0.0,0.0,1.0,35,1150,900,250,0.782608695652174,14,9,5,340.6607526605899,0.3669467787114846,0.16277718010886533,0.2060407013202762,132546.94097490114,2030.7081350736971,134577.64910997482,2004,23,824.5428571428571,35,0,21,33.79381158442921,0.6479166666666669,42.56365740740739,1029.7453703703682,29.421296296296234,0
2458,4,0,0,35,0.0,0.0,1.0,35,650,300,350,0.46153846153846156,10,3,7,339.75980419126404,0.3665966386554622,0.15975339562662616,0.20565868963903822,132576.73852237625,2008.8493441357718,134585.58786651204,2005,24,825.5428571428571,35,0,21,33.78708698583952,0.6482142857142859,42.53472222222221,1029.8611111111088,29.42460317460311,0
2459,4,0,0,35,0.0,0.0,1.0,35,750,500,250,0.6666666666666666,10,5,5,340.70516779157407,0.36705182072829134,0.1577974586060844,0.20721576598471095,132755.59413580215,2046.1033950616907,134801.69753086384,2006,25,826.5428571428571,35,0,16,33.583221024258755,0.6500000000000001,42.36111111111109,1030.555555555553,29.44444444444437,0
2460,4,1,1,35,0.027777777777777776,0.027777777777777776,0.9722222222222222,36,800,400,400,0.5,12,4,8,338.8485880823139,0.373859126984127,0.15797262638417875,0.20444983126471492,132455.95838659603,1776.502896477554,134232.4612830736,2007,0,804.5555555555555,36,0,20,33.931827298253296,0.6449652777777779,42.652027027027025,1029.3918918918916,28.594219219219212,1
2461,4,0,0,35,0.0,0.0,1.0,35,500,200,300,0.4,8,2,6,343.1917039504956,0.374124649859944,0.1637756823183567,0.20691551343944106,132427.78427479847,2089.6233871313384,134517.4076619298,2008,1,816.2285714285714,35,0,20,33.84836856703775,0.6467261904761905,42.679398148148145,1029.282407407407,29.40806878306877,0
2462,4,0,0,35,0.0,0.0,1.0,35,800,700,100,0.875,9,7,2,345.0565763019374,0.3739495798319328,0.16350758853288405,0.20836919526176062,132487.35592689045,2143.126687885804,134630.48261477627,2009,2,817.2285714285714,35,0,20,33.74051433389544,0.6473214285714286,42.62152777777778,1029.513888888889,29.41468253968254,0
2463,4,0,0,35,0.0,0.0,1.0,35,650,600,50,0.9230769230769231,7,6,1,347.616888912735,0.3737745098039216,0.16807629322801287,0.21041463112554515,132576.73852237643,2217.182677469121,134793.92119984556,2010,3,818.2285714285714,35,0,21,33.58479433580579,0.6482142857142857,42.534722222222214,1029.8611111111102,29.42460317460315,0
2464,4,1,1,35,0.027777777777777776,0.027777777777777776,0.9722222222222222,36,900,500,400,0.5555555555555556,13,5,8,339.40589516533294,0.3787367724867725,0.155390478964873,0.20685230122126885,132832.9744440386,1816.8589197305453,134649.83336376917,2011,0,796.4722222222222,36,0,14,33.53907217245651,0.6487268518518519,42.28603603603604,1030.8558558558557,28.63488488488488,0
2465,4,0,0,35,0.0,0.0,1.0,35,550,200,350,0.36363636363636365,9,2,7,347.1874603921251,0.3732843137254902,0.16592098083897766,0.21082283577153435,132695.9622020746,2214.0748242455265,134910.03702632012,2012,5,820.2285714285714,35,0,15,33.47609151501537,0.649404761904762,42.418981481481474,1030.3240740740728,29.43783068783065,0
2466,4,0,1,34,0.0,0.02857142857142857,0.9714285714285714,35,1250,1100,150,0.88,14,11,3,346.536067748189,0.372233893557423,0.16738816738816742,0.21177204140167097,132934.57031249988,2213.3246527777637,135147.89496527764,2013,6,821.2285714285714,35,0,16,33.253367003367,0.6517857142857144,42.18749999999999,1031.249999999999,29.464285714285687,0
2467,4,0,0,34,0.0,0.0,1.0,34,950,600,350,0.631578947368421,13,6,7,356.4377529540855,0.36514037433155083,0.17511531694326887,0.21719876867202145,132827.17013888876,2668.9236111110913,135496.09374999985,2014,33,846.2058823529412,34,0,16,33.1059687415791,0.6528799019607844,42.29166666666666,1030.8333333333321,30.318627450980358,0
2468,4,0,0,34,0.0,0.0,1.0,34,550,300,250,0.5454545454545454,8,3,5,357.15810813570096,0.3644162210338681,0.17350971790240055,0.21817373291053863,132919.2247732424,2694.6357709750355,135613.86054421743,2015,34,847.2058823529412,34,0,16,32.994929962287394,0.6537990196078433,42.20238095238094,1031.1904761904746,30.329131652661015,0
2469,4,0,0,34,0.0,0.0,1.0,34,800,600,200,0.75,10,6,4,356.5338016061877,0.3638406120023767,0.17875443704653948,0.21868920442468695,133072.72002551006,2688.984552154185,135761.70457766423,2016,35,848.2058823529412,34,0,16,32.856909349640404,0.6553308823529412,42.05357142857142,1031.7857142857133,30.346638655462158,0
2470,4,0,0,34,0.0,0.0,1.0,34,900,600,300,0.6666666666666666,12,6,6,357.6260408014598,0.36359922756981583,0.17710820490557877,0.22026512967544437,133226.30385487515,2729.039115646244,135955.3429705214,2017,36,849.2058823529412,34,0,18,32.67460408979091,0.6568627450980392,41.9047619047619,1032.3809523809514,30.364145658263276,0
2471,4,0,0,34,0.0,0.0,1.0,34,1100,800,300,0.7272727272727273,14,8,6,362.6220384856316,0.3646390374331551,0.1853320858080445,0.22408182378214647,133349.23469387737,2871.074263038532,136220.3089569159,2018,37,850.2058823529412,34,0,19,32.42229522053174,0.6580882352941178,41.78571428571428,1032.8571428571415,30.37815126050416,0
2472,4,0,0,34,0.0,0.0,1.0,34,900,800,100,0.8888888888888888,10,8,2,361.87155875560717,0.3650289661319073,0.18372610018774238,0.2241743938929273,133441.47002551003,2857.7345521541765,136299.2045776642,2019,38,851.2058823529412,34,0,19,32.34915696892882,0.6590073529411765,41.69642857142856,1033.2142857142844,30.388655462184836,0
2473,4,0,0,34,0.0,0.0,1.0,34,700,600,100,0.8571428571428571,8,6,2,360.3017689906345,0.36456476530005943,0.18026565464895583,0.22338709677419355,133472.2222222223,2818.059098639466,136290.28132086177,2020,39,852.2058823529412,33,1,19,32.35887096774192,0.6616161616161615,41.66666666666667,1033.3333333333342,31.31313131313134,0
2474,4,0,0,34,0.0,0.0,1.0,34,1000,700,300,0.7,13,7,6,361.40306905935495,0.364434789067142,0.19066691946722325,0.2253774918103814,133687.58680555536,2863.0208333333103,136550.60763888867,2021,40,853.2058823529412,34,0,19,32.11455815202793,0.6614583333333335,41.45833333333332,1034.1666666666652,30.41666666666662,0
2475,4,0,0,34,0.0,0.0,1.0,34,900,600,300,0.6666666666666666,12,6,6,362.28698251101423,0.36437908496732024,0.19048263724362013,0.22649452359861239,133779.93905895686,2893.346088435364,136673.28514739222,2022,41,854.2058823529412,34,0,15,31.999184886843107,0.6623774509803921,41.36904761904761,1034.523809523809,30.42717086834732,0
2476,4,0,0,34,0.0,0.0,1.0,34,550,200,350,0.36363636363636365,9,2,7,362.8866250716024,0.364434789067142,0.19128984006443495,0.22705886670246903,133810.73022959175,2911.6248582766325,136722.35508786837,2023,42,855.2058823529412,34,0,15,31.95283434971042,0.6626838235294118,41.33928571428571,1034.6428571428564,30.430672268907543,0
2477,4,0,0,34,0.0,0.0,1.0,34,1150,1000,150,0.8695652173913043,13,10,3,364.44179307344734,0.3641934046345811,0.19129823042372474,0.2289874156478826,133964.73922902482,2964.4699546485112,136929.20918367335,2024,43,856.2058823529412,34,0,16,31.758375498313395,0.6642156862745099,41.19047619047618,1035.2380952380943,30.448179271708653,0
2478,4,0,0,34,0.0,0.0,1.0,34,750,400,350,0.5333333333333333,11,4,7,367.6970762739561,0.3631350267379679,0.19769532913728605,0.23200378975052177,134118.83680555565,3063.020833333343,137181.857638889,2025,44,857.2058823529412,34,0,16,31.51984446232233,0.6657475490196079,41.04166666666667,1035.8333333333342,30.465686274509828,0
2479,4,0,0,34,0.0,0.0,1.0,34,950,700,250,0.7368421052631579,12,7,5,367.667508720486,0.3626522578728461,0.20469980065547166,0.2327669573390425,134242.17864229044,3071.2974773242845,137313.47611961473,2026,45,858.2058823529412,34,0,17,31.397185525560033,0.6669730392156862,40.92261904761906,1036.3095238095252,30.479691876750742,0
2480,4,0,0,34,0.0,0.0,1.0,34,800,600,200,0.75,10,6,4,366.0916450408907,0.3625965537730244,0.2023832040854927,0.2323561257300349,134334.72222222236,3035.763888888908,137370.48611111127,2027,46,859.2058823529412,34,0,18,31.345458199356912,0.667892156862745,40.83333333333334,1036.6666666666679,30.49019607843141,0
2481,4,0,0,34,0.0,0.0,1.0,34,950,700,250,0.7368421052631579,12,7,5,366.9324489448893,0.36293077837195487,0.20304585668940334,0.23328333067956117,134396.43565759645,3062.8826530612278,137459.3183106577,2028,47,860.2058823529412,34,0,18,31.26195943360122,0.6685049019607843,40.773809523809526,1036.9047619047624,30.497198879551835,0
2482,4,0,0,34,0.0,0.0,1.0,34,1050,800,250,0.7619047619047619,13,8,5,366.23929613633413,0.3619281045751634,0.20602411265171638,0.23363171497306137,134519.9050453516,3053.2950680272265,137573.2001133788,2029,48,861.2058823529412,34,0,19,31.1565201591309,0.6697303921568627,40.65476190476191,1037.3809523809534,30.51120448179275,0
2483,4,0,0,34,0.0,0.0,1.0,34,850,700,150,0.8235294117647058,10,7,3,368.6258320254591,0.36079545454545453,0.20885759969775242,0.23615346285304797,134674.3214994333,3128.8867630385744,137803.2082624719,2030,49,862.2058823529412,34,0,20,30.940331460029817,0.6712622549019607,40.505952380952394,1037.9761904761922,30.528711484593888,0
2484,4,0,0,34,0.0,0.0,1.0,34,750,500,250,0.6666666666666666,10,5,5,368.6258320254591,0.36079545454545453,0.20885759969775242,0.23615346285304797,134674.3214994333,3128.8867630385744,137803.2082624719,2031,50,863.2058823529412,34,0,20,30.940331460029817,0.6712622549019607,40.505952380952394,1037.9761904761922,30.528711484593888,0
2485,4,0,0,34,0.0,0.0,1.0,34,950,700,250,0.7368421052631579,12,7,5,365.9196016103774,0.36079545454545453,0.19641429908393526,0.21449514564104577,131358.63272392302,2813.339710884366,134171.9724348074,2032,51,864.2058823529412,34,0,21,34.342459257538806,0.638174019607843,43.7202380952381,1025.1190476190484,30.15056022408966,7
2486,4,1,0,35,0.02857142857142857,0.0,1.0,35,700,500,200,0.7142857142857143,9,5,4,358.2232067487955,0.36645658263305325,0.1951118916045047,0.21161660054907197,131654.57182623883,2432.3445805469796,134086.9164067858,2033,0,840.4857142857143,35,0,18,34.24084150971769,0.6389880952380952,43.43171296296296,1026.2731481481478,29.32208994708994,0
2487,4,0,0,35,0.0,0.0,1.0,35,500,200,300,0.4,8,2,6,359.9228575550151,0.36628151260504205,0.19993879161767336,0.2129523564813496,131713.969331383,2481.3736443330104,134195.34297571602,2034,1,841.4857142857143,35,0,18,34.137280602848875,0.6395833333333332,43.3738425925926,1026.5046296296307,29.328703703703734,0
2488,4,0,0,35,0.0,0.0,1.0,35,1200,900,300,0.75,15,9,6,359.9343644703845,0.36645658263305325,0.2020035432436782,0.21312535466303814,131743.67310742466,2483.8150505829994,134227.48815800768,2035,2,842.4857142857143,35,0,19,34.10700864336715,0.6398809523809523,43.34490740740741,1026.6203703703711,29.332010582010604,0
2489,4,0,0,35,0.0,0.0,1.0,35,1000,600,400,0.6,14,6,8,362.57144879789206,0.36603641456582636,0.20522730566694025,0.21485446374656658,131773.3802324461,2555.4530767747037,134328.8333092208,2036,3,843.4857142857143,35,0,19,34.00934223875549,0.6401785714285714,43.31597222222223,1026.736111111112,29.335317460317487,0
2490,4,0,0,35,0.0,0.0,1.0,35,800,600,200,0.75,10,6,4,365.77415592144393,0.3661764705882353,0.21000241448692125,0.217431053838099,131892.2422223295,2648.5547142918513,134540.79693662137,2037,4,844.4857142857143,35,0,19,33.80715962441315,0.6413690476190474,43.20023148148149,1027.199074074075,29.348544973545,0
2491,4,0,0,35,0.0,0.0,1.0,35,800,500,300,0.625,11,5,6,363.6341768046346,0.3658263305322129,0.2066874778746821,0.21666739742762078,131981.4238790297,2598.5912851509165,134580.0151641806,2038,5,845.4857142857143,35,0,19,33.77215213636707,0.6422619047619046,43.11342592592594,1027.546296296298,29.358465608465654,0
2492,4,0,0,35,0.0,0.0,1.0,35,500,300,200,0.6,7,3,4,363.4769905040172,0.3657913165266107,0.20362934362934304,0.21691368788142992,132040.8950617287,2598.7654320987976,134639.66049382748,2039,6,846.4857142857143,35,0,19,33.716216216216225,0.6428571428571426,43.05555555555557,1027.77777777778,29.36507936507943,0
2493,4,1,1,35,0.027777777777777776,0.027777777777777776,0.9722222222222222,36,650,400,250,0.6153846153846154,9,4,5,352.934427725347,0.37053571428571425,0.19102086981903077,0.2121321665591301,132311.09487866276,2139.428110543009,134450.52298920575,2040,0,823.9444444444445,36,0,19,33.715064944541744,0.6435185185185184,42.79279279279281,1028.8288288288313,28.578578578578647,0
2494,4,0,0,35,0.0,0.0,1.0,35,800,600,200,0.75,10,6,4,360.00700390759437,0.3658963585434174,0.20208008487517892,0.21602851071754187,132249.14969403745,2522.12403013549,134771.27372417293,2041,8,848.4857142857143,35,0,20,33.59553748921647,0.644940476190476,42.853009259259274,1028.5879629629649,29.388227513227566,0
2495,4,0,0,35,0.0,0.0,1.0,35,650,600,50,0.9230769230769231,7,6,1,358.04281606115416,0.36575630252100844,0.19972036063834886,0.21518881622499006,132308.68115837208,2474.4345582561964,134783.1157166283,2042,9,849.4857142857143,35,0,20,33.58610361120486,0.6455357142857141,42.7951388888889,1028.819444444446,29.39484126984131,0
2496,4,0,0,35,0.0,0.0,1.0,35,700,400,300,0.5714285714285714,10,4,6,357.1604189545804,0.3657913165266107,0.1938692886061304,0.21516737434580827,132398.0034722223,2457.495418595685,134855.49889081798,2043,10,850.4857142857143,34,1,21,33.51889338731444,0.6485906862745099,42.708333333333336,1029.1666666666672,30.26960784313727,0
2497,4,0,0,35,0.0,0.0,1.0,35,450,200,250,0.4444444444444444,7,2,5,356.6108442422877,0.36586134453781516,0.19315039072180284,0.21518590161640364,132459.27047902497,2447.282454648531,134906.5529336735,2044,11,851.4857142857143,34,1,21,33.47138699356231,0.649203431372549,42.648809523809526,1029.4047619047622,30.276610644257712,0
2498,4,0,0,35,0.0,0.0,1.0,35,950,700,250,0.7368421052631579,12,7,5,355.69572228005933,0.36558123249299723,0.1896569380440356,0.2149833893780736,132520.55165816325,2427.398667800457,134947.9503259637,2045,12,852.4857142857143,34,1,21,33.43329672023741,0.6498161764705883,42.589285714285715,1029.642857142857,30.28361344537815,0
2499,4,0,0,35,0.0,0.0,1.0,35,900,700,200,0.7777777777777778,11,7,4,354.73286778709615,0.3660714285714286,0.18721717588769637,0.2145761752698168,132551.19756235817,2404.0532879818475,134955.25085034,2046,13,853.4857142857143,34,1,21,33.42726396917147,0.6501225490196079,42.5595238095238,1029.761904761904,30.28711484593835,0
2500,4,0,0,35,0.0,0.0,1.0,35,700,600,100,0.8571428571428571,8,6,2,353.1060965808822,0.36603641456582636,0.18685866208695945,0.21376632900778256,132581.84700963716,2363.0916950113397,134944.9387046485,2047,14,854.4857142857143,34,1,21,33.4383308288059,0.6504289215686274,42.529761904761905,1029.8809523809523,30.290616246498598,0
2501,4,0,0,35,0.0,0.0,1.0,35,1350,1200,150,0.8888888888888888,15,12,3,353.7339163119192,0.36610644257703084,0.18740136683284403,0.21467134023585885,132673.81660997728,2386.2457482993195,135060.0623582766,2048,15,855.4857142857143,34,1,19,33.32972228641861,0.6513480392156863,42.44047619047619,1030.238095238095,30.30112044817926,0
2502,4,0,0,35,0.0,0.0,1.0,35,800,700,100,0.875,9,7,2,352.8018540987058,0.36621148459383757,0.18621486330381165,0.21457293093544239,132755.5941358025,2367.2839506172777,135122.87808641978,2049,16,856.4857142857143,35,0,19,33.271563342318025,0.65,42.36111111111111,1030.5555555555557,29.444444444444446,0
2503,4,0,1,34,0.0,0.02857142857142857,0.9714285714285714,35,600,400,200,0.6666666666666666,8,4,4,351.8380385218594,0.36687675070028014,0.18571107760418348,0.2143276040407442,132815.23946544924,2345.8906678669414,135161.13013331618,2050,17,857.4857142857143,35,0,19,33.236488509618994,0.6505952380952381,42.30324074074074,1030.787037037037,29.4510582010582,0
2504,4,0,0,34,0.0,0.0,1.0,34,900,800,100,0.8888888888888888,10,8,2,359.6224180522185,0.360256981580511,0.19079922239290958,0.21824490924431245,132673.81660997716,2742.4957482993045,135416.31235827645,2051,70,883.2058823529412,34,0,19,33.178058316000296,0.6513480392156863,42.44047619047618,1030.238095238094,30.301120448179237,0
2505,4,0,0,34,0.0,0.0,1.0,34,1000,700,300,0.7,13,7,6,359.91991619167385,0.36016414141414144,0.19303700683046188,0.21860399120273244,132704.4802295918,2752.5970804988647,135457.07731009068,2052,71,884.2058823529412,34,0,19,33.1395628730984,0.6516544117647058,42.410714285714285,1030.3571428571427,30.30462184873949,0
2506,4,1,1,34,0.02857142857142857,0.02857142857142857,0.9714285714285714,35,500,200,300,0.4,8,2,6,351.3907986786023,0.3660014005602241,0.1837600397582444,0.2149103230628019,132964.41139671206,2344.4941433041736,135308.90554001625,2053,0,859.9142857142857,35,0,19,33.098254030598895,0.6520833333333333,42.15856481481481,1031.3657407407402,29.467592592592577,0
2507,4,0,0,34,0.0,0.0,1.0,34,1000,900,100,0.9,11,9,2,357.41803683122595,0.35997846108140225,0.18724142850349557,0.21779611406907703,132827.17013888882,2694.9652777777733,135522.1354166666,2054,73,886.2058823529412,34,0,19,33.080706009161965,0.6528799019607843,42.291666666666664,1030.8333333333328,30.318627450980376,0
2508,4,0,0,34,0.0,0.0,1.0,34,800,500,300,0.625,11,5,6,354.21929322261025,0.35992275698158055,0.18111562334469689,0.2163785273550246,132919.2247732426,2616.510770975049,135535.73554421766,2055,74,887.2058823529412,34,0,19,33.07069191102901,0.6537990196078431,42.20238095238095,1031.190476190476,30.329131652661058,0
2509,4,0,0,34,0.0,0.0,1.0,34,800,500,300,0.625,11,5,6,355.1806036648491,0.36016414141414144,0.1835477410814299,0.21750105517709645,133011.31129535136,2648.607568027203,135659.91886337855,2056,75,888.2058823529412,34,0,19,32.95345258703598,0.654718137254902,42.113095238095234,1031.5476190476181,30.339635854341708,0
2510,4,0,0,34,0.0,0.0,1.0,34,1050,900,150,0.8571428571428571,12,9,3,356.20764326382056,0.3600527332144979,0.1839804803887637,0.21848914679175738,133072.7200255101,2680.3039965986304,135753.02402210873,2057,76,889.2058823529412,34,0,19,32.865322487596636,0.6553308823529412,42.05357142857142,1031.7857142857135,30.34663865546216,0
2511,4,0,0,34,0.0,0.0,1.0,34,750,500,250,0.6666666666666666,10,5,5,355.3929883236287,0.3601827094474153,0.18664766944840205,0.21852888005431617,133164.85969387746,2665.1714852607593,135830.03117913823,2058,77,890.2058823529412,34,0,19,32.79387735486351,0.65625,41.96428571428571,1032.1428571428564,30.357142857142836,0
2512,4,0,1,33,0.0,0.029411764705882353,0.9705882352941176,34,950,800,150,0.8421052631578947,11,8,3,354.6086037378106,0.35936571598336303,0.18537481859241334,0.21876778298874583,133287.76218820846,2652.9974489795773,135940.75963718805,2059,78,891.2058823529412,34,0,19,32.690848128506644,0.6574754901960785,41.84523809523809,1032.6190476190463,30.371148459383715,0
2513,4,0,0,33,0.0,0.0,1.0,33,650,300,350,0.46153846153846156,10,3,7,358.56108621190657,0.3583096590909091,0.17512094236129871,0.22098589256293422,133250.70473195397,2955.703485438283,136206.40821739225,2060,79,889.0909090909091,33,0,19,32.62598911968348,0.6594065656565657,41.88112745098039,1032.4754901960778,31.287136066547813,0
2514,4,0,0,33,0.0,0.0,1.0,33,850,500,350,0.5882352941176471,12,5,7,357.3842380819482,0.3581123737373737,0.172837642051072,0.22101186667591624,133377.26362757102,2933.386347798909,136310.64997536995,2061,80,890.0909090909091,33,0,20,32.529437062522234,0.660669191919192,41.75857843137254,1032.965686274509,31.301990493166937,0
2515,4,0,0,33,0.0,0.0,1.0,33,1000,700,300,0.7,13,7,6,356.4122447669805,0.3580729166666667,0.1659532101947001,0.22078704155991266,133440.56560277296,2911.9703058919627,136352.53590866493,2062,81,891.0909090909091,33,0,20,32.491079547700934,0.661300505050505,41.697303921568626,1033.2107843137253,31.309417706476523,0
2516,4,0,0,33,0.0,0.0,1.0,33,500,400,100,0.8,6,4,2,355.07665566357855,0.3575205176767677,0.1622485976808281,0.22033564659388943,133503.88259623697,2880.822430074966,136384.70502631195,2063,82,892.0909090909091,33,0,21,32.462127949721335,0.6619318181818181,41.6360294117647,1033.4558823529408,31.316844919786085,0
2517,4,0,0,33,0.0,0.0,1.0,33,1000,900,100,0.9,11,9,2,353.59033703693933,0.3577572601010101,0.15631004845180496,0.22016543716462408,133630.56163795167,2850.095065599761,136480.65670355145,2064,83,893.0909090909091,33,0,22,32.373646833392584,0.6631944444444444,41.51348039215686,1033.946078431372,31.33169934640521,0
2518,4,1,1,33,0.029411764705882353,0.029411764705882353,0.9705882352941176,34,900,700,200,0.7777777777777778,11,7,4,345.6505714012471,0.3631535947712418,0.1505763298879812,0.21718044573014758,133964.73922902494,2460.9977324263036,136425.73696145124,2065,0,867.7941176470588,34,0,18,32.24471021159154,0.6642156862745099,41.19047619047619,1035.2380952380952,30.448179271708682,0
2519,4,0,0,33,0.0,0.0,1.0,33,1000,800,200,0.8,12,8,4,353.8951388125277,0.3569681186868687,0.16687835016037744,0.2220652557511597,133915.8091238947,2878.4307718185405,136794.23989571322,2066,85,895.0909090909091,33,0,18,32.08027468624202,0.6660353535353535,41.23774509803922,1035.0490196078435,31.36512180629829,0
2520,4,0,0,33,0.0,0.0,1.0,33,900,700,200,0.7777777777777778,11,7,4,355.16403469017035,0.35546875,0.16942165055260983,0.2242122169705759,134137.87853529895,2928.1900290753565,137066.06856437432,2067,86,896.0909090909091,33,0,18,31.82536279033085,0.6682449494949495,41.02328431372549,1035.9068627450981,31.39111705288176,0
2521,4,0,0,33,0.0,0.0,1.0,33,1050,700,350,0.6666666666666666,14,7,7,356.2300080777817,0.3551530934343434,0.17257027335096864,0.22507985712179127,134169.6177551903,2959.0488033448673,137128.66655853516,2068,87,897.0909090909091,33,0,18,31.766027915779507,0.6685606060606061,40.99264705882353,1036.0294117647059,31.39483065953654,0
2522,4,0,0,33,0.0,0.0,1.0,33,900,600,300,0.6666666666666666,12,6,6,354.67698894942066,0.35574494949494945,0.13065289424483062,0.2200933399962858,133504.8420601215,2894.2482979413307,136399.09035806282,2069,88,898.0909090909091,32,1,23,32.47149256770515,0.6643880208333333,41.63510101010102,1033.4595959595968,32.2956123737374,4
2523,4,0,0,33,0.0,0.0,1.0,33,600,400,200,0.6666666666666666,8,4,4,353.6765707868032,0.356021148989899,0.12329943302097646,0.22005347732540634,133602.7254871953,2850.430759616382,136453.15624681168,2070,89,899.0909090909091,32,1,23,32.39929368181079,0.6653645833333333,41.54040404040405,1033.8383838383847,32.30744949494952,0
2524,4,0,0,33,0.0,0.0,1.0,33,600,300,300,0.5,9,3,6,354.51400103498804,0.35574494949494945,0.12174498680787615,0.22076921326810034,133635.36126734532,2875.1213205285394,136510.48258787385,2071,90,900.0909090909091,32,1,23,32.34496479016568,0.6656901041666665,41.508838383838395,1033.9646464646476,32.311395202020236,0
2525,4,0,0,33,0.0,0.0,1.0,33,450,100,350,0.2222222222222222,8,1,7,354.6914623837698,0.3558238636363636,0.11994671994671946,0.22107481559536357,133668.00103305798,2882.1797520661285,136550.1807851241,2072,91,901.0909090909091,32,1,23,32.3076923076923,0.666015625,41.477272727272734,1034.0909090909101,32.31534090909094,0
2526,4,0,0,33,0.0,0.0,1.0,33,900,700,200,0.7777777777777778,11,7,4,367.6648304981922,0.3558238636363636,0.1286684579788031,0.21571086876050005,131392.84256708494,3061.705438220586,134454.54800530552,2073,92,902.0909090909091,32,1,21,34.26313628899836,0.6432291666666667,43.686868686868685,1025.252525252525,32.039141414141405,4
2527,4,0,0,33,0.0,0.0,1.0,33,950,600,350,0.631578947368421,13,6,7,366.6699407359115,0.3556265782828283,0.13356761011568374,0.2156741439969449,131489.94880943268,3042.6823474645425,134532.63115689723,2074,93,903.0909090909091,32,1,21,34.190467397102886,0.6442057291666667,43.592171717171716,1025.631313131313,32.05097853535353,0
2528,4,0,0,33,0.0,0.0,1.0,33,750,600,150,0.8,9,6,3,368.545326934404,0.35610006313131315,0.13483506323073247,0.21769886753799653,131651.87225793264,3103.936460565217,134755.80871849786,2075,94,904.0909090909091,32,1,18,33.978736056430435,0.6458333333333335,43.43434343434342,1026.2626262626245,32.070707070707016,0
2529,4,0,0,33,0.0,0.0,1.0,33,1100,600,500,0.5454545454545454,16,6,10,372.0307619797208,0.3549558080808081,0.14455424883363954,0.2205068627127612,131781.4827568612,3205.3530889704743,134986.83584583167,2076,95,905.0909090909091,32,1,19,33.75835177898016,0.6471354166666669,43.30808080808079,1026.767676767674,32.08648989898981,0
2530,4,0,0,33,0.0,0.0,1.0,33,900,600,300,0.6666666666666666,12,6,6,372.1344561094532,0.35467960858585856,0.1449537797748799,0.22075634803341926,131813.89534550026,3210.4984504132044,135024.39379591346,2077,96,906.0909090909091,32,1,19,33.72294971105375,0.6474609375000002,43.27651515151514,1026.8939393939377,32.09043560606055,0
2531,4,0,0,33,0.0,0.0,1.0,33,850,500,350,0.5882352941176471,12,5,7,372.7125590623127,0.35365372474747475,0.1478725306158939,0.221665890389691,131911.1570247932,3232.988980716236,135144.14600550945,2078,97,907.0909090909091,32,1,19,33.60988200589971,0.6484375000000002,43.18181818181817,1027.272727272726,32.102272727272684,0
2532,4,0,0,33,0.0,0.0,1.0,33,700,500,200,0.7142857142857143,9,5,4,371.5533827176331,0.3547190656565657,0.1495604776106072,0.2215438082006456,132008.45457415044,3209.6375688705084,135218.09214302094,2079,98,908.0909090909091,32,1,20,33.54143629438507,0.6494140625,43.087121212121204,1027.6515151515139,32.11410984848481,0
2533,4,0,0,33,0.0,0.0,1.0,33,550,300,250,0.5454545454545454,8,3,5,375.56013412408436,0.35538983585858586,0.14918930183574663,0.22470140868276392,132138.2404378379,3325.1710603509764,135463.41149818889,2080,99,909.0909090909091,32,1,20,33.30749314339514,0.6507161458333335,42.96085858585858,1028.1565656565651,32.12989267676766,0
2534,4,0,0,33,0.0,0.0,1.0,33,800,300,500,0.375,13,3,10,378.1768539568707,0.35503472222222227,0.15302583794725222,0.22646119842829074,132170.69686766653,3396.7796653402684,135567.4765330068,2081,100,910.0909090909091,32,1,20,33.20747380484609,0.6510416666666667,42.92929292929293,1028.2828282828282,32.13383838383838,0
2535,4,1,0,34,0.029411764705882353,0.0,1.0,34,1000,900,100,0.9,11,9,2,369.9530144269103,0.35932857991681516,0.15296567169401976,0.22418565870642967,132618.81134960108,3012.5458056997286,135631.3571553008,2082,0,884.2941176470588,33,1,21,32.96735574063057,0.6530934343434345,42.493872549019606,1030.0245098039213,31.212863933452162,0
2536,4,0,0,34,0.0,0.0,1.0,34,1050,800,250,0.7619047619047619,13,8,5,370.2064172759082,0.35984848484848486,0.15331262722713057,0.2250951383133125,132745.06987997398,3028.6153462610455,135773.68522623501,2083,1,885.2941176470588,33,1,14,32.83374459904071,0.6543560606060608,42.37132352941176,1030.5147058823525,31.227718360071286,0
2537,4,1,1,34,0.02857142857142857,0.02857142857142857,0.9714285714285714,35,750,500,250,0.6666666666666666,10,5,5,365.1845795332898,0.364390756302521,0.14946272002109562,0.22417988211009582,133103.4297052152,2721.464002267549,135824.89370748276,2084,0,860.9714285714285,34,1,14,32.60291685894476,0.6556372549019609,42.02380952380951,1031.9047619047603,30.35014005602236,0
2538,4,0,0,34,0.0,0.0,1.0,34,1050,800,250,0.7619047619047619,13,8,5,372.9695742432936,0.3610554070112894,0.15189439995527843,0.22850494002765942,133029.37121539767,3123.1815888119627,136152.55280420964,2085,3,887.2941176470588,33,1,16,32.47653837015918,0.6571969696969698,42.0955882352941,1031.6176470588214,31.261140819964282,0
2539,4,0,1,33,0.0,0.029411764705882353,0.9705882352941176,34,1150,1000,150,0.8695652173913043,13,10,3,375.55764797155456,0.36118538324420674,0.15458901765194888,0.23067621834926758,133124.20590938564,3199.162731881947,136323.3686412676,2086,4,888.2941176470588,33,1,17,32.314427225586826,0.6581439393939394,42.003676470588225,1031.9852941176457,31.272281639928657,0
2540,4,0,0,33,0.0,0.0,1.0,33,850,600,250,0.7058823529411765,11,6,5,375.36255486172394,0.3597301136363636,0.13533895886837088,0.23129914175616542,133243.9949526833,3402.9612730843655,136646.95622576767,2087,5,862.5757575757576,32,1,17,32.19905425787778,0.6617838541666667,41.887626262626256,1032.4494949494942,32.264046717171695,0
2541,4,1,0,34,0.029411764705882353,0.0,1.0,34,1000,700,300,0.7,13,7,6,367.5565991072952,0.364861853832442,0.13151803331265,0.22886162558437245,133630.56163795164,3023.3589544886477,136653.9205924403,2088,0,838.1764705882352,33,1,20,32.01263778594287,0.6631944444444444,41.51348039215686,1033.9460784313717,31.331699346405202,0
2542,4,0,0,34,0.0,0.0,1.0,34,1050,700,350,0.6666666666666666,14,7,7,364.92904518076165,0.3649732620320856,0.12473779939650331,0.22800637086386452,133757.3007527153,2962.384809928872,136719.68556264415,2089,1,839.1764705882352,33,1,15,31.953535323618862,0.6644570707070707,41.39093137254902,1034.4362745098038,31.346553773024358,0
2543,4,0,1,33,0.0,0.029411764705882353,0.9705882352941176,34,550,400,150,0.7272727272727273,7,4,3,365.66633394706867,0.36456476530005943,0.1295225421685906,0.22885995978614546,133820.6928374905,2986.744431228385,136807.43726871887,2090,2,840.1764705882352,33,1,16,31.87095325516207,0.6650883838383839,41.329656862745104,1034.6813725490204,31.35398098633395,0
2544,4,0,0,33,0.0,0.0,1.0,33,600,300,300,0.5,9,3,6,374.49851735565994,0.35838857323232326,0.13528693528693503,0.2334203087627745,133668.00103305798,3411.693640955018,137079.694674013,2091,9,866.5757575757576,32,1,19,31.795634920634917,0.666015625,41.477272727272734,1034.0909090909101,32.31534090909094,0
2545,4,0,0,33,0.0,0.0,1.0,33,800,500,300,0.625,11,5,6,373.0082252655777,0.35815183080808083,0.1313316245575491,0.23310880164766437,133765.94424357222,3379.1594926538264,137145.10373622604,2092,10,867.5757575757576,32,1,16,31.73593311363359,0.6669921875,41.382575757575765,1034.469696969698,32.32717803030306,0
2546,4,0,0,33,0.0,0.0,1.0,33,800,500,300,0.625,11,5,6,370.99229764425024,0.3590198863636364,0.12747610331502957,0.2322598838192998,133831.2596450619,3330.0733024691626,137161.33294753105,2093,11,868.5757575757576,32,1,16,31.722595078299783,0.6676432291666665,41.31944444444446,1034.7222222222235,32.335069444444485,0
2547,4,0,0,33,0.0,0.0,1.0,33,650,500,150,0.7692307692307693,8,5,3,370.78044712737045,0.3591777146464647,0.12811127379209375,0.23233306916329757,133863.92332415085,3326.825068870555,137190.7483930214,2094,12,869.5757575757576,32,1,17,31.69533918984871,0.6679687499999998,41.2878787878788,1034.8484848484868,32.33901515151521,0
2548,4,0,0,33,0.0,0.0,1.0,33,450,300,150,0.6666666666666666,6,3,3,371.29888635152815,0.359375,0.13328454094494546,0.23307107735909918,133929.26263901676,3345.55721354968,137274.81985256643,2095,13,870.5757575757576,32,1,18,31.61645116695129,0.6686197916666665,41.224747474747495,1035.101010101013,32.34690656565665,0
2549,4,1,0,34,0.029411764705882353,0.0,1.0,34,450,300,150,0.6666666666666666,6,3,3,365.6789000568166,0.364657605466429,0.1517024205096833,0.23265976332938237,134423.66667868145,3031.1797145328915,137454.84639321433,2096,0,845.9411764705883,33,1,19,31.26723390845348,0.6710858585858585,40.74754901960785,1037.00980392157,31.42453951277485,0
2550,4,0,0,34,0.0,0.0,1.0,34,900,600,300,0.6666666666666666,12,6,6,366.2499289127676,0.36527035056446816,0.15227631149306253,0.23404061495127584,134582.5692792437,3058.171286284135,137640.74056552784,2097,1,846.9411764705883,33,1,20,31.09363312468013,0.6726641414141414,40.594362745098046,1037.622549019609,31.44310754604876,0
2551,4,0,0,34,0.0,0.0,1.0,34,1050,700,350,0.6666666666666666,14,7,7,367.11873734915474,0.3643419489007724,0.15396984156751659,0.23500594003098949,134646.15660142724,3086.2254000865023,137732.38200151373,2098,2,847.9411764705883,33,1,20,31.00757173219979,0.6732954545454546,40.533088235294116,1037.867647058823,31.450534759358273,0
2552,4,0,0,34,0.0,0.0,1.0,34,600,400,200,0.6666666666666666,8,4,4,368.592053933172,0.36449049316696375,0.15684307012853504,0.23636209605358843,134709.7589418734,3130.5893466455304,137840.34828851893,2099,3,848.9411764705883,33,1,20,30.905811002242945,0.6739267676767677,40.4718137254902,1038.11274509804,31.457961972667878,0
2553,4,0,0,34,0.0,0.0,1.0,34,550,400,150,0.7272727272727273,7,4,3,366.1604249704028,0.36372920380273327,0.1540498885733923,0.2352143503240504,134773.37630058156,3069.735348183398,137843.11164876496,2100,4,849.9411764705883,33,1,20,30.905400487824053,0.6745580808080808,40.41053921568628,1038.3578431372555,31.46538918597744,0
2554,4,0,0,34,0.0,0.0,1.0,34,850,400,450,0.47058823529411764,13,4,9,366.9783307374585,0.3625408496732026,0.1536579949899033,0.23656846461303696,134900.65607278454,3101.1235161956965,138001.77958898022,2101,5,850.9411764705883,33,1,18,30.75712221304706,0.6758207070707071,40.28799019607843,1038.8480392156866,31.480243612596563,0
2555,4,0,0,34,0.0,0.0,1.0,34,750,500,250,0.6666666666666666,10,5,5,369.0959861160557,0.3628193701723113,0.16008601553829083,0.2385620398067187,134996.15532487494,3165.3078143021753,138161.46313917713,2102,6,851.9411764705883,33,1,18,30.606819968553452,0.6767676767676768,40.19607843137254,1039.215686274509,31.491384432560878,0
2556,4,0,0,34,0.0,0.0,1.0,34,750,500,250,0.6666666666666666,10,5,5,368.51383629255514,0.36246657754010697,0.1204321189404951,0.23385285380335505,134328.3701731305,3100.3726030853454,137428.74277621586,2103,7,852.9411764705883,33,1,17,31.28903633211175,0.670138888888889,40.83946078431372,1036.6421568627447,31.413398692810446,4
2557,4,0,0,34,0.0,0.0,1.0,34,500,200,300,0.4,8,2,6,372.4593900988868,0.3620395127748069,0.12121317446855828,0.23697378639223918,134423.66667868133,3213.471381199544,137637.13805988088,2104,8,853.9411764705883,33,1,17,31.091448042228002,0.6710858585858586,40.747549019607845,1037.009803921569,31.42453951277482,0
2558,4,0,0,34,0.0,0.0,1.0,34,700,600,100,0.8571428571428571,8,6,2,395.9300529094208,0.3618909685086156,0.1106246477957431,0.23668593911809865,132105.78799357207,3666.3519186438143,135772.13991221588,2105,9,854.9411764705883,32,2,18,32.816721935642356,0.650390625,42.99242424242424,1028.030303030303,32.12594696969697,6
2559,4,0,0,34,0.0,0.0,1.0,34,900,600,300,0.6666666666666666,12,6,6,397.48925348336877,0.3613339275103981,0.10993486518103457,0.23843501169922846,132235.6216840119,3712.447709417414,135948.0693934293,2106,10,855.9411764705883,32,2,18,32.645367869711116,0.6516927083333333,42.86616161616162,1028.5353535353538,32.14172979797981,0
2560,4,0,0,34,0.0,0.0,1.0,34,650,300,350,0.46153846153846156,10,3,7,397.48925348336877,0.3613339275103981,0.10993486518103457,0.23843501169922846,132235.6216840119,3712.447709417414,135948.0693934293,2107,11,856.9411764705883,32,2,18,32.645367869711116,0.6516927083333333,42.86616161616162,1028.5353535353538,32.14172979797981,0
2561,4,0,0,34,0.0,0.0,1.0,34,900,700,200,0.7777777777777778,11,7,4,397.05796230703965,0.3605540701128936,0.11364030148141735,0.23858615611192927,132300.56244260794,3706.198347107441,136006.7607897154,2108,12,857.9411764705883,32,2,18,32.590819833087856,0.65234375,42.803030303030305,1028.7878787878792,32.149621212121225,0
2562,4,0,0,34,0.0,0.0,1.0,34,800,600,200,0.75,10,6,4,393.70747846876685,0.3605540701128936,0.15212868059167817,0.21431032844920211,128464.3328008623,3388.110588205298,131852.4433890676,2109,13,858.9411764705883,32,2,17,36.581195250550074,0.6136067708333333,46.55934343434344,1013.7626262626275,31.68008207070711,8
2563,4,2,0,36,0.05555555555555555,0.0,1.0,36,600,500,100,0.8333333333333334,7,5,2,375.5741130135064,0.37334656084656087,0.1547336219999742,0.19575309820877745,126713.00482521021,2318.02487890091,129031.02970411112,2110,0,812.1666666666666,35,1,17,38.83935414032264,0.5889880952380953,48.29282407407408,1006.8287037037051,28.76653439153443,3
2564,4,0,0,36,0.0,0.0,1.0,36,700,600,100,0.8571428571428571,8,6,2,373.90685823961917,0.3736276455026455,0.15436070261437873,0.19558204892533948,126858.71056241446,2286.66838134433,129145.37894375878,2111,1,813.1666666666666,35,1,18,38.73123468137255,0.5904761904761904,48.14814814814816,1007.407407407409,28.783068783068828,0
2565,4,3,3,36,0.07692307692307693,0.07692307692307693,0.9230769230769231,39,700,600,100,0.8571428571428571,8,6,2,349.5479567007617,0.3924876293297346,0.13291697629046983,0.18604190208458224,127562.34039560256,1118.045422155062,128680.38581775762,2112,0,751.5384615384615,37,2,15,38.622847244835164,0.59375,47.45065789473684,1010.1973684210532,27.302631578947384,0
2566,4,4,2,38,0.1,0.05,0.95,40,400,100,300,0.25,7,1,6,341.6444182994705,0.39580662393162397,0.13800285080772912,0.18374300316378683,127982.32299884943,744.8892587113718,128727.2122575608,2113,0,733.65,38,2,17,38.39285714285713,0.5962171052631579,47.03525641025641,1011.8589743589743,26.627867746288796,0
2567,4,1,2,37,0.02564102564102564,0.05128205128205128,0.9487179487179487,39,1400,1200,200,0.8571428571428571,16,12,4,349.7854008709477,0.39074448942869994,0.15345714825558798,0.18810137990892212,127978.05574792235,1152.9711064942949,129131.02685441665,2114,0,753.4358974358975,37,2,17,38.19128377402109,0.597972972972973,47.03947368421052,1011.8421052631571,27.347083926031274,0
2568,4,3,2,38,0.075,0.05,0.95,40,750,400,350,0.5333333333333333,11,4,7,343.64329970080144,0.3902510683760683,0.151366489879857,0.1862123428701295,128283.34349270942,816.850497268402,129100.19398997782,2115,0,735.425,37,3,19,38.03475754951834,0.6010698198198197,46.73793859649123,1013.0482456140361,27.379682313892868,0
2569,4,2,1,39,0.05,0.025,0.975,40,950,700,250,0.7368421052631579,12,7,5,346.545259950471,0.39177350427350427,0.16858641574735023,0.18870185356313632,128477.80687326864,904.6749961526588,129382.4818694213,2116,0,736.375,37,3,17,37.762726223952704,0.6030405405405406,46.546052631578945,1013.8157894736838,27.400426742531995,0
2570,4,1,0,40,0.025,0.0,1.0,40,1050,700,350,0.6666666666666666,14,7,7,346.0927439323928,0.3910389957264957,0.18349652558433327,0.18957259987715497,128713.06911571334,909.3318540433887,129622.40096975672,2117,0,737.35,38,2,18,37.53421773004841,0.6036184210526316,46.31410256410256,1014.7435897435897,26.70377867746289,0
2571,4,0,1,39,0.0,0.025,0.975,40,1300,1000,300,0.7692307692307693,16,10,6,346.71936833267796,0.3915998931623932,0.1842004208311414,0.19082614916051555,128902.86138733652,938.6237352984107,129841.48512263494,2118,1,738.35,38,2,19,37.324872873926,0.6055372807017544,46.12713675213675,1015.4914529914528,26.72345928924876,0
2572,4,1,1,39,0.025,0.025,0.975,40,450,200,250,0.4444444444444444,7,2,5,349.01769499422045,0.3943376068376068,0.18230437526293652,0.19248609303973588,128984.24373584629,1003.5566878515565,129987.80042369784,2119,0,739.2,38,2,19,37.18359977562755,0.606359649122807,46.047008547008545,1015.8119658119657,26.731893837156992,0
2573,4,1,0,40,0.025,0.0,1.0,40,750,500,250,0.6666666666666666,10,5,5,352.2899408723506,0.3937633547008547,0.19043839360807424,0.19482453009173223,129092.79348381895,1095.6185166922146,130188.41200051116,2120,0,740.175,38,2,21,36.98989872441827,0.6074561403508772,45.94017094017093,1016.2393162393148,26.7431399010346,0
2574,4,1,0,41,0.024390243902439025,0.0,1.0,41,1050,900,150,0.8571428571428571,12,9,3,347.5400461170748,0.39756097560975606,0.1984373396977277,0.19356823530343129,129373.18019032558,792.6091732224984,130165.78936354809,2121,0,723.0975609756098,36,5,22,36.82523430005167,0.6140046296296295,45.66441441441442,1017.3423423423433,28.259509509509535,0
2575,4,1,1,41,0.023809523809523808,0.023809523809523808,0.9761904761904762,42,900,600,300,0.6666666666666666,12,6,6,345.35416046282876,0.4002734223770809,0.19015326259675058,0.19397461612452693,129703.52055440121,558.7300900276852,130262.2506444289,2122,0,706.8571428571429,37,5,15,36.54512020093289,0.615427927927928,45.339912280701746,1018.6403508771918,27.53082029397816,0
2576,4,1,2,40,0.023809523809523808,0.047619047619047616,0.9523809523809523,42,1100,900,200,0.8181818181818182,13,9,4,348.33858432140005,0.3997168989547038,0.1985919677110386,0.19663046863606876,129899.05698147492,649.7707227223588,130548.82770419728,2123,0,707.8333333333334,37,5,16,36.270548743322216,0.6173986486486487,45.148026315789465,1019.407894736841,27.55156472261732,0
2577,4,0,0,40,0.0,0.0,1.0,40,1100,600,500,0.5454545454545454,16,6,10,364.24804299856885,0.39228098290598296,0.21660862354892196,0.20450797944891733,129688.42734203806,1447.7511717798957,131136.17851381795,2124,3,744.15,36,4,17,36.07932559425097,0.6171875,45.35472972972973,1018.5810810810817,28.293918918918937,0
2578,4,1,0,41,0.024390243902439025,0.0,1.0,41,950,400,550,0.42105263157894735,15,4,11,355.17348861653863,0.3954776422764228,0.2143141905015027,0.2008161004357965,129962.83512309153,1031.8707082328879,130994.70583132442,2125,0,726.9756097560976,38,3,18,36.031581796591226,0.6162280701754386,45.085470085470085,1019.6581196581196,26.83310841205578,0
2579,4,1,2,40,0.023809523809523808,0.047619047619047616,0.9523809523809523,42,900,600,300,0.6666666666666666,12,6,6,339.1653926731217,0.40011614401858303,0.19782625693955747,0.18608263435849642,128778.12499999999,335.4166666666663,129113.54166666666,2126,0,710.6428571428571,39,3,17,37.643678160919535,0.6025641025641025,46.25,1014.9999999999999,26.025641025641022,3
2580,4,1,0,41,0.024390243902439025,0.0,1.0,41,1050,800,250,0.7619047619047619,13,8,5,350.4573961218837,0.39994918699186993,0.20942233632862606,0.19222547708763832,128767.28121119148,825.4892157937056,129592.77042698518,2127,0,728.6585365853658,38,3,19,37.36820175438597,0.6041666666666666,46.26068376068376,1014.9572649572651,26.709401709401714,0
2581,4,3,1,43,0.06818181818181818,0.022727272727272728,0.9772727272727273,44,850,600,250,0.7058823529411765,11,6,5,330.64465849835074,0.4094102360817477,0.22098052346671127,0.18509283460268505,129572.31445312501,-230.0602402590589,129342.25421286596,2128,0,679.9090909090909,39,5,16,37.05281017665916,0.6105769230769231,45.46875,1018.1250000000001,26.105769230769234,0
2582,4,0,0,43,0.0,0.0,1.0,43,900,900,0,1.0,9,9,0,341.1270136857668,0.4068844592100406,0.23093257571319747,0.19074285131443572,129527.44904667977,237.06237672583495,129764.51142340561,2129,1,696.7209302325581,38,5,17,36.83157535684301,0.6118421052631579,45.51282051282051,1017.9487179487176,26.788124156545198,0
2583,4,1,1,43,0.022727272727272728,0.022727272727272728,0.9772727272727273,44,1150,800,350,0.6956521739130435,15,8,7,338.17254644533165,0.4085403453136011,0.23643286591768664,0.1904629834124745,129811.04736328138,-20.2935112847062,129790.75385199668,2130,0,681.8636363636364,39,5,18,36.618900984701355,0.6129807692307692,45.23437500000001,1019.062500000001,26.12980769230772,0
2584,4,1,1,43,0.022727272727272728,0.022727272727272728,0.9772727272727273,44,1000,700,300,0.7,13,7,6,341.7615883340439,0.4092010218463707,0.2538988888166869,0.19379682886828578,130076.563856337,91.0346137152971,130167.5984700523,2131,0,682.8409090909091,39,5,19,36.25814782667892,0.6156517094017093,44.97395833333334,1020.1041666666682,26.156517094017133,0
2585,4,0,0,43,0.0,0.0,1.0,43,1350,1000,350,0.7407407407407407,17,10,7,349.7448779781719,0.40473883351790324,0.24959989866535426,0.19816108902419072,130044.55133912292,496.48314796555013,130541.03448708847,2132,1,699.6279069767442,38,5,19,36.087034321427346,0.6170504385964911,45.005341880341895,1019.9786324786346,26.84154295996407,0
2586,4,1,0,44,0.022727272727272728,0.0,1.0,44,700,300,400,0.42857142857142855,11,3,8,342.86418642735293,0.40790169133192394,0.24788388305250963,0.1952257672468753,130237.26974875611,130.73910698540078,130368.00885574151,2133,0,684.7045454545455,41,3,20,36.06713885379208,0.6140752032520325,44.81646825396826,1020.734126984128,24.895954316686048,0
2587,4,2,2,44,0.043478260869565216,0.043478260869565216,0.9565217391304348,46,1000,600,400,0.6,14,6,8,333.1402946554424,0.41153381642512077,0.24055220701003588,0.19215828869828772,130738.73842191834,-489.1168689986747,130249.62155291966,2134,0,655.8913043478261,37,9,18,35.80811532825843,0.6258445945945945,44.32565789473684,1022.6973684210532,27.64046941678522,0
2588,4,1,2,43,0.022222222222222223,0.044444444444444446,0.9555555555555556,45,750,400,350,0.5333333333333333,11,4,7,340.4975001225612,0.41012205387205386,0.2530773090526368,0.1960289666209723,130665.25298524875,-101.76160112815637,130563.4913841206,2135,0,671.4444444444445,36,9,18,35.694322061901076,0.627025462962963,44.39752252252252,1022.4099099099099,28.400275275275273,0
2589,4,0,0,43,0.0,0.0,1.0,43,1600,1200,400,0.75,20,12,8,358.2669251254494,0.4037698412698412,0.26623653693018934,0.20129284821395083,129716.28578514741,694.6109693877625,130410.89675453518,2136,5,703.6279069767442,34,9,20,36.203303338397404,0.6216299019607843,45.327380952380956,1018.6904761904764,29.96148459383754,1
2590,4,0,0,43,0.0,0.0,1.0,43,1650,1300,350,0.7878787878787878,20,13,7,358.1768374877097,0.40358527131782945,0.26917436972507947,0.20233683616390138,129928.59977324255,707.4829931972665,130636.08276643981,2137,6,704.6279069767442,34,9,20,35.989802273081104,0.6237745098039216,45.11904761904761,1019.5238095238088,29.985994397759082,0
2591,4,1,1,43,0.022727272727272728,0.022727272727272728,0.9772727272727273,44,1250,1000,250,0.8,15,10,5,347.76999914792606,0.4060958421423538,0.26485270934437954,0.1986003043677765,130351.21588059393,266.4484471450386,130617.66432773897,2138,0,689.5909090909091,35,9,20,35.826462087725275,0.6258928571428573,44.7048611111111,1021.1805555555538,29.17658730158725,0
2592,4,2,2,43,0.044444444444444446,0.044444444444444446,0.9555555555555556,45,1300,1000,300,0.7692307692307693,16,10,6,339.86034584598843,0.41062710437710437,0.25935066842955745,0.1952261075252021,130578.91506371238,-124.28095325054838,130454.63411046183,2139,0,675.2222222222222,36,9,19,35.79793778463346,0.6261574074074074,44.48198198198198,1022.0720720720723,28.390890890890898,0
2593,4,1,1,43,0.022727272727272728,0.022727272727272728,0.9772727272727273,44,1050,900,150,0.8571428571428571,12,9,3,346.66735147541516,0.4087715821000704,0.25979139840329646,0.19827215662803208,130410.31867551847,241.79995606135563,130652.11863157983,2140,0,691.5454545454545,35,9,20,35.79473559962227,0.6264880952380953,44.646990740740726,1021.4120370370352,29.183201058201007,0
2594,4,0,0,43,0.0,0.0,1.0,43,1850,1400,450,0.7567567567567568,23,14,9,353.3344059001105,0.40471576227390177,0.25626113097130543,0.19161842374221183,128315.61872260775,470.8829513674402,128786.50167397519,2141,10,708.6279069767442,36,7,19,37.75633544514838,0.6032986111111112,46.70608108108108,1013.1756756756757,28.14376876876877,5
2595,4,3,1,45,0.06521739130434782,0.021739130434782608,0.9782608695652174,46,1200,700,500,0.5833333333333334,17,7,10,330.6852953266142,0.41505636070853463,0.24273187535883922,0.1824244046404434,128994.8319452707,-668.6611805142388,128326.17076475645,2142,0,663.3478260869565,40,6,19,37.63838868880887,0.603125,46.03658536585366,1015.8536585365855,25.396341463414636,0
2596,4,2,0,47,0.0425531914893617,0.0,1.0,47,800,400,400,0.5,12,4,8,358.15647040120234,0.41637758248535306,0.32601712041485564,0.185047509707288,126355.003652301,-179.9762082914208,126175.02744400958,2143,0,650.1914893617021,36,11,17,39.64633736559141,0.5833333333333334,48.64864864864865,1005.4054054054059,27.92792792792794,7
2597,4,3,3,47,0.06,0.06,0.94,50,1450,1100,350,0.7586206896551724,18,11,7,326.29673911408196,0.42649659863945577,0.2734412041392287,0.16985966389729135,126662.68957328958,-1734.0754849632824,124928.6140883263,2144,0,612.12,43,7,15,40.13131075572278,0.5750968992248063,48.342803030303024,1006.6287878787869,23.40997181113458,6
2598,4,2,2,47,0.04081632653061224,0.04081632653061224,0.9591836734693877,49,1400,1200,200,0.8571428571428571,16,12,4,329.1923403813082,0.42306193310657597,0.29066124333534904,0.17214706089557727,126847.86446127019,-1448.5309251247086,125399.33353614548,2145,0,625.530612244898,42,7,16,39.86849910221879,0.578373015873016,48.15891472868216,1007.36434108527,23.984865263935,0
2599,4,3,2,48,0.06,0.04,0.96,50,1500,1100,400,0.7333333333333333,19,11,8,323.7355813294479,0.4265136054421769,0.2878297627053519,0.17062094511687173,127165.30449079051,-1766.178508653356,125399.12598213716,2146,0,613.92,42,8,17,39.68080507253338,0.5815972222222223,47.843992248062,1008.6240310077494,24.01485788113689,0
2600,4,2,1,49,0.04,0.02,0.98,50,1450,1000,450,0.6896551724137931,19,10,9,331.80833756172535,0.4275340136054422,0.3070549851261881,0.17614746233982356,127458.67816124317,-1541.6295783005933,125917.04858294257,2147,0,614.88,42,8,15,39.176902408598046,0.5845734126984128,47.553294573643406,1009.7868217054252,24.042543373938695,0
2601,4,1,1,49,0.02,0.02,0.98,50,1450,1000,450,0.6896551724137931,19,10,9,336.1817900826247,0.4274744897959184,0.31330520663534367,0.17933707870954954,127654.44839740709,-1416.9798051499224,126237.46859225717,2148,0,615.86,42,8,16,38.86618243999104,0.5865575396825395,47.35949612403101,1010.5620155038766,24.06100036913992,0
2602,4,3,3,49,0.057692307692307696,0.057692307692307696,0.9423076923076923,52,1200,600,600,0.5,18,6,12,328.88340383166167,0.4328572775263952,0.3283813521640506,0.177708464950226,128169.64408738026,-1966.609398999546,126203.03468838072,2149,0,593.0769230769231,41,11,18,38.524521570164275,0.5932418699186992,46.85019841269841,1012.5992063492058,24.697541618273313,0
2603,4,0,0,49,0.0,0.0,1.0,49,1400,1000,400,0.7142857142857143,18,10,8,350.4473657168866,0.42796910430839,0.3390765501602946,0.18820321492203143,127923.87777176834,-833.8828045189764,127089.99496724937,2150,1,594.5510204081633,42,7,18,38.229964878671765,0.5892857142857143,47.09302325581395,1011.6279069767427,24.08637873754149,0
2604,4,3,0,52,0.057692307692307696,0.0,1.0,52,1650,1100,550,0.6666666666666666,22,11,11,323.00483167948744,0.43525326797385616,0.34008885699277225,0.16901264393415313,126872.26884088964,-2182.3635899285246,124689.9052509611,2151,0,561.1923076923077,42,10,19,39.99931871373151,0.5786210317460319,48.134689922480604,1007.4612403100748,23.987172388335114,6
2605,4,2,3,51,0.037037037037037035,0.05555555555555555,0.9444444444444444,54,1850,1600,250,0.8648648648648649,21,16,5,329.022744359125,0.4401860587002096,0.36084566860283607,0.16460934421262205,125024.80281753886,-2523.8919042361995,122500.91091330266,2152,0,541.3703703703703,41,13,16,41.74881377508846,0.561229674796748,49.975198412698404,1000.0992063492048,24.3926635694928,8
2606,4,3,1,53,0.05555555555555555,0.018518518518518517,0.9814814814814815,54,1300,1000,300,0.7692307692307693,16,10,6,330.11054067388756,0.4387738760773352,0.39206231834940586,0.16681298176323164,125440.20168895746,-2518.1734396433526,122922.02824931411,2153,0,542.2037037037037,44,10,15,41.2929029177065,0.5613162878787878,49.56018518518518,1001.7592592592591,22.76725589225589,0
2607,4,4,3,54,0.07017543859649122,0.05263157894736842,0.9473684210526316,57,1550,700,850,0.45161290322580644,24,7,17,318.76394832210593,0.44400062656641603,0.3935593130639563,0.16382984320740823,126138.94628099198,-3352.494678830936,122786.45160216105,2154,0,514.5964912280701,43,14,19,40.858314479638004,0.569767441860465,48.863636363636374,1004.5454545454566,23.36152219873155,0
2608,4,2,3,53,0.03571428571428571,0.05357142857142857,0.9464285714285714,56,2000,1500,500,0.75,25,15,10,326.61465221302683,0.44166666666666665,0.4151605043636264,0.16897342276504457,126408.98702752241,-2942.594533080943,123466.39249444146,2155,0,524.4464285714286,42,14,15,40.3837043104002,0.5739087301587301,48.59496124031008,1005.6201550387599,23.94333702473238,0
2609,4,0,0,53,0.0,0.0,1.0,53,1350,1000,350,0.7407407407407407,17,10,7,340.31452478439303,0.43712203676826317,0.41713025064175446,0.17430897378513005,125998.3623450957,-2024.1854389833934,123974.1769061123,2156,1,555.0754716981132,45,8,18,40.461851918681596,0.5657407407407407,49.003623188405804,1003.9855072463779,22.31078904991951,0
2610,4,3,0,56,0.05357142857142857,0.0,1.0,56,1750,1100,650,0.6285714285714286,24,11,13,322.58266978088307,0.4427353896103896,0.41352268397472103,0.16806139762949432,126695.52576303168,-3026.0109912781463,123669.51477175353,2157,0,526.2857142857143,44,12,18,40.19110794322329,0.5741003787878787,48.31018518518519,1006.7592592592603,22.880892255892277,0
2611,4,4,5,55,0.06666666666666667,0.08333333333333333,0.9166666666666666,60,650,300,350,0.46153846153846156,10,3,7,308.5142263503176,0.44775776836158193,0.41471361330154655,0.1638099392685766,127465.74502743472,-4132.523148148164,123333.22187928656,2158,0,492.1333333333333,44,16,15,39.757740387554236,0.5819128787878789,47.54629629629629,1009.8148148148139,22.950336700336678,0
2612,4,1,0,56,0.017857142857142856,0.0,1.0,56,1250,900,350,0.72,16,9,7,332.3014534134553,0.43954274891774897,0.43211530640357854,0.1747190017488711,127068.67391117991,-2754.978995198885,124313.69491598103,2159,0,528.0714285714286,44,12,20,39.56381822634463,0.5778882575757576,47.939814814814824,1008.2407407407425,22.91456228956233,0
2613,4,2,1,57,0.034482758620689655,0.017241379310344827,0.9827586206896551,58,1150,800,350,0.6956521739130435,15,8,7,323.35115536978304,0.44350549505948783,0.4261752180662213,0.17178719199309445,127489.12144204415,-3355.2447702331733,124133.87667181098,2160,0,510.82758620689657,44,14,16,39.35927997310597,0.5821496212121211,47.52314814814816,1009.9074074074094,22.952441077441122,0
2614,4,2,1,58,0.03389830508474576,0.01694915254237288,0.9830508474576272,59,1400,900,500,0.6428571428571429,19,9,10,297.88379650015173,0.44450126631599457,0.3768667013262639,0.1554000077753252,126749.74011663755,-4156.829537340125,122592.91057929743,2161,0,503.135593220339,45,14,18,40.75730487841443,0.5733796296296296,48.256340579710134,1006.9746376811574,22.377214170692387,8
2615,4,2,3,57,0.03333333333333333,0.05,0.95,60,2150,1600,550,0.7441860465116279,27,16,11,291.9562817429531,0.44636887947269305,0.3796755217622583,0.1540470663401525,127211.39955126545,-4570.58201793265,122640.8175333328,2162,0,495.65,43,17,19,40.43510826371289,0.5806686046511628,47.79829545454545,1008.8068181818178,23.460623678646925,0
2616,4,1,0,58,0.017241379310344827,0.0,1.0,58,1350,800,550,0.5925925925925926,19,8,11,297.0428562214853,0.4440915507158701,0.38155907639726094,0.1568362180009178,127238.61621897697,-4040.9356033291506,123197.68061564781,2163,0,512.8965517241379,42,16,20,40.279045012165454,0.58234126984127,47.77131782945735,1008.9147286821685,24.021779254337346,0
2617,4,8,9,57,0.12121212121212122,0.13636363636363635,0.8636363636363636,66,1350,900,450,0.6666666666666666,18,9,9,258.362604784972,0.4549436674436675,0.3635405073659941,0.14107363224934463,128587.88281249999,-6552.326387949945,122035.55642455004,2164,0,451.6060606060606,49,17,11,39.88639320242108,0.5873724489795918,46.4375,1014.2499999999999,20.698979591836732,0
2618,4,0,0,57,0.0,0.0,1.0,57,1000,800,200,0.8,12,8,4,302.23722855108576,0.4427866541353383,0.3749999999999998,0.16018573113207538,127392.29024943302,-3699.4614512471767,123692.82879818584,2165,1,523.7719298245614,41,16,17,39.99115566037733,0.5853658536585367,47.61904761904761,1009.5238095238088,24.622531939605093,0
2619,4,2,2,57,0.03389830508474576,0.03389830508474576,0.9661016949152542,59,1250,800,450,0.64,17,8,9,295.7427920259839,0.4463520358464836,0.37918378127305385,0.15861018327387771,127869.54306474476,-4236.700863789122,123632.84220095564,2166,0,506.9830508474576,45,14,19,39.668786196190815,0.5847222222222221,47.14673913043478,1011.4130434782605,22.47584541062801,0
2620,4,1,2,56,0.017241379310344827,0.034482758620689655,0.9655172413793104,58,1300,700,600,0.5384615384615384,19,7,12,301.8274183882689,0.4457299858842509,0.3802756643715235,0.16159709695291338,127800.84216977781,-3885.2403480098756,123915.60182176794,2167,0,516.551724137931,45,13,19,39.58491967511722,0.5840277777777778,47.21467391304348,1011.1413043478254,22.46980676328501,0
2621,4,0,1,55,0.0,0.017857142857142856,0.9821428571428571,56,1550,900,650,0.5806451612903226,22,9,13,287.48106633656084,0.44331033549783555,0.28149540877871115,0.15042855076204312,126873.28574098155,-3866.517834270699,123006.76790671085,2168,2,534.9821428571429,47,9,14,40.89300074674018,0.5722517730496455,48.13368055555554,1007.4652777777752,21.435431442080322,8
2622,4,2,1,56,0.03508771929824561,0.017543859649122806,0.9824561403508771,57,900,600,300,0.6666666666666666,12,6,6,283.23440074695213,0.44428780284043445,0.2894058282132901,0.1491701177267282,127136.71344499776,-4197.725070670048,122938.98837432772,2169,0,526.5263157894736,46,11,16,40.731217768401315,0.5760869565217392,47.87234042553192,1008.5106382978726,21.924144310823316,0
2623,4,2,1,57,0.034482758620689655,0.017241379310344827,0.9827586206896551,58,1250,1100,150,0.88,14,11,3,283.90615235888146,0.44746294615849974,0.3017663853139205,0.15057512348774044,127420.4593234591,-4364.909532335075,123055.54979112402,2170,0,518.4137931034483,47,11,12,40.42510317255611,0.5777925531914894,47.59114583333333,1009.6354166666658,21.48160460992906,0
2624,4,1,3,55,0.017241379310344827,0.05172413793103448,0.9482758620689655,58,1100,700,400,0.6363636363636364,15,7,8,287.0018067807422,0.4470281306715063,0.3148595805190191,0.15296250141610965,127617.7300347221,-4274.696180555563,123343.03385416654,2171,0,519.3965517241379,47,11,13,40.146048109965655,0.5797872340425532,47.39583333333333,1010.4166666666656,21.49822695035459,0
2625,4,2,1,56,0.03508771929824561,0.017543859649122806,0.9824561403508771,57,1200,700,500,0.5833333333333334,17,7,10,291.6691824658856,0.4448099415204678,0.33371891266628073,0.1561287976729154,127793.20987654336,-3945.3317901234427,123847.87808641992,2172,0,528.2982456140351,47,10,15,39.84947344322344,0.5815602836879432,47.22222222222223,1011.1111111111123,21.51300236406622,0
2626,4,3,2,57,0.05084745762711865,0.03389830508474576,0.9661016949152542,59,1400,1000,400,0.7142857142857143,18,10,8,289.81736374156344,0.44911601402688484,0.3663440420472275,0.15758291060583568,128419.8148038754,-4354.412551926515,124065.40225194888,2173,0,511.1525423728813,45,14,13,39.2593833780161,0.5902777777777777,46.603260869565226,1013.5869565217405,22.52415458937201,0
2627,4,4,3,58,0.06557377049180328,0.04918032786885246,0.9508196721311475,61,1850,1400,450,0.7567567567567568,23,14,9,292.8875175069125,0.45006830601092895,0.39211731827479857,0.16179902666158566,129050.14349489793,-4640.5647675737,124409.57872732423,2174,0,494.9836065573771,48,13,16,38.542276899043124,0.5930989583333334,45.982142857142854,1016.0714285714283,21.168154761904756,0
2628,4,2,1,59,0.03333333333333333,0.016666666666666666,0.9833333333333333,60,1450,1100,350,0.7586206896551724,18,11,7,297.0282227036554,0.44919962335216573,0.3959785828206883,0.16398199615677267,129024.94454089503,-4335.190007716056,124689.75453317897,2175,0,504.1666666666667,47,13,17,38.4626338573707,0.5939716312056738,46.00694444444444,1015.972222222222,21.616430260047274,0
2629,4,2,2,59,0.03278688524590164,0.03278688524590164,0.9672131147540983,61,1700,1100,600,0.6470588235294118,23,11,12,292.56509581861644,0.44978369763205833,0.39914845463326376,0.16233740865003693,129224.92391117993,-4638.177297668013,124586.74661351192,2176,0,496.8688524590164,44,17,18,38.373478432443925,0.5996685606060606,45.8101851851852,1016.7592592592611,23.108164983165025,0
2630,4,0,0,59,0.0,0.0,1.0,59,1900,1200,700,0.631578947368421,26,12,14,302.57324841850306,0.44812974868497957,0.39824445699718125,0.16721767470457494,129066.22922010974,-3989.6023527488496,125076.6268673609,2177,1,514.6101694915254,46,13,19,38.27993223986507,0.5955615942028984,45.96631205673759,1016.1347517730504,22.089885908109792,0
2631,4,2,2,59,0.03278688524590164,0.03278688524590164,0.9672131147540983,61,1950,1600,350,0.8205128205128205,23,16,7,295.62166322872474,0.45083105646630234,0.3951963470047257,0.16521448621623688,129507.51135973974,-4542.671884790079,124964.83947494967,2178,0,498.7049180327869,44,17,12,38.00979411140423,0.6025094696969696,45.532407407407426,1017.8703703703734,23.133417508417576,0
2632,4,1,1,59,0.016666666666666666,0.016666666666666666,0.9833333333333333,60,1500,1100,400,0.7333333333333333,19,11,8,296.553985938345,0.44892302259887007,0.3929705426356589,0.16586656341504727,129538.57197687095,-4316.964029499545,125221.6079473714,2179,0,508.0,43,17,13,37.95465116279068,0.6041666666666667,45.50189393939394,1017.992424242424,23.67424242424242,0
2633,4,0,0,59,0.0,0.0,1.0,59,1800,1300,500,0.7222222222222222,23,13,10,302.87831278344703,0.4484828560296123,0.39666565778853924,0.16961185515873023,129586.77685950407,-3950.1951331496784,125636.58172635439,2180,1,516.9830508474577,43,16,13,37.744915674603185,0.6046511627906976,45.45454545454545,1018.1818181818177,23.678646934460875,0
2634,4,1,2,58,0.016666666666666666,0.03333333333333333,0.9666666666666667,60,2050,1200,850,0.5853658536585366,29,12,17,302.4003444973236,0.449688088512241,0.4013623978201639,0.1707398868161809,129908.37191358003,-4143.132716049403,125765.23919753064,2181,0,509.35,44,16,16,37.43188010899182,0.606534090909091,45.13888888888888,1019.4444444444428,23.16919191919188,0
2635,4,4,4,58,0.06451612903225806,0.06451612903225806,0.935483870967742,62,1450,900,550,0.6206896551724138,20,9,11,296.94304156252434,0.45053873611845585,0.4114657652810598,0.16991056195631574,130428.05212620019,-4653.094993141296,125774.9571330589,2182,0,493.7741935483871,44,18,18,37.04658417935704,0.6117424242424243,44.629629629629626,1021.4814814814807,23.215488215488197,0
2636,4,2,2,58,0.03333333333333333,0.03333333333333333,0.9666666666666667,60,1850,1600,250,0.8648648648648649,21,16,5,307.1650715314488,0.44822269303201506,0.41667573038460426,0.17586674801279037,130451.69860253755,-3985.95893347052,126465.73966906703,2183,0,510.75,44,16,19,36.761684643040574,0.6119791666666667,44.606481481481474,1021.5740740740727,23.21759259259256,0
2637,4,0,0,58,0.0,0.0,1.0,58,1250,700,550,0.56,18,7,11,319.3230652979455,0.44547791893526917,0.4215707414661616,0.18183411344414158,130239.96293571747,-3282.2751622151804,126957.68777350229,2184,1,528.9655172413793,46,12,19,36.66514677783568,0.6073369565217391,44.81382978723404,1020.7446808510635,22.190101757631815,0
2638,4,1,0,59,0.01694915254237288,0.0,1.0,59,1050,600,450,0.5714285714285714,15,6,9,314.99068649896344,0.44608416130917594,0.4198218210324074,0.18047979376724993,130480.18470392846,-3579.983549856993,126900.20115407147,2185,0,520.9830508474577,43,16,20,36.53306222386999,0.6136143410852714,44.578598484848484,1021.6856060606059,23.760130373502463,0
2639,4,0,1,58,0.0,0.01694915254237288,0.9830508474576272,59,1800,1200,600,0.6666666666666666,24,12,12,315.2777101401953,0.44605980907851156,0.41404291063816423,0.18132247634328244,130625.35085406639,-3563.3476992940596,127062.00315477233,2186,1,521.9830508474577,43,16,14,36.3792071946889,0.6150678294573644,44.43655303030304,1022.2537878787891,23.773343904157887,0
2640,4,0,0,58,0.0,0.0,1.0,58,1700,1400,300,0.8235294117647058,20,14,6,320.491852244647,0.4449737850373059,0.4144176252476839,0.1838904827949973,130534.7532074396,-3232.935032449954,127301.81817498965,2187,4,531.9655172413793,42,16,14,36.33743441431192,0.6155753968253967,44.52519379844962,1021.8992248062026,24.330933923957204,0
2641,4,0,1,57,0.0,0.017241379310344827,0.9827586206896551,58,1400,1000,400,0.7142857142857143,18,10,8,323.1220634333108,0.4443310143174027,0.41229165100951826,0.1862319571497396,130708.09789262977,-3153.065940298054,127555.03195233172,2188,5,532.9655172413793,42,16,15,36.09518620297545,0.6173115079365079,44.355620155038764,1022.5775193798459,24.347083794758234,0
2642,4,0,1,56,0.0,0.017543859649122806,0.9824561403508771,57,1800,1500,300,0.8333333333333334,21,15,6,326.04424544520765,0.44259085213032584,0.4115159012010696,0.18779579028044946,130683.32732407919,-2878.2906300702944,127805.0366940089,2189,6,543.2105263157895,42,15,15,36.045496904220386,0.6170634920634921,44.379844961240316,1022.4806201550396,24.344776670358083,0
2643,4,0,0,56,0.0,0.0,1.0,56,2100,1700,400,0.8095238095238095,25,17,8,338.19738722236417,0.4399959415584416,0.4228430774773777,0.19510223082682437,130744.07837498421,-2356.538859756869,128387.53951522734,2190,7,553.2321428571429,41,15,16,35.67342047401946,0.6191565040650406,44.320436507936506,1022.7182539682536,24.944347657762282,0
2644,4,0,0,56,0.0,0.0,1.0,56,1500,800,700,0.5333333333333333,22,8,14,336.3017605027548,0.43973214285714285,0.4207420183982684,0.19470101923843713,130881.55759870213,-2396.8603524427435,128484.69724625938,2191,8,554.2321428571429,42,14,16,35.58297821969696,0.619047619047619,44.186046511627914,1023.2558139534895,24.36323366555927,0
2645,4,0,1,55,0.0,0.017857142857142856,0.9821428571428571,56,1050,600,450,0.5714285714285714,15,6,9,335.9646492388153,0.4393939393939394,0.42439202531987985,0.19475623629310473,130931.13864100724,-2402.3531864070583,128528.78545460019,2192,9,555.2321428571429,42,14,16,35.54152464810958,0.6195436507936507,44.13759689922481,1023.4496124031015,24.367847914359558,0
2646,4,0,1,54,0.0,0.01818181818181818,0.9818181818181818,55,2150,1500,650,0.6976744186046512,28,15,13,336.94435632141955,0.4372474747474748,0.41823517767851737,0.19544993057787785,130955.93268320721,-2175.0275111171127,128780.9051720901,2193,10,565.9454545454546,42,13,16,35.49141657988575,0.6197916666666666,44.11337209302326,1023.5465116279075,24.3701550387597,0
2647,4,0,0,54,0.0,0.0,1.0,54,1850,1300,550,0.7027027027027027,24,13,11,312.992594561649,0.43798771255532265,0.3076555205166822,0.17562611726407526,129665.1289198128,-2683.1549750434533,126981.97394476936,2194,11,572.4814814814815,47,7,16,37.40811173612885,0.6003989361702129,45.37760416666664,1018.4895833333288,21.669991134751676,6
2648,4,0,0,54,0.0,0.0,1.0,54,1500,900,600,0.6,21,9,12,313.3781622838973,0.4382934428138831,0.3074452646854702,0.17653836973190717,129819.89354263079,-2663.4560667438627,127156.43747588692,2195,12,573.4814814814815,47,7,16,37.24162407722884,0.6019503546099292,45.22569444444443,1019.0972222222191,21.682919621749342,0
2649,4,2,3,53,0.03571428571428571,0.05357142857142857,0.9464285714285714,56,1450,900,550,0.6206896551724138,20,9,11,306.2040972715593,0.4413352272727273,0.3139255089540922,0.17398928868168162,130156.27170138863,-3229.1232638889123,126927.14843749971,2196,0,553.9642857142857,49,7,16,37.084439226895306,0.6031037414965987,44.89583333333332,1020.4166666666646,20.824829931972747,0
2650,4,1,2,52,0.018518518518518517,0.037037037037037035,0.962962962962963,54,2000,1400,600,0.7,26,14,12,310.3917897951376,0.43692493594223153,0.3196289038875586,0.17665792943358924,130220.0555555553,-2716.1527777778047,127503.90277777749,2197,0,573.9814814814815,49,5,17,36.91316949706074,0.6037414965986396,44.83333333333332,1020.6666666666646,20.829931972789073,0
2651,4,0,0,52,0.0,0.0,1.0,52,750,600,150,0.8,9,6,3,314.33175486913797,0.43505687531422826,0.30004318580364964,0.1786887867621652,130173.9878713345,-2216.4363908179294,127957.55148051656,2198,1,561.4423076923077,47,5,18,36.859192469093784,0.6054964539007095,44.87847222222221,1020.486111111108,21.71247044917251,0
2652,4,0,1,51,0.0,0.019230769230769232,0.9807692307692307,52,1500,700,800,0.4666666666666667,23,7,16,321.8566455367684,0.4341691804927099,0.2965889233622194,0.18395463286242955,130383.45210808367,-2006.923330926059,128376.52877715761,2199,2,562.4423076923077,43,9,18,36.455435790449705,0.6126453488372092,44.67329545454545,1021.306818181818,23.751321353065535,0
2653,4,2,2,51,0.03773584905660377,0.03773584905660377,0.9622641509433962,53,1350,700,650,0.5185185185185185,20,7,13,314.2641732064165,0.4350507982583454,0.2935775523505526,0.1812074829162639,130725.33097694829,-2383.5423886788294,128341.78858826945,2200,0,551.4150943396227,45,8,15,36.304251550044285,0.6134259259259258,44.33876811594204,1022.6449275362332,22.725442834138516,0
2654,4,0,0,51,0.0,0.0,1.0,51,1450,1100,350,0.7586206896551724,18,11,7,328.46723350520176,0.4326143790849673,0.28753324902978217,0.18855416936107133,130552.75769054193,-1623.5393709825366,128929.21831955938,2201,4,574.0392156862745,43,8,16,36.11548678033112,0.6143410852713178,44.507575757575765,1021.969696969698,23.766737138830187,0
2655,4,0,0,51,0.0,0.0,1.0,51,1350,800,550,0.5925925925925926,19,8,11,328.36527354071944,0.4323856209150327,0.28622074987831336,0.18896756360051226,130649.55305899924,-1619.8447543617845,129029.70830463746,2202,5,575.0392156862745,43,8,16,36.02028529084846,0.6153100775193798,44.412878787878796,1022.3484848484862,23.775546159267122,0
2656,4,1,2,50,0.019230769230769232,0.038461538461538464,0.9615384615384616,52,1450,1100,350,0.7586206896551724,18,11,7,323.9295989114713,0.43365855957767724,0.2927097020158351,0.1877927418214837,130933.83353188688,-1917.331164014894,129016.50236787199,2203,0,564.9615384615385,45,7,17,35.84673791190963,0.615509259259259,44.13496376811595,1023.4601449275377,22.743558776167504,0
2657,4,0,0,50,0.0,0.0,1.0,50,1450,1000,450,0.6896551724137931,19,10,9,331.47566552430203,0.43220238095238095,0.2920195439739408,0.19200571569049238,130901.38888888917,-1321.8749999999773,129579.5138888892,2204,7,562.14,44,6,17,35.68641422366993,0.6164772727272726,44.16666666666668,1023.3333333333355,23.257575757575808,0
2658,4,0,0,50,0.0,0.0,1.0,50,1950,1500,450,0.7692307692307693,24,15,9,335.12704019701926,0.4317091836734694,0.29558650628561045,0.1947188483162609,131019.8570387518,-1218.3406207132948,129801.5164180385,2205,8,563.14,44,6,18,35.473380362364736,0.6176609848484849,44.05092592592593,1023.796296296297,23.268097643097658,0
2659,4,0,0,50,0.0,0.0,1.0,50,1250,900,350,0.72,16,9,7,337.926898988806,0.4309608843537415,0.29842733188720194,0.19719531700486018,131185.8024691357,-1133.7577160493886,130052.04475308632,2206,9,564.14,44,6,18,35.23420553145337,0.6193181818181819,43.888888888888886,1024.4444444444437,23.282828282828266,0
2660,4,0,1,49,0.0,0.02,0.98,50,1500,1400,100,0.9333333333333333,16,14,2,336.7183824908406,0.4306462585034014,0.29450358041416713,0.19748284702953156,131378.97317491804,-1152.2254503653362,130226.7477245527,2207,10,565.14,41,9,18,35.07031804399716,0.6255081300813008,43.70039682539682,1025.198412698412,25.00483933410761,0
2661,4,0,0,49,0.0,0.0,1.0,49,1500,1000,500,0.6666666666666666,20,10,10,335.7545315121857,0.4306795634920635,0.27864240404491136,0.19731066470957728,131455.26389085726,-972.6598915028978,130482.60399935435,2208,11,533.8979591836735,41,8,18,35.01811857082971,0.626270325203252,43.62599206349206,1025.4960317460316,25.012098335269062,0
2662,4,2,0,51,0.0392156862745098,0.0,1.0,51,1100,800,300,0.7272727272727273,14,8,6,332.18850848374564,0.4329084967320262,0.29030882533625335,0.19807196121239637,132008.45457415082,-1429.6616735536916,130578.79290059712,2209,0,513.9215686274509,43,8,18,34.55277061064013,0.628875968992248,43.087121212121225,1027.651515151517,23.898872445384118,0
2663,4,0,0,51,0.0,0.0,1.0,51,1350,900,450,0.6666666666666666,18,9,9,332.18850848374564,0.432859477124183,0.29030882533625335,0.19807196121239637,132008.45457415082,-1429.6616735536916,130578.79290059712,2210,1,514.9215686274509,43,8,18,34.55277061064013,0.628875968992248,43.087121212121225,1027.651515151517,23.898872445384118,0
2664,4,0,1,50,0.0,0.0196078431372549,0.9803921568627451,51,1050,700,350,0.6666666666666666,14,7,7,334.1967873062291,0.43256535947712416,0.29347278294090495,0.19965361178916458,132081.45127589835,-1371.7606641700977,130709.69061172825,2211,2,515.9215686274509,43,8,18,34.42777905727007,0.6296027131782944,43.01609848484849,1027.9356060606074,23.9054792107118,0
2665,4,0,1,49,0.0,0.02,0.98,50,1200,700,500,0.5833333333333334,17,7,10,336.62976883259677,0.4316836734693878,0.2942243166823748,0.20133268586887568,132123.9004942613,-1104.6323838711494,131019.26811039014,2212,3,526.28,42,8,18,34.32257304429783,0.6314484126984127,42.97480620155039,1028.1007751937996,24.478589885566656,0
2666,4,1,0,50,0.02,0.0,1.0,50,1500,1200,300,0.8,18,12,6,340.99821764251305,0.4326105442176871,0.3037038499506417,0.20585887632411545,132476.45767235116,-964.5847485109215,131511.87292384024,2213,0,504.46,40,10,20,33.855914774596904,0.6380208333333334,42.63211382113821,1029.4715447154474,25.736788617886184,0
2667,4,0,0,50,0.0,0.0,1.0,50,1000,600,400,0.6,14,6,8,340.04281496855924,0.4323044217687075,0.300254261774054,0.2061100144669321,132627.82782383767,-980.1720167233763,131647.6558071143,2214,1,505.46,41,9,13,33.72851054608493,0.6379573170731708,42.48511904761904,1030.0595238095223,25.123403019744444,0
2668,4,0,0,50,0.0,0.0,1.0,50,950,500,450,0.5263157894736842,14,5,9,366.04243581245225,0.4320663265306122,0.3143408933346532,0.21600996343648954,131614.7395420222,-331.00258851679126,131283.7369535054,2215,2,506.46,40,10,12,34.08046119309366,0.6294270833333332,43.470528455284565,1026.117886178864,25.652947154471597,5
2669,4,0,0,50,0.0,0.0,1.0,50,650,400,250,0.6153846153846154,9,4,5,367.3480057089232,0.43207482993197277,0.3185246063966727,0.2170770924315052,131666.88484243868,-326.4864870447177,131340.39835539396,2216,3,507.46,40,10,13,33.99428986368288,0.6299479166666665,43.41971544715449,1026.3211382113846,25.658028455284615,0
2670,4,1,0,51,0.0196078431372549,0.0,1.0,51,1600,1400,200,0.875,18,14,4,376.5268966949714,0.43517973856209147,0.2856567154248997,0.2180727085574748,130896.31287989714,-307.513250686505,130588.79962921064,2217,0,498.4901960784314,41,10,16,34.53900064630793,0.6206808943089432,44.17162698412697,1023.3134920634907,24.958865660085138,6
2671,4,0,2,49,0.0,0.0392156862745098,0.9607843137254902,51,1550,1300,250,0.8387096774193549,18,13,5,379.29818989515513,0.435016339869281,0.28165882538533693,0.2203015599913309,131005.52780970176,-261.9680871041569,130743.5597225976,2218,1,499.4901960784314,42,9,16,34.35735131724247,0.6202876984126985,44.06492248062015,1023.7403100775178,24.37476928755995,0
2672,4,0,2,47,0.0,0.04081632653061224,0.9591836734693877,49,850,600,250,0.7058823529411765,11,6,5,388.877280404329,0.43392148526077096,0.2824866087901483,0.22470945491101998,130807.80805902544,373.6369307290338,131181.44498975447,2219,2,518.3061224489796,40,9,16,34.312909795350684,0.6213541666666668,44.2581300813008,1022.9674796747946,25.574186991869865,0
2673,4,0,0,47,0.0,0.0,1.0,47,1250,800,450,0.64,17,8,9,400.8431520916662,0.42929000925069377,0.2928166477689593,0.23081040707083283,130671.89554569346,1075.7869000657327,131747.6824457592,2220,3,540.1702127659574,38,9,16,34.145114942528735,0.6233552631578948,44.391025641025635,1022.4358974358962,26.906207827260427,0
2674,4,0,1,46,0.0,0.02127659574468085,0.9787234042553191,47,1400,1100,300,0.7857142857142857,17,11,6,394.0987277727311,0.42954054887449894,0.28708567170838784,0.22812208620574745,130874.74093967001,915.5137803819351,131790.25472005195,2221,4,541.1702127659574,39,8,16,34.11137551325122,0.62366452991453,44.19270833333333,1023.2291666666656,26.236645299145273,0
2675,4,1,1,46,0.02127659574468085,0.02127659574468085,0.9787234042553191,47,1500,1000,500,0.6666666666666666,20,10,10,390.5146389951662,0.42911655874190563,0.29709313651219693,0.2271454971196735,131061.33355034716,836.2738715277724,131897.60742187494,2222,0,541.3191489361702,39,8,16,34.01364869447269,0.625534188034188,44.010416666666664,1023.9583333333328,26.255341880341867,0
2676,4,1,0,47,0.02127659574468085,0.0,1.0,47,1150,700,450,0.6086956521739131,16,7,9,392.08120950981174,0.42826857847671906,0.3028908135983319,0.22900895348803513,131221.37586805565,889.8871527777877,132111.26302083343,2223,0,542.2978723404256,39,8,17,33.81116985224346,0.6271367521367521,43.85416666666667,1024.5833333333342,26.271367521367544,0
2677,4,0,0,47,0.0,0.0,1.0,47,1000,400,600,0.4,16,4,12,392.76267374679435,0.4282878507554733,0.3041304109311569,0.2297342692611759,131276.04683059017,912.0662304183945,132188.11306100857,2224,1,543.2978723404256,40,7,17,33.738265238661896,0.6260416666666667,43.80081300813008,1024.7967479674792,25.61991869918698,0
2678,4,1,1,47,0.020833333333333332,0.020833333333333332,0.9791666666666666,48,1550,1300,250,0.8387096774193549,18,13,5,388.2796073361202,0.42976137706855794,0.30874496889864655,0.22879865606934363,131559.0823086599,616.3934032972545,132175.47571195717,2225,0,532.9583333333334,36,12,15,33.56636480058543,0.6359953703703705,43.52477477477477,1025.9009009009,28.497247247247223,0
2679,4,0,0,47,0.0,0.0,1.0,47,1000,600,400,0.6,14,6,8,395.6223363685632,0.43027289546716,0.3101202464945114,0.23298343968336008,131535.81700370772,1007.7014478309015,132543.51845153864,2226,1,515.3829787234042,35,12,18,33.40161815036293,0.6377976190476191,43.54745370370369,1025.810185185183,29.30886243386237,0
2680,4,1,1,47,0.020833333333333332,0.020833333333333332,0.9791666666666666,48,1350,800,550,0.5925925925925926,19,8,11,382.25914615948665,0.43122044917257685,0.3045990817851809,0.22688461108553512,131834.36850761742,478.97862803936243,132313.34713565678,2227,0,505.625,37,11,15,33.44232685600397,0.6368243243243243,43.2565789473684,1026.9736842105237,27.756045519203344,0
2681,4,0,0,47,0.0,0.0,1.0,47,1100,700,400,0.6363636363636364,15,7,8,391.0831578817506,0.4297332716620413,0.31005707216302336,0.2313253072090951,131703.5336645767,901.406769945615,132604.94043452232,2228,3,517.3829787234042,36,11,15,33.34818979703785,0.6374421296296298,43.384009009009006,1026.4639639639636,28.512887887887878,0
2682,4,0,1,46,0.0,0.02127659574468085,0.9787234042553191,47,1550,1000,550,0.6451612903225806,21,10,11,388.84358666147455,0.42981036077705825,0.3112480179553936,0.23079271436447163,131834.36850761742,852.589739150473,132686.9582467679,2229,4,518.3829787234042,37,10,15,33.273275677984195,0.6368243243243243,43.2565789473684,1026.9736842105237,27.756045519203344,0
2683,4,0,0,46,0.0,0.0,1.0,46,950,500,450,0.5263157894736842,14,5,9,396.3008723945107,0.4280495169082126,0.31354782980225404,0.23452394231083448,131721.7857898581,1240.291724376701,132962.0775142348,2230,5,530.5217391304348,37,9,15,33.19580930000713,0.6356981981981983,43.366228070175424,1026.535087719296,27.74419155998097,0
2684,4,0,0,46,0.0,0.0,1.0,46,1150,600,550,0.5217391304347826,17,6,11,394.44036108816425,0.4282105475040258,0.31017370878942385,0.2341146021515677,131834.36850761742,1200.159183594917,133034.52769121234,2231,6,531.5217391304348,37,9,15,33.12958217666737,0.6368243243243243,43.2565789473684,1026.9736842105237,27.756045519203344,0
2685,4,0,1,45,0.0,0.021739130434782608,0.9782608695652174,46,1250,1000,250,0.8,15,10,5,356.0285149998878,0.4283816425120773,0.27844055321832384,0.2057280730188791,130807.80805902586,115.46422374231221,130923.27228276817,2232,7,532.5217391304348,40,6,17,35.1529902642559,0.6213541666666667,44.25813008130082,1022.9674796747979,25.574186991869947,4
2686,4,0,0,45,0.0,0.0,1.0,45,1000,600,400,0.6,14,6,8,358.8965536587444,0.4255260942760943,0.28161426857699023,0.20702975110584923,130741.54188368062,384.5377604166777,131126.0796440973,2233,8,545.0222222222222,39,6,17,35.14675426088139,0.6223290598290598,44.32291666666667,1022.7083333333339,26.223290598290614,0
2687,4,1,2,44,0.021739130434782608,0.043478260869565216,0.9565217391304348,46,1600,1200,400,0.75,20,12,8,351.0821198332603,0.42650966183574884,0.2730197432301218,0.20410573325563192,131041.82287535546,1.2881923788943936,131043.11106773435,2234,0,534.1521739130435,40,6,17,35.04280397022333,0.6236979166666666,44.029471544715456,1023.8821138211396,25.597052845528488,0
2688,4,1,1,44,0.022222222222222223,0.022222222222222223,0.9777777777777777,45,900,600,300,0.6666666666666666,12,6,6,357.4563485023395,0.42489478114478113,0.2694342694342695,0.20762890030029507,131008.00781250001,365.92881944444576,131373.93663194447,2235,0,544.6444444444444,39,6,17,34.91385158051824,0.625,44.0625,1023.7500000000001,26.250000000000004,0
2689,4,1,0,45,0.022222222222222223,0.0,1.0,45,1100,700,400,0.6363636363636364,15,7,8,362.14378119533916,0.4243686868686869,0.2782636205454998,0.21122905956553764,131168.017578125,500.3363715277784,131668.35394965278,2236,0,545.6222222222223,39,6,18,34.63197410345062,0.6266025641025641,43.90625,1024.375,26.266025641025642,0
2690,4,0,1,44,0.0,0.022222222222222223,0.9777777777777777,45,1400,900,500,0.6428571428571429,19,9,10,359.7935925608382,0.42485269360269357,0.2765853335978308,0.21016448436838783,131223.97898902785,442.70936611806565,131666.68835514592,2237,1,546.6222222222223,40,5,18,34.63557164583746,0.6255208333333333,43.85162601626017,1024.5934959349606,25.614837398374014,0
2691,4,0,0,44,0.0,0.0,1.0,44,1300,1000,300,0.7692307692307693,16,10,6,362.232556552718,0.4234275898520084,0.27909368211859276,0.21142772662884182,131194.69536675364,704.5979817708517,131899.2933485245,2238,2,559.4090909090909,39,5,18,34.60271564141671,0.626869658119658,43.88020833333334,1024.479166666668,26.268696581196618,0
2692,4,0,0,44,0.0,0.0,1.0,44,1050,800,250,0.7619047619047619,13,8,5,365.09569502068274,0.4234165785764623,0.281455356740433,0.21369646455505464,131302.08462431445,787.5651687157383,132089.6497930302,2239,3,560.4090909090909,40,4,18,34.42075689968602,0.6263020833333333,43.77540650406505,1024.8983739837417,25.622459349593544,0
2693,4,2,3,43,0.043478260869565216,0.06521739130434782,0.9347826086956522,46,1250,700,550,0.56,18,7,11,351.90907966734926,0.429579307568438,0.26806131581933035,0.20818772140183334,131709.7262081917,69.97228859446136,131779.69849678618,2240,0,537.0,41,5,16,34.347214168357986,0.628810975609756,43.3779761904762,1026.488095238096,25.036295005807222,0
2694,4,1,0,44,0.022727272727272728,0.0,1.0,44,1250,700,550,0.56,18,7,11,363.54383615700067,0.4233505109231854,0.29591577879249087,0.21517864896860342,131728.8208007815,777.8401692708626,132506.66097005238,2241,0,560.8636363636364,39,5,17,34.02936326737697,0.6322115384615383,43.359375000000014,1026.562500000002,26.322115384615437,0
2695,4,0,1,43,0.0,0.022727272727272728,0.9772727272727273,44,1400,900,500,0.6428571428571429,19,9,10,359.92013971384995,0.4230201726568006,0.2903471895714047,0.2139344483253939,131889.27001953174,693.9208984375435,132583.19091796927,2242,1,561.8636363636364,39,5,17,33.960488287191964,0.6338141025641024,43.20312500000002,1027.1875000000039,26.338141025641125,0
2696,4,0,0,43,0.0,0.0,1.0,43,1150,900,250,0.782608695652174,14,9,5,388.49332550200353,0.42377260981912146,0.2955436737907431,0.22522960871029177,130935.05333371792,1600.065772942142,132535.11910666007,2243,2,529.7674418604652,37,6,18,34.19353974716092,0.6278153153153154,44.133771929824555,1023.4649122807006,27.66121384542434,4
2697,4,0,0,43,0.0,0.0,1.0,43,800,500,300,0.625,11,5,6,389.9609792332492,0.42308047249907715,0.2934515213385791,0.2270720415236,131103.4404816865,1625.045206217281,132728.48568790377,2244,3,530.7674418604652,37,6,19,33.98509992862241,0.6295045045045045,43.96929824561403,1024.1228070175425,27.678994784257906,0
2698,4,0,1,42,0.0,0.023255813953488372,0.9767441860465116,43,1250,1000,250,0.8,15,10,5,389.95324481557543,0.4228959025470653,0.29344998170107783,0.227233515896587,131131.51552641194,1627.031995421668,132758.5475218336,2245,4,531.7674418604652,37,6,20,33.95681672197839,0.629786036036036,43.94188596491228,1024.2324561403507,27.681958274063533,0
2699,4,0,0,42,0.0,0.0,1.0,42,1250,900,350,0.72,16,9,7,397.387034878341,0.4205865272938443,0.30190497135735717,0.23135964757897823,131097.37059694852,2019.2790763736957,133116.64967332222,2246,10,545.3333333333334,36,6,20,33.801132614910934,0.6313657407407407,43.97522522522524,1024.0990990991008,28.447197197197244,0
2700,4,0,0,42,0.0,0.0,1.0,42,950,500,450,0.5263157894736842,14,5,9,410.8176019881793,0.42063492063492064,0.31797695523605607,0.2392167333272814,131103.44048168664,2372.123111825608,133475.56359351226,2247,11,546.3333333333334,37,5,18,33.45110635260529,0.6295045045045045,43.969298245614034,1024.1228070175437,27.678994784257938,1
2701,4,0,1,41,0.0,0.023809523809523808,0.9761904761904762,42,1250,800,450,0.64,17,8,9,404.65900676784725,0.4196791521486643,0.3167181274392916,0.23666727642379848,131271.93583602645,2224.0742343798056,133496.01007040625,2248,12,547.3333333333334,37,5,18,33.437656038233825,0.6311936936936937,43.80482456140351,1024.7807017543857,27.696775723091505,0
2702,4,0,0,41,0.0,0.0,1.0,41,1100,600,500,0.5454545454545454,16,6,10,405.51259171128254,0.4178607723577236,0.3339282173309537,0.23751451800232287,131328.12500000015,2451.0416666666815,133779.16666666683,2249,13,559.6341463414634,37,4,18,33.35873983739837,0.6317567567567566,43.75000000000001,1025.0000000000011,27.702702702702734,0
2703,4,1,0,42,0.023809523809523808,0.0,1.0,42,750,600,150,0.8,9,6,3,395.85850715034985,0.4203082655826558,0.3333307206345717,0.2337951118380522,131645.74361100997,2022.6175077104458,133668.3611187204,2250,0,547.2857142857143,36,6,19,33.28418193789092,0.6368634259259258,43.44031531531533,1026.2387387387412,28.5066316316317,0
2704,4,0,0,42,0.0,0.0,1.0,42,1000,900,100,0.9,11,9,2,395.5934185081005,0.4200300038714673,0.3383176935649792,0.23470503470236628,131819.1518165125,2029.357778386498,133848.509594899,2251,1,548.2857142857143,36,6,20,33.115381803560325,0.638599537037037,43.2713963963964,1026.9144144144148,28.52540040040041,0
2705,4,0,0,42,0.0,0.0,1.0,42,1250,900,350,0.72,16,9,7,391.39626223890906,0.4192315137437089,0.33320545142314306,0.2329229028314135,131934.82069485035,1927.7591358250252,133862.5798306754,2252,2,549.2857142857143,36,6,20,33.10611458219153,0.6397569444444444,43.15878378378379,1027.3648648648657,28.537912912912937,0
2706,4,0,0,42,0.0,0.0,1.0,42,1400,900,500,0.6428571428571429,19,9,10,387.2485661055052,0.4183362369337979,0.3305898920356749,0.23168934525185214,132137.36329234648,1834.0008927846816,133971.36418513115,2253,3,550.2857142857143,36,6,20,33.0079408543264,0.6417824074074073,42.961711711711715,1028.1531531531537,28.559809809809824,0
2707,4,0,0,42,0.0,0.0,1.0,42,1700,1000,700,0.5882352941176471,24,10,14,386.27465088871475,0.4175014518002323,0.32778550842466814,0.23234966985978847,132340.0612394489,1823.9221907718525,134163.98343022075,2254,4,551.2857142857143,36,6,20,32.82828973769656,0.6438078703703705,42.76463963963964,1028.9414414414414,28.581706706706704,0
2708,4,0,0,42,0.0,0.0,1.0,42,1150,700,450,0.6086956521739131,16,7,9,401.4936313017155,0.4172473867595819,0.35301608795176853,0.23625740774208506,131506.13667052463,2164.5974486592377,133670.73411918388,2255,5,552.2857142857143,35,7,19,33.281144211238995,0.6375,43.576388888888886,1025.6944444444441,29.305555555555546,6
2709,4,1,1,42,0.023255813953488372,0.023255813953488372,0.9767441860465116,43,1000,600,400,0.6,14,6,8,390.3600146198827,0.42015042451088963,0.34136066911464646,0.2317762586805555,131848.06428049685,1693.642460027607,133541.70674052445,2256,0,540.4186046511628,36,7,18,33.2204861111111,0.6388888888888888,43.24324324324325,1027.027027027028,28.528528528528554,0
2710,4,0,0,42,0.0,0.0,1.0,42,950,700,250,0.7368421052631579,12,7,5,399.1240036548677,0.416182733255904,0.3516012629679748,0.2359621109607578,131684.26890432098,2111.670524691359,133795.93942901233,2257,7,554.2857142857143,35,7,18,33.16136671177267,0.6392857142857142,43.40277777777778,1026.388888888889,29.325396825396826,0
2711,4,0,1,41,0.0,0.023809523809523808,0.9761904761904762,42,1400,900,500,0.6428571428571429,19,9,10,393.81754184585105,0.4156987998451413,0.35073850634491377,0.23400258636007487,131876.23844875448,1987.0352107531585,133863.27365950763,2258,8,555.2857142857143,38,4,19,33.10320019416129,0.6354166666666666,43.215811965811966,1027.1367521367522,27.02991452991453,0
2712,4,0,0,41,0.0,0.0,1.0,41,1300,900,400,0.6923076923076923,17,9,8,392.32427968613115,0.4154979674796748,0.34675836465164367,0.23379026778322234,131985.99810979617,2156.2623274161706,134142.26043721233,2259,9,565.5365853658536,38,3,19,33.03051569972966,0.6365131578947368,43.10897435897436,1027.5641025641025,27.04116059379217,0
2713,4,1,0,42,0.023809523809523808,0.0,1.0,42,850,700,150,0.8235294117647058,10,7,3,386.3038955181975,0.4170659117305459,0.3581551053461167,0.23255918243901738,132371.20361328137,1827.1023220486252,134198.30593533,2260,0,553.047619047619,39,3,20,32.796103687957626,0.6386217948717948,42.73437500000001,1029.062500000001,26.386217948717974,0
2714,4,0,0,42,0.0,0.0,1.0,42,850,500,350,0.5882352941176471,12,5,7,389.7575250148715,0.41644889663182344,0.36460862527459814,0.23557042864106395,132520.5516581634,1930.1900089463043,134450.74166710972,2261,1,554.047619047619,34,8,20,32.5565094230547,0.6498161764705882,42.58928571428572,1029.6428571428582,30.283613445378183,0
2715,4,0,0,42,0.0,0.0,1.0,42,1500,1200,300,0.8,18,12,6,387.41884029302093,0.4161585365853659,0.3557520514384138,0.23525255909198328,132695.96220207488,1881.7831575788894,134577.74535965378,2262,2,555.047619047619,35,7,19,32.43980753388752,0.6494047619047618,42.41898148148149,1030.324074074075,29.437830687830715,0
2716,4,0,0,42,0.0,0.0,1.0,42,700,500,200,0.7142857142857143,9,5,4,388.7649755523426,0.41574719318621756,0.35990245154665645,0.23644558349167075,132755.59413580253,1922.1450617283995,134677.73919753093,2263,3,556.047619047619,35,7,19,32.34501347708896,0.6499999999999999,42.361111111111114,1030.5555555555559,29.444444444444454,0
2717,4,0,0,42,0.0,0.0,1.0,42,1750,1400,350,0.8,21,14,7,388.696806961531,0.41574719318621756,0.3358531079059657,0.23078371325926514,131847.23816609953,1865.6344482237082,133712.87261432325,2264,4,557.047619047619,34,8,16,33.264025733163315,0.643075980392157,43.244047619047606,1027.0238095238076,30.206582633053163,3
2718,4,0,0,42,0.0,0.0,1.0,42,1150,600,550,0.5217391304347826,17,6,11,384.79146499736737,0.4160496515679442,0.329107639348603,0.22938673521113778,132000.11337868482,1758.5034013605432,133758.61678004535,2265,5,558.047619047619,34,8,16,33.20976212542477,0.6446078431372548,43.095238095238095,1027.6190476190477,30.224089635854344,0
2719,4,0,0,42,0.0,0.0,1.0,42,1100,800,300,0.7272727272727273,14,8,6,383.08350096830645,0.41527535811072397,0.3259900087905496,0.22933381553924728,132159.8776148832,1725.6537208504542,133885.53133573366,2266,6,559.047619047619,35,7,17,33.09226324478463,0.6440476190476192,42.9398148148148,1028.240740740739,29.37830687830683,0
2720,4,0,0,42,0.0,0.0,1.0,42,1500,1000,500,0.6666666666666666,20,10,10,382.5671546638648,0.41481562137049943,0.3225454166340864,0.22976666389575326,132282.13168827622,1721.3597465709038,134003.49143484712,2267,7,560.047619047619,36,6,17,32.982120051085566,0.6432291666666666,42.82094594594595,1028.716216216217,28.57545045045047,0
2721,4,0,0,42,0.0,0.0,1.0,42,1150,800,350,0.6956521739130435,15,8,7,381.23605941876355,0.4145252613240418,0.32506190882149966,0.22932815266574855,132341.5858725762,1690.6769390581735,134032.26281163437,2268,8,561.047619047619,37,5,17,32.95636189258312,0.6418918918918919,42.76315789473684,1028.9473684210527,27.809388335704128,0
2722,4,0,0,42,0.0,0.0,1.0,42,950,700,250,0.7368421052631579,12,7,5,380.6774980887745,0.4145252613240418,0.3202267767485163,0.22511194312122662,131693.6476247499,1626.5857042551543,133320.23332900504,2269,9,562.047619047619,37,5,15,33.625213652387565,0.6354166666666666,43.39364035087719,1026.425438596491,27.74122807017543,4
2723,4,0,0,42,0.0,0.0,1.0,42,1100,900,200,0.8181818181818182,13,9,4,380.07266415718436,0.41398083623693377,0.32067085698012643,0.22525319159290375,131778.07113727316,1617.0485149276888,133395.11965220084,2270,10,563.047619047619,37,5,15,33.55537163605297,0.6362612612612611,43.31140350877194,1026.7543859649136,27.750118539592258,0
2724,4,0,0,42,0.0,0.0,1.0,42,900,600,300,0.6666666666666666,12,6,6,380.8412974551391,0.4138719512195122,0.3179848981771034,0.22587579168254457,131806.21831957914,1639.4502394967753,133445.66855907592,2271,11,564.047619047619,37,5,15,33.50718544224952,0.6365427927927927,43.28399122807018,1026.8640350877197,27.75308202939783,0
2725,4,1,2,41,0.023255813953488372,0.046511627906976744,0.9534883720930233,43,1650,1400,250,0.8484848484848485,19,14,5,371.7806574782958,0.415813030638612,0.30818132800892806,0.2234983295138851,132317.6120334203,1238.6257595486306,133556.23779296892,2272,0,551.9069767441861,39,4,15,33.2237563700179,0.6380876068376067,42.78645833333334,1028.854166666668,26.380876068376104,0
2726,4,0,0,41,0.0,0.0,1.0,41,600,500,100,0.8333333333333334,7,5,2,385.91724223706314,0.4121189024390244,0.32153165838562625,0.2299065783219022,131975.16453379902,1986.2983081332904,133961.4628419323,2273,13,579.2926829268292,37,4,15,33.20605680645964,0.6382319819819819,43.11951754385966,1027.5219298245627,27.770862968231423,0
2727,4,0,0,41,0.0,0.0,1.0,41,1000,800,200,0.8,12,8,4,391.3093725981239,0.4112042682926829,0.3332657126955145,0.2343358426708307,132172.40521121898,2144.0601915974325,134316.46540281642,2274,14,580.2926829268292,37,4,16,32.86814885903178,0.6402027027027026,42.92763157894738,1028.2894736842118,27.79160739687059,0
2728,4,0,0,41,0.0,0.0,1.0,41,1550,1300,250,0.8387096774193549,18,13,5,392.23721090330895,0.4105182926829268,0.3311938382541715,0.2362990026661401,132398.0034722224,2186.477089104359,134584.48056132675,2275,15,581.2926829268292,36,5,16,32.61639676113361,0.6443865740740741,42.70833333333334,1029.166666666668,28.587962962963005,0
2729,4,0,0,41,0.0,0.0,1.0,41,1150,700,450,0.6086956521739131,16,7,9,399.9974537225436,0.4097052845528455,0.3349834712103017,0.24212090770225822,132576.7385223767,2406.0715663580368,134982.81008873472,2276,16,582.2926829268292,35,6,17,32.236176668914354,0.6482142857142856,42.53472222222223,1029.8611111111122,29.424603174603206,0
2730,4,0,0,41,0.0,0.0,1.0,41,1200,1000,200,0.8333333333333334,14,10,4,399.27044701245165,0.4088922764227642,0.3312435025989604,0.24258463414103157,132716.9124360849,2397.9881908936195,135114.90062697852,2277,17,583.2926829268292,36,5,16,32.11338797814209,0.6475694444444444,42.39864864864866,1030.4054054054068,28.62237237237241,0
2731,4,0,0,41,0.0,0.0,1.0,41,850,400,450,0.47058823529411764,13,4,9,397.71353512608454,0.4086128048780488,0.32929361311971705,0.24182568504576776,132745.9231824732,2358.970076495431,135104.89325896863,2278,18,584.2926829268292,36,5,16,32.12422139656867,0.6478587962962963,42.370495495495504,1030.5180180180196,28.625500500500543,0
2732,4,1,1,41,0.023809523809523808,0.023809523809523808,0.9761904761904762,42,850,500,350,0.5882352941176471,12,5,7,393.267207171093,0.4100125822686798,0.3239337988716613,0.2409510249012739,133030.99203740238,2063.345341149836,135094.3373785522,2279,0,571.3571428571429,38,4,16,31.951420533001933,0.6469298245614035,42.0940170940171,1031.6239316239323,27.147998200629797,0
2733,4,1,0,42,0.023809523809523808,0.0,1.0,42,700,400,300,0.5714285714285714,10,4,6,391.4968759060383,0.4091052071234998,0.3253508071275726,0.2402208912007953,133086.10586054495,2020.5589341807274,135106.6647947257,2280,0,572.3333333333334,38,4,17,31.94156830261614,0.6474780701754386,42.04059829059829,1031.8376068376067,27.153621232568597,0
2734,4,0,0,42,0.0,0.0,1.0,42,1200,800,400,0.6666666666666666,16,8,8,393.99454787131583,0.40897212543554007,0.3253606794130548,0.2422903454477902,133168.79799702318,2093.5560714807507,135262.35406850395,2281,1,573.3333333333334,38,4,17,31.793853293309862,0.6483004385964912,41.960470085470085,1032.1581196581199,27.162055780476837,0
2735,4,0,0,42,0.0,0.0,1.0,42,1150,800,350,0.6956521739130435,15,8,7,392.7455081742187,0.40904471544715443,0.32337778829188446,0.24170108917065608,133196.36774965297,2062.4550277595104,135258.82277741248,2282,2,574.3333333333334,38,4,17,31.798325053474084,0.6485745614035088,41.93376068376068,1032.264957264957,27.16486729644624,0
2736,4,0,0,42,0.0,0.0,1.0,42,1050,800,250,0.7619047619047619,13,8,5,389.6013610638225,0.4088874370886566,0.318584485009731,0.24029975460637146,133279.09412895376,1985.1432947987264,135264.2374237525,2283,3,575.3333333333334,38,4,17,31.796214864631825,0.6493969298245614,41.85363247863247,1032.5854700854688,27.173301844354445,0
2737,4,0,0,42,0.0,0.0,1.0,42,950,600,350,0.631578947368421,13,6,7,388.3367177979589,0.40880274874177314,0.30976023011604337,0.24005366928840563,133361.84619037173,1957.8603258090282,135319.70651618074,2284,4,576.3333333333334,38,4,17,31.74562129361467,0.6502192982456141,41.773504273504265,1032.905982905982,27.181736392262685,0
2738,4,0,0,42,0.0,0.0,1.0,42,1100,600,500,0.5454545454545454,16,6,10,386.42384834023926,0.40851238869531553,0.30703326240340467,0.2397761321633072,133502.1235880699,1917.8178429900343,135419.94143105994,2285,5,577.3333333333334,35,7,17,31.65399727479747,0.6574404761904764,41.63773148148147,1033.449074074072,29.527116402116345,0
2739,4,0,0,42,0.0,0.0,1.0,42,800,300,500,0.375,13,3,10,385.54691271792984,0.4078953735965931,0.305311150215966,0.23942516902441638,133532.02830289755,1896.5722522290555,135428.6005551266,2286,6,578.3333333333334,35,7,17,31.646603210153042,0.6577380952380953,41.60879629629628,1033.564814814813,29.53042328042323,0
2740,4,0,0,42,0.0,0.0,1.0,42,1150,1000,150,0.8695652173913043,13,10,3,386.4967225514532,0.4076050135501355,0.30130480667754056,0.24079230957285083,133651.68065200606,1931.1873070987554,135582.86795910483,2287,7,579.3333333333334,35,7,17,31.50184687709872,0.6589285714285715,41.49305555555555,1034.027777777777,29.54365079365077,0
2741,4,0,0,42,0.0,0.0,1.0,42,800,400,400,0.5,12,4,8,391.5123687076851,0.4064677700348432,0.29924593411509126,0.24550516135933523,133891.14610125174,2084.0079518175635,135975.1540530693,2288,8,580.3333333333334,35,7,16,31.131644673078362,0.6613095238095238,41.261574074074076,1034.953703703704,29.570105820105827,0
2742,4,0,1,41,0.0,0.023809523809523808,0.9761904761904762,42,1350,1200,150,0.8888888888888888,15,12,3,380.6231293485091,0.4065040650406504,0.2535816618911171,0.22514825786886394,131705.23356401388,1740.828052467357,133446.06161648122,2289,9,581.3333333333334,33,9,16,33.614891754218405,0.6439393939393939,43.38235294117647,1026.4705882352944,31.105169340463465,6
2743,4,2,2,41,0.046511627906976744,0.046511627906976744,0.9534883720930233,43,1100,900,200,0.8181818181818182,13,9,4,369.35157815725285,0.4125599852344038,0.25156546670914315,0.22013933054767684,131992.67415641993,1150.3405009739483,133143.01465739388,2290,0,568.5581395348837,36,7,16,33.61392694063926,0.6403356481481481,43.10247747747748,1027.5900900900901,28.54416916916917,0
2744,4,0,0,41,0.0,0.0,1.0,41,1100,700,400,0.6363636363636364,15,7,8,382.98946514316367,0.40475101626016263,0.26870244122443476,0.2265999710710286,131713.96933138292,1889.012533221886,133602.9818646048,2291,31,597.2926829268292,35,6,16,33.54533111587176,0.6395833333333333,43.373842592592595,1026.50462962963,29.328703703703713,0
2745,4,0,0,41,0.0,0.0,1.0,41,850,400,450,0.47058823529411764,13,4,9,384.3135659895091,0.4048780487804878,0.2659773970907693,0.22756083647042358,131743.67310742452,1926.1761616940967,133669.84926911863,2292,32,598.2926829268292,35,6,16,33.48130402104472,0.6398809523809523,43.344907407407405,1026.62037037037,29.33201058201057,0
2746,4,0,0,41,0.0,0.0,1.0,41,1450,1300,150,0.896551724137931,16,13,3,382.22803412021426,0.4044969512195122,0.27353349364479573,0.22721190909691238,131892.24222232937,1882.582492069615,133774.82471439897,2293,33,599.2926829268292,35,6,16,33.38462441314555,0.6413690476190477,43.20023148148148,1027.199074074074,29.348544973544968,0
2747,4,0,0,41,0.0,0.0,1.0,41,950,700,250,0.7368421052631579,12,7,5,382.5139185167827,0.4044969512195122,0.27668651960522217,0.22781050865190144,131963.7458404352,1895.593904715548,133859.33974515076,2294,34,600.2926829268292,36,5,16,33.30501972818939,0.6400462962962962,43.13063063063064,1027.477477477479,28.541041041041083,0
2748,4,0,0,41,0.0,0.0,1.0,41,1250,800,450,0.64,17,8,9,382.9144030078692,0.4046239837398374,0.2795195140649247,0.22927156812228572,132166.31063073222,1921.6767865838979,134087.98741731612,2295,35,601.2926829268292,36,5,17,33.090114262767855,0.6420717592592592,42.933558558558566,1028.265765765767,28.56293793793797,0
2749,4,0,0,41,0.0,0.0,1.0,41,750,300,450,0.4,12,3,9,382.0112286766636,0.40426829268292686,0.27635689757379267,0.22925693579058137,132253.17166829004,1904.4393210778517,134157.6109893679,2296,36,602.2926829268292,36,5,18,33.02564593825268,0.6429398148148147,42.84909909909911,1028.6036036036048,28.572322322322357,0
2750,4,0,0,41,0.0,0.0,1.0,41,1000,800,200,0.8,12,8,4,381.6831546841794,0.4038871951219512,0.2708259368902104,0.22958781990449967,132340.06123944905,1902.3944129940915,134242.45565244314,2297,37,603.2926829268292,36,5,18,32.94639925577324,0.6438078703703705,42.76463963963965,1028.9414414414425,28.581706706706736,0
2751,4,0,0,41,0.0,0.0,1.0,41,850,600,250,0.7058823529411765,11,6,5,377.79530305124666,0.4041158536585366,0.27100206470572874,0.22778914216277216,132429.53619100797,1806.2893964451177,134235.8255874531,2298,38,604.2926829268292,33,8,18,32.95618029924195,0.6511994949494951,42.67769607843135,1029.2892156862722,31.1905822935234,0
2752,4,1,1,41,0.023809523809523808,0.023809523809523808,0.9761904761904762,42,1150,800,350,0.6956521739130435,15,8,7,366.3700709315611,0.40819783197831977,0.2517450783016222,0.22288585411486433,132765.81809807228,1328.284438775478,134094.10253684776,2299,0,590.8809523809524,34,8,14,32.91170921412344,0.6522671568627454,42.35119047619046,1030.595238095236,30.311624649859883,0
2753,4,1,1,41,0.023809523809523808,0.023809523809523808,0.9761904761904762,42,1050,800,250,0.7619047619047619,13,8,5,363.7865268571534,0.406975900116144,0.2565111254061727,0.22204052918321346,132888.5363520405,1268.6118197278574,134157.14817176838,2300,0,591.8571428571429,34,8,16,32.85489550860178,0.6534926470588238,42.23214285714284,1031.0714285714262,30.32563025210077,0
2754,4,0,0,41,0.0,0.0,1.0,41,1000,500,500,0.5,15,5,10,368.9853692605762,0.4036077235772358,0.26458216528567036,0.22447690384320482,132765.8180980724,1597.7288832199374,134363.54698129234,2301,41,607.2926829268292,34,7,16,32.844326364021406,0.6522671568627452,42.35119047619047,1030.595238095237,30.31162464985991,0
2755,4,0,0,41,0.0,0.0,1.0,41,1150,800,350,0.6956521739130435,15,8,7,348.16431306773455,0.4036077235772358,0.16915789061582465,0.20347689215872283,131243.84576263843,938.8846808633366,132182.73044350176,2302,42,608.2926829268292,37,4,17,34.91338951310862,0.6309121621621622,43.83223684210526,1024.6710526315783,27.6938122332859,7
2756,4,0,0,41,0.0,0.0,1.0,41,800,500,300,0.625,11,5,6,347.8769808712908,0.40289634146341463,0.16468438440289046,0.20391011956673286,131356.983567182,939.241223535005,132296.224790717,2303,43,609.2926829268292,36,5,18,34.80651982862791,0.6339699074074074,43.721846846846844,1025.1126126126123,28.475350350350343,0
2757,4,0,0,41,0.0,0.0,1.0,41,1300,900,400,0.6923076923076923,17,9,8,346.7594449005917,0.40276930894308943,0.16835373887335714,0.2040235803717436,131501.32395909433,919.8652199496925,132421.189179044,2304,44,610.2926829268292,36,5,20,34.689512882447666,0.6354166666666665,43.58108108108109,1025.6756756756765,28.490990990991016,0
2758,4,0,0,41,0.0,0.0,1.0,41,1250,900,350,0.72,16,9,7,352.23163735112604,0.4029725609756098,0.1742970941561921,0.20787141706887693,131616.85333982637,1071.9239509780132,132688.77729080437,2305,45,611.2926829268292,36,5,14,34.432616330114136,0.6365740740740741,43.46846846846847,1026.1261261261266,28.503503503503516,0
2759,4,0,0,41,0.0,0.0,1.0,41,1050,900,150,0.8571428571428571,12,9,3,351.8668178805044,0.4029725609756098,0.17439492661520073,0.20812888027130438,131703.53366457688,1068.4206588345191,132771.9543234114,2306,46,612.2926829268292,36,5,15,34.35454379228377,0.6374421296296295,43.38400900900901,1026.463963963965,28.512887887887914,0
2760,4,0,0,41,0.0,0.0,1.0,41,1400,1200,200,0.8571428571428571,16,12,4,375.4930488520706,0.4027947154471545,0.2171437264431788,0.21226199764592132,129954.9515836604,1629.0137979642743,131583.96538162467,2307,47,613.2926829268292,37,4,16,35.52162866974943,0.6179617117117117,45.093201754385966,1019.6271929824564,27.557491702228553,8
2761,4,0,0,41,0.0,0.0,1.0,41,1100,800,300,0.7272727272727273,14,8,6,372.704571321793,0.40261686991869916,0.21698272293847976,0.2110224103106665,130017.30974687713,1491.6091387245285,131508.91888560166,2308,48,614.2926829268292,38,3,16,35.52927927927929,0.6167763157894737,45.032051282051285,1019.8717948717954,26.838731443994615,0
2762,4,1,1,41,0.023809523809523808,0.023809523809523808,0.9761904761904762,42,1200,700,500,0.5833333333333334,17,7,10,361.5443546958589,0.40497967479674796,0.2127618229422359,0.20629295532646055,130318.55955678665,1023.6501820769602,131342.2097388636,2309,0,600.6428571428571,37,5,16,35.50794673539521,0.6216216216216216,44.73684210526316,1021.052631578947,27.59601706970127,0
2763,4,1,0,42,0.023809523809523808,0.0,1.0,42,1250,700,550,0.56,18,7,11,360.0472511122327,0.40652826171118855,0.2211225805809096,0.20629909301295862,130480.80490037611,995.851025458386,131476.6559258345,2310,0,601.6190476190476,38,4,17,35.38159224789988,0.621436403508772,44.57799145299145,1021.6880341880334,26.886527215474562,0
2764,4,0,0,42,0.0,0.0,1.0,42,850,600,250,0.7058823529411765,11,6,5,361.1193714375111,0.4059596399535424,0.21841741086984667,0.20735101483620824,130562.68376981512,1029.7428592300291,131592.42662904516,2311,1,602.6190476190476,38,4,11,35.27118614537597,0.6222587719298246,44.49786324786324,1022.0085470085465,26.894961763382803,0
2765,4,0,0,42,0.0,0.0,1.0,42,1500,1200,300,0.8,18,12,6,362.1749612552574,0.4052458381726674,0.21261897298884014,0.20869214654870966,130699.20562358461,1067.1959465629316,131766.40157014754,2312,2,603.6190476190476,38,4,12,35.10583185316756,0.6236293859649124,44.36431623931624,1022.5427350427349,26.909019343229865,0
2766,4,0,0,42,0.0,0.0,1.0,42,1350,1100,250,0.8148148148148148,16,11,5,363.01004704744344,0.40462882307394504,0.21070533476548547,0.20991450546656493,130835.79881656796,1098.9418967784263,131934.74071334637,2313,3,604.6190476190476,38,4,12,34.946089181286546,0.625,44.230769230769226,1023.0769230769223,26.923076923076902,0
2767,4,0,0,42,0.0,0.0,1.0,42,1050,700,350,0.6666666666666666,14,7,7,361.4163812968178,0.4045925280681378,0.20742546940479922,0.20943784128507045,130917.78897518065,1063.1667077580328,131980.9556829387,2314,4,605.6190476190476,38,4,12,34.90382607787867,0.6258223684210527,44.150641025641015,1023.3974358974347,26.93151147098512,0
2768,4,1,1,42,0.023255813953488372,0.023255813953488372,0.9767441860465116,43,650,400,250,0.6153846153846154,9,4,5,356.7510921662593,0.40884551495016613,0.20370418547889346,0.20793915170544286,131141.34250216995,756.963433159703,131898.30593532964,2315,0,592.5116279069767,39,4,12,34.79704820502389,0.6263354700854702,43.93229166666666,1024.2708333333317,26.26335470085466,0
2769,4,0,0,42,0.0,0.0,1.0,42,900,500,400,0.5555555555555556,13,5,8,363.6253173505854,0.4048949864498645,0.20840602183885792,0.21101721172234741,130972.46334876528,1124.9807098765273,132097.4440586418,2316,6,607.6190476190476,38,4,12,34.79194934418814,0.6263706140350878,44.097222222222214,1023.61111111111,26.937134502923946,0
2770,4,1,0,43,0.023255813953488372,0.0,1.0,43,1000,700,300,0.7,13,7,6,353.95597858417614,0.4083148763381321,0.2079788239742859,0.20731707317073161,131328.12499999988,697.3572530864052,132025.4822530863,2317,0,594.4651162790698,38,5,15,34.67987804878047,0.6299342105263158,43.74999999999999,1024.999999999999,26.97368421052629,0
2771,4,0,0,43,0.0,0.0,1.0,43,1600,1100,500,0.6875,21,11,10,353.1359576524629,0.4083840900701366,0.2108552974268154,0.2075782031540716,131465.0463533676,685.0070083643722,132150.05336173196,2318,1,595.4651162790698,38,5,17,34.56262805153315,0.6313048245614036,43.61645299145299,1025.5341880341875,26.987741790373356,0
2772,4,0,0,43,0.0,0.0,1.0,43,1100,900,200,0.8181818181818182,13,9,4,352.0216019229764,0.4080841638981174,0.21264742287019534,0.20722007357832573,131519.8348696945,659.5645910950234,132179.39946078951,2319,2,596.4651162790698,38,5,17,34.535899038294616,0.6318530701754387,43.56303418803418,1025.747863247862,26.993364822312156,0
2773,4,0,0,43,0.0,0.0,1.0,43,1000,700,300,0.7,13,7,6,355.3986512283776,0.4077380952380953,0.21014015478047,0.20965900776396404,131602.03904594912,754.237435166908,132356.27648111602,2320,3,597.4651162790698,38,5,10,34.36632305983619,0.6326754385964912,43.482905982905976,1026.0683760683746,27.001799370220386,0
2774,4,0,0,43,0.0,0.0,1.0,43,1100,900,200,0.8181818181818182,13,9,4,351.97454626002093,0.4078765227021041,0.20503746877602036,0.2082371576641796,131711.68456424848,671.83208232886,132383.51664657734,2321,4,598.4651162790698,38,5,10,34.34355918678879,0.6337719298245614,43.37606837606837,1026.495726495725,27.013045434098025,0
2775,4,0,1,42,0.0,0.023255813953488372,0.9767441860465116,43,1300,1100,200,0.8461538461538461,15,11,4,352.1684761466506,0.40801495016611294,0.2050838966376003,0.2085019647130721,131739.1030777447,678.87183596316,132417.97491370785,2322,5,599.4651162790698,38,5,11,34.310932459152866,0.634046052631579,43.349358974358964,1026.6025641025624,27.01585695006743,0
2776,4,1,0,43,0.023255813953488372,0.0,1.0,43,1050,900,150,0.8571428571428571,12,9,3,353.18592777783084,0.406999815430048,0.20489211557024278,0.2097082349430687,131848.8056674152,713.428551208975,132562.2342186242,2323,0,600.3255813953489,38,5,13,34.17420853705052,0.6351425438596492,43.242521367521356,1027.0299145299127,27.027103013945073,0
2777,4,1,0,44,0.022727272727272728,0.0,1.0,44,1400,1100,300,0.7857142857142857,17,11,6,346.00115166121157,0.4095423713883016,0.20573811256113017,0.20711809387797558,132156.90239800335,345.2880859374901,132502.19048394085,2324,0,587.6590909090909,39,5,16,34.048496437375476,0.6364850427350428,42.94270833333333,1028.2291666666656,26.3648504273504,0
2778,4,0,0,44,0.0,0.0,1.0,44,750,500,250,0.6666666666666666,10,5,5,343.9109692179098,0.40960843904157856,0.2025059160428353,0.20615865203937,132210.46142578125,293.7255859375013,132504.18701171875,2325,1,588.6590909090909,39,5,16,34.0483515648739,0.6370192307692308,42.890625,1028.4375,26.370192307692307,0
2779,4,1,2,43,0.022222222222222223,0.044444444444444446,0.9555555555555556,45,1300,1000,300,0.7692307692307693,16,10,6,337.5763372590711,0.4114057239057239,0.1967087941021588,0.20351030617618301,132424.15229030346,-59.34794104037735,132364.80434926308,2326,0,576.5555555555555,40,5,16,33.996511321748294,0.6375,42.6829268292683,1029.2682926829275,25.731707317073187,0
2780,4,0,0,43,0.0,0.0,1.0,43,1050,600,450,0.5714285714285714,15,6,9,349.7953412801327,0.40822259136212624,0.19603364279805158,0.2097114249854823,132215.03404058423,649.6405909181,132864.67463150233,2327,3,582.5116279069767,40,3,17,33.892457180500664,0.6354166666666667,42.886178861788615,1028.455284552845,25.711382113821124,0
2781,4,0,0,43,0.0,0.0,1.0,43,1250,700,550,0.56,18,7,11,346.57859654897794,0.4074612403100775,0.20393736593342537,0.20864773297591835,132371.8572361027,575.4505006940185,132947.3077367967,2328,4,583.5116279069767,40,3,17,33.81744189874251,0.6369791666666667,42.73373983739837,1029.0650406504053,25.726626016260134,0
2782,4,0,0,43,0.0,0.0,1.0,43,900,600,300,0.6666666666666666,12,6,6,346.04681039866796,0.40750738279808046,0.19837931854181035,0.20862041083277816,132424.80604383664,565.0389317881643,132989.84497562482,2329,5,584.5116279069767,39,4,18,33.777894443882175,0.639155982905983,42.68229166666666,1029.270833333332,26.39155982905979,0
2783,4,0,0,43,0.0,0.0,1.0,43,1050,700,350,0.6666666666666666,14,7,7,347.3917856769686,0.4065845330380214,0.19884356077892607,0.2101784083967262,132558.85959201367,609.9717881944213,133168.83138020808,2330,6,585.5116279069767,39,4,18,33.60855418436846,0.6404914529914532,42.55208333333332,1029.791666666665,26.404914529914485,0
2784,4,0,0,43,0.0,0.0,1.0,43,1200,900,300,0.75,15,9,6,348.57650536078893,0.40580011074197125,0.1988383850259834,0.2114982600011164,132666.1512586804,648.8606770833137,133315.0119357637,2331,7,586.5116279069767,39,4,13,33.47025615099426,0.6415598290598292,42.44791666666666,1030.208333333332,26.415598290598254,0
2785,4,0,0,43,0.0,0.0,1.0,43,850,500,350,0.5882352941176471,12,5,7,351.82707973897715,0.4052464008859358,0.20625874002608757,0.21423562793951878,132800.3268771702,744.5502387152833,133544.8771158855,2332,8,587.5116279069767,39,4,13,33.251747515580256,0.6428952991452992,42.317708333333336,1030.7291666666672,26.428952991453006,0
2786,4,0,0,43,0.0,0.0,1.0,43,1100,700,400,0.6363636363636364,15,7,8,348.0519921324722,0.40443890734588406,0.21366602001944668,0.2130043773853979,132988.28667534713,657.367621527774,133645.6542968749,2333,9,588.5116279069767,39,4,13,33.16038847370902,0.6447649572649572,42.135416666666664,1031.4583333333328,26.44764957264956,0
2787,4,0,0,43,0.0,0.0,1.0,43,1200,700,500,0.5833333333333334,17,7,10,347.99118380827474,0.4034237726098191,0.2061383331299116,0.21388937029605382,133149.50086805562,666.9704861111218,133816.47135416674,2334,10,589.5116279069767,39,4,15,33.00026914278025,0.6463675213675213,41.97916666666667,1032.083333333334,26.46367521367523,0
2788,4,0,0,43,0.0,0.0,1.0,43,1000,700,300,0.7,13,7,6,347.99118380827474,0.40321613141380586,0.2061383331299116,0.21388937029605382,133149.50086805562,666.9704861111218,133816.47135416674,2335,11,590.5116279069767,39,4,15,33.00026914278025,0.6463675213675213,41.97916666666667,1032.083333333334,26.46367521367523,0
2789,4,1,2,42,0.022727272727272728,0.045454545454545456,0.9545454545454546,44,900,700,200,0.7777777777777778,11,7,4,338.0126376670193,0.4042569591261452,0.20308783288322907,0.2092714052693617,133419.72061107808,219.5103361094614,133639.23094718755,2336,0,578.0681818181819,40,4,16,32.98720407895599,0.6473958333333333,41.71747967479675,1033.1300813008133,25.828252032520332,0
2790,4,0,0,42,0.0,0.0,1.0,42,1250,1100,150,0.88,14,11,3,347.55384392406023,0.40103561749903216,0.20087314727215388,0.21420665482666576,133251.5158156184,862.4153060851776,134113.93112170356,2337,1,593.1428571428571,38,4,16,32.90929394315673,0.6491228070175439,41.88034188034188,1032.4786324786326,27.170490328385068,0
2791,4,0,0,42,0.0,0.0,1.0,42,1150,600,550,0.5217391304347826,17,6,11,349.61154646987814,0.4004790940766551,0.20623347073859066,0.21627601041697075,133389.43591798164,926.8973948060559,134316.3333127877,2338,2,594.1428571428571,38,4,17,32.71796462922745,0.6504934210526315,41.746794871794876,1033.0128205128208,27.184547908232126,0
2792,4,0,0,42,0.0,0.0,1.0,42,1100,800,300,0.7272727272727273,14,8,6,346.61402641525154,0.4000919473480449,0.1964254946266728,0.21506077469626256,133499.8233641064,854.5822603915746,134354.405624498,2339,3,595.1428571428571,38,4,19,32.68483579723629,0.6515899122807016,41.639957264957275,1033.4401709401725,27.1957939721098,0
2793,4,0,0,42,0.0,0.0,1.0,42,750,600,150,0.8,9,6,3,344.90331109909266,0.400104045683314,0.20160206718346307,0.21431853146330906,133555.03420857995,812.7147024983663,134367.74891107832,2340,4,596.1428571428571,38,4,19,32.67377260981913,0.6521381578947367,41.58653846153847,1033.6538461538466,27.201417004048597,0
2794,4,0,0,42,0.0,0.0,1.0,42,1050,600,450,0.5714285714285714,15,6,9,343.73728028891105,0.3997289972899729,0.1998641986242733,0.21407267687490875,133637.87187705465,787.2637245233517,134425.13560157802,2341,5,597.1428571428571,38,4,19,32.62102190535236,0.6529605263157894,41.50641025641026,1033.9743589743598,27.209851551956838,0
2795,4,0,0,42,0.0,0.0,1.0,42,650,400,250,0.6153846153846154,9,4,5,344.3368142246724,0.3995112272551297,0.1988914136197757,0.21508832485956647,133748.36205164742,810.8969793264761,134559.2590309739,2342,6,598.1428571428571,38,4,13,32.49500791847414,0.6540570175438596,41.399572649572654,1034.4017094017101,27.221097615834477,0
2796,4,0,1,41,0.0,0.023809523809523808,0.9761904761904762,42,900,700,200,0.7777777777777778,11,7,4,344.47456450957753,0.39937814556716994,0.19791943207181717,0.2158202219818738,133858.89788333705,822.1971108189116,134681.09499415595,2343,7,599.1428571428571,38,4,14,32.380927799573264,0.6551535087719298,41.292735042735046,1034.8290598290603,27.232343679712113,0
2797,4,0,0,41,0.0,0.0,1.0,41,750,500,250,0.6666666666666666,10,5,5,344.00210889342833,0.39994918699186993,0.1806171947569406,0.216010138241635,133941.8297195742,1015.2543785156031,134957.0840980898,2344,8,566.7317073170732,38,3,14,32.310265937317226,0.6559758771929824,41.21260683760684,1035.1495726495732,27.240778227620346,0
2798,4,0,0,41,0.0,0.0,1.0,41,750,400,350,0.5333333333333333,11,4,7,344.42504755209956,0.3997713414634146,0.180591486063437,0.2167641273295422,134024.7872379282,1032.298743516687,135057.08598144486,2345,9,567.7317073170732,38,3,14,32.21643279680836,0.6567982456140351,41.13247863247863,1035.470085470085,27.24921277552855,0
2799,4,0,0,41,0.0,0.0,1.0,41,750,400,350,0.5333333333333333,11,4,7,344.42504755209956,0.3997713414634146,0.180591486063437,0.2167641273295422,134024.7872379282,1032.298743516687,135057.08598144486,2346,10,568.7317073170732,38,3,14,32.21643279680836,0.6567982456140351,41.13247863247863,1035.470085470085,27.24921277552855,0
2800,4,0,1,40,0.0,0.024390243902439025,0.975609756097561,41,1050,900,150,0.8571428571428571,12,9,3,343.57461890991067,0.3996189024390244,0.17643685100217343,0.21688147818688117,134135.43721236035,1017.1063445101976,135152.54355687054,2347,11,569.7317073170732,38,3,15,32.12793935643564,0.6578947368421052,41.02564102564103,1035.8974358974365,27.260458839406223,0
2801,4,0,0,40,0.0,0.0,1.0,40,1050,600,450,0.5714285714285714,15,6,9,353.0333733988616,0.3971287393162393,0.1854499735309687,0.22244164187806867,134067.73147747395,1466.0767014850808,135533.80817895904,2348,24,584.7,37,3,16,31.950657314275627,0.6590653153153152,41.09100877192983,1035.6359649122815,27.990161213845443,0
2802,4,0,0,40,0.0,0.0,1.0,40,800,600,200,0.75,10,6,4,352.48232216708334,0.3971287393162393,0.18684503016830734,0.22243824298680284,134124.51577648905,1455.3041560865008,135579.81993257554,2349,25,585.7,37,3,17,31.908167495854062,0.6596283783783783,41.03618421052632,1035.8552631578957,27.99608819345664,0
2803,4,0,0,40,0.0,0.0,1.0,40,950,700,250,0.7368421052631579,12,7,5,352.8409168309122,0.3972222222222222,0.18311812023708707,0.22283696405203607,134152.9124345953,1466.927323791936,135619.8397583872,2350,26,586.7,37,3,17,31.870501693480104,0.6599099099099099,41.00877192982456,1035.9649122807018,27.999051683262213,0
2804,4,0,0,40,0.0,0.0,1.0,40,1050,500,550,0.47619047619047616,16,5,11,357.1379925895341,0.3972222222222222,0.12336244541484698,0.21282237997064052,131985.99810979614,1427.4428829717265,133413.44099276786,2351,27,587.7,38,2,13,33.934419837804114,0.6365131578947368,43.10897435897436,1027.5641025641023,27.041160593792167,6
2805,4,0,0,40,0.0,0.0,1.0,40,1100,700,400,0.6363636363636364,15,7,8,357.10101334497,0.39650106837606836,0.12389304646086718,0.2132631191428899,132068.3478180473,1432.3481673241272,133500.69598537142,2352,28,588.7,38,2,14,33.852380209957396,0.6373355263157894,43.02884615384615,1027.884615384615,27.049595141700394,0
2806,4,0,0,40,0.0,0.0,1.0,40,300,200,100,0.6666666666666666,4,2,2,357.10101334497,0.39650106837606836,0.12389304646086718,0.2132631191428899,132068.3478180473,1432.3481673241272,133500.69598537142,2353,29,589.7,38,2,14,33.852380209957396,0.6373355263157894,43.02884615384615,1027.884615384615,27.049595141700394,0
2807,4,0,0,40,0.0,0.0,1.0,40,850,500,350,0.5882352941176471,12,5,7,360.2706139887191,0.39622061965811967,0.12543640897755615,0.2156246510589198,132150.72320841538,1522.0044378698076,133672.7276462852,2354,30,590.7,38,2,15,33.68791562759767,0.6381578947368423,42.94871794871794,1028.2051282051273,27.058029689608613,0
2808,4,0,0,40,0.0,0.0,1.0,40,1350,1100,250,0.8148148148148148,16,11,5,363.0854235116523,0.39497863247863246,0.12201484788703154,0.21841822072709074,132343.03232750745,1610.3651882898662,133953.39751579732,2355,31,591.7,38,2,15,33.42180631986987,0.6400767543859649,42.761752136752136,1028.9529914529912,27.077710301394507,0
2809,4,2,1,41,0.047619047619047616,0.023809523809523808,0.9761904761904762,42,700,500,200,0.7142857142857143,9,5,4,348.88563366587124,0.39937814556716994,0.12017854135085027,0.21244451354608007,132800.32687717033,866.4366529895328,133666.76353015986,2356,0,564.4761904761905,39,3,13,33.32754337207344,0.6428952991452991,42.31770833333334,1030.7291666666683,26.428952991453034,0
2810,4,0,0,41,0.0,0.0,1.0,41,750,600,150,0.8,9,6,3,358.2690972768107,0.3978658536585366,0.13160869400295883,0.2177382131842998,132728.0700402695,1310.4731673241251,134038.5432075936,2357,1,579.2439024390244,38,3,13,33.158372213582176,0.6439144736842106,42.38782051282051,1030.4487179487173,27.117071524966246,0
2811,4,0,0,41,0.0,0.0,1.0,41,1350,900,450,0.6666666666666666,18,9,9,356.7285511483112,0.3978404471544716,0.1263115854290473,0.2174399109305152,132838.1835438126,1277.4345505515455,134115.61809436415,2358,2,580.2439024390244,38,3,13,33.08740974885135,0.6450109649122806,42.28098290598291,1030.8760683760688,27.128317588843917,0
2812,4,0,0,41,0.0,0.0,1.0,41,1200,900,300,0.75,15,9,6,357.4691150346424,0.3982723577235772,0.12437660113083404,0.21869498330446374,132975.88962853386,1306.9547172912564,134282.8443458251,2359,3,581.2439024390244,38,3,14,32.9300031075202,0.6463815789473684,42.1474358974359,1031.4102564102564,27.142375168690958,0
2813,4,0,0,41,0.0,0.0,1.0,41,1150,700,450,0.6086956521739131,16,7,9,348.4570312500001,0.397510162601626,0.09777439024390233,0.2049747242647057,131492.43918474668,990.1914858645366,132482.63067061122,2360,4,582.2439024390244,38,3,20,34.65494791666665,0.6315789473684212,43.58974358974358,1025.641025641024,26.990553306342736,4
2814,4,0,0,41,0.0,0.0,1.0,41,950,500,450,0.5263157894736842,14,5,9,338.2776745117103,0.3975863821138212,0.11036389722185946,0.19842511020605338,131384.3261869036,733.2555641835976,132117.58175108721,2361,5,583.2439024390244,37,4,19,35.02495543672014,0.6323198198198199,43.695175438596486,1025.2192982456136,27.70862968231388,2
2815,4,0,0,41,0.0,0.0,1.0,41,750,300,450,0.4,12,3,9,338.54067020752984,0.39728150406504065,0.10999337703447631,0.19916411503907103,131496.7646295011,703.4005655586031,132200.1651950597,2362,6,584.2439024390244,37,4,19,34.90485353859312,0.633445945945946,43.58552631578946,1025.6578947368398,27.720483641536212,0
2816,4,0,0,41,0.0,0.0,1.0,41,1000,800,200,0.8,12,8,4,337.0990627145144,0.39730691056910566,0.11004940621292869,0.19846203471958968,131524.88175448202,667.3828726146369,132192.26462709665,2363,7,585.2439024390244,37,4,19,34.913482095136274,0.6337274774774776,43.55811403508771,1025.7675438596482,27.723447131341842,0
2817,4,0,0,41,0.0,0.0,1.0,41,1400,1000,400,0.7142857142857143,18,10,8,336.359078665768,0.397510162601626,0.11205339794728797,0.19828460604219553,131574.63480029564,651.2645874424484,132225.89938773809,2364,8,586.2439024390244,38,3,16,34.88232843902947,0.6324013157894738,43.50961538461537,1025.9615384615365,26.99898785425096,0
2818,4,0,0,41,0.0,0.0,1.0,41,1100,600,500,0.5454545454545454,16,6,10,340.44104240083027,0.3977642276422764,0.1117107694807169,0.2014136413415748,131711.68456424854,768.0126378844152,132479.69720213296,2365,9,587.2439024390244,38,3,16,34.639536497363295,0.6337719298245614,43.37606837606837,1026.4957264957254,27.013045434098036,0
2819,4,1,1,41,0.023809523809523808,0.023809523809523808,0.9761904761904762,42,1200,800,400,0.6666666666666666,16,8,8,334.3232986421607,0.4009993224932249,0.11733400912316294,0.1992809269549799,131996.29041883684,425.8870442708381,132422.17746310768,2366,0,574.2380952380952,39,3,16,34.510157965872615,0.6348824786324787,43.098958333333336,1027.604166666667,26.348824786324794,0
2820,4,0,0,41,0.0,0.0,1.0,41,650,300,350,0.46153846153846156,10,3,7,339.64344638323996,0.3968241869918699,0.115074457032603,0.2017400229722134,131862.5217013888,757.2482638888832,132619.76996527766,2367,11,589.2439024390244,39,2,16,34.5081135902637,0.6335470085470085,43.229166666666664,1027.0833333333326,26.335470085470067,0
2821,4,0,0,41,0.0,0.0,1.0,41,1150,900,250,0.782608695652174,14,9,5,339.38506302091434,0.39690040650406505,0.11419266121444593,0.2020720251555619,131953.8686049969,756.6344024720586,132710.50300746897,2368,12,590.2439024390244,40,1,16,34.42280745136826,0.6328125,43.14024390243902,1027.439024390243,25.685975609756078,0
2822,4,0,0,41,0.0,0.0,1.0,41,1350,900,450,0.6666666666666666,18,9,9,341.26669190181565,0.3959857723577236,0.11660831910810199,0.20403391579661737,132110.5368828078,816.9851774737202,132927.5220602815,2369,13,591.2439024390244,40,1,17,34.21683471727955,0.6343750000000001,42.98780487804878,1028.0487804878044,25.70121951219511,0
2823,4,1,1,41,0.023809523809523808,0.023809523809523808,0.9761904761904762,42,950,800,150,0.8421052631578947,11,8,3,334.24781692203146,0.4006847657762292,0.11486052191798435,0.2010915520368509,132346.95845930962,447.3363882590029,132794.2948475686,2370,0,578.1428571428571,41,1,17,34.159676693662426,0.6351626016260162,42.757936507936506,1028.9682539682537,25.09678668215253,0
2824,4,0,0,41,0.0,0.0,1.0,41,950,600,350,0.631578947368421,13,6,7,338.7765082322103,0.3959349593495935,0.11311906420121409,0.20324582334429164,132241.16478493286,760.0400100799774,133001.20479501283,2371,15,593.2439024390244,40,1,18,34.1494993907058,0.6356770833333334,42.860772357723576,1028.5569105691054,25.713922764227636,0
2825,4,0,0,41,0.0,0.0,1.0,41,1150,900,250,0.782608695652174,14,9,5,340.85389479122233,0.3956808943089431,0.11748160135629782,0.20548620514556523,132424.1522903032,827.4576145151487,133251.60990481835,2372,16,594.2439024390244,40,1,18,33.91217417061611,0.6375000000000002,42.68292682926828,1029.2682926829254,25.731707317073138,0
2826,4,0,1,40,0.0,0.024390243902439025,0.975609756097561,41,950,400,550,0.42105263157894735,15,4,11,339.14468767499955,0.3950711382113821,0.11204779833033207,0.2050247002102085,132528.77338224597,789.2858913345168,133318.0592735805,2373,17,595.2439024390244,40,1,18,33.851082379260426,0.6385416666666668,42.58130081300813,1029.674796747967,25.741869918699177,0
2827,4,0,1,39,0.0,0.025,0.975,40,800,600,200,0.75,10,6,4,345.7585184480951,0.39503205128205127,0.11369270464433878,0.208743520942121,132478.4193250866,1161.1083984374754,133639.52772352408,2374,18,605.525,39,1,18,33.73142854733716,0.639690170940171,42.63020833333332,1029.4791666666652,26.39690170940167,0
2828,4,1,1,39,0.025,0.025,0.975,40,950,700,250,0.7368421052631579,12,7,5,342.73028451794306,0.39706196581196584,0.12224441298412425,0.20780256183923587,132639.32427300338,1091.902669270823,133731.2269422742,2375,0,603.65,39,1,15,33.64776098021372,0.6412927350427351,42.47395833333333,1030.1041666666658,26.412927350427328,0
2829,4,1,1,39,0.025,0.025,0.975,40,900,400,500,0.4444444444444444,14,4,10,338.58607733497485,0.39727564102564106,0.12234660871323211,0.20587781580054704,132746.64849175327,989.23339843748,133735.88189019074,2376,0,604.625,39,1,15,33.64679150240912,0.6423611111111112,42.36979166666666,1030.5208333333317,26.423611111111068,0
2830,4,0,0,39,0.0,0.0,1.0,39,800,500,300,0.625,11,5,6,345.9590281718953,0.3933310841205578,0.1268013059800701,0.21010257353210032,132700.54879830495,1381.79058002773,134082.3393783327,2377,21,621.1282051282051,38,1,15,33.503128024332916,0.6436403508771931,42.4145299145299,1030.3418803418783,27.114260008996798,0
2831,4,0,0,39,0.0,0.0,1.0,39,1300,1100,200,0.8461538461538461,15,11,4,343.48237048587924,0.3932186234817814,0.12256027554535054,0.20921198929594445,132810.65088757378,1323.6234385272662,134134.27432610103,2378,22,622.1282051282051,38,1,15,33.45641583747927,0.6447368421052633,42.3076923076923,1030.7692307692294,27.125506072874458,0
2832,4,1,0,40,0.025,0.0,1.0,40,900,400,500,0.4444444444444444,14,4,10,337.15141622737855,0.3952590811965812,0.12363773965691216,0.20752612017474023,133203.26063368036,981.9335937499757,134185.19422743033,2379,0,607.55,39,1,16,33.226118398923646,0.6469017094017095,41.92708333333332,1032.2916666666652,26.469017094017055,0
2833,4,0,0,40,0.0,0.0,1.0,40,900,300,600,0.3333333333333333,15,3,12,333.0553781779519,0.3947516025641025,0.12038577912254134,0.20574729436974395,133337.70751953113,881.7681206597081,134219.47564019085,2380,1,608.55,39,1,17,33.1972810556396,0.6482371794871796,41.79687499999999,1032.812499999999,26.48237179487177,0
2834,4,0,0,40,0.0,0.0,1.0,40,900,500,400,0.5555555555555556,13,5,8,335.5601208200394,0.39459134615384617,0.1252429442778873,0.20820224815216387,133499.82336410595,959.5111883429198,134459.33455244885,2381,2,609.55,38,2,19,32.97042454943314,0.6515899122807018,41.63995726495725,1033.4401709401689,27.19579397210971,0
2835,4,0,0,40,0.0,0.0,1.0,40,900,500,400,0.5555555555555556,13,5,8,335.3635007625502,0.39409722222222227,0.11855688746512327,0.20870177471891935,133610.2564673277,961.6006693330298,134571.85713666075,2382,3,610.55,38,2,19,32.86508387585683,0.652686403508772,41.53311965811965,1033.8675213675208,27.20704003598739,0
2836,4,0,0,40,0.0,0.0,1.0,40,1050,700,350,0.6666666666666666,14,7,7,339.35520536800965,0.39340277777777777,0.1186073530930496,0.21213534238724566,133775.99172921682,1079.5158293154996,134855.50755853232,2383,4,611.55,38,2,16,32.596216737237086,0.6543311403508772,41.37286324786324,1034.5085470085464,27.223909131803854,0
2837,4,1,1,40,0.024390243902439025,0.024390243902439025,0.975609756097561,41,600,300,300,0.5,9,3,6,332.7820027440125,0.3946646341463415,0.1240730701584396,0.20981936926339362,134091.86333550356,724.6717664930607,134816.53510199662,2384,0,597.609756097561,39,2,17,32.45090767374032,0.655715811965812,41.067708333333336,1035.7291666666672,26.557158119658133,0
2838,4,0,0,40,0.0,0.0,1.0,40,450,200,250,0.4444444444444444,7,2,5,349.77346800240036,0.3945379273504273,0.11505812678218885,0.20736245001598752,131790.2425229284,1254.4670204674776,133044.70954339587,2099,1,553.95,36,4,18,34.320848870366305,0.6383101851851851,43.29954954954955,1026.8018018018024,28.52227227227229,5
2839,4,1,1,40,0.024390243902439025,0.024390243902439025,0.975609756097561,41,1150,1000,150,0.8695652173913043,13,10,3,341.32635296833257,0.3986788617886179,0.11499235665883334,0.2038423862140486,132068.34781804707,815.6815006574327,132884.0293187045,2100,0,541.4146341463414,38,3,18,34.257743477808944,0.6373355263157896,43.02884615384614,1027.8846153846132,27.049595141700348,0
2840,4,0,2,38,0.0,0.05,0.95,40,950,300,650,0.3157894736842105,16,3,13,351.6547244916441,0.3942574786324786,0.12089874207298057,0.20970655888934414,132013.44515897785,1284.6303373146118,133298.07549629247,2101,3,555.95,38,2,18,34.04763142391793,0.6367872807017545,43.08226495726495,1027.6709401709388,27.043972109761548,0
2841,4,0,0,38,0.0,0.0,1.0,38,1350,800,550,0.5925925925925926,19,8,11,361.42343407513647,0.3897729966808914,0.13416984518087216,0.21475851089246395,131876.97991488117,1932.686191258834,133809.66610614,2102,4,581.1315789473684,36,2,18,33.93428169425868,0.6391782407407407,43.215090090090094,1027.13963963964,28.53165665665667,0
2842,4,0,0,38,0.0,0.0,1.0,38,1100,900,200,0.8181818181818182,13,9,4,365.4056520923251,0.39024715504978663,0.14165537130497485,0.21778749675652942,131992.67415641993,2046.1738343072825,134038.84799072723,2103,5,582.1315789473684,36,2,18,33.71529680365296,0.6403356481481481,43.10247747747748,1027.5900900900901,28.54416916916917,0
2843,4,0,1,37,0.0,0.02631578947368421,0.9736842105263158,38,1150,800,350,0.6956521739130435,15,8,7,366.68198480257337,0.39063240872451394,0.13920813318493996,0.21888204547371393,132050.54029959007,2084.1108422611715,134134.65114185124,2104,6,583.1315789473684,36,2,18,33.6241371754136,0.6409143518518519,43.04617117117117,1027.8153153153148,28.550425425425413,0
2844,4,0,0,37,0.0,0.0,1.0,37,800,500,300,0.625,11,5,6,365.50945910617224,0.38948323323323325,0.1278389330081373,0.21885028662940706,132166.31063073204,2261.607342139438,134427.91797287148,2105,7,587.6216216216217,36,1,18,33.5375369619976,0.6420717592592593,42.93355855855856,1028.2657657657655,28.56293793793793,0
2845,4,2,1,38,0.05128205128205128,0.02564102564102564,0.9743589743589743,39,950,900,50,0.9473684210526315,10,9,1,353.7826665019874,0.3942026540710751,0.13843389315087418,0.2151694578233394,132755.59413580218,1593.934334108846,134349.52846991102,2106,0,558.4358974358975,35,4,17,33.24629380053907,0.6500000000000001,42.36111111111109,1030.5555555555532,29.444444444444375,0
2846,4,0,0,38,0.0,0.0,1.0,38,500,100,400,0.2,9,1,8,362.91451729522197,0.3905879563774301,0.14744810135821473,0.22006302159464275,132643.1565334466,2027.6254251700525,134670.78195861666,2107,1,574.1315789473684,34,4,17,33.12410917215609,0.6510416666666667,42.47023809523809,1030.1190476190466,30.297619047619015,0
2847,4,0,0,38,0.0,0.0,1.0,38,1100,900,200,0.8181818181818182,13,9,4,363.6025017437663,0.38999525841631105,0.14580944839079524,0.22149410947537482,132815.23946544906,2058.3906678669255,134873.63013331598,2108,2,575.1315789473684,35,3,19,32.933322104947976,0.6505952380952382,42.30324074074073,1030.7870370370358,29.451058201058167,0
2848,4,0,0,38,0.0,0.0,1.0,38,750,400,350,0.5333333333333333,11,4,7,359.58689122758216,0.39015825035561874,0.1415604013316285,0.21646278076664327,132369.03077063547,1919.633653924191,134288.66442455965,2109,3,576.1315789473684,36,2,21,33.48562778142555,0.6440972222222223,42.736486486486484,1029.0540540540537,28.584834834834826,2
2849,4,0,0,38,0.0,0.0,1.0,38,800,700,100,0.875,9,7,2,363.2473701095052,0.39021752015173067,0.1461015777956931,0.21900270203171998,132426.97934420893,2020.750395665923,134447.72973987486,2110,4,577.1315789473684,36,2,21,33.333105397520065,0.644675925925926,42.68018018018017,1029.2792792792782,28.59109109109106,0
2850,4,1,0,39,0.02564102564102564,0.0,1.0,39,1400,1100,300,0.7857142857142857,17,11,6,353.92485287460397,0.39268443544759335,0.14655755591925845,0.21547238452210332,132793.26331178815,1599.7672360726278,134393.03054786078,2111,0,563.3076923076923,37,2,18,33.204787234042556,0.6463963963963963,42.32456140350877,1030.7017543859643,27.856804172593627,0
2851,4,1,0,40,0.025,0.0,1.0,40,1000,700,300,0.7,13,7,6,346.58155344905964,0.3967681623931624,0.1519179004037683,0.21281825967987725,133113.66705246922,1226.9483024691444,134340.61535493837,2112,0,550.2,38,2,21,33.07256617317183,0.6477521929824561,42.01388888888889,1031.9444444444453,27.156432748538034,0
2852,4,0,0,40,0.0,0.0,1.0,40,850,600,250,0.7058823529411765,11,6,5,344.7801707573096,0.39615384615384613,0.15156039747438177,0.2120255397636135,133168.79799702315,1182.792182591862,134351.590179615,2113,1,551.2,38,2,21,33.06377876686333,0.6483004385964912,41.960470085470085,1032.1581196581196,27.162055780476834,0
2853,4,0,0,40,0.0,0.0,1.0,40,950,700,250,0.7368421052631579,12,7,5,345.82230669662977,0.396207264957265,0.1548126681846409,0.2128238934587793,133196.36774965294,1212.4550277595104,134408.82277741245,2114,2,552.2,38,2,21,33.009254467674054,0.6485745614035088,41.93376068376068,1032.2649572649568,27.164867296446232,0
2854,4,0,0,40,0.0,0.0,1.0,40,900,700,200,0.7777777777777778,11,7,4,347.50701239662374,0.39619391025641026,0.1582660664389941,0.2140191370802152,133223.94035585146,1259.2506985535883,134483.19105440506,2115,3,553.2,38,2,21,32.938140329090345,0.6488486842105262,41.907051282051285,1032.3717948717951,27.167678812415662,0
2855,4,1,1,40,0.024390243902439025,0.024390243902439025,0.975609756097561,41,900,700,200,0.7777777777777778,11,7,4,339.7820765378717,0.3988821138211382,0.15507562475564218,0.21051208102305766,133445.31385633696,868.465169270853,134313.7790256078,2116,0,540.6829268292682,39,2,21,32.91588953859598,0.6493055555555556,41.69270833333334,1033.229166666668,26.493055555555593,0
2856,4,0,0,40,0.0,0.0,1.0,40,900,800,100,0.8888888888888888,10,8,2,343.75463587854466,0.3952323717948718,0.16223239218119767,0.21265281985346451,133389.43591798167,1170.6473948060568,134560.08331278773,2117,5,555.2,38,2,21,32.869221222463544,0.6504934210526315,41.746794871794876,1033.012820512821,27.184547908232133,0
2857,4,0,0,40,0.0,0.0,1.0,40,800,500,300,0.625,11,5,6,344.4014420017776,0.3953525641025641,0.16245604963805604,0.21321139207152282,133417.02849915982,1189.8034005405698,134606.8318997004,2118,6,556.2,38,2,21,32.82488796966563,0.6507675438596492,41.720085470085465,1033.1196581196573,27.187359424201507,0
2858,4,0,0,40,0.0,0.0,1.0,40,1050,900,150,0.8571428571428571,12,9,3,346.01516776093325,0.3951388888888889,0.16288129459207945,0.21436980700935201,133444.62393390675,1234.7727874570826,134679.39672136382,2119,7,557.2,38,2,21,32.75557508702995,0.6510416666666666,41.69337606837607,1033.2264957264956,27.190170940170937,0
2859,4,0,0,40,0.0,0.0,1.0,40,1400,1100,300,0.7857142857142857,17,11,6,347.2203596864989,0.39485844017094013,0.16002333474756059,0.21593625007416292,133585.55036164966,1276.7274226667316,134862.2777843164,2120,8,558.2,37,3,22,32.5833510111724,0.6542792792792793,41.557017543859644,1033.7719298245606,27.939781887150286,0
2860,4,1,1,40,0.024390243902439025,0.024390243902439025,0.975609756097561,41,1500,1200,300,0.8,18,12,6,339.43402792133907,0.3971798780487805,0.14590857496646348,0.21346237278297836,133997.13187824166,896.63724066769,134893.76911890935,2121,0,545.560975609756,38,3,18,32.373250094589466,0.6565241228070176,41.159188034188034,1035.363247863248,27.24640125955916,0
2861,4,0,0,40,0.0,0.0,1.0,40,1150,800,350,0.6956521739130435,15,8,7,351.2432320287266,0.39511217948717947,0.10852201911092663,0.21083353104567204,132260.59701219955,1292.2693403462617,133552.8663525458,2122,10,560.2,38,2,20,33.80937543276554,0.6392543859649124,42.84188034188034,1028.6324786324785,27.069275753486277,3
2862,4,0,0,40,0.0,0.0,1.0,40,1050,700,350,0.6666666666666666,14,7,7,346.35530202481215,0.39548611111111115,0.10032703488372063,0.20850589181893678,132370.51647308056,1169.4460424428332,133539.9625155234,2123,11,561.2,38,2,20,33.824534537652255,0.6403508771929824,42.73504273504273,1029.0598290598289,27.080521817363916,0
2863,4,0,0,40,0.0,0.0,1.0,40,1250,900,350,0.72,16,9,7,349.90705676739003,0.39447115384615383,0.1003035143769968,0.21143032580732266,132510.87474030483,1273.300887579037,133784.17562788387,2124,12,562.2,37,3,20,33.592030528931495,0.643581081081081,42.59868421052632,1029.6052631578957,27.82716927453772,0
2864,4,0,0,40,0.0,0.0,1.0,40,550,300,250,0.5454545454545454,8,3,5,348.81032654612005,0.394284188034188,0.09762272388457038,0.21092580660622098,132539.10007165666,1246.2013552246854,133785.30142688134,2125,13,563.2,37,3,20,33.591892059773556,0.6438626126126126,42.57127192982456,1029.7149122807016,27.830132764343286,0
2865,4,0,0,40,0.0,0.0,1.0,40,1550,1200,350,0.7741935483870968,19,12,7,344.73739656061775,0.3937232905982906,0.10060646900269576,0.20966815430162183,132755.59413580265,1153.163580246935,133908.7577160496,2126,14,564.2,38,2,16,33.47933513027855,0.644188596491228,42.36111111111112,1030.555555555557,27.11988304093571,0
2866,4,0,0,40,0.0,0.0,1.0,40,800,700,100,0.875,9,7,2,345.91183851640073,0.3934428418803419,0.10383279776096188,0.21053700354370478,132783.1210849041,1186.2507076850193,133969.3717925891,2127,15,565.2,38,2,16,33.42144362668877,0.6444627192982455,42.33440170940172,1030.6623931623944,27.122694556905117,0
2867,4,0,0,40,0.0,0.0,1.0,40,750,600,150,0.8,9,6,3,344.8073236865419,0.39366987179487184,0.09612953367875665,0.21032810831701212,132865.71905361983,1162.6145993133355,134028.33365293316,2128,16,566.2,38,2,16,33.36701208981003,0.6452850877192982,42.25427350427351,1030.9829059829071,27.131129104813347,0
2868,4,0,0,40,0.0,0.0,1.0,40,1350,900,450,0.6666666666666666,18,9,9,349.5031879501622,0.3937366452991453,0.10014762250077691,0.21366398184185692,132948.34270445263,1293.1739215793903,134241.516626032,2129,17,567.2,38,2,16,33.16304948375289,0.6461074561403508,42.17414529914531,1031.30341880342,27.13956365272158,0
2869,4,1,1,40,0.024390243902439025,0.024390243902439025,0.975609756097561,41,550,500,50,0.9090909090909091,6,5,1,345.6137139189622,0.3960619918699187,0.07313713633004082,0.2136750479484388,133367.22932778118,1019.7388268609755,134386.96815464215,2130,0,554.3414634146342,40,1,19,32.84345074117802,0.6468749999999999,41.768292682926834,1032.9268292682934,25.823170731707336,7
2870,4,1,1,40,0.024390243902439025,0.024390243902439025,0.975609756097561,41,1150,1000,150,0.8695652173913043,13,10,3,342.006036769414,0.39446138211382115,0.08141295206055554,0.21220585230755254,133500.54974848012,931.722719369293,134432.2724678494,2131,0,554.8536585365854,37,4,19,32.80316091954024,0.6534346846846848,41.639254385964904,1033.442982456139,27.930891417733484,0
2871,4,0,0,40,0.0,0.0,1.0,40,950,800,150,0.8421052631578947,11,8,3,333.82627373164,0.3929220085470086,0.05144963279622883,0.19866256329117774,131934.82069485038,825.5691591014172,132760.38985395178,2132,2,569.725,36,4,16,34.584749168767566,0.6397569444444444,43.15878378378379,1027.364864864866,28.537912912912944,4
2872,4,0,0,40,0.0,0.0,1.0,40,800,400,400,0.5,12,4,8,332.0260497161925,0.3929220085470086,0.051525943641468785,0.197714830967221,131958.55391418273,762.7354764774495,132721.28939066018,2133,3,570.725,38,2,16,34.607119337284686,0.6362390350877194,43.135683760683754,1027.4572649572635,27.038349077822726,0
2873,4,0,0,40,0.0,0.0,1.0,40,1100,800,300,0.7272727272727273,14,8,6,333.2433001656708,0.3931356837606838,0.04825605572304825,0.1987270492432476,132013.44515897793,798.519226203513,132811.96438518146,2134,4,571.725,38,2,17,34.520653567591914,0.6367872807017544,43.082264957264954,1027.6709401709395,27.043972109761565,0
2874,4,0,0,40,0.0,0.0,1.0,40,1000,700,300,0.7,13,7,6,335.0397301399898,0.39375,0.041898701298701324,0.20066940899797162,132178.18737900877,856.9888459712281,133035.17622498,2135,5,572.725,38,2,18,34.308874458874456,0.6384320175438596,42.92200854700855,1028.3119658119665,27.060841205578065,0
2875,4,0,0,40,0.0,0.0,1.0,40,1000,700,300,0.7,13,7,6,335.8434237989292,0.394284188034188,0.041850140201474595,0.20173651452026783,132288.07259706708,885.6158457520712,133173.68844281914,2136,6,573.725,38,2,18,34.177787586111386,0.6395285087719298,42.815170940170944,1028.739316239317,27.07208726945571,0
2876,4,1,1,40,0.024390243902439025,0.024390243902439025,0.975609756097561,41,800,500,300,0.625,11,5,6,328.3902372776178,0.3960365853658536,0.037579003971954794,0.19828012461733452,132482.65241468523,501.29324651920524,132983.94566120443,2137,0,560.7073170731708,37,4,18,34.174188766996835,0.6432995495495495,42.62609649122807,1029.4956140350873,27.82420578473209,0
2877,4,0,0,40,0.0,0.0,1.0,40,900,700,200,0.7777777777777778,11,7,4,337.86555693053054,0.3942574786324786,0.03348922437370083,0.2038567033598667,132455.95838659615,950.4612298109014,133406.41961640705,2138,8,575.725,36,4,19,33.95712540568137,0.6449652777777778,42.65202702702703,1029.3918918918926,28.594219219219237,0
2878,4,0,0,40,0.0,0.0,1.0,40,900,600,300,0.6666666666666666,12,6,6,338.3582615930661,0.3940438034188034,0.02901902887139074,0.2046261867729497,132542.9145361579,969.3980297865517,133512.31256594448,2139,9,576.725,36,4,19,33.85712853601632,0.6458333333333334,42.56756756756757,1029.7297297297307,28.60360360360363,0
2879,4,0,0,40,0.0,0.0,1.0,40,950,700,250,0.7368421052631579,12,7,5,342.15869855453786,0.39310897435897435,0.030411018801924206,0.20756417601968938,132658.90045450866,1078.0793462381484,133736.9798007468,2140,10,577.725,36,4,18,33.64282721177671,0.6469907407407407,42.454954954954964,1030.1801801801812,28.616116116116146,0
2880,4,1,0,41,0.024390243902439025,0.0,1.0,41,1350,1100,250,0.8148148148148148,16,11,5,335.34791514620747,0.39443597560975613,0.026088512187343316,0.20524514234094848,132991.11415291263,719.65857283012,133710.77272574275,2141,0,564.609756097561,37,4,19,33.485148470996776,0.648367117117117,42.1326754385965,1031.4692982456156,27.877548601232853,0
2881,4,0,0,41,0.0,0.0,1.0,41,800,600,200,0.75,10,6,4,337.1258710730384,0.39397865853658537,0.029084463119193327,0.20701200182418839,133113.66705246933,775.2121913580473,133888.87924382737,2142,1,565.609756097561,38,3,19,33.316509645580986,0.647752192982456,42.0138888888889,1031.9444444444462,27.156432748538055,0
2882,4,0,0,41,0.0,0.0,1.0,41,750,400,350,0.5333333333333333,11,4,7,335.93028408797335,0.39372459349593497,0.026310347883454988,0.20647625649774473,133149.50086805574,745.7899305555793,133895.29079861133,2143,2,566.609756097561,39,2,19,33.31146548243845,0.6463675213675213,41.97916666666668,1032.0833333333348,26.463675213675252,0
2883,4,0,0,41,0.0,0.0,1.0,41,1250,700,550,0.56,18,7,11,334.54470659752076,0.39341971544715443,0.03278285053284402,0.20592161753921956,133203.2606336807,712.4891493055745,133915.74978298627,2144,3,567.609756097561,39,2,19,33.29339051463168,0.6469017094017093,41.92708333333334,1032.291666666668,26.46901709401713,0
2884,4,0,0,41,0.0,0.0,1.0,41,1200,900,300,0.75,15,9,6,338.83937671926884,0.3929878048780488,0.029187598714800922,0.2091689651802515,133310.81271701423,834.1905381944823,134145.00325520872,2145,4,568.609756097561,39,2,19,33.07486046668013,0.6479700854700854,41.822916666666686,1032.708333333336,26.479700854700923,0
2885,4,0,0,41,0.0,0.0,1.0,41,800,500,300,0.625,11,5,6,338.7645602592191,0.3919715447154472,0.030316891190690587,0.20972951989082023,133418.40820312526,839.4856770833617,134257.89388020863,2146,5,569.609756097561,39,2,19,32.96909659205486,0.6490384615384615,41.718750000000014,1033.125000000002,26.490384615384666,0
2886,4,0,1,40,0.0,0.024390243902439025,0.975609756097561,41,1150,700,450,0.6086956521739131,16,7,9,341.7926777919915,0.39189532520325204,0.029359709591866068,0.21224446527570343,133530.41174620565,927.975951563894,134458.38769776953,2147,6,570.609756097561,36,5,19,32.77879167574637,0.6556712962962963,41.61036036036036,1033.5585585585584,28.709959959959956,0
2887,4,0,0,40,0.0,0.0,1.0,40,800,400,400,0.5,12,4,8,350.5152497402566,0.38855502136752135,0.0372744228248818,0.21716182149741464,133445.31385633696,1354.9235026041852,134800.23735894114,2148,7,585.0,39,1,19,32.63864384850625,0.6493055555555554,41.69270833333334,1033.229166666668,26.493055555555593,0
2888,4,0,0,40,0.0,0.0,1.0,40,1300,900,400,0.6923076923076923,17,9,8,349.58040829500516,0.3875534188034188,0.036519607843137125,0.2174219612566496,133588.61395178968,1340.0005797869276,134928.6145315766,2149,8,586.0,36,4,20,32.51929012345679,0.65625,41.554054054054056,1033.7837837837842,28.716216216216228,0
2889,4,0,0,40,0.0,0.0,1.0,40,750,600,150,0.8,9,6,3,349.58040829500516,0.3875534188034188,0.036519607843137125,0.2174219612566496,133588.61395178968,1339.992441766094,134928.60639355576,2150,9,587.0,36,4,20,32.51929012345679,0.65625,41.554054054054056,1033.7837837837842,28.716216216216228,0
2890,4,0,0,40,0.0,0.0,1.0,40,800,500,300,0.625,11,5,6,347.9073036033444,0.3877136752136752,0.03673491614027502,0.21672217514829775,133646.82883897412,1299.3415713010393,134946.17041027517,2151,10,588.0,36,4,21,32.5042655921005,0.6568287037037037,41.49774774774775,1034.0090090090093,28.722472472472482,0
2891,4,0,0,40,0.0,0.0,1.0,40,850,600,250,0.7058823529411765,11,6,5,346.84881258422485,0.3873397435897436,0.04299324912892022,0.21640349828624458,133705.05640775908,1275.0880103076036,134980.1444180667,2152,11,589.0,36,4,17,32.47336853948897,0.6574074074074074,41.44144144144144,1034.234234234234,28.728728728728722,0
2892,4,1,0,41,0.024390243902439025,0.0,1.0,41,1250,1100,150,0.88,14,11,3,340.27100227117205,0.38856707317073175,0.04583599155911067,0.21406922547945903,134010.95920138896,920.00868055556,134930.96788194453,2153,0,575.609756097561,37,4,19,32.33777665995975,0.6585022522522522,41.145833333333336,1035.4166666666672,27.984234234234247,0
2893,4,0,0,41,0.0,0.0,1.0,41,1100,800,300,0.7272727272727273,14,8,6,340.9913063851188,0.3884146341463415,0.047406535056456534,0.21468812650007058,134039.343836565,941.250192366874,134980.59402893187,2154,1,576.609756097561,37,4,19,32.290784272201044,0.6587837837837838,41.118421052631575,1035.5263157894728,27.987197724039806,0
2894,4,0,0,41,0.0,0.0,1.0,41,1450,1100,350,0.7586206896551724,18,11,7,340.3991172145495,0.38704268292682925,0.049824838383070835,0.2155716624549685,134253.74484592027,939.9712456597415,135193.71609158002,2155,2,577.609756097561,39,2,20,32.0921072469595,0.6573183760683761,40.91145833333334,1036.3541666666679,26.573183760683794,0
2895,4,0,1,40,0.0,0.024390243902439025,0.975609756097561,41,700,400,300,0.5714285714285714,10,4,6,340.60565750167973,0.3865853658536585,0.04371665061239094,0.21602083478643824,134307.72705078125,949.1943359374994,135256.92138671875,2156,3,578.609756097561,39,2,20,32.03289870364787,0.6578525641025641,40.859375,1036.5625,26.578525641025642,0
2896,4,0,0,40,0.0,0.0,1.0,40,1150,900,250,0.782608695652174,14,9,5,344.3772007565743,0.3873130341880342,0.04838211046990892,0.21870656781032688,134356.87413251505,1253.8888432317783,135610.76297574682,2157,4,586.85,38,2,20,31.886120843638345,0.6600877192982457,40.811965811965806,1036.752136752136,27.282950967161476,0
2897,4,0,0,40,0.0,0.0,1.0,40,1050,800,250,0.7619047619047619,13,8,5,346.6586812085002,0.38684561965811964,0.05233546194252736,0.22099206407441443,134495.3649485902,1324.7971683468566,135820.16211693705,2158,5,587.85,38,2,21,31.68881106876781,0.6614583333333333,40.67841880341881,1037.2863247863256,27.29700854700857,0
2898,4,0,0,40,0.0,0.0,1.0,40,1200,900,300,0.75,15,9,6,344.87586858108085,0.3865785256410256,0.05588333705108206,0.2205532837159751,134610.82845721883,1284.8395197431514,135895.66797696197,2159,6,588.85,35,5,21,31.619915978883206,0.6684523809523808,40.56712962962963,1037.7314814814818,29.649470899470906,0
2899,4,1,1,40,0.024390243902439025,0.024390243902439025,0.975609756097561,41,1000,900,100,0.9,11,9,2,334.4084766884108,0.3909806910569105,0.0524975867172921,0.2156923292459288,134920.75837036403,823.7290560557212,135744.48742641974,2160,0,575.4634146341464,37,4,16,31.583003518029912,0.6675112612612611,40.2686403508772,1038.9254385964919,28.079065908013295,0
2900,4,0,0,40,0.0,0.0,1.0,40,800,400,400,0.5,12,4,8,343.29381509267444,0.38613782051282053,0.049848189112990715,0.22077095974788347,134813.78971877307,1256.1480399318516,136069.9377587049,2161,8,590.85,36,4,17,31.45873996963783,0.6684027777777777,40.371621621621635,1038.5135135135154,28.847597597597648,0
2901,4,0,0,40,0.0,0.0,1.0,40,1100,800,300,0.7272727272727273,14,8,6,342.3077571941686,0.38565705128205124,0.043453284196834696,0.2208483474037344,134930.76480196434,1237.5694951708701,136168.3342971352,2162,9,591.85,36,4,18,31.367873401257317,0.6695601851851851,40.25900900900902,1038.9639639639656,28.860110110110156,0
2902,4,0,0,40,0.0,0.0,1.0,40,850,400,450,0.47058823529411764,13,4,9,343.0828504057923,0.3852163461538462,0.04457416838227335,0.2218858883248117,135018.52940355928,1264.5083850743013,136283.03778863358,2163,10,592.85,36,4,18,31.260383934698616,0.6704282407407405,40.17454954954957,1039.3018018018042,28.86949449449456,0
2903,4,0,1,39,0.0,0.025,0.975,40,1200,800,400,0.6666666666666666,16,8,8,343.3319544901426,0.38565705128205124,0.04473947895791608,0.22249694193581987,135091.68836805562,1276.2586805555661,136367.94704861118,2164,11,593.85,37,3,18,31.181112224448892,0.6692004504504503,40.10416666666667,1039.583333333334,28.096846846846862,0
2904,4,0,1,38,0.0,0.02564102564102564,0.9743589743589743,39,700,500,200,0.7142857142857143,9,5,4,324.18689227527267,0.3855994152046784,0.07426805664786995,0.20386965031319138,133996.38447569194,890.1444307483227,134886.52890644028,2165,12,592.2307692307693,36,3,19,32.76865346965415,0.6603009259259258,41.15990990990991,1035.3603603603606,28.760010010010017,7
2905,4,0,0,38,0.0,0.0,1.0,38,1250,1100,150,0.88,14,11,3,333.1031416447507,0.38319404931247036,0.08397811185313708,0.20938914982517895,133981.000902885,1325.8984642918392,135306.89936717684,2166,25,608.5,35,3,19,32.553218744177386,0.6622023809523809,41.17476851851852,1035.3009259259263,29.580026455026466,0
2906,4,0,0,38,0.0,0.0,1.0,38,950,700,250,0.7368421052631579,12,7,5,331.9233618957531,0.382823613086771,0.0886338373590696,0.20932925761839996,134100.85419077936,1302.2412712191374,135403.09546199848,2167,26,609.5,35,3,19,32.46417197452228,0.6633928571428571,41.05902777777778,1035.7638888888891,29.593253968253975,0
2907,4,0,0,38,0.0,0.0,1.0,38,1250,1000,250,0.8,15,10,5,331.1328060043717,0.382216097676624,0.09069160504567164,0.2096862195872097,134250.7461526921,1290.9652563443133,135541.71140903642,2168,27,610.5,35,3,20,32.33517608517609,0.6648809523809524,40.914351851851855,1036.342592592593,29.60978835978837,0
2908,4,0,0,38,0.0,0.0,1.0,38,1250,1000,250,0.8,15,10,5,330.55854825766255,0.38162339971550496,0.0918525657600906,0.2096658893906249,134310.72638031546,1279.5117455418374,135590.23812585732,2169,28,611.5,35,3,21,32.29027095429507,0.6654761904761904,40.85648148148148,1036.5740740740737,29.616402116402107,0
2909,4,0,0,38,0.0,0.0,1.0,38,1100,800,300,0.7272727272727273,14,8,6,327.51116908904106,0.38080844001896635,0.0772029672440222,0.20858760385265798,134460.73555652009,1207.4785397376581,135668.21409625775,2170,29,612.5,35,3,22,32.2198275862069,0.6669642857142857,40.71180555555556,1037.1527777777778,29.63293650793651,0
2910,4,0,0,38,0.0,0.0,1.0,38,1200,1000,200,0.8333333333333334,14,10,4,324.7832790902464,0.3802157420578473,0.07551295975577532,0.20753257997463012,134580.80317911954,1141.9189118227068,135722.72209094223,2171,30,613.5,35,3,22,32.171058746978986,0.6681547619047619,40.59606481481482,1037.615740740741,29.646164021164033,0
2911,4,0,0,38,0.0,0.0,1.0,38,850,700,150,0.8235294117647058,10,7,3,324.7387280854276,0.3801120199146515,0.075144372975257,0.20801835096215118,134670.88906035668,1146.570644718794,135817.45970507548,2172,31,614.5,35,3,22,32.0825899494499,0.669047619047619,40.50925925925926,1037.962962962963,29.65608465608466,0
2912,4,0,0,38,0.0,0.0,1.0,38,1000,700,300,0.7,13,7,6,326.9119422211948,0.37972676623992413,0.07641316845390356,0.21010415083155876,134791.0504543896,1212.9608196159143,136004.01127400552,2173,32,615.5,35,3,18,31.906672611086343,0.6702380952380952,40.39351851851852,1038.425925925926,29.669312169312175,0
2913,4,0,0,38,0.0,0.0,1.0,38,700,500,200,0.7142857142857143,9,5,4,327.31651678680345,0.3791785206258891,0.07900014660606969,0.21088770553923614,134881.20666420183,1229.7693490655001,136110.97601326733,2174,33,616.5,35,3,19,31.80652274837513,0.6711309523809523,40.30671296296296,1038.773148148148,29.6792328042328,0
2914,4,0,1,37,0.0,0.02631578947368421,0.9736842105263158,38,700,600,100,0.8571428571428571,8,6,2,329.57704382577384,0.37903034613560926,0.08227165328940012,0.2126968456092001,134941.32754897553,1294.7127647033674,136236.0403136789,2175,34,617.5,35,3,19,31.68804073372692,0.6717261904761904,40.248842592592595,1039.00462962963,29.68584656084657,0
2915,4,0,0,37,0.0,0.0,1.0,37,1000,500,500,0.5,15,5,10,337.5177540765493,0.377784034034034,0.0845872230240785,0.21751698095066238,134890.65334467115,1705.5980725623517,136596.2514172335,2176,35,615.7567567567568,34,3,19,31.532202612881033,0.6734068627450981,40.297619047619044,1038.8095238095234,30.553221288515395,0
2916,4,0,0,37,0.0,0.0,1.0,37,1000,900,100,0.9,11,9,2,339.875846377738,0.3778778778778779,0.09016233555126907,0.2195985390844761,134983.4201388887,1775.520833333309,136758.94097222202,2177,36,616.7567567567568,34,3,19,31.37864207431168,0.674325980392157,40.20833333333332,1039.1666666666652,30.563725490196035,0
2917,4,0,0,37,0.0,0.0,1.0,37,900,600,300,0.6666666666666666,12,6,6,341.07086857999104,0.37762762762762764,0.0934645986192375,0.2205591616817274,135014.3494897957,1809.8922902494082,136824.24178004512,2178,37,617.7567567567568,34,3,19,31.316819396716305,0.6746323529411766,40.178571428571416,1039.2857142857129,30.56722689075626,0
2918,4,0,0,37,0.0,0.0,1.0,37,750,600,150,0.8,9,6,3,340.00612957873847,0.37728353353353355,0.09459923788179458,0.2200588226354308,135045.28238378663,1783.244756235802,136828.52714002243,2179,38,618.7567567567568,34,3,19,31.313709769785834,0.6749387254901962,40.14880952380951,1039.40476190476,30.570728291316474,0
2919,4,0,0,37,0.0,0.0,1.0,37,850,600,250,0.7058823529411765,11,6,5,337.43733563445113,0.3773460960960961,0.08987352737352738,0.21933426816239288,135199.99999999977,1724.3055555555266,136924.3055555553,2180,39,619.7567567567568,34,3,20,31.226629273504276,0.6764705882352943,39.999999999999986,1039.9999999999982,30.588235294117595,0
2920,4,0,0,37,0.0,0.0,1.0,37,650,400,250,0.6153846153846154,9,4,5,336.9869215919402,0.377220970970971,0.09179807310648402,0.21948104719335926,135272.23186728387,1716.994598765421,136989.2264660493,2181,40,620.7567567567568,35,2,20,31.1665554072096,0.675,39.93055555555555,1040.2777777777771,29.722222222222204,0
2921,4,0,0,37,0.0,0.0,1.0,37,550,500,50,0.9090909090909091,6,5,1,336.16278922506064,0.3760322822822823,0.09190151005097635,0.21967847388893463,135392.661179698,1702.794924554159,137095.45610425217,2182,41,621.7567567567568,35,2,21,31.068357058125738,0.6761904761904762,39.8148148148148,1040.740740740739,29.735449735449688,0
2922,4,0,0,37,0.0,0.0,1.0,37,1000,700,300,0.7,13,7,6,338.076247909006,0.37571946946946944,0.09741266388665282,0.22167156896424325,135513.14407578867,1762.7550582990302,137275.8991340877,2183,42,622.7567567567568,35,2,22,30.89891803764635,0.6773809523809524,39.69907407407407,1041.203703703703,29.74867724867723,0
2923,4,0,0,37,0.0,0.0,1.0,37,1200,900,300,0.75,15,9,6,339.413075258538,0.37534409409409414,0.10175905430933763,0.22311017269916594,135603.5414121441,1805.1230013288623,137408.664413473,2184,43,623.7567567567568,35,2,22,30.774368448346113,0.6782738095238096,39.61226851851851,1041.5509259259252,29.75859788359786,0
2924,4,0,0,37,0.0,0.0,1.0,37,700,500,200,0.7142857142857143,9,5,4,340.1918210996105,0.37493743743743746,0.10080701201715936,0.22400441131999188,135664.68431122453,1830.406551927617,137495.09086315215,2185,44,624.7567567567568,34,3,22,30.693396945111026,0.6810661764705882,39.55357142857143,1041.7857142857147,30.64075630252102,0
2925,4,0,0,37,0.0,0.0,1.0,37,950,800,150,0.8421052631578947,11,8,3,342.9184832870923,0.375,0.11867039453246386,0.21618773946360156,134088.01020408157,1796.251417233556,135884.26162131512,2186,45,625.7567567567568,34,3,17,32.19228927203065,0.6654411764705883,41.07142857142857,1035.714285714285,30.46218487394956,2
2926,4,0,0,37,0.0,0.0,1.0,37,1300,1100,200,0.8461538461538461,15,11,4,347.5592581840341,0.3747497497497498,0.1272663498458837,0.2204077538971874,134303.87081916092,1935.7107426303755,136239.5815617913,2187,46,626.7567567567568,34,3,19,31.85655219937981,0.6675857843137255,40.863095238095234,1036.5476190476184,30.486694677871128,0
2927,4,0,0,37,0.0,0.0,1.0,37,950,600,350,0.631578947368421,13,6,7,346.3828951313574,0.375,0.12861736334405194,0.2198471028282696,134334.72222222213,1906.2499999999898,136240.97222222213,2188,47,627.7567567567568,34,3,19,31.85624330117899,0.6678921568627452,40.83333333333333,1036.6666666666658,30.49019607843135,0
2928,4,0,0,37,0.0,0.0,1.0,37,1050,800,250,0.7619047619047619,13,8,5,346.4896506150351,0.3749061561561562,0.12975083247215569,0.22010053736005383,134365.57716836722,1911.2563775510093,136276.83354591823,2189,48,628.7567567567568,34,3,19,31.822683430933523,0.6681985294117647,40.80357142857142,1036.7857142857133,30.493697478991567,0
2929,4,0,1,36,0.0,0.02702702702702703,0.972972972972973,37,900,600,300,0.6666666666666666,12,6,6,346.9973934760744,0.3744369369369369,0.12723893679007925,0.2207957848480703,134427.2976899092,1929.184382086156,136356.48207199536,2190,49,629.7567567567568,34,3,19,31.74793364711286,0.6688112745098039,40.74404761904761,1037.0238095238087,30.50070028011202,0
2930,4,0,0,36,0.0,0.0,1.0,36,900,700,200,0.7777777777777778,11,7,4,333.23743788642213,0.3742063492063492,0.056962262735389624,0.19980754878938892,132219.3889853393,1612.0900848765255,133831.4790702158,2191,50,645.6944444444445,35,1,22,34.31380823767725,0.6446428571428573,42.881944444444436,1028.4722222222206,29.384920634920586,6
2931,4,0,0,36,0.0,0.0,1.0,36,1050,700,350,0.6666666666666666,14,7,7,332.9416781282542,0.37427248677248676,0.05414948131483577,0.20026058988905143,132338.45191400888,1612.1972522290785,133950.64916623797,2192,51,646.6944444444445,35,1,22,34.20181852268467,0.6458333333333334,42.7662037037037,1028.935185185185,29.39814814814814,0
2932,4,0,0,36,0.0,0.0,1.0,36,800,400,400,0.5,12,4,8,332.5574765299148,0.37334656084656087,0.05437551509702576,0.20129907660974034,132576.73852237655,1617.8771219135788,134194.6156442901,2193,52,647.6944444444445,35,1,22,33.97252191503709,0.6482142857142856,42.53472222222222,1029.861111111111,29.424603174603174,0
2933,4,1,0,37,0.02702702702702703,0.0,1.0,37,1250,900,350,0.72,16,9,7,334.2444924042231,0.3790978478478479,0.013209121658742218,0.19562438105278715,131299.26960321833,1377.2115443146054,132676.48114753293,2194,0,631.1621621621622,36,1,18,35.214079038933434,0.6333912037037036,43.77815315315316,1024.8873873873893,28.469094094094146,4
2934,4,0,0,37,0.0,0.0,1.0,37,750,500,250,0.6666666666666666,10,5,5,334.37837469440194,0.37903528528528524,0.010911735458687843,0.19629368804594036,131414.71021274675,1388.4474423748366,132803.15765512158,2195,1,632.1621621621622,36,1,18,35.094270547318324,0.6345486111111109,43.665540540540555,1025.3378378378397,28.48160660660666,0
2935,4,0,0,37,0.0,0.0,1.0,37,1250,1100,150,0.88,14,11,3,333.8872677819802,0.3793793793793794,0.006445180358223501,0.1964499505787002,131501.32395909438,1381.3235532830274,132882.6475123774,2196,2,633.1621621621622,36,1,19,35.01957985653636,0.6354166666666665,43.58108108108109,1025.675675675677,28.490990990991026,0
2936,4,0,0,37,0.0,0.0,1.0,37,1150,700,450,0.6086956521739131,16,7,9,362.0915060592519,0.3793793793793794,0.01920507331017296,0.1969296462863644,128429.74044568237,1915.3235583556766,130345.06400403805,2197,3,634.1621621621622,36,1,12,37.41783320371811,0.6044560185185184,46.59346846846848,1013.6261261261277,28.156281281281323,7
2937,4,0,0,37,0.0,0.0,1.0,37,850,500,350,0.5882352941176471,12,5,7,360.1074876440717,0.37916041041041043,0.02669084010709999,0.1962716597304617,128515.36502718965,1855.8690447204333,130371.23407191008,2198,4,635.1621621621622,36,1,12,37.38060861839185,0.605324074074074,46.50900900900903,1013.9639639639663,28.16566566566573,0
2938,4,1,1,37,0.02631578947368421,0.02631578947368421,0.9736842105263158,38,1000,700,300,0.7,13,7,6,350.64771492146684,0.38470542911332384,0.03095373422757719,0.19281459858508238,128867.1754770701,1437.3961218836798,130304.57159895377,2199,0,619.421052631579,37,1,12,37.26151907847373,0.6069819819819818,46.1622807017544,1015.3508771929843,27.441915599810386,0
2939,4,3,0,40,0.075,0.0,1.0,40,600,400,200,0.6666666666666666,8,4,4,338.6277497027348,0.39397702991452993,0.054299568965517464,0.18885009118037144,129424.43828870427,766.2069098184129,130190.64519852269,2200,0,589.375,37,3,15,36.99982040229886,0.6126126126126126,45.6140350877193,1017.5438596491232,27.50118539592225,0
2940,4,1,2,39,0.024390243902439025,0.04878048780487805,0.9512195121951219,41,1150,700,450,0.6086956521739131,16,7,9,329.8697234734502,0.4004573170731707,0.053149500556358475,0.1853451864065616,129717.84056770045,357.99763952809786,130075.83820722855,2201,0,575.9756097560976,38,3,11,36.92492571228806,0.6137609649122806,45.325854700854705,1018.6965811965821,26.807804768331106,0
2941,4,3,3,39,0.07142857142857142,0.07142857142857142,0.9285714285714286,42,1300,1000,300,0.7692307692307693,16,10,6,322.54101354456316,0.40156794425087106,0.04759715268553544,0.18215285052283003,129917.22140842043,-19.273546006910408,129897.94786241352,2202,0,563.1666666666666,39,3,11,36.90961224072751,0.6140491452991451,45.13020833333335,1019.479166666669,26.140491452991512,0
2942,4,0,0,39,0.0,0.0,1.0,39,1050,600,450,0.5714285714285714,15,6,9,344.3460428029303,0.388663967611336,0.05515528372987144,0.19305153534202754,129631.08114448942,1127.5899632741184,130758.67110776354,2203,3,607.4871794871794,36,3,12,36.644365807807134,0.6166087962962962,45.41103603603605,1018.3558558558585,28.287662662662736,0
2943,4,0,1,38,0.0,0.02564102564102564,0.9743589743589743,39,700,500,200,0.7142857142857143,9,5,4,343.8331956701965,0.38863585245164195,0.05444005045995115,0.19304601209416067,129688.42734203803,1118.2372828910075,130806.66462492904,2204,4,608.4871794871794,36,3,12,36.599180025796954,0.6171875,45.35472972972973,1018.5810810810815,28.29391891891893,0
2944,4,1,0,39,0.02564102564102564,0.0,1.0,39,800,500,300,0.625,11,5,6,343.39342510912354,0.3888888888888889,0.06439439014024662,0.1935062576113057,129831.8483179126,1116.6806164272502,130948.52893433986,2205,0,609.2051282051282,36,3,14,36.46477900552486,0.6186342592592593,45.21396396396397,1019.144144144145,28.309559559559585,0
2945,4,2,3,38,0.04878048780487805,0.07317073170731707,0.926829268292683,41,650,400,250,0.6153846153846154,9,4,5,329.0214357935627,0.39916158536585367,0.061881883210709754,0.1873343741103513,130235.32238476137,370.0425524143327,130605.3649371757,2206,0,580.439024390244,38,3,14,36.42235363896447,0.6189692982456141,44.81837606837606,1020.7264957264948,26.861223571749864,0
2946,4,0,0,38,0.0,0.0,1.0,38,1000,600,400,0.6,14,6,8,341.16156843179107,0.38987671882408725,0.06687170026991995,0.19313108630457004,130010.8582087757,1270.9416599338172,131281.79986870952,2207,2,619.921052631579,37,1,14,36.340066480306774,0.6185247747747749,45.03837719298245,1019.8464912280696,27.563418681839718,0
2947,4,0,0,38,0.0,0.0,1.0,38,1150,800,350,0.6956521739130435,15,8,7,341.8616145814756,0.3902619724988146,0.07232811147507578,0.19380491166675612,130066.77685682141,1292.967667936298,131359.7445247577,2208,3,620.921052631579,37,1,15,36.26551918735891,0.6190878378378377,44.98355263157895,1020.0657894736848,27.569345661450942,0
2948,4,1,0,39,0.02564102564102564,0.0,1.0,39,1100,800,300,0.7272727272727273,14,8,6,334.3399189690864,0.3921783625730994,0.07359285330619403,0.1912019587042633,130406.32482144317,920.3025765597846,131326.62739800295,2209,0,605.974358974359,36,3,17,36.11356119073869,0.6244212962962963,44.65090090090091,1021.3963963963972,28.372122122122146,0
2949,4,0,0,39,0.0,0.0,1.0,39,1000,600,400,0.6,14,6,8,335.9968673111673,0.39257197480881695,0.07138334916112643,0.19243456946003246,130463.84222059918,967.0884566999612,131430.93067729915,2210,1,606.974358974359,36,3,18,36.01305298353908,0.625,44.594594594594604,1021.6216216216233,28.378378378378425,0
2950,4,1,2,38,0.025,0.05,0.95,40,900,800,100,0.8888888888888888,10,8,2,333.0101879778797,0.3949519230769231,0.06806240617628134,0.19194394394818948,130710.70545744845,705.5993190212359,131416.30477646968,2211,0,592.775,37,3,13,35.83976695975408,0.6255630630630631,44.353070175438596,1022.5877192982457,27.637505926979614,0
2951,4,2,1,39,0.05,0.025,0.975,40,1050,900,150,0.8571428571428571,12,9,3,329.92184081049436,0.39755608974358975,0.06703193655556805,0.19085559185385753,130850.90033712289,634.1139821868212,131485.0143193097,2212,0,593.675,37,3,14,35.77713624834781,0.6269707207207207,44.21600877192982,1023.1359649122801,27.65232337600757,0
2952,4,0,0,39,0.0,0.0,1.0,39,750,300,450,0.4,12,3,9,337.83396649617544,0.3935841205578048,0.08007880861249483,0.19522161270046146,130809.21292914521,1038.3590516191744,131847.5719807644,2213,1,609.8974358974359,36,3,14,35.61688132981068,0.6284722222222223,44.25675675675675,1022.9729729729718,28.415915915915882,0
2953,4,0,0,39,0.0,0.0,1.0,39,1200,800,400,0.6666666666666666,16,8,8,335.2310650868025,0.3932186234817814,0.08041658427262588,0.19463415569965062,130991.17036011055,982.4619113573157,131973.63227146788,2214,2,610.8974358974359,37,2,16,35.49967866323908,0.6283783783783785,44.07894736842104,1023.6842105263138,27.667140825035506,0
2954,4,0,0,39,0.0,0.0,1.0,39,1050,800,250,0.7619047619047619,13,8,5,332.55257919495904,0.3932748538011696,0.09506295319444136,0.18711232730279187,129772.26382725166,831.653034228999,130603.91686148067,2215,3,611.8974358974359,38,1,13,36.80140505400021,0.6143092105263158,45.27243589743589,1018.9102564102552,26.813427800269874,4
2955,4,0,0,39,0.0,0.0,1.0,39,950,700,250,0.7368421052631579,12,7,5,329.2399527801083,0.3926282051282051,0.09194438622231527,0.1858939425696918,129908.37191358021,754.2052469135748,130662.57716049379,2216,4,612.8974358974359,38,1,14,36.74784287011807,0.6156798245614036,45.138888888888886,1019.4444444444441,26.82748538011695,0
2956,4,0,0,39,0.0,0.0,1.0,39,850,600,250,0.7058823529411765,11,6,5,326.1588713665191,0.3919815564552407,0.09448761159515984,0.18469760032097093,130023.43885633674,681.6596137152735,130705.098470052,2217,5,613.8974358974359,39,0,15,36.70983981888129,0.6151175213675215,45.026041666666664,1019.8958333333328,26.1511752136752,0
2957,4,1,1,39,0.025,0.025,0.975,40,1000,600,400,0.6,14,6,8,321.69929196168283,0.3966212606837607,0.08704081632653082,0.18329378262933052,130262.58680555527,381.5158420138555,130644.10264756913,2218,0,599.525,38,2,15,36.58163265306122,0.6192434210526316,44.79166666666665,1020.8333333333311,26.86403508771924,0
2958,4,1,0,40,0.025,0.0,1.0,40,950,600,350,0.631578947368421,13,6,7,323.5179200804484,0.3940705128205128,0.10558983476260231,0.1852382246592361,130453.51765103334,440.8101395280528,130894.3277905614,2219,0,600.5,38,2,17,36.34220525691976,0.6211622807017545,44.60470085470084,1021.5811965811939,26.883715699505103,0
2959,4,0,0,40,0.0,0.0,1.0,40,500,200,300,0.4,8,2,6,325.636926097035,0.3943242521367521,0.10639571353894417,0.18684566275453737,130535.38795976693,501.42849642047935,131036.81645618741,2220,1,601.5,38,2,15,36.205349364000696,0.621984649122807,44.52457264957265,1021.901709401709,26.892150247413394,0
2960,4,0,1,39,0.0,0.025,0.975,40,500,300,200,0.6,7,3,4,326.8792196419745,0.39399038461538466,0.10924628893999588,0.1876906731749776,130562.68376981512,535.6456370078081,131098.32940682292,2221,2,602.5,38,2,15,36.14602934002368,0.6222587719298246,44.49786324786324,1022.0085470085465,26.894961763382803,0
2961,4,1,2,38,0.025,0.05,0.95,40,1200,900,300,0.75,15,9,6,332.47851329855587,0.39444444444444443,0.11411408274132917,0.1917159234514321,130726.51855504401,692.7517075754054,131419.27026261942,2222,0,602.95,38,2,15,35.83738159910851,0.62390350877193,44.33760683760683,1022.649572649571,26.911830859199238,0
2962,4,0,0,38,0.0,0.0,1.0,38,850,700,150,0.8235294117647058,10,7,3,340.857507855413,0.3901137980085348,0.11542297789427325,0.19579890767694452,130578.91506371208,1301.760713416088,131880.67577712817,2223,4,619.1842105263158,36,2,15,35.77245849860438,0.6261574074074076,44.48198198198197,1022.0720720720698,28.390890890890827,0
2963,4,0,1,37,0.0,0.02631578947368421,0.9736842105263158,38,1100,900,200,0.8181818181818182,13,9,4,339.7230188469528,0.38943219535324797,0.1233324447432167,0.1960206135430763,130751.61944038607,1283.8669750831605,132035.48641546923,2224,5,620.1842105263158,36,2,16,35.62678925346838,0.6278935185185187,44.31306306306305,1022.7477477477457,28.409659659659603,0
2964,4,0,0,37,0.0,0.0,1.0,37,600,300,300,0.5,9,3,6,348.1657608695654,0.38501001001001,0.13014101057579341,0.20019531249999958,130617.28395061691,1695.2932098764961,132312.5771604934,2225,6,637.4324324324324,35,2,16,35.546874999999986,0.6285714285714288,44.44444444444442,1022.2222222222192,29.20634920634912,0
2965,4,0,0,37,0.0,0.0,1.0,37,1300,1000,300,0.7692307692307693,16,10,6,352.22032457403196,0.3840715715715716,0.13970743403808883,0.20330313574531164,130765.21675936645,1811.6334179955438,132576.85017736198,2226,7,638.4324324324324,35,2,16,35.293486665912255,0.6300595238095238,44.29976851851852,1022.8009259259262,29.222883597883605,0
2966,4,1,1,37,0.02631578947368421,0.02631578947368421,0.9736842105263158,38,600,400,200,0.6666666666666666,8,4,4,345.12452546120016,0.3896248221906116,0.14383823299588427,0.20078165771072917,131068.54056336758,1446.9935729648735,132515.53413633246,2227,0,622.6052631578947,36,2,17,35.16830712269512,0.6310763888888888,44.003378378378386,1023.9864864864878,28.444069069069105,0
2967,4,1,0,38,0.02631578947368421,0.0,1.0,38,200,100,100,0.5,3,1,2,347.4440958255241,0.3868835941204362,0.15985583876155518,0.20289129549554688,131212.72243527317,1517.8171414657963,132730.53957673896,2228,0,623.578947368421,36,2,19,34.96327031582033,0.6325231481481481,43.862612612612615,1024.54954954955,28.45970970970972,0
2968,4,0,0,38,0.0,0.0,1.0,38,650,500,150,0.7692307692307693,8,5,3,345.6937008394475,0.3863205310573732,0.16024818142918296,0.20247773906310493,131328.125,1479.9118375131898,132808.03683751318,2229,1,624.578947368421,35,3,19,34.89159891598916,0.6357142857142857,43.75,1025.0,29.285714285714285,0
2969,4,0,0,38,0.0,0.0,1.0,38,1000,700,300,0.7,13,7,6,345.74744710820573,0.3858611901375059,0.1644090755164236,0.20298055890865435,131417.11576485337,1487.4264564043185,132904.5422212577,2230,2,625.578947368421,35,3,19,34.800414832373846,0.6366071428571429,43.66319444444444,1025.3472222222222,29.29563492063492,0
2970,4,1,1,38,0.02564102564102564,0.02564102564102564,0.9743589743589743,39,800,400,400,0.5,12,4,8,335.8764973242381,0.3900416104363473,0.14683755058878445,0.19897245133886138,131761.33639974432,1051.1072305413506,132812.44363028568,2231,0,610.5128205128206,36,3,18,34.70668348506453,0.6380208333333334,43.3277027027027,1026.6891891891892,28.519144144144143,0
2971,4,2,1,39,0.05,0.025,0.975,40,900,500,400,0.5555555555555556,13,5,8,327.15841003227115,0.39457799145299144,0.15046676624346556,0.19519132891358876,132031.50398439908,639.0433835410976,132670.5473679402,2232,0,596.2,37,3,19,34.65883832995484,0.638795045045045,43.064692982456144,1027.7412280701758,27.776789947842587,0
2972,4,0,0,39,0.0,0.0,1.0,39,1300,1100,200,0.8461538461538461,15,11,4,333.83824357290274,0.38998538011695905,0.1503730242360377,0.1989728264273508,131992.67415642014,1012.8405009739645,133005.5146573941,2233,1,612.4871794871794,36,3,19,34.52625570776255,0.6403356481481481,43.102477477477485,1027.5900900900915,28.54416916916921,0
2973,4,0,0,39,0.0,0.0,1.0,39,850,500,350,0.5882352941176471,12,5,7,337.36655244954136,0.38978857399910033,0.1585816965376614,0.2016908485469461,132108.419124361,1113.792381908962,133222.21150626996,2234,2,613.4871794871794,36,3,19,34.319202541351764,0.6414930555555554,42.98986486486488,1028.040540540542,28.556681681681724,0
2974,4,1,0,40,0.025,0.0,1.0,40,1450,1200,250,0.8275862068965517,17,12,5,338.23075719464805,0.39388354700854705,0.21115764604810994,0.19299049086988765,130318.55955678692,822.5524289684517,131141.11198575536,2235,0,599.125,37,3,20,36.103056987399796,0.6216216216216215,44.73684210526317,1021.0526315789491,27.596017069701325,3
2975,4,1,1,40,0.024390243902439025,0.024390243902439025,0.975609756097561,41,1200,1000,200,0.8333333333333334,14,10,4,327.560538703981,0.3989329268292683,0.2030540694162295,0.1884802642729044,130644.5883213715,358.80234586167614,131003.39066723318,2236,0,585.4878048780488,38,3,20,36.04586860347651,0.6230811403508769,44.41773504273506,1022.3290598290624,26.903396311291118,0
2976,4,0,0,40,0.0,0.0,1.0,40,1100,900,200,0.8181818181818182,13,9,4,338.38197532277627,0.394017094017094,0.20419349730813874,0.18223379489668348,128036.38100162556,676.7289201183604,128713.10992174392,2237,2,601.125,38,2,19,38.420159048523885,0.5967653508771928,46.981837606837615,1012.0726495726509,26.633490778227657,6
2977,4,4,3,41,0.09090909090909091,0.06818181818181818,0.9318181818181819,44,1050,800,250,0.7619047619047619,13,8,5,324.14842467462074,0.409013830162086,0.21979234404127101,0.1789729453772197,129029.04652852906,-435.087566101784,128593.95896242728,2238,0,547.3863636363636,42,2,15,37.76963121920205,0.6004464285714286,46.00290697674419,1015.9883720930242,24.190199335548193,0
2978,4,2,2,41,0.046511627906976744,0.046511627906976744,0.9534883720930233,43,1550,1400,150,0.9032258064516129,17,14,3,330.3529129304225,0.4046234772978959,0.2358541319077938,0.18284525083588238,129125.75511975639,-68.58613236960059,129057.16898738679,2239,0,561.0697674418604,41,2,17,37.51372620790629,0.6028963414634145,45.9077380952381,1016.3690476190488,24.789488966318263,0
2979,4,0,0,41,0.0,0.0,1.0,41,1400,1100,300,0.7857142857142857,17,11,6,361.13754630798235,0.39913617886178865,0.23577151601312063,0.18743834281508848,126541.17974175328,939.7542317708131,127480.9339735241,2240,1,589.3414634146342,39,2,15,39.379615729716676,0.5798611111111112,48.46354166666666,1006.1458333333318,25.79861111111107,8
2980,4,2,0,43,0.046511627906976744,0.0,1.0,43,1050,800,250,0.7619047619047619,13,8,5,348.4907122822526,0.40633074935400515,0.23232015816607898,0.18322354417612657,127067.0068519303,256.3343450805942,127323.3411970109,2241,0,562.8837209302326,41,2,17,39.1574625274689,0.5820630081300815,47.94146825396824,1008.2341269841247,24.591076267905482,0
2981,4,1,0,44,0.022727272727272728,0.0,1.0,44,1200,800,400,0.6666666666666666,16,8,8,341.2123165234437,0.407494274136716,0.23861120766936894,0.18133518725187076,127502.2359789146,-98.92841899329846,127403.3075599213,2242,0,551.0681818181819,40,4,15,38.89489836989336,0.5880208333333334,47.510162601626014,1009.9593495934954,25.248983739837385,0
2982,4,2,3,43,0.043478260869565216,0.06521739130434782,0.9347826086956522,46,600,400,200,0.6666666666666666,8,4,4,330.227945975273,0.4145330112721417,0.20984313937214227,0.18053035855953684,128635.5530485697,-700.9616552314844,127934.59139333821,2243,0,528.0652173913044,42,4,12,38.015609577482735,0.5964781746031746,46.39050387596899,1014.4379844961232,24.153285345145793,2
2983,4,0,0,43,0.0,0.0,1.0,43,1450,1200,250,0.8275862068965517,17,12,5,341.2152657548473,0.4050849021779254,0.21446603427172484,0.18523114426691728,128355.55555555568,159.37500000000904,128514.9305555557,2244,2,565.8604651162791,39,4,20,38.02254660087719,0.5982905982905983,46.66666666666667,1013.3333333333344,25.98290598290601,0
2984,4,0,0,43,0.0,0.0,1.0,43,1350,1000,350,0.7407407407407407,17,10,7,338.8252955526366,0.4047849760059062,0.21561006690028672,0.18458392966673487,128496.3348765432,107.56172839506297,128603.89660493826,2245,3,566.8604651162791,41,2,14,37.93949771689499,0.5965447154471545,46.52777777777778,1013.8888888888888,24.7289972899729,0
2985,4,0,0,43,0.0,0.0,1.0,43,1400,1100,300,0.7857142857142857,17,11,6,333.2403159157216,0.40490033222591365,0.18831991651759106,0.18240522555386865,128685.3063652588,-21.4445582802675,128663.86180697853,2246,4,567.8604651162791,40,3,14,37.88853832799145,0.6,46.34146341463415,1014.6341463414636,25.36585365853659,1
2986,4,1,1,43,0.022727272727272728,0.022727272727272728,0.9772727272727273,44,1200,800,400,0.6666666666666666,16,8,8,325.7753606383352,0.4090358527131783,0.1771608446251931,0.17950958784796955,128949.36244173588,-398.29498929202236,128551.06745244385,2247,0,555.9318181818181,41,3,14,37.80930520283909,0.6011178861788619,46.0813492063492,1015.6746031746027,24.77255129694153,0
2987,4,2,3,42,0.044444444444444446,0.06666666666666667,0.9333333333333333,45,850,600,250,0.7058823529411765,11,6,5,321.9871068526199,0.410016835016835,0.17879251092247506,0.17867059329358426,129226.6050662163,-677.8938137755074,128548.7112524408,2248,0,544.5333333333333,41,4,15,37.62389420106029,0.6039126016260162,45.80853174603175,1016.765873015873,24.79916763453349,0
2988,4,1,1,42,0.023255813953488372,0.023255813953488372,0.9767441860465116,43,950,700,250,0.7368421052631579,12,7,5,333.0578098016081,0.4101605758582503,0.18111994491921624,0.183973037701463,129046.45568940457,-4.014021085320962,129042.44166831924,2249,0,565.8139534883721,40,3,15,37.5256301260252,0.6036458333333332,45.98577235772358,1016.0569105691067,25.401422764227668,0
2989,4,2,3,41,0.045454545454545456,0.06818181818181818,0.9318181818181819,44,1050,900,150,0.8571428571428571,12,9,3,327.01500810325706,0.41225114517265676,0.17929091090745541,0.18193958955561476,129330.57089240898,-341.2995116993468,128989.27138070964,2250,0,553.9090909090909,40,4,15,37.39051520298398,0.6065104166666665,45.70630081300815,1017.1747967479704,25.42936991869926,0
2990,4,0,0,41,0.0,0.0,1.0,41,1050,800,250,0.7619047619047619,13,8,5,338.28952475666597,0.403760162601626,0.18950189501894976,0.18709481879399315,129095.50781250026,534.3315972222522,129629.83940972251,2251,3,594.5121951219512,39,2,16,37.34283176165097,0.6057692307692306,45.937500000000014,1016.250000000002,26.05769230769236,0
2991,4,1,0,42,0.023809523809523808,0.0,1.0,42,1550,1300,250,0.8387096774193549,18,13,5,333.39082273373447,0.41015776229190865,0.18753624927501478,0.1859024704751807,129418.71667031923,229.48929112791149,129648.20596144715,2252,0,581.3333333333334,38,4,18,37.138850972980535,0.6107456140350876,45.61965811965812,1017.5213675213674,26.776878092667562,0
2992,4,0,1,41,0.0,0.023809523809523808,0.9761904761904762,42,1100,800,300,0.7272727272727273,14,8,6,334.5152335025812,0.4103876306620209,0.18526543607891366,0.18691651786387636,129500.26167223684,263.9620543867349,129764.22372662358,2253,1,582.3333333333334,38,4,12,37.02743955774815,0.6115679824561404,45.539529914529915,1017.8418803418804,26.7853126405758,0
2993,4,0,0,41,0.0,0.0,1.0,41,1000,800,200,0.8,12,8,4,339.5425721215135,0.4097052845528455,0.18576728015626975,0.18972563546050786,129500.26167223684,594.170387720068,130094.4320599569,2254,2,546.6341463414634,38,3,13,36.89951366292292,0.6115679824561404,45.539529914529915,1017.8418803418804,26.7853126405758,0
2994,4,1,1,41,0.023809523809523808,0.023809523809523808,0.9761904761904762,42,1050,900,150,0.8571428571428571,12,9,3,332.50948264686076,0.41238385598141697,0.181176356022982,0.18689326093599423,129731.44531250012,227.38715277779303,129958.83246527791,2255,0,534.5952380952381,39,3,14,36.84389911383778,0.6121794871794872,45.31250000000001,1018.7500000000009,26.121794871794894,0
2995,4,1,1,41,0.023809523809523808,0.023809523809523808,0.9761904761904762,42,1300,1100,200,0.8461538461538461,15,11,4,330.20361899385574,0.4126863143631436,0.17944132175097938,0.1862272283489845,129864.12896050356,176.32107204862214,130040.45003255218,2256,0,535.5714285714286,39,3,14,36.768118719127905,0.6135149572649572,45.18229166666667,1019.270833333334,26.135149572649592,0
2996,4,1,1,41,0.023809523809523808,0.023809523809523808,0.9761904761904762,42,1400,900,500,0.6428571428571429,19,9,10,333.30284617194593,0.41186362756484707,0.19756192420817253,0.1892580509132876,130129.69970703126,274.51985677083405,130404.2195638021,2257,0,536.547619047619,39,3,15,36.420048494129645,0.6161858974358975,44.921875,1020.3125000000001,26.161858974358978,0
2997,4,0,1,40,0.0,0.024390243902439025,0.975609756097561,41,850,600,250,0.7058823529411765,11,6,5,340.97462514417526,0.4084603658536585,0.2032520325203253,0.19321895424836596,130050.00000000001,668.7500000000007,130718.75000000001,2258,1,550.4146341463414,39,2,16,36.30514705882353,0.6153846153846154,45.0,1020.0000000000001,26.153846153846157,0
2998,4,0,0,40,0.0,0.0,1.0,40,1000,700,300,0.7,13,7,6,350.07863112146714,0.40368589743589745,0.21536346496281644,0.1983501893956465,130044.5513391225,1105.1637035210613,131149.71504264357,2259,2,564.75,38,2,17,36.078523794560255,0.6170504385964912,45.005341880341874,1019.9786324786312,26.841542959963977,0
2999,4,1,1,40,0.024390243902439025,0.024390243902439025,0.975609756097561,41,1100,500,600,0.45454545454545453,17,5,12,340.35818408996283,0.4070121951219512,0.20746640119462434,0.19392501186521097,130262.58680555526,667.3701283877233,130929.95693394297,2260,0,551.9512195121952,38,3,17,36.10544217687075,0.6192434210526316,44.79166666666665,1020.833333333331,26.864035087719238,0
3000,4,0,0,40,0.0,0.0,1.0,40,1400,1200,200,0.8571428571428571,16,12,4,345.6846485775538,0.40344551282051283,0.20971320912706792,0.19682187917222532,130235.3223847612,1004.0703301920967,131239.39271495328,2261,4,566.75,38,2,18,35.9971390691508,0.6189692982456141,44.818376068376054,1020.7264957264933,26.861223571749825,0
3001,4,0,0,40,0.0,0.0,1.0,40,1000,600,400,0.6,14,6,8,347.72095398629904,0.40361912393162397,0.20759609190466,0.19869159297106667,130374.54433094787,1066.7950396257968,131441.33937057367,2262,5,567.75,37,3,19,35.80407630090902,0.6221846846846848,44.682017543859644,1021.2719298245605,27.601944049312447,0
3002,4,3,2,41,0.06976744186046512,0.046511627906976744,0.9534883720930233,43,1000,500,500,0.5,15,5,10,330.0893239124987,0.412906053894426,0.21211757593099456,0.19229134140983567,131119.87428944392,56.25413113885753,131176.12842058277,2263,0,529.0697674418604,40,3,15,35.50142223986243,0.6244791666666667,43.95325203252032,1024.1869918699172,25.60467479674793,0
3003,4,1,1,41,0.023809523809523808,0.023809523809523808,0.9761904761904762,42,1150,700,450,0.6086956521739131,16,7,9,350.55223165371973,0.41066589237320944,0.2583646332513063,0.20034150855650384,130380.76560356634,759.8167857760508,131140.5823893424,2264,0,542.6428571428571,35,7,19,35.7254835297673,0.6261904761904763,44.67592592592592,1021.2962962962948,29.179894179894138,2
3004,4,0,0,41,0.0,0.0,1.0,41,1100,700,400,0.6363636363636364,15,7,8,352.2609713419573,0.4095274390243902,0.24432238885143742,0.2019324581173244,130498.99798525359,993.9407578874973,131492.9387431411,2265,1,527.829268292683,35,6,18,35.56203745657757,0.6273809523809524,44.560185185185176,1021.7592592592578,29.19312169312165,0
3005,4,0,0,41,0.0,0.0,1.0,41,1100,800,300,0.7272727272727273,14,8,6,350.7946991128929,0.4094258130081301,0.23909907344474934,0.2019572018545308,130665.2529852486,967.3356210940492,131632.58860634264,2266,2,528.829268292683,36,5,18,35.43112310460037,0.627025462962963,44.397522522522515,1022.4099099099086,28.400275275275238,0
3006,4,1,0,42,0.023809523809523808,0.0,1.0,42,750,500,250,0.6666666666666666,10,5,5,341.52654878628175,0.4131339527680991,0.23595299302240247,0.19828929474307963,130991.17036011055,547.3924669128708,131538.56282702342,2267,0,517.2142857142857,37,5,20,35.33856398171951,0.6283783783783785,44.07894736842104,1023.6842105263138,27.667140825035506,0
3007,4,0,0,42,0.0,0.0,1.0,42,1050,700,350,0.6666666666666666,14,7,7,340.9024653471276,0.41285569105691056,0.23753678401852385,0.19807133285290152,131019.23338190588,532.9559335564691,131552.18931546234,2268,1,518.2142857142857,37,5,20,35.32618881867837,0.6286599099099099,44.051535087719294,1023.793859649122,27.670104314841137,0
3008,4,1,2,41,0.023255813953488372,0.046511627906976744,0.9534883720930233,43,1600,1000,600,0.625,22,10,12,328.5208270980953,0.41332133628645257,0.22600314321523074,0.1929853501897856,131440.53939673747,36.55463700370137,131477.09403374116,2269,0,507.13953488372096,37,6,21,35.2184024807528,0.6328828828828829,43.640350877192986,1025.4385964912283,27.714556661925087,0
3009,4,0,0,41,0.0,0.0,1.0,41,1000,800,200,0.8,12,8,4,339.4143697534536,0.4121443089430894,0.22486615110053543,0.1987998451413086,131328.12500000012,714.930555555568,132043.05555555568,2270,3,513.8536585365854,36,5,21,35.05250677506775,0.6336805555555556,43.75000000000001,1025.000000000001,28.472222222222246,0
3010,4,0,0,41,0.0,0.0,1.0,41,1300,1000,300,0.7692307692307693,16,10,6,338.3634293890389,0.4123729674796748,0.2243373951626888,0.19895410403558567,131476.4596863213,697.365156678688,132173.82484299998,2271,4,514.8536585365854,35,6,21,34.92986589173533,0.6372023809523808,43.60532407407408,1025.5787037037048,29.30224867724871,0
3011,4,1,0,42,0.023809523809523808,0.0,1.0,42,1300,900,400,0.6923076923076923,17,9,8,315.75544214972683,0.41548102981029805,0.19051372519580667,0.17498037461005547,129174.23575726866,-242.5064148221109,128931.72934244655,2272,0,503.57142857142856,38,4,17,37.83543527763181,0.6082785087719298,45.86004273504274,1016.5598290598294,26.75157444894288,5
3012,4,0,1,41,0.0,0.023809523809523808,0.9761904761904762,42,1400,900,500,0.6428571428571429,19,9,10,317.9792388601968,0.4146825396825397,0.19043401240035474,0.17684658161239525,129315.90374157949,-176.03976400969236,129139.8639775698,2273,1,504.57142857142856,36,6,17,37.63516755240626,0.6134259259259258,45.72072072072073,1017.1171171171177,28.25325325325327,0
3013,4,0,0,41,0.0,0.0,1.0,41,1150,900,250,0.782608695652174,14,9,5,324.0017246243904,0.41049288617886176,0.193717117592348,0.1798076532422784,129230.80800165024,174.20093342761942,129405.00893507786,2274,2,517.7317073170732,35,6,17,37.56841680895464,0.6145833333333335,45.80439814814814,1016.7824074074063,29.050925925925892,0
3014,4,1,1,41,0.023809523809523808,0.023809523809523808,0.9761904761904762,42,1150,800,350,0.6956521739130435,15,8,7,316.106450296065,0.4137388695315525,0.19864449817984564,0.17670291924713238,129516.42679419274,-211.8044142115151,129304.62237998123,2275,0,506.3809523809524,36,6,16,37.47948703765166,0.615451388888889,45.523648648648646,1017.9054054054046,28.27515015015013,0
3015,4,0,0,41,0.0,0.0,1.0,41,700,400,300,0.5714285714285714,10,4,6,316.89099308525664,0.41471036585365856,0.20589433141926272,0.17765934596838043,129631.08114448912,15.78440771853036,129646.86555220764,2276,1,515.2926829268292,36,5,16,37.34334107412731,0.6166087962962963,45.41103603603604,1018.355855855856,28.28766266266267,0
3016,4,2,1,42,0.046511627906976744,0.023255813953488372,0.9767441860465116,43,1400,1000,400,0.7142857142857143,18,10,8,307.37582483971033,0.4199889258028793,0.22246342246926343,0.17525557172841724,130289.85407991821,-590.409726787926,129699.44435313028,2277,0,492.27906976744185,38,5,17,36.91964908608901,0.6195175438596492,44.76495726495727,1020.9401709401711,26.866846603688714,0
3017,4,0,0,42,0.0,0.0,1.0,42,1300,800,500,0.6153846153846154,18,8,10,316.31326202664593,0.4163037166085946,0.23631291201906568,0.18035473256154982,130290.57167830523,-157.47285222371966,130133.09882608152,2278,1,505.0,37,5,17,36.69080925786705,0.6213400900900898,44.76425438596493,1020.9429824561433,27.593053579895766,0
3018,4,1,1,42,0.023255813953488372,0.023255813953488372,0.9767441860465116,43,1100,700,400,0.6363636363636364,15,7,8,310.9226440479381,0.4196197858988557,0.23332150202509894,0.1785285722066374,130562.68376981534,-481.02102965883125,130081.6627401565,2279,0,494.2325581395349,38,5,16,36.55372325597603,0.6222587719298245,44.49786324786326,1022.0085470085482,26.89496176338285,0
3019,4,0,0,42,0.0,0.0,1.0,42,1450,1100,350,0.7586206896551724,18,11,7,316.6756202962633,0.4161222415795587,0.2367614141599974,0.18147499569007294,130486.54994806118,-135.6181709756595,130350.93177708551,2280,3,507.0,37,5,18,36.48359805394577,0.6233108108108107,44.572368421052644,1021.7105263157914,27.613798008534904,0
3020,4,1,0,43,0.023255813953488372,0.0,1.0,43,1200,600,600,0.5,18,6,12,310.0297010892035,0.4179125138427464,0.24689182004238974,0.17965967977819006,130917.78897518083,-482.3194033530502,130435.46957182778,2281,0,496.1860465116279,38,5,17,36.21855099697257,0.6258223684210527,44.15064102564103,1023.397435897436,26.931511470985157,0
3021,4,0,0,43,0.0,0.0,1.0,43,1350,900,450,0.6666666666666666,18,9,9,309.4849876171529,0.4179355850867479,0.2463713601362878,0.1798541319790891,131027.14913662433,-489.8128743881898,130537.33626223615,2282,1,497.1860465116279,38,5,18,36.1223433858569,0.6269188596491228,44.04380341880342,1023.8247863247865,26.942757534862803,0
3022,4,0,0,43,0.0,0.0,1.0,43,750,500,250,0.6666666666666666,10,5,5,308.4062407757957,0.41848929494278336,0.24115594932532392,0.1796100986680911,131109.19922017684,-513.0209474760702,130596.17827270078,2283,2,498.1860465116279,38,5,19,36.067355170735084,0.6277412280701754,43.96367521367522,1024.1452991452998,26.951192082771048,0
3023,4,0,1,42,0.0,0.023255813953488372,0.9767441860465116,43,1300,900,400,0.6923076923076923,17,9,8,309.3362590683821,0.4181893687707641,0.24280301285578876,0.1810532479098835,131300.74929003217,-476.7834803491804,130823.96580968298,2284,3,499.1860465116279,38,5,19,35.850793981722795,0.6296600877192982,43.776709401709404,1024.8931623931626,26.97087269455691,0
3024,4,0,0,42,0.0,0.0,1.0,42,850,500,350,0.5882352941176471,12,5,7,316.13253176142894,0.4161706349206349,0.2505593696324724,0.18448633630524866,131187.6746330602,-105.46165647121745,131082.21297658898,2285,4,511.42857142857144,37,5,20,35.79049823397196,0.6303490990990991,43.887061403508774,1024.4517543859652,27.687885253674732,0
3025,4,0,0,42,0.0,0.0,1.0,42,800,600,200,0.75,10,6,4,316.71074261403703,0.41550522648083626,0.2536506577807669,0.18523020027977405,131271.93583602642,-84.95354339797359,131186.98229262844,2286,5,512.4285714285714,37,5,20,35.690848134674354,0.6311936936936937,43.80482456140351,1024.7807017543855,27.696775723091502,0
3026,4,0,0,42,0.0,0.0,1.0,42,1150,700,450,0.6086956521739131,16,7,9,317.27146539758076,0.4151180797522261,0.25222609368950843,0.1858304297328686,131328.12499999988,-66.66666666667953,131261.4583333332,2287,6,513.4285714285714,37,5,20,35.61991869918699,0.6317567567567568,43.74999999999999,1024.999999999999,27.702702702702677,0
3027,4,1,1,42,0.023255813953488372,0.023255813953488372,0.9767441860465116,43,1250,800,450,0.64,17,8,9,312.19442787357286,0.4160437430786268,0.24619586800073612,0.18417170057111754,131602.0390459493,-382.91534261085354,131219.12370333844,2288,0,502.4651162790698,38,5,16,35.474585242260154,0.6326754385964912,43.48290598290598,1026.068376068376,27.00179937022042,0
3028,4,0,0,42,0.0,0.0,1.0,42,1650,1300,350,0.7878787878787878,20,13,7,319.6772979211819,0.41406552458381723,0.247370188857845,0.18848270174218637,131581.12502164117,12.69970086948797,131593.82472251065,2289,8,515.4285714285714,37,5,18,35.30367193901181,0.6342905405405406,43.503289473684205,1025.9868421052624,27.72937411095304,0
3029,4,0,1,41,0.0,0.023809523809523808,0.9761904761904762,42,1200,800,400,0.6666666666666666,16,8,8,321.1958506830302,0.41372677119628337,0.24717134717134726,0.1897975481308814,131665.51246537393,58.08325638657686,131723.5957217605,2290,9,516.4285714285714,37,5,18,35.1798433048433,0.6351351351351351,43.421052631578945,1026.315789473684,27.738264580369837,0
3030,4,0,0,41,0.0,0.0,1.0,41,1000,600,400,0.6,14,6,8,331.4563724012794,0.4116107723577236,0.25546585579991055,0.19561078143267205,131616.85333982625,525.0489509780004,132141.90229080425,2291,10,528.2926829268292,36,5,18,34.965567383669885,0.6365740740740742,43.468468468468465,1026.1261261261257,28.50350350350349,0
3031,4,1,0,42,0.023809523809523808,0.0,1.0,42,650,300,350,0.46153846153846156,10,3,7,331.8683257250406,0.4134001161440186,0.2724754898227548,0.19888773335304524,132200.59447378048,374.63798957372114,132575.23246335422,2292,0,516.6904761904761,37,5,19,34.367891921668985,0.6404842342342343,42.90021929824562,1028.399122807018,27.794570886676166,0
3032,4,0,0,42,0.0,0.0,1.0,42,1000,800,200,0.8,12,8,4,309.29777309082135,0.413291231126597,0.20511618214025273,0.1815492800215662,131410.26925131466,-271.01927186064654,131139.249979454,2293,1,517.6904761904761,38,4,19,35.741638011878706,0.6307565789473686,43.66987179487178,1025.3205128205107,26.982118758434492,5
3033,4,1,0,43,0.023255813953488372,0.0,1.0,43,1150,600,550,0.5217391304347826,17,6,11,306.46504469556436,0.4162513842746401,0.2124735729386893,0.18152160339660323,131755.55555555533,-524.3055555555802,131231.24999999974,2294,0,506.6279069767442,39,4,16,35.46739718614718,0.6324786324786327,43.33333333333332,1026.666666666665,26.32478632478628,0
3034,4,0,0,43,0.0,0.0,1.0,43,800,400,400,0.5,12,4,8,309.57716844355195,0.4159745293466224,0.21770536973866106,0.18362284756417166,131809.03320312485,-438.9865451389045,131370.04665798595,2295,1,507.6279069767442,39,4,16,35.33382362886319,0.6330128205128207,43.28124999999999,1026.8749999999989,26.330128205128176,0
3035,4,0,0,43,0.0,0.0,1.0,43,1000,600,400,0.6,14,6,8,307.00131495290645,0.4158361018826135,0.20993188071934377,0.1827371134206705,131942.7747938366,-498.67892795140745,131444.0958658852,2296,2,508.6279069767442,39,4,17,35.26574487140492,0.6343482905982908,43.15104166666666,1027.3958333333317,26.343482905982864,0
3036,4,0,0,43,0.0,0.0,1.0,43,1400,1000,400,0.7142857142857143,18,10,8,306.83309258987606,0.41463639719453677,0.21515479730211395,0.18306802745495077,132032.19112507434,-497.6308951351733,131534.56022993918,2297,3,509.6279069767442,40,3,17,35.18037839085006,0.6335937500000001,43.0640243902439,1027.7439024390242,25.693597560975604,0
3037,4,0,1,42,0.0,0.023255813953488372,0.9767441860465116,43,1100,800,300,0.7272727272727273,14,8,6,307.93780183145134,0.4142211148025101,0.22147846935046012,0.18423457960548734,132136.65729930912,-462.02564197899846,131674.63165733012,2298,4,510.6279069767442,40,3,18,35.04723897070937,0.6346354166666668,42.96239837398373,1028.1504065040638,25.703760162601593,0
3038,4,0,0,42,0.0,0.0,1.0,42,950,500,450,0.5263157894736842,14,5,9,304.8217828742832,0.4126863143631436,0.19918125352907956,0.18274860442462953,132215.0340405843,-339.5955201930128,131875.43852039127,2299,5,496.6190476190476,40,2,18,35.04878952569169,0.6354166666666667,42.886178861788615,1028.4552845528453,25.711382113821134,0
3039,4,0,0,42,0.0,0.0,1.0,42,1350,1200,150,0.8888888888888888,15,12,3,308.76454199055024,0.4115369725125823,0.20126748971193442,0.18575406937934186,132345.7135819454,-227.26727229161176,132118.44630965378,2300,6,497.6190476190476,40,2,18,34.81646090534981,0.63671875,42.75914634146342,1028.9634146341473,25.724085365853682,0
3040,4,0,0,42,0.0,0.0,1.0,42,1200,900,300,0.75,15,9,6,333.8852066894233,0.4116216608594658,0.2549581892211372,0.1888158456546949,129970.32470703138,297.2520680868648,130267.57677511824,2301,7,498.6190476190476,39,3,16,36.56666070759698,0.6145833333333333,45.07812500000001,1019.687500000001,26.14583333333336,8
3041,4,1,1,42,0.023255813953488372,0.023255813953488372,0.9767441860465116,43,950,800,150,0.8421052631578947,11,8,3,332.1244617172779,0.4140596160944998,0.24465774571819998,0.18772984362870146,129951.54303200812,32.017255767081,129983.5602877752,2302,0,488.0,40,3,17,36.63057742782154,0.6127604166666667,45.09654471544716,1019.6138211382118,25.490345528455297,1
3042,4,0,1,41,0.0,0.023809523809523808,0.9761904761904762,42,850,600,250,0.7058823529411765,11,6,5,341.2327744514209,0.4113675958188154,0.2536316519453976,0.19244741775257382,129864.12896050354,462.77940538195566,130326.9083658855,2303,9,500.6190476190476,39,3,17,36.487076307273036,0.6135149572649572,45.18229166666667,1019.2708333333339,26.13514957264959,0
3043,4,2,2,41,0.046511627906976744,0.046511627906976744,0.9534883720930233,43,1200,900,300,0.75,15,9,6,336.3598500624737,0.4127214839424142,0.2538205980066439,0.1916468913146655,130262.5868055558,163.02083333335824,130425.60763888915,2304,0,479.27906976744185,40,3,18,36.207482993197274,0.6158854166666665,44.79166666666668,1020.8333333333353,25.520833333333382,0
3044,4,2,0,43,0.046511627906976744,0.0,1.0,43,1550,1300,250,0.8387096774193549,18,13,5,334.4270703198249,0.4141519010705057,0.25424606386780146,0.19215998689187802,130589.98243343219,134.5650476660411,130724.54748109823,2305,0,479.5581395348837,38,5,19,35.92557750601026,0.6225328947368419,44.47115384615386,1022.1153846153866,26.89777327935228,0
3045,4,0,1,42,0.0,0.023255813953488372,0.9767441860465116,43,1250,1100,150,0.88,14,11,3,330.4864410736914,0.4141749723145072,0.24805877608140015,0.1905672418046613,130726.5185550444,40.66837424211721,130767.18692928652,2306,1,480.5581395348837,38,5,19,35.88831139434462,0.6239035087719296,44.33760683760685,1022.6495726495742,26.911830859199323,0
3046,4,1,0,43,0.023255813953488372,0.0,1.0,43,850,500,350,0.5882352941176471,12,5,7,331.2474271104119,0.4126291989664083,0.25372362508102775,0.1919551787229666,130917.78897518087,73.23615220250667,130991.02512738337,2307,0,480.27906976744185,38,5,20,35.675696836830575,0.6258223684210527,44.15064102564103,1023.3974358974364,26.931511470985168,0
3047,4,1,0,44,0.022727272727272728,0.0,1.0,44,1350,1000,350,0.7407407407407407,17,10,7,327.5090870538976,0.4132091261451727,0.2498512347515609,0.1914361811457657,131250.0116188284,-202.88570378078424,131047.12591504761,2308,0,470.34090909090907,40,4,22,35.436295414724455,0.6257812499999998,43.82621951219514,1024.6951219512223,25.61737804878056,0
3048,4,1,0,45,0.022222222222222223,0.0,1.0,45,650,400,250,0.6153846153846154,9,4,5,321.09911512990664,0.4151094276094276,0.2435559257716695,0.1894248096872004,131602.0390459493,-548.470629642384,131053.56841630691,2309,0,460.8666666666667,38,7,18,35.24616479244758,0.6326754385964912,43.48290598290598,1026.068376068376,27.00179937022042,0
3049,4,0,0,45,0.0,0.0,1.0,45,750,500,250,0.6666666666666666,10,5,5,321.5608139978098,0.4154671717171717,0.24547158026233595,0.18997006022527427,131656.8560979618,-532.862836949384,131123.99326101242,2310,1,461.8666666666667,38,7,18,35.1791848844472,0.6332236842105263,43.429487179487175,1026.2820512820508,27.007422402159232,0
3050,4,0,1,44,0.0,0.022222222222222223,0.9777777777777777,45,1350,1000,350,0.7407407407407407,17,10,7,323.505447642211,0.41517255892255894,0.24518680403788107,0.19153196835452896,131739.10307774486,-476.33649737015867,131262.7665803747,2311,2,462.8666666666667,38,7,18,35.046570923092915,0.634046052631579,43.34935897435897,1026.6025641025637,27.015856950067466,0
3051,4,0,0,44,0.0,0.0,1.0,44,1000,500,500,0.5,15,5,10,328.81346410211313,0.4135724982381959,0.24349838169325988,0.19425474392158032,131656.85609796178,-141.8906147271621,131514.9654832346,2312,3,474.3181818181818,38,6,19,34.99310326879033,0.6332236842105263,43.429487179487175,1026.2820512820506,27.007422402159225,0
3052,4,0,0,44,0.0,0.0,1.0,44,1050,800,250,0.7619047619047619,13,8,5,326.27130908811085,0.41355047568710357,0.2381112330633568,0.19303046414523195,131711.6845642485,-205.25125100447372,131506.43331324405,2313,4,475.3181818181818,38,6,19,35.00316576464057,0.6337719298245614,43.37606837606837,1026.4957264957252,27.013045434098032,0
3053,4,0,0,44,0.0,0.0,1.0,44,550,400,150,0.7272727272727273,7,4,3,294.6211713198038,0.413649577167019,0.09878446262663632,0.17234542248772522,131279.5972867883,-1064.4502553948575,130215.14703139346,2314,5,476.3181818181818,43,1,15,36.24907595638515,0.6216085271317829,43.797348484848484,1024.810606060606,23.832804792107115,6
3054,4,0,0,44,0.0,0.0,1.0,44,750,300,450,0.4,12,3,9,297.67967167487694,0.41284575405214935,0.09961466092739157,0.17469487554031451,131402.6268422119,-976.8128693627339,130425.81397284917,2315,6,477.3181818181818,42,2,16,36.047120625019694,0.6242559523809523,43.677325581395344,1025.2906976744177,24.41168327796233,0
3055,4,0,0,44,0.0,0.0,1.0,44,1500,900,600,0.6,21,9,12,295.54802454621955,0.41187676180408733,0.10379338764927604,0.17434863687576124,131601.40170550122,-1021.0931396851375,130580.30856581609,2316,7,478.3181818181818,42,2,13,35.9022334498064,0.6262400793650794,43.483527131782935,1026.0658914728663,24.43014027316348,0
3056,4,0,1,43,0.0,0.022727272727272728,0.9772727272727273,44,1400,1000,400,0.7142857142857143,18,10,8,296.4259387561944,0.4114803558844256,0.10136200145883834,0.17573244690723955,131789.58553037455,-986.8296781738039,130802.75585220075,2317,8,479.3181818181818,43,1,14,35.6909411601955,0.6266957364341086,43.300189393939384,1026.7992424242407,23.879052149400945,0
3057,4,0,1,42,0.0,0.023255813953488372,0.9767441860465116,43,1150,900,250,0.782608695652174,14,9,5,304.00112601753096,0.40912236987818384,0.10790961072028327,0.18003867692318237,131750.58144229578,-589.5349776155556,131161.04646468023,2318,9,490.93023255813955,42,1,15,35.53563001415765,0.6277281746031746,43.33817829457363,1026.6472868217027,24.44398301956435,0
3058,4,0,2,40,0.0,0.047619047619047616,0.9523809523809523,42,900,500,400,0.5555555555555556,13,5,8,313.82915879017,0.4066976384049555,0.09976708074534191,0.18045176630434798,130617.28395061739,-201.6975308641861,130415.5864197532,2319,10,503.3095238095238,41,1,14,36.424365942028984,0.6178861788617885,44.44444444444445,1022.2222222222231,24.932249322493245,4
3059,4,2,2,40,0.047619047619047616,0.047619047619047616,0.9523809523809523,42,1300,800,500,0.6153846153846154,18,8,10,315.91586710347946,0.4083793070073558,0.11000678754969417,0.18272800546484502,130845.55820302671,-132.7624047303973,130712.79579829631,2320,0,503.64285714285717,41,1,18,36.140772972623544,0.6201727642276422,44.221230158730165,1023.1150793650804,24.954026325977573,0
3060,4,0,0,40,0.0,0.0,1.0,40,1300,1000,300,0.7692307692307693,16,10,6,332.76277877622533,0.40070779914529914,0.12222929611897704,0.19182220782420475,130714.91021050364,699.4113498264073,131414.32156033005,2321,12,529.825,39,1,19,35.84184323112967,0.6220619658119657,44.34895833333334,1022.604166666668,26.22061965811969,0
3061,4,0,0,40,0.0,0.0,1.0,40,800,600,200,0.75,10,6,4,332.76277877622533,0.40070779914529914,0.12222929611897704,0.19182220782420475,130714.91021050364,699.4113498264073,131414.32156033005,2322,13,530.825,39,1,19,35.84184323112967,0.6220619658119657,44.34895833333334,1022.604166666668,26.22061965811969,0
3062,4,1,0,41,0.024390243902439025,0.0,1.0,41,700,400,300,0.5714285714285714,10,4,6,323.85259402253524,0.40302337398373983,0.12492221417796401,0.1880211630887033,130989.80150910527,284.2774018441646,131274.07891094944,2323,0,518.8536585365854,40,1,20,35.79225818193853,0.6231770833333332,44.08028455284554,1023.6788617886198,25.591971544715495,0
3063,4,0,0,41,0.0,0.0,1.0,41,850,700,150,0.8235294117647058,10,7,3,326.11713177796605,0.4027439024390244,0.12819035910144727,0.18997736728660966,131119.87428944427,352.08746447221904,131471.9617539165,2324,1,519.8536585365854,40,1,20,35.60312892769728,0.6244791666666667,43.95325203252033,1024.18699186992,25.604674796747997,0
3064,4,0,0,41,0.0,0.0,1.0,41,950,900,50,0.9473684210526315,10,9,1,324.5955552899205,0.40276930894308943,0.12225364789110627,0.18947584208903842,131197.94894118933,317.2542178928139,131515.20315908216,2325,2,520.8536585365854,40,1,20,35.56339483516848,0.6252604166666667,43.877032520325216,1024.491869918701,25.612296747967527,0
3065,4,0,0,41,0.0,0.0,1.0,41,1350,800,550,0.5925925925925926,19,8,11,325.3881701455424,0.4019308943089431,0.11727045898531929,0.19084394537373445,131380.213497257,349.9134526406324,131730.12694989765,2326,3,521.8536585365854,40,1,20,35.359461736716895,0.6270833333333332,43.69918699186992,1025.2032520325208,25.63008130081302,0
3066,4,0,0,41,0.0,0.0,1.0,41,850,600,250,0.7058823529411765,11,6,5,324.28270099148574,0.40261686991869916,0.11847794823206392,0.19058455071083774,131458.36560785584,325.9347734483488,131784.3003813042,2327,4,522.8536585365854,40,1,20,35.3091038218875,0.6278645833333333,43.6229674796748,1025.5081300813013,25.63770325203253,0
3067,4,0,0,41,0.0,0.0,1.0,41,800,400,400,0.5,12,4,8,325.32842125139956,0.40243902439024387,0.11504886749224186,0.19132951207862034,131484.42147531235,355.1238515434021,131839.54532685576,2328,5,523.8536585365854,40,1,20,35.25606090632846,0.628125,43.59756097560976,1025.6097560975613,25.640243902439032,0
3068,4,0,0,41,0.0,0.0,1.0,41,1250,800,450,0.64,17,8,9,324.16146718417957,0.4025660569105691,0.11673112274353414,0.1912950516749657,131614.73954202203,332.88541460110963,131947.62495662313,2329,6,524.8536585365854,40,1,17,35.15483146809285,0.6294270833333333,43.47052845528456,1026.1178861788626,25.652947154471565,0
3069,4,1,0,42,0.023809523809523808,0.0,1.0,42,850,500,350,0.5882352941176471,12,5,7,316.0048518489509,0.4048344947735192,0.11966389801043031,0.1878251570633777,131887.99622858418,-64.55065822624505,131823.44557035793,2330,0,513.3333333333334,41,1,19,35.0894984225098,0.630589430894309,43.20436507936508,1027.1825396825407,25.053232675183917,0
3070,4,0,0,42,0.0,0.0,1.0,42,1150,1000,150,0.8695652173913043,13,10,3,315.8368895193324,0.40444734804490906,0.12637574821394137,0.1882300633855721,131989.9189421138,-62.54291068279494,131927.37603143102,2331,1,514.3333333333334,41,1,20,34.991471970135805,0.6316056910569106,43.10515873015873,1027.5793650793646,25.062911343399136,0
3071,4,0,0,42,0.0,0.0,1.0,42,1050,700,350,0.6666666666666666,14,7,7,315.8368895193324,0.40444734804490906,0.12637574821394137,0.1882300633855721,131989.9189421138,-62.54291068279494,131927.37603143102,2332,2,515.3333333333334,41,1,20,34.991471970135805,0.6316056910569106,43.10515873015873,1027.5793650793646,25.062911343399136,0
3072,4,0,0,42,0.0,0.0,1.0,42,1250,1000,250,0.8,15,10,5,317.92741448812274,0.4042537746806039,0.12030692018144995,0.18985855570671104,132066.3868122479,-2.4950199987520136,132063.89179224914,2333,3,516.3333333333334,41,1,20,34.86099716887044,0.6323678861788619,43.03075396825396,1027.876984126983,25.07017034456056,0
3073,4,1,1,42,0.023255813953488372,0.023255813953488372,0.9767441860465116,43,1350,1000,350,0.7407407407407407,17,10,7,312.9586470424259,0.4064230343300111,0.12012948612930185,0.18816505743468165,132323.21994621717,-317.66082266690535,132005.55912355025,2334,0,505.30232558139534,42,1,21,34.73111697118102,0.6334325396825398,42.781007751937985,1028.875968992248,24.49704688076781,0
3074,4,0,0,42,0.0,0.0,1.0,42,1200,900,300,0.75,15,9,6,320.10888203017805,0.40443524970963995,0.11554783950617242,0.19206532921810693,132244.8979591837,66.55328798185496,132311.45124716556,2335,1,518.0714285714286,41,1,21,34.625771604938244,0.6341463414634146,42.857142857142854,1028.5714285714287,25.087108013937286,0
3075,4,0,0,42,0.0,0.0,1.0,42,1200,800,400,0.6666666666666666,16,8,8,317.8504707785904,0.4036367595818815,0.11627458542229063,0.1912265129301358,132346.95845930965,13.308610481227134,132360.2670697909,2336,2,519.0714285714286,41,1,21,34.58148540943566,0.6351626016260162,42.757936507936506,1028.968253968254,25.096786682152537,0
3076,4,1,0,43,0.023255813953488372,0.0,1.0,43,1250,900,350,0.72,16,9,7,311.8074097006926,0.4068152454780362,0.12814896198652703,0.18941973199252993,132711.95969867488,-323.86583821124185,132388.09386046365,2337,0,507.9767441860465,40,3,19,34.37140414899564,0.6403645833333333,42.403455284552855,1030.3861788617899,25.759654471544746,0
3077,4,0,0,43,0.0,0.0,1.0,43,1200,900,300,0.75,15,9,6,313.03314004782357,0.4071843853820598,0.1246729901937178,0.19069640477507985,132816.69439693657,-284.7946204309394,132531.89977650563,2338,1,508.9767441860465,40,3,19,34.23502251142002,0.64140625,42.30182926829269,1030.792682926831,25.769817073170778,0
3078,4,0,0,43,0.0,0.0,1.0,43,1000,500,500,0.5,15,5,10,310.3296921110143,0.406999815430048,0.12171421366923818,0.18931417477247406,132869.077237838,-353.35603394142356,132515.7212038966,2339,2,509.9767441860465,40,3,19,34.25229998357155,0.6419270833333333,42.25101626016261,1030.9959349593503,25.774898373983756,0
3079,4,0,0,43,0.0,0.0,1.0,43,1050,600,450,0.5714285714285714,15,6,9,312.9013564997938,0.4065614617940199,0.12409210677053495,0.19155300171730438,133000.07952442332,-276.81894044549983,132723.26058397783,2340,3,510.9767441860465,40,3,19,34.055008210180624,0.6432291666666667,42.1239837398374,1031.5040650406506,25.787601626016265,0
3080,4,1,3,41,0.022727272727272728,0.06818181818181818,0.9318181818181819,44,950,800,150,0.8421052631578947,11,8,3,307.832206533517,0.4083751761804087,0.12956249017175447,0.18954449356140693,133216.06217718564,-598.3611268581533,132617.70105032748,2341,0,500.34090909090907,41,3,20,33.969985264911266,0.6438008130081301,41.91468253968254,1032.3412698412694,25.17905536198218,0
3081,4,0,0,41,0.0,0.0,1.0,41,1150,800,350,0.6956521739130435,15,8,7,327.64185647121917,0.40203252032520326,0.13327746213288272,0.19950868737124436,132800.32687717033,502.1891276041868,133302.51600477452,2342,5,537.5121951219512,39,2,20,33.87495789119083,0.6428952991452991,42.31770833333334,1030.7291666666683,26.428952991453034,0
3082,4,1,1,41,0.023809523809523808,0.023809523809523808,0.9761904761904762,42,1250,800,450,0.64,17,8,9,322.3672007199526,0.4042295780100658,0.1390088784454977,0.19776399932989036,133078.71187991634,180.04236482916428,133258.7542447455,2343,0,525.6904761904761,40,2,20,33.73223021110345,0.6440104166666666,42.04776422764229,1031.8089430894331,25.795223577235827,0
3083,4,0,0,41,0.0,0.0,1.0,41,1250,900,350,0.72,16,9,7,332.56624454274174,0.4012195121951219,0.14520875143127987,0.20396709920717424,133068.8815646705,650.8436414930948,133719.7252061636,2344,7,539.5121951219512,39,2,20,33.47898788490663,0.6455662393162391,42.057291666666686,1031.7708333333362,26.455662393162466,0
3084,4,0,0,41,0.0,0.0,1.0,41,1350,1000,350,0.7407407407407407,17,10,7,330.5159197155104,0.4010924796747968,0.1419798212514365,0.20329498748981986,133176.37939453154,603.3827039930857,133779.76209852463,2345,8,540.5121951219512,39,2,20,33.42426497796615,0.6466346153846152,41.953125000000014,1032.1875000000023,26.466346153846214,0
3085,4,0,0,41,0.0,0.0,1.0,41,1150,1000,150,0.8695652173913043,13,10,3,333.0253726941853,0.4007876016260163,0.14794598758216426,0.20513452260858137,133230.1445855037,673.8037109375251,133903.94829644123,2346,9,541.5121951219512,39,2,20,33.30569148757273,0.6471688034188033,41.90104166666668,1032.395833333335,26.47168803418808,0
3086,4,0,0,41,0.0,0.0,1.0,41,1050,700,350,0.6666666666666666,14,7,7,335.9091942979135,0.40073678861788614,0.15010062144196157,0.20736013401429135,133310.81271701414,756.0655381944684,134066.8782552086,2347,10,542.5121951219512,39,2,21,33.15051106179814,0.6479700854700854,41.82291666666668,1032.7083333333353,26.479700854700905,0
3087,4,0,0,41,0.0,0.0,1.0,41,1000,700,300,0.7,13,7,6,337.2870101866875,0.4006859756097561,0.14668585415052315,0.2083614147041128,133337.7075195314,794.6153428819594,134132.32286241336,2348,11,543.5121951219512,39,2,21,33.08801899478904,0.6482371794871794,41.79687500000001,1032.8125000000011,26.482371794871824,0
3088,4,0,0,41,0.0,0.0,1.0,41,650,300,350,0.46153846153846156,10,3,7,338.43924699576223,0.40066056910569103,0.14647917804041866,0.20952811808389346,133418.40820312517,830.8051215277924,134249.21332465296,2349,12,544.5121951219512,39,2,21,32.97749882368757,0.6490384615384615,41.71875000000001,1033.1250000000014,26.49038461538465,0
3089,4,1,1,41,0.023809523809523808,0.023809523809523808,0.9761904761904762,42,950,700,250,0.7368421052631579,12,7,5,332.6383482427222,0.4021607626790554,0.1445646751851426,0.20743929154232088,133687.58680555574,493.93446180557567,134181.5212673613,2350,0,532.5238095238095,39,3,21,32.85824603814128,0.6517094017094017,41.45833333333334,1034.166666666668,26.517094017094053,0
3090,4,0,0,41,0.0,0.0,1.0,41,1200,1000,200,0.8333333333333334,14,10,4,338.71541880778716,0.39964430894308944,0.1521381376955766,0.2115373653309013,133741.45507812515,860.0585937500161,134601.51367187517,2351,14,546.5121951219512,39,2,18,32.647280966767376,0.6522435897435896,41.40625000000001,1034.3750000000011,26.522435897435926,0
3091,4,0,0,41,0.0,0.0,1.0,41,1600,1200,400,0.75,20,12,8,337.69402495107425,0.39890752032520327,0.15315443554918584,0.21213673956787454,133957.03667534716,847.2981770833294,134804.3348524305,2352,15,547.5121951219512,39,2,18,32.458324948011004,0.654380341880342,41.197916666666664,1035.208333333333,26.54380341880341,0
3092,4,0,0,41,0.0,0.0,1.0,41,1250,1000,250,0.8,15,10,5,337.7946545809591,0.39890752032520327,0.15621335452944152,0.2128234762892203,134064.892578125,857.2808159722229,134922.17339409722,2353,16,548.5121951219512,39,2,18,32.34803527123985,0.6554487179487181,41.09375,1035.625,26.55448717948718,0
3093,4,0,0,41,0.0,0.0,1.0,41,900,400,500,0.4444444444444444,14,4,10,338.26821778201423,0.3989837398373984,0.158358778157917,0.21359221751378604,134145.81298828113,875.4530164930418,135021.26600477417,2354,17,549.5121951219512,39,2,18,32.255006703536104,0.6562500000000002,41.01562499999999,1035.937499999999,26.562499999999975,0
3094,4,0,0,41,0.0,0.0,1.0,41,1100,900,200,0.8181818181818182,13,9,4,335.1096792989812,0.398780487804878,0.1532456579089312,0.21206559094569094,134226.7578124999,796.1371527777637,135022.89496527766,2355,18,550.5121951219512,39,2,18,32.25606487066076,0.6570512820512822,40.93749999999999,1036.2499999999993,26.570512820512803,0
3095,4,0,0,41,0.0,0.0,1.0,41,1250,900,350,0.72,16,9,7,336.30463877174833,0.39855182926829263,0.15899007231278373,0.21313574240629904,134280.73459201382,831.8467881944396,135112.58138020826,2356,19,551.5121951219512,39,2,18,32.17127303182579,0.6575854700854702,40.885416666666664,1036.4583333333328,26.575854700854688,0
3096,4,0,0,41,0.0,0.0,1.0,41,1900,1500,400,0.7894736842105263,23,15,8,335.4882011182672,0.3986788617886179,0.1571989926407904,0.21356269375533665,134442.73003472204,820.7899305555363,135263.51996527758,2357,20,552.5121951219512,39,2,19,32.030936118923265,0.6591880341880343,40.72916666666666,1037.083333333332,26.591880341880305,0
3097,4,0,0,41,0.0,0.0,1.0,41,950,800,150,0.8421052631578947,11,8,3,334.89298752134425,0.39883130081300816,0.15654142079233369,0.2133416171944993,134469.73876953113,806.5945095485981,135276.33327907973,2358,21,553.5121951219512,39,2,19,32.01945448763012,0.6594551282051283,40.70312499999999,1037.187499999999,26.59455128205126,0
3098,4,0,0,41,0.0,0.0,1.0,41,1200,900,300,0.75,15,9,6,334.57996314818445,0.3989329268292683,0.15898634733996087,0.21378326747273896,134579.2229940941,805.5511221000429,135384.77411619414,2359,22,554.5121951219512,37,4,19,31.918502765155516,0.664132882882883,40.59758771929823,1037.6096491228052,28.043504030346085,0
3099,4,0,0,41,0.0,0.0,1.0,41,550,300,250,0.5454545454545454,8,3,5,332.8670321810321,0.3987042682926829,0.15615528936354472,0.21285497247035695,134607.66774392096,761.2909741458673,135368.95871806683,2360,23,555.5121951219512,37,4,19,31.93461186249648,0.6644144144144146,40.57017543859648,1037.7192982456122,28.04646752015168,0
3100,4,0,0,41,0.0,0.0,1.0,41,1150,800,350,0.6956521739130435,15,8,7,336.91104795651324,0.3983485772357724,0.14291193790753787,0.21808433703053343,135050.04160502955,899.9702087442419,135950.01181377377,2361,24,556.5121951219512,38,3,19,31.389402816322338,0.6669407894736842,40.14423076923077,1039.4230769230767,27.353238866396755,1
3101,4,0,0,41,0.0,0.0,1.0,41,950,400,550,0.42105263157894735,15,4,11,338.9968651223568,0.39773882113821135,0.14000145344102188,0.22011050621987313,135161.1139076082,963.8387802249899,136124.9526878332,2362,25,557.5121951219512,38,3,19,31.224742285694717,0.6680372807017544,40.03739316239316,1039.8504273504268,27.36448493027439,0
3102,4,0,0,41,0.0,0.0,1.0,41,1050,800,250,0.7619047619047619,13,8,5,340.87143817825927,0.398094512195122,0.13962763292382263,0.22183986110317735,135244.4480970123,1020.193905690709,136264.642002703,2363,26,558.5121951219512,38,3,19,31.093150849082434,0.6688596491228069,39.95726495726496,1040.1709401709409,27.372919478182656,0
3103,4,0,0,41,0.0,0.0,1.0,41,700,300,400,0.42857142857142855,11,3,8,343.8954584228788,0.39778963414634144,0.1445230903325665,0.22415354579129837,135300.0184911244,1105.8123767258523,136405.83086785028,2364,27,559.5121951219512,38,3,20,30.959257547751072,0.669407894736842,39.90384615384616,1040.3846153846166,27.37854251012149,0
3104,4,0,0,41,0.0,0.0,1.0,41,1400,1100,300,0.7857142857142857,17,11,6,333.35677020262557,0.3974339430894309,0.1660744064400801,0.20624294395068116,133393.4736784488,693.5235103113354,134086.9971887601,2365,28,560.5121951219512,40,1,20,33.13371044433515,0.6471354166666666,41.742886178861795,1033.0284552845537,25.825711382113845,5
3105,4,0,0,41,0.0,0.0,1.0,41,650,400,250,0.6153846153846154,9,4,5,335.587929240374,0.3965701219512195,0.1681746656176233,0.20806451612903246,133472.22222222263,758.333333333373,134230.555555556,2366,29,561.5121951219512,40,1,20,32.997311827957,0.6479166666666665,41.666666666666686,1033.3333333333364,25.83333333333341,0
3106,4,0,0,41,0.0,0.0,1.0,41,900,500,400,0.5555555555555556,13,5,8,335.9656728500568,0.3967479674796748,0.1638599699177159,0.20890497101278005,133579.88281250026,775.6510416666976,134355.53385416695,2367,30,562.5121951219512,39,2,20,32.87988714228135,0.6506410256410255,41.562500000000014,1033.750000000002,26.50641025641031,0
3107,4,0,0,41,0.0,0.0,1.0,41,1100,800,300,0.7272727272727273,14,8,6,333.8963971217498,0.3964430894308943,0.16549697977592093,0.20837569623016078,133714.5195855037,729.3592664930803,134443.8788519968,2368,31,563.5121951219512,39,2,17,32.798809044213925,0.6519764957264957,41.43229166666668,1034.270833333335,26.519764957265004,0
3108,4,0,0,41,0.0,0.0,1.0,41,950,900,50,0.9473684210526315,10,9,1,336.64439736726024,0.3960619918699187,0.1699753445379797,0.2105511432400271,133795.33420138902,808.2899305555657,134603.62413194458,2369,32,564.5121951219512,39,2,17,32.64699959726138,0.6527777777777778,41.35416666666667,1034.5833333333344,26.527777777777803,0
3109,4,1,1,41,0.023809523809523808,0.023809523809523808,0.9761904761904762,42,1600,1400,200,0.875,18,14,4,334.0680033141652,0.3994386372435153,0.17500376263904682,0.21075553006665865,134113.6987925958,560.6191145439728,134674.31790713978,2370,0,552.047619047619,41,1,18,32.39582335663889,0.6526930894308942,41.04662698412699,1035.8134920634925,25.263743708865672,0
3110,4,0,1,40,0.0,0.024390243902439025,0.975609756097561,41,1050,800,250,0.7619047619047619,13,8,5,347.8656889119675,0.3957571138211382,0.19228302770472272,0.21370696133702577,133131.14636005388,1062.3515888360457,134193.49794888994,2371,34,566.5121951219512,40,1,17,33.02191038897096,0.6445312499999998,41.99695121951221,1032.012195121954,25.80030487804885,3
3111,4,0,0,40,0.0,0.0,1.0,40,1450,1100,350,0.7586206896551724,18,11,7,349.74428363808426,0.394778311965812,0.21508477141992022,0.21512204261761564,133176.37939453172,1315.5354817708776,134491.9148763026,2372,35,579.325,39,1,17,32.928083055807846,0.6466346153846152,41.95312500000002,1032.1875000000036,26.466346153846246,0
3112,4,0,0,40,0.0,0.0,1.0,40,1150,900,250,0.782608695652174,14,9,5,350.5601064046904,0.3947382478632479,0.2124420012104089,0.21640428984409146,133310.81271701428,1346.6905381944846,134657.50325520878,2373,36,580.325,39,1,18,32.772258086208055,0.6479700854700854,41.822916666666686,1032.7083333333364,26.479700854700933,0
3113,4,0,0,40,0.0,0.0,1.0,40,850,600,250,0.7058823529411765,11,6,5,352.70571700544565,0.39445779914529916,0.21509276999092464,0.21820228294092392,133391.50526258702,1409.5893012153035,134801.09456380233,2374,37,581.325,39,1,18,32.63598282410676,0.6487713675213674,41.74479166666668,1033.020833333335,26.48771367521372,0
3114,4,0,0,40,0.0,0.0,1.0,40,800,700,100,0.875,9,7,2,354.0929741410513,0.39424412393162395,0.22109335618509895,0.21937840165553357,133445.31385633702,1450.4096137152978,134895.72347005233,2375,38,582.325,39,1,18,32.54622861847633,0.6493055555555554,41.69270833333334,1033.2291666666683,26.4930555555556,0
3115,4,0,0,40,0.0,0.0,1.0,40,700,500,200,0.7142857142857143,9,5,4,351.70384290529194,0.3933360042735043,0.213675236953917,0.21857072268298383,133559.51126379738,1394.6868116268524,134954.19807542424,2376,39,583.325,36,4,18,32.493554127174356,0.6559606481481483,41.5822072072072,1033.6711711711696,28.713088088088043,0
3116,4,0,0,40,0.0,0.0,1.0,40,1100,700,400,0.6363636363636364,15,7,8,351.37495478744154,0.3934962606837607,0.2092063407910083,0.21902294769334832,133670.5780264119,1393.6986620883288,135064.27668850025,2377,40,584.325,37,3,19,32.39085197752093,0.6551238738738738,41.47478070175438,1034.1008771929821,27.948672356567084,0
3117,4,0,0,40,0.0,0.0,1.0,40,850,500,350,0.5882352941176471,12,5,7,351.37495478744154,0.3934962606837607,0.2092063407910083,0.21902294769334832,133670.5780264119,1393.6986620883288,135064.27668850025,2378,41,585.325,37,3,19,32.39085197752093,0.6551238738738738,41.47478070175438,1034.1008771929821,27.948672356567084,0
3118,4,0,0,40,0.0,0.0,1.0,40,1400,1100,300,0.7857142857142857,17,11,6,353.06856031585875,0.3938301282051282,0.21115172706081853,0.22126567544894227,133869.08111149567,1452.9927477685242,135322.0738592642,2379,42,586.325,37,3,18,32.14840714840715,0.6570945945945947,41.282894736842096,1034.86842105263,27.969416785206217,0
3119,4,0,0,40,0.0,0.0,1.0,40,1150,1000,150,0.8695652173913043,13,10,3,355.55605429474315,0.39366987179487184,0.2146398305084749,0.22316816173818957,133925.8233302553,1523.6274622960748,135449.4507925514,2380,43,587.325,37,3,18,32.027277542372886,0.6576576576576577,41.22807017543859,1035.0877192982443,27.975343764817413,0
3120,4,0,0,40,0.0,0.0,1.0,40,1100,900,200,0.8181818181818182,13,9,4,355.5625878021739,0.3934561965811966,0.21477128335451123,0.22386220528024847,134039.343836565,1531.8751923668744,135571.21902893187,2381,44,588.325,37,3,18,31.913560638147676,0.6587837837837838,41.118421052631575,1035.5263157894728,27.987197724039806,0
3121,4,0,0,40,0.0,0.0,1.0,40,1000,700,300,0.7,13,7,6,354.652061852059,0.3932024572649573,0.21208840656432004,0.22346155598350187,134067.73147747366,1509.479479262829,135577.2109567365,2382,45,589.325,37,3,18,31.908748014822663,0.6590653153153154,41.091008771929815,1035.6359649122792,27.990161213845383,0
3122,4,0,0,40,0.0,0.0,1.0,40,750,300,450,0.4,12,3,9,356.7233024152527,0.3924412393162393,0.2161092294665543,0.22528888778203912,134152.9124345951,1571.0939904585878,135724.0064250537,2383,46,590.325,37,3,18,31.769951312447077,0.6599099099099099,41.008771929824555,1035.9649122807007,27.99905168326218,0
3123,4,0,0,40,0.0,0.0,1.0,40,950,700,250,0.7368421052631579,12,7,5,354.50160969737715,0.3926549145299145,0.20893650793650842,0.2242329458929191,134209.71476800545,1515.511984456746,135725.2267524622,2384,47,591.325,37,3,18,31.770723104056426,0.660472972972973,40.95394736842105,1036.184210526315,28.004978662873377,0
3124,4,0,0,40,0.0,0.0,1.0,40,1100,800,300,0.7272727272727273,14,8,6,356.7445973016485,0.39249465811965817,0.21409456314787434,0.22635324985837457,134323.35550361633,1583.8262734687428,135907.18177708506,2385,48,592.325,37,3,18,31.599058599534597,0.6615990990990992,40.84429824561403,1036.6228070175425,28.016832622095745,0
3125,4,0,0,40,0.0,0.0,1.0,40,1200,800,400,0.6666666666666666,16,8,8,353.35572911163354,0.39129273504273504,0.20940473673081006,0.22490164777508942,134437.04433094792,1500.819963835018,135937.86429478292,2386,49,593.325,37,3,19,31.573359413547607,0.6627252252252254,40.734649122807014,1037.0614035087715,28.028686581318148,0
3126,4,0,0,40,0.0,0.0,1.0,40,500,300,200,0.6,7,3,4,351.8555098120814,0.3914930555555556,0.20558873269210465,0.2244710032590761,134522.34251163804,1466.4854811095545,135988.8279927476,2387,50,594.325,37,3,19,31.527124511151033,0.6635698198198199,40.652412280701746,1037.3903508771918,28.037577050734914,0
3127,4,0,0,40,0.0,0.0,1.0,40,700,400,300,0.5714285714285714,10,4,6,348.11077166139864,0.3910523504273504,0.2010405662370589,0.2229510530816506,134664.5662607724,1375.6372152969939,136040.2034760694,2388,51,595.325,37,3,19,31.482410733150207,0.6649774774774776,40.51535087719297,1037.938596491227,28.05239449976289,0
3128,4,0,0,40,0.0,0.0,1.0,40,850,500,350,0.5882352941176471,12,5,7,347.3737318772228,0.3910389957264957,0.19823371000105605,0.2230021604844353,134749.93657904342,1361.7176679362726,136111.65424697968,2389,52,596.325,37,3,20,31.4164422501496,0.6658220720720722,40.43311403508771,1038.2675438596482,28.06128496917968,0
3129,4,0,0,40,0.0,0.0,1.0,40,950,700,250,0.7368421052631579,12,7,5,348.18428450205136,0.3908386752136752,0.2011774023231261,0.22369777301454702,134778.3993632655,1385.544109726056,136163.94347299155,2390,53,597.325,37,3,20,31.367036254839846,0.6661036036036037,40.40570175438596,1038.3771929824552,28.064248458985276,0
3130,4,0,0,40,0.0,0.0,1.0,40,800,400,400,0.5,12,4,8,347.1532301396725,0.3903846153846154,0.19770424319189384,0.2237367144451193,134892.28055747907,1365.658183287147,136257.93874076623,2391,54,598.325,37,3,18,31.280346210681852,0.6672297297297298,40.29605263157894,1038.815789473683,28.07610241820765,0
3131,4,0,1,39,0.0,0.025,0.975,40,650,600,50,0.9230769230769231,7,6,1,349.4249736028079,0.38997061965811963,0.19449984172206447,0.22573282037040268,134977.7230133309,1432.917460180043,136410.64047351092,2392,55,599.325,37,3,18,31.136237733459946,0.6680743243243243,40.21381578947368,1039.1447368421043,28.08499288762444,0
3132,4,0,0,39,0.0,0.0,1.0,39,1000,700,300,0.7,13,7,6,354.8527711931458,0.3905195681511471,0.18204405609564933,0.22894207461734017,134930.7648019642,1776.1111618375219,136706.87596380172,2393,56,588.3076923076923,36,3,18,31.042027964448295,0.6695601851851851,40.25900900900901,1038.9639639639645,28.860110110110124,0
3133,4,0,0,39,0.0,0.0,1.0,39,900,500,400,0.5555555555555556,13,5,8,357.24995862331247,0.3892543859649123,0.18997694252298802,0.23123542202616928,135047.79061155755,1849.1635216297411,136896.95413318728,2394,57,589.3076923076923,36,3,18,30.86312748284579,0.6707175925925926,40.1463963963964,1039.4144144144148,28.872622622622632,0
3134,4,0,0,39,0.0,0.0,1.0,39,650,400,250,0.6153846153846154,9,4,5,356.300024359428,0.3888326585695007,0.1908285626192685,0.23080740525346516,135077.05498995612,1825.5915966642299,136902.64658662034,2395,58,590.3076923076923,36,3,18,30.85865561694292,0.6710069444444444,40.11824324324324,1039.5270270270266,28.87575075075074,0
3135,4,0,0,39,0.0,0.0,1.0,39,1150,900,250,0.782608695652174,14,9,5,355.98051709870674,0.3888326585695007,0.1927367552841397,0.23097456882448072,135135.5932579539,1821.127673281392,136956.7209312353,2396,59,591.3076923076923,36,3,18,30.808648326654392,0.6715856481481481,40.06193693693694,1039.7522522522524,28.88200700700701,0
3136,4,0,0,39,0.0,0.0,1.0,39,1050,800,250,0.7619047619047619,13,8,5,355.235343349042,0.38838281601439495,0.19162065605716117,0.23124093492002135,135252.70783875103,1809.308421597285,137062.01626034832,2397,60,592.3076923076923,36,3,18,30.711405218144428,0.6727430555555556,39.94932432432433,1040.2027027027036,28.894519519519545,0
3137,4,0,0,39,0.0,0.0,1.0,39,1000,700,300,0.7,13,7,6,357.78139091169356,0.38812977957714795,0.20486684572566216,0.23008786520136962,134813.78971877292,1847.308837553784,136661.0985563267,2398,61,593.3076923076923,36,3,16,31.082601387985264,0.6684027777777777,40.37162162162163,1038.5135135135142,28.847597597597616,1
3138,4,0,0,39,0.0,0.0,1.0,39,950,800,150,0.8421052631578947,11,8,3,357.78139091169356,0.38812977957714795,0.20486684572566216,0.23008786520136962,134813.78971877292,1846.773039931838,136660.56275870476,2399,62,594.3076923076923,36,3,16,31.082601387985264,0.6684027777777777,40.37162162162163,1038.5135135135142,28.847597597597616,0
3139,4,0,0,39,0.0,0.0,1.0,39,750,500,250,0.6666666666666666,10,5,5,359.51209727099933,0.38812977957714795,0.18365287588294676,0.22128974434506823,133203.26063368033,1813.1071554028454,135016.36778908316,2400,63,595.3076923076923,35,4,16,32.64904978136563,0.6544642857142858,41.92708333333332,1032.291666666665,29.49404761904757,7
3140,4,0,0,39,0.0,0.0,1.0,39,750,500,250,0.6666666666666666,10,5,5,358.5696711362729,0.3881016644174539,0.15863109169397216,0.21298174442190676,131862.52170138896,1776.2803819444546,133638.80208333343,2401,64,596.3076923076923,35,4,18,34.022143340094665,0.6410714285714285,43.22916666666667,1027.083333333334,29.345238095238113,7
3141,4,0,0,39,0.0,0.0,1.0,39,600,300,300,0.5,9,3,6,360.08050087708745,0.3876799370220423,0.157520298784239,0.21438193201112718,131951.6933111498,1702.646363811736,133654.33967496155,2402,65,597.3076923076923,35,4,18,33.89341838458938,0.6419642857142855,43.142361111111114,1027.4305555555563,29.355158730158752,0
3142,4,0,0,39,0.0,0.0,1.0,39,900,700,200,0.7777777777777778,11,7,4,359.66823849392955,0.3874269005847953,0.16474690962418936,0.21497801442147274,132100.37964034648,1702.4621699245658,133802.84181027106,2403,66,598.3076923076923,35,4,18,33.7541281993545,0.6434523809523809,42.99768518518519,1028.0092592592603,29.371693121693152,0
3143,4,0,0,39,0.0,0.0,1.0,39,550,200,350,0.36363636363636365,9,2,7,360.48329481558204,0.38770805218173643,0.1658269706885509,0.2161440322355778,132219.3889853395,1732.5761959876522,133951.96518132713,2404,67,599.3076923076923,35,4,19,33.61326806212018,0.6446428571428571,42.88194444444444,1028.4722222222222,29.384920634920633,0
3144,4,1,0,40,0.025,0.0,1.0,40,550,300,250,0.5454545454545454,8,3,5,353.09405495354184,0.392815170940171,0.1713582677165355,0.2135378332338087,132542.91453615788,1360.0230297865542,133902.93756594445,2405,0,585.3,36,4,20,33.477781423155434,0.6458333333333334,42.56756756756757,1029.7297297297305,28.603603603603624,0
3145,4,1,2,39,0.024390243902439025,0.04878048780487805,0.9512195121951219,41,900,700,200,0.7777777777777778,11,7,4,338.0984555906574,0.39400406504065044,0.15415342944296073,0.2039811283416395,132452.98603121116,756.4300031046793,133209.41603431583,2406,0,572.0,38,3,18,33.95411693478637,0.6411732456140351,42.65491452991453,1029.3803418803416,27.088956365272146,1
3146,4,0,0,39,0.0,0.0,1.0,39,1100,600,500,0.5454545454545454,16,6,10,357.85496494305914,0.3879610886189833,0.15883627464187877,0.21508966840261792,132311.0948786626,1669.6364438763285,133980.73132253895,2407,1,595.5128205128206,36,3,18,33.58850518096906,0.6435185185185185,42.7927927927928,1028.8288288288302,28.578578578578615,0
3147,4,1,1,39,0.025,0.025,0.975,40,1300,1100,200,0.8461538461538461,15,11,4,348.92032353331876,0.3917334401709402,0.15682011708355503,0.21162727176213875,132652.03145438977,1256.9979464835274,133909.0294008733,2408,0,581.6,37,3,14,33.47558541777542,0.6449887387387387,42.46162280701754,1030.1535087719294,27.84198672356566,0
3148,4,0,0,39,0.0,0.0,1.0,39,1050,900,150,0.8571428571428571,12,9,3,358.0760865294953,0.3875955915429599,0.16413396013264814,0.2170524826696685,132629.89921932085,1698.3190538511724,134328.21827317204,2409,3,597.5128205128206,36,3,16,33.26204402171934,0.6467013888888888,42.48310810810812,1030.067567567569,28.61298798798803,0
3149,4,0,0,39,0.0,0.0,1.0,39,900,800,100,0.8888888888888888,10,8,2,355.77509032816727,0.3870051731893837,0.15811125122600544,0.21615817241054017,132716.91243608494,1643.4743020047313,134360.38673808967,2410,4,598.5128205128206,36,3,16,33.23383424408015,0.6475694444444444,42.39864864864866,1030.405405405407,28.622372372372418,0
3150,4,0,0,39,0.0,0.0,1.0,39,900,500,400,0.5555555555555556,13,5,8,360.25857519656614,0.3866396761133603,0.15955536506175627,0.21939100058377745,132803.95418645017,1768.7526631361327,134572.7068495863,2411,5,599.5128205128206,36,3,16,33.030836884081715,0.6484375,42.3141891891892,1030.743243243245,28.631756756756804,0
3151,4,0,1,38,0.0,0.02564102564102564,0.9743589743589743,39,1000,600,400,0.6,14,6,8,362.3277846398617,0.3868364822312191,0.16031032502905784,0.22099339562811035,132861.99787202754,1827.918670359562,134689.9165423871,2412,6,600.5128205128206,36,3,16,32.9191698525396,0.6490162037037037,42.25788288288289,1030.9684684684694,28.638013013013037,0
3152,4,0,0,38,0.0,0.0,1.0,38,1450,1200,250,0.8275862068965517,17,12,5,362.76166824384273,0.387609649122807,0.15117428356347795,0.22194616696361763,132978.12328798397,2047.8731687768927,135025.99645676085,2413,7,597.2894736842105,36,2,16,32.79128907813809,0.6501736111111112,42.145270270270274,1031.4189189189192,28.650525525525534,0
3153,4,2,1,39,0.05,0.025,0.975,40,800,500,300,0.625,11,5,6,346.0151677609333,0.3937366452991453,0.14454296349912132,0.2143698070093521,133444.62393390675,1234.7727874570828,134679.39672136382,2414,0,568.375,38,2,17,32.75557508702995,0.6510416666666666,41.69337606837607,1033.2264957264956,27.190170940170937,0
3154,4,0,0,39,0.0,0.0,1.0,39,1250,1000,250,0.8,15,10,5,351.9258836477847,0.38973234367971205,0.1429725956946588,0.2180274557273552,133443.8977016965,1592.4723232148144,135036.3700249113,2415,1,583.9487179487179,37,2,17,32.60362499557819,0.6528716216216217,41.69407894736841,1033.2236842105249,27.924964438122295,0
3155,4,0,0,39,0.0,0.0,1.0,39,750,500,250,0.6666666666666666,10,5,5,353.6506126904119,0.3895355375618534,0.14249671000243036,0.21943554243812774,133501.31539901384,1642.5674028999615,135143.8828019138,2416,2,584.9487179487179,36,3,18,32.50154371435835,0.6553819444444444,41.63851351351351,1033.4459459459456,28.70683183183182,0
3156,4,0,0,39,0.0,0.0,1.0,39,1100,900,200,0.8181818181818182,13,9,4,353.65366036271206,0.38922627080521816,0.14295730779007854,0.21978246096610232,133559.5112637974,1646.7620069393522,135206.27327073677,2417,3,585.9487179487179,36,3,19,32.44316737480481,0.6559606481481483,41.5822072072072,1033.6711711711698,28.71308808808805,0
3157,4,0,0,39,0.0,0.0,1.0,39,850,600,250,0.7058823529411765,11,6,5,369.31541428602065,0.38922627080521816,0.1620440552511455,0.2132544124577191,130780.41459956561,1863.5095822173296,132643.92418178293,2418,4,586.9487179487179,36,3,16,34.84095746632903,0.6281828703703705,44.2849099099099,1022.8603603603591,28.412787787787753,5
3158,4,0,1,38,0.0,0.02564102564102564,0.9743589743589743,39,750,500,250,0.6666666666666666,10,5,5,369.02336837202813,0.38914192532613584,0.15880838668157082,0.21324480141803442,130809.21292914523,1854.3312738413956,132663.54420298664,2419,5,587.9487179487179,36,3,16,34.81923345075592,0.6284722222222223,44.25675675675675,1022.9729729729719,28.415915915915885,0
3159,4,0,0,38,0.0,0.0,1.0,38,1150,800,350,0.6956521739130435,15,8,7,375.79852473617933,0.38906175912754865,0.15452595835939564,0.21658055877652577,130706.0335889273,2223.8269193672622,132929.86050829457,2420,6,588.3947368421053,35,3,16,34.75063667232596,0.6294642857142858,44.35763888888888,1022.5694444444431,29.216269841269803,0
3160,4,1,0,39,0.02564102564102564,0.0,1.0,39,950,500,450,0.5263157894736842,14,5,9,382.61089717124315,0.3932186234817814,0.12736224706299515,0.21833074610897188,130321.6695066014,2202.9404042352426,132524.60991083665,2421,0,574.2820512820513,35,4,18,34.96703317463915,0.6255952380952381,44.73379629629629,1021.0648148148141,29.173280423280403,8
3161,4,0,1,38,0.0,0.02564102564102564,0.9743589743589743,39,750,500,250,0.6666666666666666,10,5,5,380.1249677713525,0.3934997750787224,0.12133518081178662,0.2177393309875229,130469.43486636227,2118.9379447445053,132588.37281110676,2422,1,575.2820512820513,35,4,18,34.88031513160378,0.6270833333333334,44.58912037037037,1021.6435185185182,29.189814814814806,0
3162,4,2,1,39,0.05,0.025,0.975,40,1250,1200,50,0.96,13,12,1,362.3561993638432,0.4020299145299145,0.054263301500681704,0.2027535069722878,129554.63927469132,1440.114213605959,130994.75348829728,2423,0,557.1,35,5,16,36.26364256480216,0.6178571428571429,45.48611111111111,1018.0555555555553,29.08730158730158,8
3163,4,2,3,38,0.04878048780487805,0.07317073170731707,0.926829268292683,41,850,500,350,0.5882352941176471,12,5,7,355.09392265193344,0.4061991869918699,0.04548174100525504,0.20009962640099624,129831.84831791263,1020.5000608716937,130852.34837878433,2424,0,544.4634146341464,36,5,17,36.16666666666666,0.6186342592592593,45.21396396396397,1019.1441441441452,28.309559559559588,0
3164,4,3,4,37,0.07317073170731707,0.0975609756097561,0.9024390243902439,41,1150,900,250,0.782608695652174,14,9,5,345.8014850170096,0.4084349593495935,0.07193830323122263,0.19688094599209627,130233.84871357834,807.0116569271836,131040.86037050551,2425,0,545.1463414634146,36,5,18,35.99565129449838,0.6226851851851853,44.81981981981981,1020.7207207207199,28.35335335335333,0
3165,4,0,0,37,0.0,0.0,1.0,37,1250,1000,250,0.8,15,10,5,367.3847932487844,0.3993681181181181,0.09975192583888237,0.20726047770072925,129876.19447314052,2142.9077708907284,132019.10224403127,2426,1,596.5945945945946,32,5,18,35.808404558404554,0.6279296875,45.17045454545455,1019.3181818181821,31.85369318181819,0
3166,4,1,0,38,0.02631578947368421,0.0,1.0,38,900,800,100,0.8888888888888888,10,8,2,355.3342034892601,0.40356804172593647,0.09865024549607893,0.20229518666179408,130231.31315179256,1655.1279856305232,131886.4411374231,2427,0,581.8684210526316,33,5,19,35.75496758314323,0.6291035353535354,44.822303921568626,1020.7107843137253,30.930629827688644,0
3167,4,0,0,38,0.0,0.0,1.0,38,950,700,250,0.7368421052631579,12,7,5,356.6847147022073,0.4033902323376008,0.098066595059076,0.20322733744660668,130262.58680555563,1692.5347222222322,131955.12152777787,2428,1,582.8684210526316,33,5,19,35.68877551020408,0.6294191919191918,44.79166666666667,1020.833333333334,30.934343434343457,0
3168,4,1,2,37,0.02564102564102564,0.05128205128205128,0.9487179487179487,39,900,600,300,0.6666666666666666,12,6,6,345.6810905678847,0.4071637426900585,0.09608196764160093,0.1983117835363128,130528.56445312499,1224.2513020833335,131752.8157552083,2429,0,568.8974358974359,35,4,15,35.70017838939859,0.6276785714285715,44.53125,1021.8749999999999,29.19642857142857,0
3169,4,0,0,37,0.0,0.0,1.0,37,1050,700,350,0.6666666666666666,14,7,7,360.35261561196864,0.4024336836836837,0.10653812718142985,0.20564780775883046,130325.14537677825,1992.6014033064296,132317.74678008468,2430,3,595.5135135135135,33,4,19,35.53168506961113,0.630050505050505,44.73039215686275,1021.0784313725497,30.941770647653023,0
3170,4,0,0,37,0.0,0.0,1.0,37,700,400,300,0.5714285714285714,10,4,6,365.60582304654804,0.40299674674674674,0.10627928468360359,0.20915062011619645,130419.01139285389,2136.3900002403116,132555.40139309422,2431,4,596.5135135135135,33,4,19,35.30231453709257,0.6309974747474746,44.63848039215687,1021.4460784313741,30.952911467617398,0
3171,4,1,1,37,0.02631578947368421,0.02631578947368421,0.9736842105263158,38,1100,900,200,0.8181818181818182,13,9,4,358.4927650935582,0.4085763394973921,0.09512284786471392,0.20667468806400452,130718.71456916103,1772.3426870748306,132491.05725623586,2432,0,581.7894736842105,34,4,15,35.180199844780745,0.6317401960784313,44.345238095238095,1022.6190476190479,30.07703081232494,0
3172,4,1,1,37,0.02631578947368421,0.02631578947368421,0.9736842105263158,38,500,300,200,0.6,7,3,4,358.42408079172526,0.40675379326695116,0.09113882949720908,0.20679793674155245,130749.15143140602,1772.728883219969,132521.88031462597,2433,0,582.7631578947369,34,4,16,35.151127148566324,0.6320465686274509,44.3154761904762,1022.7380952380962,30.08053221288518,0
3173,4,0,0,37,0.0,0.0,1.0,37,1150,900,250,0.782608695652174,14,9,5,368.82186774083533,0.40259009009009006,0.10131896037936317,0.21253105417331022,130700.8121876202,2241.06353325645,132941.87572087665,2434,7,599.5135135135135,33,4,17,34.9342841163311,0.6338383838383839,44.36274509803922,1022.5490196078437,30.986333927510415,0
3174,4,2,2,37,0.05128205128205128,0.05128205128205128,0.9487179487179487,39,900,600,300,0.6666666666666666,12,6,6,350.6719628437225,0.40910368870895186,0.09285457726488011,0.20475911709054317,131209.51753257902,1402.2998113854749,132611.8173439645,2435,0,569.7179487179487,35,4,18,34.883830396143985,0.6345238095238095,43.86574074074075,1024.5370370370383,29.272486772486808,0
3175,4,0,1,36,0.0,0.02702702702702703,0.972972972972973,37,1050,800,250,0.7619047619047619,13,8,5,365.99917455320417,0.4010573073073073,0.09837307071171297,0.21210680823690556,130920.20083922053,2183.337087898887,133103.5379271194,2436,9,601.5135135135135,33,4,18,34.78413263880574,0.6360479797979798,44.14828431372549,1023.4068627450984,31.01232917409389,0
3176,4,1,0,37,0.02702702702702703,0.0,1.0,37,500,300,200,0.6,7,3,4,365.2460523584547,0.40221471471471476,0.10429009160003999,0.21201530752954653,130982.9171021964,2168.1986795944,133151.1157817908,2437,0,602.1891891891892,33,4,19,34.73988886228499,0.6366792929292928,44.087009803921575,1023.6519607843147,31.019756387403476,0
3177,4,0,0,37,0.0,0.0,1.0,37,900,500,400,0.5555555555555556,13,5,8,363.68730467364344,0.4011511511511512,0.09895035020663157,0.21197339556919892,131139.77346453292,2138.7741493656354,133278.54761389855,2438,1,603.1891891891892,33,4,19,34.62102177554439,0.6382575757575757,43.93382352941177,1024.2647058823534,31.038324420677377,0
3178,4,0,0,37,0.0,0.0,1.0,37,750,400,350,0.5333333333333333,11,4,7,363.41209402829685,0.4011511511511512,0.09783919581742317,0.21198616147819518,131171.156000697,2133.8368956651498,133304.99289636215,2439,2,604.1891891891892,33,4,20,34.5963183395143,0.6385732323232322,43.903186274509814,1024.387254901962,31.042038027332183,0
3179,4,0,0,37,0.0,0.0,1.0,37,1100,700,400,0.6363636363636364,15,7,8,365.51807884867327,0.4010885885885886,0.09581457578587793,0.21391376440947915,131296.72369100837,2198.265240532503,133494.98893154087,2440,3,605.1891891891892,33,4,20,34.41535633145999,0.6398358585858585,43.78063725490197,1024.8774509803932,31.05689245395131,0
3180,4,1,1,37,0.02631578947368421,0.02631578947368421,0.9736842105263158,38,750,500,250,0.6666666666666666,10,5,5,355.8852053405297,0.4053016832622096,0.09254998837114314,0.20999484315125125,131610.90573637543,1767.678597174168,133378.5843335496,2441,0,590.2368421052631,33,5,16,34.344893307854626,0.6429924242424242,43.474264705882355,1026.1029411764707,31.094028520499112,0
3181,4,0,0,37,0.0,0.0,1.0,37,1200,1000,200,0.8333333333333334,14,10,4,365.2485429970861,0.4007132132132132,0.10090577782506904,0.21575146493316227,131651.87225793273,2217.130905009674,133869.0031629424,2442,5,607.1891891891892,32,5,17,34.06332020997375,0.6458333333333335,43.434343434343425,1026.2626262626252,32.07070707070704,0
3182,4,0,0,37,0.0,0.0,1.0,37,900,700,200,0.7777777777777778,11,7,4,364.2134502525838,0.40102602602602605,0.10258302583025825,0.21550621183067725,131716.66953627174,2194.5965335169803,133911.26606978872,2443,6,608.1891891891892,32,5,17,34.02444649446495,0.646484375,43.37121212121212,1026.515151515151,32.07859848484847,0
3183,4,0,0,37,0.0,0.0,1.0,37,650,400,250,0.6153846153846154,9,4,5,366.53681239906655,0.4005880880880881,0.10443937113062907,0.21743573269450103,131813.89534550055,2262.929005968787,134076.82435146935,2444,7,609.1891891891892,32,5,17,33.866654371080784,0.6474609375,43.276515151515156,1026.89393939394,32.09043560606062,0
3184,4,0,0,37,0.0,0.0,1.0,37,500,300,200,0.6,7,3,4,364.9855817442882,0.40046296296296297,0.10483854890051125,0.21670019867941895,131846.31191970204,2224.4005713702672,134070.7124910723,2445,8,610.1891891891892,32,5,17,33.87376034751251,0.6477864583333334,43.244949494949495,1027.0202020202019,32.09438131313131,0
3185,4,0,0,37,0.0,0.0,1.0,37,650,400,250,0.6153846153846154,9,4,5,365.9639890337018,0.3992117117117117,0.10792879130512745,0.21821105543921626,132008.45457415067,2262.0681244260904,134270.52269857677,2446,9,611.1891891891892,32,5,19,33.685035016586795,0.6494140625,43.08712121212122,1027.651515151516,32.11410984848487,0
3186,4,0,1,36,0.0,0.02702702702702703,0.972972972972973,37,950,700,250,0.7368421052631579,12,7,5,383.36916666167417,0.3993681181181181,0.0922797434019671,0.22259226631490442,130992.77388038542,2651.7888767077015,133644.5627570931,2447,10,612.1891891891892,34,3,18,34.26609683296506,0.6344975490196079,44.07738095238095,1023.6904761904757,30.10854341736693,3
3187,4,0,0,36,0.0,0.0,1.0,36,750,400,350,0.5333333333333333,11,4,7,388.27198901279377,0.39401455026455023,0.0907394099093699,0.22464884520220485,130857.49959450697,2961.6603289600184,133819.159923467,2448,21,629.9166666666666,33,3,18,34.27793248692457,0.6354166666666666,44.20955882352941,1023.1617647058828,31.004901960784327,0
3188,4,0,0,36,0.0,0.0,1.0,36,1200,800,400,0.6666666666666666,16,8,8,389.9884947373057,0.3941633597883598,0.08595412941677294,0.22619332694763725,130951.5570934256,3013.9201268742777,133965.4772202999,2449,22,630.9166666666666,33,3,18,34.13852969348659,0.6363636363636364,44.11764705882353,1023.5294117647059,31.016042780748663,0
3189,4,0,0,36,0.0,0.0,1.0,36,650,500,150,0.7692307692307693,8,5,3,389.9884947373057,0.3943452380952381,0.08595412941677294,0.22619332694763725,130951.5570934256,3013.9201268742777,133965.4772202999,2450,23,631.9166666666666,33,3,18,34.13852969348659,0.6363636363636364,44.11764705882353,1023.5294117647059,31.016042780748663,0
3190,4,1,0,37,0.02702702702702703,0.0,1.0,37,1050,800,250,0.7619047619047619,13,8,5,379.6618117756945,0.3959584584584585,0.09292600766639558,0.22219636557287253,131297.620819161,2569.7385204081647,133867.35933956917,2451,0,615.8108108108108,34,3,19,34.05205792387811,0.6375612745098038,43.779761904761905,1024.8809523809525,30.14355742296919,0
3191,4,0,0,37,0.0,0.0,1.0,37,1150,800,350,0.6956521739130435,15,8,7,380.91303073960654,0.3957394894894895,0.09492561027989388,0.22402397429794568,131485.18786344194,2616.88782436994,134102.07568781188,2452,1,616.8108108108108,33,4,19,33.83008224797863,0.641729797979798,43.59681372549019,1025.612745098039,31.079174093879974,0
3192,4,0,1,36,0.0,0.02702702702702703,0.972972972972973,37,800,600,200,0.75,10,6,4,377.0788301002888,0.39580205205205204,0.08820908820908824,0.2223171806760294,131579.47063629367,2523.16657054978,134102.63720684344,2453,2,617.8108108108108,33,4,17,33.83301481127569,0.6426767676767677,43.50490196078431,1025.9803921568623,31.090314913844313,0
3193,4,0,0,36,0.0,0.0,1.0,36,600,500,100,0.8333333333333334,7,5,2,369.4646304172131,0.39576719576719577,0.10323655619465,0.20163159426804875,128566.75347222238,2333.348952326048,130900.10242454843,2086,3,567.8333333333334,34,2,15,37.0908655162969,0.6099877450980391,46.45833333333334,1014.166666666668,29.82843137254906,8
3194,4,2,0,38,0.05263157894736842,0.0,1.0,38,1150,900,250,0.782608695652174,14,9,5,353.2651003190477,0.406235182550972,0.10206771082370203,0.19561784021348014,129144.15048494452,1524.4242553364334,130668.57474028095,2087,0,538.8947368421053,36,2,17,36.91280744515842,0.6116898148148149,45.88963963963965,1016.4414414414424,28.23448448448451,0
3195,4,0,0,38,0.0,0.0,1.0,38,1050,600,450,0.5714285714285714,15,6,9,355.75114216608426,0.406264817449028,0.10030198446936955,0.19728017883755591,129201.38888888895,1592.708333333338,130794.09722222229,2088,1,539.8947368421053,36,2,17,36.791325136612016,0.6122685185185186,45.833333333333336,1016.6666666666672,28.240740740740755,0
3196,4,1,2,37,0.02564102564102564,0.05128205128205128,0.9487179487179487,39,350,100,250,0.2857142857142857,6,1,5,348.13409237306274,0.40893499775078723,0.09516387983895269,0.19401418877655532,129396.54659366334,1209.4698609187342,130606.01645458207,2089,0,527.025641025641,37,2,18,36.78635898264899,0.612331081081081,45.64144736842105,1017.434210526315,27.498221906116623,0
3197,4,0,0,37,0.0,0.0,1.0,37,850,700,150,0.8235294117647058,10,7,3,366.5009406073637,0.40111986986986986,0.09769605671245052,0.20324143070044695,129201.38888888872,2070.486111111087,131271.8749999998,2090,3,555.5945945945946,35,2,20,36.51810109289617,0.6142857142857144,45.83333333333332,1016.6666666666653,29.04761904761901,0
3198,4,2,2,37,0.05128205128205128,0.05128205128205128,0.9487179487179487,39,850,700,150,0.8235294117647058,10,7,3,348.2896006995798,0.41081871345029236,0.08282324616986014,0.19520612683747707,129619.7643145004,1229.043191174185,130848.80750567459,2091,0,528.0512820512821,37,2,13,36.55546731990956,0.6145833333333335,45.42214912280701,1018.3114035087702,27.521929824561358,0
3199,4,1,0,38,0.02631578947368421,0.0,1.0,38,700,400,300,0.5714285714285714,10,4,6,359.8973378302276,0.40561284969179706,0.102763957987839,0.20206526509462477,129688.42734203777,1734.9039495576455,131423.33129159542,2092,0,542.921052631579,36,2,14,36.190114243596845,0.6171875000000002,45.35472972972972,1018.5810810810793,28.29391891891887,0
3200,4,2,3,37,0.05,0.075,0.925,40,1050,700,350,0.6666666666666666,14,7,7,350.56471674811263,0.4115117521367522,0.11953452459739733,0.1998880328326027,130291.32806793257,1137.644823877908,131428.97289181047,2093,0,516.725,36,4,16,35.81582285462167,0.6232638888888891,44.7635135135135,1020.945945945944,28.359609609609556,0
3201,4,3,3,37,0.075,0.075,0.925,40,1100,800,300,0.7272727272727273,14,8,6,346.3619848442447,0.4117521367521368,0.11263488218454132,0.19985130535930287,130751.61944038616,1057.4780861942859,131809.09752658044,2094,0,487.7,36,4,15,35.45703956544079,0.6278935185185186,44.313063063063055,1022.7477477477464,28.409659659659624,0
3202,4,0,0,37,0.0,0.0,1.0,37,650,500,150,0.7692307692307693,8,5,3,386.45754178384664,0.4019019019019019,0.1599003828339598,0.20853449216430034,128115.23604948999,2502.219837748639,130617.45588723863,2095,1,527.9459459459459,35,2,16,37.122846880835326,0.6032738095238095,46.90393518518519,1012.3842592592601,28.925264550264576,7
3203,4,3,1,39,0.075,0.025,0.975,40,1000,700,300,0.7,13,7,6,369.50948882767045,0.4155982905982906,0.1613162878787877,0.2032302188552189,128875.73964497054,1524.1617357002103,130399.90138067075,2096,0,489.275,38,2,14,36.773989898989896,0.6052631578947367,46.15384615384616,1015.3846153846164,26.720647773279378,0
3204,4,0,0,39,0.0,0.0,1.0,39,1250,1000,250,0.8,15,10,5,379.8238919533887,0.41079059829059833,0.1626424270623883,0.20856521896230554,128811.5153220221,1985.138215604793,130796.65353762689,2097,1,502.8205128205128,37,2,15,36.57782458414344,0.606418918918919,46.21710526315789,1015.1315789473679,27.435988620199133,0
3205,4,0,0,39,0.0,0.0,1.0,39,1150,900,250,0.782608695652174,14,9,5,379.7019895542146,0.41045321637426896,0.16129871711819477,0.2090844130351446,128922.84765504758,1990.452350723285,130913.30000577086,2098,2,503.8205128205128,37,2,15,36.467105736701924,0.607545045045045,46.10745614035087,1015.5701754385955,27.4478425794215,0
3206,4,2,2,39,0.04878048780487805,0.04878048780487805,0.9512195121951219,41,1450,900,550,0.6206896551724138,20,9,11,361.3372494447751,0.4166666666666667,0.14635145225210788,0.20132235683554617,129386.7852105037,1150.4530164930793,130537.23822699678,2099,0,480.1951219512195,39,2,16,36.460466366335616,0.6087072649572649,45.65104166666668,1017.3958333333352,26.087072649572697,0
3207,4,2,2,39,0.04878048780487805,0.04878048780487805,0.9512195121951219,41,1050,700,350,0.6666666666666666,14,7,7,362.3260214004197,0.41793699186991873,0.1476097860579384,0.2021452257601772,129439.78000217032,1179.8800998264078,130619.66010199672,2100,0,481.1463414634146,39,2,13,36.38134660661275,0.6092414529914529,45.59895833333334,1017.6041666666681,26.092414529914567,0
3208,4,2,2,39,0.04878048780487805,0.04878048780487805,0.9512195121951219,41,1200,1000,200,0.8333333333333334,14,10,4,360.45694701481216,0.41826727642276423,0.14376618904310545,0.20178156930829177,129572.31445312501,1141.0481770833333,130713.36263020834,2101,0,482.0975609756098,39,2,14,36.29399427051361,0.6105769230769231,45.46875,1018.1250000000001,26.105769230769234,0
3209,4,2,0,41,0.04878048780487805,0.0,1.0,41,1200,700,500,0.5833333333333334,17,7,10,359.9181767428647,0.416260162601626,0.16868249541623648,0.19714549265880774,128713.0691157132,1067.0683991822623,129780.13751489545,2102,0,483.0487804878049,38,3,16,37.183485997052,0.6036184210526316,46.314102564102555,1014.7435897435885,26.703778677462854,2
3210,4,3,2,42,0.06818181818181818,0.045454545454545456,0.9545454545454546,44,1050,800,250,0.7619047619047619,13,8,5,342.0458013464592,0.42532152924594785,0.17706574432158573,0.19092790717299005,129459.81744497322,57.16195623945407,129516.97940121267,2103,0,451.04545454545456,40,4,13,36.87691398708474,0.6078125,45.579268292682926,1017.6829268292681,25.442073170731703,0
3211,4,1,0,43,0.023255813953488372,0.0,1.0,43,650,400,250,0.6153846153846154,9,4,5,370.6812188365656,0.42271133259505356,0.22808812729498196,0.20331822049349677,128767.2812111911,951.2850796974212,129718.56629088853,2104,0,462.51162790697674,38,5,16,36.85504385964909,0.6041666666666669,46.26068376068374,1014.957264957262,26.709401709401632,2
3212,4,2,2,43,0.044444444444444446,0.044444444444444446,0.9555555555555556,45,1250,700,550,0.56,18,7,11,358.77452297769435,0.42763047138047133,0.226411657559199,0.198956780923994,129201.38888888879,272.29436043537606,129473.68324932417,2105,0,442.9111111111111,38,7,17,36.71448087431694,0.6085526315789473,45.83333333333333,1016.6666666666658,26.75438596491226,0
3213,4,1,2,42,0.022727272727272728,0.045454545454545456,0.9545454545454546,44,1150,800,350,0.6956521739130435,15,8,7,364.821284600914,0.42619142001409444,0.22820417287630446,0.20230998509687023,129201.38888888867,627.083333333309,129828.47222222199,2106,0,453.75,38,6,18,36.56079234972678,0.6085526315789475,45.83333333333332,1016.6666666666649,26.754385964912235,0
3214,4,2,1,43,0.045454545454545456,0.022727272727272728,0.9772727272727273,44,950,600,350,0.631578947368421,13,6,7,365.74334749620834,0.42594917195207893,0.23357219925332595,0.2035208890421621,129337.19735051837,660.8439029512442,129998.04125346961,2107,0,454.6136363636364,38,6,19,36.39892518292895,0.6099232456140353,45.69978632478631,1017.2008547008523,26.768443544759272,0
3215,4,1,1,43,0.022727272727272728,0.022727272727272728,0.9772727272727273,44,1150,800,350,0.6956521739130435,15,8,7,365.0085214959581,0.42502422480620156,0.2334867251696,0.20364181876036602,129439.78000216992,649.3245442708095,130089.10454644074,2108,0,455.59090909090907,39,5,14,36.313103524755185,0.6092414529914532,45.59895833333332,1017.6041666666649,26.092414529914485,0
3216,4,0,0,43,0.0,0.0,1.0,43,1350,900,450,0.6666666666666666,18,9,9,368.1190067833844,0.4235188261351052,0.22403800614230818,0.2055510937056574,129473.0771513622,932.3001132295763,130405.37726459178,2109,2,467.1860465116279,38,5,15,36.200048988732576,0.611293859649123,45.566239316239304,1017.7350427350411,26.782501124606345,0
3217,4,1,0,44,0.022727272727272728,0.0,1.0,44,950,600,350,0.631578947368421,13,6,7,361.0414247943131,0.42390107470049326,0.2253629114700475,0.20320524840839846,129784.51063368036,571.5169270833131,130356.02756076367,2110,0,457.54545454545456,39,5,16,36.06326245484904,0.6127136752136754,45.26041666666666,1018.9583333333318,26.127136752136714,0
3218,4,4,3,45,0.08333333333333333,0.0625,0.9375,48,1100,1000,100,0.9090909090909091,12,10,2,349.32793773387976,0.4303339243498818,0.24660184023421206,0.20029810530496572,130508.09500328742,-444.5946206237518,130063.50038266367,2111,0,420.3333333333333,38,10,14,35.62774466750316,0.6217105263157894,44.55128205128206,1021.7948717948726,26.889338731444017,1
3219,4,1,1,45,0.021739130434782608,0.021739130434782608,0.9782608695652174,46,850,600,250,0.7058823529411765,11,6,5,361.09054162176284,0.42900563607085346,0.2510609424525627,0.20604203529795645,130320.07250071033,211.46911269378913,130531.54161340412,2112,0,439.19565217391306,36,10,19,35.51799566192419,0.6235532407407407,44.73536036036037,1021.0585585585599,28.362737737737774,0
3220,4,3,3,45,0.0625,0.0625,0.9375,48,750,500,250,0.6666666666666666,10,5,5,347.768128892011,0.43263334810874704,0.2552616461249215,0.20081616803450641,130781.15297866917,-503.6966268536624,130277.4563518155,2113,0,421.8333333333333,38,10,16,35.391207088642844,0.6244517543859648,44.28418803418804,1022.8632478632492,26.917453891138138,0
3221,4,3,4,44,0.0625,0.08333333333333333,0.9166666666666666,48,1300,1000,300,0.7692307692307693,16,10,6,348.66459347865316,0.43321513002364065,0.24745283178933764,0.2018227638032301,130874.74093967032,-473.722330729146,130401.01860894117,2114,0,422.6041666666667,39,9,17,35.27361379754998,0.6236645299145298,44.19270833333334,1023.2291666666681,26.236645299145337,0
3222,4,1,1,44,0.022222222222222223,0.022222222222222223,0.9777777777777777,45,800,400,400,0.5,12,4,8,371.92636256605977,0.4251473063973064,0.26978248089359225,0.21301237128783426,130463.842220599,704.5884566999475,131168.43067729895,2115,0,451.6,36,9,19,35.09539425338037,0.625,44.5945945945946,1021.6216216216218,28.378378378378383,0
3223,4,0,0,44,0.0,0.0,1.0,44,1150,900,250,0.782608695652174,14,9,5,378.7715117437875,0.4221172480620155,0.2799822572399484,0.21645109262787712,130377.57087746533,1076.6619237480763,131454.2328012134,2116,3,462.8636363636364,36,8,20,35.00822398647407,0.6241319444444444,44.679054054054056,1021.2837837837841,28.368993993994003,0
3224,4,0,0,44,0.0,0.0,1.0,44,1200,900,300,0.75,15,9,6,375.16685519769794,0.4217318534178999,0.22707404911122908,0.2094121600013343,129459.11864144579,927.5643464410696,130386.68298788686,2117,4,463.8636363636364,36,8,16,36.03495813507432,0.6148726851851851,45.57995495495497,1017.6801801801826,28.26889389389396,6
3225,4,0,1,43,0.0,0.022727272727272728,0.9772727272727273,44,750,500,250,0.6666666666666666,10,5,5,378.6536676109607,0.4207408386187456,0.23192577249097512,0.2119757157195481,129573.74762854094,1012.7149531288325,130586.46258166977,2118,5,464.8636363636364,36,8,17,35.82936990745861,0.6160300925925926,45.467342342342356,1018.1306306306326,28.28140640640646,0
3226,4,0,0,43,0.0,0.0,1.0,43,1150,800,350,0.6956521739130435,15,8,7,373.2323772913074,0.42063492063492064,0.18406922520132252,0.19974322408607928,127783.97108966223,950.4201207868715,128734.3912104491,2119,6,462.7674418604651,37,6,17,37.79721559483787,0.5960022522522522,47.23135964912281,1011.0745614035089,27.326339497392134,6
3227,4,1,1,43,0.022727272727272728,0.022727272727272728,0.9772727272727273,44,1450,1100,350,0.7586206896551724,18,11,7,366.93495268377404,0.4227448907681466,0.19706895703105798,0.1982822871875161,128172.28768707666,606.6864323637908,128778.97411944045,2120,0,453.22727272727275,37,7,18,37.55854087709801,0.5999436936936937,46.84758771929824,1012.609649122806,27.367828354670433,0
3228,4,3,0,46,0.06521739130434782,0.0,1.0,46,800,500,300,0.625,11,5,6,351.8321613667767,0.4297906602254428,0.20656077810248274,0.19316081197291501,128804.55864800353,-136.48274739582803,128668.0759006077,2121,0,434.2391304347826,39,7,19,37.29530100906448,0.6028311965811965,46.223958333333336,1015.1041666666671,26.028311965811977,0
3229,4,1,1,46,0.02127659574468085,0.02127659574468085,0.9787234042553191,47,1500,1200,300,0.8,18,12,6,347.68879333512507,0.431718316373728,0.22148587373561246,0.19280923994038734,129201.3888888888,-414.4042968750089,128786.98459201379,2122,0,425.97872340425533,38,9,20,36.99624316939891,0.6085526315789473,45.83333333333333,1016.666666666666,26.754385964912263,0
3230,4,2,2,46,0.041666666666666664,0.041666666666666664,0.9583333333333334,48,1000,700,300,0.7,13,7,6,336.00773966800074,0.43578235815602834,0.21542606266214337,0.18854812804886356,129666.74619108996,-886.1939404455052,128780.55225064445,2123,0,414.875,40,8,14,36.82045333599413,0.6098958333333333,45.3760162601626,1018.4959349593496,25.46239837398374,0
3231,4,0,0,46,0.0,0.0,1.0,46,1000,800,200,0.8,12,8,4,348.9238624373757,0.4309581320450886,0.22527863832211636,0.1945370027561808,129413.28125000003,-168.92361111111074,129244.35763888892,2124,2,433.9130434782609,39,7,20,36.74924924924925,0.608974358974359,45.625,1017.5000000000002,26.089743589743595,0
3232,4,2,3,45,0.041666666666666664,0.0625,0.9375,48,1800,1500,300,0.8333333333333334,21,15,6,333.2942643963156,0.43383385047281325,0.21575078654600932,0.18830484635519168,129933.65698420575,-938.7714750251893,128994.88550918056,2125,0,416.7916666666667,41,7,15,36.61888602380722,0.6110264227642276,45.114087301587304,1019.543650793651,24.866918312040266,0
3233,4,0,0,45,0.0,0.0,1.0,45,1100,700,400,0.6363636363636364,15,7,8,350.3520140399197,0.4287878787878788,0.21334359763920974,0.19563032155593657,129473.07715136262,72.23066878517506,129545.3078201478,2126,4,445.46666666666664,38,7,15,36.652101266708655,0.6112938596491228,45.566239316239326,1017.7350427350444,26.782501124606434,0
3234,4,0,3,42,0.0,0.06666666666666667,0.9333333333333333,45,1100,600,500,0.5454545454545454,16,6,10,354.3158017592866,0.42889309764309763,0.21576308732657123,0.19839186784759139,129581.83235627158,182.57816494997763,129764.41052122157,2127,5,446.46666666666664,38,7,15,36.44062609303954,0.6123903508771928,45.45940170940172,1018.1623931623942,26.79374718848406,0
3235,4,1,1,42,0.023255813953488372,0.023255813953488372,0.9767441860465116,43,900,600,300,0.6666666666666666,12,6,6,365.7795073574608,0.42250369139904026,0.2264694756183232,0.20417229203146267,129459.11864144579,870.698527919845,130329.81716936563,2128,0,467.3953488372093,36,7,15,36.273791081110986,0.6148726851851851,45.57995495495497,1017.6801801801826,28.26889389389396,0
3236,4,3,2,43,0.06666666666666667,0.044444444444444446,0.9555555555555556,45,950,500,450,0.5263157894736842,14,5,9,358.9368657356554,0.4277356902356902,0.2312647692218146,0.2030854999079331,129990.07100819999,331.6457328877169,130321.7167410877,2129,0,447.55555555555554,38,7,16,35.907979745067216,0.6165021929824561,45.05876068376068,1019.764957264957,26.835919928025184,0
3237,4,0,0,43,0.0,0.0,1.0,43,950,500,450,0.5263157894736842,14,5,9,373.34201017141396,0.4224575489110373,0.23846592866434602,0.20976719403792649,129717.10519641287,1085.7689615291301,130802.874157942,2130,1,469.3720930232558,36,7,16,35.818547792762935,0.6174768518518517,45.32657657657659,1018.6936936936956,28.2970470470471,0
3238,4,0,1,42,0.0,0.023255813953488372,0.9767441860465116,43,1100,900,200,0.8181818181818182,13,9,4,371.7879062216012,0.4223191214470284,0.23421835125042723,0.20935337668943838,129803.1577819376,1051.8488505397622,130855.00663247737,2131,2,470.3720930232558,36,7,16,35.770527130069624,0.6183449074074073,45.24211711711713,1019.0315315315336,28.306431431431488,0
3239,4,2,1,43,0.045454545454545456,0.022727272727272728,0.9772727272727273,44,800,600,200,0.75,10,6,4,368.4908594525046,0.4272815362931642,0.24684011057171018,0.2095017977351538,130178.65022170317,793.9285405124989,130972.57876221566,2132,0,460.22727272727275,37,7,19,35.47274005229041,0.6202139639639639,44.873903508771946,1020.504385964915,27.581199620673377,0
3240,4,1,1,43,0.022727272727272728,0.022727272727272728,0.9772727272727273,44,1400,900,500,0.6428571428571429,19,9,10,369.54321652537055,0.42903232910500355,0.24403336230102401,0.2110480500236105,130353.7485827665,834.3498622613954,131188.0984450279,2133,0,460.72727272727275,34,10,19,35.26803062096838,0.6280637254901961,44.702380952380956,1021.1904761904766,30.035014005602253,0
3241,4,0,0,43,0.0,0.0,1.0,43,1050,600,450,0.5714285714285714,15,6,9,380.00832986255716,0.4262181616832779,0.25457997152349265,0.21651637399145715,130262.58680555565,1300.1736111111215,131562.76041666677,2134,2,472.4418604651163,37,6,19,35.093537414965986,0.6210585585585584,44.79166666666667,1020.8333333333342,27.59009009009011,0
3242,4,2,2,43,0.044444444444444446,0.044444444444444446,0.9555555555555556,45,1450,1000,450,0.6896551724137931,19,10,9,364.50834628056526,0.4285984848484849,0.24338049424636843,0.2100737925237308,130706.03358892746,528.6880304783892,131234.72161940584,2135,0,452.4,35,10,16,35.039261460101855,0.6294642857142857,44.357638888888886,1022.5694444444443,29.21626984126984,0
3243,4,0,0,43,0.0,0.0,1.0,43,1000,600,400,0.6,14,6,8,379.73328213610574,0.42573366555924697,0.25379170879676405,0.21834663722826098,130617.28395061739,1319.9459876543328,131937.22993827172,2136,4,474.4418604651163,35,8,17,34.74014945652173,0.6285714285714286,44.44444444444445,1022.2222222222231,29.20634920634923,0
3244,4,0,1,42,0.0,0.023255813953488372,0.9767441860465116,43,800,600,200,0.75,10,6,4,379.5008379417674,0.4253414544112219,0.2541570311639689,0.2188093402761391,130722.82745160705,1321.884511200392,132044.71196280746,2137,5,475.4418604651163,36,7,18,34.638943948904306,0.6276041666666666,44.34121621621622,1022.6351351351354,28.40653153153154,0
3245,4,0,1,41,0.0,0.023809523809523808,0.9761904761904762,42,650,400,250,0.6153846153846154,9,4,5,386.0715292345715,0.4224254742547426,0.2641043058228614,0.22216090017778314,130646.86381440758,1687.8069005058317,132334.6707149134,2138,6,486.92857142857144,35,7,18,34.54811974036757,0.6288690476190476,44.41550925925926,1022.337962962963,29.209656084656086,0
3246,4,2,1,42,0.046511627906976744,0.023255813953488372,0.9767441860465116,43,1050,800,250,0.7619047619047619,13,8,5,378.34683358324776,0.4233573274270949,0.252488039501624,0.21961511604544878,130982.06948502586,1311.3302491681168,132293.39973419398,2139,0,476.4186046511628,36,7,20,34.405482214888146,0.6302083333333333,44.08783783783785,1023.648648648651,28.43468468468475,0
3247,4,0,0,42,0.0,0.0,1.0,42,1050,700,350,0.6666666666666666,14,7,7,384.93304803824697,0.42174796747967475,0.2586084314961141,0.22286791602528766,130883.62328800155,1676.2864101080265,132559.90969810958,2140,1,488.76190476190476,35,7,20,34.336825585341025,0.6312499999999999,44.18402777777778,1023.2638888888889,29.23611111111111,0
3248,4,0,0,42,0.0,0.0,1.0,42,1350,1000,350,0.7407407407407407,17,10,7,383.64866189589236,0.42111885404568333,0.25801770653255796,0.22269261408899513,130982.0694850257,1650.2191380569916,132632.28862308268,2141,2,489.76190476190476,36,6,20,34.26980198019802,0.6302083333333333,44.087837837837846,1023.6486486486497,28.43468468468471,0
3249,4,0,0,42,0.0,0.0,1.0,42,1100,800,300,0.7272727272727273,14,8,6,393.27139071249354,0.4215543941153697,0.2669357540729569,0.22930747243082333,131155.0401753106,1915.9050097394854,133070.94518505008,2142,3,490.76190476190476,36,6,21,33.84798262972734,0.6319444444444444,43.918918918918926,1024.3243243243255,28.453453453453488,0
3250,4,0,0,42,0.0,0.0,1.0,42,1100,800,300,0.7272727272727273,14,8,6,395.26736730781926,0.42150600077429345,0.26596980255516844,0.23151374370886568,131328.12500000012,1982.1727132538076,133310.29771325394,2143,4,491.76190476190476,34,8,21,33.62127371273712,0.6378676470588235,43.75000000000001,1025.000000000001,30.147058823529438,0
3251,4,0,0,42,0.0,0.0,1.0,42,1450,1100,350,0.7586206896551724,18,11,7,396.56829482751453,0.42127613240418116,0.2680066118027711,0.23345803095498038,131522.32552800738,2031.51687327824,133553.84240128563,2144,5,492.76190476190476,32,10,22,33.39103274249138,0.64453125,43.56060606060606,1025.757575757576,32.05492424242425,0
3252,4,2,2,42,0.045454545454545456,0.045454545454545456,0.9545454545454546,44,1250,900,350,0.72,16,9,7,380.0474389565735,0.4257069238900634,0.24772217311484335,0.22440782215738628,131637.38031173058,1220.0378773968034,132857.41818912738,2145,0,471.3181818181818,37,7,14,33.69828952523418,0.6348536036036035,43.448464912280706,1026.2061403508776,27.73530109056426,2
3253,4,2,2,42,0.045454545454545456,0.045454545454545456,0.9545454545454546,44,950,600,350,0.631578947368421,13,6,7,383.4756361581913,0.42592714940098664,0.244335776343251,0.22743820979236617,131806.21831957914,1308.8946839412176,133115.11300352035,2146,0,472.27272727272725,37,7,14,33.43955775048941,0.6365427927927927,43.28399122807018,1026.8640350877197,27.75308202939783,0
3254,4,0,0,42,0.0,0.0,1.0,42,1150,900,250,0.782608695652174,14,9,5,398.3215277144236,0.42082849399922573,0.25408286058105567,0.23475545356786237,131565.50068587105,2081.074245541839,133646.5749314129,2147,8,495.76190476190476,35,7,14,33.30230896510229,0.638095238095238,43.51851851851852,1025.9259259259259,29.31216931216931,0
3255,4,0,0,42,0.0,0.0,1.0,42,850,700,150,0.8235294117647058,10,7,3,396.79478789147123,0.42011469221835074,0.2562282835768792,0.2344023573773268,131654.57182623885,2047.9695805469792,133702.54140678584,2148,9,496.76190476190476,35,7,15,33.251217059509045,0.6389880952380952,43.43171296296296,1026.273148148148,29.322089947089943,0
3256,4,0,0,42,0.0,0.0,1.0,42,1050,800,250,0.7619047619047619,13,8,5,359.4822500875283,0.4199090205187766,0.18684146042636596,0.20750312059507847,130766.7743921208,1001.6668590335661,131768.44125115438,2149,10,497.76190476190476,37,5,16,35.10622141223557,0.626126126126126,44.298245614035096,1022.8070175438609,27.643432906590835,7
3257,4,0,0,42,0.0,0.0,1.0,42,1400,1100,300,0.7857142857142857,17,11,6,360.53800898499543,0.42012679055361984,0.18930001243317207,0.20833744333321258,130808.47447083434,1032.2853888158465,131840.7598596502,2150,11,498.76190476190476,38,4,16,35.03698868581375,0.6247258771929824,44.25747863247864,1022.9700854700861,26.92026540710753,0
3258,4,0,0,42,0.0,0.0,1.0,42,1250,900,350,0.72,16,9,7,357.6453591509497,0.4197275454897406,0.18505702552476389,0.20710563784448596,130890.45606874143,962.4728340273325,131852.92890276876,2151,12,499.76190476190476,38,4,16,35.02797208881464,0.625548245614035,44.17735042735043,1023.2905982905992,26.92869995501577,0
3259,4,0,0,42,0.0,0.0,1.0,42,700,300,400,0.42857142857142855,11,3,8,357.3289344568632,0.4195218737901665,0.18837630031659858,0.2073633265312664,130972.46334876555,960.0501543210017,131932.51350308655,2152,13,500.76190476190476,38,4,16,34.95307553143375,0.6263706140350876,44.09722222222223,1023.6111111111121,26.937134502924003,0
3260,4,1,1,42,0.023255813953488372,0.023255813953488372,0.9767441860465116,43,900,400,500,0.4444444444444444,14,4,10,348.7453442412558,0.42144241417497236,0.18439477442021945,0.20357277448153469,131197.94894118933,550.9347734483702,131748.8837146377,2153,0,490.09302325581393,40,3,16,34.94486327414611,0.6252604166666667,43.877032520325216,1024.491869918701,25.612296747967527,0
3261,4,0,0,42,0.0,0.0,1.0,42,950,600,350,0.631578947368421,13,6,7,353.44147393682294,0.41964285714285715,0.19112754427510792,0.20601007784355596,131141.34250217053,870.1578776042062,132011.50037977475,2154,15,502.76190476190476,39,3,16,34.881796840570864,0.62633547008547,43.932291666666686,1024.2708333333364,26.26335470085478,0
3262,4,0,0,42,0.0,0.0,1.0,42,1250,900,350,0.72,16,9,7,352.85964811280365,0.4192920054200542,0.1927366189411317,0.20638723056681146,131274.74500868074,864.3120659722418,132139.05707465298,2155,16,503.76190476190476,39,3,17,34.76189266110999,0.6276709401709402,43.80208333333334,1024.7916666666683,26.276709401709443,0
3263,4,0,0,42,0.0,0.0,1.0,42,1100,600,500,0.5454545454545454,16,6,10,353.62548747438655,0.4186628919860627,0.19337979094076663,0.20712349980642678,131328.12500000026,888.1944444444746,132216.31944444473,2156,17,504.76190476190476,39,3,17,34.68834688346885,0.6282051282051281,43.750000000000014,1025.000000000002,26.282051282051334,0
3264,4,0,0,42,0.0,0.0,1.0,42,1100,600,500,0.5454545454545454,16,6,10,352.145516946396,0.4184088269454123,0.19045882755644206,0.20699600839978302,131465.0463533677,858.965341697722,132324.01169506542,2157,18,505.76190476190476,38,4,19,34.588021321665465,0.6313048245614035,43.616452991452995,1025.5341880341884,26.98774179037338,0
3265,4,2,0,44,0.045454545454545456,0.0,1.0,44,1000,900,100,0.9,11,9,2,340.59649296233823,0.42208421423537706,0.20430269463500617,0.20293288982570443,131979.9735297277,190.3832250975001,132170.3567548252,2158,0,483.72727272727275,40,4,17,34.36541885075661,0.6330729166666667,43.114837398373986,1027.5406504065043,25.688516260162608,0
3266,4,0,0,44,0.0,0.0,1.0,44,850,600,250,0.7058823529411765,11,6,5,337.65282001225495,0.4216107293868922,0.2077177468636544,0.20187328175200758,132110.5368828078,121.49906636260934,132232.03594917041,2159,1,484.72727272727275,40,4,18,34.30971563200211,0.6343750000000001,42.98780487804878,1028.0487804878044,25.70121951219511,0
3267,4,0,0,44,0.0,0.0,1.0,44,1100,900,200,0.8181818181818182,13,9,4,338.910734601974,0.42123634601832277,0.2033419554166449,0.20346704956353362,132267.29811124314,165.3614333399295,132432.65954458306,2160,2,485.72727272727275,40,4,18,34.1197803464401,0.6359375,42.83536585365853,1028.6585365853646,25.716463414634113,0
3268,4,0,0,44,0.0,0.0,1.0,44,750,500,250,0.6666666666666666,10,5,5,339.36478381988667,0.4208949964763918,0.2054973821989532,0.20388069475422615,132293.4340195154,179.14652736465422,132472.58054688005,2161,3,486.72727272727275,40,4,18,34.081835094998176,0.6361979166666667,42.80995934959349,1028.7601626016253,25.719004065040632,0
3269,4,0,0,44,0.0,0.0,1.0,44,750,500,250,0.6666666666666666,10,5,5,337.296192653559,0.42112623326286114,0.20041975308641957,0.20291883247874537,132345.71358194525,127.94106104170473,132473.65464298695,2162,4,487.72727272727275,40,4,18,34.08251028806585,0.63671875,42.75914634146341,1028.9634146341461,25.724085365853654,0
3270,4,0,1,43,0.0,0.022727272727272728,0.9772727272727273,44,1550,1200,350,0.7741935483870968,19,12,7,337.6880868932302,0.420630725863284,0.19845151735262778,0.20403135381755844,132507.9800044743,149.29390885381972,132657.2739133281,2163,5,488.72727272727275,38,6,20,33.909454878765885,0.6417214912280702,42.60149572649572,1029.5940170940162,27.094579397210953,0
3271,4,0,0,43,0.0,0.0,1.0,43,1350,1000,350,0.7407407407407407,17,10,7,344.5531970590022,0.4188353636028055,0.2056793614866288,0.20835151793825424,132539.10007165666,533.3541330024627,133072.45420465912,2164,6,499.69767441860466,37,6,20,33.70148280268343,0.6438626126126126,42.57127192982456,1029.7149122807016,27.830132764343286,0
3272,4,0,0,43,0.0,0.0,1.0,43,700,400,300,0.5714285714285714,10,4,6,342.3287043122124,0.41865079365079366,0.2049917624100559,0.20744129718881452,132618.00219382346,479.789771897143,133097.7919657206,2165,7,500.69767441860466,38,5,20,33.67951111572106,0.6428179824561404,42.49465811965812,1030.0213675213672,27.10582546108861,0
3273,4,0,0,43,0.0,0.0,1.0,43,950,500,450,0.5263157894736842,14,5,9,342.12189681853516,0.4182124400147656,0.19939823230740306,0.20807741593389595,132755.5941358024,483.7191358024604,133239.3132716049,2166,8,501.69767441860466,38,5,14,33.546720575022455,0.6441885964912281,42.36111111111111,1030.555555555555,27.119883040935658,0
3274,4,0,0,43,0.0,0.0,1.0,43,650,300,350,0.46153846153846156,10,3,7,344.0055223208018,0.41782022886674053,0.19990883758522937,0.2099239617713502,132880.86480034742,542.3502604166866,133423.2150607641,2167,9,502.69767441860466,39,4,14,33.37248265642891,0.6436965811965811,42.23958333333334,1031.0416666666683,26.436965811965855,0
3275,4,0,0,43,0.0,0.0,1.0,43,1200,900,300,0.75,15,9,6,343.2995849904864,0.4174049464747139,0.20321649445792378,0.20994497782525084,132961.427137587,529.1205512152985,133490.5476888023,2168,10,503.69767441860466,39,4,14,33.30987189846144,0.6444978632478633,42.16145833333334,1031.3541666666683,26.444978632478676,0
3276,4,1,0,44,0.022727272727272728,0.0,1.0,44,1050,800,250,0.7619047619047619,13,8,5,337.4276645757268,0.41799903100775193,0.20924255844539275,0.20817258650600848,133288.5117675491,195.04624809967615,133483.55801564877,2169,0,493.22727272727275,40,4,16,33.13363186038119,0.64609375,41.84451219512195,1032.6219512195123,25.81554878048781,0
3277,4,0,1,43,0.0,0.022727272727272728,0.9772727272727273,44,1100,900,200,0.8181818181818182,13,9,4,336.90990058668143,0.4178779069767442,0.21187221556243374,0.20799990338771926,133314.74837233144,183.01172417213715,133497.76009650357,2170,1,494.22727272727275,40,4,16,33.12073574755626,0.6463541666666666,41.81910569105692,1032.7235772357735,25.81808943089434,0
3278,4,0,0,43,0.0,0.0,1.0,43,850,600,250,0.7058823529411765,11,6,5,343.45010722562256,0.4149593946105574,0.21873276814814613,0.21155587400330317,133230.14458550356,551.5814887152884,133781.72607421884,2171,2,506.4418604651163,39,4,17,33.03663017522618,0.6471688034188035,41.90104166666667,1032.3958333333342,26.471688034188055,0
3279,4,1,0,44,0.022727272727272728,0.0,1.0,44,1300,900,400,0.6923076923076923,17,9,8,339.53137193941956,0.4161601479915433,0.2233455461415157,0.21127579100305588,133606.80474175356,272.9600694444491,133879.764811198,2172,0,495.90909090909093,39,5,19,32.760810243492855,0.6509081196581197,41.536458333333336,1033.8541666666672,26.50908119658121,0
3280,4,0,0,44,0.0,0.0,1.0,44,1300,700,600,0.5384615384615384,19,7,12,339.780829709606,0.4153563248766737,0.22531316387077838,0.21189347219578955,133687.58680555562,284.89583333333866,133972.48263888896,2173,1,496.90909090909093,39,5,20,32.67358313188288,0.6517094017094017,41.458333333333336,1034.1666666666672,26.51709401709403,0
3281,4,0,0,44,0.0,0.0,1.0,44,800,600,200,0.75,10,6,4,343.0566594228244,0.41526823467230445,0.22212231038869512,0.21471844978241428,133822.27783203125,381.72471788194525,134204.0025499132,2174,2,497.90909090909093,39,5,13,32.454214067586165,0.6530448717948718,41.328125,1034.6875,26.53044871794872,0
3282,4,0,0,44,0.0,0.0,1.0,44,1000,600,400,0.6,14,6,8,343.6433672217487,0.414893851303735,0.2249878781779755,0.21571599116124568,133930.0794813369,404.83669704861643,134334.91617838552,2175,3,498.90909090909093,39,5,14,32.33129130186841,0.6541132478632479,41.223958333333336,1035.1041666666674,26.5411324786325,0
3283,4,0,0,44,0.0,0.0,1.0,44,1350,1000,350,0.7407407407407407,17,10,7,343.59071936650037,0.4144644115574348,0.22951344430217602,0.21615770572803913,134010.95920138908,408.98437500001927,134419.9435763891,2176,4,499.90909090909093,39,5,14,32.25184439973172,0.6549145299145298,41.14583333333334,1035.4166666666683,26.54914529914534,0
3284,4,0,0,44,0.0,0.0,1.0,44,1150,600,550,0.5217391304347826,17,6,11,339.50341529480454,0.41381474630021137,0.22591457703321094,0.21396903557633623,134076.7330643964,303.9017573864977,134380.63482178288,2177,5,500.90909090909093,40,4,14,32.291973309783145,0.6539062499999999,41.08231707317074,1035.6707317073187,25.89176829268297,0
3285,4,0,0,44,0.0,0.0,1.0,44,1200,900,300,0.75,15,9,6,338.3033750970633,0.4133632840028189,0.2278635962291411,0.21351865649314977,134129.36377363023,275.2832928481863,134404.6470664784,2178,6,501.90909090909093,40,4,14,32.27051244317997,0.6544270833333332,41.03150406504066,1035.8739837398384,25.89684959349596,0
3286,4,0,0,44,0.0,0.0,1.0,44,1100,800,300,0.7272727272727273,14,8,6,338.8835553010577,0.4130439570119803,0.2305398562998091,0.21465431658137812,134260.98573104638,299.76803655232135,134560.7537675987,2179,7,502.90909090909093,40,4,14,32.12415016016213,0.6557291666666667,40.90447154471545,1036.3821138211385,25.909552845528463,0
3287,4,0,0,44,0.0,0.0,1.0,44,1400,900,500,0.6428571428571429,19,9,10,341.6110265903748,0.4123942917547569,0.22669602857219195,0.21779036529718646,134498.06791798855,389.20461117720095,134887.27252916576,2180,8,503.90909090909093,40,4,17,31.817012834329372,0.6580729166666668,40.67581300813008,1037.2967479674792,25.93241869918698,0
3288,4,0,0,44,0.0,0.0,1.0,44,1350,900,450,0.6666666666666666,18,9,9,342.0624705576326,0.41217406624383374,0.22215988907740947,0.21936902069352404,134712.93945312494,416.0585049305143,135128.99795805546,2181,9,504.90909090909093,39,5,20,31.59115994380896,0.6618589743589745,40.46875,1038.1249999999995,26.61858974358973,0
3289,4,0,0,44,0.0,0.0,1.0,44,950,500,450,0.5263157894736842,14,5,9,344.775550321979,0.4120859760394644,0.22592778335004993,0.22176853140065356,134821.09917534716,496.60373263887874,135317.70290798604,2182,10,505.90909090909093,39,5,13,31.4129889669007,0.6629273504273505,40.36458333333333,1038.541666666666,26.62927350427349,0
3290,4,0,0,44,0.0,0.0,1.0,44,1050,600,450,0.5714285714285714,15,6,9,343.61475766261367,0.41161249119097953,0.22468027961082182,0.22146469437750532,134893.66964934883,470.2911213563257,135363.96077070516,2183,11,506.90909090909093,40,4,14,31.370858605621844,0.6619791666666668,40.294715447154466,1038.8211382113814,25.970528455284533,0
3291,4,0,0,44,0.0,0.0,1.0,44,1000,600,400,0.6,14,6,8,342.5650024735442,0.41188777307963353,0.22516538625693538,0.2211101379601965,134946.460440214,445.5869108995797,135392.04735111358,2184,12,507.90909090909093,40,4,14,31.345567618675,0.6625000000000001,40.24390243902438,1039.0243902439013,25.975609756097533,0
3292,4,0,0,44,0.0,0.0,1.0,44,1100,700,400,0.6363636363636364,15,7,8,346.71187686427015,0.4116675475687104,0.22838142891422764,0.22460517976216698,135078.4826017085,566.6628453631944,135645.1454470717,2185,13,508.90909090909093,40,4,15,31.106413139114267,0.6638020833333333,40.11686991869918,1039.5325203252023,25.988313008130056,0
3293,4,0,0,44,0.0,0.0,1.0,44,1200,800,400,0.6666666666666666,16,8,8,350.97098044511614,0.4118217054263566,0.2250386412493115,0.22819803137708491,135210.5693122479,690.9972156123903,135901.5665278603,2186,14,509.90909090909093,40,4,17,30.86423522897531,0.6651041666666667,39.98983739837398,1040.0406504065033,26.001016260162583,0
3294,4,0,1,43,0.0,0.022727272727272728,0.9772727272727273,44,700,500,200,0.7142857142857143,9,5,4,349.08649043953864,0.41172260394644117,0.2180583679704431,0.22730593614116523,135263.42207019628,643.7266590653687,135907.14872926165,2187,15,510.90909090909093,40,4,17,30.86064706265468,0.6656250000000001,39.9390243902439,1040.2439024390242,26.006097560975604,0
3295,4,0,1,42,0.0,0.023255813953488372,0.9767441860465116,43,1000,800,200,0.8,12,8,4,356.4259180504683,0.4105989294942783,0.22632428617020994,0.23150292387103613,135172.91802300344,1035.8262803819403,136208.74430338538,2188,16,522.6744186046511,39,4,17,30.7598959898494,0.6663995726495726,40.026041666666664,1039.8958333333333,26.663995726495724,0
3296,4,0,0,42,0.0,0.0,1.0,42,1000,600,400,0.6,14,6,8,363.7230144730743,0.4098795005807201,0.22887525502341077,0.23616518344672674,135161.11390760835,1432.241558002782,136593.35546561112,2189,17,533.8809523809524,38,4,18,30.581954861467853,0.6680372807017543,40.037393162393165,1039.850427350428,27.36448493027442,0
3297,4,0,0,42,0.0,0.0,1.0,42,950,600,350,0.631578947368421,13,6,7,365.00826201735833,0.409141502129307,0.22706465763875672,0.23773146804434905,135272.23186728396,1475.0964506172877,136747.32831790124,2190,18,534.8809523809524,38,4,18,30.437805963506896,0.6691337719298245,39.93055555555556,1040.2777777777778,27.375730994152047,0
3298,4,0,0,42,0.0,0.0,1.0,42,500,300,200,0.6,7,3,4,367.3634188282969,0.4088632404181185,0.22739941032373512,0.23963511962282555,135327.80796853322,1542.897239571928,136870.70520810515,2191,19,535.8809523809524,38,4,18,30.32117431632269,0.6696820175438596,39.87713675213676,1040.4914529914538,27.38135402609089,0
3299,4,0,0,42,0.0,0.0,1.0,42,1500,1200,300,0.8,18,12,6,367.72596755899775,0.4086212737127371,0.2295687885010267,0.24005703244132992,135355.60029951073,1554.7538169333236,136910.35411644404,2192,20,536.8809523809524,38,4,18,30.284052019164964,0.6699561403508771,39.85042735042736,1040.598290598292,27.384165542060313,0
3300,4,0,0,42,0.0,0.0,1.0,42,1050,800,250,0.7619047619047619,13,8,5,367.49325961396323,0.4076776035617499,0.22980931415992467,0.24067677828191017,135470.96896701393,1556.9335937500045,137027.90256076393,2193,21,537.8809523809524,39,3,19,30.17518844640118,0.6693376068376069,39.739583333333336,1041.041666666667,26.693376068376075,0
3301,4,0,0,42,0.0,0.0,1.0,42,1050,800,250,0.7619047619047619,13,8,5,370.1851777900079,0.40715737514518,0.22480791856604632,0.24299023127818198,135552.31255425353,1635.8913845486163,137188.20393880215,2194,22,538.8809523809524,39,3,19,30.024111400086703,0.670138888888889,39.661458333333336,1041.354166666667,26.701388888888896,0
3302,4,1,1,42,0.023255813953488372,0.023255813953488372,0.9767441860465116,43,1050,700,350,0.6666666666666666,14,7,7,365.58517737154244,0.4069767441860465,0.21654561905460645,0.24244874733635735,135919.3754328253,1338.095037355226,137257.47047018053,2195,0,527.3255813953489,37,6,16,29.778741675429387,0.6773648648648649,39.30921052631578,1042.7631578947353,28.182788051209062,0
3303,4,0,0,42,0.0,0.0,1.0,42,1150,800,350,0.6956521739130435,15,8,7,373.13276809145697,0.4047498064266357,0.2323344546286863,0.2471003695987634,135868.3916179694,1739.3898121094157,137607.78143007882,2196,24,540.8809523809524,36,6,17,29.632705047886507,0.6788194444444444,39.35810810810811,1042.5675675675684,28.960210210210235,0
3304,4,0,0,42,0.0,0.0,1.0,42,1000,800,200,0.8,12,8,4,371.6173045177052,0.4045078397212543,0.22999758278946136,0.2462995434881483,135897.74476757165,1700.3907201120087,137598.13548768367,2197,25,541.8809523809524,36,6,17,29.643005004140115,0.6791087962962963,39.32995495495496,1042.6801801801803,28.963338338338342,0
3305,4,0,0,42,0.0,0.0,1.0,42,1200,900,300,0.75,15,9,6,373.0310946440029,0.4042900696864111,0.23635985006247395,0.24764451379914768,135956.46057797657,1743.1974626653625,137699.65804064192,2198,26,542.8809523809524,36,6,17,29.5477450239355,0.6796875,39.273648648648646,1042.905405405405,28.969594594594582,0
3306,4,0,0,42,0.0,0.0,1.0,42,1500,1100,400,0.7333333333333333,19,11,8,328.9200444720824,0.4052942315137437,0.11133786848072558,0.21236099958634444,134956.35986328128,490.5536957195796,135446.91355900085,2199,27,543.8809523809524,39,3,15,31.690162907268167,0.6642628205128205,40.234375,1039.0625000000002,26.64262820512821,7
3307,4,0,0,42,0.0,0.0,1.0,42,900,400,500,0.4444444444444444,14,4,10,328.9200444720824,0.4052942315137437,0.11133786848072558,0.21236099958634444,134956.35986328128,477.9703776041668,135434.33024088544,2200,28,544.8809523809524,39,3,15,31.690162907268167,0.6642628205128205,40.234375,1039.0625000000002,26.64262820512821,0
3308,4,0,0,42,0.0,0.0,1.0,42,1300,1000,300,0.7692307692307693,16,10,6,327.16454830723217,0.4047619047619047,0.11288706283194694,0.21186080646060165,135064.61724175356,437.670898437505,135502.28814019106,2201,29,545.8809523809524,39,3,15,31.62819003240139,0.6653311965811965,40.130208333333336,1039.4791666666672,26.65331196581198,0
3309,4,0,0,42,0.0,0.0,1.0,42,1250,800,450,0.64,17,8,9,325.6012031030733,0.40420538133952766,0.10699379421206512,0.2114819004930373,135172.91802300356,402.4929470486204,135575.41097005218,2202,30,546.8809523809524,39,3,15,31.561258305786488,0.6663995726495726,40.02604166666667,1039.8958333333342,26.66399572649575,0
3310,4,0,0,42,0.0,0.0,1.0,42,850,600,250,0.7058823529411765,11,6,5,325.6012031030733,0.40414488966318235,0.10699379421206512,0.2114819004930373,135172.91802300356,402.4929470486204,135575.41097005218,2203,31,547.8809523809524,39,3,15,31.561258305786488,0.6663995726495726,40.02604166666667,1039.8958333333342,26.66399572649575,0
3311,4,0,1,41,0.0,0.023809523809523808,0.9761904761904762,42,1300,1000,300,0.7692307692307693,16,10,6,331.9335351367382,0.40418118466898956,0.09621526288192928,0.2167330729422232,135362.54882812503,586.2738715277784,135948.8226996528,2204,32,548.8809523809524,39,3,17,31.208291624958285,0.6682692307692308,39.84375,1040.6250000000002,26.682692307692314,0
3312,4,0,1,40,0.0,0.024390243902439025,0.975609756097561,41,500,200,300,0.4,8,2,6,338.1212537426987,0.40421747967479676,0.1015884465683845,0.2203898774395178,135300.01849112406,949.5623767258229,136249.5808678499,2205,33,555.9512195121952,38,3,17,31.109442390634644,0.6694078947368423,39.903846153846146,1040.3846153846139,27.378542510121417,0
3313,4,1,1,40,0.024390243902439025,0.024390243902439025,0.975609756097561,41,900,700,200,0.7777777777777778,11,7,4,339.78121717350643,0.40233739837398375,0.10320586828416811,0.22164295204640153,135327.80796853296,996.3694617941214,136324.17743032708,2206,0,554.9024390243902,38,3,17,31.038650443235102,0.6696820175438598,39.87713675213674,1040.4914529914515,27.38135402609083,0
3314,4,0,0,40,0.0,0.0,1.0,40,1150,700,450,0.6086956521739131,16,7,9,346.25210050300586,0.4012686965811966,0.12497888067581875,0.22245640378313844,134778.39936326537,1340.5946977894512,136118.99406105484,2207,35,569.775,37,3,18,31.417194649771194,0.6661036036036037,40.40570175438595,1038.3771929824543,28.06424845898525,2
3315,4,0,0,40,0.0,0.0,1.0,40,1100,800,300,0.7272727272727273,14,8,6,346.9544210914712,0.4005608974358974,0.13063060686015837,0.22378442068357304,134920.7583703639,1362.2707227223736,136283.02909308628,2208,36,570.775,37,3,16,31.25714599824099,0.6675112612612613,40.26864035087719,1038.925438596491,28.07906590801327,0
3316,4,0,0,40,0.0,0.0,1.0,40,650,400,250,0.6153846153846154,9,4,5,349.930169734284,0.3999465811965812,0.13081812427471262,0.22641556852636702,135034.69967922816,1450.5430757540694,136485.24275498223,2209,37,571.775,37,3,16,31.066370397721265,0.6686373873873874,40.15899122807017,1039.3640350877188,28.09091986723564,0
3317,4,0,0,40,0.0,0.0,1.0,40,1000,500,500,0.5,15,5,10,352.34579215149097,0.39929220085470085,0.1317796610169495,0.22913068046725185,135216.6671803088,1528.604741946071,136745.27192225488,2210,38,572.775,38,2,17,30.8224191063174,0.6685855263157896,39.98397435897435,1040.0641025641012,27.37010796221319,0
3318,4,0,0,40,0.0,0.0,1.0,40,800,600,200,0.75,10,6,4,349.9904522519589,0.39890491452991456,0.1334257547751081,0.2281263068292888,135300.01849112424,1470.7429322813925,136770.76142340564,2211,39,573.775,38,2,17,30.8007291024851,0.6694078947368421,39.90384615384615,1040.3846153846152,27.378542510121452,0
3319,4,0,0,40,0.0,0.0,1.0,40,600,300,300,0.5,9,3,6,346.8103617292425,0.39890491452991456,0.0998298267326736,0.21892404084158418,134135.4372123602,1303.9119000657386,135439.34911242596,2212,40,574.775,38,2,17,32.04414191419143,0.6578947368421053,41.02564102564102,1035.8974358974351,27.260458839406187,4
3320,4,0,0,40,0.0,0.0,1.0,40,900,500,400,0.5555555555555556,13,5,8,346.89952630816686,0.3988915598290598,0.09944570485717286,0.21914558349252714,134163.10683988954,1308.2236421579246,135471.33048204746,2213,41,575.775,38,2,18,32.0141968306349,0.6581688596491229,40.99893162393162,1036.0042735042725,27.263270355375592,0
3321,4,0,0,40,0.0,0.0,1.0,40,750,500,250,0.6666666666666666,10,5,5,344.20597300457007,0.3982638888888889,0.102314432989691,0.21793720222874213,134246.13284388918,1241.664155526325,135487.7969994155,2214,42,576.775,38,2,18,32.0010738831615,0.6589912280701755,40.918803418803414,1036.3247863247857,27.271704903283833,0
3322,4,0,2,38,0.0,0.05,0.95,40,800,600,200,0.75,10,6,4,344.7002417476514,0.39775641025641023,0.10178276999175595,0.21891172420937222,134356.87413251505,1262.5693987873337,135619.4435313024,2215,43,577.775,38,2,19,31.877748007694404,0.6600877192982457,40.811965811965806,1036.752136752136,27.282950967161476,0
3323,4,0,1,37,0.0,0.02631578947368421,0.9736842105263158,38,1000,700,300,0.7,13,7,6,360.3211098992351,0.3937292555713608,0.114185703336803,0.22803816047405528,134229.6751988476,2073.157109812527,136302.83230866012,2216,47,605.578947368421,36,2,19,31.60001448960373,0.6626157407407407,40.93468468468469,1036.261261261262,28.785035035035055,0
3324,4,0,0,37,0.0,0.0,1.0,37,1400,1200,200,0.8571428571428571,16,12,4,370.9502551020406,0.39207957957957956,0.10909749034749017,0.23605925324675325,134430.72702331975,2573.422496570658,137004.1495198904,2217,48,587.7567567567568,35,2,19,31.123511904761912,0.6666666666666665,40.74074074074075,1037.037037037038,29.629629629629658,0
3325,4,0,0,37,0.0,0.0,1.0,37,800,500,300,0.625,11,5,6,372.18465268889776,0.39176676676676675,0.10979692033028354,0.23723462712645108,134490.74743870032,2611.078425068594,137101.8258637689,2218,49,588.7567567567568,35,2,19,31.03148478762181,0.6672619047619047,40.682870370370374,1037.268518518519,29.636243386243397,0
3326,4,0,0,37,0.0,0.0,1.0,37,900,500,400,0.5555555555555556,13,5,8,375.1844340796413,0.3917042042042042,0.10750522996786649,0.2399360653322443,134610.82845721886,2700.7774991426686,137311.6059563615,2219,50,589.7567567567568,35,2,19,30.833612164473198,0.6684523809523808,40.56712962962963,1037.731481481482,29.649470899470913,0
3327,4,0,0,37,0.0,0.0,1.0,37,900,600,300,0.6666666666666666,12,6,6,378.99799778525954,0.3907344844844845,0.10608334086594917,0.24317682690513442,134730.96305941365,2812.5530478395144,137543.51610725318,2220,51,590.7567567567568,35,2,19,30.614548494983275,0.6696428571428571,40.45138888888889,1038.194444444445,29.66269841269843,0
3328,4,0,0,37,0.0,0.0,1.0,37,1100,600,500,0.5454545454545454,16,6,10,372.99869311904445,0.38942067067067065,0.10441097218417039,0.2407195735535346,134941.32754897565,2666.5877647033813,137607.91531367903,2221,52,591.7567567567568,35,2,16,30.560158367680362,0.6717261904761904,40.2488425925926,1039.004629629631,29.6858465608466,0
3329,4,0,0,37,0.0,0.0,1.0,37,1050,1000,50,0.9523809523809523,11,10,1,374.7940030668363,0.3884196696696696,0.10884239099359916,0.2426838458214317,135061.60950628007,2724.056257501721,137785.66576378178,2222,53,592.7567567567568,35,2,16,30.39344634970122,0.6729166666666666,40.133101851851855,1039.467592592593,29.699074074074087,0
3330,4,0,0,37,0.0,0.0,1.0,37,850,600,250,0.7058823529411765,11,6,5,375.06175370159343,0.3875437937937938,0.11578371159942469,0.2438715570739885,135212.0373049555,2742.5727666323833,137954.6100715879,2223,54,593.7567567567568,35,2,16,30.236386230432537,0.6744047619047618,39.98842592592593,1040.046296296297,29.715608465608486,0
3331,4,0,0,37,0.0,0.0,1.0,37,1050,700,350,0.6666666666666666,14,7,7,376.33108665550986,0.38654279279279274,0.11985820507346823,0.2453111049997375,135302.3341719179,2783.694889188964,138086.02906110688,2224,55,594.7567567567568,35,2,16,30.113309786034776,0.675297619047619,39.901620370370374,1040.393518518519,29.725529100529112,0
3332,4,0,0,37,0.0,0.0,1.0,37,1200,900,300,0.75,15,9,6,377.804531298526,0.3861986986986987,0.11804106665063308,0.24647770220419074,135332.4398255315,2825.8417995541795,138158.28162508568,2225,56,595.7567567567568,35,2,16,30.044957360029663,0.6755952380952381,39.87268518518518,1040.509259259259,29.728835978835967,0
3333,4,0,0,37,0.0,0.0,1.0,37,900,500,400,0.5555555555555556,13,5,8,380.72197033978796,0.38676176176176175,0.11375877657016464,0.2487973806173964,135392.66117969822,2909.3921467764094,138302.05332647462,2226,57,596.7567567567568,35,2,16,29.908993179122188,0.6761904761904761,39.81481481481482,1040.7407407407409,29.735449735449738,0
3334,4,0,0,37,0.0,0.0,1.0,37,650,300,350,0.46153846153846156,10,3,7,381.4145741187347,0.3862925425425425,0.11736566166945916,0.24949857810187304,135428.4748219504,2930.878809552807,138359.3536315032,2227,58,597.7567567567568,36,1,16,29.855250820440695,0.6744791666666665,39.78040540540541,1040.878378378379,28.913288288288307,0
3335,4,0,0,37,0.0,0.0,1.0,37,750,600,150,0.8,9,6,3,362.0747549333807,0.38588588588588585,0.06691337824547317,0.22015588587344626,132745.92318247302,2212.7895209398625,134958.7127034129,2228,59,598.7567567567568,36,1,15,33.04238152478782,0.6478587962962963,42.3704954954955,1030.5180180180182,28.625500500500507,6
3336,4,0,0,37,0.0,0.0,1.0,37,500,200,300,0.4,8,2,6,359.9317567818313,0.3855730730730731,0.06297152609836987,0.21919197404019305,132803.9541864499,2160.072107580547,134964.02629403045,2229,60,599.7567567567568,36,1,15,33.039258530900625,0.6484375,42.314189189189186,1030.7432432432427,28.63175675675674,0
3337,4,0,0,37,0.0,0.0,1.0,37,550,400,150,0.7272727272727273,7,4,3,382.18351408783394,0.3855730730730731,0.12614660580107318,0.21416882528310585,129613.56122470845,2537.0635552813806,132150.62477998983,2230,61,600.7567567567568,35,2,17,35.698927786618185,0.618452380952381,45.42824074074074,1018.2870370370366,29.09391534391533,7
3338,4,0,0,37,0.0,0.0,1.0,37,1050,1000,50,0.9523809523809523,11,10,1,382.54132231404935,0.38513513513513514,0.12818181818181773,0.2146915584415584,129672.4965706448,2521.017661179704,132193.5142318245,2231,62,601.7567567567568,35,2,18,35.62973484848483,0.619047619047619,45.370370370370374,1018.5185185185192,29.10052910052912,0
3339,4,0,0,37,0.0,0.0,1.0,37,850,500,350,0.5882352941176471,12,5,7,378.12517997581114,0.38560435435435436,0.11942974323710343,0.21285256294802066,129790.4074502744,2415.404235253778,132205.81168552817,2232,63,602.7567567567568,35,2,18,35.622065727699535,0.6202380952380953,45.25462962962963,1018.9814814814819,29.113756613756625,0
3340,4,0,0,37,0.0,0.0,1.0,37,1150,900,250,0.782608695652174,14,9,5,376.07197475781425,0.38501001001001,0.12067368162714365,0.21265687404469472,129967.37423911183,2375.417416838135,132342.79165594996,2233,64,603.7567567567568,35,2,18,35.49423004161937,0.6220238095238095,45.08101851851852,1019.6759259259262,29.13359788359789,0
3341,4,0,0,37,0.0,0.0,1.0,37,1000,800,200,0.8,12,8,4,377.20403139448564,0.38522897897897895,0.1213823901068567,0.21361966096710838,130026.38996056236,2409.295696159115,132435.68565672147,2234,65,604.7567567567568,35,2,18,35.40531850506884,0.6226190476190476,45.023148148148145,1019.9074074074069,29.14021164021163,0
3342,4,0,0,37,0.0,0.0,1.0,37,1000,900,100,0.9,11,9,2,374.68173688492493,0.3851038538538538,0.12346102908716383,0.21283467734391068,130144.46159122068,2352.550582990377,132497.01217421106,2235,66,605.7567567567568,35,2,18,35.3495538415003,0.6238095238095238,44.9074074074074,1020.370370370369,29.153439153439113,0
3343,4,0,0,37,0.0,0.0,1.0,37,1100,800,300,0.7272727272727273,14,8,6,373.67763431903415,0.3849161661661662,0.11891891891891926,0.21290934978642617,130262.58680555534,2335.296639231803,132597.88344478715,2236,67,606.7567567567568,34,3,18,35.25510204081633,0.6271446078431373,44.79166666666666,1020.8333333333317,30.024509803921518,0
3344,4,1,1,37,0.02631578947368421,0.02631578947368421,0.9736842105263158,38,1100,800,300,0.7272727272727273,14,8,6,363.81316017611437,0.38849869606448556,0.11235081363546984,0.2093525500870107,130646.86381440735,1906.209678283578,132553.07349269092,2237,0,591.7631578947369,35,3,16,35.117009132420094,0.6288690476190478,44.415509259259245,1022.3379629629611,29.209656084656032,0
3345,4,0,0,37,0.0,0.0,1.0,37,800,600,200,0.75,10,6,4,373.8138808922621,0.3854792292292292,0.09876802161668663,0.20394503265118266,128555.01570001683,2212.901475694409,130767.91717571123,2238,69,608.7567567567568,35,2,16,36.99260062390627,0.6077380952380954,46.46990740740739,1014.1203703703678,28.974867724867654,3
3346,4,2,0,39,0.05128205128205128,0.0,1.0,39,900,600,300,0.6666666666666666,12,6,6,361.57552286281964,0.3951866846603689,0.11143292640757352,0.2000861803830131,129117.79495854468,1537.166844606002,130654.96180315068,2239,0,578.4871794871794,37,2,18,36.72849911892688,0.6095157657657658,45.91557017543858,1016.3377192982434,27.468587008060634,0
3347,4,0,0,39,0.0,0.0,1.0,39,1000,700,300,0.7,13,7,6,360.4512276468012,0.39468061178587494,0.107542997612742,0.20061342817828437,129344.54038075234,1524.5067255234794,130869.04710627582,2240,1,579.4871794871794,36,3,21,36.52602494556994,0.6137152777777779,45.692567567567565,1017.2297297297293,28.25638138138137,0
3348,4,4,3,40,0.09302325581395349,0.06976744186046512,0.9302325581395349,43,1100,1000,100,0.9090909090909091,12,10,2,330.3798749226205,0.40919158361018826,0.10267302881497287,0.1876139108723476,130132.9400489126,-1.3391086654852273,130131.60094024711,2241,0,526.4883720930233,40,3,16,36.49132636122177,0.6145833333333335,44.918699186991866,1020.3252032520318,25.508130081300795,0
3349,4,2,1,41,0.047619047619047616,0.023809523809523808,0.9761904761904762,42,1050,800,250,0.7619047619047619,13,8,5,335.53401416953204,0.4057539682539682,0.1082149420928269,0.1903951410646809,130103.13042534703,330.80512152775896,130433.93554687478,2242,0,539.9761904761905,39,3,17,36.39005173235315,0.6159188034188036,44.94791666666666,1020.2083333333318,26.159188034187995,0
3350,4,1,0,42,0.023809523809523808,0.0,1.0,42,1250,1000,250,0.8,15,10,5,330.3517533328965,0.4050764614789005,0.11011873620432766,0.1884878630807455,130317.12420784912,210.19575052274564,130527.31995837187,2243,0,540.952380952381,38,4,19,36.30563112552753,0.6197916666666667,44.73824786324785,1021.0470085470066,26.86965811965807,0
3351,4,0,0,42,0.0,0.0,1.0,42,800,600,200,0.75,10,6,4,328.21300416770595,0.4055482965543941,0.11161700784342354,0.18764597701832966,130395.54172092004,159.50249565971305,130555.04421657976,2244,1,541.952380952381,39,3,19,36.280915349311584,0.6188568376068377,44.66145833333333,1021.3541666666658,26.188568376068353,0
3352,4,0,0,42,0.0,0.0,1.0,42,1050,500,550,0.47619047619047616,16,5,11,326.5427052980666,0.4051127564847077,0.11138701581152399,0.18720382210804976,130501.95448133661,122.89225260414716,130624.84673394075,2245,2,542.952380952381,39,3,14,36.21599636388349,0.6199252136752138,44.55729166666666,1021.7708333333318,26.199252136752097,0
3353,4,0,1,41,0.0,0.023809523809523808,0.9761904761904762,42,1400,1100,300,0.7857142857142857,17,11,6,328.52904195136756,0.40389082462253195,0.1148174021034658,0.18925123684240738,130688.28124999997,186.97916666666646,130875.26041666664,2246,3,543.952380952381,39,3,16,35.97697636511818,0.6217948717948718,44.375,1022.4999999999998,26.217948717948712,0
3354,4,0,2,39,0.0,0.04878048780487805,0.9512195121951219,41,1250,800,450,0.64,17,8,9,349.68670043442734,0.4042936991869919,0.11410995104622446,0.19113942946075996,128629.57552146754,818.2325906988242,129447.80811216637,2247,4,550.0975609756098,36,5,16,37.52821566015395,0.6064814814814814,46.396396396396405,1014.4144144144154,28.178178178178207,5
3355,4,1,0,40,0.025,0.0,1.0,40,850,700,150,0.8235294117647058,10,7,3,357.2704881702398,0.4013354700854701,0.12854941794110974,0.19491930369536978,128555.01570001706,1185.7826431755782,129740.79834319264,2248,0,564.55,35,5,18,37.41202541276728,0.6077380952380952,46.469907407407405,1014.1203703703696,28.974867724867703,0
3356,4,3,0,43,0.06976744186046512,0.0,1.0,43,700,600,100,0.8571428571428571,8,6,2,341.59521796884434,0.4112679955703211,0.18630207002300003,0.1828539107950873,127793.20987654332,143.59675068588336,127936.8066272292,2249,0,526.0930232558139,38,5,16,38.58745421245423,0.594298245614035,47.22222222222223,1011.111111111112,26.60818713450295,7
3357,4,0,0,43,0.0,0.0,1.0,43,1550,1100,450,0.7096774193548387,20,11,9,343.7469683048759,0.4114987080103359,0.18735268698931495,0.18499836839680595,128009.3505734532,200.56523486011264,128209.91580831331,2250,1,527.0930232558139,38,5,19,38.312042511261254,0.5964912280701754,47.00854700854701,1011.9658119658123,26.63067926225822,0
3358,4,0,0,43,0.0,0.0,1.0,43,1450,900,550,0.6206896551724138,20,9,11,344.5334807184705,0.41140642303433,0.18924252912499817,0.18567179728821326,128063.41428336616,224.42677514792592,128287.84105851408,2251,2,528.0930232558139,38,5,20,38.23688515938358,0.5970394736842106,46.955128205128204,1012.1794871794868,26.636302294197023,0
3359,4,4,4,43,0.0851063829787234,0.0851063829787234,0.9148936170212766,47,850,500,350,0.5882352941176471,12,5,7,318.9748306865426,0.42160037002775214,0.1898196068408835,0.17527824854557528,128840.02267995235,-1180.6037517683276,127659.41892818402,2252,0,484.06382978723406,40,7,17,38.093093093093096,0.6015625,46.1890243902439,1015.2439024390239,25.381097560975597,0
3360,4,3,3,43,0.06521739130434782,0.06521739130434782,0.9347826086956522,46,1400,1100,300,0.7857142857142857,17,11,6,338.8004588666325,0.42035024154589373,0.21983601624793114,0.1847421370046354,128533.3948907356,-489.047172730948,128044.34771800465,2253,0,495.32608695652175,37,9,17,37.90233924452134,0.6036036036036037,46.49122807017544,1014.0350877192982,27.406353722143194,1
3361,4,3,0,46,0.06521739130434782,0.0,1.0,46,1400,800,600,0.5714285714285714,20,8,12,338.7925037945991,0.42195048309178745,0.23913043478260843,0.18616497285662864,128839.34389667973,-470.0392187980975,128369.30467788164,2254,0,496.2608695652174,37,9,20,37.590790042121185,0.6067004504504505,46.18969298245614,1015.2412280701752,27.438952110004735,0
3362,4,1,0,47,0.02127659574468085,0.0,1.0,47,1500,1200,300,0.8,18,12,6,330.38120908740876,0.424645390070922,0.24108275506107724,0.18360010271334393,129285.00987082538,-856.8244556017557,128428.18541522362,2255,0,486.6808510638298,37,10,23,37.35119047619047,0.611204954954955,45.751096491228054,1016.9956140350856,27.486367946894205,0
3363,4,1,1,47,0.020833333333333332,0.020833333333333332,0.9791666666666666,48,1050,700,350,0.6666666666666666,14,7,7,326.2862258486591,0.4268247635933806,0.2389438381082316,0.18257084240234103,129554.63927469116,-1145.6211419753308,128409.01813271584,2256,0,477.5208333333333,38,10,15,37.18167348794906,0.6121162280701755,45.4861111111111,1018.0555555555538,26.790935672514575,0
3364,4,1,3,45,0.020833333333333332,0.0625,0.9375,48,1600,1400,200,0.875,18,14,4,303.9616556398603,0.4251532949172577,0.12637884120311504,0.1665358208644957,128722.74900990506,-1762.5876913265133,126960.16131857855,2257,0,478.5,41,7,13,38.59319500114055,0.598831300813008,46.3045634920635,1014.7817460317474,24.750774293457255,6
3365,4,2,1,46,0.0425531914893617,0.02127659574468085,0.9787234042553191,47,1000,700,300,0.7,13,7,6,304.5802079153619,0.42429848905334566,0.13733404617419565,0.16725957651822754,128814.23017259946,-1553.1469983144432,127261.08317428501,2258,0,489.51063829787233,40,7,15,38.48462475389595,0.6013020833333331,46.21443089430897,1015.1422764227682,25.378556910569205,0
3366,4,2,2,46,0.041666666666666664,0.041666666666666664,0.9583333333333334,48,850,600,250,0.7058823529411765,11,6,5,302.21855487226856,0.42458998226950356,0.15961630123927484,0.16738503910296254,129152.1364776762,-1793.5655910101002,127358.5708866661,2259,0,480.2708333333333,42,6,17,38.20185891325072,0.6016865079365077,45.88178294573646,1016.4728682170589,24.20173495754902,0
3367,4,0,0,46,0.0,0.0,1.0,46,900,400,500,0.4444444444444444,14,4,10,332.36289635972025,0.4214774557165861,0.1586495015246625,0.18024526694083204,128315.61872260776,-656.2602311504203,127659.35849145734,2260,1,497.5652173913044,36,10,22,38.28753102886145,0.6032986111111112,46.70608108108108,1013.1756756756758,28.143768768768773,8
3368,4,0,0,46,0.0,0.0,1.0,46,950,500,450,0.5263157894736842,14,5,9,355.733058033264,0.42163848631239936,0.1521739130434785,0.18811909750143344,127302.17013888877,-107.468574993922,127194.70156389485,2261,2,498.5652173913044,34,12,18,38.73348472336913,0.5971200980392157,47.70833333333333,1009.1666666666657,29.68137254901958,4
3369,4,1,1,46,0.02127659574468085,0.02127659574468085,0.9787234042553191,47,950,500,450,0.5263157894736842,14,5,9,346.3492400892765,0.4250886524822695,0.1530160122833959,0.18459272686076802,127617.73003472212,-559.9392361111206,127057.790798611,2262,0,488.93617021276594,35,12,18,38.646907216494846,0.5982142857142857,47.39583333333333,1010.4166666666657,28.869047619047592,0
3370,4,3,2,47,0.061224489795918366,0.04081632653061224,0.9591836734693877,49,1150,700,450,0.6086956521739131,16,7,9,334.3141210983843,0.43027210884353745,0.15167489987655536,0.1800430738581578,128036.38100162543,-1239.1259633647428,126797.25503826069,2263,0,469.9183673469388,38,11,19,38.52308314859775,0.596765350877193,46.98183760683761,1012.0726495726499,26.63349077822763,0
3371,4,2,2,47,0.04081632653061224,0.04081632653061224,0.9591836734693877,49,1400,1100,300,0.7857142857142857,17,11,6,334.4435243087248,0.430750425170068,0.1659766795390658,0.18173201029897376,128394.44739006228,-1211.8160455423465,127182.63134451993,2264,0,470.8775510204082,37,12,16,38.15443669082909,0.6021959459459459,46.628289473684205,1013.4868421052629,27.391536273115214,0
3372,4,3,3,47,0.06,0.06,0.94,50,1150,700,450,0.6086956521739131,16,7,9,323.2566991585018,0.4331462585034014,0.16621502209131123,0.17803465713793254,128929.98598327111,-1664.503661699184,127265.48232157192,2265,0,453.76,38,12,18,37.892953573181856,0.605811403508772,46.100427350427346,1015.5982905982895,26.726270805218146,0
3373,4,1,0,48,0.020833333333333332,0.0,1.0,48,2100,1600,500,0.7619047619047619,26,16,10,338.1657415646922,0.42992760047281325,0.17894031781226882,0.1864459039678195,128972.51136271423,-877.1830107134016,128095.32835200083,2266,0,473.2708333333333,36,12,19,37.47112897265336,0.6099537037037037,46.058558558558566,1015.765765765767,28.21571571571575,0
3374,4,1,1,48,0.02040816326530612,0.02040816326530612,0.9795918367346939,49,1350,1200,150,0.8888888888888888,15,12,3,333.06692046701204,0.43172477324263037,0.17960943946311647,0.18509261158367485,129285.0098708255,-1187.8879799553897,128097.12189087011,2267,0,464.59183673469386,37,12,20,37.282906558849945,0.611204954954955,45.75109649122806,1016.9956140350865,27.48636794689423,0
3375,4,0,0,48,0.0,0.0,1.0,48,1350,800,550,0.5925925925925926,19,8,11,341.64203171190525,0.4307402482269504,0.18562158469945356,0.18945603576751133,129201.38888888905,-771.8749999999818,128429.51388888907,2268,1,474.9583333333333,36,12,20,37.14993169398907,0.6122685185185185,45.83333333333334,1016.666666666668,28.240740740740776,0
3376,4,2,1,49,0.04,0.02,0.98,50,1150,900,250,0.782608695652174,14,9,5,327.3594874565815,0.43535714285714283,0.1891591528622356,0.18431846466120855,129799.47973738032,-1501.7817682080542,128297.69796917227,2269,0,456.92,38,12,17,36.90610365555324,0.6145833333333334,45.245726495726494,1019.0170940170935,26.816239316239304,0
3377,4,1,4,46,0.02,0.08,0.92,50,1250,900,350,0.72,16,9,7,329.0195311461552,0.4345323129251701,0.19520276642565237,0.18589895711828067,129935.60209155163,-1449.7298241288606,128485.87226742276,2270,0,457.9,38,12,18,36.72587236718014,0.615953947368421,45.11217948717949,1019.5512820512822,26.830296896086374,0
3378,4,0,0,46,0.0,0.0,1.0,46,1100,700,400,0.6363636363636364,15,7,8,342.3261907609753,0.43051529790660226,0.17687310191058314,0.19262234912968323,129774.47041636235,-314.9599768687543,129459.5104394936,2271,1,437.6521739130435,36,10,18,36.550204465075154,0.6180555555555556,45.270270270270274,1018.9189189189192,28.30330330330331,0
3379,4,0,2,44,0.0,0.043478260869565216,0.9565217391304348,46,1700,1500,200,0.8823529411764706,19,15,4,342.0835164783667,0.4301731078904992,0.17184768199196898,0.19305112164352728,129889.23890106333,-313.4064808051143,129575.83242025822,2272,2,438.6521739130435,36,10,18,36.43992119605244,0.6192129629629629,45.157657657657666,1019.3693693693702,28.31581581581584,0
3380,4,0,0,44,0.0,0.0,1.0,44,1300,900,400,0.6923076923076923,17,9,8,356.47508115401075,0.4258500704721635,0.17715474634099682,0.1996680660844959,129595.0414540816,439.4805839002218,130034.52203798182,2273,3,459.27272727272725,34,10,18,36.37222806812424,0.6204044117647058,45.44642857142857,1018.2142857142853,29.947478991596626,0
3381,4,0,0,44,0.0,0.0,1.0,44,1050,500,550,0.47619047619047616,16,5,11,355.51182558057167,0.42564085623678644,0.1759225817416985,0.19989948773446342,129746.60572562365,425.29053287982583,130171.89625850348,2274,4,460.27272727272725,34,10,18,36.24264820440914,0.6219362745098038,45.29761904761905,1018.8095238095243,29.964985994397775,0
3382,4,0,0,44,0.0,0.0,1.0,44,1250,900,350,0.72,16,9,7,356.88951675069455,0.42547568710359407,0.18061027280160502,0.20114095805811047,129837.58680555565,467.5347222222276,130305.12152777788,2275,5,461.27272727272725,34,10,19,36.11508585445624,0.6228553921568627,45.208333333333336,1019.1666666666674,29.975490196078454,0
3383,4,1,0,45,0.022222222222222223,0.0,1.0,45,1450,1200,250,0.8275862068965517,17,12,5,349.83492683161575,0.4279040404040404,0.1749663051556265,0.19947601096197037,130292.12648158861,116.14730688443035,130408.27378847304,2276,0,452.0,35,10,22,35.83364036579376,0.6252976190476189,44.76273148148148,1020.9490740740737,29.169973544973534,0
3384,4,0,0,45,0.0,0.0,1.0,45,1050,600,450,0.5714285714285714,15,6,9,353.5482640684065,0.4276094276094276,0.1707061549309965,0.2020537488432395,130380.7656035665,219.17866941014785,130599.94427297665,2277,1,453.0,35,10,22,35.648987609549714,0.6261904761904762,44.675925925925924,1021.2962962962961,29.179894179894173,0
3385,4,0,0,45,0.0,0.0,1.0,45,800,600,200,0.75,10,6,4,350.4277809691194,0.42746212121212124,0.1661756930281746,0.2005755898076165,130439.87509645052,141.9511959876441,130581.82629243816,2278,2,454.0,35,10,22,35.668762746431,0.6267857142857143,44.61805555555555,1021.5277777777769,29.186507936507912,0
3386,4,1,1,45,0.021739130434782608,0.021739130434782608,0.9782608695652174,46,900,700,200,0.7777777777777778,11,7,4,342.97848259933113,0.4285225442834138,0.17026711289218222,0.19775159368155734,130722.82745160708,-232.97659991071808,130489.85085169636,2279,0,445.10869565217394,36,10,17,35.57267004368094,0.6276041666666666,44.34121621621622,1022.6351351351357,28.406531531531545,0
3387,4,0,0,45,0.0,0.0,1.0,45,900,600,300,0.6666666666666666,12,6,6,349.1200233845419,0.4270833333333333,0.1698964506347589,0.2005906913798887,130587.7074358067,118.15669474450698,130705.86413055121,2280,1,455.55555555555554,35,10,17,35.55243366172196,0.6282738095238096,44.473379629629626,1022.1064814814811,29.203042328042315,0
3388,4,0,1,44,0.0,0.022222222222222223,0.9777777777777777,45,1150,700,450,0.6086956521739131,16,7,9,347.57353161220766,0.4268097643097643,0.17171237096551129,0.20062098620882288,130765.2167593663,90.10564021775181,130855.32239958405,2281,2,456.55555555555554,35,10,19,35.412305269510775,0.6300595238095239,44.29976851851851,1022.800925925925,29.22288359788357,0
3389,4,0,0,44,0.0,0.0,1.0,44,1050,500,550,0.47619047619047616,16,5,11,354.7725805691332,0.4226898343904158,0.16730775335710746,0.20469115108592484,130749.15143140576,477.2427721088278,131226.3942035146,2282,3,467.8181818181818,34,10,19,35.24449035812672,0.632046568627451,44.31547619047618,1022.738095238094,30.080532212885117,0
3390,4,0,1,43,0.0,0.022727272727272728,0.9772727272727273,44,1050,700,350,0.6666666666666666,14,7,7,358.26640070451685,0.422293428470754,0.16053449807521503,0.20752412267223894,130901.38888888883,579.5138888888841,131480.90277777772,2283,4,468.8181818181818,34,10,19,35.00101791530946,0.633578431372549,44.166666666666664,1023.3333333333328,30.09803921568626,0
3391,4,0,1,42,0.0,0.023255813953488372,0.9767441860465116,43,1000,700,300,0.7,13,7,6,366.9744754117122,0.4201965669988926,0.16689944134078227,0.21189816483450463,130779.59183673456,998.5544217686905,131778.14625850326,2284,5,480.4186046511628,34,9,19,34.90165270018622,0.6323529411764707,44.28571428571428,1022.8571428571418,30.084033613445346,0
3392,4,1,0,43,0.023255813953488372,0.0,1.0,43,1150,800,350,0.6956521739130435,15,8,7,359.5610456765297,0.42349575489110375,0.1557430035474967,0.20962551081932068,131150.23389274688,831.3030478394988,131981.53694058637,1731,0,428.27906976744185,35,8,20,34.716101694915245,0.6339285714285714,43.92361111111111,1024.3055555555552,29.265873015873005,0
3393,4,1,0,44,0.022727272727272728,0.0,1.0,44,1150,700,450,0.6086956521739131,16,7,9,351.8000091720216,0.4255197322057787,0.15966550379642963,0.20669416984510003,131446.78605109724,448.7166709533474,131895.5027220506,1732,0,419.52272727272725,35,9,21,34.61531226486081,0.6369047619047619,43.63425925925925,1025.4629629629617,29.29894179894176,0
3394,4,0,1,43,0.0,0.022727272727272728,0.9772727272727273,44,800,700,100,0.875,9,7,2,355.94675905156555,0.42510130373502464,0.16296592446795422,0.21043572395128554,131684.26890432098,577.947102194789,132262.21600651578,1733,1,420.52272727272725,35,9,18,34.26928281461434,0.6392857142857142,43.40277777777778,1026.388888888889,29.325396825396826,1
3395,4,1,0,44,0.022727272727272728,0.0,1.0,44,1150,1000,150,0.8695652173913043,13,10,3,356.96542998875515,0.425266472868217,0.16646856299696733,0.21169768013771625,131803.09070644717,609.8293895747614,132412.92009602193,1734,0,421.47727272727275,35,9,19,34.123271716260916,0.6404761904761904,43.28703703703704,1026.8518518518517,29.338624338624335,0
3396,4,0,1,43,0.0,0.022727272727272728,0.9772727272727273,44,1000,900,100,0.9,11,9,2,359.5216822059115,0.4249581571529246,0.16895518565941092,0.21371432883974975,131892.2422223294,683.6241587362811,132575.8663810657,1735,1,422.47727272727275,35,9,20,33.96772300469484,0.6413690476190477,43.20023148148148,1027.1990740740741,29.348544973544975,0
3397,4,0,1,42,0.0,0.023255813953488372,0.9767441860465116,43,1300,1000,300,0.7692307692307693,16,10,6,367.20022292676697,0.4230112587670727,0.16718418130262735,0.21819583494574016,131877.8061224491,1085.1119614512638,132962.91808390038,1736,2,432.3720930232558,34,9,20,33.78510856127336,0.6433823529411763,43.21428571428572,1027.1428571428582,30.210084033613477,0
3398,4,1,0,43,0.023255813953488372,0.0,1.0,43,900,600,300,0.6666666666666666,12,6,6,353.38258497046604,0.4228497600590624,0.17858689015929397,0.20972705821901597,131831.05656478275,719.4078121444621,132550.4643769272,1737,0,432.16279069767444,33,10,17,34.18705250596658,0.6452020202020202,43.259803921568626,1026.9607843137253,31.120023767082586,1
3399,4,0,0,43,0.0,0.0,1.0,43,1150,1000,150,0.8695652173913043,13,10,3,352.0622100931989,0.42317275747508304,0.18218441510878813,0.2092897478724249,131893.99059256038,686.97796520567,132580.96855776606,1738,1,433.16279069767444,33,10,18,34.15752008271693,0.6458333333333335,43.198529411764696,1027.2058823529399,31.127450980392116,0
3400,4,0,1,42,0.0,0.023255813953488372,0.9767441860465116,43,800,400,400,0.5,12,4,8,352.21002543319713,0.4230343300110742,0.18530303576729223,0.20955121669315044,131925.46323829767,693.0941524894199,132618.5573907871,1739,2,434.16279069767444,33,10,18,34.122007833313454,0.6461489898989898,43.16789215686274,1027.3284313725483,31.131164587046918,0
3401,4,0,1,41,0.0,0.023809523809523808,0.9761904761904762,42,1450,1200,250,0.8275862068965517,17,12,5,362.841647740622,0.4184451219512195,0.1871751650512712,0.21579529576152756,131911.15702479324,1172.5723140495681,133083.7293388428,1740,3,445.3809523809524,32,10,18,33.86338495575221,0.6484375,43.18181818181817,1027.2727272727261,32.10227272727269,0
3402,4,0,0,41,0.0,0.0,1.0,41,1050,800,250,0.7619047619047619,13,8,5,384.59125507818476,0.41778455284552846,0.1203183760319062,0.21895653526164377,130232.20663265292,1818.130311697663,132050.33694435057,1741,4,448.219512195122,34,7,19,35.00748386595133,0.6268382352941178,44.82142857142856,1020.7142857142845,30.02100840336131,8
3403,4,0,1,40,0.0,0.024390243902439025,0.975609756097561,41,1000,600,400,0.6,14,6,8,384.673052894627,0.41763211382113824,0.12224987555997968,0.21917418130042718,130262.58680555565,1821.7084750566992,132084.29528061234,1742,5,449.219512195122,32,9,19,34.97448979591837,0.6318359375,44.79166666666667,1020.8333333333342,31.901041666666693,0
3404,4,0,0,40,0.0,0.0,1.0,40,1150,800,350,0.6956521739130435,15,8,7,393.4006670515016,0.4137419871794872,0.11577811479234756,0.22362271339293555,130171.45691609963,2241.907596371864,132413.36451247148,1743,6,460.65,34,6,19,34.844552029864666,0.6262254901960785,44.88095238095237,1020.4761904761893,30.014005602240864,0
3405,4,1,0,41,0.024390243902439025,0.0,1.0,41,1450,1000,450,0.6896551724137931,19,10,9,402.1339069219177,0.4166666666666667,0.12095812123294047,0.22337594687483503,129267.58660210513,2237.9981216119363,131505.58472371707,1744,0,450.390243902439,31,10,21,35.54470763977807,0.6243279569892473,45.76822916666667,1016.9270833333342,32.80409946236562,4
3406,4,1,1,41,0.023809523809523808,0.023809523809523808,0.9761904761904762,42,1100,800,300,0.7272727272727273,14,8,6,394.70022127252645,0.4193041037553233,0.12816992885188827,0.22121315389596446,129618.91842987972,1832.123157075826,131451.04158695554,1745,0,440.64285714285717,32,10,18,35.37481917751603,0.6253255208333333,45.42297979797981,1018.3080808080817,31.822127525252554,0
3407,4,1,1,41,0.023809523809523808,0.023809523809523808,0.9761904761904762,42,1100,800,300,0.7272727272727273,14,8,6,386.54969239103144,0.42439750290360045,0.12586914347520084,0.21865941471011371,129981.25908604865,1648.8431432622124,131630.10222931087,1746,0,432.9761904761905,33,9,19,35.212990225533794,0.6265782828282829,45.067401960784316,1019.7303921568629,30.90092097445039,0
3408,4,0,0,41,0.0,0.0,1.0,41,1250,900,350,0.72,16,9,7,396.87664982890664,0.41905487804878044,0.12729441969342314,0.22426724614194699,129940.55333958278,2114.0742972655985,132054.62763684837,1747,2,444.5365853658537,32,9,20,34.991228070175445,0.6285807291666666,45.10732323232324,1019.5707070707077,31.861584595959616,0
3409,4,1,2,40,0.023809523809523808,0.047619047619047616,0.9523809523809523,42,1050,800,250,0.7619047619047619,13,8,5,391.32981923742943,0.42076800232288036,0.1519949836237231,0.21958262884326935,129665.12891981343,1749.163404857256,131414.29232467068,1748,0,434.92857142857144,31,11,20,35.41347055314072,0.6283602150537634,45.37760416666667,1018.4895833333339,32.85450268817206,1
3410,4,1,1,40,0.024390243902439025,0.024390243902439025,0.975609756097561,41,850,600,250,0.7058823529411765,11,6,5,391.9401675157984,0.42014735772357725,0.14235049751018192,0.22002653662838872,129683.21352731872,1965.612086776874,131648.82561409558,1749,0,432.7560975609756,32,9,20,35.37947812073883,0.6259765625,45.35984848484849,1018.5606060606067,31.83001893939396,0
3411,4,1,0,41,0.024390243902439025,0.0,1.0,41,800,300,500,0.375,13,3,10,388.153449799167,0.42009654471544716,0.1478700073104271,0.21915740934814512,129908.37191358031,1884.8765432098853,131793.2484567902,1750,0,433.7317073170732,32,9,22,35.24636693914624,0.6282552083333333,45.13888888888889,1019.4444444444449,31.857638888888903,0
3412,4,1,1,41,0.023809523809523808,0.023809523809523808,0.9761904761904762,42,850,500,350,0.5882352941176471,12,5,7,379.0087463556849,0.4220867208672087,0.1522837706511173,0.21594684385382062,130262.58680555565,1474.1319444444543,131736.71875000012,1751,0,424.3809523809524,33,9,23,35.11904761904761,0.6294191919191918,44.79166666666667,1020.8333333333342,30.93434343434346,0
3413,4,0,0,41,0.0,0.0,1.0,41,850,400,450,0.47058823529411764,13,4,9,387.79386781527836,0.4197662601626016,0.15583502303067265,0.2198907463007069,130075.001201461,1888.4575643983108,131963.4587658593,1752,1,435.5609756097561,33,8,23,35.085796091622605,0.6275252525252526,44.97549019607843,1020.0980392156864,30.91206179441474,0
3414,4,2,1,42,0.046511627906976744,0.023255813953488372,0.9767441860465116,43,1100,700,400,0.6363636363636364,15,7,8,365.414256142894,0.42561830933923955,0.14603582986128072,0.21063986195738776,130714.10323245074,953.364853093868,131667.46808554462,1753,0,416.25581395348837,32,11,20,35.00792278882166,0.6363932291666667,44.349747474747474,1022.6010101010098,31.956281565656557,0
3415,4,1,1,42,0.023255813953488372,0.023255813953488372,0.9767441860465116,43,1150,600,550,0.5217391304347826,17,6,11,366.3963921857585,0.42515688445921,0.14823787408219635,0.21173634589793255,130810.95838434852,985.7326420773401,131796.69102642586,1754,0,417.2325581395349,32,11,20,34.88464782358266,0.6373697916666666,44.255050505050505,1022.9797979797979,31.968118686868685,0
3416,4,0,0,42,0.0,0.0,1.0,42,1200,900,300,0.75,15,9,6,373.92247511818186,0.4228489159891599,0.15240094555974992,0.21536445259651762,130681.82615294355,1372.9743776145228,132054.80053055807,1755,2,428.1666666666667,32,10,21,34.82315592327322,0.6360677083333334,44.38131313131313,1022.4747474747473,31.952335858585855,0
3417,4,1,0,43,0.023255813953488372,0.0,1.0,43,1150,800,350,0.6956521739130435,15,8,7,365.1159051099098,0.4255721668512366,0.15732676436613602,0.21228555234469704,131045.64838343425,969.3701040465162,132015.01848748076,1756,0,419.1860465116279,33,10,22,34.679707759824446,0.6373106060606061,44.025735294117645,1023.8970588235294,31.027183600713013,0
3418,4,0,0,43,0.0,0.0,1.0,43,1050,700,350,0.6666666666666666,14,7,7,365.20138655122327,0.4255029531192322,0.16035267792534547,0.21250855055863646,131077.0196559015,973.9018646674306,132050.92152056893,1757,1,420.1860465116279,33,10,22,34.645763523216864,0.6376262626262627,43.995098039215684,1024.0196078431368,31.030897207367783,0
3419,4,0,0,43,0.0,0.0,1.0,43,1100,600,500,0.5454545454545454,16,6,10,367.3627314903133,0.4246493170911776,0.16115562882585865,0.21431568165926382,131175.63952664376,1037.808248299295,132213.44777494305,1758,2,421.1860465116279,34,9,22,34.4906062366841,0.6363357843137256,43.89880952380951,1024.40476190476,30.12955182072824,0
3420,4,1,1,43,0.022727272727272728,0.022727272727272728,0.9772727272727273,44,950,500,450,0.5263157894736842,14,5,9,356.8917535865751,0.4264226568005638,0.1494480480676248,0.20955181068483317,131422.3514543684,580.887848399147,132003.23930276756,1759,0,412.59090909090907,33,11,22,34.509456794550005,0.6410984848484849,43.65808823529411,1025.3676470588227,31.071746880570387,0
3421,4,1,2,42,0.022727272727272728,0.045454545454545456,0.9545454545454546,44,1250,1000,250,0.8,15,10,5,357.75319775782253,0.42474894291754756,0.14922884761594424,0.21057624931314853,131516.61169982684,610.0976787773727,132126.70937860422,1760,0,413.5681818181818,33,11,22,34.392174432497,0.6420454545454546,43.566176470588225,1025.735294117646,31.082887700534727,0
3422,4,0,0,42,0.0,0.0,1.0,42,1400,1100,300,0.7857142857142857,17,11,6,378.0089723142105,0.4218326558265582,0.15253970097738234,0.2212290443679834,131297.6208191609,1526.335742630372,132823.95656179127,1761,5,433.7142857142857,34,8,23,34.094407015913575,0.6375612745098039,43.7797619047619,1024.8809523809516,30.143557422969167,0
3423,4,0,0,42,0.0,0.0,1.0,42,1550,1200,350,0.7741935483870968,19,12,7,378.4798809949774,0.4211793457220287,0.15125712593022556,0.22265018839413261,131495.0074089897,1553.6535803693123,133048.66098935902,1762,6,434.7142857142857,31,11,23,33.88253247852396,0.6468413978494624,43.58723958333333,1025.6510416666658,33.08551747311825,0
3424,4,0,0,42,0.0,0.0,1.0,42,1000,800,200,0.8,12,8,4,375.4685732027716,0.42063492063492064,0.14477291901012412,0.22178841300814858,131651.8722579327,1486.2281272318967,133138.1003851646,1763,7,435.7142857142857,32,10,19,33.80110933398951,0.6458333333333335,43.434343434343425,1026.262626262625,32.07070707070703,0
3425,4,0,0,42,0.0,0.0,1.0,42,850,600,250,0.7058823529411765,11,6,5,375.8699421435924,0.42033246225319393,0.15033294094910166,0.22259275306406032,131749.07415378527,1504.1033759310258,133253.1775297163,1764,8,436.7142857142857,32,10,20,33.69255524125774,0.6468098958333334,43.339646464646464,1026.6414141414139,32.08254419191918,0
3426,4,0,0,42,0.0,0.0,1.0,42,1250,1000,250,0.8,15,10,5,376.590728618509,0.4202719705768487,0.15362696802859066,0.22368581832400605,131862.52170138896,1531.6406250000093,133394.16232638896,1765,9,437.7142857142857,33,9,20,33.55941514536849,0.6455176767676767,43.22916666666667,1027.083333333334,31.12373737373739,0
3427,4,1,2,41,0.023255813953488372,0.046511627906976744,0.9534883720930233,43,1050,700,350,0.6666666666666666,14,7,7,366.6629433221144,0.4239802510151347,0.15036176874024942,0.21950361108313088,132159.87761488336,1091.625943072706,133251.50355795605,1766,0,428.51162790697674,35,8,21,33.51437040372206,0.644047619047619,42.93981481481482,1028.2407407407404,29.37830687830687,0
3428,4,1,1,41,0.023809523809523808,0.023809523809523808,0.9761904761904762,42,900,600,300,0.6666666666666666,12,6,6,365.8797411725388,0.4218689508323655,0.14223318390453699,0.2202462274045391,132368.2260186257,1286.1704550325796,133654.39647365827,1767,0,420.85714285714283,35,7,22,33.324546357740026,0.6461309523809524,42.73726851851852,1029.050925925926,29.401455026455032,0
3429,4,0,0,41,0.0,0.0,1.0,41,900,600,300,0.6666666666666666,12,6,6,373.13662765775024,0.41996951219512196,0.14803523035230315,0.22388197659465017,132244.89795918367,1669.0830498866146,133913.9810090703,1768,1,431.7317073170732,34,7,22,33.2622010030864,0.6470588235294117,42.857142857142854,1028.5714285714284,30.25210084033613,0
3430,4,0,0,41,0.0,0.0,1.0,41,1100,700,400,0.6363636363636364,15,7,8,370.9421048402975,0.41989329268292686,0.14413982121536284,0.22274570729152252,132275.51197562352,1613.311366213145,133888.82334183666,1769,2,432.7317073170732,34,7,22,33.28776569069938,0.6473651960784315,42.82738095238095,1028.6904761904757,30.255602240896344,0
3431,4,0,0,41,0.0,0.0,1.0,41,1300,1100,200,0.8461538461538461,15,11,4,371.56819691241384,0.4194105691056911,0.1458071373189027,0.2240345503135222,132429.5361910082,1641.3774854304365,134070.91367643865,1770,3,433.7317073170732,33,8,23,33.11641762908281,0.651199494949495,42.67769607843137,1029.289215686274,31.190582293523455,0
3432,4,0,0,41,0.0,0.0,1.0,41,900,800,100,0.8888888888888888,10,8,2,371.9925757798527,0.41933434959349597,0.14412416851441257,0.22523239242463106,132587.25610342162,1664.294982698946,134251.55108612057,1771,4,434.7317073170732,33,8,23,32.94661272409965,0.6527777777777779,42.52450980392156,1029.9019607843125,31.209150326797346,0
3433,4,1,0,42,0.023809523809523808,0.0,1.0,42,1400,1100,300,0.7857142857142857,17,11,6,363.362272952225,0.4213124274099884,0.14841508064782194,0.22196361130551262,132919.22477324237,1259.5663265305911,134178.79109977296,1772,0,425.35714285714283,34,8,21,32.83498807049953,0.6537990196078433,42.20238095238094,1031.1904761904743,30.329131652661008,0
3434,4,1,0,43,0.023255813953488372,0.0,1.0,43,1200,700,500,0.5833333333333334,17,7,10,348.1728248184208,0.4231035437430786,0.14213131805538493,0.21465444161749345,133263.00643272029,679.7114786951145,133942.7179114154,1773,0,416.4418604651163,35,8,22,32.88180043343421,0.6550595238095238,41.869212962962955,1032.5231481481476,29.50066137566136,0
3435,4,0,0,43,0.0,0.0,1.0,43,1050,700,350,0.6666666666666666,14,7,7,348.7654837558094,0.4228959025470653,0.13971237030801498,0.21555775047225625,133355.88121905684,701.9856850093199,134057.86690406615,1774,1,417.4418604651163,36,7,23,32.773431821485666,0.6539351851851853,41.77927927927927,1032.8828828828823,28.691191191191177,0
3436,4,0,0,43,0.0,0.0,1.0,43,1400,900,500,0.6428571428571429,19,9,10,350.48766979638253,0.42273440383905503,0.1419684548344411,0.21696180045290223,133414.0453798391,751.9955766577159,134166.0409564968,1775,2,418.4418604651163,36,7,23,32.670681636508974,0.6545138888888891,41.72297297297296,1033.1081081081065,28.697447447447402,0
3437,4,1,1,43,0.022727272727272728,0.022727272727272728,0.9772727272727273,44,1100,900,200,0.8181818181818182,13,9,4,342.90128190917636,0.4245287174066244,0.13563832420710775,0.21343570638699286,133617.7198101817,363.55016333900056,133981.2699735207,1776,0,409.90909090909093,36,8,23,32.66279090876085,0.6565393518518519,41.52590090090089,1033.8963963963954,28.719344344344318,0
3438,4,0,0,43,0.0,0.0,1.0,43,1150,800,350,0.6956521739130435,15,8,7,348.81779273658924,0.42153469915097824,0.13959738534857724,0.21661633443238773,133532.02830289752,715.6694744512772,134247.6977773488,1777,4,420.4418604651163,35,8,23,32.595651362448685,0.6577380952380953,41.60879629629628,1033.5648148148127,29.53042328042322,0
3439,4,0,0,43,0.0,0.0,1.0,43,1100,500,600,0.45454545454545453,17,5,12,350.83436959524596,0.4209579180509413,0.14443851589646184,0.2187512276576077,133681.60211173247,780.0201206704169,134461.62223240288,1778,5,421.4418604651163,35,8,23,32.39379313560903,0.6592261904761906,41.46412037037036,1034.1435185185169,29.546957671957625,0
3440,4,0,0,43,0.0,0.0,1.0,43,1000,600,400,0.6,14,6,8,347.10627890419005,0.42038113695090434,0.1405024670774564,0.21748263767921233,133861.2011986667,692.8126875428525,134554.01388620955,1779,6,422.4418604651163,35,8,18,32.31054039443761,0.6610119047619047,41.29050925925925,1034.837962962962,29.56679894179891,0
3441,4,0,0,43,0.0,0.0,1.0,43,1000,800,200,0.8,12,8,4,346.4534810456973,0.42038113695090434,0.1377247689242822,0.2172501421816707,133891.1461012517,677.4107295953402,134568.55683084705,1780,7,423.4418604651163,35,8,18,32.29749123984196,0.6613095238095238,41.261574074074076,1034.9537037037037,29.57010582010582,0
3442,4,1,0,44,0.022727272727272728,0.0,1.0,44,1350,1100,250,0.8148148148148148,16,11,5,337.40786103437057,0.42196309020436923,0.1404219897046768,0.21336699170977602,134200.50276205258,256.06091733625703,134456.56367938884,1781,0,414.79545454545456,36,8,19,32.222720356482995,0.6623263888888888,40.96283783783784,1036.1486486486485,28.781906906906904,0
3443,4,0,1,43,0.0,0.022727272727272728,0.9772727272727273,44,900,600,300,0.6666666666666666,12,6,6,336.98683003427055,0.4213134249471459,0.14100886074698993,0.21344045401275916,134258.8508060424,248.69290743445265,134507.54371347686,1782,1,415.79545454545456,36,8,20,32.17542286935421,0.6629050925925927,40.90653153153153,1036.373873873873,28.788163163163137,0
3444,4,0,1,42,0.0,0.023255813953488372,0.9767441860465116,43,950,700,250,0.7368421052631579,12,7,5,347.84264962732436,0.41878922111480255,0.14963526404389316,0.21990730222202035,134190.7793209876,735.4552469135784,134926.23456790118,1783,2,426.2325581395349,35,8,20,31.962131367292226,0.6642857142857144,40.97222222222222,1036.1111111111109,29.603174603174597,0
3445,4,1,1,42,0.023255813953488372,0.023255813953488372,0.9767441860465116,43,750,500,250,0.6666666666666666,10,5,5,345.79616907780667,0.41761258767072723,0.14798209772481075,0.2187924453536113,134220.76106234986,682.6049972136364,134903.3660595635,1784,0,426.9767441860465,35,8,20,31.985205145388882,0.6645833333333333,40.94328703703703,1036.226851851851,29.60648148148146,0
3446,4,0,1,41,0.0,0.023809523809523808,0.9761904761904762,42,850,600,250,0.7058823529411765,11,6,5,354.57127757960126,0.4165698799845141,0.15273672687465867,0.22353406630018327,134088.01020408157,1108.7514172335573,135196.76162131512,1785,4,438.14285714285717,34,8,20,31.890565134099617,0.6654411764705883,41.07142857142857,1035.714285714285,30.46218487394956,0
3447,4,0,0,41,0.0,0.0,1.0,41,1200,700,500,0.5833333333333334,17,7,10,350.95915328045913,0.4161585365853659,0.14703036068692898,0.2165461663601838,133292.88435570992,1156.071566358027,134448.95592206795,1786,5,440.1219512195122,35,6,21,32.779926025554815,0.6553571428571429,41.84027777777778,1032.6388888888891,29.50396825396826,3
3448,4,0,0,41,0.0,0.0,1.0,41,800,500,300,0.625,11,5,6,350.0673469321772,0.4159044715447155,0.14386840117856048,0.21636237911468506,133355.88121905678,1136.707907231542,134492.58912628834,1787,6,441.1219512195122,36,5,21,32.739815016717564,0.6539351851851853,41.77927927927927,1032.8828828828819,28.691191191191162,0
3449,4,0,0,41,0.0,0.0,1.0,41,1100,500,600,0.45454545454545453,17,5,12,351.98515097743683,0.41519308943089434,0.1514773709044992,0.21805967320850647,133443.1322158306,1194.0002079782344,134637.13242380886,1788,7,442.1219512195122,36,5,21,32.602861035422336,0.6548032407407408,41.69481981981981,1033.22072072072,28.700575575575556,0
3450,4,0,0,41,0.0,0.0,1.0,41,750,500,250,0.6666666666666666,10,5,5,351.57078059204576,0.41509146341463415,0.147982276965956,0.2181548210378519,133502.97796201808,1187.1555754941323,134690.1335375122,1789,8,443.1219512195122,34,7,21,32.553613255001345,0.6596200980392157,41.63690476190476,1033.4523809523805,30.395658263305307,0
3451,4,0,0,41,0.0,0.0,1.0,41,950,700,250,0.7368421052631579,12,7,5,354.9089151180685,0.4145071138211382,0.14956016672096717,0.2207757176851939,133595.26643990935,1282.8302154195085,134878.09665532885,1790,9,444.1219512195122,34,7,21,32.37491363426993,0.6605392156862745,41.54761904761905,1033.809523809524,30.406162464986004,0
3452,4,0,0,41,0.0,0.0,1.0,41,800,700,100,0.875,9,7,2,354.2696611521085,0.41443089430894314,0.14674581468356718,0.22074507006938393,133656.80980725616,1270.1105442176786,134926.92035147385,1791,10,445.1219512195122,34,7,21,32.32980274771664,0.6611519607843137,41.488095238095234,1034.0476190476184,30.41316526610642,0
3453,4,0,0,41,0.0,0.0,1.0,41,900,800,100,0.8888888888888888,10,8,2,353.91738652666294,0.414354674796748,0.14864910389435426,0.22089326538388274,133718.3673469388,1265.051020408169,134983.41836734695,1792,11,446.1219512195122,34,7,19,32.277279005524875,0.661764705882353,41.42857142857143,1034.2857142857144,30.420168067226896,0
3454,4,0,0,41,0.0,0.0,1.0,41,1300,1000,300,0.7692307692307693,16,10,6,350.65561826292753,0.4140497967479675,0.14625960780247693,0.2193499350351511,133801.32144043635,1183.637018818581,134984.95845925494,1793,12,447.1219512195122,35,6,19,32.2786152440616,0.6604166666666667,41.348379629629626,1034.6064814814813,29.56018518518518,0
3455,4,0,1,40,0.0,0.024390243902439025,0.975609756097561,41,950,600,350,0.631578947368421,13,6,7,352.2884449155949,0.41341463414634144,0.14787983263415727,0.22090906552841857,133891.14610125162,1233.6607295953263,135124.80683084694,1794,13,448.1219512195122,35,6,19,32.14651830313875,0.6613095238095239,41.26157407407407,1034.953703703703,29.570105820105802,0
3456,4,0,0,40,0.0,0.0,1.0,40,1200,1100,100,0.9166666666666666,13,11,2,354.88176219110494,0.411338141025641,0.15463542831581312,0.22253525368252886,133891.14610125174,1503.1051740397859,135394.25127529152,1795,14,459.225,35,5,20,32.07941922015956,0.6613095238095238,41.261574074074076,1034.953703703704,29.570105820105827,0
3457,4,0,0,40,0.0,0.0,1.0,40,900,600,300,0.6666666666666666,12,6,6,353.35537229058406,0.4103766025641025,0.15012293249888242,0.22266365290536247,134070.8858453361,1474.9335562414253,135545.81940157752,1796,15,460.225,35,5,20,31.939167039189375,0.6630952380952382,41.08796296296296,1035.6481481481483,29.589947089947092,0
3458,4,0,0,40,0.0,0.0,1.0,40,1100,900,200,0.8181818181818182,13,9,4,355.28178884344726,0.4102697649572649,0.15408847184986563,0.22461035125187448,134190.7793209878,1535.1080246913714,135725.88734567916,1797,16,461.225,35,5,20,31.769436997319023,0.6642857142857143,40.97222222222223,1036.1111111111122,29.603174603174637,0
3459,4,0,1,39,0.0,0.025,0.975,40,850,700,150,0.8235294117647058,10,7,3,353.82549114613477,0.41052350427350426,0.14579053148727183,0.2244235905598287,134310.72638031543,1504.5117455418376,135815.2381258573,1798,17,462.225,35,5,20,31.687323209766262,0.6654761904761904,40.85648148148148,1036.5740740740735,29.6164021164021,0
3460,4,0,0,39,0.0,0.0,1.0,39,750,600,150,0.8,9,6,3,359.9097063930077,0.40856950067476383,0.14854664569780263,0.22735016103908312,134160.80092860502,1857.1548943329847,136017.955822938,1799,32,474.64102564102564,35,4,20,31.67953766804456,0.6639880952380952,41.001157407407405,1035.9953703703695,29.5998677248677,0
3461,4,0,0,39,0.0,0.0,1.0,39,950,600,350,0.631578947368421,13,6,7,358.80912098179334,0.40854138551506974,0.14307434608942127,0.22739813718272903,134280.73459201396,1836.2304687500102,136116.96506076396,1800,33,475.64102564102564,35,4,20,31.58814907872697,0.6651785714285714,40.88541666666667,1036.458333333334,29.613095238095255,0
3462,4,1,1,39,0.025,0.025,0.975,40,850,600,250,0.7058823529411765,11,6,5,349.1879163239302,0.40989583333333335,0.13082329317269115,0.2229430542683556,134550.78125000012,1396.7013888889032,135947.48263888902,1801,0,464.725,36,4,20,31.567938420348067,0.665798611111111,40.62500000000001,1037.500000000001,28.81944444444447,0
3463,4,0,0,39,0.0,0.0,1.0,39,750,500,250,0.6666666666666666,10,5,5,356.0985331632653,0.4077260458839406,0.13315018315018312,0.22660815746753232,134430.72702331952,1774.1169410150737,136204.84396433458,1802,35,477.64102564102564,35,4,20,31.508556547619037,0.6666666666666667,40.74074074074073,1037.0370370370363,29.62962962962961,0
3464,4,0,0,39,0.0,0.0,1.0,39,750,500,250,0.6666666666666666,10,5,5,356.8165598392909,0.4075292397660819,0.13296829987670122,0.22762610860068053,134520.7626698601,1799.8471525634238,136320.60982242352,1803,36,478.64102564102564,35,4,20,31.400038119677202,0.6675595238095239,40.653935185185176,1037.384259259258,29.639550264550227,0
3465,4,0,1,38,0.0,0.02564102564102564,0.9743589743589743,39,750,400,350,0.5333333333333333,11,4,7,355.999979781135,0.40738866396761136,0.12974664925100932,0.22748503106835571,134581.66099773243,1782.2170678006275,136363.87806553306,1804,37,479.64102564102564,34,5,20,31.360429095915567,0.670343137254902,40.595238095238095,1037.6190476190475,30.51820728291316,0
3466,4,0,0,38,0.0,0.0,1.0,38,950,700,250,0.7368421052631579,12,7,5,359.26879041413804,0.4070797771455666,0.1414522718905964,0.2305506343783439,134736.11288265281,2081.2960600906695,136817.4089427435,1805,38,486.7631578947368,34,4,20,31.121478805947334,0.6718750000000002,40.446428571428555,1038.2142857142837,30.535714285714228,0
3467,4,0,0,38,0.0,0.0,1.0,38,1150,1000,150,0.8695652173913043,13,10,3,349.97436126348055,0.406857515410147,0.1451158035745761,0.22234541334739427,134370.7200038581,1805.261381172848,136175.98138503093,1806,39,487.7631578947368,35,3,21,31.727227059611533,0.6660714285714285,40.798611111111114,1036.8055555555559,29.623015873015884,1
3468,4,0,0,38,0.0,0.0,1.0,38,1350,1000,350,0.7407407407407407,17,10,7,349.7183164740301,0.40641299193930774,0.1379560415039609,0.22309788402539035,134520.76266986033,1808.8749303412335,136329.63760020156,1807,40,488.7631578947368,35,3,21,31.584128268065015,0.6675595238095238,40.65393518518519,1037.38425925926,29.639550264550287,0
3469,4,0,0,38,0.0,0.0,1.0,38,900,500,400,0.5555555555555556,13,5,8,351.3244995382211,0.4064426268373637,0.14038414125879006,0.22467727980454283,134610.82845721877,1858.4163880315436,136469.2448452503,1808,41,489.7631578947368,35,3,21,31.45261729496616,0.668452380952381,40.567129629629626,1037.7314814814813,29.649470899470895,0
3470,4,0,0,38,0.0,0.0,1.0,38,900,500,400,0.5555555555555556,13,5,8,353.27583805537165,0.40601292081555235,0.14083684855880607,0.22686023931243643,134761.0050824117,1921.5614015346346,136682.5664839463,1809,42,490.7631578947368,35,3,21,31.252206182885587,0.6699404761904761,40.4224537037037,1038.3101851851852,29.66600529100529,0
3471,4,0,0,38,0.0,0.0,1.0,38,1100,800,300,0.7272727272727273,14,8,6,351.1156142383743,0.40539058795637745,0.13903909539840242,0.22603382512017037,134851.15124528485,1869.6689600480354,136720.8202053329,1810,43,491.7631578947368,35,3,20,31.218427308520894,0.6708333333333332,40.33564814814816,1038.6574074074092,29.675925925925977,0
3472,4,0,1,37,0.0,0.02631578947368421,0.9736842105263158,38,1000,600,400,0.6,14,6,8,348.4843825179441,0.4045608108108108,0.1358691829797214,0.2254603569892749,135031.5339934841,1811.276148834007,136842.8101423181,1811,44,492.7631578947368,35,3,20,31.107089829250196,0.6726190476190477,40.16203703703703,1039.3518518518508,29.695767195767168,0
3473,4,0,0,37,0.0,0.0,1.0,37,900,600,300,0.6666666666666666,12,6,6,351.25492846610035,0.4025588088088088,0.13638263162945363,0.22733927208580573,135045.28238378663,2087.064200680246,137132.34658446687,1812,45,500.7837837837838,34,3,20,31.021408391555013,0.6749387254901962,40.14880952380951,1039.40476190476,30.570728291316474,0
3474,4,0,0,37,0.0,0.0,1.0,37,800,500,300,0.625,11,5,6,350.1786490326599,0.40233983983983984,0.13407039655321884,0.22683679253361885,135076.21882086157,2060.1615646258388,137136.3803854874,1813,46,501.7837837837838,34,3,20,31.018571537639342,0.6752450980392157,40.11904761904761,1039.5238095238085,30.57422969187672,0
3475,4,0,1,36,0.0,0.02702702702702703,0.972972972972973,37,1300,900,400,0.6923076923076923,17,9,8,350.8897869395279,0.4020583083083083,0.1352960471348379,0.22768732534397,135138.10232426296,2083.715986394545,137221.81831065752,1814,47,502.7837837837838,34,3,20,30.93847797878024,0.6758578431372548,40.0595238095238,1039.7619047619041,30.58123249299718,0
3476,4,0,0,36,0.0,0.0,1.0,36,950,800,150,0.8421052631578947,11,8,3,357.0314501042237,0.4004298941798942,0.13639311401957288,0.23096748499877348,135027.99591803623,2441.8482374567297,137469.84415549296,1815,48,514.9166666666666,33,3,20,30.88853024407497,0.6770833333333335,40.16544117647058,1039.3382352941169,31.495098039215662,0
3477,4,0,0,36,0.0,0.0,1.0,36,750,500,250,0.6666666666666666,10,5,5,358.91422122802715,0.40019841269841266,0.14033622801157875,0.232595060250371,135091.68836805562,2497.265625000009,137588.95399305562,1816,49,515.9166666666666,33,3,20,30.77613560454241,0.6777146464646464,40.10416666666667,1039.583333333334,31.50252525252527,0
3478,4,0,0,36,0.0,0.0,1.0,36,550,400,150,0.7272727272727273,7,4,3,360.95279677598387,0.3997685185185185,0.14576869198643672,0.23474378438603635,135219.11832288056,2561.54378724528,137780.66211012585,1817,50,516.9166666666666,33,3,20,30.59618141471268,0.6789772727272728,39.98161764705882,1040.0735294117642,31.51737967914437,0
3479,4,0,0,36,0.0,0.0,1.0,36,900,600,300,0.6666666666666666,12,6,6,361.3572990110339,0.3993386243386243,0.14684783746989227,0.23521478174889976,135250.98519800068,2574.786139946164,137825.77133794685,1818,51,517.9166666666666,33,3,20,30.553919258561095,0.6792929292929293,39.95098039215686,1040.196078431372,31.52109328579915,0
3480,4,0,0,36,0.0,0.0,1.0,36,850,600,250,0.7058823529411765,11,6,5,361.0127377549126,0.3995701058201058,0.13708369306438528,0.2362436205308342,135442.2652945982,2579.2766003460174,138021.54189494424,1819,52,518.9166666666666,33,3,21,30.37241974727258,0.6811868686868687,39.7671568627451,1040.9313725490194,31.54337492572786,0
3481,4,0,0,36,0.0,0.0,1.0,36,1100,900,200,0.8181818181818182,13,9,4,359.4156220551889,0.39917328042328043,0.13739834209356472,0.23603662721986046,135569.8604503075,2545.1851451364782,138115.04559544398,1820,53,519.9166666666666,33,3,21,30.287028320389126,0.682449494949495,39.64460784313725,1041.4215686274504,31.55822935234698,0
3482,4,0,0,36,0.0,0.0,1.0,36,1000,700,300,0.7,13,7,6,360.54505226356866,0.3990740740740741,0.1348244857419172,0.23762434374766356,135697.51567906578,2585.0135765090376,138282.5292555748,1821,54,520.9166666666666,33,3,21,30.13065553203169,0.6837121212121212,39.52205882352941,1041.9117647058824,31.573083778966133,0
3483,4,0,0,36,0.0,0.0,1.0,36,950,600,350,0.631578947368421,13,6,7,359.28055984492255,0.3981150793650794,0.13336337748517368,0.2376392256641456,135825.23098087288,2559.8730055747915,138385.10398644768,1822,55,521.9166666666666,33,3,21,30.036640802570737,0.6849747474747474,39.399509803921575,1042.4019607843147,31.587938205585296,0
3484,4,0,0,36,0.0,0.0,1.0,36,450,400,50,0.8888888888888888,5,4,1,360.4581013631947,0.39783399470899466,0.13177709859854048,0.23863167846666905,135857.1691927383,2594.163452758551,138451.33264549685,1823,56,522.9166666666666,33,3,21,29.974212413306685,0.685290404040404,39.368872549019606,1042.524509803921,31.591651812240034,0
3485,4,0,0,36,0.0,0.0,1.0,36,1000,700,300,0.7,13,7,6,361.0868689581094,0.39666005291005296,0.1285113826232247,0.24012276785714287,136016.91657054983,2622.784505959253,138639.70107650908,1824,57,523.9166666666666,33,3,21,29.799107142857125,0.6868686868686869,39.21568627450981,1043.1372549019613,31.61021984551398,0
3486,4,0,0,36,0.0,0.0,1.0,36,1150,800,350,0.6956521739130435,15,8,7,363.770886856775,0.39588293650793654,0.13551575650812353,0.24256140184694105,136112.81005202315,2702.7755250384334,138815.58557706157,1825,58,524.9166666666666,33,3,21,29.63385691916227,0.6878156565656566,39.123774509803916,1043.5049019607834,31.621360665478285,0
3487,4,0,0,36,0.0,0.0,1.0,36,1000,800,200,0.8,12,8,4,366.0455565527273,0.3957506613756614,0.1356408650961365,0.24473909346280465,136208.7373245867,2771.720612264512,138980.4579368512,1826,59,525.9166666666666,33,3,21,29.479240040698127,0.6887626262626263,39.03186274509804,1043.8725490196077,31.63250148544266,0
3488,4,0,0,36,0.0,0.0,1.0,36,950,700,250,0.7368421052631579,12,7,5,367.59331595228673,0.3950066137566137,0.1397560275919627,0.24644080607627308,136304.69838823992,2820.939212081872,139125.6376003218,1827,60,526.9166666666666,33,3,21,29.34355807221374,0.689709595959596,38.93995098039215,1044.24019607843,31.64364230540697,0
3489,4,0,0,36,0.0,0.0,1.0,36,1050,700,350,0.6666666666666666,14,7,7,370.71740212177616,0.39459325396825395,0.1364909948653792,0.24966323621566058,136464.7085856401,2917.9684496347445,139382.67703527483,1828,61,527.9166666666666,33,3,21,29.103135507076402,0.6912878787878789,38.78676470588235,1044.85294117647,31.66221033868091,0
3490,4,0,0,36,0.0,0.0,1.0,36,1200,800,400,0.6666666666666666,16,8,8,369.7560426657734,0.3934689153439153,0.13674011564306965,0.2503776631765381,136656.84472318334,2905.9388216070706,139562.7835447904,1829,62,528.9166666666666,33,3,21,28.937626972964523,0.6931818181818181,38.60294117647059,1045.5882352941173,31.684491978609618,0
3491,4,0,0,36,0.0,0.0,1.0,36,700,500,200,0.7142857142857143,9,5,4,367.4544848494469,0.39343584656084657,0.13003541389995577,0.24927317756003012,136720.92013888885,2847.7430555555497,139568.6631944444,1830,63,529.9166666666666,33,3,22,28.93426294820717,0.6938131313131313,38.541666666666664,1045.833333333333,31.691919191919183,0
3492,4,0,0,36,0.0,0.0,1.0,36,900,500,400,0.5555555555555556,13,5,8,369.16841076916086,0.3931547619047619,0.12905587442895672,0.2511227667518983,136817.0614216887,2901.707426230287,139718.76884791898,1831,64,530.9166666666666,33,3,22,28.794146070048036,0.694760101010101,38.44975490196078,1046.2009803921562,31.703060011883522,0
3493,4,0,0,36,0.0,0.0,1.0,36,800,500,300,0.625,11,5,6,369.3103874329781,0.39265873015873015,0.13164760380476537,0.2516792815874061,136881.17438304969,2910.327908737013,139791.5022917867,1832,65,531.9166666666666,33,3,22,28.7268952258266,0.6953914141414141,38.38848039215686,1046.4460784313717,31.71048722519308,0
3494,4,0,0,36,0.0,0.0,1.0,36,1200,900,300,0.75,15,9,6,364.4101369624527,0.3921957671957672,0.12555113348160307,0.24925186549801703,137009.4453605583,2785.5261497981387,139794.97151035644,1833,66,532.9166666666666,33,3,19,28.72807659292208,0.6966540404040404,38.26593137254901,1046.9362745098028,31.725341651812208,0
3495,4,0,0,36,0.0,0.0,1.0,36,1200,1000,200,0.8333333333333334,14,10,4,365.22114211168616,0.39174933862433864,0.12883635039533914,0.2500360126764621,137041.52249134946,2810.0922722029964,139851.61476355247,1834,67,533.9166666666666,33,3,19,28.67509363295879,0.696969696969697,38.23529411764706,1047.0588235294117,31.72905525846702,0
3496,4,0,0,36,0.0,0.0,1.0,36,550,500,50,0.9090909090909091,6,5,1,365.8635369804433,0.39138558201058204,0.13186806043113108,0.25093658001884983,137105.6880166282,2832.3943915801574,139938.08240820837,1835,68,534.9166666666666,33,3,19,28.59476168187846,0.6976010101010102,38.174019607843135,1047.3039215686274,31.736482471776586,0
3497,4,0,0,36,0.0,0.0,1.0,36,1150,700,450,0.6086956521739131,16,7,9,365.45015560343336,0.390625,0.1293112410656274,0.2515780056690304,137234.06412197236,2830.4420174932775,140064.50613946564,1836,69,535.9166666666666,33,3,20,28.47855750487329,0.6988636363636365,38.0514705882353,1047.7941176470592,31.751336898395735,0
3498,4,0,0,36,0.0,0.0,1.0,36,250,0,250,0.0,5,0,5,363.66295270128745,0.390244708994709,0.12574552683896667,0.25057871946403765,137266.16753472213,2783.7239583333226,140049.89149305545,1837,70,536.9166666666666,33,3,20,28.493621603711066,0.6991792929292929,38.02083333333333,1047.9166666666658,31.75505050505048,0
3499,4,0,0,36,0.0,0.0,1.0,36,1100,700,400,0.6363636363636364,15,7,8,366.5972289157417,0.38986441798941796,0.12338320087268206,0.25377070312322697,137426.74091695502,2876.0524798154547,140302.7933967705,1838,71,537.9166666666666,33,3,21,28.25794763908368,0.7007575757575758,37.86764705882353,1048.5294117647059,31.77361853832442,0
3500,4,0,0,36,0.0,0.0,1.0,36,700,500,200,0.7142857142857143,9,5,4,367.2808520262742,0.3897982804232804,0.12136587329411919,0.25447953447682814,137458.8668570982,2897.201947568241,140356.06880466646,1839,72,538.9166666666666,33,3,21,28.208265163024418,0.7010732323232324,37.83700980392157,1048.6519607843136,31.777332144979198,0
3501,4,0,0,36,0.0,0.0,1.0,36,1100,900,200,0.8181818181818182,13,9,4,364.53947943051804,0.38912037037037034,0.11597871235721713,0.2532839240199052,137555.26720492102,2828.865099961533,140384.13230488254,1840,73,539.9166666666666,33,3,21,28.184871495327098,0.7020202020202021,37.74509803921568,1049.019607843136,31.78847296494352,0
3502,4,0,0,36,0.0,0.0,1.0,36,850,700,150,0.8235294117647058,10,7,3,363.60742037180944,0.3888392857142857,0.11197744292593015,0.2528710906420032,137587.40816332656,2805.5605115820767,140392.96867490862,1841,74,540.9166666666666,33,3,21,28.17756395280926,0.7023358585858586,37.71446078431372,1049.1421568627447,31.792186571598325,0
3503,4,0,0,36,0.0,0.0,1.0,36,1300,1100,200,0.8461538461538461,15,11,4,363.6123850539106,0.3883101851851852,0.11371304731500964,0.2531096943765513,137619.5528762975,2808.0347702806534,140427.58764657815,1842,75,541.9166666666666,33,3,21,28.14568247294247,0.7026515151515151,37.68382352941176,1049.2647058823525,31.795900178253106,0
3504,4,0,0,36,0.0,0.0,1.0,36,1050,900,150,0.8571428571428571,12,9,3,365.4609219222257,0.3878968253968254,0.11119867678536699,0.2551078073564682,137716.00954260386,2865.9639621780116,140581.97350478187,1843,76,542.9166666666666,33,3,21,28.001921580073933,0.7035984848484849,37.591911764705884,1049.6323529411768,31.807040998217477,0
3505,4,0,0,36,0.0,0.0,1.0,36,550,300,250,0.5454545454545454,8,3,5,366.0140751722542,0.38743386243386246,0.11621143146181123,0.2559708230204653,137780.3327596356,2885.9082143886826,140666.2409740243,1844,77,543.9166666666666,33,3,21,27.92388914828218,0.704229797979798,37.530637254901954,1049.8774509803911,31.814468211527004,0
3506,4,0,0,36,0.0,0.0,1.0,36,1150,800,350,0.6956521739130435,15,8,7,370.35575313007314,0.3865244708994709,0.13205377389050854,0.26095321142895467,138037.77581038553,3024.6168841311105,141062.39269451663,1845,78,544.9166666666666,33,3,21,27.5557580174927,0.7067550505050504,37.28553921568628,1050.8578431372557,31.844177064765326,0
3507,4,0,0,36,0.0,0.0,1.0,36,700,400,300,0.5714285714285714,10,4,6,370.7148279854927,0.3861937830687831,0.1319905950021374,0.26169720820012954,138102.17411872852,3039.3047445694156,141141.47886329793,1846,79,545.9166666666666,33,3,20,27.48277855505032,0.7073863636363635,37.22426470588236,1051.1029411764719,31.851604278074905,0
3508,4,0,1,35,0.0,0.027777777777777776,0.9722222222222222,36,800,500,300,0.625,11,5,6,372.7077291321033,0.3861937830687831,0.10965302491103213,0.2435601671770255,135392.66117969816,2892.3782578875066,138285.03943758566,1847,80,546.9166666666666,35,1,23,30.117511862396196,0.6761904761904762,39.81481481481481,1040.7407407407402,29.73544973544972,8
3509,4,0,0,35,0.0,0.0,1.0,35,800,500,300,0.625,11,5,6,373.0260912211433,0.38406862745098036,0.11733536643476605,0.24417734093471344,135452.8959297839,3105.4928626543187,138558.38879243823,1848,81,556.6,35,0,24,30.049199466310885,0.6767857142857143,39.75694444444444,1040.972222222222,29.742063492063483,0
3510,4,0,0,35,0.0,0.0,1.0,35,800,600,200,0.75,10,6,4,373.0260912211433,0.38406862745098036,0.11733536643476605,0.24417734093471344,135452.8959297839,3105.4928626543187,138558.38879243823,1849,82,557.6,35,0,24,30.049199466310885,0.6767857142857143,39.75694444444444,1040.972222222222,29.742063492063483,0
3511,4,0,0,35,0.0,0.0,1.0,35,600,400,200,0.6666666666666666,8,4,4,372.21036577358643,0.38396358543417364,0.11663622647502625,0.24384794174314692,135483.01832829634,3085.636761616928,138568.65508991326,1850,83,558.6,35,0,24,30.040415971836207,0.6770833333333334,39.72800925925925,1041.087962962962,29.745370370370342,0
3512,4,0,0,35,0.0,0.0,1.0,35,800,600,200,0.75,10,6,4,371.19297629608934,0.3837535014005602,0.11363787929309832,0.24359031420393232,135543.2731722606,3062.5421971450414,138605.81536940567,1851,84,559.6,35,0,24,30.006877292430815,0.6776785714285715,39.67013888888888,1041.3194444444428,29.75198412698408,0
3513,4,0,0,35,0.0,0.0,1.0,35,750,600,150,0.8,9,6,3,369.2800000000002,0.38347338935574227,0.11382857142857161,0.24294736842105272,135633.68055555556,3017.4515335648202,138651.1320891204,1852,85,560.6,32,3,24,29.96666666666668,0.685546875,39.583333333333336,1041.6666666666667,32.552083333333336,0
3514,4,0,0,35,0.0,0.0,1.0,35,900,800,100,0.8888888888888888,10,8,2,366.9420415615052,0.3830532212885154,0.11017239641092869,0.24184040599658269,135697.51567906578,2958.624687620149,138656.14036668593,1853,86,561.6,33,2,24,29.964028071826235,0.6837121212121212,39.52205882352941,1041.9117647058824,31.573083778966133,0
3515,4,0,0,35,0.0,0.0,1.0,35,1100,800,300,0.7272727272727273,14,8,6,367.58882638769137,0.3819677871148459,0.11063115112021782,0.24313456899328953,135825.23098087273,2985.5674500192213,138810.79843089194,1854,87,562.6,33,2,24,29.82012696919822,0.6849747474747475,39.39950980392157,1042.4019607843136,31.58793820558526,0
3516,4,0,0,35,0.0,0.0,1.0,35,1250,900,350,0.72,16,9,7,367.76033173110767,0.38200280112044815,0.1072083263387611,0.24412171786518932,135953.00635572866,2999.6245434448374,138952.6308991735,1855,88,563.6,33,2,18,29.68860164512339,0.6862373737373737,39.27696078431373,1042.8921568627457,31.602792632204412,0
3517,4,0,0,35,0.0,0.0,1.0,35,1150,900,250,0.782608695652174,14,9,5,370.4672318443256,0.38235294117647056,0.10698431339652736,0.24702650580692515,136112.8100520233,3085.067191705116,139197.8772437284,1856,89,564.6,33,2,19,29.459165198669016,0.6878156565656566,39.12377450980392,1043.5049019607845,31.62136066547832,0
3518,4,0,0,35,0.0,0.0,1.0,35,800,500,300,0.625,11,5,6,370.2775048807085,0.38182773109243695,0.10812588069516194,0.2471225103106672,136144.7820549789,3082.2700403690897,139227.052095348,1857,90,565.6,33,2,20,29.432343040551125,0.6881313131313131,39.09313725490196,1043.6274509803925,31.625074272133105,0
3519,4,0,0,35,0.0,0.0,1.0,35,450,200,250,0.4444444444444444,7,2,5,371.0343783490903,0.3819327731092437,0.10584545195323636,0.24785096473719223,136176.7578125,3105.2517361111113,139282.00954861112,1858,91,566.6,33,2,20,29.380821689953425,0.6884469696969697,39.0625,1043.75,31.62878787878788,0
3520,4,0,0,35,0.0,0.0,1.0,35,750,500,250,0.6666666666666666,10,5,5,373.05583452656697,0.381547619047619,0.108583503840606,0.24942618512537684,136208.7373245868,3162.6928344867497,139371.43015907356,1859,92,567.6,33,2,20,29.29629412225092,0.6887626262626263,39.031862745098046,1043.8725490196089,31.632501485442692,0
3521,4,0,0,35,0.0,0.0,1.0,35,1200,1000,200,0.8333333333333334,14,10,4,370.3864117976393,0.38095238095238093,0.10133394139778806,0.24817870266440759,136285.50347222228,3095.659722222228,139381.1631944445,1860,93,568.6,34,1,20,29.28970470869912,0.6871936274509804,38.958333333333336,1044.166666666667,30.710784313725497,0
3522,4,0,0,35,0.0,0.0,1.0,35,650,400,250,0.6153846153846154,9,4,5,370.2145075041861,0.3809173669467787,0.0986124682431111,0.24828147246381663,136316.5816326531,3093.275226757374,139409.85685941047,1861,94,569.6,34,1,21,29.263328393372845,0.6875,38.92857142857143,1044.2857142857147,30.714285714285726,0
3523,4,0,0,35,0.0,0.0,1.0,35,1350,900,450,0.6666666666666666,18,9,9,370.59764125291167,0.3809173669467787,0.09592185592185598,0.24919496567006158,136409.8373724491,3110.632794784598,139520.4701672337,1862,95,570.6,34,1,21,29.160731244064582,0.6884191176470588,38.83928571428572,1044.6428571428582,30.72478991596642,0
3524,4,0,0,35,0.0,0.0,1.0,35,850,600,250,0.7058823529411765,11,6,5,371.3427334347676,0.3805672268907563,0.09821591353040815,0.24991593777787727,136440.9297052154,3133.269557823131,139574.19926303855,1863,96,571.6,34,1,21,29.110405271953816,0.6887254901960784,38.80952380952381,1044.7619047619046,30.728291316526605,0
3525,4,0,0,35,0.0,0.0,1.0,35,750,500,250,0.6666666666666666,10,5,5,370.80599315156707,0.3804271708683473,0.09526847767704538,0.2497746893239683,136472.02558106591,3120.9289965986563,139592.95457766458,1864,97,572.6,34,1,21,29.093558922942535,0.689031862745098,38.77976190476191,1044.8809523809537,30.731792717086872,0
3526,4,0,0,35,0.0,0.0,1.0,35,1050,800,250,0.7619047619047619,13,8,5,370.9767485215323,0.3799719887955182,0.09097033505280483,0.2503308897210247,136534.22796201817,3130.2047902494332,139664.4327522676,1865,98,573.6,34,1,22,29.027366442647217,0.6896446078431373,38.720238095238095,1045.1190476190477,30.738795518207287,0
3527,4,0,0,35,0.0,0.0,1.0,35,1150,1000,150,0.8695652173913043,13,10,3,370.9767485215323,0.3799719887955182,0.09097033505280483,0.2503308897210247,136534.22796201817,3130.2047902494332,139664.4327522676,1866,99,574.6,34,1,22,29.027366442647217,0.6896446078431373,38.720238095238095,1045.1190476190477,30.738795518207287,0
3528,4,0,0,35,0.0,0.0,1.0,35,1400,1000,400,0.7142857142857143,18,10,8,370.2869059823956,0.3803221288515406,0.09491933385376017,0.25097223627695714,136689.79591836742,3122.888321995476,139812.6842403629,1867,100,575.6,34,1,24,28.891070886460227,0.6911764705882353,38.57142857142858,1045.7142857142862,30.75630252100842,0
3529,4,0,0,35,0.0,0.0,1.0,35,700,400,300,0.5714285714285714,10,4,6,369.99412707734757,0.38011204481792715,0.09288560045532113,0.250996015936255,136720.92013888902,3117.1875000000114,139838.10763888902,1868,101,576.6,34,1,25,28.867861885790166,0.6914828431372548,38.54166666666667,1045.8333333333344,30.759803921568658,0
3530,4,0,0,35,0.0,0.0,1.0,35,1000,800,200,0.8,12,8,4,373.7046846071203,0.37934173669467786,0.09767249405192979,0.25422964011942517,136819.97532139573,3226.0531450872336,140046.02846648297,1869,102,577.6,32,3,25,28.672610427226655,0.697265625,38.446969696969695,1046.2121212121208,32.694128787878775,0
3531,4,0,0,35,0.0,0.0,1.0,35,750,600,150,0.8,9,6,3,374.4976528288159,0.3793767507002801,0.10146701373924771,0.25500920698376334,136853.00168669026,3250.225582848707,140103.22726953897,1870,103,578.6,32,3,25,28.619122320099756,0.6975911458333333,38.41540404040405,1046.3383838383847,32.69807449494952,0
3532,4,0,0,35,0.0,0.0,1.0,35,1100,700,400,0.6363636363636364,15,7,8,373.5339642398743,0.3788865546218487,0.10291200428186742,0.2550242676716841,136945.30236267313,3230.7443351115126,140176.04669778465,1871,104,579.6,33,2,26,28.552838270304026,0.6960227272727272,38.32720588235295,1046.6911764705892,31.717914438502703,0
3533,4,0,0,35,0.0,0.0,1.0,35,900,700,200,0.7777777777777778,11,7,4,368.14485464343045,0.37815126050420167,0.10418257126614172,0.2519715172442781,137032.35721371893,3089.5514455782486,140121.9086592972,1872,105,580.6,34,1,17,28.607636914913783,0.6945465686274509,38.24404761904763,1047.0238095238105,30.794817927170897,0
3534,4,0,0,35,0.0,0.0,1.0,35,1100,900,200,0.8181818181818182,13,9,4,368.14485464343045,0.37815126050420167,0.10418257126614172,0.2519715172442781,137032.35721371893,3089.5514455782486,140121.9086592972,1873,106,581.6,34,1,17,28.607636914913783,0.6945465686274509,38.24404761904763,1047.0238095238105,30.794817927170897,0
3535,4,0,0,35,0.0,0.0,1.0,35,1000,700,300,0.7,13,7,6,369.9948545899525,0.37787114845938374,0.10787589498806693,0.25414400667736087,137157.03125,3149.479166666667,140306.51041666666,1874,107,582.6,34,1,17,28.43575974542562,0.6957720588235294,38.125,1047.5,30.808823529411764,0
3536,4,0,0,35,0.0,0.0,1.0,35,950,700,250,0.7368421052631579,12,7,5,368.35733920752233,0.3774159663865546,0.11018924270458053,0.2536996322147585,137250.57397959192,3111.451247165546,140362.02522675745,1875,108,583.6,34,1,18,28.386067560402942,0.6966911764705881,38.03571428571429,1047.8571428571436,30.819327731092457,0
3537,4,0,0,35,0.0,0.0,1.0,35,1000,500,500,0.5,15,5,10,367.10047745304433,0.3769957983193277,0.10729048376107175,0.253743077272489,137375.34722222236,3086.111111111121,140461.4583333335,1876,109,584.6,34,1,19,28.295574986751447,0.6979166666666666,37.91666666666667,1048.3333333333344,30.833333333333364,0
3538,4,0,0,35,0.0,0.0,1.0,35,600,300,300,0.5,9,3,6,367.90691621970166,0.37692577030812324,0.11279390303226866,0.25521731747209264,137500.1771541952,3117.4532312925407,140617.63038548775,1877,110,585.6,34,1,21,28.15101210745366,0.699142156862745,37.79761904761906,1048.8095238095252,30.84733893557427,0
3539,4,0,0,35,0.0,0.0,1.0,35,650,400,250,0.6153846153846154,9,4,5,369.75397471801125,0.37657563025210083,0.11532962668784741,0.25719351059114715,137593.8368055556,3175.173611111117,140769.01041666672,1878,111,586.6,34,1,22,28.009994704792174,0.7000612745098038,37.708333333333336,1049.166666666667,30.85784313725491,0
3540,4,0,0,35,0.0,0.0,1.0,35,750,400,350,0.5333333333333333,11,4,7,367.9947905020609,0.3760504201680672,0.11081759987035089,0.25643273346052703,137656.2942885488,3131.3598356009115,140787.6541241497,1879,112,587.6,34,1,23,27.994422386084327,0.7006740196078431,37.648809523809526,1049.4047619047622,30.864845938375357,0
3541,4,0,1,34,0.0,0.02857142857142857,0.9714285714285714,35,1000,700,300,0.7,13,7,6,369.3516688796345,0.37556022408963585,0.11379315931884815,0.25784431231288524,137718.7659438777,3173.331207483011,140892.0971513607,1880,113,588.6,34,1,23,27.897102188953166,0.7012867647058822,37.58928571428572,1049.6428571428582,30.87184873949583,0
3542,4,0,0,34,0.0,0.0,1.0,34,600,500,100,0.8333333333333334,7,5,2,370.153568269321,0.37435011883541297,0.09614618670255903,0.2586244262475534,137748.16927383697,3397.5952758554436,141145.76454969242,1881,114,579.1176470588235,33,1,23,27.847011440579035,0.7039141414141414,37.56127450980392,1049.7549019607843,31.81075460487225,0
3543,4,0,0,34,0.0,0.0,1.0,34,1050,800,250,0.7619047619047619,13,8,5,366.45648642724007,0.37379307783719545,0.09573066099251859,0.25699935259258977,137876.8457444252,3305.1728902345244,141182.01863465973,1882,115,580.1176470588235,33,1,24,27.816997277324013,0.7051767676767676,37.43872549019608,1050.2450980392155,31.82560903149138,0
3544,4,0,1,33,0.0,0.029411764705882353,0.9705882352941176,34,800,500,300,0.625,11,5,6,365.3399308299338,0.3733103089720737,0.09832285690757869,0.2566962202519833,137941.20650711277,3279.086168781249,141220.29267589402,1883,116,581.1176470588235,33,1,24,27.78280059107169,0.7058080808080808,37.37745098039216,1050.4901960784323,31.83303624480098,0
3545,4,0,0,33,0.0,0.0,1.0,33,850,800,50,0.9411764705882353,9,8,1,366.45350091891265,0.37156723484848486,0.10427973767525978,0.2584461532796543,138069.9730872742,3519.2450019223443,141589.21808919654,1884,117,590.3939393939394,33,0,16,27.626515858208954,0.7070707070707071,37.254901960784316,1050.9803921568634,31.847890671420103,0
3546,4,0,0,33,0.0,0.0,1.0,33,950,600,350,0.631578947368421,13,6,7,363.4680930343705,0.3701862373737374,0.10445911156784016,0.2575491086975998,138231.01579020088,3448.512741493657,141679.52853169452,1885,118,591.3939393939394,33,0,17,27.54620188012275,0.70864898989899,37.10171568627451,1051.593137254902,31.866458704694004,0
3547,4,0,0,33,0.0,0.0,1.0,33,500,300,200,0.6,7,3,4,364.22452547784883,0.37006786616161613,0.10204586061029808,0.258328502285198,138263.23559448274,3471.772275086489,141735.00786956924,1886,119,592.3939393939394,33,0,17,27.494562262098963,0.7089646464646465,37.07107843137254,1051.7156862745087,31.87017231134875,0
3548,4,0,0,33,0.0,0.0,1.0,33,750,500,250,0.6666666666666666,10,5,5,364.22452547784883,0.37006786616161613,0.10204586061029808,0.258328502285198,138263.23559448274,3471.772275086489,141735.00786956924,1887,120,593.3939393939394,33,0,17,27.494562262098963,0.7089646464646465,37.07107843137254,1051.7156862745087,31.87017231134875,0
3549,4,0,0,33,0.0,0.0,1.0,33,800,700,100,0.875,9,7,2,365.70780376417184,0.3693576388888889,0.10106187692394597,0.25987051221122914,138327.6864667434,3517.502883506326,141845.18935024974,1888,121,594.3939393939394,33,0,18,27.392047219633422,0.7095959595959597,37.00980392156862,1051.9607843137244,31.877599524658315,0
3550,4,0,0,33,0.0,0.0,1.0,33,950,600,350,0.631578947368421,13,6,7,364.956327097417,0.36860795454545453,0.1051182686402814,0.25982711645592194,138392.15235726626,3501.4183246827934,141893.57068194906,1889,122,595.3939393939394,33,0,18,27.348299557419047,0.7102272727272728,36.948529411764696,1052.2058823529399,31.885026737967873,0
3551,4,0,0,33,0.0,0.0,1.0,33,600,400,200,0.6666666666666666,8,4,4,365.5348220105953,0.3680555555555556,0.10434966663138989,0.2612266323686364,138521.1291930986,3526.859260861181,142047.98845395978,1890,123,596.3939393939394,33,0,20,27.206053550640274,0.711489898989899,36.82598039215685,1052.696078431371,31.899881164587,0
3552,4,0,0,33,0.0,0.0,1.0,33,600,400,200,0.6666666666666666,8,4,4,366.2037408949096,0.3677004419191919,0.10145924381752569,0.26195306727961426,138553.3827884707,3547.753418156466,142101.13620662718,1891,124,597.3939393939394,33,0,20,27.15669014084506,0.7118055555555556,36.795343137254896,1052.8186274509799,31.903594771241814,0
3553,4,0,0,33,0.0,0.0,1.0,33,650,400,250,0.6153846153846154,9,4,5,356.57606957924406,0.36766098484848486,0.09455606392149085,0.22951445605311915,134845.6869834711,3024.1520080980513,137869.83899156915,1892,125,598.3939393939394,32,1,18,31.082087284220762,0.677734375,40.34090909090909,1038.636363636364,32.457386363636374,8
3554,4,0,0,33,0.0,0.0,1.0,33,1050,700,350,0.6666666666666666,14,7,7,359.3505479704819,0.3668718434343434,0.09030163130515478,0.23234991047486547,135009.66299676054,3103.1592758392044,138112.82227259973,1893,126,599.3939393939394,32,1,18,30.846545579718946,0.6793619791666666,40.18308080808081,1039.267676767677,32.4771148989899,0
3555,4,0,0,33,0.0,0.0,1.0,33,750,700,50,0.9333333333333333,8,7,1,360.4524184776349,0.36695075757575757,0.08762960590969815,0.2334858191444824,135075.28130101535,3137.6423642995765,138212.9236653149,1894,127,600.3939393939394,32,1,18,30.752510223085945,0.6800130208333333,40.1199494949495,1039.520202020203,32.48500631313134,0
3556,4,0,0,33,0.0,0.0,1.0,33,850,700,150,0.8235294117647058,10,7,3,361.5130673090002,0.366595643939394,0.08374454931831976,0.23459890538137265,135140.91554752074,3171.041379706164,138311.95692722691,1895,128,601.3939393939394,32,1,19,30.65953248330297,0.6806640625,40.05681818181819,1039.772727272728,32.49289772727275,0
3557,4,0,0,33,0.0,0.0,1.0,33,850,500,350,0.5882352941176471,12,5,7,358.37335269894004,0.36564867424242425,0.08168355072943578,0.2331974470405898,135239.39680899907,3093.2392102846634,138332.63601928373,1896,129,602.3939393939394,32,1,19,30.643056567127932,0.681640625,39.96212121212121,1040.151515151515,32.504734848484844,0
3558,4,0,0,33,0.0,0.0,1.0,33,1200,1000,200,0.8333333333333334,14,10,4,360.25256613503166,0.36537247474747475,0.08362930444949357,0.23527746831100885,135370.7609555148,3153.5328027752325,138524.29375829003,1897,130,603.3939393939394,32,1,19,30.463378629782433,0.6829427083333333,39.83585858585859,1040.656565656566,32.52051767676769,0
3559,4,0,0,33,0.0,0.0,1.0,33,1450,1000,450,0.6896551724137931,19,10,9,361.0667730496019,0.36336016414141414,0.08933314230926048,0.23732588134551147,135600.80165608114,3192.1887753800775,138792.99043146122,1898,131,604.3939393939394,32,1,19,30.21325817270779,0.6852213541666666,39.614898989899,1041.540404040405,32.54813762626266,0
3560,4,0,0,33,0.0,0.0,1.0,33,900,700,200,0.7777777777777778,11,7,4,361.0667730496019,0.36336016414141414,0.08933314230926048,0.23732588134551147,135600.80165608114,3192.1887753800775,138792.99043146122,1899,132,605.3939393939394,32,1,19,30.21325817270779,0.6852213541666666,39.614898989899,1041.540404040405,32.54813762626266,0
3561,4,0,0,33,0.0,0.0,1.0,33,450,300,150,0.6666666666666666,6,3,3,359.88351239172835,0.36320233585858586,0.08763676028249989,0.2369831493012094,135666.5634405929,3164.831873023172,138831.39531361609,1900,133,606.3939393939394,32,1,20,30.178665212297492,0.6858723958333333,39.55176767676768,1041.79292929293,32.55602904040406,0
3562,4,0,0,33,0.0,0.0,1.0,33,1000,600,400,0.6,14,6,8,357.70211975394835,0.3629655934343434,0.08981857836819684,0.2359804631758064,135732.3411673555,3110.3492309458434,138842.69039830135,1901,134,607.3939393939394,32,1,20,30.17008966436447,0.6865234375,39.488636363636374,1042.0454545454556,32.56392045454549,0
3563,4,0,0,33,0.0,0.0,1.0,33,850,700,150,0.8235294117647058,10,7,3,360.89284397093843,0.36328125,0.09466348112345435,0.23896489275605773,135863.94444763302,3206.465060963182,139070.4095085962,1902,135,608.3939393939394,32,1,18,29.95614831859837,0.6878255208333333,39.362373737373744,1042.550505050506,32.57970328282831,0
3564,4,0,0,33,0.0,0.0,1.0,33,1200,900,300,0.75,15,9,6,359.98481552919907,0.3629655934343434,0.09139335241030144,0.2390252874816067,135962.68875624952,3188.9006861544904,139151.58944240402,1903,136,609.3939393939394,32,1,18,29.881709039548014,0.6888020833333333,39.267676767676775,1042.9292929292942,32.591540404040444,0
3565,4,0,0,33,0.0,0.0,1.0,33,1000,700,300,0.7,13,7,6,360.90233911133595,0.36261047979797983,0.09224032653779712,0.240301049804752,136061.46893493025,3220.9804803081506,139282.4494152384,1904,137,610.3939393939394,32,1,18,29.759671628544915,0.6897786458333333,39.17297979797981,1043.308080808082,32.60337752525256,0
3566,4,0,0,33,0.0,0.0,1.0,33,300,100,200,0.3333333333333333,5,1,4,363.5890527369804,0.3622159090909091,0.09224000439971403,0.24253942864173875,136127.34231519743,3298.882288797061,139426.2246039945,1905,138,611.3939393939394,32,1,18,29.624168179068356,0.6904296875,39.109848484848484,1043.560606060606,32.61126893939394,0
3567,4,0,0,33,0.0,0.0,1.0,33,500,400,100,0.8,6,4,2,363.5890527369804,0.3622159090909091,0.09224000439971403,0.24253942864173875,136127.34231519743,3298.882288797061,139426.2246039945,1906,139,612.3939393939394,32,1,18,29.624168179068356,0.6904296875,39.109848484848484,1043.560606060606,32.61126893939394,0
3568,4,0,0,33,0.0,0.0,1.0,33,950,700,250,0.7368421052631579,12,7,5,361.0494214261344,0.36261047979797983,0.08369171228661765,0.24161665523403303,136240.72059123896,3237.9266688292937,139478.64726006825,1907,140,613.3939393939394,33,0,19,29.57787983722658,0.6890782828282829,39.00122549019608,1043.9950980392157,31.636215092097444,0
3569,4,0,0,33,0.0,0.0,1.0,33,600,500,100,0.8333333333333334,7,5,2,360.46068395284806,0.36249210858585856,0.08025823699216428,0.24231599921246672,136400.69324298354,3233.4174356016983,139634.11067858525,1908,141,614.3939393939394,33,0,21,29.434537775692167,0.6906565656565656,38.84803921568628,1044.6078431372555,31.654783125371377,0
3570,4,0,0,33,0.0,0.0,1.0,33,900,600,300,0.6666666666666666,12,6,6,359.6108850852682,0.3615056818181818,0.07974668699425336,0.2424033215116272,136496.72188881683,3217.141393935028,139713.86328275184,1909,142,615.3939393939394,33,0,21,29.361513427934785,0.6916035353535352,38.756127450980394,1044.9754901960787,31.665923945335717,0
3571,4,0,0,33,0.0,0.0,1.0,33,900,700,200,0.7777777777777778,11,7,4,359.6108850852682,0.3615056818181818,0.07974668699425336,0.2424033215116272,136496.72188881683,3217.141393935028,139713.86328275184,1910,143,616.3939393939394,33,0,21,29.361513427934785,0.6916035353535352,38.756127450980394,1044.9754901960787,31.665923945335717,0
3572,4,0,0,33,0.0,0.0,1.0,33,800,600,200,0.75,10,6,4,359.6325082696691,0.36107165404040403,0.07513758762439693,0.2428587223303253,136560.75975886683,3222.3377126585947,139783.09747152543,1911,144,617.3939393939394,33,0,21,29.297470395122513,0.6922348484848484,38.69485294117647,1045.2205882352944,31.673351158645286,0
3573,4,0,0,33,0.0,0.0,1.0,33,1050,800,250,0.7619047619047619,13,8,5,358.6076207757202,0.360519255050505,0.06737479091867926,0.24304994663059748,136688.88055375335,3203.5348483756216,139892.41540212897,1912,145,618.3939393939394,33,0,21,29.197307512012188,0.6934974747474747,38.572303921568626,1045.7107843137253,31.688205585264402,0
3574,4,0,0,33,0.0,0.0,1.0,33,750,300,450,0.4,12,3,9,358.6076207757202,0.360519255050505,0.06737479091867926,0.24304994663059748,136688.88055375335,3203.5348483756216,139892.41540212897,1913,146,619.3939393939394,33,0,21,29.197307512012188,0.6934974747474747,38.572303921568626,1045.7107843137253,31.688205585264402,0
3575,4,0,0,33,0.0,0.0,1.0,33,450,200,250,0.4444444444444444,7,2,5,358.6076207757202,0.360519255050505,0.06737479091867926,0.24304994663059748,136688.88055375335,3203.5348483756216,139892.41540212897,1914,147,620.3939393939394,33,0,21,29.197307512012188,0.6934974747474747,38.572303921568626,1045.7107843137253,31.688205585264402,0
3576,4,0,0,33,0.0,0.0,1.0,33,800,700,100,0.875,9,7,2,375.7995958494277,0.36055871212121215,0.057897289432558674,0.23359392711790128,133567.21460796313,3438.901053681255,137006.11566164438,1915,148,621.3939393939394,33,0,18,31.863144635447522,0.6625631313131315,41.57475490196077,1033.7009803921558,31.32427213309563,5
3577,4,0,0,33,0.0,0.0,1.0,33,850,600,250,0.7058823529411765,11,6,5,376.3261125003089,0.36091382575757575,0.0630124882821339,0.2343220229642143,133630.56163795158,3457.7339544886345,137088.29559244023,1916,149,622.3939393939394,33,0,19,31.785957686381398,0.6631944444444446,41.51348039215685,1033.9460784313712,31.331699346405188,0
3578,4,0,0,33,0.0,0.0,1.0,33,800,500,300,0.625,11,5,6,377.58411764265867,0.360519255050505,0.06835323977842656,0.23591321517554975,133757.3007527151,3500.926476595511,137258.2272293106,1917,150,623.3939393939394,33,0,18,31.626263673340446,0.6644570707070707,41.390931372549005,1034.4362745098022,31.346553773024308,0
3579,4,0,0,33,0.0,0.0,1.0,33,550,200,350,0.36363636363636365,9,2,7,378.44138587755276,0.36036142676767674,0.06517197561973687,0.23665201330209612,133788.99491781995,3526.258530372918,137315.25344819287,1918,151,624.3939393939394,33,0,18,31.572297243939026,0.6647727272727273,41.36029411764705,1034.5588235294108,31.350267379679114,0
3580,4,0,1,32,0.0,0.030303030303030304,0.9696969696969697,33,600,400,200,0.6666666666666666,8,4,4,377.5311518178336,0.3597301136363636,0.06662073123465828,0.2364890983642275,133852.39451172625,3506.689734717412,137359.08424644367,1919,152,625.3939393939394,33,0,19,31.532251697457763,0.6654040404040404,41.299019607843135,1034.8039215686274,31.357694592988707,0
3581,4,0,0,32,0.0,0.0,1.0,32,600,500,100,0.8333333333333334,7,5,2,385.04659273852116,0.35861895161290325,0.062156844802342626,0.24127231453248607,133863.92332415056,3908.7695133149555,137772.69283746553,1920,153,638.625,32,0,19,31.326256710590513,0.66796875,41.28787878787878,1034.8484848484843,32.339015151515135,0
3582,4,0,0,32,0.0,0.0,1.0,32,950,700,250,0.7368421052631579,12,7,5,389.97254699965293,0.3578839045698925,0.05545436532130221,0.24544626691820046,134027.3015030353,4053.39362692581,138080.6951299611,1921,154,639.625,32,0,19,31.034833150428806,0.6695963541666667,41.1300505050505,1035.4797979797972,32.358743686868664,0
3583,4,0,0,32,0.0,0.0,1.0,32,900,800,100,0.8888888888888888,10,8,2,389.40879807340275,0.3572958669354838,0.05141792636840181,0.24552808382752675,134092.6806735282,4043.3739223038433,138136.05459583204,1922,155,640.625,32,0,19,30.983837214027382,0.6702473958333334,41.06691919191919,1035.732323232323,32.3666351010101,0
3584,4,0,0,32,0.0,0.0,1.0,32,700,600,100,0.8571428571428571,8,6,2,388.8118221219154,0.3571068548387097,0.050268096514745286,0.2458081519516519,134190.77932098776,4034.9922839506307,138225.77160493837,1923,156,641.625,32,0,20,30.900915996425386,0.6712239583333333,40.97222222222223,1036.111111111112,32.37847222222225,0
3585,4,0,0,32,0.0,0.0,1.0,32,1000,800,200,0.8,12,8,4,387.8249931602885,0.35731686827956993,0.05126096491228016,0.2456224956681828,134256.19834710754,4013.5818411386695,138269.7801882462,1924,157,642.625,32,0,20,30.860897904483423,0.671875,40.909090909090914,1036.3636363636372,32.38636363636366,0
3586,4,0,0,32,0.0,0.0,1.0,32,900,800,100,0.8888888888888888,10,8,2,386.43234453794867,0.35750588037634407,0.04760001826817706,0.245397987703101,134354.35677800732,3983.773817722678,138338.13059573,1925,158,643.625,32,0,20,30.79862379734502,0.6728515625,40.81439393939394,1036.742424242424,32.39820075757575,0
3587,4,0,0,32,0.0,0.0,1.0,32,850,600,250,0.7058823529411765,11,6,5,384.30529714362837,0.3566028225806452,0.04921475529583619,0.2447041636230826,134452.55107897162,3934.1655188246223,138386.71659779624,1926,159,644.625,32,0,20,30.755417579741902,0.673828125,40.719696969696976,1037.121212121213,32.410037878787904,0
3588,4,0,0,32,0.0,0.0,1.0,32,1000,600,400,0.6,14,6,8,369.67073366566336,0.35687584005376344,0.0580753234750464,0.21597393835110576,131231.0785410928,3302.4578168044204,134533.53635789722,1927,160,645.625,32,0,19,34.375385089340725,0.6416015625,43.844696969696976,1024.6212121212127,32.0194128787879,6
3589,4,1,0,33,0.030303030303030304,0.0,1.0,33,850,400,450,0.47058823529411764,13,4,9,360.83192053122013,0.3629655934343434,0.06201752385915804,0.21291371885890828,131610.90573637554,2897.883175941965,134508.7889123175,1928,0,627.030303030303,33,0,19,34.217997332696385,0.6429924242424241,43.47426470588236,1026.1029411764716,31.09402852049914,0
3590,4,0,0,33,0.0,0.0,1.0,33,900,500,400,0.5555555555555556,13,5,8,359.6379605948928,0.3607165404040404,0.05999855355463968,0.21343952618875364,131831.05656478275,2882.290465205687,134713.34702998842,1929,1,628.030303030303,33,0,19,34.02645186953062,0.6452020202020202,43.259803921568626,1026.9607843137253,31.120023767082586,0
3591,4,0,0,33,0.0,0.0,1.0,33,500,300,200,0.6,7,3,4,360.61811333907326,0.3608743686868687,0.06170509678025771,0.21437595929135544,131893.99059256053,2912.672409650129,134806.66300221067,1930,2,629.030303030303,33,0,20,33.93780322914181,0.6458333333333334,43.1985294117647,1027.205882352941,31.12745098039215,0
3592,4,0,0,33,0.0,0.0,1.0,33,450,300,150,0.6666666666666666,6,3,3,363.5309531787192,0.3609532828282828,0.06414816099930598,0.21646615848369183,131956.93963860048,2994.0864090734262,134951.02604767392,1931,3,630.030303030303,33,0,20,33.79949904580152,0.6464646464646465,43.13725490196078,1027.4509803921565,31.13487819370171,0
3593,4,0,0,33,0.0,0.0,1.0,33,600,400,200,0.6666666666666666,8,4,4,363.8761203176456,0.36055871212121215,0.06903902504236403,0.21721202997182135,132051.39136690198,3010.0695946270553,135061.46096152902,1932,4,631.030303030303,33,0,20,33.695376773578175,0.6474116161616161,43.045343137254896,1027.8186274509792,31.146019013666034,0
3594,4,0,0,33,0.0,0.0,1.0,33,700,500,200,0.7142857142857143,9,5,4,363.3117582269179,0.3590198863636364,0.07218136325725988,0.2179610855467135,132240.39619677525,3008.8981701749285,135249.29436695017,1933,5,632.030303030303,33,0,20,33.5193762659359,0.6493055555555556,42.861519607843135,1028.5539215686274,31.16830065359477,0
3595,4,0,0,33,0.0,0.0,1.0,33,550,400,150,0.7272727272727273,7,4,3,365.6440441676093,0.3584280303030303,0.0743821344250224,0.2195433552748863,132271.9101427334,3072.8872308727214,135344.79737360612,1934,6,633.030303030303,33,0,20,33.42764673179255,0.6496212121212122,42.83088235294117,1028.676470588234,31.172014260249515,0
3596,4,0,0,33,0.0,0.0,1.0,33,900,800,100,0.8888888888888888,10,8,2,362.2152882990501,0.358822601010101,0.029001850566735987,0.215682739850798,131956.93963860048,2959.3641868512027,134916.30382545167,1935,7,634.030303030303,33,0,17,33.8332935750636,0.6464646464646465,43.13725490196078,1027.4509803921565,31.13487819370171,2
3597,4,0,0,33,0.0,0.0,1.0,33,700,400,300,0.5714285714285714,10,4,6,362.2152882990501,0.358822601010101,0.029001850566735987,0.215682739850798,131956.93963860048,2959.3641868512027,134916.30382545167,1936,8,635.030303030303,33,0,17,33.8332935750636,0.6464646464646465,43.13725490196078,1027.4509803921565,31.13487819370171,0
3598,4,1,0,34,0.029411764705882353,0.0,1.0,34,900,600,300,0.6666666666666666,12,6,6,354.96092585303626,0.3643048128342246,0.02620580747920509,0.21332213638539202,132306.12953514734,2592.7012471655253,134898.83078231287,1937,0,617.3235294117648,34,0,19,33.6679395201728,0.647671568627451,42.797619047619044,1028.8095238095234,30.25910364145657,0
3599,4,0,0,34,0.0,0.0,1.0,34,800,700,100,0.875,9,7,2,355.3877510107254,0.3648989898989899,0.03570214212852796,0.2149723109260681,132551.19756235817,2621.414399092958,135172.61196145113,1938,1,618.3235294117648,34,0,21,33.41040462427745,0.6501225490196079,42.5595238095238,1029.761904761904,30.28711484593835,0
3600,4,0,0,34,0.0,0.0,1.0,34,900,700,200,0.7777777777777778,11,7,4,355.0706423267456,0.36449049316696375,0.033314296592423576,0.21513103623326357,132612.5,2617.361111111111,135229.86111111112,1939,2,619.3235294117648,34,0,22,33.356930960086295,0.650735294117647,42.5,1030.0,30.294117647058822,0
3601,4,0,1,33,0.0,0.029411764705882353,0.9705882352941176,34,850,700,150,0.8235294117647058,10,7,3,358.6116626134168,0.36402629233511585,0.027712644849967827,0.2178093992925699,132704.4802295917,2717.8748582766275,135422.35508786832,1940,3,620.3235294117648,34,0,15,33.17326208357404,0.651654411764706,42.41071428571428,1030.3571428571418,30.304621848739462,0
3602,4,0,0,33,0.0,0.0,1.0,33,550,400,150,0.7272727272727273,7,4,3,367.20210516522116,0.3575994318181818,0.034580511133712744,0.22195914299267558,132524.15687475976,3132.629877931565,135656.78675269132,1941,4,639.7575757575758,33,0,22,33.133480123780046,0.6521464646464646,42.58578431372549,1029.6568627450984,31.20172311348783,0
3603,4,0,0,33,0.0,0.0,1.0,33,950,800,150,0.8421052631578947,11,8,3,368.3916976141321,0.3585069444444444,0.03825018389511459,0.2230521489012368,132587.2561034218,3168.8088715878494,135756.06497500965,1942,5,640.7575757575758,33,0,22,33.03932651118514,0.6527777777777778,42.52450980392157,1029.9019607843138,31.20915032679739,0
3604,4,0,0,33,0.0,0.0,1.0,33,700,600,100,0.8571428571428571,8,6,2,368.558900152271,0.3586253156565657,0.03873135350651391,0.22352857970274104,132650.37035034611,3177.8949202230024,135828.26527056913,1943,6,641.7575757575758,33,0,16,32.971488619240226,0.6534090909090908,42.46323529411765,1030.1470588235302,31.216577540106975,0
3605,4,0,0,33,0.0,0.0,1.0,33,900,600,300,0.6666666666666666,12,6,6,379.8085589371983,0.3586253156565657,0.011863870805936427,0.21762638871886059,130481.60750973185,3311.606263216074,133793.21377294793,1944,7,642.7575757575758,33,0,19,34.87602954699933,0.6316287878787878,44.57720588235294,1021.6911764705883,30.960338680926917,5
3606,4,0,0,33,0.0,0.0,1.0,33,950,600,350,0.631578947368421,13,6,7,379.14079603053364,0.3577572601010101,0.02001068108249493,0.21794716607103287,130606.84479827493,3303.6766207708843,133910.5214190458,1945,8,643.7575757575758,33,0,19,34.76589038084961,0.632891414141414,44.45465686274511,1022.1813725490215,30.975193107546104,0
3607,4,0,0,33,0.0,0.0,1.0,33,900,600,300,0.6666666666666666,12,6,6,379.1162652169553,0.35890151515151514,0.020003486446439123,0.2184631296250193,130700.81218762035,3310.160755478686,134010.97294309904,1946,9,644.7575757575758,33,0,19,34.6711209651646,0.6338383838383838,44.36274509803923,1022.5490196078448,30.986333927510447,0
3608,4,1,1,33,0.029411764705882353,0.029411764705882353,0.9705882352941176,34,950,700,250,0.7368421052631579,12,7,5,377.55638926424746,0.36449049316696375,0.018668709055349453,0.21973884035528127,131084.19075963716,3098.334750566887,134182.52551020405,1947,0,626.7647058823529,34,0,19,34.3222022010385,0.6354166666666667,43.988095238095234,1024.0476190476188,30.119047619047613,0
3609,4,1,0,34,0.029411764705882353,0.0,1.0,34,1000,600,400,0.6,14,6,8,375.1074096106812,0.36675579322638147,0.028216164514585973,0.21970576848625623,131328.12500000006,3052.6573129251715,134380.78231292524,1948,0,627.7352941176471,33,1,20,34.13787262872627,0.6401515151515151,43.75,1025.0000000000005,31.060606060606073,0
3610,4,1,0,35,0.02857142857142857,0.0,1.0,35,300,200,100,0.6666666666666666,4,2,2,363.3664987491604,0.371218487394958,0.02826656062564159,0.21487969493931827,131694.45153061225,2570.6703514739165,134265.12188208615,1949,0,610.7714285714286,34,1,19,34.068613237454564,0.6415441176470589,43.39285714285714,1026.4285714285713,30.1890756302521,0
3611,4,0,0,35,0.0,0.0,1.0,35,1100,700,400,0.6363636363636364,15,7,8,368.33407588120787,0.37153361344537816,0.027566303428372407,0.21625503718915098,131419.6588010205,2681.2677154195135,134100.92651644003,1950,1,611.7714285714286,34,1,21,34.21886489415225,0.6387867647058822,43.66071428571429,1025.3571428571436,30.157563025210106,1
3612,4,0,0,35,0.0,0.0,1.0,35,650,400,250,0.6153846153846154,9,4,5,368.33407588120787,0.37153361344537816,0.027566303428372407,0.21625503718915098,131419.6588010205,2681.2677154195135,134100.92651644003,1951,2,612.7714285714286,34,1,21,34.21886489415225,0.6387867647058822,43.66071428571429,1025.3571428571436,30.157563025210106,0
3613,4,0,0,35,0.0,0.0,1.0,35,950,700,250,0.7368421052631579,12,7,5,368.41344384009716,0.3714985994397759,0.029115267276827117,0.21682037104687685,131511.2244897959,2690.1006235827617,134201.32511337864,1952,3,613.7714285714286,34,1,22,34.12425526152894,0.6397058823529411,43.57142857142857,1025.7142857142853,30.168067226890745,0
3614,4,0,0,35,0.0,0.0,1.0,35,1150,900,250,0.782608695652174,14,9,5,368.02187938772767,0.37153361344537816,0.024425406399655403,0.21745830172732017,131663.9048327665,2691.039540816333,134354.94437358284,1953,4,614.7714285714286,34,1,16,33.980010052971416,0.6412377450980392,43.42261904761905,1026.3095238095243,30.18557422969189,0
3615,4,0,0,35,0.0,0.0,1.0,35,500,300,200,0.6,7,3,4,366.7305326656547,0.3710434173669468,0.030406412507038683,0.21756654572035344,131816.6737528346,2668.2397959183845,134484.913548753,1954,5,615.7714285714286,34,1,16,33.858876265553754,0.6427696078431371,43.27380952380953,1026.904761904763,30.20308123249303,0
3616,4,0,0,35,0.0,0.0,1.0,35,750,400,350,0.5333333333333333,11,4,7,365.4461616327154,0.37083333333333335,0.030097842822376153,0.21732838929901482,131908.37762188227,2641.0820578231446,134549.4596797054,1955,6,616.7714285714286,34,1,17,33.79930080735503,0.643688725490196,43.18452380952382,1027.2619047619062,30.213585434173712,0
3617,4,0,1,34,0.0,0.02857142857142857,0.9714285714285714,35,850,700,150,0.8235294117647058,10,7,3,367.7173313063421,0.371218487394958,0.033753598729276524,0.2195623401451562,132061.2882653062,2712.244897959197,134773.5331632654,1956,7,617.7714285714286,34,1,17,33.586692147324534,0.645220588235294,43.03571428571429,1027.8571428571436,30.231092436974812,0
3618,4,0,0,34,0.0,0.0,1.0,34,800,600,200,0.75,10,6,4,376.0297695355748,0.3648061497326203,0.03541760215536627,0.22390863549618326,131956.93963860057,3123.9475201845507,135080.88715878513,1957,8,636.7058823529412,33,1,17,33.47845101781171,0.6464646464646464,43.13725490196079,1027.4509803921571,31.13487819370173,0
3619,4,0,0,34,0.0,0.0,1.0,34,950,500,450,0.5263157894736842,14,5,9,377.9077356790749,0.364434789067142,0.03234382233694788,0.22540073054087625,132019.9037029027,3178.2685745866856,135198.1722774894,1958,9,637.7058823529412,33,1,17,33.36662294300021,0.6470959595959596,43.07598039215686,1027.6960784313721,31.14230540701128,0
3620,4,0,0,34,0.0,0.0,1.0,34,750,300,450,0.4,12,3,9,379.4154694275652,0.36395202020202017,0.039285814468849045,0.2266764214785196,132082.88278546705,3222.857795078804,135305.74058054585,1959,10,638.7058823529412,33,1,17,33.264286281990145,0.6477272727272728,43.014705882352935,1027.9411764705876,31.149732620320837,0
3621,4,1,0,35,0.02857142857142857,0.0,1.0,35,750,500,250,0.6666666666666666,10,5,5,367.3075453437395,0.3694327731092437,0.04310717262259134,0.22146561904824574,132429.53619100802,2728.849030420966,135158.385221429,1960,0,621.4285714285714,33,2,19,33.22605369686869,0.651199494949495,42.67769607843136,1029.2892156862727,31.190582293523413,0
3622,4,0,0,35,0.0,0.0,1.0,35,550,300,250,0.5454545454545454,8,3,5,368.88509582631855,0.3690826330532213,0.04857925076946645,0.22278962545196973,132492.61289227675,2774.910040609353,135267.52293288612,1961,1,622.4285714285714,33,2,19,33.12192496924969,0.6518308080808082,42.61642156862744,1029.5343137254883,31.19800950683298,0
3623,4,1,1,35,0.027777777777777776,0.027777777777777776,0.9722222222222222,36,1450,1100,350,0.7586206896551724,18,11,7,361.5878798222833,0.3745701058201058,0.04404028740056476,0.22051767882119502,132857.8514739227,2407.9577664398903,135265.80924036258,1962,0,606.1111111111111,34,2,17,32.94240762124712,0.653186274509804,42.26190476190475,1030.9523809523794,30.32212885154057,0
3624,4,0,0,35,0.0,0.0,1.0,35,800,500,300,0.625,11,5,6,371.4080812167369,0.3677170868347339,0.05088276776155931,0.22544604612195687,132681.9331056563,2855.828437379834,135537.76154303612,1963,3,624.4285714285714,33,2,17,32.866336584592204,0.6537247474747476,42.43259803921568,1030.2696078431359,31.220291146761692,0
3625,4,0,0,35,0.0,0.0,1.0,35,1400,1200,200,0.8571428571428571,16,12,4,371.2808887108189,0.36621148459383757,0.05733983121359865,0.22651095842814473,132871.38848339568,2866.5214400711143,135737.9099234668,1964,4,625.4285714285714,33,2,17,32.67896410317366,0.6556186868686869,42.248774509803916,1031.0049019607834,31.242572786690406,0
3626,4,0,0,35,0.0,0.0,1.0,35,900,800,100,0.8888888888888888,10,8,2,370.75744733912575,0.36540616246498603,0.05848723519826149,0.22676560151207004,132966.16685890054,2859.6393214148534,135825.80618031538,1965,5,626.4285714285714,33,2,18,32.5971364068441,0.6565656565656566,42.156862745098046,1031.3725490196089,31.253713606654813,0
3627,4,0,0,35,0.0,0.0,1.0,35,1000,700,300,0.7,13,7,6,371.1485524623625,0.36568627450980395,0.07330947575516045,0.22835531463772674,133187.44781153888,2886.46569228182,136073.9135038207,1966,6,627.4285714285714,33,2,18,32.364631564367414,0.6587752525252526,41.942401960784316,1032.230392156863,31.279708853238272,0
3628,4,0,0,35,0.0,0.0,1.0,35,750,700,50,0.9333333333333333,8,7,1,370.8855627975604,0.36540616246498603,0.07384344051010716,0.22838742551218197,133219.07439446368,2881.806276432146,136100.88067089583,1967,7,628.4285714285714,33,2,19,32.339644666033564,0.6590909090909091,41.911764705882355,1032.3529411764707,31.283422459893053,0
3629,4,0,0,35,0.0,0.0,1.0,35,700,500,200,0.7142857142857143,9,5,4,370.00470270238907,0.36498599439775914,0.07721677800006788,0.22823276903150289,133282.33882401,2863.0184304113827,136145.35725442137,1968,8,629.4285714285714,33,2,19,32.298836933301686,0.6597222222222222,41.85049019607843,1032.5980392156864,31.29084967320262,0
3630,4,0,1,34,0.0,0.02857142857142857,0.9714285714285714,35,650,500,150,0.7692307692307693,8,5,3,374.2930710545381,0.3653711484593838,0.07666960471896367,0.2312714078334055,133345.61827181868,2982.068194925044,136327.68646674373,1969,9,630.4285714285714,33,2,19,32.12456494225596,0.6603535353535352,41.78921568627452,1032.8431372549032,31.29827688651222,0
3631,4,0,0,34,0.0,0.0,1.0,34,450,300,150,0.6666666666666666,6,3,3,383.43061288185964,0.36398915626856804,0.0810936185208897,0.23668520624609274,133309.1828161667,3422.964333996528,136732.14715016322,1970,10,642.0882352941177,32,2,19,31.925255736235076,0.6624348958333334,41.82449494949495,1032.7020202020199,32.27193813131312,0
3632,4,0,0,34,0.0,0.0,1.0,34,600,300,300,0.5,9,3,6,381.75016887751707,0.36359922756981583,0.08033942183230236,0.23585471158746915,133341.7827262525,3380.649614835224,136722.43234108773,1971,11,643.0882352941177,32,2,19,31.935870008149955,0.6627604166666666,41.792929292929294,1032.8282828282834,32.275883838383855,0
3633,4,0,0,34,0.0,0.0,1.0,34,750,700,50,0.9333333333333333,8,7,1,380.71121621390853,0.36380347593582885,0.0831445889687008,0.2354193847200292,133374.38662190086,3355.4249885215863,136729.81161042245,1972,12,644.0882352941177,32,2,19,31.929929104021518,0.6630859375,41.76136363636364,1032.9545454545457,32.279829545454554,0
3634,4,0,0,34,0.0,0.0,1.0,34,650,300,350,0.46153846153846156,10,3,7,379.5139372601666,0.36350638740344626,0.07920591724234205,0.23489739288569778,133408.91273788922,3326.108347750862,136735.02108564007,1973,13,645.0882352941177,33,1,19,31.926156583629894,0.6609848484848485,41.72794117647059,1033.0882352941173,31.30570409982174,0
3635,4,0,0,34,0.0,0.0,1.0,34,450,100,350,0.2222222222222222,8,1,7,379.5139372601666,0.36350638740344626,0.07920591724234205,0.23489739288569778,133408.91273788922,3326.108347750862,136735.02108564007,1974,14,646.0882352941177,33,1,19,31.926156583629894,0.6609848484848485,41.72794117647059,1033.0882352941173,31.30570409982174,0
3636,4,0,0,34,0.0,0.0,1.0,34,700,500,200,0.7142857142857143,9,5,4,380.1561697381135,0.3636363636363636,0.08134894332540288,0.2354957139648812,133440.56560277293,3345.6508614475165,136786.21646422043,1975,15,647.0882352941177,33,1,19,31.87776756414818,0.661300505050505,41.697303921568626,1033.210784313725,31.309417706476516,0
3637,4,0,0,34,0.0,0.0,1.0,34,750,400,350,0.5333333333333333,11,4,7,380.4630593132151,0.363320707070707,0.07922201138519913,0.23588709677419353,133472.2222222223,3356.250000000009,136828.4722222223,1976,16,648.0882352941177,33,1,19,31.83803763440859,0.6616161616161615,41.66666666666667,1033.3333333333342,31.31313131313134,0
3638,4,0,0,34,0.0,0.0,1.0,34,700,600,100,0.8571428571428571,8,6,2,379.2719587212743,0.36306075460487225,0.08293212227475877,0.23556299348196916,133537.46588358338,3329.403249668407,136866.86913325178,1977,17,649.0882352941177,32,2,19,31.803282026223624,0.6647135416666666,41.60353535353536,1033.5858585858591,32.2995580808081,0
3639,4,1,1,34,0.02857142857142857,0.02857142857142857,0.9714285714285714,35,650,500,150,0.7692307692307693,8,5,3,370.44535881799914,0.3689075630252101,0.0713930306158721,0.23145294402536853,133757.30075271527,2909.9542543733182,136667.2550070886,1978,0,631.5142857142857,33,2,16,31.810878450420585,0.6644570707070707,41.39093137254902,1034.4362745098035,31.34655377302435,0
3640,4,0,0,34,0.0,0.0,1.0,34,1150,700,450,0.6086956521739131,16,7,9,381.1199270188182,0.362002376708259,0.08595213991858208,0.23817815118727523,133765.9442435721,3396.1733815427015,137162.1176251148,1979,19,651.0882352941177,32,2,16,31.526150372269015,0.6669921875,41.38257575757576,1034.469696969697,32.32717803030303,0
3641,4,0,0,34,0.0,0.0,1.0,34,500,300,200,0.6,7,3,4,376.7374376954494,0.3613339275103981,0.08027374360045991,0.23619507508077714,133884.09994052755,3287.830551951153,137171.9304924787,1980,20,652.0882352941177,33,1,16,31.520993684626,0.665719696969697,41.26838235294117,1034.9264705882342,31.36140819964346,0
3642,4,0,0,34,0.0,0.0,1.0,34,1150,700,450,0.6086956521739131,16,7,9,373.27488533314664,0.3609811348781937,0.0826801253045597,0.2350352295875624,134042.683403018,3206.953455401759,137249.63685841975,1981,21,653.0882352941177,33,1,16,31.451676528599595,0.6672979797979799,41.11519607843137,1035.539215686274,31.379976232917393,0
3643,4,0,0,34,0.0,0.0,1.0,34,650,400,250,0.6153846153846154,9,4,5,387.5598531807947,0.3609811348781937,0.08032860427297672,0.2323144491352308,132208.88600538266,3447.7712898885175,135656.65729527117,1982,22,654.0882352941177,33,1,17,32.92768906895455,0.648989898989899,42.892156862745104,1028.4313725490206,31.164587046940017,4
3644,4,2,2,34,0.05555555555555555,0.05555555555555555,0.9444444444444444,36,650,400,250,0.6153846153846154,9,4,5,370.6542103269789,0.36916335978835974,0.07327091136079922,0.22471542724183322,132636.34366426614,2632.443844307276,135268.7875085734,1983,0,618.6944444444445,35,1,16,32.93164794007491,0.6488095238095237,42.476851851851855,1030.0925925925928,29.431216931216937,0
3645,4,0,0,34,0.0,0.0,1.0,34,1050,800,250,0.7619047619047619,13,8,5,391.2648274648636,0.360034165181224,0.08298832215987484,0.23551618324175344,132366.4745080018,3558.0691621011197,135924.5436701029,1984,24,656.0882352941177,33,1,18,32.67325135961256,0.6505681818181819,42.7389705882353,1029.0441176470592,31.183155080213915,0
3646,4,1,1,34,0.02857142857142857,0.02857142857142857,0.9714285714285714,35,850,600,250,0.7058823529411765,11,6,5,384.1994742409483,0.3652310924369748,0.07605177993527512,0.2327796814518689,132612.50000000012,3189.9305555555707,135802.43055555568,1985,0,638.3142857142857,34,1,18,32.60686353829558,0.650735294117647,42.50000000000001,1030.000000000001,30.29411764705885,0
3647,4,0,0,34,0.0,0.0,1.0,34,900,700,200,0.7777777777777778,11,7,4,390.6516717294927,0.36021984551396313,0.07518828569028724,0.23653001795494652,132587.25610342182,3559.0866493656263,136146.34275278746,1986,26,658.0882352941177,33,1,18,32.46618673647468,0.6527777777777778,42.52450980392157,1029.901960784314,31.209150326797396,0
3648,4,0,0,34,0.0,0.0,1.0,34,850,600,250,0.7058823529411765,11,6,5,392.6708145031822,0.3595699643493761,0.07521393236728491,0.23835260198759917,132681.9331056563,3620.064548490944,136301.99765414724,1987,27,659.0882352941177,33,1,16,32.31867788747472,0.6537247474747476,42.43259803921568,1030.2696078431359,31.220291146761692,0
3649,4,0,0,34,0.0,0.0,1.0,34,500,100,400,0.2,9,1,8,391.25213538644255,0.35936571598336303,0.073319527620753,0.2376913261798561,132713.4996155325,3584.8880238369798,136298.38763936947,1988,28,660.0882352941177,33,1,16,32.32338249286393,0.6540404040404041,42.40196078431372,1030.392156862745,31.224004753416516,0
3650,4,0,0,34,0.0,0.0,1.0,34,700,500,200,0.7142857142857143,9,5,4,391.32904743659174,0.3595142602495544,0.07262362733440542,0.23813873291908352,132776.64389898113,3591.871515763159,136368.5154147443,1989,29,661.0882352941177,33,1,17,32.25772889417361,0.6546717171717171,42.3406862745098,1030.6372549019604,31.231431966726074,0
3651,4,0,0,34,0.0,0.0,1.0,34,1400,1100,300,0.7857142857142857,17,11,6,392.34646336585485,0.36014557338086745,0.06645967944952602,0.23916075723431673,132839.80320069205,3623.8453960015413,136463.6485966936,1990,30,662.0882352941177,33,1,17,32.167835631637345,0.6553030303030303,42.279411764705884,1030.8823529411766,31.238859180035654,0
3652,4,0,0,34,0.0,0.0,1.0,34,800,600,200,0.75,10,6,4,391.03729287706784,0.36021984551396313,0.06624113871838211,0.2387654413837189,132902.97752066507,3594.004108996527,136496.9816296616,1991,31,663.0882352941177,33,1,17,32.13790507883686,0.6559343434343434,42.218137254901954,1031.1274509803916,31.2462863933452,0
3653,4,0,1,33,0.0,0.029411764705882353,0.9705882352941176,34,950,600,350,0.631578947368421,13,6,7,390.3693760180034,0.3596813725490196,0.0651013463943606,0.23936779145634157,133060.97902549495,3588.5862709054168,136649.56529640037,1992,32,664.0882352941177,33,1,17,31.995956566496414,0.6575126262626263,42.064950980392155,1031.740196078431,31.26485442661912,0
3654,4,0,0,33,0.0,0.0,1.0,33,600,400,200,0.6666666666666666,8,4,4,401.67752590822965,0.35874368686868685,0.07035466675569513,0.245790540010811,132983.402921258,4083.2888544536286,137066.69177571163,1993,33,677.969696969697,32,1,17,31.782500918105043,0.6591796875,42.140151515151516,1031.4393939393938,32.232481060606055,0
3655,4,0,0,33,0.0,0.0,1.0,33,900,700,200,0.7777777777777778,11,7,4,402.7586407653945,0.358230744949495,0.06830418724691878,0.24709786879390416,133081.0950413222,4119.912190082634,137201.00723140483,1994,34,678.969696969697,32,1,17,31.656112334801765,0.66015625,42.04545454545454,1031.818181818181,32.24431818181816,0
3656,4,0,0,33,0.0,0.0,1.0,33,600,300,300,0.5,9,3,6,404.70671403295813,0.35874368686868685,0.06810027871671709,0.24916280827812223,133211.40699928565,4182.310159677566,137393.7171589632,1995,35,679.969696969697,32,1,17,31.474488339856485,0.6614583333333335,41.91919191919191,1032.3232323232312,32.260101010100975,0
3657,4,0,0,33,0.0,0.0,1.0,33,1250,1000,250,0.8,15,10,5,402.9654011961636,0.3586647727272727,0.07314371246392226,0.24874369934969204,133309.18281616663,4143.797667329848,137452.98048349647,1996,36,680.969696969697,32,1,17,31.420915352325054,0.6624348958333335,41.82449494949494,1032.7020202020194,32.27193813131311,0
3658,4,0,0,33,0.0,0.0,1.0,33,1100,1000,100,0.9090909090909091,12,10,2,400.88729567248384,0.35771780303030304,0.07096265182073802,0.24789561344645433,133374.38662190078,4093.619432966018,137468.0060548668,1997,37,681.969696969697,32,1,18,31.40890477936683,0.6630859375,41.76136363636363,1032.954545454545,32.27982954545453,0
3659,4,0,0,33,0.0,0.0,1.0,33,1250,1000,250,0.8,15,10,5,399.1364907808628,0.3573626893939394,0.07144138881571171,0.24768931409911693,133505.86149427615,4057.4480811645303,137563.30957544068,1998,38,682.969696969697,31,2,18,31.321789299063468,0.667002688172043,41.63411458333333,1033.4635416666658,33.33753360215051,0
3660,4,0,0,33,0.0,0.0,1.0,33,500,300,200,0.6,7,3,4,399.91402251297393,0.3573232323232323,0.0683478778716875,0.2483973013073542,133539.5050048828,4080.864122178822,137620.36912706163,1999,39,683.969696969697,31,2,18,31.267846644830776,0.6673387096774194,41.6015625,1033.59375,33.341733870967744,0
3661,4,0,0,33,0.0,0.0,1.0,33,550,400,150,0.7272727272727273,7,4,3,400.6806782685352,0.3569286616161616,0.06501085931744699,0.2490997576173769,133573.15275404195,4104.036288791244,137677.1890428332,2000,40,684.969696969697,31,2,18,31.21417999748079,0.6676747311827957,41.56901041666667,1033.723958333334,33.345934139784966,0
3662,4,0,0,33,0.0,0.0,1.0,33,1000,700,300,0.7,13,7,6,402.07940984677225,0.3570470328282828,0.06103329366169241,0.25110997105524835,133741.455078125,4154.937065972221,137896.39214409722,2001,41,685.969696969697,31,2,18,31.008727760993622,0.6693548387096775,41.40625,1034.375,33.36693548387097,0
3663,4,0,0,33,0.0,0.0,1.0,33,1000,800,200,0.8,12,8,4,405.1580238123493,0.35684974747474746,0.06373165618448606,0.254423877512494,133943.5577392577,4253.661431206582,138197.2191704643,2002,42,686.969696969697,31,2,18,30.725890985324956,0.6713709677419356,41.21093749999999,1035.156249999999,33.392137096774164,0
3664,4,0,0,33,0.0,0.0,1.0,33,1500,1100,400,0.7333333333333333,19,11,8,402.53593998599274,0.35684974747474746,0.06463020547527631,0.25324096477599783,134010.9592013888,4188.8454861111,138199.80468749988,2003,43,687.969696969697,31,2,18,30.726022803487595,0.6720430107526882,41.14583333333333,1035.4166666666658,33.40053763440857,0
3665,4,0,0,33,0.0,0.0,1.0,33,750,500,250,0.6666666666666666,10,5,5,389.7190502678836,0.3569286616161616,0.051221609440787574,0.23993546347817887,133211.40699928574,3783.004604122024,136994.41160340776,2004,44,688.969696969697,32,1,20,31.861291177429877,0.6614583333333334,41.91919191919192,1032.3232323232319,32.260101010100996,4
3666,4,0,0,33,0.0,0.0,1.0,33,750,500,250,0.6666666666666666,10,5,5,394.1747464547267,0.35669191919191917,0.048201788023282344,0.24331737745307255,133309.18281616678,3909.4226673298754,137218.60548349665,2005,45,689.969696969697,32,1,20,31.647868525084572,0.6624348958333333,41.824494949494955,1032.7020202020208,32.27193813131315,0
3667,4,0,0,33,0.0,0.0,1.0,33,700,700,0,1.0,7,7,0,394.7043035803394,0.356573547979798,0.04847151381804826,0.2440722530302918,133374.386621901,3928.68887741049,137303.0754993115,2006,46,690.969696969697,32,1,20,31.568573524019058,0.6630859375,41.76136363636365,1032.9545454545469,32.27982954545459,0
3668,4,0,0,33,0.0,0.0,1.0,33,850,700,150,0.8235294117647058,10,7,3,395.84814318022165,0.35665246212121215,0.04987821039616813,0.24585833839706359,133537.46588358347,3972.111583001755,137509.57746658524,2007,47,691.969696969697,32,1,20,31.37495928007166,0.6647135416666665,41.603535353535364,1033.5858585858598,32.29955808080812,0
3669,4,1,0,34,0.029411764705882353,0.0,1.0,34,550,400,150,0.7272727272727273,7,4,3,388.55594110029324,0.3618724004753417,0.04615877615849806,0.24339513105718663,133852.39451172634,3601.8286236063154,137454.22313533266,2008,0,672.5882352941177,33,1,17,31.247039317858835,0.6654040404040403,41.29901960784314,1034.803921568628,31.35769459298873,0
3670,4,0,0,34,0.0,0.0,1.0,34,700,500,200,0.7142857142857143,9,5,4,387.9261594700693,0.36190953654188945,0.042157094900475256,0.24341934196762313,133915.8091238947,3589.889105151873,137505.69822904657,2009,1,673.5882352941177,33,1,17,31.199680322045946,0.6660353535353535,41.23774509803922,1035.0490196078435,31.36512180629829,0
3671,4,0,0,34,0.0,0.0,1.0,34,500,300,200,0.6,7,3,4,388.0828024976913,0.36151960784313725,0.04595784093204003,0.2437275414645353,133947.52206182727,3596.5459498750565,137544.06801170233,2010,2,674.5882352941177,33,1,17,31.16380075766545,0.6663510101010102,41.20710784313726,1035.1715686274515,31.368835412953075,0
3672,4,0,0,34,0.0,0.0,1.0,34,750,600,150,0.8,9,6,3,389.5861984450104,0.361798128342246,0.030627306273063093,0.23051934449475517,131716.66953627183,3473.545885929529,135190.21542220135,2011,3,675.5882352941177,32,2,16,33.373308733087335,0.646484375,43.371212121212125,1026.5151515151517,32.07859848484849,4
3673,4,0,0,34,0.0,0.0,1.0,34,950,600,350,0.631578947368421,13,6,7,389.22233330351474,0.3625965537730244,0.031016634256012976,0.231682671989078,131943.58555568295,3471.078046882959,135414.6636025659,2012,4,676.5882352941177,32,2,17,33.15308672319856,0.6487630208333335,43.15025252525252,1027.398989898989,32.106218434343404,0
3674,4,0,0,34,0.0,0.0,1.0,34,700,600,100,0.8571428571428571,8,6,2,379.64604943606935,0.36317216280451575,0.02894215652244947,0.2283424359969343,132336.75063775506,3248.2249149659783,135584.97555272104,2013,5,677.5882352941177,34,0,20,33.00214046048826,0.6479779411764706,42.76785714285714,1028.9285714285709,30.26260504201679,2
3675,4,1,0,35,0.02857142857142857,0.0,1.0,35,750,400,350,0.5333333333333333,11,4,7,368.8196605439931,0.3670168067226891,0.027841537724788035,0.22327913809419767,132581.8470096372,2779.7725340136067,135361.6195436508,2014,0,659.2,34,1,21,33.03375332331521,0.6504289215686274,42.529761904761905,1029.8809523809525,30.290616246498605,0
3676,4,2,3,34,0.05405405405405406,0.08108108108108109,0.9189189189189189,37,850,600,250,0.7058823529411765,11,6,5,354.6077973341469,0.37543793793793795,0.025309807624217973,0.21712616467786006,133007.1625679734,2033.0753895787705,135040.23795755216,2015,0,624.5135135135135,36,1,18,32.972389010189225,0.650462962962963,42.11711711711712,1031.5315315315318,28.65365365365366,0
3677,4,0,0,34,0.0,0.0,1.0,34,1050,800,250,0.7619047619047619,13,8,5,381.6124758271304,0.36198380867498514,0.027563465281375876,0.2306696418632768,132524.1568747596,3314.574322375995,135838.73119713558,2016,8,680.5882352941177,33,1,20,32.76253669761168,0.6521464646464648,42.58578431372548,1029.656862745097,31.201723113487787,0
3678,4,0,0,34,0.0,0.0,1.0,34,950,700,250,0.7368421052631579,12,7,5,383.04400124426684,0.36140819964349374,0.02927179200056007,0.2321185890741211,132618.81134960108,3359.7680279219503,135978.57937752304,2017,9,681.5882352941177,33,1,20,32.63025480864564,0.6530934343434345,42.493872549019606,1030.0245098039213,31.212863933452162,0
3679,4,0,0,34,0.0,0.0,1.0,34,650,400,250,0.6153846153846154,9,4,5,380.4597768787101,0.36101827094474154,0.027886606593160446,0.23113481242747064,132713.49961553246,3298.4296905036454,136011.9293060361,2018,10,682.5882352941177,33,1,19,32.601391531874405,0.6540404040404041,42.40196078431372,1030.3921568627447,31.22400475341651,0
3680,4,0,0,34,0.0,0.0,1.0,34,400,200,200,0.5,6,2,4,380.66924568938305,0.3612596553773024,0.02980350185025893,0.23145681033998702,132745.06987997398,3306.3931240388238,136051.4630040128,2019,11,683.5882352941177,33,1,19,32.56419213541048,0.6543560606060606,42.37132352941176,1030.5147058823525,31.227718360071286,0
3681,4,0,0,34,0.0,0.0,1.0,34,800,400,400,0.5,12,4,8,382.038591858771,0.36073975044563283,0.03648933119794129,0.23268114381782207,132808.22167255386,3347.57319901,136155.79487156385,2020,12,684.5882352941177,33,1,19,32.46529841873737,0.6549873737373737,42.310049019607845,1030.7598039215688,31.235145573380873,0
3682,4,0,0,34,0.0,0.0,1.0,34,800,500,300,0.625,11,5,6,385.6536008802328,0.35992275698158055,0.034613797973724214,0.23527945933324107,132871.38848339568,3448.465884515559,136319.85436791123,2021,13,685.5882352941177,33,1,19,32.30850568564524,0.6556186868686869,42.248774509803916,1031.0049019607834,31.242572786690406,0
3683,4,0,0,34,0.0,0.0,1.0,34,900,700,200,0.7777777777777778,11,7,4,385.45432430995874,0.3597556446821153,0.036480366127751296,0.23565213913176938,132949.91673752837,3449.2240646258574,136399.14080215423,2022,14,686.5882352941177,34,0,19,32.23455115625843,0.6541053921568627,42.17261904761905,1031.309523809524,30.332633053221297,0
3684,4,0,0,34,0.0,0.0,1.0,34,1000,700,300,0.7,13,7,6,383.7551316548399,0.3592171717171717,0.03516107573885807,0.23519250147955026,133042.0138888888,3411.1111111111013,136453.12499999988,2023,15,687.5882352941177,34,0,19,32.18564889606893,0.6550245098039216,42.08333333333333,1031.6666666666658,30.343137254901936,0
3685,4,0,0,34,0.0,0.0,1.0,34,950,700,250,0.7368421052631579,12,7,5,382.77133229300966,0.3581773618538324,0.03728204084401954,0.23536364900570161,133164.85969387754,3394.338151927441,136559.19784580497,2024,16,688.5882352941177,34,0,19,32.0874183006536,0.65625,41.964285714285715,1032.142857142857,30.357142857142858,0
3686,4,0,0,34,0.0,0.0,1.0,34,800,500,300,0.625,11,5,6,381.73393438270193,0.3579174093879976,0.03561156935098775,0.23511340049480023,133226.30385487515,3371.400226757355,136597.70408163252,2025,17,689.5882352941177,34,0,20,32.05239083640837,0.6568627450980392,41.9047619047619,1032.3809523809514,30.364145658263276,0
3687,4,1,1,34,0.02857142857142857,0.02857142857142857,0.9714285714285714,35,800,600,200,0.75,10,6,4,375.8833747174262,0.3638655462184874,0.02887296505226078,0.23324683583458836,133503.88259623697,3036.8315003697476,136540.7140966067,2026,0,670.8571428571429,33,2,20,31.924557294754738,0.6619318181818181,41.6360294117647,1033.4558823529408,31.316844919786085,0
3688,4,0,0,34,0.0,0.0,1.0,34,650,500,150,0.7692307692307693,8,5,3,384.34004102683383,0.3574532085561497,0.03453127648754051,0.23730603956639004,133318.49666950098,3447.9272959183522,136766.42396541932,2027,19,691.5882352941177,34,0,20,31.892411143131607,0.6577818627450981,41.81547619047618,1032.738095238094,30.374649859943943,0
3689,4,0,0,34,0.0,0.0,1.0,34,1000,700,300,0.7,13,7,6,383.2073837796616,0.3567104872251931,0.03143875966890164,0.23699860791561847,133379.97626133796,3422.4383503401486,136802.4146116781,2028,20,692.5882352941177,34,0,20,31.859849794475807,0.6583946078431373,41.75595238095239,1032.9761904761913,30.38165266106445,0
3690,4,0,0,34,0.0,0.0,1.0,34,750,500,250,0.6666666666666666,10,5,5,383.2073837796616,0.3567104872251931,0.03143875966890164,0.23699860791561847,133379.97626133796,3422.4383503401486,136802.4146116781,2029,21,693.5882352941177,34,0,20,31.859849794475807,0.6583946078431373,41.75595238095239,1032.9761904761913,30.38165266106445,0
3691,4,0,0,34,0.0,0.0,1.0,34,1050,600,450,0.5714285714285714,15,6,9,373.0436760849246,0.3565805109922757,0.047421966288597295,0.22643885811162198,132681.93310565664,3118.1123092619637,135800.0454149186,2030,22,694.5882352941177,33,1,18,32.82420899250625,0.6537247474747474,42.4325980392157,1030.2696078431386,31.220291146761777,5
3692,4,0,0,34,0.0,0.0,1.0,34,1000,800,200,0.8,12,8,4,387.75429925616817,0.3565805109922757,0.08742193522834163,0.21864084792634234,129856.32216274989,3283.539083525563,133139.86124627545,2031,23,695.5882352941177,33,1,19,35.30958178028936,0.6253156565656566,45.189950980392155,1019.2401960784313,30.886066547831252,6
3693,4,0,0,34,0.0,0.0,1.0,34,750,400,350,0.5333333333333333,11,4,7,383.6363813835124,0.35630199049316696,0.08433351711268555,0.21718516774650265,130012.50270328719,3175.505214340642,133188.00791762784,2032,24,696.5882352941177,33,1,19,35.25544740847554,0.6268939393939394,45.036764705882355,1019.8529411764705,30.904634581105167,0
3694,4,0,0,34,0.0,0.0,1.0,34,1000,800,200,0.8,12,8,4,383.18404891377867,0.35602346999405826,0.08531708178767006,0.21745107070260433,130106.2560823961,3170.928398933089,133277.1844813292,2033,25,697.5882352941177,33,1,19,35.171546546546544,0.6278409090909092,44.944852941176464,1020.2205882352933,30.915775401069496,0
3695,4,0,0,34,0.0,0.0,1.0,34,650,600,50,0.9230769230769231,7,6,1,422.0194645978122,0.35607917409388,0.10924315790268846,0.22996959907789846,128507.33651055246,4057.940858623169,132565.27736917563,2034,26,698.5882352941177,31,3,16,35.81944801164334,0.6165994623655913,46.51692708333334,1013.932291666668,32.70749327956994,3
3696,4,1,1,34,0.02857142857142857,0.02857142857142857,0.9714285714285714,35,1150,1000,150,0.8695652173913043,13,10,3,413.85306588089213,0.3628501400560224,0.09942245837257668,0.22709657314788365,128784.53290799426,3659.574756402429,132444.1076643967,2035,0,679.6,32,3,16,35.7419040510843,0.6168619791666665,46.24368686868688,1015.025252525254,31.719539141414188,0
3697,4,1,0,35,0.02857142857142857,0.0,1.0,35,850,500,350,0.5882352941176471,12,5,7,415.05692801972674,0.3627801120448179,0.11437097032024268,0.22849437864905306,128912.72454660249,3701.2238865932195,132613.9484331957,2036,0,680.5714285714286,32,3,17,35.57985204525675,0.6181640625,46.11742424242425,1015.5303030303039,31.735321969696997,0
3698,4,1,1,35,0.027777777777777776,0.027777777777777776,0.9722222222222222,36,850,500,350,0.5882352941176471,12,5,7,403.4533727492607,0.3675429894179894,0.10154826958105656,0.22373323397913572,129201.38888888904,3225.670052800754,132427.0589416898,2037,0,662.6388888888889,32,4,18,35.57889344262295,0.62109375,45.83333333333334,1016.6666666666679,31.77083333333337,0
3699,4,0,0,35,0.0,0.0,1.0,35,500,100,400,0.2,9,1,8,411.85895385084524,0.3618347338935574,0.10840670929726492,0.227348273749231,129019.90504535142,3627.600623582761,132647.50566893417,2038,2,682.5714285714286,34,1,18,35.55117764237169,0.6145833333333333,46.01190476190476,1015.9523809523805,29.88095238095237,0
3700,4,2,2,35,0.05405405405405406,0.05405405405405406,0.9459459459459459,37,950,600,350,0.631578947368421,13,6,7,393.4960888918588,0.37271646646646645,0.10241889288132033,0.2195962044461018,129450.69204152249,2788.0508575979375,132238.74289912044,2039,0,646.6216216216217,33,4,14,35.57723185613358,0.6212121212121213,45.588235294117645,1017.6470588235294,30.83778966131907,0
3701,4,0,0,35,0.0,0.0,1.0,35,650,500,150,0.7692307692307693,8,5,3,412.792745472288,0.3620098039215686,0.11286651492837052,0.22821236239322876,129080.38548752842,3656.6893424036357,132737.07482993204,2040,4,684.5714285714286,34,1,18,35.465479537644484,0.6151960784313726,45.952380952380956,1016.1904761904768,29.887955182072847,0
3702,4,1,0,36,0.027777777777777776,0.0,1.0,36,800,600,200,0.75,10,6,4,400.52970395015865,0.36903108465608464,0.10945644080416961,0.22319974788591831,129394.01113406805,3165.399062517577,132559.4101965856,2041,0,666.5277777777778,32,4,19,35.45622362869197,0.623046875,45.6439393939394,1017.4242424242432,31.7945075757576,0
3703,4,1,1,36,0.02702702702702703,0.02702702702702703,0.972972972972973,37,1050,800,250,0.7619047619047619,13,8,5,394.53912702099984,0.3730605605605606,0.1154832688278713,0.21639556622436595,128765.68657487526,2760.620314302213,131526.30688917747,2042,0,649.4864864864865,33,4,15,36.251308057635015,0.6142676767676767,46.262254901960794,1014.9509803921586,30.756090314913898,1
3704,4,0,0,36,0.0,0.0,1.0,36,450,400,50,0.8888888888888888,5,4,1,402.45563290311964,0.3663194444444444,0.1201802418434863,0.22022010474586448,128672.4175347223,3156.9878472222335,131829.40538194455,2043,1,668.5,33,3,17,36.14604722792608,0.6133207070707071,46.35416666666667,1014.583333333334,30.744949494949516,0
3705,4,1,2,35,0.02702702702702703,0.05405405405405406,0.9459459459459459,37,600,300,300,0.5,9,3,6,390.5205588268676,0.36890015015015015,0.11602834812306106,0.21507623546494584,128929.21095521556,2669.9015022675862,131599.11245748313,2044,0,651.4054054054054,34,3,17,36.185919978119,0.6136642156862744,46.10119047619048,1015.5952380952392,29.87044817927174,0
3706,4,2,1,36,0.05405405405405406,0.02702702702702703,0.972972972972973,37,650,400,250,0.6153846153846154,9,4,5,383.7161908383237,0.3798173173173173,0.11611400652496529,0.21295126614360785,129231.6485969388,2517.6551870748362,131749.30378401364,2045,0,640.7567567567568,34,3,20,36.04964289895797,0.6167279411764706,45.80357142857143,1016.7857142857146,29.905462184873958,0
3707,4,1,1,36,0.02702702702702703,0.02702702702702703,0.972972972972973,37,950,700,250,0.7368421052631579,12,7,5,375.17769897524505,0.3843531031031031,0.10439465853478613,0.20929964018974337,129436.83556241433,2312.3628257887603,131749.19838820308,2046,0,622.7027027027027,35,2,15,36.057400667273285,0.6166666666666666,45.601851851851855,1017.5925925925931,29.074074074074087,0
3708,4,1,1,36,0.02702702702702703,0.02702702702702703,0.972972972972973,37,450,400,50,0.8888888888888888,5,4,1,380.34647333563044,0.3838213213213213,0.09898640965277394,0.21250107284075817,129495.73072059323,2450.648898319616,131946.37961891285,2047,0,623.6756756756756,35,2,15,35.86583655522706,0.6172619047619048,45.54398148148148,1017.8240740740737,29.08068783068782,0
3709,4,1,2,35,0.02702702702702703,0.05405405405405406,0.9459459459459459,37,850,700,150,0.8235294117647058,10,7,3,376.181818181818,0.38544794794794796,0.10002457002456988,0.2111224489795919,129672.4965706448,2356.0871056241513,132028.58367626896,2048,0,624.6486486486486,35,2,18,35.79166666666666,0.619047619047619,45.370370370370374,1018.5185185185192,29.10052910052912,0
3710,4,0,0,35,0.0,0.0,1.0,35,650,400,250,0.6153846153846154,9,4,5,392.00696762955397,0.3729341736694678,0.10519793459552473,0.2180735811880227,129326.01042868134,3139.3394367550945,132465.34986543644,2049,1,661.1714285714286,33,2,20,35.742469879518055,0.619949494949495,45.71078431372549,1017.1568627450986,30.82293523469996,0
3711,4,4,2,37,0.10256410256410256,0.05128205128205128,0.9487179487179487,39,1000,600,400,0.6,14,6,8,363.4516722195247,0.3939496176338282,0.09114850197789592,0.2067853401601063,130206.62607725472,1664.7631963681347,131871.38927362286,2050,0,594.2564102564103,37,2,20,35.572894284486466,0.6204954954954953,44.846491228070185,1020.6140350877208,27.58416311047894,0
3712,4,0,0,37,0.0,0.0,1.0,37,750,400,350,0.5333333333333333,11,4,7,380.9832843127534,0.3836961961961962,0.10843938933826536,0.21559689904172594,129996.88042534732,2505.3276909722294,132502.20811631955,2051,1,627.3783783783783,35,2,20,35.33899387129723,0.6223214285714285,45.052083333333336,1019.7916666666674,29.136904761904784,0
3713,4,2,1,38,0.05128205128205128,0.02564102564102564,0.9743589743589743,39,1000,800,200,0.8,12,8,4,362.29530844185734,0.3940901934322987,0.10520523825244887,0.2079182435146622,130542.57079101277,1658.992189904603,132201.56298091737,2052,0,596.1538461538462,37,2,16,35.26153433476394,0.6238738738738738,44.51754385964913,1021.9298245614046,27.61972498814607,0
3714,4,1,0,39,0.02564102564102564,0.0,1.0,39,1100,800,300,0.7272727272727273,14,8,6,366.4084491812056,0.39319050832208724,0.13212094232349325,0.21196263107934457,130850.90033712289,1788.9750932979332,132639.87543042083,2053,0,597.1282051282051,37,2,18,34.84386721680421,0.6269707207207207,44.21600877192982,1023.1359649122801,27.65232337600757,0
3715,4,1,2,38,0.025,0.05,0.95,40,1150,700,450,0.6086956521739131,16,7,9,365.2004276569092,0.3988114316239317,0.13669203502919114,0.21359771354177262,131273.37643363266,1588.2186427058032,132861.59507633845,2054,0,583.175,38,2,19,34.44710870169587,0.6293859649122808,43.80341880341879,1024.7863247863233,26.968061178587458,0
3716,4,0,0,38,0.0,0.0,1.0,38,1150,1000,150,0.8695652173913043,13,10,3,377.5226649462164,0.39033605974395447,0.13092495919808322,0.21979456562233624,131097.37059694828,2298.4457430403345,133395.8163399886,2055,1,614.6052631578947,36,2,19,34.30970969870245,0.6313657407407407,43.97522522522522,1024.099099099099,28.447197197197195,0
3717,4,2,1,39,0.05,0.025,0.975,40,900,900,0,1.0,9,9,0,358.8788453314694,0.39479166666666665,0.12050507749866401,0.21128455620364342,131524.88175448202,1440.5024448896143,132965.38419937162,2056,0,584.825,37,3,20,34.35495724211649,0.6337274774774775,43.55811403508771,1025.7675438596482,27.723447131341842,0
3718,4,0,0,39,0.0,0.0,1.0,39,1350,1100,250,0.8148148148148148,16,11,5,368.68361020740986,0.3918972109761583,0.1301783809194066,0.2170872013819843,131530.20154867708,1898.6059116549063,133428.807460332,2057,1,600.8205128205128,36,3,22,34.09814469206281,0.6357060185185185,43.55292792792793,1025.7882882882886,28.49411911911913,0
3719,4,1,1,39,0.025,0.025,0.975,40,1000,600,400,0.6,14,6,8,353.7418489748085,0.39508547008547007,0.11839878838521023,0.20426564910041084,130781.15297866885,1252.5533731463074,132033.70635181514,2058,0,586.775,38,2,15,35.238449620499985,0.624451754385965,44.28418803418803,1022.8632478632466,26.917453891138067,3
3720,4,0,0,39,0.0,0.0,1.0,39,950,600,350,0.631578947368421,13,6,7,358.8184304287579,0.39361223571749887,0.12307032590051481,0.20711994548511453,130766.77439212055,1584.3057479224262,132351.080140043,2059,1,602.7692307692307,37,2,16,35.123195397369926,0.6261261261261262,44.29824561403508,1022.8070175438588,27.64343290659078,0
3721,4,1,0,40,0.025,0.0,1.0,40,1100,700,400,0.6363636363636364,15,7,8,350.50452141146087,0.3960336538461538,0.13135756753937677,0.20427275664265465,131136.55495516444,1192.7910868215085,132329.34604198593,2060,0,588.675,38,2,17,34.96184068704148,0.6280153508771931,43.9369658119658,1024.2521367521344,26.954003598740382,0
3722,4,0,1,39,0.0,0.025,0.975,40,800,500,300,0.625,11,5,6,350.9712391651193,0.3953659188034188,0.13466531122927772,0.20512889426158762,131246.00643080182,1212.714702498326,132458.72113330013,2061,1,589.675,38,2,17,34.83930247106662,0.6291118421052633,43.83012820512819,1024.6794871794848,26.96524966261802,0
3723,4,0,0,39,0.0,0.0,1.0,39,600,400,200,0.6666666666666666,8,4,4,356.18315885318185,0.3913630229419703,0.14239524836827333,0.2077068083649451,131159.59357686958,1543.367670821765,132702.96124769133,2062,2,605.1538461538462,37,2,17,34.79313851423677,0.6300675675675678,43.91447368421051,1024.342105263156,27.684921763869085,0
3724,4,0,0,39,0.0,0.0,1.0,39,1100,800,300,0.7272727272727273,14,8,6,361.34613983495586,0.3915035987404409,0.15121236563564833,0.21133548328519994,131271.9358360263,1686.9214566020123,132958.85729262832,2063,3,606.1538461538462,37,2,18,34.54731079249589,0.6311936936936938,43.8048245614035,1024.7807017543846,27.696775723091477,0
3725,4,1,1,39,0.025,0.025,0.975,40,1050,700,350,0.6666666666666666,14,7,7,351.9018712408109,0.3944177350427351,0.15043898156277447,0.2076768038048101,131616.85333982625,1263.2674412827078,132880.12078110897,2064,0,591.975,36,4,15,34.44107587064676,0.6365740740740742,43.468468468468465,1026.1261261261257,28.50350350350349,0
3726,4,2,2,39,0.04878048780487805,0.04878048780487805,0.9512195121951219,41,850,600,250,0.7058823529411765,11,6,5,343.6020728668412,0.3981707317073171,0.14509174980733586,0.2042426534655182,131890.67790089254,863.5820637119089,132754.25996460445,2065,0,578.4878048780488,37,4,15,34.37811343580985,0.6373873873873874,43.20175438596491,1027.19298245614,27.761972498814597,0
3727,4,0,1,38,0.0,0.02564102564102564,0.9743589743589743,39,950,500,450,0.5263157894736842,14,5,9,353.76046958171736,0.3911381016644175,0.10457383508902729,0.20442494310943476,130809.2129291451,1455.0257182858263,132264.23864743093,2066,6,609.1538461538462,36,3,17,35.20957177454867,0.6284722222222223,44.256756756756744,1022.9729729729709,28.415915915915857,5
3728,4,1,0,39,0.02564102564102564,0.0,1.0,39,1050,600,450,0.5714285714285714,15,6,9,351.4162929153369,0.3900134952766532,0.12067891051724766,0.20444199305688782,131068.54056336732,1411.9241285203975,132480.46469188773,2067,0,609.8205128205128,36,3,19,35.00724000146632,0.6310763888888891,44.00337837837837,1023.9864864864858,28.444069069069048,0
3729,4,0,0,39,0.0,0.0,1.0,39,850,500,350,0.5882352941176471,12,5,7,352.30335463939525,0.39023841655420605,0.12682651781057497,0.20526579182865462,131126.20380092924,1439.240296039273,132565.4440969685,2068,1,610.8205128205128,36,3,19,34.926241524647246,0.6316550925925927,43.94707207207207,1024.2117117117111,28.45032532532531,0
3730,4,2,2,39,0.04878048780487805,0.04878048780487805,0.9512195121951219,41,950,800,150,0.8421052631578947,11,8,3,339.56809610600664,0.3985264227642276,0.12272833473857458,0.20032014711314974,131602.0390459489,737.570768500211,132339.60981444913,2069,0,581.9756097560976,38,3,16,34.77240385950299,0.6326754385964914,43.48290598290596,1026.0683760683728,27.001799370220336,0
3731,4,0,0,39,0.0,0.0,1.0,39,850,600,250,0.7058823529411765,11,6,5,352.96450525480867,0.3900134952766532,0.12737127371273682,0.2067363530778164,131328.12499999988,1470.8333333333183,132798.9583333332,2070,3,612.8205128205128,36,3,19,34.705284552845534,0.6336805555555557,43.74999999999999,1024.999999999999,28.472222222222197,0
3732,4,1,0,40,0.025,0.0,1.0,40,700,500,200,0.7142857142857143,9,5,4,347.50675828151725,0.39284188034188033,0.12357759123236534,0.19830774888759645,130323.35778061225,1083.6911848072507,131407.0489654195,2071,0,598.475,34,6,21,35.861412304224466,0.6277573529411764,44.732142857142854,1021.0714285714287,30.03151260504202,4
3733,4,0,1,39,0.0,0.025,0.975,40,800,500,300,0.625,11,5,6,345.6689003202018,0.3925747863247863,0.1216345609065157,0.19770110468734792,130410.31867551856,1015.758289394704,131426.07696491326,2072,1,599.475,35,5,21,35.820231350330495,0.6264880952380952,44.64699074074073,1021.412037037036,29.18320105820103,0
3734,4,1,1,39,0.025,0.025,0.975,40,1100,700,400,0.6363636363636364,15,7,8,348.6024715609126,0.3925480769230769,0.12887403715450807,0.1998352349960868,130498.99798525377,1098.4546467764026,131597.45263203018,2073,0,600.325,35,5,15,35.65549010723456,0.6273809523809524,44.56018518518518,1021.7592592592592,29.193121693121693,0
3735,4,1,0,40,0.025,0.0,1.0,40,850,800,50,0.9411764705882353,9,8,1,346.24482230824907,0.39210737179487176,0.13671477079796301,0.1995481412324449,130706.03358892749,1051.2574749228477,131757.29106385034,2074,0,601.3,35,5,16,35.50615449915111,0.6294642857142856,44.35763888888889,1022.5694444444446,29.216269841269845,0
3736,4,0,1,39,0.0,0.025,0.975,40,800,700,100,0.875,9,7,2,347.2416178292202,0.3927483974358974,0.13630474142808668,0.20042940409907367,130765.2167593664,1081.4250846622094,131846.6418440286,2075,1,602.3,35,5,17,35.420792312624954,0.6300595238095238,44.29976851851852,1022.8009259259259,29.222883597883595,0
3737,4,0,0,39,0.0,0.0,1.0,39,1000,500,500,0.5,15,5,10,357.60435429555963,0.3902665317139002,0.14807184741977508,0.20583821680229664,130657.85147392287,1544.763321995465,132202.61479591834,2076,2,618.6410256410256,34,5,17,35.264564896755175,0.6311274509803921,44.404761904761905,1022.3809523809521,30.07002801120447,0
3738,4,0,0,39,0.0,0.0,1.0,39,1000,700,300,0.7,13,7,6,357.4966695171714,0.39046333783175885,0.1468314378675264,0.2061004289364096,130718.71456916099,1546.301020408162,132265.01558956914,2077,3,619.6410256410256,34,5,17,35.205665502522315,0.6317401960784315,44.345238095238095,1022.6190476190476,30.077030812324928,0
3739,4,0,0,39,0.0,0.0,1.0,39,1200,1000,200,0.8333333333333334,14,10,4,357.1645013333635,0.38998538011695905,0.1560480478330144,0.2065593354279223,130840.48327664392,1546.3151927437605,132386.7984693877,2078,4,620.6410256410256,34,5,18,35.09085796291986,0.6329656862745099,44.226190476190474,1023.0952380952376,30.091036414565814,0
3740,4,1,1,39,0.025,0.025,0.975,40,1500,1200,300,0.8,18,12,6,350.421131838116,0.39549946581196577,0.15440206638821752,0.2046297469488562,131212.72243527314,1195.9421414657954,132408.66457673893,2079,0,606.1,36,4,19,34.88701729317799,0.6325231481481481,43.862612612612615,1024.5495495495497,28.459709709709713,0
3741,4,1,1,39,0.025,0.025,0.975,40,950,700,250,0.7368421052631579,12,7,5,350.1115519821562,0.3933360042735043,0.15277716734424818,0.20491094756203249,131299.26960321816,1193.878210981256,132493.14781419942,2080,0,607.075,36,4,20,34.80753030802474,0.6333912037037037,43.778153153153156,1024.887387387388,28.469094094094107,0
3742,4,0,0,39,0.0,0.0,1.0,39,1200,900,300,0.75,15,9,6,357.43627974607796,0.3899291497975708,0.15983128083455678,0.20854769360794587,131179.87403817312,1577.6892307527532,132757.56326892588,2081,7,623.6410256410256,35,4,20,34.74054249990584,0.6342261904761903,43.89467592592593,1024.4212962962972,29.26917989417992,0
3743,4,1,1,39,0.025,0.025,0.975,40,1250,900,350,0.72,16,9,7,347.0685163623945,0.3931490384615384,0.15183711479851025,0.20375612898969214,131417.11576485346,1122.2324031207236,132539.34816797418,2082,0,609.025,35,5,20,34.76655096512022,0.6366071428571427,43.66319444444445,1025.3472222222229,29.29563492063494,0
3744,4,0,0,39,0.0,0.0,1.0,39,1050,800,250,0.7619047619047619,13,8,5,356.9984140515594,0.38961988304093564,0.16841309118628844,0.20926571432253102,131358.63272392302,1578.9647108843665,132937.5974348074,2083,9,625.6410256410256,34,5,20,34.57109123988696,0.638174019607843,43.7202380952381,1025.1190476190484,30.15056022408966,0
3745,4,0,0,39,0.0,0.0,1.0,39,800,300,500,0.375,13,3,10,358.8235908363474,0.3893949617633828,0.16497760316680754,0.21100786587407083,131480.69905045378,1635.6753117914086,133116.3743622452,2084,10,626.6410256410256,34,5,20,34.40099632424065,0.6393995098039214,43.60119047619049,1025.5952380952401,30.16456582633059,0
3746,4,0,0,39,0.0,0.0,1.0,39,1000,700,300,0.7,13,7,6,361.4590791393239,0.3893106162843005,0.17276459039800107,0.21340940151924495,131633.36167800473,1716.0147392290473,133349.37641723378,2085,11,627.6410256410256,34,5,18,34.179234338747115,0.6409313725490196,43.45238095238096,1026.1904761904777,30.182072829131698,0
3747,4,0,0,39,0.0,0.0,1.0,39,950,700,250,0.7368421052631579,12,7,5,360.6805566761012,0.3895355375618534,0.17102144830313692,0.2134624873176406,131725.00177154213,1702.1293934240566,133427.13116496618,2086,12,628.6410256410256,34,5,18,34.106701070779685,0.6418504901960783,43.36309523809525,1026.5476190476204,30.192577030812366,0
3748,4,0,1,38,0.0,0.02564102564102564,0.9743589743589743,39,1650,1300,350,0.7878787878787878,20,13,7,359.6306104328952,0.39009784075573545,0.1604911855259561,0.2136978585960759,131877.8061224491,1685.4591836734867,133563.2653061226,2087,13,629.6410256410256,34,5,18,33.97948539638385,0.6433823529411763,43.21428571428572,1027.1428571428582,30.210084033613477,0
3749,4,0,0,38,0.0,0.0,1.0,38,700,500,200,0.7142857142857143,9,5,4,360.7225864664076,0.3893729255571361,0.15932792584009237,0.21469213249690347,131938.95266439923,1918.6720521542104,133857.62471655343,2088,14,637.1578947368421,34,4,19,33.88977404403245,0.6439950980392156,43.15476190476191,1027.3809523809534,30.217086834733923,0
3750,4,0,0,38,0.0,0.0,1.0,38,1000,800,200,0.8,12,8,4,360.2724525008617,0.38885431484115696,0.16004943657713921,0.21483271361686723,132011.1577958892,1911.9967153206592,133923.15451120984,2089,15,638.1578947368421,35,3,20,33.828532680106626,0.6425595238095237,43.08449074074075,1027.662037037038,29.361772486772516,0
3751,4,0,0,38,0.0,0.0,1.0,38,900,700,200,0.7777777777777778,11,7,4,360.98247477079565,0.3881282598387861,0.15742661088659493,0.21576354918668975,132100.37964034645,1937.1843921467878,134037.56403249325,2090,16,639.1578947368421,35,3,20,33.720352022817686,0.6434523809523809,42.99768518518519,1028.00925925926,29.371693121693145,0
3752,4,0,0,38,0.0,0.0,1.0,38,850,400,450,0.47058823529411764,13,4,9,360.9504172143969,0.3876985538169749,0.15480555637828397,0.21625384065744535,132189.63162562152,1942.7805373370995,134132.41216295862,2091,17,640.1578947368421,35,3,21,33.631237103732865,0.6443452380952381,42.910879629629626,1028.356481481481,29.381613756613746,0
3753,4,0,0,38,0.0,0.0,1.0,38,1400,1000,400,0.7142857142857143,18,10,8,363.20880402189516,0.3869873162636321,0.15615763546798034,0.21814019886522107,132282.1316882762,2009.2069687931282,134291.3386570693,2092,18,641.1578947368421,36,2,21,33.47997628170042,0.6432291666666665,42.82094594594595,1028.7162162162167,28.575450450450465,0
3754,4,1,1,38,0.02564102564102564,0.02564102564102564,0.9743589743589743,39,700,400,300,0.5714285714285714,10,4,6,355.3596467625616,0.3907726045883941,0.15504230784487838,0.214981073559813,132555.70461180786,1621.1925790512032,134176.89719085908,2093,0,625.6923076923077,33,6,23,33.40659585862191,0.6524621212121213,42.55514705882352,1029.7794117647052,31.205436720142583,0
3755,4,0,0,38,0.0,0.0,1.0,38,750,600,150,0.8,9,6,3,356.125421442792,0.3903064248458985,0.15168989568854352,0.21598775560231653,132650.37035034588,1848.033809111862,134498.40415945774,2094,1,622.7105263157895,33,5,18,33.29169640732809,0.653409090909091,42.46323529411764,1030.1470588235281,31.216577540106915,0
3756,4,0,1,37,0.0,0.02631578947368421,0.9736842105263158,38,750,400,350,0.5333333333333333,11,4,7,356.35228431132765,0.38989153627311524,0.15704987796482883,0.21685403119090174,132776.64389898098,1863.052071318701,134639.69597029968,2095,2,623.7105263157895,33,5,19,33.15893777249306,0.6546717171717172,42.34068627450979,1030.6372549019593,31.23143196672604,0
3757,4,0,0,37,0.0,0.0,1.0,37,1100,700,400,0.6363636363636364,15,7,8,367.29719222895034,0.3853853853853854,0.1666672187569358,0.22280875772461,132658.02158261903,2344.983770788687,135003.0053534077,2096,22,641.5135135135135,32,5,19,32.996282224128784,0.6559244791666667,42.455808080808076,1030.176767676767,32.19302398989897,0
3758,4,0,0,37,0.0,0.0,1.0,37,800,600,200,0.75,10,6,4,368.18321733273314,0.38488488488488487,0.16913495634554088,0.22412226719516035,132788.1262913223,2378.0719123048643,135166.19820362717,2097,23,642.5135135135135,32,5,19,32.84255175793213,0.6572265625,42.32954545454545,1030.681818181818,32.20880681818181,0
3759,4,0,0,37,0.0,0.0,1.0,37,1450,1300,150,0.896551724137931,16,13,3,370.78076640064,0.38497872872872874,0.17322318644875567,0.22629265608577176,132885.74667125806,2454.295798898071,135340.04247015613,2098,24,643.5135135135135,32,5,19,32.67741244183197,0.658203125,42.234848484848484,1031.0606060606062,32.220643939393945,0
3760,4,0,0,37,0.0,0.0,1.0,37,950,600,350,0.631578947368421,13,6,7,370.0711172768392,0.38513513513513514,0.17634060008601038,0.2266477532347657,133015.96297571668,2445.073206815624,135461.03618253232,2099,25,644.5135135135135,32,5,19,32.56476948184415,0.6595052083333334,42.108585858585855,1031.565656565656,32.23642676767675,0
3761,4,0,0,37,0.0,0.0,1.0,37,1150,900,250,0.782608695652174,14,9,5,370.4967976838012,0.3852915415415415,0.17399591209397713,0.2279543116793759,133187.44781153876,2469.104581170695,135656.55239270945,2100,26,645.5135135135135,33,4,19,32.381450591634035,0.6587752525252526,41.94240196078431,1032.230392156862,31.279708853238244,0
3762,4,0,0,37,0.0,0.0,1.0,37,700,300,400,0.42857142857142855,11,3,8,370.23396274741657,0.3854166666666667,0.17280100613433969,0.2279861770602511,133219.0743944636,2464.4451653210203,135683.51955978462,2101,27,646.5135135135135,33,4,20,32.35646169673948,0.6590909090909092,41.91176470588235,1032.3529411764698,31.283422459893025,0
3763,4,0,0,37,0.0,0.0,1.0,37,1000,800,200,0.8,12,8,4,369.9133138032031,0.3855730730730731,0.17198960546896935,0.22820967880006993,133287.76218820864,2460.9835600907036,135748.74574829935,2102,28,647.5135135135135,34,3,20,32.29574975021135,0.6574754901960784,41.845238095238095,1032.6190476190477,30.371148459383758,0
3764,4,0,0,37,0.0,0.0,1.0,37,1200,900,300,0.75,15,9,6,371.3040129642945,0.3854166666666667,0.17531600041105788,0.23001766798837323,133441.47002551006,2509.470663265288,135950.94068877536,2103,29,648.5135135135135,34,3,21,32.10551330798479,0.6590073529411765,41.69642857142856,1033.2142857142846,30.388655462184843,0
3765,4,0,0,37,0.0,0.0,1.0,37,900,700,200,0.7777777777777778,11,7,4,376.51270767444925,0.38522897897897895,0.18437485104151796,0.23386211842877766,133539.5050048828,2655.874751430521,136195.37975631334,2104,30,649.5135135135135,31,6,21,31.872532963802808,0.6673387096774194,41.6015625,1033.59375,33.341733870967744,0
3766,4,0,0,37,0.0,0.0,1.0,37,1050,500,550,0.47619047619047616,16,5,11,380.2668417612085,0.3847597597597598,0.18160474461620146,0.2372709759708781,133707.78613620327,2768.927510579418,136476.71364678268,2105,31,650.5135135135135,31,6,19,31.606577069956767,0.6690188172043011,41.43880208333333,1034.244791666666,33.362735215053746,0
3767,4,0,0,37,0.0,0.0,1.0,37,550,400,150,0.7272727272727273,7,4,3,386.2368859851563,0.3845095095095095,0.16158012823521717,0.23118004048882812,132153.07716836708,2808.4785997732106,134961.5557681403,2106,32,651.5135135135135,34,3,20,33.01807147543513,0.646139705882353,42.946428571428555,1028.2142857142835,30.2415966386554,4
3768,4,0,1,36,0.0,0.02702702702702703,0.972972972972973,37,800,400,400,0.5,12,4,8,386.0989159221955,0.3847284784784785,0.164083975965164,0.23186805167003174,132278.91375171448,2814.549039780497,135093.46279149497,2107,33,652.5135135135135,35,2,21,32.89453945394539,0.6452380952380954,42.82407407407406,1028.703703703702,29.391534391534346,0
3769,4,0,0,36,0.0,0.0,1.0,36,750,400,350,0.5333333333333333,11,4,7,384.43265457959524,0.3837301587301587,0.15794900637420373,0.2312318199737888,132338.45191400874,2975.044474451287,135313.49638846001,2108,34,655.8611111111111,35,1,21,32.877296587926516,0.6458333333333335,42.766203703703695,1028.9351851851839,29.39814814814811,0
3770,4,1,1,36,0.02702702702702703,0.02702702702702703,0.972972972972973,37,900,700,200,0.7777777777777778,11,7,4,374.38488111426165,0.3879191691691692,0.1462727321009598,0.2266482579789695,132581.84700963701,2527.354597960555,135109.20160759758,2109,0,639.1081081081081,34,3,21,32.89046545678725,0.6504289215686276,42.52976190476189,1029.880952380951,30.29061624649856,0
3771,4,1,1,36,0.02702702702702703,0.02702702702702703,0.972972972972973,37,600,600,0,1.0,6,6,0,376.003101406784,0.3883571071071071,0.14455227213808075,0.22799963815507343,132643.1565334466,2574.847647392275,135218.00418083888,2110,0,640.081081081081,34,3,18,32.787039177164,0.6510416666666667,42.47023809523809,1030.1190476190466,30.297619047619015,0
3772,4,0,0,36,0.0,0.0,1.0,36,1500,1300,200,0.8666666666666667,17,13,4,384.2643469431924,0.3836474867724868,0.15455230390990593,0.23305383119801387,132650.37035034588,2994.5615868896402,135644.93193723552,2111,37,658.8611111111111,33,3,18,32.5670156237608,0.653409090909091,42.46323529411764,1030.1470588235281,31.216577540106915,0
3773,4,0,0,36,0.0,0.0,1.0,36,650,600,50,0.9230769230769231,7,6,1,383.1569065194744,0.3832506613756614,0.15192892059717322,0.23316567176763928,132776.64389898095,2974.857626874256,135751.50152585522,2112,38,659.8611111111111,33,3,20,32.468291716210864,0.6546717171717172,42.34068627450979,1030.637254901959,31.23143196672603,0
3774,4,0,0,36,0.0,0.0,1.0,36,900,700,200,0.7777777777777778,11,7,4,381.6714523575231,0.3831679894179894,0.14961114961115007,0.23238477035945387,132796.49234693864,2936.9260204081447,135733.41836734678,2113,39,660.8611111111111,34,2,20,32.48657311157311,0.6525735294117647,42.32142857142856,1030.7142857142846,30.315126050420137,0
3775,4,0,0,36,0.0,0.0,1.0,36,1000,800,200,0.8,12,8,4,380.4436571667438,0.3839451058201058,0.14448228970224175,0.23220736537851747,132888.53635204062,2911.320153061204,135799.85650510184,2114,40,661.8611111111111,34,2,20,32.42552822999654,0.6534926470588236,42.23214285714285,1031.071428571427,30.325630252100797,0
3776,4,0,0,36,0.0,0.0,1.0,36,600,400,200,0.6666666666666666,8,4,4,376.06437475714154,0.3835813492063492,0.14228697826505154,0.23028959768697024,133011.3112953514,2804.1631235827585,135815.47441893414,2115,41,662.8611111111111,34,2,21,32.41488747836124,0.654718137254902,42.113095238095234,1031.5476190476184,30.339635854341715,0
3777,4,0,0,36,0.0,0.0,1.0,36,1000,800,200,0.8,12,8,4,375.12482712110204,0.3830853174603175,0.14567708934271795,0.23009248950166944,133072.7200255101,2783.776218820852,135856.49624433095,2116,42,663.8611111111111,34,2,21,32.377360486135146,0.6553308823529412,42.05357142857142,1031.7857142857135,30.34663865546216,0
3778,4,0,0,36,0.0,0.0,1.0,36,850,700,150,0.8235294117647058,10,7,3,374.14778383645324,0.3836805555555556,0.14704694889837389,0.2298715193535229,133134.1429280043,2762.368905895665,135896.51183389995,2117,43,664.8611111111111,34,2,22,32.34081208905294,0.6559436274509804,41.994047619047606,1032.0238095238076,30.353641456582576,0
3779,4,0,0,36,0.0,0.0,1.0,36,950,800,150,0.8421052631578947,11,8,3,365.2639444484926,0.3838458994708995,0.1638995077830252,0.22039738954714344,132457.56842635464,2524.0705200547422,134981.6389464094,2118,44,665.8611111111111,35,1,19,33.25041226294883,0.6470238095238094,42.65046296296297,1029.3981481481487,29.41137566137568,8
3780,4,0,0,36,0.0,0.0,1.0,36,700,500,200,0.7142857142857143,9,5,4,365.2639444484926,0.3838458994708995,0.1638995077830252,0.22039738954714344,132457.56842635464,2476.394783093291,134933.96320944795,2119,45,666.8611111111111,35,1,19,33.25041226294883,0.6470238095238094,42.65046296296297,1029.3981481481487,29.41137566137568,0
3781,4,0,0,36,0.0,0.0,1.0,36,1050,700,350,0.6666666666666666,14,7,7,365.3616092827119,0.38270502645502646,0.15760509919966026,0.22133103887044614,132606.53941883147,2489.8677286951324,135096.4071475266,2120,46,667.8611111111111,35,1,20,33.09793703412369,0.6485119047619048,42.50578703703704,1029.9768518518522,29.42791005291006,0
3782,4,0,0,36,0.0,0.0,1.0,36,750,500,250,0.6666666666666666,10,5,5,363.78235071329397,0.38255621693121694,0.15526841448189832,0.22054924532345477,132636.3436642661,2450.15217764061,135086.49584190673,2121,47,668.8611111111111,35,1,18,33.10861423220976,0.6488095238095237,42.476851851851855,1030.0925925925926,29.43121693121693,0
3783,4,0,0,36,0.0,0.0,1.0,36,950,500,450,0.5263157894736842,14,5,9,365.2356381430919,0.38144841269841273,0.15392413750077982,0.2223119178171041,132785.41512613595,2499.593165937925,135285.00829207388,2122,48,669.8611111111111,35,1,18,32.92122871046228,0.6502976190476191,42.332175925925924,1030.671296296296,29.447751322751316,0
3784,4,0,0,36,0.0,0.0,1.0,36,1500,1200,300,0.8,18,12,6,367.51495553979214,0.38125000000000003,0.15599154223270117,0.22405583223770886,132845.0671537422,2564.509789737643,135409.57694347983,2123,49,670.8611111111111,35,1,18,32.80250084203435,0.6508928571428572,42.27430555555555,1030.902777777777,29.454365079365054,0
3785,4,0,0,36,0.0,0.0,1.0,36,450,200,250,0.4444444444444444,7,2,5,369.3441198169593,0.380026455026455,0.15473696679509708,0.22589055948448333,132964.41139671206,2621.924698859729,135586.33609557178,2124,50,671.8611111111111,35,1,18,32.63534302173345,0.6520833333333333,42.15856481481481,1031.3657407407402,29.467592592592577,0
3786,4,0,0,36,0.0,0.0,1.0,36,350,200,150,0.5714285714285714,5,2,3,378.81037163681316,0.37996031746031744,0.06884451688852655,0.21821611549219244,130688.28125000003,2711.590417095337,133399.87166709537,2125,51,672.8611111111111,34,2,16,34.69165987503395,0.6314338235294117,44.375,1022.5000000000002,30.073529411764714,7
3787,4,0,0,36,0.0,0.0,1.0,36,900,700,200,0.7777777777777778,11,7,4,378.3413547331391,0.3801256613756614,0.06907422496411009,0.21828949486315638,130749.15143140587,2693.5622165532873,133442.71364795917,2126,52,673.8611111111111,34,2,16,34.641873278236915,0.632046568627451,44.31547619047619,1022.7380952380951,30.08053221288515,0
3788,4,0,0,36,0.0,0.0,1.0,36,750,500,250,0.6666666666666666,10,5,5,375.6293230265981,0.37838955026455023,0.07247430676750022,0.21740969908509183,130870.9343112246,2631.792091836746,133502.72640306136,2127,53,674.8611111111111,34,2,16,34.58769633507853,0.6332720588235293,44.19642857142858,1023.2142857142866,30.094537815126074,0
3789,4,1,1,36,0.02702702702702703,0.02702702702702703,0.972972972972973,37,650,600,50,0.9230769230769231,7,6,1,368.0892321677911,0.38319569569569567,0.06593030643663611,0.21426667935661947,131090.963648834,2250.6344307270233,133341.59807956102,2128,0,657.5945945945946,35,2,16,34.55771549125979,0.6333333333333333,43.98148148148148,1024.074074074074,29.259259259259256,0
3790,4,1,1,36,0.02702702702702703,0.02702702702702703,0.972972972972973,37,800,600,200,0.75,10,6,4,367.3622180264766,0.3839777277277277,0.0585611031888289,0.2143390238465619,131179.87403817297,2238.105897419406,133417.9799355924,2129,0,658.5675675675676,35,2,16,34.486333935901776,0.6342261904761906,43.894675925925924,1024.421296296296,29.26917989417989,0
3791,4,0,0,36,0.0,0.0,1.0,36,1300,1000,300,0.7692307692307693,16,10,6,374.57643418548236,0.3789021164021164,0.06231109044408312,0.218004498434609,131084.19075963725,2620.2097505669,133704.40051020414,2130,56,677.8611111111111,34,2,17,34.398492598620486,0.6354166666666666,43.98809523809524,1024.0476190476195,30.11904761904763,0
3792,4,0,0,36,0.0,0.0,1.0,36,850,700,150,0.8235294117647058,10,7,3,371.2195372897918,0.37901785714285713,0.05577178782128267,0.21691015325548113,131236.62308673467,2543.519699546489,133780.14278628115,2131,57,678.8611111111111,34,2,17,34.330099531389195,0.6369485294117647,43.839285714285715,1024.642857142857,30.136554621848738,0
3793,4,0,0,36,0.0,0.0,1.0,36,650,300,350,0.46153846153846156,10,3,7,370.98281532869913,0.37896825396825395,0.05419377323420127,0.21694429852917413,131267.12018140592,2539.5691609977357,133806.68934240364,2132,58,679.8611111111111,34,2,18,34.305297397769515,0.6372549019607843,43.80952380952381,1024.7619047619048,30.140056022408967,0
3794,4,1,1,36,0.02702702702702703,0.02702702702702703,0.972972972972973,37,650,500,150,0.7692307692307693,8,5,3,362.79217932053473,0.3813188188188188,0.048673659552793014,0.21331794963233316,131476.4596863212,2139.726267789786,133616.185954111,2133,0,662.4594594594595,35,2,18,34.30352574953918,0.637202380952381,43.605324074074076,1025.5787037037042,29.30224867724869,0
3795,4,0,0,36,0.0,0.0,1.0,36,750,500,250,0.6666666666666666,10,5,5,374.2182089681443,0.37820767195767196,0.011970029239766422,0.20314702772556398,128355.55555555547,2409.815591778114,130765.37114733359,2134,60,681.8611111111111,34,2,17,37.1864720394737,0.607843137254902,46.666666666666664,1013.3333333333327,29.80392156862743,6
3796,4,1,1,36,0.02702702702702703,0.02702702702702703,0.972972972972973,37,750,500,250,0.6666666666666666,10,5,5,363.7364672415119,0.3862925425425425,0.013593694104876208,0.19873980043046188,128613.70991941006,1956.2992969821553,130570.00921639221,2135,0,664.4054054054054,35,2,14,37.18811805872508,0.6083333333333334,46.41203703703703,1014.3518518518512,28.981481481481463,0
3797,4,3,2,37,0.07692307692307693,0.05128205128205128,0.9487179487179487,39,1050,800,250,0.7619047619047619,13,8,5,352.7727941175529,0.3900134952766532,0.0147468394690915,0.19549053044015732,129173.5212397083,1313.7808027469862,130487.30204245528,2136,0,631.2564102564103,37,2,15,36.89540412756624,0.6100788288288288,45.86074561403508,1016.5570175438589,27.474513987671862,0
3798,4,1,1,37,0.02631578947368421,0.02631578947368421,0.9736842105263158,38,1050,900,150,0.8571428571428571,12,9,3,360.88392450905,0.38839497392128974,0.023663810689514175,0.20041708722735072,129258.63997443396,1729.4730541352244,130988.11302856918,2137,0,648.8421052631579,36,2,16,36.60252860834256,0.6128472222222222,45.77702702702703,1016.8918918918924,28.246996996997012,0
3799,4,2,2,37,0.05128205128205128,0.05128205128205128,0.9487179487179487,39,750,500,250,0.6666666666666666,10,5,5,354.31682950544445,0.38978857399910033,0.023566652027279034,0.19802065793492113,129508.13140822177,1377.3821031471198,130885.51351136889,2138,0,633.1538461538462,37,2,14,36.51556160005745,0.6134572072072071,45.531798245614034,1017.8728070175439,27.510075865339026,0
3800,4,0,0,37,0.0,0.0,1.0,37,1000,900,100,0.9,11,9,2,370.49350442618476,0.3822572572572573,0.020991626728025903,0.20576206889307588,129260.23046339172,2178.01515346366,131438.2456168554,2139,3,668.3783783783783,35,2,16,36.35660899916536,0.6148809523809522,45.77546296296297,1016.8981481481488,29.054232804232825,0
3801,4,1,0,38,0.02631578947368421,0.0,1.0,38,950,600,350,0.631578947368421,13,6,7,372.38701215807896,0.3867650545282124,0.05250650113733557,0.20938379732716872,129745.78622118762,2063.129134201796,131808.9153553894,2140,0,651.7631578947369,36,2,15,35.81366751409308,0.6177662037037036,45.298423423423436,1018.806306306308,28.300175175175223,0
3802,4,0,1,37,0.0,0.02631578947368421,0.9736842105263158,38,1050,900,150,0.8571428571428571,12,9,3,371.80891914166176,0.3864983404457089,0.054446059901133825,0.20951872467198293,129831.84831791277,2054.5278386494874,131886.37615656224,2141,1,652.7631578947369,36,2,15,35.74079189686925,0.6186342592592592,45.21396396396398,1019.1441441441463,28.309559559559617,0
3803,4,0,0,37,0.0,0.0,1.0,37,1200,1000,200,0.8333333333333334,14,10,4,381.8568841716118,0.3836336336336336,0.04576355496600937,0.21462990386197503,129731.4453125001,2507.769097222238,132239.21440972234,2142,2,671.2702702702703,35,2,15,35.58708248125427,0.6196428571428569,45.31250000000001,1018.7500000000008,29.10714285714288,0
3804,4,2,1,38,0.05128205128205128,0.02564102564102564,0.9743589743589743,39,950,600,350,0.631578947368421,13,6,7,370.95091588271515,0.3912505623031939,0.06603341531676699,0.21213901683835007,130406.32482144331,1875.9541953271134,132282.27901677042,2143,0,637.7948717948718,36,3,17,35.17870268283719,0.6244212962962962,44.650900900900915,1021.3963963963984,28.372122122122178,0
3805,4,2,1,39,0.05,0.025,0.975,40,950,700,250,0.7368421052631579,12,7,5,363.0942794097562,0.3944177350427351,0.06855495978552284,0.20913243702878206,130682.67549871137,1490.0263783087378,132172.7018770201,2144,0,622.8,37,3,17,35.09908400357463,0.6252815315315313,44.38048245614036,1022.4780701754404,27.634542437174066,0
3806,4,1,1,39,0.025,0.025,0.975,40,1200,1000,200,0.8333333333333334,14,10,4,359.44282394679664,0.3948851495726496,0.07200996677740878,0.20793310540902424,130850.90033712308,1406.683426631282,132257.58376375437,2145,0,623.775,37,3,17,35.022036759189795,0.6269707207207207,44.21600877192983,1023.1359649122817,27.65232337600761,0
3807,4,1,1,39,0.025,0.025,0.975,40,1000,500,500,0.5,15,5,10,357.271909272509,0.3930288461538462,0.07329636772741832,0.2069781954835711,130906.99932912068,1353.8787174900112,132260.87804661068,2146,0,624.75,37,3,17,35.020781992214005,0.6275337837837838,44.16118421052632,1023.3552631578962,27.658250355618815,0
3808,4,0,0,39,0.0,0.0,1.0,39,950,500,450,0.5263157894736842,14,5,9,365.22994346298515,0.38922627080521816,0.07875084860828219,0.21097400263567745,130794.81336805565,1754.0364583333392,132548.849826389,2147,3,641.7692307692307,37,2,17,34.930838424983015,0.6264076576576576,44.270833333333336,1022.9166666666674,27.646396396396415,0
3809,4,0,0,39,0.0,0.0,1.0,39,1000,800,200,0.8,12,8,4,366.9300527357861,0.3882984705353127,0.08173110386516091,0.21248222763623717,130890.45606874145,1805.5283895828895,132695.98445832432,2148,4,642.7692307692307,38,1,17,34.79044859748034,0.625548245614035,44.17735042735043,1023.2905982905993,26.92869995501577,0
3810,4,0,0,39,0.0,0.0,1.0,39,750,500,250,0.6666666666666666,10,5,5,368.36052570391655,0.38801731893837155,0.07917088129987304,0.21391700347241993,130999.80481591054,1851.0313938198497,132850.8362097304,2149,5,643.7692307692307,38,1,17,34.64308077645586,0.6266447368421053,44.07051282051282,1023.7179487179484,26.93994601889338,0
3811,4,0,0,39,0.0,0.0,1.0,39,850,700,150,0.8235294117647058,10,7,3,368.36052570391655,0.38812977957714795,0.07917088129987304,0.21391700347241993,130999.80481591054,1851.0313938198497,132850.8362097304,2150,6,644.7692307692307,38,1,17,34.64308077645586,0.6266447368421053,44.07051282051282,1023.7179487179484,26.93994601889338,0
3812,4,0,1,38,0.0,0.02564102564102564,0.9743589743589743,39,1100,700,400,0.6363636363636364,15,7,8,363.74347764074867,0.3888888888888889,0.07200990657755035,0.2119883720450978,131136.55495516476,1740.0133090437598,132876.56826420853,2151,7,645.7692307692307,38,1,17,34.62283995688607,0.628015350877193,43.93696581196581,1024.252136752137,26.954003598740446,0
3813,4,0,0,38,0.0,0.0,1.0,38,850,500,350,0.5882352941176471,12,5,7,372.67262603633657,0.3861279042200095,0.06472962612185995,0.21637261422109663,130991.17036011058,2163.364689135094,133154.53504924566,2152,8,660.8947368421053,37,1,17,34.541470294201645,0.6283783783783785,44.07894736842104,1023.684210526314,27.667140825035514,0
3814,4,1,0,39,0.02564102564102564,0.0,1.0,39,850,600,250,0.7058823529411765,11,6,5,364.5853442045213,0.38849527665317135,0.07749200126177302,0.21386501118801302,131385.84530476423,1781.1363777774234,133166.98168254163,2153,0,644.9230769230769,36,3,18,34.34914140304628,0.6342592592592593,43.693693693693696,1025.2252252252254,28.478478478478483,0
3815,4,1,1,39,0.025,0.025,0.975,40,1000,700,300,0.7,13,7,6,372.22282139152446,0.3926282051282051,0.10356374973124094,0.21086581513909622,130038.81602993222,1748.263247783038,131787.07927771527,2154,0,629.775,37,3,18,35.51969110585537,0.6188063063063063,45.0109649122807,1019.9561403508767,27.566382171645316,8
3816,4,0,0,39,0.0,0.0,1.0,39,1200,800,400,0.6666666666666666,16,8,8,374.4293009399884,0.38922627080521816,0.12066365007541502,0.2127087082017081,130147.65346004821,1946.2189808051726,132093.8724408534,2155,1,646.8974358974359,36,3,18,35.35274804105508,0.6218171296296295,44.9042792792793,1020.3828828828856,28.343968968969044,0
3817,4,0,0,39,0.0,0.0,1.0,39,1100,900,200,0.8181818181818182,13,9,4,374.2384962063033,0.38947930724246516,0.12019566736547871,0.21291421789816273,130205.11379200175,1945.5531967778923,132150.66698877965,2156,2,647.8974358974359,36,3,18,35.299201883114506,0.6223958333333333,44.84797297297299,1020.6081081081105,28.35022522522529,0
3818,4,1,1,39,0.025,0.025,0.975,40,1150,800,350,0.6956521739130435,15,8,7,368.9966532340685,0.3953258547008547,0.11276859504132197,0.211805479323161,130550.14209733397,1634.5257842301937,132184.66788156415,2157,0,632.675,36,4,18,35.082644628099175,0.6258680555555556,44.510135135135144,1021.9594594594607,28.387762762762797,0
3819,4,0,0,39,0.0,0.0,1.0,39,800,500,300,0.625,11,5,6,377.46363776269686,0.3894230769230769,0.11567655183832848,0.21621489490793788,130469.43486636222,2049.49350030006,132518.9283666623,2158,4,649.8974358974359,35,4,18,34.948288395453346,0.6270833333333334,44.58912037037037,1021.6435185185179,29.1898148148148,0
3820,4,0,0,39,0.0,0.0,1.0,39,1100,600,500,0.5454545454545454,16,6,10,382.68888405016367,0.38959176788124156,0.12175640009407429,0.2198780439197782,130587.70743580657,2194.8928058556025,132782.60024166218,2159,5,650.8974358974359,35,4,18,34.69465991016494,0.6282738095238096,44.47337962962962,1022.10648148148,29.203042328042287,0
3821,4,0,0,39,0.0,0.0,1.0,39,850,500,350,0.5882352941176471,12,5,7,385.09035084720375,0.3886077372919478,0.1235436512774073,0.22176585132882642,130676.44702717755,2264.447766632363,132940.89479380992,2160,6,651.8974358974359,35,4,18,34.54314768696703,0.6291666666666667,44.38657407407407,1022.453703703703,29.212962962962944,0
3822,4,1,0,40,0.025,0.0,1.0,40,1400,900,500,0.6428571428571429,19,9,10,377.0457569810336,0.3931490384615384,0.1220874825998497,0.21939129747326294,131075.36844269378,1884.2823032086608,132959.65074590244,2161,0,636.575,37,3,19,34.34421511939178,0.629222972972973,43.99671052631578,1024.0131578947357,27.67603129445232,0
3823,4,0,0,40,0.0,0.0,1.0,40,1050,900,150,0.8571428571428571,12,9,3,355.5026385543114,0.3930154914529915,0.10110381219039422,0.19910720757631697,129591.85157933214,1214.292498653436,130806.14407798558,2162,1,637.575,37,3,17,36.40022614688779,0.6143018018018017,45.449561403508774,1018.2017543859652,27.518966334755817,3
3824,4,0,0,40,0.0,0.0,1.0,40,1400,1000,400,0.7142857142857143,18,10,8,353.385296874656,0.3933092948717949,0.10635629709364891,0.1984854539277845,129703.52055440146,1167.0634233610467,130870.58397776251,2163,2,638.575,37,3,17,36.34059921062075,0.6154279279279278,45.33991228070176,1018.6403508771938,27.53082029397821,0
3825,4,0,0,40,0.0,0.0,1.0,40,900,600,300,0.6666666666666666,12,6,6,352.28447599100605,0.3937633547008547,0.10124784853700564,0.19871580635997543,129871.1141889813,1150.3154816866827,131021.42967066799,2164,3,639.575,37,3,18,36.198364888123926,0.617117117117117,45.17543859649123,1019.2982456140357,27.548601232811777,0
3826,4,1,1,40,0.024390243902439025,0.024390243902439025,0.975609756097561,41,1000,800,200,0.8,12,8,4,344.6287115913323,0.39563008130081306,0.09552823699217594,0.19649956727660092,130290.5716783048,780.9634935749427,131071.53517187975,2165,0,624.9512195121952,37,4,19,35.96809776966313,0.6213400900900901,44.76425438596491,1020.9429824561398,27.59305357989567,0
3827,4,1,1,40,0.024390243902439025,0.024390243902439025,0.975609756097561,41,850,600,250,0.7058823529411765,11,6,5,340.58966896449476,0.3979166666666667,0.08131780199841465,0.19625428787833707,130699.20562358461,702.9598354518207,131402.16545903642,2166,0,583.1219512195122,38,3,18,35.65762894855989,0.6236293859649122,44.36431623931624,1022.5427350427349,26.909019343229865,0
3828,4,0,0,40,0.0,0.0,1.0,40,950,600,350,0.631578947368421,13,6,7,350.8402698353761,0.39346955128205124,0.07858253780971802,0.2017818529102538,130626.6245984343,1165.8160443598238,131792.44064279413,2167,1,598.575,37,3,18,35.46906843290788,0.6247184684684683,44.43530701754387,1022.2587719298258,27.62861545756286,0
3829,4,0,0,40,0.0,0.0,1.0,40,1100,700,400,0.6363636363636364,15,7,8,347.86540605903673,0.3934561965811966,0.06548027444253868,0.20079755617071157,130766.77439212079,1097.8474145891212,131864.6218067099,2168,2,599.575,37,3,18,35.40326615208691,0.626126126126126,44.298245614035096,1022.8070175438608,27.64343290659083,0
3830,4,0,0,40,0.0,0.0,1.0,40,600,400,200,0.6666666666666666,8,4,4,350.81871651371944,0.3935496794871795,0.0698022719965703,0.20294416886481828,130850.90033712306,1180.9889821868346,132031.8893193099,2169,3,600.575,37,3,18,35.24262762119101,0.6269707207207207,44.21600877192983,1023.1359649122816,27.652323376007608,0
3831,4,0,0,40,0.0,0.0,1.0,40,1550,1300,250,0.8387096774193549,18,13,5,350.5651362517139,0.39316239316239315,0.0650535331905786,0.20413206811664628,131103.44048168662,1192.0590951061838,132295.4995767928,2170,4,601.575,37,3,19,34.993754461099215,0.6295045045045045,43.969298245614034,1024.1228070175434,27.67899478425793,0
3832,4,0,0,40,0.0,0.0,1.0,40,1000,800,200,0.8,12,8,4,349.21702533079673,0.39256143162393164,0.06428609654286666,0.20379354576300007,131187.67463306006,1162.5938990843224,132350.26853214437,2171,5,602.575,37,3,19,34.94316154696921,0.6303490990990992,43.88706140350877,1024.451754385964,27.687885253674704,0
3833,4,1,0,41,0.024390243902439025,0.0,1.0,41,900,600,300,0.6666666666666666,12,6,6,342.18554687500006,0.3968241869918699,0.07204268292682947,0.20128561580882362,131492.43918474688,798.9624424720598,132291.40162721893,2172,0,588.8536585365854,38,3,20,34.81575520833334,0.631578947368421,43.58974358974359,1025.6410256410256,26.99055330634278,0
3834,4,0,0,41,0.0,0.0,1.0,41,1150,900,250,0.782608695652174,14,9,5,342.4373638469686,0.39690040650406505,0.07800307258668648,0.20215801350646145,131629.4461451711,814.9681085177683,132444.41425368885,2173,1,589.8536585365854,38,3,14,34.67117820579559,0.6329495614035088,43.45619658119657,1026.175213675212,27.00461088618979,0
3835,4,1,0,42,0.023809523809523808,0.0,1.0,42,1050,600,450,0.5714285714285714,15,6,9,333.64638896694936,0.3992571622144793,0.08342144522819783,0.19859712337845617,131942.77479383672,404.44607204860597,132347.22086588532,2174,0,576.7857142857143,39,3,16,34.58136892088276,0.6343482905982907,43.151041666666664,1027.3958333333328,26.343482905982892,0
3836,4,0,0,42,0.0,0.0,1.0,42,1300,1000,300,0.7692307692307693,16,10,6,332.67920782566694,0.39913617886178865,0.08079308763545989,0.19830092961934756,131996.2904188367,382.48426649304537,132378.77468532973,2175,1,577.7857142857143,39,3,17,34.5523948302078,0.6348824786324787,43.09895833333333,1027.6041666666658,26.348824786324766,0
3837,4,0,1,41,0.0,0.023809523809523808,0.9761904761904762,42,1150,800,350,0.6956521739130435,15,8,7,333.8496654456716,0.39935394889663184,0.07947523047310301,0.1998441508559261,132156.9023980034,424.10753038193354,132581.00992838535,2176,2,578.7857142857143,39,3,17,34.36085925100462,0.6364850427350428,42.94270833333333,1028.229166666666,26.36485042735041,0
3838,4,1,1,41,0.023809523809523808,0.023809523809523808,0.9761904761904762,42,950,700,250,0.7368421052631579,12,7,5,331.99015469320113,0.4011686991869919,0.0765223431349853,0.19887177227738354,132183.68055555547,376.7361111111057,132560.41666666657,2177,0,579.5,39,3,17,34.38175310642896,0.6367521367521367,42.916666666666664,1028.3333333333328,26.367521367521356,0
3839,4,0,0,41,0.0,0.0,1.0,41,900,500,400,0.5555555555555556,13,5,8,338.12383723108053,0.39646849593495936,0.0765522101282119,0.20207624607686037,132095.80342793456,732.9479874351313,132828.75141536968,2178,4,594.6341463414634,38,3,18,34.312426383981155,0.6376096491228072,43.002136752136735,1027.9914529914506,27.052406657669753,0
3840,4,0,0,41,0.0,0.0,1.0,41,800,500,300,0.625,11,5,6,338.65175240344087,0.3960111788617886,0.07470383275261328,0.2028328012995094,132178.1873790085,752.4749570823102,132930.6623360908,2179,5,595.6341463414634,38,3,19,34.21601731601732,0.6384320175438598,42.92200854700854,1028.3119658119645,27.06084120557801,0
3841,4,0,0,41,0.0,0.0,1.0,41,950,500,450,0.5263157894736842,14,5,9,337.7159710423095,0.3955792682926829,0.07158458037935866,0.2024192987081737,132205.6544031704,729.5921908101309,132935.24659398053,2180,6,596.6341463414634,38,3,19,34.21246277443036,0.6387061403508772,42.89529914529914,1028.418803418803,27.06365272154745,0
3842,4,0,0,41,0.0,0.0,1.0,41,1300,1100,200,0.8461538461538461,15,11,4,337.0105737854132,0.39535060975609754,0.06264862689125028,0.2025960704369157,132317.61203342007,718.4868706597135,133036.0989040798,2181,7,597.6341463414634,39,2,20,34.118090007087176,0.6380876068376069,42.78645833333333,1028.854166666666,26.380876068376054,0
3843,4,0,0,41,0.0,0.0,1.0,41,1300,900,400,0.6923076923076923,17,9,8,337.06993697271554,0.3954776422764228,0.06237067837372079,0.20277569046385377,132344.40646701373,721.8641493055369,133066.27061631926,2182,8,598.6341463414634,39,2,21,34.08964365256125,0.638354700854701,42.76041666666666,1028.958333333332,26.383547008546973,0
3844,4,0,0,41,0.0,0.0,1.0,41,1100,800,300,0.7272727272727273,14,8,6,336.46003357095503,0.3947408536585366,0.06249572822661276,0.20299263766162481,132452.986031211,713.0380760213313,133166.02410723234,2183,9,599.6341463414634,38,3,21,33.996280920256005,0.6411732456140352,42.65491452991452,1029.3803418803404,27.088956365272118,0
3845,4,0,0,41,0.0,0.0,1.0,41,750,300,450,0.4,12,3,9,335.66895857043033,0.394385162601626,0.05946988293290301,0.20295968774791745,132535.48127145867,697.6093944042492,133233.09066586292,2184,10,600.6341463414634,38,3,21,33.9338209863734,0.6419956140350878,42.57478632478632,1029.7008547008534,27.09739091318035,0
3846,4,0,0,41,0.0,0.0,1.0,41,850,500,350,0.5882352941176471,12,5,7,334.55346843201755,0.39400406504065044,0.05975609756097522,0.20258137158823147,132590.4923661332,671.7218204397429,133262.21418657294,2185,11,601.6341463414634,38,3,21,33.90733056708159,0.6425438596491229,42.52136752136751,1029.9145299145282,27.103013945119162,0
3847,4,0,0,41,0.0,0.0,1.0,41,800,500,300,0.625,11,5,6,336.14683564424803,0.39397865853658537,0.06348443617161137,0.20414358204994526,132700.54879830527,721.3739133610944,133421.92271166638,2186,12,602.6341463414634,38,3,17,33.7558758468132,0.643640350877193,42.414529914529915,1030.3418803418808,27.114260008996865,0
3848,4,0,0,41,0.0,0.0,1.0,41,800,600,200,0.75,10,6,4,339.37444469357865,0.3940802845528455,0.06420800602740173,0.20655806106996533,132783.1210849038,812.6395965738794,133595.7606814777,2187,13,603.6341463414634,38,3,17,33.58988977575067,0.6444627192982457,42.3344017094017,1030.6623931623922,27.122694556905056,0
3849,4,0,0,41,0.0,0.0,1.0,41,1100,700,400,0.6363636363636364,15,7,8,339.2539933957958,0.39410569105691057,0.05980538354606346,0.20694064704610826,132865.71905361983,815.045154868892,133680.76420848872,2188,14,604.6341463414634,38,3,17,33.51014680483594,0.6452850877192982,42.25427350427351,1030.9829059829071,27.131129104813347,0
3850,4,0,0,41,0.0,0.0,1.0,41,1300,900,400,0.6923076923076923,17,9,8,334.6189164370982,0.3941565040650406,0.05705838876570568,0.2044893378226712,132934.5703125,696.4843750000008,133631.0546875,2189,15,605.6341463414634,39,2,17,33.560606060606055,0.6442307692307692,42.1875,1031.25,26.442307692307693,0
3851,4,0,1,40,0.0,0.024390243902439025,0.975609756097561,41,950,800,150,0.8421052631578947,11,8,3,340.72043830830034,0.3935721544715447,0.06000911094421402,0.2089681697488369,133068.88156467024,867.8575303819554,133936.7390950522,2190,16,606.6341463414634,39,2,17,33.26865640249032,0.6455662393162394,42.05729166666667,1031.7708333333342,26.455662393162413,0
3852,4,0,1,39,0.0,0.025,0.975,40,1000,400,600,0.4,16,4,12,348.0036355475588,0.39066506410256413,0.06270975761342479,0.21290412532168165,132975.889628534,1255.2186061801606,134231.10823471416,2191,19,622.4,38,2,17,33.17407292314067,0.6463815789473684,42.147435897435905,1031.4102564102575,27.142375168690986,0
3853,4,0,0,39,0.0,0.0,1.0,39,700,700,0,1.0,7,7,0,350.86215692276295,0.38872019793072426,0.06661486661486649,0.21441576256391076,132934.57031250012,1528.3420138889046,134462.91232638902,2192,20,635.7435897435897,37,2,17,33.141835016835024,0.647804054054054,42.18750000000001,1031.250000000001,27.871621621621646,0
3854,4,0,0,39,0.0,0.0,1.0,39,800,600,200,0.75,10,6,4,353.13010668777787,0.38827035537561855,0.060219624512929615,0.2166202284179914,133075.95245652503,1598.6250577100616,134674.5775142351,2193,21,636.7435897435897,37,2,18,32.941462982642584,0.6492117117117117,42.050438596491226,1031.7982456140346,27.886439070649583,0
3855,4,0,0,39,0.0,0.0,1.0,39,650,400,250,0.6153846153846154,9,4,5,354.4697009394739,0.38787674313990106,0.0640766805892723,0.2176069377391643,133104.23790252768,1636.2838806171121,134740.5217831448,2194,22,637.7435897435897,37,2,18,32.878524244678225,0.6494932432432432,42.02302631578947,1031.9078947368419,27.889402560455185,0
3856,4,0,0,39,0.0,0.0,1.0,39,1000,900,100,0.9,11,9,2,355.17348037531764,0.3875955915429599,0.06715584535852237,0.218536153219166,133189.11227493064,1661.0481109572067,134850.16038588784,2195,23,638.7435897435897,37,2,19,32.775210679130375,0.6503378378378378,41.940789473684205,1032.2368421052624,27.898293029871958,0
3857,4,0,0,39,0.0,0.0,1.0,39,750,400,350,0.5333333333333333,11,4,7,354.1688014517024,0.38689271255060725,0.0627833459945597,0.21841569111137393,133274.01369892654,1640.2995392813139,134914.31323820786,2196,24,639.7435897435897,37,2,20,32.715987929630806,0.6511824324324325,41.858552631578945,1032.565789473684,27.907183499288756,0
3858,4,1,0,40,0.025,0.0,1.0,40,700,400,300,0.5714285714285714,10,4,6,347.5452659182004,0.3903044871794872,0.06531607976241016,0.2161383091739309,133585.55036164966,1285.5524055478509,134871.1027671975,2197,0,624.725,37,3,21,32.574954037618454,0.6542792792792793,41.557017543859644,1033.7719298245606,27.939781887150286,0
3859,4,0,0,40,0.0,0.0,1.0,40,1200,1000,200,0.8333333333333334,14,10,4,346.20020800056517,0.38947649572649573,0.06032280292589842,0.21612882608003509,133727.278164916,1259.2823032086646,134986.56046812466,2198,1,625.725,37,3,17,32.4679096434503,0.6556869369369369,41.41995614035087,1034.3201754385955,27.954599336178255,0
3860,4,1,2,39,0.024390243902439025,0.04878048780487805,0.9512195121951219,41,650,100,550,0.15384615384615385,12,1,11,339.14147896154157,0.3932672764227642,0.06079813920236421,0.21295799025653755,133941.82971957407,885.0460451822578,134826.87576475632,2199,0,611.439024390244,38,3,18,32.43605291223723,0.6559758771929824,41.212606837606835,1035.1495726495723,27.240778227620325,0
3861,4,1,1,39,0.025,0.025,0.975,40,1250,900,350,0.72,16,9,7,347.71540032014104,0.3891025641025641,0.06792569659442727,0.21850598113503034,133969.47937212363,1316.6502301117735,135286.12960223542,2200,0,627.65,38,2,18,32.18653250773994,0.65625,41.18589743589744,1035.2564102564106,27.24358974358975,0
3862,4,0,0,39,0.0,0.0,1.0,39,1050,500,550,0.47619047619047616,16,5,11,361.8080596230683,0.38424988753936123,0.07248797525251294,0.2272674578111369,133954.1989482341,1893.141759964606,135847.3407081987,2201,29,644.7435897435897,37,2,18,31.837089114853654,0.6579391891891893,41.20065789473684,1035.1973684210527,27.978307254623047,0
3863,4,0,0,39,0.0,0.0,1.0,39,650,400,250,0.6153846153846154,9,4,5,364.7379228034736,0.3841655420602789,0.07065261649212573,0.22999428696939966,134096.12212411495,1981.9882079101085,136078.11033202507,2202,30,645.7435897435897,37,2,18,31.619203895828925,0.6593468468468469,41.06359649122806,1035.7456140350864,27.993124703650984,0
3864,4,0,0,39,0.0,0.0,1.0,39,1300,1200,100,0.9230769230769231,14,12,2,363.8083442103149,0.38394062078272606,0.07243107973498564,0.22958566651668946,134124.51577648878,1959.1236005309174,136083.6393770197,2203,31,646.7435897435897,37,2,18,31.614864507250974,0.6596283783783785,41.03618421052631,1035.8552631578937,27.996088193456586,0
3865,4,0,0,39,0.0,0.0,1.0,39,1150,1000,150,0.8695652173913043,13,10,3,364.48807358393316,0.3841093117408907,0.07482793807942012,0.23019273524204537,134152.9124345951,1979.4273237919224,136132.33975838704,2204,32,647.7435897435897,37,2,18,31.568850550381025,0.6599099099099099,41.008771929824555,1035.9649122807007,27.99905168326218,0
3866,4,0,0,39,0.0,0.0,1.0,39,1100,900,200,0.8181818181818182,13,9,4,364.5194531657059,0.3831252811515969,0.07567262597411761,0.23110680018614446,134294.9408111148,1990.6236774776673,136285.56448859247,2205,33,648.7435897435897,37,2,20,31.425980288444578,0.6613175675675677,40.87171052631578,1036.5131578947355,28.01386913229015,0
3867,4,0,0,39,0.0,0.0,1.0,39,800,700,100,0.875,9,7,2,371.75808499237723,0.38332208726945566,0.0690990126388733,0.23661426432421911,134437.04433094762,2195.6116305016562,136632.6559614493,2206,34,649.7435897435897,37,2,20,31.096250088108825,0.6627252252252254,40.734649122807,1037.0614035087692,28.028686581318087,0
3868,4,0,0,39,0.0,0.0,1.0,39,1050,700,350,0.6666666666666666,14,7,7,367.41636967819517,0.3817476383265857,0.07219782605065861,0.23476937796219766,134579.9917315964,2089.4264903894637,136669.41822198586,2207,35,650.7435897435897,36,3,20,31.065950365386012,0.666087962962963,40.596846846846844,1037.6126126126123,28.822572572572565,0
3869,4,0,0,39,0.0,0.0,1.0,39,1050,800,250,0.7619047619047619,13,8,5,365.276535147533,0.381578947368421,0.06677738738062033,0.23396482449303757,134667.6421987866,2038.1859477720918,136705.8281465587,2208,36,651.7435897435897,36,3,20,31.033913782503337,0.6669560185185186,40.512387387387385,1037.9504504504503,28.83195695695695,0
3870,4,0,0,39,0.0,0.0,1.0,39,850,600,250,0.7058823529411765,11,6,5,367.7800252196843,0.381578947368421,0.06639020306446275,0.23594739405012327,134726.09169558072,2109.9130803100397,136836.00477589076,2209,37,652.7435897435897,36,3,20,30.91057417651949,0.6675347222222223,40.45608108108108,1038.1756756756758,28.83821321321322,0
3871,4,0,0,39,0.0,0.0,1.0,39,500,200,300,0.4,8,2,6,367.89023202412955,0.38135402609086816,0.06629957172256562,0.2362080737647962,134755.32119957788,2115.033276519758,136870.35447609765,2210,38,653.7435897435897,36,3,20,30.87852494577006,0.6678240740740742,40.427927927927925,1038.2882882882877,28.841341341341327,0
3872,4,0,1,38,0.0,0.02564102564102564,0.9743589743589743,39,800,600,200,0.75,10,6,4,368.56297610441936,0.38135402609086816,0.07313696710921369,0.23740397287619863,134872.27091956823,2141.7851128155226,137014.05603238376,2211,39,654.7435897435897,36,3,17,30.744299291702813,0.6689814814814815,40.31531531531532,1038.738738738739,28.85385385385386,0
3873,4,0,0,38,0.0,0.0,1.0,38,950,600,350,0.631578947368421,13,6,7,369.7346741950632,0.38143077287814126,0.07072297127734828,0.23892938189580115,134989.2713659605,2382.0428536644736,137371.31421962497,2212,40,659.6315789473684,36,2,17,30.597095795405284,0.6701388888888888,40.2027027027027,1039.189189189189,28.86636636636636,0
3874,4,0,0,38,0.0,0.0,1.0,38,1200,900,300,0.75,15,9,6,369.46271344208276,0.3811936936936937,0.06803900325027112,0.23914031171601852,135047.79061155746,2379.024632740852,137426.8152442983,2213,41,660.6315789473684,36,2,17,30.545774647887335,0.6707175925925926,40.1463963963964,1039.4144144144143,28.872622622622618,0
3875,4,0,0,38,0.0,0.0,1.0,38,1000,800,200,0.8,12,8,4,369.47408925906,0.3811196064485538,0.06574813699832904,0.23934142582107953,135077.05498995617,2381.494374442008,137458.54936439818,2214,42,661.6315789473684,36,2,18,30.51628570396851,0.6710069444444444,40.11824324324324,1039.527027027027,28.875750750750754,0
3876,4,1,0,39,0.02564102564102564,0.0,1.0,39,900,600,300,0.6666666666666666,12,6,6,361.7327924205587,0.38419365721997306,0.08006136129161212,0.23684766422350234,135462.40790435512,2000.2390158510245,137462.64692020614,2215,0,645.6410256410256,37,2,19,30.333631767432067,0.6728603603603605,39.747807017543856,1041.008771929824,28.135372214319567,0
3877,4,0,0,39,0.0,0.0,1.0,39,700,500,200,0.7142857142857143,9,5,4,361.61636629336795,0.3838562753036437,0.08298230834035403,0.2371484125912859,135519.48676515848,2001.2128731917492,137520.69963835023,2216,1,646.6410256410256,37,2,19,30.279854675652903,0.6734234234234234,39.69298245614035,1041.2280701754382,28.141299193930763,0
3878,4,0,1,38,0.0,0.02564102564102564,0.9743589743589743,39,1100,700,400,0.6363636363636364,15,7,8,360.58459918994384,0.38382816014394966,0.07920989894244634,0.23666012014560464,135548.0307041591,1975.3064644890887,137523.33716864817,2217,2,647.6410256410256,37,2,19,30.2783115720754,0.673704954954955,39.6655701754386,1041.3377192982464,28.14426268373639,0
3879,4,0,0,38,0.0,0.0,1.0,38,1300,1100,200,0.8461538461538461,15,11,4,367.665532845033,0.3824087245139877,0.08647104352576984,0.24148940680048778,135575.0344939535,2369.253459540638,137944.28795349415,2218,3,661.3421052631579,36,2,19,30.067086577277976,0.6759259259259258,39.63963963963965,1041.4414414414423,28.928928928928954,0
3880,4,0,0,38,0.0,0.0,1.0,38,800,500,300,0.625,11,5,6,368.47738744415267,0.3821271929824561,0.08986746789126521,0.2422208497847172,135604.35593955452,2393.4277605308116,137997.78370008533,2219,4,662.3421052631579,36,2,19,30.016758568493877,0.6762152777777778,39.61148648648649,1041.5540540540549,28.93205705705708,0
3881,4,0,0,38,0.0,0.0,1.0,38,800,500,300,0.625,11,5,6,366.4000000000001,0.38163821716453294,0.09094736842105222,0.24105263157894738,135633.68055555547,2339.2392815112316,137972.9198370667,2220,5,663.3421052631579,35,3,19,30.04166666666667,0.6785714285714286,39.58333333333333,1041.666666666666,29.761904761904745,0
3882,4,0,0,38,0.0,0.0,1.0,38,1350,1100,250,0.8148148148148148,16,11,5,370.09277999443304,0.38137150308202944,0.09024310387165424,0.24389276760687326,135693.96888931765,2443.8716349451433,138137.8405242628,2221,6,664.3421052631579,35,3,19,29.885488409982976,0.6791666666666666,39.52546296296297,1041.898148148149,29.76851851851854,0
3883,4,0,0,38,0.0,0.0,1.0,38,1000,600,400,0.6,14,6,8,370.4851909299143,0.3814159554291133,0.08673424647924355,0.24435737538036767,135724.11807966826,2456.7551601080263,138180.8732397763,2222,7,665.3421052631579,35,3,19,29.84525991336222,0.6794642857142856,39.49652777777778,1042.0138888888891,29.771825396825403,0
3884,4,0,0,38,0.0,0.0,1.0,38,1150,900,250,0.782608695652174,14,9,5,366.84974021106325,0.38088252726410626,0.08764236003576142,0.2427785165379168,135844.74833086852,2366.922126843281,138211.6704577118,2223,8,666.3421052631579,35,3,20,29.819977980089547,0.6806547619047618,39.38078703703704,1042.4768518518522,29.78505291005292,0
3885,4,0,0,38,0.0,0.0,1.0,38,850,600,250,0.7058823529411765,11,6,5,366.2384965091222,0.3811047889995258,0.08371506029727938,0.2425791453348658,135874.91426611802,2352.5248628257955,138227.4391289438,2224,9,667.3421052631579,35,3,16,29.80591326228538,0.680952380952381,39.351851851851855,1042.592592592593,29.788359788359802,0
3886,4,0,0,38,0.0,0.0,1.0,38,550,300,250,0.5454545454545454,8,3,5,364.66031471026474,0.38070471787577054,0.08336400441663572,0.24173839405627495,135905.08355034728,2311.8381076388987,138216.92165798618,2225,10,668.3421052631579,35,3,16,29.817057942057943,0.6812499999999999,39.32291666666667,1042.708333333334,29.791666666666686,0
3887,4,0,0,38,0.0,0.0,1.0,38,1100,800,300,0.7272727272727273,14,8,6,368.44641097454144,0.38012683736367947,0.09148926231709709,0.24528625912293328,136055.98020619,2425.8675197187927,138481.8477259088,2226,11,669.3421052631579,35,3,16,29.568356630426738,0.6827380952380953,39.17824074074074,1043.2870370370372,29.808201058201064,0
3888,4,0,0,38,0.0,0.0,1.0,38,550,200,350,0.36363636363636365,9,2,7,369.001888784525,0.3793563300142247,0.0962499416242466,0.2460740406273134,136116.3623113854,2445.438957475987,138561.8012688614,2227,12,670.3421052631579,35,3,17,29.493862762496303,0.6833333333333333,39.12037037037037,1043.518518518518,29.8148148148148,0
3889,4,0,0,38,0.0,0.0,1.0,38,700,500,200,0.7142857142857143,9,5,4,368.24554483846657,0.3792674253200569,0.09470532618972549,0.24598802395209568,136176.75781250003,2429.296874999999,138606.05468750003,2228,13,671.3421052631579,35,3,18,29.45359281437125,0.6839285714285714,39.0625,1043.7500000000002,29.821428571428577,0
3890,4,0,0,38,0.0,0.0,1.0,38,900,800,100,0.8888888888888888,10,8,2,365.3518989837449,0.3785265528686581,0.09749851240826524,0.24488891772892604,136297.58900248614,2359.3165937928525,138656.905596279,2229,14,672.3421052631579,35,3,18,29.409129535210234,0.6851190476190476,38.94675925925925,1044.212962962962,29.834656084656054,0
3891,4,0,0,38,0.0,0.0,1.0,38,750,400,350,0.5333333333333333,11,4,7,365.1256224535989,0.3787932669511617,0.10099384098544206,0.2451557750759879,136358.02469135798,2357.561728395055,138715.58641975303,2230,15,673.3421052631579,35,3,18,29.35505319148936,0.6857142857142857,38.888888888888886,1044.4444444444441,29.84126984126983,0
3892,4,0,0,38,0.0,0.0,1.0,38,1100,800,300,0.7272727272727273,14,8,6,362.80987545837087,0.3781709340919867,0.10098651414178539,0.2442270503924468,136448.7033420138,2300.987413194434,138749.69075520823,2231,16,674.3421052631579,35,3,18,29.325564971751405,0.6866071428571429,38.80208333333333,1044.7916666666658,29.851190476190453,0
3893,4,0,0,38,0.0,0.0,1.0,38,850,800,50,0.9411764705882353,9,8,1,363.13000917129466,0.37788940256045517,0.10384958408869638,0.2448619008818237,136509.1725206833,2314.115413880313,138823.28793456362,2232,17,675.3421052631579,35,3,18,29.257231328681655,0.6872023809523808,38.74421296296296,1045.023148148148,29.85780423280423,0
3894,4,0,0,38,0.0,0.0,1.0,38,1150,900,250,0.782608695652174,14,9,5,359.25032960378417,0.3781412991939308,0.09162236448199956,0.24018374519618443,136206.96058652687,2186.4790970078757,138393.43968353473,2233,18,676.3421052631579,35,3,16,29.658337029234573,0.6842261904761905,39.03356481481481,1043.8657407407402,29.824735449735435,1
3895,4,0,0,38,0.0,0.0,1.0,38,1050,800,250,0.7619047619047619,13,8,5,359.9383973391284,0.37774122807017546,0.09875859011305721,0.24126034329818832,136297.58900248614,2211.7471493484077,138509.33615183455,2234,19,677.3421052631579,35,3,16,29.550450750018477,0.6851190476190476,38.94675925925925,1044.212962962962,29.834656084656054,0
3896,4,0,0,38,0.0,0.0,1.0,38,800,500,300,0.625,11,5,6,360.78609507155676,0.3777264106211475,0.09693648395620569,0.24203516251529034,136327.80517243216,2237.035295567547,138564.8404679997,2235,20,678.3421052631579,35,3,16,29.498342199564078,0.6854166666666668,38.91782407407407,1044.3287037037028,29.837962962962937,0
3897,4,0,0,38,0.0,0.0,1.0,38,850,500,350,0.5882352941176471,12,5,7,362.8098754583709,0.3771040777619725,0.09405992548669806,0.2442270503924467,136448.70334201367,2300.9874131944184,138749.69075520808,2236,21,679.3421052631579,35,3,16,29.32556497175141,0.686607142857143,38.80208333333332,1044.791666666665,29.851190476190425,0
3898,4,0,0,38,0.0,0.0,1.0,38,1500,1100,400,0.7333333333333333,19,11,8,358.68873885970083,0.376215030820294,0.08740663924588965,0.24290810096390797,136660.4040745025,2203.709597908065,138864.11367241057,2237,22,680.3421052631579,35,3,16,29.223396797284337,0.6886904761904763,38.599537037037024,1045.60185185185,29.87433862433857,0
3899,4,0,0,38,0.0,0.0,1.0,38,950,800,150,0.8421052631578947,11,8,3,359.2185050726096,0.37634838786154573,0.0790492050750593,0.24390214726181975,136752.0479024943,2224.786638549447,138976.83454104373,2238,23,681.3421052631579,34,4,17,29.118768495333473,0.6917892156862746,38.51190476190476,1045.9523809523807,30.763305322128843,0
3900,4,0,0,38,0.0,0.0,1.0,38,1100,700,400,0.6363636363636364,15,7,8,357.6400060578325,0.3763780227596017,0.07547972115085155,0.24326163879537388,136814.31405895684,2186.0544217687006,139000.36848072553,2239,24,682.3421052631579,34,4,17,29.098391746320747,0.6924019607843137,38.45238095238095,1046.1904761904757,30.770308123249286,0
3901,4,0,0,38,0.0,0.0,1.0,38,150,0,150,0.0,3,0,3,355.67389772104355,0.376215030820294,0.07650209594783441,0.24211536411131235,136841.99245541816,2134.2249657064276,138976.2174211246,2240,25,683.3421052631579,35,3,17,29.122418879056045,0.6904761904761905,38.42592592592592,1046.2962962962947,29.89417989417985,0
3902,4,0,0,38,0.0,0.0,1.0,38,800,500,300,0.625,11,5,6,357.028844379844,0.3760075865339023,0.08167149792197814,0.24345813053412874,136902.54870756163,2175.6317515431983,139078.18045910483,2241,26,684.3421052631579,35,3,17,29.0270404777704,0.6910714285714287,38.36805555555555,1046.527777777777,29.900793650793627,0
3903,4,0,0,38,0.0,0.0,1.0,38,750,600,150,0.8,9,6,3,353.2914459023865,0.3753556187766714,0.07252405832179387,0.24174541752140594,137023.70139960555,2081.8603180726914,139105.56171767824,2242,27,685.3421052631579,35,3,16,29.00499299874715,0.6922619047619047,38.25231481481481,1046.99074074074,29.914021164021143,0
3904,4,0,0,38,0.0,0.0,1.0,38,1100,900,200,0.8181818181818182,13,9,4,350.04889960623893,0.37467401612138457,0.06568769991276491,0.24035982863706098,137144.90767532584,2001.4848036694154,139146.39247899526,2243,28,686.3421052631579,35,3,16,28.970073664825044,0.6934523809523809,38.136574074074076,1047.4537037037042,29.92724867724869,0
3905,4,0,1,37,0.0,0.02631578947368421,0.9736842105263158,38,1000,800,200,0.8,12,8,4,351.648814030218,0.3731478188715031,0.057464616815368075,0.2425118058677549,137296.4908720207,2056.0296371313384,139352.52050915203,2244,29,687.3421052631579,35,3,16,28.778414319896925,0.6949404761904763,37.991898148148145,1048.032407407407,29.943783068783056,0
3906,4,0,0,37,0.0,0.0,1.0,37,1150,800,350,0.6956521739130435,15,8,7,352.8773645528778,0.37384259259259256,0.008935285531030068,0.24382172668702087,137362.50030036527,2295.391274029963,139657.89157439524,2245,30,693.7297297297297,33,4,17,28.681026420388125,0.7001262626262625,37.92892156862745,1048.2843137254904,31.76619132501486,3
3907,4,0,0,37,0.0,0.0,1.0,37,600,500,100,0.8333333333333334,7,5,2,355.2823131668627,0.37327952952952953,0.0181864697465961,0.24616605293674865,137458.86685709836,2367.3408364571446,139826.2076935555,2246,31,694.7297297297297,33,4,18,28.52282244556114,0.7010732323232323,37.837009803921575,1048.6519607843145,31.777332144979226,0
3908,4,0,0,37,0.0,0.0,1.0,37,1150,800,350,0.6956521739130435,15,8,7,347.54296516408215,0.37327952952952953,0.020335621892042077,0.2276874706227906,135483.01832829622,2017.2339838391345,137500.25231213536,2247,32,695.7297297297297,35,2,19,30.682439318139707,0.6770833333333335,39.728009259259245,1041.087962962961,29.745370370370313,6
3909,4,0,0,37,0.0,0.0,1.0,37,850,500,350,0.5882352941176471,12,5,7,347.54296516408215,0.37327952952952953,0.020335621892042077,0.2276874706227906,135483.01832829622,2017.2339838391345,137500.25231213536,2248,33,696.7297297297297,35,2,19,30.682439318139707,0.6770833333333335,39.728009259259245,1041.087962962961,29.745370370370313,0
3910,4,0,0,37,0.0,0.0,1.0,37,750,500,250,0.6666666666666666,10,5,5,348.45782205272184,0.37281031031031026,0.019682236421149746,0.22867068016107475,135543.2731722606,2046.2227527005957,137589.4959249612,2249,34,697.7297297297297,35,2,19,30.59874124708237,0.6776785714285715,39.67013888888888,1041.3194444444428,29.75198412698408,0
3911,4,0,0,37,0.0,0.0,1.0,37,600,500,100,0.8333333333333334,7,5,2,350.8220764378206,0.372997997997998,0.017301141995518465,0.2304158426122267,135573.40561771247,2112.4287337105447,137685.83435142302,2250,35,698.7297297297297,35,2,19,30.507242350151888,0.6779761904761905,39.641203703703695,1041.435185185184,29.755291005290974,0
3912,4,0,0,37,0.0,0.0,1.0,37,600,200,400,0.3333333333333333,10,2,8,348.1899928416038,0.3725913413413413,0.016856760771741808,0.22927092756635595,135664.6843112243,2047.430487755776,137712.11479898007,2251,36,699.7297297297297,34,3,20,30.48508741858072,0.6810661764705883,39.553571428571416,1041.7857142857129,30.640756302520966,0
3913,4,0,0,37,0.0,0.0,1.0,37,1050,800,250,0.7619047619047619,13,8,5,350.4356785380455,0.3718405905905906,0.022650105564678613,0.23175338378241098,135819.7562358274,2119.2176870748017,137938.9739229022,2252,37,700.7297297297297,34,3,20,30.2725749961931,0.6825980392156864,39.40476190476189,1042.3809523809502,30.658263305322066,0
3914,4,0,0,37,0.0,0.0,1.0,37,1300,1000,300,0.7692307692307693,16,10,6,351.3306282694803,0.3718405905905906,0.021336476919944003,0.23274989730590812,135881.80980725607,2147.888321995449,138029.6981292515,2253,38,701.7297297297297,34,3,17,30.187637969094915,0.6832107843137256,39.34523809523809,1042.6190476190463,30.66526610644254,0
3915,4,0,0,37,0.0,0.0,1.0,37,1200,700,500,0.5833333333333334,17,7,10,352.18719376159794,0.3719344344344344,0.023478958410465323,0.23372422858724215,135943.8775510203,2175.538548752818,138119.4160997731,2254,39,702.7297297297297,34,3,17,30.1036910197869,0.6838235294117647,39.28571428571428,1042.857142857142,30.672268907562998,0
3916,4,0,0,37,0.0,0.0,1.0,37,900,700,200,0.7777777777777778,11,7,4,353.5597115302612,0.3718405905905906,0.018055028667832262,0.2352500950751461,136037.00573979566,2219.44090136051,138256.44664115616,2255,40,703.7297297297297,34,3,17,29.975465023393795,0.6847426470588236,39.196428571428555,1043.2142857142837,30.68277310924364,0
3917,4,0,0,37,0.0,0.0,1.0,37,600,500,100,0.8333333333333334,7,5,2,351.45032116729925,0.37149649649649646,0.0197653443517678,0.23425567034459116,136099.10891439888,2166.41510770973,138265.5240221086,2256,41,704.7297297297297,34,3,17,29.968862901692344,0.6853553921568629,39.13690476190475,1043.4523809523794,30.689775910364098,0
3918,4,0,0,37,0.0,0.0,1.0,37,1150,600,550,0.5217391304347826,17,6,11,349.9614915170729,0.3702765265265265,0.021973874572788432,0.23477342289654646,136327.80517243233,2141.896406678673,138469.70157911102,2257,42,705.7297297297297,35,2,17,29.78095330451807,0.6854166666666666,38.917824074074076,1044.3287037037042,29.837962962962976,0
3919,4,0,0,37,0.0,0.0,1.0,37,700,400,300,0.5714285714285714,10,4,6,353.2672172912967,0.3697134634634635,0.02608391043086966,0.23780336841823516,136448.70334201382,2240.5707465277683,138689.2740885416,2258,43,706.7297297297297,35,2,17,29.574817215021596,0.6866071428571429,38.80208333333333,1044.791666666666,29.85119047619046,0
3920,4,0,0,37,0.0,0.0,1.0,37,950,700,250,0.7368421052631579,12,7,5,356.9187978057638,0.3695257757757758,0.02722456675945084,0.24088017520075083,136539.41213348767,2346.6965663580268,138886.1086998457,2259,44,707.7297297297297,35,2,18,29.38953488372093,0.6875,38.71527777777778,1045.138888888889,29.86111111111111,0
3921,4,0,0,37,0.0,0.0,1.0,37,850,600,250,0.7058823529411765,11,6,5,345.8154172199995,0.3695257757757758,0.03899960367458699,0.20817268001030034,132369.0307706357,1755.0503205908853,134124.08109122657,2260,45,708.7297297297297,36,1,17,33.83991756037062,0.6440972222222221,42.7364864864865,1029.0540540540558,28.584834834834883,8
3922,4,0,0,37,0.0,0.0,1.0,37,1000,700,300,0.7,13,7,6,348.4986760769741,0.36936936936936937,0.03956472884262818,0.21011067937622335,132426.9793442092,1830.1253956659505,134257.10473987515,2261,46,709.7297297297297,36,1,18,33.71261852662291,0.6446759259259258,42.68018018018019,1029.2792792792802,28.591091091091116,0
3923,4,0,0,37,0.0,0.0,1.0,37,600,200,400,0.3333333333333333,10,2,8,348.849942430954,0.36890015015015015,0.036848049099197366,0.21064637871227118,132484.94059938335,1843.4727802126638,134328.41337959602,2262,47,710.7297297297297,36,1,18,33.64530919565376,0.6452546296296295,42.62387387387388,1029.504504504506,28.59734734734739,0
3924,4,0,0,37,0.0,0.0,1.0,37,950,700,250,0.7368421052631579,12,7,5,348.78778925102006,0.36836836836836834,0.03688512479240669,0.2112591470523069,132600.90115453315,1849.915033276547,134450.8161878097,2263,48,711.7297297297297,36,1,18,33.530368467089446,0.6464120370370369,42.511261261261275,1029.9549549549567,28.60985985985991,0
3925,4,0,0,37,0.0,0.0,1.0,37,1200,1000,200,0.8333333333333334,14,10,4,348.580369673624,0.367774024024024,0.036703588834736456,0.211786877988955,132716.91243608494,1852.5020797825073,134569.41451586745,2264,49,712.7297297297297,36,1,18,33.41917122040073,0.6475694444444443,42.39864864864866,1030.405405405407,28.622372372372418,0
3926,4,0,0,37,0.0,0.0,1.0,37,1100,600,500,0.5454545454545454,16,6,10,348.55481156101075,0.3678991491491492,0.02887528122398164,0.2124281454746671,132832.97444403887,1859.914475286128,134692.888919325,2265,50,713.7297297297297,36,1,18,33.30329182142596,0.6487268518518517,42.28603603603605,1030.855855855858,28.634884884884944,0
3927,4,1,0,38,0.02631578947368421,0.0,1.0,38,900,600,300,0.6666666666666666,12,6,6,343.1161676539679,0.3719327880512091,0.025063455324096928,0.21111735962708855,133189.11227493078,1539.867555401665,134728.97983033245,2266,0,695.921052631579,37,1,19,33.086360739324405,0.6503378378378377,41.94078947368421,1032.2368421052636,27.89829302987199,0
3928,4,0,1,37,0.0,0.02631578947368421,0.9736842105263158,38,700,500,200,0.7142857142857143,9,5,4,339.9570286827208,0.37299964438122335,-0.016339907635070317,0.21794671838851506,134700.92438539537,1565.7309839845263,136266.6553693799,2267,1,696.921052631579,35,3,16,31.657770282826025,0.669345238095238,40.48032407407408,1038.0787037037048,29.659391534391567,2
3929,4,0,0,37,0.0,0.0,1.0,37,700,600,100,0.8571428571428571,8,6,2,347.64534334699067,0.3694944944944945,-0.008476757128816459,0.22233488319557718,134612.54428854876,1959.4848356009059,136572.02912414967,2268,53,716.7297297297297,34,3,16,31.54635577989369,0.6706495098039216,40.56547619047619,1037.7380952380954,30.521708683473395,0
3930,4,0,0,37,0.0,0.0,1.0,37,800,500,300,0.625,11,5,6,354.8838058231133,0.3694944944944945,0.006497093986872704,0.20001055047081467,129837.58680555565,1815.4513888888932,131653.03819444455,2269,54,717.7297297297297,34,3,19,36.166189697465235,0.6228553921568627,45.208333333333336,1019.1666666666674,29.975490196078454,8
3931,4,0,0,37,0.0,0.0,1.0,37,1000,600,400,0.6,14,6,8,353.5001235852328,0.3688688688688689,0.011777774972544286,0.19969492469551017,129928.59977324263,1785.955215419503,131714.55498866213,2270,55,718.7297297297297,34,3,19,36.10900280242878,0.6237745098039216,45.11904761904762,1019.5238095238095,29.985994397759104,0
3932,4,0,0,37,0.0,0.0,1.0,37,850,700,150,0.8235294117647058,10,7,3,351.140787175148,0.36883758758758756,0.0002522943013028023,0.19928983748947118,130110.72137188193,1737.4362244897795,131848.15759637172,2271,56,719.7297297297297,34,3,19,35.98429599377675,0.6256127450980392,44.94047619047618,1020.2380952380939,30.00700280112041,0
3933,4,0,0,37,0.0,0.0,1.0,37,700,400,300,0.5714285714285714,10,4,6,349.49786403617514,0.36858733733733734,-0.006828477842125702,0.19882184395369124,130201.83000283435,1701.0522959183495,131902.8822987527,2272,57,720.7297297297297,34,3,20,35.93379408219602,0.6265318627450981,44.85119047619047,1020.5952380952372,30.017507002801093,0
3934,4,1,1,37,0.02631578947368421,0.02631578947368421,0.9736842105263158,38,1150,900,250,0.782608695652174,14,9,5,338.7503702243236,0.37485182550972024,-0.009080541521557794,0.19437387553513308,130536.1678004534,1243.8492063491954,131780.0170068026,2273,0,702.7368421052631,34,4,17,35.86954411307861,0.6299019607843137,44.52380952380952,1021.904761904761,30.05602240896356,0
3935,4,0,0,37,0.0,0.0,1.0,37,1150,1000,150,0.8695652173913043,13,10,3,346.02180919110043,0.3693380880880881,-0.012045887240894837,0.19762849458460857,130356.43029423774,1621.2335700211368,131977.66386425888,2274,59,722.7297297297297,33,4,21,35.86580963238528,0.6303661616161617,44.69975490196078,1021.2009803921565,30.94548425430777,0
3936,4,2,1,38,0.05128205128205128,0.02564102564102564,0.9743589743589743,39,750,600,150,0.8,9,6,3,327.9334984951169,0.38000449842555106,-0.004617705070193656,0.1897206889199498,130854.01663237308,782.2830932784608,131636.29972565154,2275,0,686.6153846153846,35,4,18,35.8248491704374,0.6309523809523809,44.21296296296296,1023.1481481481479,29.232804232804227,0
3937,4,0,0,38,0.0,0.0,1.0,38,1000,500,500,0.5,15,5,10,336.1831248904806,0.3739035087719298,-0.0005605621550088813,0.19396569683909443,130749.15143140574,1191.1316609977155,131940.28309240346,2276,1,705.6842105263158,34,4,18,35.71979397043419,0.632046568627451,44.31547619047618,1022.7380952380939,30.080532212885117,0
3938,4,0,0,38,0.0,0.0,1.0,38,1200,1000,200,0.8333333333333334,14,10,4,335.0315221568836,0.3742443100995732,0.0019017927689002345,0.19360631270303302,130810.03578514735,1165.0970804988629,131975.1328656462,2277,2,706.6842105263158,34,4,18,35.68772062531518,0.6326593137254901,44.25595238095238,1022.9761904761901,30.087535014005592,0
3939,4,0,0,38,0.0,0.0,1.0,38,800,500,300,0.625,11,5,6,336.16348912896007,0.3742443100995732,0.005648939101680739,0.1945673527988825,130870.9343112242,1198.8059807255902,132069.7402919498,2278,3,707.6842105263158,34,4,18,35.59724646112082,0.6332720588235295,44.196428571428555,1023.2142857142834,30.09453781512598,0
3940,4,0,0,38,0.0,0.0,1.0,38,850,500,350,0.5882352941176471,12,5,7,340.6266689843138,0.37368124703651023,0.0017841731902727975,0.19777506594166874,130992.77388038544,1323.9264455782236,132316.70032596367,2279,4,708.6842105263158,34,4,19,35.35997402798774,0.6344975490196079,44.07738095238095,1023.6904761904759,30.10854341736694,0
3941,4,2,2,38,0.05,0.05,0.95,40,1000,900,100,0.9,11,9,2,323.4793538439361,0.3830261752136752,-0.002753981328940114,0.1898955200998735,131414.71021274655,501.9891090414726,131916.699321788,2280,0,674.2,36,4,19,35.37365000915246,0.6345486111111112,43.66554054054054,1025.337837837838,28.481606606606608,0
3942,4,0,0,38,0.0,0.0,1.0,38,750,500,250,0.6666666666666666,10,5,5,339.0600534622665,0.3736367946894263,-0.0006692723670824741,0.1972165873097087,131061.33355034704,1287.5325520833119,132348.86610243036,2281,6,710.6842105263158,35,3,19,35.330832485588324,0.6330357142857144,44.01041666666666,1023.9583333333319,29.25595238095234,0
3943,4,0,0,38,0.0,0.0,1.0,38,1000,900,100,0.9,11,9,2,342.0212582591211,0.3739183262209578,-0.0027297056199822034,0.19939974542774827,131150.2338927467,1371.2336033950373,132521.46749614173,2282,7,711.6842105263158,35,3,19,35.16525423728814,0.6339285714285714,43.9236111111111,1024.3055555555538,29.265873015872966,0
3944,4,1,0,39,0.02564102564102564,0.0,1.0,39,1300,900,400,0.6923076923076923,17,9,8,335.7224834504988,0.3758715699505173,0.002598537526875111,0.19740125586296411,131476.45968632106,1028.0412755058182,132504.50096182688,2283,0,694.4102564102565,35,4,21,34.997578339540304,0.637202380952381,43.60532407407407,1025.578703703703,29.302248677248656,0
3945,4,0,0,39,0.0,0.0,1.0,39,1200,800,400,0.6666666666666666,16,8,8,336.80505737031234,0.37632141250562307,0.0025345902123155017,0.19819166124938295,131506.1366705246,1058.386381172832,132564.52305169744,2284,1,695.4102564102565,35,4,21,34.939911983750854,0.6375,43.576388888888886,1025.694444444444,29.30555555555554,0
3946,4,0,0,39,0.0,0.0,1.0,39,800,500,300,0.625,11,5,6,336.63119550626266,0.3756747638326586,0.0017819124317324242,0.19839753437283966,131565.50068587088,1057.8103566529348,132623.31104252383,2285,2,696.4102564102565,35,4,16,34.8845517448857,0.6380952380952382,43.51851851851851,1025.9259259259245,29.31216931216927,0
3947,4,0,0,39,0.0,0.0,1.0,39,1100,800,300,0.7272727272727273,14,8,6,336.3652760957511,0.3755060728744939,-0.00119744891318474,0.19839508799659555,131595.18771701382,1052.8103298611,132647.9980468749,2286,3,697.4102564102565,35,4,16,34.861463620981375,0.6383928571428572,43.48958333333333,1026.041666666666,29.315476190476172,0
3948,4,0,1,38,0.0,0.02564102564102564,0.9743589743589743,39,850,400,450,0.47058823529411764,13,4,9,334.73026594718715,0.37491565452091763,-0.0033419131608924957,0.1979926264833623,131703.53366457683,1017.0317699456282,132720.56543452246,2287,4,698.4102564102565,36,3,17,34.794295117937466,0.6374421296296295,43.38400900900901,1026.4639639639645,28.512887887887903,0
3949,4,1,1,38,0.02564102564102564,0.02564102564102564,0.9743589743589743,39,700,500,200,0.7142857142857143,9,5,4,336.53530633397827,0.37516869095816463,-0.0017099641976241475,0.1993627282551579,131761.3363997443,1068.4683416524604,132829.80474139674,2288,0,699.2820512820513,36,3,17,34.68977368286351,0.6380208333333334,43.3277027027027,1026.689189189189,28.519144144144136,0
3950,4,0,0,38,0.0,0.0,1.0,38,1050,800,250,0.7619047619047619,13,8,5,346.75712528285254,0.37012505926979616,0.0002847515542687695,0.2056436641383334,131803.0907064472,1540.7321673525387,133343.82287379974,2289,14,718.6842105263158,35,3,17,34.38533213104899,0.6404761904761904,43.28703703703704,1026.851851851852,29.338624338624342,0
3951,4,0,0,38,0.0,0.0,1.0,38,650,400,250,0.6153846153846154,9,4,5,347.29735595646343,0.37039177335229967,-6.346715286387195e-05,0.20652193487841333,131905.89871966562,1562.1139720801898,133468.01269174583,2290,15,719.6842105263158,36,2,17,34.2678871592487,0.6394675925925926,43.18693693693694,1027.2522522522524,28.53478478478479,0
3952,4,0,0,38,0.0,0.0,1.0,38,900,600,300,0.6666666666666666,12,6,6,347.96699423547466,0.37027323376007587,-0.008910342918440506,0.20755207773810094,132021.60564280508,1587.832257933619,133609.4379007387,2291,16,720.6842105263158,36,2,18,34.13415881364599,0.640625,43.07432432432433,1027.7027027027036,28.547297297297323,0
3953,4,0,0,38,0.0,0.0,1.0,38,1150,800,350,0.6956521739130435,15,8,7,350.40328138017014,0.3704954954954955,-0.007375107355509725,0.2098054008053992,132166.31063073233,1662.301786583912,133828.61241731624,2292,17,721.6842105263158,36,2,20,33.92586609717811,0.6420717592592591,42.93355855855857,1028.2657657657678,28.562937937937996,0
3954,4,0,0,38,0.0,0.0,1.0,38,950,700,250,0.7368421052631579,12,7,5,348.53692119890354,0.37053994784257943,-0.003555253362220956,0.20916795257758145,132253.17166829013,1619.0226544111986,133872.19432270134,2293,18,722.6842105263158,36,2,21,33.886440770746674,0.6429398148148147,42.849099099099114,1028.6036036036055,28.572322322322375,0
3955,4,0,0,38,0.0,0.0,1.0,38,950,900,50,0.9473684210526315,10,9,1,348.53692119890354,0.3705844001896634,-0.003555253362220956,0.20916795257758145,132253.17166829013,1619.0226544111986,133872.19432270134,2294,19,723.6842105263158,36,2,21,33.886440770746674,0.6429398148148147,42.849099099099114,1028.6036036036055,28.572322322322375,0
3956,4,0,0,38,0.0,0.0,1.0,38,1200,900,300,0.75,15,9,6,348.6681208275498,0.3705844001896634,-0.007702182284980763,0.20421989934185064,131328.12500000012,1558.0653711143714,132886.1903711145,2295,20,724.6842105263158,35,3,21,34.81537940379403,0.6357142857142857,43.75000000000001,1025.000000000001,29.285714285714313,1
3957,4,2,2,38,0.05,0.05,0.95,40,800,600,200,0.75,10,6,4,337.1240667158135,0.38007478632478636,-0.005926342875522295,0.19445616389971482,130738.73842191813,819.3753125961686,131558.1137345143,2296,0,689.4,37,3,16,35.70626049819523,0.6258445945945947,44.325657894736835,1022.6973684210514,27.640469416785173,2
3958,4,1,1,38,0.02564102564102564,0.02564102564102564,0.9743589743589743,39,800,400,400,0.5,12,4,8,344.84615589310846,0.37654633378317587,-0.009537693098733202,0.1980901082839148,130578.91506371235,1205.9273800827839,131784.84244379515,2297,0,708.0512820512821,36,3,16,35.67054135448803,0.6261574074074074,44.48198198198198,1022.072072072072,28.39089089089089,0
3959,4,3,2,39,0.07317073170731707,0.04878048780487805,0.9512195121951219,41,1000,800,200,0.8,12,8,4,328.48378244814086,0.38445121951219513,0.006271123080326513,0.19198585968678358,131246.0064308021,422.4369247205777,131668.4433555227,2298,0,674.439024390244,38,3,17,35.41536336148472,0.6291118421052632,43.830128205128204,1024.679487179487,26.96524966261808,0
3960,4,1,0,40,0.025,0.0,1.0,40,1050,800,250,0.7619047619047619,13,8,5,338.1515886729418,0.37954059829059833,0.02689900502835152,0.1979150218738877,131300.02891514695,879.862674092027,132179.89158923898,2299,0,692.275,37,3,18,35.113204771584456,0.6314752252252251,43.77741228070175,1024.8903508771928,27.6997392128971,0
3961,4,0,0,40,0.0,0.0,1.0,40,600,400,200,0.6666666666666666,8,4,4,339.34599709227746,0.3801949786324786,0.02208524975933268,0.19890568820161128,131356.22409058549,915.0417676592672,132271.26585824476,2300,1,693.275,37,3,18,35.02591631903587,0.6320382882882883,43.72258771929824,1025.1096491228063,27.70566619250828,0
3962,4,0,0,40,0.0,0.0,1.0,40,900,500,400,0.5555555555555556,13,5,8,339.8609392772688,0.3802884615384616,0.0312860808210389,0.19994083182387237,131496.76462950127,938.1227877808383,132434.8874172821,2301,2,694.275,37,3,18,34.87099992872923,0.633445945945946,43.585526315789465,1025.6578947368412,27.720483641536248,0
3963,4,1,1,40,0.024390243902439025,0.024390243902439025,0.975609756097561,41,950,600,350,0.631578947368421,13,6,7,335.36601116128963,0.3836382113821138,0.027900672387928926,0.19855403581323644,131739.1030777447,636.1635026298262,132375.2665803745,2302,0,678.3170731707318,38,3,15,34.742168800083256,0.634046052631579,43.349358974358964,1026.6025641025624,27.01585695006743,0
3964,4,0,0,40,0.0,0.0,1.0,40,1450,1100,350,0.7586206896551724,18,11,7,340.31521659726826,0.3803418803418803,0.029241452991453087,0.20109535526202174,131665.51246537364,961.5554786087689,132627.0679439824,2303,4,696.275,37,3,16,34.689280626780615,0.6351351351351353,43.42105263157893,1026.3157894736817,27.738264580369776,0
3965,4,0,0,40,0.0,0.0,1.0,40,1050,600,450,0.5714285714285714,15,6,9,341.12864036274345,0.3799412393162393,0.026532955880782305,0.20172490223851133,131693.64762474963,984.8949917281916,132678.54261647782,2304,5,697.275,37,3,16,34.64006249332336,0.6354166666666667,43.39364035087718,1026.4254385964887,27.74122807017537,0
3966,4,1,0,41,0.024390243902439025,0.0,1.0,41,1100,700,400,0.6363636363636364,15,7,8,337.6186997808624,0.38409552845528455,0.03408042188530036,0.2014821272885788,132040.895061728,715.8950617283549,132756.79012345633,2305,0,681.2439024390244,38,3,19,34.38063063063062,0.637061403508772,43.055555555555536,1027.7777777777746,27.04678362573091,0
3967,4,0,1,40,0.0,0.024390243902439025,0.975609756097561,41,950,500,450,0.5263157894736842,14,5,9,315.9274975800147,0.3841717479674797,-0.06776197399322936,0.18530808476637067,131382.88498064154,109.20926473811664,131492.09424537965,2306,1,682.2439024390244,38,3,17,35.5992514242045,0.6304824561403508,43.6965811965812,1025.2136752136762,26.979307242465165,5
3968,4,2,2,40,0.047619047619047616,0.047619047619047616,0.9523809523809523,42,1150,1000,150,0.8695652173913043,13,10,3,307.20176192539157,0.38876790553619817,-0.05132758329105336,0.18183023205854273,131728.82080078137,-306.5348307291514,131422.2859700522,2307,0,666.9285714285714,39,3,12,35.47532978183664,0.6322115384615383,43.35937500000001,1026.562500000001,26.322115384615408,0
3969,4,0,0,40,0.0,0.0,1.0,40,800,500,300,0.625,11,5,6,322.3673741032237,0.379420405982906,-0.04897904639726347,0.1896493344252549,131496.7646295014,478.0533433364093,131974.81797283783,2308,9,701.275,37,3,18,35.31956025942555,0.6334459459459459,43.58552631578947,1025.6578947368423,27.72048364153628,0
3970,4,2,1,41,0.047619047619047616,0.023809523809523808,0.9761904761904762,42,1050,900,150,0.8571428571428571,12,9,3,310.61978179431907,0.3871830236159504,-0.03129782786074009,0.18489094193345637,131942.77479383693,-203.19281684026743,131739.58197699665,2309,0,668.8333333333334,39,3,14,35.17280492750684,0.6343482905982906,43.15104166666667,1027.3958333333344,26.343482905982935,0
3971,4,0,0,41,0.0,0.0,1.0,41,750,500,250,0.6666666666666666,10,5,5,318.77875207040006,0.38168191056910566,-0.029870057385824378,0.1894152609644516,131876.23844875448,207.8685440864935,132084.10699284097,2310,1,686.1463414634146,38,3,14,35.03007766451702,0.6354166666666666,43.215811965811966,1027.1367521367522,27.02991452991453,0
3972,4,0,0,41,0.0,0.0,1.0,41,1000,900,100,0.9,11,9,2,316.72267575441253,0.38074186991869924,-0.03339069887049251,0.1886565503406718,131969.53125,159.54861111111148,132129.07986111112,2311,2,687.1463414634146,39,2,15,34.98918626655853,0.6346153846153846,43.125,1027.5,26.346153846153847,0
3973,4,0,0,41,0.0,0.0,1.0,41,800,600,200,0.75,10,6,4,316.73194370344066,0.380614837398374,-0.028419850385408618,0.18892849797933178,132023.0523003473,163.18359375000952,132186.2358940973,2312,3,688.1463414634146,39,2,15,34.935215217244405,0.6351495726495726,43.07291666666667,1027.7083333333342,26.35149572649575,0
3974,4,1,1,41,0.023809523809523808,0.023809523809523808,0.9761904761904762,42,650,200,450,0.3076923076923077,11,2,9,308.5812542653415,0.3850416182733256,-0.023658964623296308,0.18513046084288828,132241.16478493303,-238.57110103112018,132002.5936839019,2313,0,672.7380952380952,40,2,15,34.92593781905608,0.6356770833333333,42.86077235772358,1028.5569105691068,25.713922764227668,0
3975,4,0,0,41,0.0,0.0,1.0,41,750,400,350,0.5333333333333333,11,4,7,318.2810229811432,0.3811229674796748,-0.018871107683408717,0.19081776970196507,132215.03404058437,216.3072575847793,132431.34129816917,2314,5,690.1463414634146,40,1,15,34.70273386034256,0.6354166666666666,42.88617886178862,1028.455284552846,25.711382113821152,0
3976,4,0,0,41,0.0,0.0,1.0,41,700,300,400,0.42857142857142855,11,3,8,319.87835738509057,0.38104674796747967,-0.021464956795389067,0.19204085014542627,132267.29811124332,261.8892111177214,132529.18732236105,2315,6,691.1463414634146,40,1,15,34.609225778831586,0.6359375,42.83536585365854,1028.658536585366,25.71646341463415,0
3977,4,0,0,41,0.0,0.0,1.0,41,950,600,350,0.631578947368421,13,6,7,320.6756628284912,0.3804623983739837,-0.025464512989984422,0.1930536124733237,132371.85723610298,289.6866118051581,132661.54384790815,2316,7,692.1463414634146,40,1,16,34.48383698729344,0.6369791666666667,42.73373983739838,1029.0650406504076,25.72662601626019,0
3978,4,1,1,41,0.023809523809523808,0.023809523809523808,0.9761904761904762,42,900,700,200,0.7777777777777778,11,7,4,312.21713911439576,0.3851867982965544,-0.02682814102286335,0.18957272700923802,132692.98095703125,-114.19025708335391,132578.7906999479,2317,0,676.6428571428571,39,3,13,34.37984447140498,0.6418269230769231,42.421875,1030.3125,26.41826923076923,0
3979,4,0,0,41,0.0,0.0,1.0,41,600,300,300,0.5,9,3,6,320.0738909379663,0.38000508130081306,-0.030029270316559664,0.19395552372928543,132618.00219382337,289.51199411935045,132907.51418794272,2318,9,694.1463414634146,38,3,17,34.2525844483629,0.6428179824561404,42.49465811965811,1030.0213675213663,27.105825461088585,0
3980,4,0,0,41,0.0,0.0,1.0,41,850,700,150,0.8235294117647058,10,7,3,319.24104079895784,0.38033536585365857,-0.029390711826853155,0.19373450952953708,132673.0304099092,270.93526280222636,132943.96567271143,2319,10,695.1463414634146,38,3,13,34.21890663348197,0.6433662280701755,42.441239316239304,1030.2350427350411,27.1114484930274,0
3981,4,0,0,41,0.0,0.0,1.0,41,900,800,100,0.8888888888888888,10,8,2,324.5540014497034,0.3798526422764228,-0.031002148363452497,0.1979738377995977,132865.7190536196,424.42015486886237,133290.13920848846,2320,11,696.1463414634146,38,3,13,33.88903281519862,0.6452850877192983,42.2542735042735,1030.9829059829053,27.131129104813297,0
3982,4,0,0,41,0.0,0.0,1.0,41,800,600,200,0.75,10,6,4,327.00366186820895,0.38023373983739833,-0.03354132391184028,0.19961494881025185,132893.2574169953,491.31636259038675,133384.57377958568,2321,12,697.1463414634146,38,3,13,33.798311055849126,0.6455592105263158,42.227564102564095,1031.0897435897427,27.133940620782703,0
3983,4,0,0,41,0.0,0.0,1.0,41,1450,1300,150,0.896551724137931,16,13,3,327.95659868803546,0.3800558943089431,-0.03802684872388984,0.20049176992625728,132948.3427044523,520.2572549126802,133468.599959365,2322,13,698.1463414634146,38,3,13,33.718576262992514,0.646107456140351,42.17414529914529,1031.3034188034173,27.13956365272151,0
3984,4,1,2,40,0.023809523809523808,0.047619047619047616,0.9523809523809523,42,1150,900,250,0.782608695652174,14,9,5,321.49681040751096,0.38283972125435545,-0.04341341096107554,0.19831971882822994,133283.92062717007,170.0710720486021,133453.99169921866,2323,0,682.5,39,3,15,33.54948468341236,0.6477029914529915,41.84895833333333,1032.604166666666,26.4770299145299,0
3985,4,0,0,40,0.0,0.0,1.0,40,650,300,350,0.46153846153846156,10,3,7,334.7608707598685,0.37715010683760686,-0.05014880952380962,0.2050410333404195,133019.3905817174,905.9374038165502,133925.32798553395,2324,25,717.275,37,3,15,33.47195649092969,0.6486486486486487,42.10526315789473,1031.5789473684206,27.880512091038394,0
3986,4,0,0,40,0.0,0.0,1.0,40,500,300,200,0.6,7,3,4,334.5395327511262,0.3776575854700855,-0.05452178533475027,0.2052162322808407,133075.95245652506,903.8333910433928,133979.78584756845,2325,26,718.275,37,3,15,33.421006021962455,0.6492117117117117,42.050438596491226,1031.7982456140348,27.88643907064959,0
3987,4,0,0,40,0.0,0.0,1.0,40,1150,900,250,0.782608695652174,14,9,5,332.3623481997913,0.37727029914529914,-0.05438177182919057,0.2045005977746951,133189.11227493078,853.4092220683325,134042.5214969991,2326,27,719.275,37,3,16,33.363872955173136,0.6503378378378377,41.94078947368421,1032.2368421052636,27.89829302987199,0
3988,4,0,0,40,0.0,0.0,1.0,40,1100,500,600,0.45454545454545453,17,5,12,355.63149972812386,0.37727029914529914,-0.12054294975688795,0.21303362653616806,132183.68055555594,1401.73611111115,133585.4166666671,2327,28,720.275,39,1,14,33.773973527822804,0.6367521367521366,42.916666666666686,1028.3333333333364,26.367521367521448,7
3989,4,0,0,40,0.0,0.0,1.0,40,800,700,100,0.875,9,7,2,355.63149972812386,0.37727029914529914,-0.12054294975688795,0.21303362653616806,132183.68055555594,1401.73611111115,133585.4166666671,2328,29,721.275,39,1,14,33.773973527822804,0.6367521367521366,42.916666666666686,1028.3333333333364,26.367521367521448,0
3990,4,1,0,41,0.024390243902439025,0.0,1.0,41,750,600,150,0.8,9,6,3,347.6013033049314,0.37972560975609754,-0.1079448656448162,0.20971437428572465,132452.98603121162,1008.5133364380578,133461.49936764967,2329,0,704.6585365853658,38,3,15,33.70956581906245,0.6411732456140349,42.65491452991455,1029.3803418803452,27.088956365272242,0
3991,4,0,0,41,0.0,0.0,1.0,41,1100,600,500,0.5454545454545454,16,6,10,351.24804152821025,0.3790396341463415,-0.11069729784434723,0.21269039700577597,132590.4923661337,1114.4301537731367,133704.92251990683,2330,1,705.6585365853658,38,3,15,33.477480982019365,0.6425438596491226,42.52136752136754,1029.9145299145323,27.103013945119272,0
3992,4,0,0,41,0.0,0.0,1.0,41,600,300,300,0.5,9,3,6,355.981860629193,0.3790650406504065,-0.11337593151911618,0.2158727735966468,132645.51487508244,1243.879437869847,133889.3943129523,2331,2,706.6585365853658,38,3,12,33.300274839244956,0.6430921052631577,42.46794871794873,1030.1282051282071,27.108636977058083,0
3993,4,0,1,40,0.0,0.024390243902439025,0.975609756097561,41,1000,700,300,0.7,13,7,6,355.981860629193,0.3790650406504065,-0.11337593151911618,0.2158727735966468,132645.51487508244,1243.879437869847,133889.3943129523,2332,3,707.6585365853658,38,3,12,33.300274839244956,0.6430921052631577,42.46794871794873,1030.1282051282071,27.108636977058083,0
3994,4,0,0,40,0.0,0.0,1.0,40,750,400,350,0.5333333333333333,11,4,7,357.90582721480325,0.37872596153846155,-0.10418884394294214,0.21691402199070098,132623.79410010795,1493.3657471529923,134117.15984726095,2333,4,716.775,37,3,15,33.272567596338085,0.6447072072072071,42.48903508771931,1030.0438596491244,27.83902323376012,0
3995,4,0,0,40,0.0,0.0,1.0,40,1000,800,200,0.8,12,8,4,356.11738134055196,0.378525641025641,-0.09606523358518637,0.21631771379813633,132708.51518015168,1451.9617815097101,134160.4769616614,2334,5,717.775,37,3,12,33.233456599624006,0.6455518018018017,42.40679824561404,1030.3728070175446,27.84791370317688,0
3996,4,0,1,39,0.0,0.025,0.975,40,800,600,200,0.75,10,6,4,359.8080579447713,0.3782451923076923,-0.0958297872340419,0.219054128541506,132793.26331178838,1556.017236072657,134349.28054786104,2335,6,718.775,37,3,12,33.05319148936171,0.6463963963963963,42.32456140350878,1030.701754385966,27.856804172593677,0
3997,4,0,1,38,0.0,0.02564102564102564,0.9743589743589743,39,850,700,150,0.8235294117647058,10,7,3,365.9343445000493,0.37570287899235266,-0.10200188316207481,0.22194662147049501,132652.03145439006,1908.386835372446,134560.4182897625,2336,37,738.0512820512821,37,2,13,33.03740908284548,0.6449887387387386,42.461622807017555,1030.1535087719317,27.84198672356572,0
3998,4,0,0,38,0.0,0.0,1.0,38,1100,800,300,0.7272727272727273,14,8,6,370.09597398170877,0.3739627785680417,-0.10035083982984816,0.2237972499460547,132539.10007165684,2210.4374663358108,134749.53753799264,2337,38,756.8684210526316,37,1,14,33.04393834522415,0.6438626126126126,42.57127192982457,1029.714912280703,27.830132764343322,0
3999,4,1,1,38,0.02564102564102564,0.02564102564102564,0.9743589743589743,39,1150,800,350,0.6956521739130435,15,8,7,360.41265226235276,0.3783175888439046,-0.09454059181166508,0.21930644412569059,132773.48632812547,1770.6488715278233,134544.13519965328,2338,0,738.4358974358975,39,0,13,33.0574927565528,0.642628205128205,42.34375000000002,1030.6250000000036,26.426282051282143,0
4000,4,0,0,38,0.0,0.0,1.0,38,900,700,200,0.7777777777777778,11,7,4,367.2187786484626,0.37461474632527264,-0.10535593442336633,0.22301372174343667,132700.54879830533,2146.0266911388853,134846.57548944422,2339,40,758.8684210526316,38,0,13,32.95550774229228,0.6436403508771928,42.41452991452992,1030.3418803418813,27.114260008996876,0
4001,4,0,0,38,0.0,0.0,1.0,38,850,600,250,0.7058823529411765,11,6,5,368.3193175911489,0.37414058795637745,-0.1087162869861219,0.22433994798733609,132810.65088757392,2183.3456607495036,134993.99654832343,2340,41,759.8684210526316,38,0,13,32.81638681592039,0.6447368421052632,42.30769230769231,1030.7692307692305,27.125506072874487,0
4002,4,0,0,38,0.0,0.0,1.0,38,1000,700,300,0.7,13,7,6,363.32593564534557,0.373770151730678,-0.07465326876792855,0.21556078120689043,131819.1518165125,1981.9506449216735,133801.10246143417,2341,42,760.8684210526316,36,2,16,33.94378038527615,0.638599537037037,43.2713963963964,1026.9144144144148,28.52540040040041,2
4003,4,1,0,39,0.02564102564102564,0.0,1.0,39,700,500,200,0.7142857142857143,9,5,4,354.1938461717667,0.37578722447143503,-0.06344622385578036,0.21179346311903588,132116.03570329322,1558.9373653431683,133674.97306863638,2342,0,742.3333333333334,37,2,18,33.87905290102388,0.6396396396396395,42.98245614035087,1028.0701754385957,27.785680417259343,0
4004,4,0,0,39,0.0,0.0,1.0,39,950,700,250,0.7368421052631579,12,7,5,357.457912993667,0.37544984255510566,-0.06526707123722064,0.21438332633507648,132228.78674207444,1653.2452293013168,133882.03197137575,2343,1,743.3333333333334,37,2,18,33.68159203980098,0.6407657657657657,42.872807017543856,1028.5087719298242,27.797534376481735,0
4005,4,0,0,39,0.0,0.0,1.0,39,900,600,300,0.6666666666666666,12,6,6,356.6929150225077,0.376040260908682,-0.06876046969833605,0.21440420382166464,132313.3815813518,1639.0491545475359,133952.43073589934,2344,2,744.3333333333334,37,2,18,33.616092045898604,0.6416103603603605,42.79057017543859,1028.8377192982443,27.806424845898494,0
4006,4,0,0,39,0.0,0.0,1.0,39,900,600,300,0.6666666666666666,12,6,6,362.91962135322643,0.37570287899235266,-0.07384839813723842,0.2188051015282646,132426.97934420907,1812.0968917031787,134239.07623591225,2345,3,745.3333333333334,36,3,18,33.34153902261123,0.6446759259259259,42.68018018018018,1029.2792792792793,28.59109109109109,0
4007,4,0,0,39,0.0,0.0,1.0,39,1200,700,500,0.5833333333333334,17,7,10,360.76671307089714,0.375,-0.07580995640044264,0.21834623368850772,132571.90626014516,1765.506173403122,134337.41243354828,2346,4,746.3333333333334,36,3,19,33.25109349371241,0.6461226851851853,42.53941441441441,1029.8423423423415,28.606731731731706,0
4008,4,0,0,39,0.0,0.0,1.0,39,500,300,200,0.6,7,3,4,358.94960636444057,0.3744939271255061,-0.07949306495595676,0.21791837748030965,132687.90486009658,1725.6542437707967,134413.55910386736,2347,5,747.3333333333334,36,3,15,33.18122199147449,0.6472800925925927,42.4268018018018,1030.2927927927926,28.61924424424424,0
4009,4,0,0,39,0.0,0.0,1.0,39,800,500,300,0.625,11,5,6,355.683117390274,0.37362235717498876,-0.07467356926550628,0.21660462897359803,132803.95418645005,1647.2248853583392,134451.17907180838,2348,6,748.3333333333334,36,3,15,33.14873993954623,0.6484375,42.31418918918919,1030.7432432432438,28.631756756756772,0
4010,4,0,0,39,0.0,0.0,1.0,39,800,500,300,0.625,11,5,6,354.56290863055835,0.37393162393162394,-0.07275924541404499,0.21659323244363038,132920.05423920532,1625.704209276833,134545.75844848214,2349,7,749.3333333333334,36,3,15,33.061000691638455,0.6495949074074074,42.20157657657657,1031.193693693693,28.644269269269248,0
4011,4,0,0,39,0.0,0.0,1.0,39,700,500,200,0.7142857142857143,9,5,4,354.6046186283409,0.3732849752586595,-0.07913143509694076,0.21729317132135317,133036.2050183629,1635.0505488596682,134671.25556722257,2350,8,750.3333333333334,36,3,16,32.943319506604084,0.6507523148148149,42.08896396396396,1031.6441441441439,28.656781781781774,0
4012,4,0,0,39,0.0,0.0,1.0,39,1300,1100,200,0.8461538461538461,15,11,4,346.2911403744513,0.3737067026540711,-0.06415020316659636,0.21039601158208704,132716.9124360849,1416.850930322237,134133.76336640713,2351,9,751.3333333333334,36,3,16,33.47814207650274,0.6475694444444444,42.39864864864866,1030.4054054054068,28.62237237237241,7
4013,4,0,0,39,0.0,0.0,1.0,39,650,400,250,0.6153846153846154,9,4,5,348.3423809141734,0.3733974358974359,-0.060304464413304615,0.2118060549997079,132745.92318247314,1448.2061876065422,134194.1293700797,2352,10,752.3333333333334,36,3,16,33.396167996211716,0.6478587962962963,42.370495495495504,1030.5180180180191,28.625500500500532,0
4014,4,0,0,39,0.0,0.0,1.0,39,850,600,250,0.7058823529411765,11,6,5,350.93713719250275,0.373959739091318,-0.051657313125203164,0.21421202854230378,132891.02447041645,1527.27913724536,134418.3036076618,2353,11,753.3333333333334,36,3,16,33.18361365953108,0.6493055555555556,42.22972972972973,1031.0810810810817,28.64114114114116,0
4015,4,0,0,39,0.0,0.0,1.0,39,850,500,350,0.5882352941176471,12,5,7,347.7495373602992,0.37317251461988304,-0.04668645553093298,0.21283538698427704,132991.1141529126,1449.519683941232,134440.63383685384,2354,12,754.3333333333334,37,2,16,33.16535115693986,0.648367117117117,42.1326754385965,1031.4692982456154,27.87754860123285,0
4016,4,0,0,39,0.0,0.0,1.0,39,800,700,100,0.875,9,7,2,346.5072785066408,0.3731443994601889,-0.04723748473748468,0.21223570808531747,133019.3905817174,1418.4374038165502,134437.82798553395,2355,13,755.3333333333334,37,2,16,33.1690228174603,0.6486486486486487,42.10526315789473,1031.5789473684206,27.880512091038394,0
4017,4,1,1,39,0.025,0.025,0.975,40,800,500,300,0.625,11,5,6,339.4820910399907,0.3780181623931624,-0.046337678460583565,0.20954239412468395,133306.67529585806,1051.0457758053985,134357.72107166346,2356,0,737.425,38,2,16,33.062409476515626,0.649671052631579,41.82692307692308,1032.6923076923083,27.176113360323903,0
4018,4,0,0,39,0.0,0.0,1.0,39,800,700,100,0.875,9,7,2,347.35252077228,0.3731443994601889,-0.04205411471185827,0.21372396278106162,133189.11227493064,1452.7147776238728,134641.82705255452,2357,15,757.3333333333334,37,2,16,32.97703774520218,0.6503378378378378,41.940789473684205,1032.2368421052624,27.898293029871958,0
4019,4,0,1,38,0.0,0.02564102564102564,0.9743589743589743,39,1000,800,200,0.8,12,8,4,350.2350270563079,0.37342555105713,-0.0463270006697486,0.21615422574156676,133302.32018505692,1537.4283433364099,134839.74852839333,2358,16,758.3333333333334,37,2,16,32.78916259644651,0.651463963963964,41.83114035087719,1032.6754385964912,27.910146989094358,0
4020,4,0,0,38,0.0,0.0,1.0,38,800,600,200,0.75,10,6,4,356.4482351416178,0.37334044570886676,-0.05092119612007151,0.21996166327379787,133297.72973987513,1902.7481028325733,135200.4778427077,2359,17,756.8421052631579,36,2,16,32.63336059614685,0.6533564814814814,41.83558558558559,1032.6576576576585,28.684934934934958,0
4021,4,0,0,38,0.0,0.0,1.0,38,900,700,200,0.7777777777777778,11,7,4,356.5766628140137,0.3728959222380275,-0.05269470011706123,0.2203855223268287,133355.88121905702,1910.3190183426818,135266.2002373997,2360,18,757.8421052631579,36,2,16,32.571730992876866,0.6539351851851851,41.77927927927929,1032.882882882884,28.69119119119122,0
4022,4,0,0,38,0.0,0.0,1.0,38,1200,900,300,0.75,15,9,6,355.3185219368261,0.37279220009483166,-0.06028761713915243,0.2206532963070833,133532.0283028978,1889.3313119644945,135421.35961486227,2361,19,758.8421052631579,35,3,17,32.427678238148566,0.6577380952380951,41.6087962962963,1033.5648148148148,29.53042328042328,0
4023,4,0,0,38,0.0,0.0,1.0,38,900,600,300,0.6666666666666666,12,6,6,349.3617896500528,0.37326635846372686,-0.010792076495246716,0.20624585062008322,131629.44614517115,1597.259775184437,133226.7059203556,2362,20,759.8421052631579,38,0,14,34.49353635259413,0.6329495614035088,43.45619658119657,1026.1752136752125,27.004610886189802,8
4024,4,0,0,38,0.0,0.0,1.0,38,1000,600,400,0.6,14,6,8,348.02020207972686,0.37256993835941205,-0.014527367544590497,0.20589766635357226,131711.68456424854,1567.6654156621946,133279.34997991074,2363,21,760.8421052631579,38,0,14,34.4450371218429,0.6337719298245614,43.37606837606837,1026.4957264957254,27.013045434098036,0
4025,4,2,1,39,0.05,0.025,0.975,40,1050,800,250,0.7619047619047619,13,8,5,331.9160289376576,0.3780849358974359,-0.007395967183947416,0.1985803941314182,132136.65729930927,771.6549135765734,132908.31221288585,2364,0,723.75,40,0,15,34.430908372047064,0.6346354166666668,42.96239837398374,1028.150406504065,25.703760162601622,0
4026,4,0,0,39,0.0,0.0,1.0,39,800,500,300,0.625,11,5,6,338.4290749982406,0.3748875393612236,-0.007902343668766854,0.2015860142380824,131969.53125,1132.4652777777792,133101.99652777778,2365,1,743.3076923076923,39,0,15,34.431603135982705,0.6346153846153847,43.125,1027.5,26.346153846153847,0
4027,4,0,0,39,0.0,0.0,1.0,39,1050,700,350,0.6666666666666666,14,7,7,339.31484167531505,0.3742408906882591,-0.010599329748265829,0.20297196892941566,132130.12695312488,1166.742621527764,133296.86957465264,2366,2,744.3076923076923,39,0,15,34.247298210064166,0.6362179487179489,42.96874999999999,1028.124999999999,26.362179487179464,0
4028,4,0,0,39,0.0,0.0,1.0,39,1050,800,250,0.7619047619047619,13,8,5,338.9866866789509,0.37353801169590645,-0.012673777486904125,0.20320677338077003,132210.46142578125,1163.5172526041677,133373.9786783854,2367,3,745.3076923076923,39,0,15,34.174959485465415,0.6370192307692308,42.890625,1028.4375,26.370192307692307,0
4029,4,0,0,39,0.0,0.0,1.0,39,650,600,50,0.9230769230769231,7,6,1,337.52283287934665,0.37342555105713,-0.014956183057448502,0.2026162902543187,132264.03130425327,1128.4261067708155,133392.45741102408,2368,4,746.3076923076923,39,0,15,34.1587552742616,0.6375534188034189,42.83854166666666,1028.6458333333317,26.375534188034145,0
4030,4,0,0,39,0.0,0.0,1.0,39,600,400,200,0.6666666666666666,8,4,4,338.2551167896254,0.3737629329734593,-0.012462223883851875,0.20319997161887696,132290.82031249985,1149.6093749999868,133440.42968749985,2369,5,747.3076923076923,39,0,15,34.11300121506683,0.637820512820513,42.81249999999999,1028.7499999999989,26.3782051282051,0
4031,4,0,0,39,0.0,0.0,1.0,39,1000,700,300,0.7,13,7,6,335.2309239385997,0.37244152046783624,-0.008303945152442482,0.20209986329696786,132424.80604383678,1078.5780164930518,133503.38406032984,2370,6,748.3076923076923,39,0,16,34.05620635563201,0.639155982905983,42.682291666666664,1029.2708333333333,26.391559829059826,0
4032,4,0,0,39,0.0,0.0,1.0,39,1250,1000,250,0.8,15,10,5,334.62972898499663,0.37224471434997747,-0.010790760411397482,0.20231283614780998,132532.04345703125,1069.8323567708342,133601.8758138021,2371,7,749.3076923076923,39,0,17,33.96402377339404,0.640224358974359,42.578125,1029.6875,26.40224358974359,0
4033,4,0,0,39,0.0,0.0,1.0,39,950,700,250,0.7368421052631579,12,7,5,336.87330463652484,0.3719073324336482,-0.009542776533067343,0.2041055904562472,132612.49999999985,1134.722222222208,133747.22222222207,2372,8,750.3076923076923,39,0,17,33.825512405609494,0.6410256410256412,42.49999999999999,1029.9999999999989,26.41025641025638,0
4034,4,0,0,39,0.0,0.0,1.0,39,750,700,50,0.9333333333333333,8,7,1,337.60519883587335,0.3716824111560954,-0.010989381251182095,0.20528139103154827,132746.64849175327,1163.1917317708142,133909.84022352408,2373,9,751.3076923076923,39,0,15,33.67206189561644,0.6423611111111112,42.36979166666666,1030.5208333333317,26.423611111111068,0
4035,4,0,0,39,0.0,0.0,1.0,39,400,300,100,0.75,5,3,2,337.60519883587335,0.3716824111560954,-0.010989381251182095,0.20528139103154827,132746.64849175327,1163.1917317708142,133909.84022352408,2374,10,752.3076923076923,39,0,15,33.67206189561644,0.6423611111111112,42.36979166666666,1030.5208333333317,26.423611111111068,0
4036,4,0,0,39,0.0,0.0,1.0,39,800,500,300,0.625,11,5,6,336.92807361718417,0.3714293747188484,-0.013264832907148305,0.20545761827413866,132854.01611328122,1152.4495442708346,134006.46565755206,2375,11,753.3076923076923,39,0,15,33.58183035263212,0.6434294871794872,42.265625,1030.9374999999998,26.434294871794865,0
4037,4,0,0,39,0.0,0.0,1.0,39,1000,700,300,0.7,13,7,6,337.5573921028468,0.37064215024741337,-0.010981610981610546,0.20628507295173967,132934.57031249997,1174.6093750000005,134109.17968749997,2376,12,754.3076923076923,39,0,16,33.4848484848485,0.6442307692307693,42.1875,1031.2499999999998,26.442307692307686,0
4038,4,0,0,39,0.0,0.0,1.0,39,850,500,350,0.5882352941176471,12,5,7,337.6082987545774,0.3705015744489429,-0.011393709636488891,0.2066129403132153,132988.28667534716,1179.5898437499955,134167.87651909716,2377,13,755.3076923076923,39,0,16,33.429694337844204,0.6447649572649572,42.135416666666664,1031.458333333333,26.447649572649564,0
4039,4,0,1,38,0.0,0.02564102564102564,0.9743589743589743,39,750,600,150,0.8,9,6,3,340.8880340118122,0.3703328834907782,-0.013876807091669496,0.20892048817159592,133042.01388888893,1270.486111111116,134312.50000000006,2378,14,756.3076923076923,39,0,16,33.291262789445355,0.6452991452991453,42.083333333333336,1031.666666666667,26.452991452991462,0
4040,4,0,0,38,0.0,0.0,1.0,38,1000,800,200,0.8,12,8,4,347.25278717769254,0.36828769559032715,-0.018184644078333978,0.21197575262820445,132893.25741699553,1629.5108070348592,134522.76822403038,2379,37,776.8421052631579,38,0,16,33.276344420267336,0.6455592105263157,42.22756410256411,1031.0897435897446,27.133940620782752,0
4041,4,0,1,37,0.0,0.02631578947368421,0.9736842105263158,38,1250,800,450,0.64,17,8,9,349.22201957786973,0.36747273589378854,-0.010203636680765849,0.2139649632642075,133030.99203740235,1691.4703411498344,134722.46237855218,2380,38,777.8421052631579,38,0,16,33.08737227285279,0.6469298245614035,42.0940170940171,1031.623931623932,27.147998200629793,0
4042,4,0,0,37,0.0,0.0,1.0,37,850,700,150,0.8235294117647058,10,7,3,355.8384858376188,0.3656156156156156,0.00021837699915527864,0.2176213782697429,132962.84072984013,2062.6591835949685,135025.4999134351,2381,82,798.8378378378378,37,0,16,32.98515132185129,0.6480855855855854,42.160087719298254,1031.3596491228084,27.874585111427255,0
4043,4,0,0,37,0.0,0.0,1.0,37,750,500,250,0.6666666666666666,10,5,5,354.1085579476012,0.36423923923923923,0.0037108309159319397,0.21722043874099925,133075.95245652518,2024.6667243767406,135100.6191809019,2382,83,799.8378378378378,37,0,16,32.91622387530997,0.6492117117117115,42.05043859649123,1031.7982456140357,27.886439070649615,0
4044,4,0,0,37,0.0,0.0,1.0,37,1200,1000,200,0.8333333333333334,14,10,4,354.4958656101596,0.3643330830830831,-0.00043647557459713937,0.2177881910654583,133132.52635426284,2038.9860341643582,135171.5123884272,2383,84,800.8378378378378,37,0,16,32.849465221702786,0.6497747747747746,41.99561403508772,1032.017543859649,27.892366050260787,0
4045,4,0,0,37,0.0,0.0,1.0,37,1050,800,250,0.7619047619047619,13,8,5,352.5579483285199,0.3646771771771771,-0.006108062182828444,0.2172569137082029,133245.71021852872,1995.3668436441922,135241.0770621729,2384,85,801.8378378378378,37,0,16,32.785949447748514,0.6509009009009009,41.8859649122807,1032.4561403508767,27.904220009483154,0
4046,4,0,0,37,0.0,0.0,1.0,37,650,300,350,0.46153846153846156,10,3,7,355.1457986150614,0.36505255255255253,-0.006107413562017161,0.21901820468618424,133274.01369892654,2066.3412059479797,135340.35490487452,2385,86,802.8378378378378,37,0,16,32.69076758344837,0.6511824324324325,41.858552631578945,1032.565789473684,27.907183499288756,0
4047,4,0,0,37,0.0,0.0,1.0,37,950,800,150,0.8421052631578947,11,8,3,355.68988599943214,0.3647084584584585,-0.008940150341423925,0.21985555945634194,133358.94217451522,2086.885387811636,135445.82756232686,2386,87,803.8378378378378,37,0,17,32.59156050955414,0.652027027027027,41.776315789473685,1032.8947368421052,27.916073968705547,0
4048,4,0,0,37,0.0,0.0,1.0,37,950,500,450,0.5263157894736842,14,5,9,358.75615726112596,0.36439564564564564,-0.013514947612369044,0.22225899210201128,133443.89770169675,2174.763989881509,135618.66169157825,2387,88,804.8378378378378,37,0,17,32.42719498390464,0.6528716216216215,41.694078947368425,1033.223684210527,27.92496443812235,0
4049,4,0,0,37,0.0,0.0,1.0,37,300,0,300,0.0,6,0,6,368.68014682202545,0.36439564564564564,-0.04591281298811922,0.22159617245829116,132311.09487866246,2360.6664963924736,134671.76137505495,2388,89,805.8378378378378,36,1,19,33.31007370110917,0.6435185185185186,42.792792792792795,1028.828828828829,28.578578578578586,3
4050,4,0,0,37,0.0,0.0,1.0,37,800,700,100,0.875,9,7,2,368.07925424280023,0.3644269269269269,-0.050453367673212735,0.22210616269626585,132459.27047902474,2351.158966295284,134810.42944532,2389,90,806.8378378378378,34,3,19,33.17624609691222,0.6492034313725491,42.64880952380951,1029.4047619047603,30.27661064425766,0
4051,4,0,0,37,0.0,0.0,1.0,37,1100,900,200,0.8181818181818182,13,9,4,369.80175829168786,0.3649587087087087,-0.057690565377537695,0.2238736886620987,132581.84700963704,2405.8000283446563,134987.6470379817,2390,91,807.8378378378378,34,3,20,33.00846722922205,0.6504289215686274,42.5297619047619,1029.8809523809514,30.29061624649857,0
4052,4,0,0,37,0.0,0.0,1.0,37,1000,800,200,0.8,12,8,4,373.6141588452958,0.3645207707707708,-0.06290278263476023,0.22710703363517423,132735.14739229018,2518.3460884353713,135253.49348072556,2391,92,808.8378378378378,34,3,15,32.75594000308071,0.6519607843137255,42.38095238095238,1030.4761904761901,30.30812324929971,0
4053,4,0,0,37,0.0,0.0,1.0,37,900,600,300,0.6666666666666666,12,6,6,374.05980238546107,0.36411411411411415,-0.06018414551987383,0.2278643365283798,132815.23946544906,2536.168445644702,135351.40791109376,2392,93,809.8378378378378,35,2,15,32.66384085635153,0.6505952380952382,42.30324074074073,1030.7870370370358,29.451058201058167,0
4054,4,0,0,37,0.0,0.0,1.0,37,950,700,250,0.7368421052631579,12,7,5,372.5222210265779,0.36420795795795796,-0.06325687924464807,0.22756410793464804,132920.05423920543,2503.1347648324027,135423.18900403785,2393,94,810.8378378378378,36,1,15,32.598012449492195,0.6495949074074074,42.20157657657658,1031.1936936936938,28.644269269269273,0
4055,4,0,0,37,0.0,0.0,1.0,37,1050,900,150,0.8571428571428571,12,9,3,369.29215690013524,0.3640828328328329,-0.06460521657028195,0.22611739018751612,133007.1625679734,2423.7003895787684,135430.86295755216,2394,95,811.8378378378378,36,1,15,32.59370451237263,0.650462962962963,42.11711711711712,1031.5315315315318,28.65365365365366,0
4056,4,1,1,37,0.02631578947368421,0.02631578947368421,0.9736842105263158,38,850,600,250,0.7058823529411765,11,6,5,360.6821158740963,0.3700213371266003,-0.05799422097773932,0.22243244827677566,133274.01369892654,2013.9106503924236,135287.92434931896,2395,0,791.4473684210526,37,1,16,32.54785228841456,0.6511824324324325,41.858552631578945,1032.565789473684,27.907183499288756,0
4057,4,0,0,37,0.0,0.0,1.0,37,700,300,400,0.42857142857142855,11,3,8,370.0957475065688,0.3638638638638639,-0.05726214977796906,0.22767098131847044,133181.46482631282,2457.97875578281,135639.44358209564,2396,97,813.8378378378378,36,1,16,32.39781074987272,0.6521990740740742,41.9481981981982,1032.2072072072074,28.67242242242243,0
4058,4,0,0,37,0.0,0.0,1.0,37,450,300,150,0.6666666666666666,6,3,3,372.8171862680925,0.36402027027027023,-0.05424859912808422,0.2298830383922083,133268.65875588413,2536.969275018246,135805.6280309024,2397,98,814.8378378378378,36,1,16,32.23997527901988,0.6530671296296298,41.86373873873873,1032.545045045044,28.681806806806776,0
4059,4,0,0,37,0.0,0.0,1.0,37,1100,800,300,0.7272727272727273,14,8,6,371.4327387778625,0.36439564564564564,-0.05117839959222281,0.22974730362841067,133384.9617142479,2508.7083282606736,135893.67004250857,2398,99,815.8378378378378,36,1,16,32.15891747519894,0.6542245370370372,41.75112612612612,1032.9954954954944,28.69431931931929,0
4060,4,0,1,36,0.0,0.02702702702702703,0.972972972972973,37,950,800,150,0.8421052631578947,11,8,3,369.12656875331623,0.3648023023023023,-0.049022873812644696,0.22904844484256906,133502.97796201825,2455.956301896225,135958.93426391447,2399,100,816.8378378378378,34,3,16,32.1000364781323,0.6596200980392157,41.636904761904766,1033.4523809523819,30.39565826330535,0
4061,4,0,0,36,0.0,0.0,1.0,36,800,600,200,0.75,10,6,4,369.38127501309873,0.3639880952380952,-0.03480704112151978,0.22921208919686997,133503.88259623712,2662.766874519425,136166.64947075656,2400,101,834.0555555555555,33,3,16,32.09254812443179,0.6619318181818181,41.63602941176471,1033.455882352942,31.316844919786117,0
4062,4,0,0,36,0.0,0.0,1.0,36,400,300,100,0.75,5,3,2,369.38127501309873,0.3639880952380952,-0.03480704112151978,0.22921208919686997,133503.88259623712,2662.766874519425,136166.64947075656,2401,102,835.0555555555555,33,3,16,32.09254812443179,0.6619318181818181,41.63602941176471,1033.455882352942,31.316844919786117,0
4063,4,0,1,35,0.0,0.027777777777777776,0.9722222222222222,36,1050,700,350,0.6666666666666666,14,7,7,365.30515838252273,0.3633267195767196,-0.038180050156098044,0.22724283634626274,133595.26643990938,2560.6079931972868,136155.87443310666,2402,103,836.0555555555555,34,2,17,32.10622025180409,0.6605392156862745,41.54761904761905,1033.8095238095243,30.40616246498601,0
4064,4,0,0,35,0.0,0.0,1.0,35,900,700,200,0.7777777777777778,11,7,4,368.56072695960984,0.3634453781512605,-0.031022288017107158,0.22945877517162822,133626.03635204092,2849.8618197278984,136475.89817176881,2403,104,851.1142857142858,34,1,18,31.991220495106493,0.660845588235294,41.517857142857146,1033.9285714285722,30.409663865546243,0
4065,4,0,0,35,0.0,0.0,1.0,35,1050,800,250,0.7619047619047619,13,8,5,372.2321428382341,0.3636204481792717,-0.0384064164091773,0.23310099319524005,133841.52494331068,2964.0235260770987,136805.54846938778,2404,105,852.1142857142858,34,1,16,31.680232781101402,0.6629901960784313,41.30952380952381,1034.7619047619048,30.43417366946779,0
4066,4,0,0,35,0.0,0.0,1.0,35,700,500,200,0.7142857142857143,9,5,4,372.81014675885893,0.36341036414565825,-0.03949318827956794,0.2336581547061832,133872.32320011337,2981.7920918367363,136854.11529195012,2405,106,853.1142857142858,34,1,16,31.634408911384632,0.663296568627451,41.279761904761905,1034.8809523809525,30.437675070028014,0
4067,4,0,0,35,0.0,0.0,1.0,35,750,400,350,0.5333333333333333,11,4,7,371.3665790880085,0.3632703081232493,-0.03289036544850488,0.2332515929328054,133951.04595336076,2948.9883401920424,136900.0342935528,2406,107,854.1142857142858,35,0,16,31.59287418008347,0.6619047619047618,41.2037037037037,1035.1851851851852,29.57671957671958,0
4068,4,0,0,35,0.0,0.0,1.0,35,700,500,200,0.7142857142857143,9,5,4,371.48425642699135,0.36281512605042016,-0.023449773293313436,0.23408740327526184,134070.88584533604,2961.0446673525357,137031.9305126886,2407,108,855.1142857142858,35,0,16,31.46978840709284,0.6630952380952382,41.08796296296296,1035.6481481481478,29.58994708994708,0
4069,4,0,0,35,0.0,0.0,1.0,35,850,600,250,0.7058823529411765,11,6,5,370.12196661700466,0.3617997198879552,-0.02113424264178021,0.23456774317447104,134280.73459201385,2940.0499131944393,137220.78450520828,2408,109,856.1142857142858,35,0,16,31.29501675041876,0.6651785714285714,40.885416666666664,1036.458333333333,29.61309523809523,0
4070,4,0,0,35,0.0,0.0,1.0,35,800,500,300,0.625,11,5,6,375.6472370112208,0.3609593837535014,-0.016762074848914787,0.23885192309322395,134400.72183909887,3097.4519622342214,137498.1738013331,2409,110,857.1142857142858,35,0,16,31.031760427131008,0.6663690476190476,40.769675925925924,1036.9212962962958,29.62632275132274,0
4071,4,0,0,35,0.0,0.0,1.0,35,650,400,250,0.6153846153846154,9,4,5,376.38000531989024,0.36057422969187675,-0.022035897599387955,0.23990879144216617,134490.74743870035,3123.925647290816,137614.67308599115,2410,111,858.1142857142858,35,0,17,30.922692107416488,0.6672619047619047,40.682870370370374,1037.2685185185192,29.636243386243404,0
4072,4,0,1,34,0.0,0.02857142857142857,0.9714285714285714,35,1150,900,250,0.782608695652174,14,9,5,376.7229014411581,0.3602591036414566,-0.009971327373925032,0.24136482414573465,134677.95589436768,3147.2808527762463,137825.23674714394,2411,112,859.1142857142858,33,2,18,30.726584022038566,0.673611111111111,40.50245098039216,1037.9901960784323,31.4542483660131,0
4073,4,0,0,34,0.0,0.0,1.0,34,600,400,200,0.6666666666666666,8,4,4,383.26792281940385,0.35854872251931075,-0.0069932572688360395,0.24492191210963163,134583.53261146825,3516.3101979389926,138099.84280940724,2412,113,873.5294117647059,32,2,18,30.651212784943617,0.6751302083333333,40.593434343434346,1037.626262626263,32.42582070707072,0
4074,4,0,0,34,0.0,0.0,1.0,34,500,300,200,0.6,7,3,4,380.7555010922265,0.35788027332144984,-0.010111635895233784,0.24375468995156568,134649.04729109278,3453.6730945821882,138102.72038567497,2413,114,874.5294117647059,32,2,18,30.65085158150852,0.67578125,40.53030303030303,1037.878787878788,32.433712121212125,0
4075,4,0,0,34,0.0,0.0,1.0,34,1050,900,150,0.8571428571428571,12,9,3,384.80751105971046,0.35782456922162803,-0.002628924608880201,0.2470157816896174,134747.3492022498,3570.3584136822806,138317.7076159321,2414,115,875.5294117647059,32,2,18,30.447373221452033,0.6767578125,40.43560606060606,1038.257575757576,32.44554924242425,0
4076,4,0,0,34,0.0,0.0,1.0,34,450,200,250,0.4444444444444444,7,2,5,384.95597255446705,0.3572489601901367,0.0006508926527810655,0.24733421236624514,134780.12447709424,3576.882779818396,138357.00725691265,2415,116,876.5294117647059,32,2,15,30.41073889429312,0.6770833333333333,40.40404040404041,1038.383838383839,32.44949494949497,0
4077,4,0,0,34,0.0,0.0,1.0,34,1100,800,300,0.7272727272727273,14,8,6,383.8399725471131,0.35706327985739755,-0.0029883611198486815,0.24751060298727642,134911.26543209876,3556.867283950619,138468.13271604938,2416,117,877.5294117647059,32,2,15,30.30860071301247,0.6783854166666666,40.27777777777778,1038.888888888889,32.46527777777778,0
4078,4,0,0,34,0.0,0.0,1.0,34,1050,800,250,0.7619047619047619,13,8,5,381.2111231573091,0.3567104872251931,-0.0040056600941917875,0.2464845840304644,135009.66299676054,3493.437053616981,138503.1000503775,2417,118,878.5294117647059,32,2,15,30.278570850038477,0.6793619791666666,40.18308080808081,1039.267676767677,32.4771148989899,0
4079,4,0,0,34,0.0,0.0,1.0,34,800,500,300,0.625,11,5,6,379.7317909992681,0.3568961675579323,-0.006176720657897539,0.24597418058984868,135075.28130101535,3458.475697632909,138533.75699864826,2418,119,879.5294117647059,32,2,16,30.251477792623174,0.6800130208333333,40.1199494949495,1039.520202020203,32.48500631313134,0
4080,4,0,1,33,0.0,0.029411764705882353,0.9705882352941176,34,950,600,350,0.631578947368421,13,6,7,381.7465768195857,0.3562277183600713,-0.007168113146898136,0.24772916155313543,135140.91554752065,3517.916379706147,138658.8319272268,2419,120,880.5294117647059,32,2,16,30.133576199149953,0.6806640625,40.05681818181818,1039.7727272727273,32.49289772727273,0
4081,4,0,0,33,0.0,0.0,1.0,33,750,500,250,0.6666666666666666,10,5,5,387.6650153295441,0.35353535353535354,0.00531232687506189,0.25169860263591365,135159.37805175778,3879.312472873263,139038.69052463103,2420,121,899.8787878787879,31,2,16,29.96128641789799,0.683467741935484,40.0390625,1039.8437499999998,33.543346774193544,0
4082,4,0,1,32,0.0,0.030303030303030304,0.9696969696969697,33,850,700,150,0.8235294117647058,10,7,3,392.9158445087742,0.3537326388888889,0.05516980880539468,0.24339366810108234,133439.60636988565,3886.107125548403,137325.71349543406,2421,122,900.8787878787879,32,1,18,31.549146604749676,0.6637369791666667,41.69823232323232,1033.2070707070702,32.287720959595944,5
4083,4,0,0,32,0.0,0.0,1.0,32,650,400,250,0.6153846153846154,9,4,5,392.30938728793916,0.35179351478494625,0.0657088635504599,0.2434526666852519,133505.86149427618,4075.1205444335837,137580.98203870977,2422,123,914.90625,31,1,18,31.498178362941502,0.667002688172043,41.63411458333333,1033.463541666666,33.337533602150515,0
4084,4,0,0,32,0.0,0.0,1.0,32,600,500,100,0.8333333333333334,7,5,2,394.8318232861379,0.3517305107526882,0.0696049565436454,0.24546357439848462,133573.15275404183,4147.786288791229,137720.93904283305,2423,124,915.90625,31,1,18,31.36533253558382,0.6676747311827957,41.569010416666664,1033.723958333333,33.34593413978494,0
4085,4,0,0,32,0.0,0.0,1.0,32,1150,900,250,0.782608695652174,14,9,5,396.3354852222777,0.3507644489247312,0.06342478906938664,0.24684706573726337,133640.46096801758,4193.291388617622,137833.7523566352,2424,125,916.90625,31,1,18,31.25878877555304,0.6683467741935484,41.50390625,1033.984375,33.35433467741935,0
4086,4,0,0,32,0.0,0.0,1.0,32,600,300,300,0.5,9,3,6,395.77227013703805,0.35053343413978494,0.06058769831276778,0.24672082962545958,133674.12143283416,4180.90209960937,137855.02353244353,2425,126,917.90625,31,1,19,31.239507260975408,0.6686827956989247,41.471354166666664,1034.114583333333,33.35853494623655,0
4087,4,1,1,32,0.030303030303030304,0.030303030303030304,0.9696969696969697,33,900,600,300,0.6666666666666666,12,6,6,385.233999617065,0.3556265782828283,0.05205999985214449,0.2418184019035756,133929.2626390164,3718.8211024385264,137648.08374145493,2426,0,891.060606060606,32,1,15,31.255844921525576,0.6686197916666667,41.224747474747474,1035.10101010101,32.34690656565656,0
4088,4,0,0,32,0.0,0.0,1.0,32,800,700,100,0.875,9,7,2,396.7180736184293,0.3502394153225807,0.06119464016104703,0.24866839504095228,133876.17323133675,4222.219509548608,138098.39274088535,2427,128,919.90625,31,1,15,31.0119946317732,0.6706989247311828,41.276041666666664,1034.895833333333,33.38373655913978,0
4089,4,0,0,32,0.0,0.0,1.0,32,1100,900,200,0.8181818181818182,13,9,4,396.0849649934735,0.3494833669354838,0.06684748427672971,0.24872634057647017,133943.5577392578,4210.605875651043,138154.16361490884,2428,129,920.90625,31,1,15,30.960691823899374,0.6713709677419355,41.2109375,1035.15625,33.39213709677419,0
4090,4,0,0,32,0.0,0.0,1.0,32,550,400,150,0.7272727272727273,7,4,3,394.115194183208,0.3488113239247312,0.0616825955734408,0.24794335634057507,134010.95920138882,4163.151041666658,138174.11024305547,2429,130,921.90625,31,1,15,30.94399731723675,0.6720430107526882,41.14583333333333,1035.416666666666,33.400537634408586,0
4091,4,0,0,32,0.0,0.0,1.0,32,650,500,150,0.7692307692307693,8,5,3,422.14009739892987,0.34887432795698925,0.08457476461843405,0.23795494875727402,129844.02101826353,4562.473535863699,134406.49455412725,2430,131,922.90625,32,0,16,34.445975801123225,0.6276041666666666,45.20202020202021,1019.19191919192,31.8497474747475,5
4092,4,0,0,32,0.0,0.0,1.0,32,950,600,350,0.631578947368421,13,6,7,420.92610875212046,0.3488113239247312,0.08645897832817329,0.23785712583438598,129940.55333958281,4539.074297265599,134479.6276368484,2431,132,923.90625,32,0,16,34.37822497420021,0.6285807291666666,45.10732323232324,1019.570707070708,31.861584595959624,0
4093,4,1,0,33,0.030303030303030304,0.0,1.0,33,850,400,450,0.47058823529411764,13,4,9,412.32819658475614,0.358230744949495,0.0942486085343226,0.23493118177503566,130262.58680555563,4142.18750000001,134404.77430555565,2432,0,896.8787878787879,33,0,17,34.2687074829932,0.6294191919191918,44.79166666666667,1020.833333333334,30.934343434343457,0
4094,4,0,0,33,0.0,0.0,1.0,33,450,400,50,0.8888888888888888,5,4,1,410.64083455465203,0.358230744949495,0.09249479916786685,0.2343465365417371,130325.14537677822,4103.365292195317,134428.51066897353,2433,1,897.8787878787879,33,0,18,34.24797967674828,0.630050505050505,44.73039215686275,1021.0784313725495,30.941770647653016,0
4095,4,0,0,33,0.0,0.0,1.0,33,1000,800,200,0.8,12,8,4,408.86915598284054,0.35767834595959597,0.092214284415844,0.23390009712539306,130419.01139285375,4064.8622224625174,134483.87361531626,2434,2,898.8787878787879,33,0,18,34.19753549290143,0.6309974747474747,44.638480392156865,1021.4460784313728,30.95291146761736,0
4096,4,1,1,33,0.029411764705882353,0.029411764705882353,0.9705882352941176,34,550,500,50,0.9090909090909091,6,5,1,401.7259049809069,0.3649175579322638,0.08497531041756567,0.2314167537143535,130688.28125000001,3700.173611111112,134388.45486111112,2435,0,873.4117647058823,34,0,13,34.105881553925556,0.6314338235294117,44.375,1022.5000000000001,30.07352941176471,0
4097,4,0,0,33,0.0,0.0,1.0,33,750,600,150,0.8,9,6,3,412.1468292991505,0.3573232323232323,0.09117069980379311,0.23672896393628887,130575.52984429065,4163.2581218762,134738.78796616686,2436,4,900.8787878787879,33,0,14,33.95433653077538,0.6325757575757576,44.48529411764706,1022.0588235294117,30.971479500891263,0
4098,4,1,0,34,0.029411764705882353,0.0,1.0,34,550,300,250,0.5454545454545454,8,3,5,403.5536741157556,0.3626151218062983,0.09232016640551777,0.2339413982719591,130931.84700963729,3767.6055839002356,134699.4525935375,2437,0,875.3529411764706,34,0,16,33.811455546508455,0.6338848039215685,44.136904761904766,1023.4523809523818,30.101540616246524,0
4099,4,1,0,35,0.02857142857142857,0.0,1.0,35,350,300,50,0.8571428571428571,4,3,1,400.33090931134666,0.3688025210084034,0.1107225797889988,0.23485352799654752,131389.1439909297,3520.4258786848063,134909.5698696145,2438,0,851.3142857142857,34,1,17,33.429613717293705,0.6384803921568627,43.69047619047619,1025.2380952380952,30.15406162464986,0
4100,4,1,1,35,0.027777777777777776,0.027777777777777776,0.9722222222222222,36,550,400,150,0.7272727272727273,7,4,3,390.5310268512075,0.3740575396825397,0.10761813465659209,0.23070210626846496,131654.57182623894,3083.03902499144,134737.6108512304,2439,0,828.6388888888889,35,1,13,33.411925303560025,0.6389880952380952,43.43171296296297,1026.273148148149,29.32208994708997,0
4101,4,0,0,35,0.0,0.0,1.0,35,900,600,300,0.6666666666666666,12,6,6,400.3666000936688,0.3689775910364146,0.1050712628438848,0.2363808282744811,131633.3616780045,3540.3202947845743,135173.68197278908,2440,2,853.3142857142857,34,1,13,33.18107115235886,0.6409313725490196,43.45238095238095,1026.190476190476,30.182072829131645,0
4102,4,0,0,35,0.0,0.0,1.0,35,500,300,200,0.6,7,3,4,400.6570576126,0.36904761904761907,0.10758446981622893,0.23674191183538218,131663.90483276654,3550.414540816334,135214.31937358287,2441,3,854.3142857142857,34,1,13,33.14266519738622,0.6412377450980392,43.42261904761905,1026.3095238095245,30.1855742296919,0
4103,4,0,0,35,0.0,0.0,1.0,35,800,600,200,0.75,10,6,4,399.2315145937736,0.36852240896358546,0.1098258809496202,0.23627819837626002,131725.00177154187,3517.7543934240275,135242.7561649659,2442,4,855.3142857142857,34,1,14,33.11734121921992,0.6418504901960784,43.363095238095234,1026.5476190476184,30.192577030812306,0
4104,4,1,1,35,0.027777777777777776,0.027777777777777776,0.9722222222222222,36,800,600,200,0.75,10,6,4,387.80131482834196,0.3729166666666666,0.1033783783783786,0.23142981691368789,132040.8950617283,3041.126543209866,135082.02160493817,2443,0,832.5277777777778,35,1,16,33.09121621621622,0.6428571428571428,43.05555555555555,1027.7777777777771,29.365079365079346,0
4105,4,0,0,35,0.0,0.0,1.0,35,550,200,350,0.36363636363636365,9,2,7,394.35121439832704,0.36775210084033616,0.1059164359750211,0.2346019691018464,131921.96609224955,3404.717506858699,135326.68359910825,2444,1,857.1428571428571,35,0,16,33.04322517650593,0.6416666666666667,43.17129629629629,1027.314814814814,29.35185185185183,0
4106,4,0,0,35,0.0,0.0,1.0,35,800,600,200,0.75,10,6,4,394.8566013657884,0.36775210084033616,0.1297717504837248,0.22734911146961867,130669.4859699395,3337.25310903986,134006.73907897936,2445,2,858.1428571428571,33,2,17,34.30058631986895,0.6335227272727272,44.39338235294118,1022.4264705882358,30.98262032085563,3
4107,4,0,1,34,0.0,0.02857142857142857,0.9714285714285714,35,950,600,350,0.631578947368421,13,6,7,396.4145333356069,0.36827731092436977,0.13197453076424392,0.22907801512796705,130810.03578514744,3370.9998582766543,134181.03564342408,2446,3,859.1428571428571,34,1,17,34.117886651926,0.6326593137254901,44.25595238095239,1022.9761904761908,30.087535014005613,0
4108,4,0,0,34,0.0,0.0,1.0,34,900,500,400,0.5555555555555556,13,5,8,405.5960371765724,0.36668152109328583,0.13008391627537685,0.23456879835097316,130840.48327664383,3813.6763038548565,134654.1595804987,2447,4,876.5,34,0,17,33.85210612054921,0.6329656862745099,44.22619047619047,1023.0952380952369,30.091036414565792,0
4109,4,0,0,34,0.0,0.0,1.0,34,1650,1400,250,0.8484848484848485,19,14,5,406.86858784904985,0.36762849079025545,0.1325530793915799,0.23586306471600008,130931.84700963713,3854.4111394557763,134786.2581490929,2448,5,877.5,34,0,17,33.72663913768368,0.6338848039215685,44.13690476190476,1023.4523809523805,30.101540616246485,0
4110,4,0,0,34,0.0,0.0,1.0,34,600,300,300,0.5,9,3,6,406.38910437579915,0.36746137849079025,0.1288261291955719,0.23577149253867216,130962.30867346935,3844.3310657596303,134806.639739229,2449,6,878.5,34,0,17,33.70793595409785,0.6341911764705883,44.107142857142854,1023.5714285714283,30.105042016806717,0
4111,4,0,0,34,0.0,0.0,1.0,34,800,500,300,0.625,11,5,6,404.4077879935099,0.36760992275698157,0.1232900136798909,0.23499371464487748,131023.24263038555,3797.363945578238,134820.6065759638,2450,7,879.5,34,0,17,33.69670542635659,0.6348039215686274,44.04761904761905,1023.8095238095242,30.11204481792718,0
4112,4,0,0,34,0.0,0.0,1.0,34,600,300,300,0.5,9,3,6,403.89997994111724,0.36733140225787286,0.12124103216452298,0.23488463336535162,131053.71492346942,3786.5185657596435,134840.23348922905,2451,8,880.5,34,0,17,33.678738906328725,0.635110294117647,44.017857142857146,1023.9285714285717,30.115546218487403,0
4113,4,1,1,34,0.02857142857142857,0.02857142857142857,0.9714285714285714,35,600,400,200,0.6666666666666666,8,4,4,396.6394277797865,0.37331932773109244,0.11570557294523853,0.2319580907240576,131268.81456832998,3413.2774991426677,134682.09206747264,2452,0,856.3142857142857,35,0,17,33.64628040057225,0.6351190476190476,43.807870370370374,1024.7685185185192,29.279100529100546,0
4114,4,1,0,35,0.02857142857142857,0.0,1.0,35,800,500,300,0.625,11,5,6,394.85569759517495,0.37118347338935576,0.1174165406127976,0.2320562934781485,131457.57607642087,3381.394768922397,134838.97084534325,2453,0,857.2857142857143,32,3,19,33.500574571123686,0.6438802083333333,43.62373737373738,1025.5050505050513,32.04703282828285,0
4115,4,1,0,36,0.027777777777777776,0.0,1.0,36,650,400,250,0.6153846153846154,9,4,5,383.34254190851027,0.377744708994709,0.11058074781225136,0.2275078258635494,131831.05656478286,2907.290465205702,134738.34702998857,2454,0,834.4444444444445,33,3,17,33.417859984089084,0.6452020202020201,43.25980392156863,1026.9607843137262,31.120023767082614,0
4116,4,0,0,36,0.0,0.0,1.0,36,850,400,450,0.47058823529411764,13,4,9,383.2889667688182,0.37743055555555555,0.10617734522844025,0.228306906292731,131969.53125000012,2916.49305555557,134886.02430555568,2455,1,835.4444444444445,34,2,17,33.27926466612599,0.6443014705882353,43.12500000000001,1027.500000000001,30.220588235294144,0
4117,4,1,1,36,0.02702702702702703,0.02702702702702703,0.972972972972973,37,850,500,350,0.5882352941176471,12,5,7,376.0882877270472,0.38379004004004,0.10580288851921571,0.22567836684876905,132249.14969403722,2547.471252357683,134796.6209463949,2456,0,813.8378378378378,35,2,17,33.18201211507444,0.6449404761904761,42.85300925925926,1028.587962962963,29.388227513227516,0
4118,4,1,1,36,0.02702702702702703,0.02702702702702703,0.972972972972973,37,550,300,250,0.5454545454545454,8,3,5,370.6010588601681,0.38078703703703703,0.10395010395010384,0.22326454033771118,132398.0034722223,2413.4517800497306,134811.45525227205,2457,0,814.8108108108108,34,3,18,33.17307692307691,0.6485906862745099,42.708333333333336,1029.1666666666672,30.26960784313727,0
4119,4,0,0,36,0.0,0.0,1.0,36,700,500,200,0.7142857142857143,9,5,4,381.339319178297,0.3763723544973545,0.11086418363902317,0.22882934027937393,132249.14969403733,2886.360141246586,135135.5098352839,2458,1,838.0555555555555,35,1,18,33.046983421477066,0.644940476190476,42.85300925925927,1028.587962962964,29.38822751322754,0
4120,4,1,1,36,0.02702702702702703,0.02702702702702703,0.972972972972973,37,1050,700,350,0.6666666666666666,14,7,7,377.9809595626356,0.38006756756756754,0.10670865039797084,0.2290119931467732,132612.49999999988,2625.167448988326,135237.6674489882,2459,0,816.3783783783783,34,3,18,32.76699029126213,0.6507352941176471,42.49999999999999,1029.999999999999,30.294117647058798,0
4121,4,0,0,36,0.0,0.0,1.0,36,1000,800,200,0.8,12,8,4,374.87709847195356,0.37592592592592594,0.07175953625038245,0.21831692766063562,131108.39468293474,2666.7124723664347,133775.10715530117,2460,3,840.0555555555555,33,3,18,34.36627477962588,0.637941919191919,43.964460784313744,1024.1421568627475,31.03461081402265,7
4122,4,0,1,35,0.0,0.027777777777777776,0.9722222222222222,36,750,600,150,0.8,9,6,3,374.99312501512566,0.3755952380952381,0.0699678324095121,0.21874162819270332,131171.156000697,2637.656340109593,133808.8123408066,2461,4,841.0555555555555,33,3,18,34.299731825976,0.6385732323232322,43.903186274509814,1024.387254901962,31.042038027332183,0
4123,4,2,2,35,0.05405405405405406,0.05405405405405406,0.9459459459459459,37,650,500,150,0.7692307692307693,8,5,3,363.7881652254819,0.3808495995995996,0.0855808819609718,0.21461260753445793,131602.82206632663,2175.1098356009143,133777.93190192754,2462,0,819.081081081081,34,3,17,34.15032679738562,0.640625,43.48214285714286,1026.0714285714294,30.178571428571452,0
4124,4,0,0,35,0.0,0.0,1.0,35,750,500,250,0.6666666666666666,10,5,5,382.23868307133023,0.37058823529411766,0.08997095326115678,0.2233165524207233,131231.0785410928,3032.31892791553,134263.39746900834,2463,1,866.6285714285714,32,3,19,34.05345040049292,0.6416015625,43.844696969696976,1024.6212121212127,32.0194128787879,0
4125,4,1,0,36,0.027777777777777776,0.0,1.0,36,750,600,150,0.8,9,6,3,372.37425597616436,0.3758267195767196,0.09377031994373453,0.2197244288434411,131610.9057363757,2601.702620386422,134212.6083567621,2464,0,843.5277777777778,33,3,18,33.921906723993786,0.6429924242424241,43.47426470588237,1026.1029411764728,31.094028520499176,0
4126,4,1,0,37,0.02702702702702703,0.0,1.0,37,700,300,400,0.42857142857142855,11,3,8,360.31373099827323,0.3801926926926927,0.09061395462414779,0.2149681022604077,132030.69905045375,2114.4947562358543,134145.1938066896,2465,0,821.7027027027027,34,3,19,33.807772500868744,0.6449142156862744,43.065476190476204,1027.7380952380972,30.227591036414623,0
4127,4,0,0,37,0.0,0.0,1.0,37,800,500,300,0.625,11,5,6,360.31373099827323,0.3801926926926927,0.09061395462414779,0.2149681022604077,132030.69905045375,2114.4947562358543,134145.1938066896,2466,1,822.7027027027027,34,3,19,33.807772500868744,0.6449142156862744,43.065476190476204,1027.7380952380972,30.227591036414623,0
4128,4,1,1,37,0.02631578947368421,0.02631578947368421,0.9736842105263158,38,1000,800,200,0.8,12,8,4,353.93163031224015,0.3827643432906591,0.09515718429933084,0.21288580470066415,132338.45191400903,1767.7528077846478,134106.20472179368,2467,0,802.0263157894736,35,3,20,33.661886014248225,0.6458333333333333,42.76620370370371,1028.935185185186,29.39814814814817,0
4129,4,1,1,37,0.02631578947368421,0.02631578947368421,0.9736842105263158,38,650,500,150,0.7692307692307693,8,5,3,352.7480662741618,0.3812233285917497,0.10521143302237568,0.2132018186726224,132520.55165816328,1749.2870637195233,134269.8387218828,2468,0,803.0,34,4,21,33.509172544032054,0.6498161764705883,42.589285714285715,1029.6428571428573,30.28361344537816,0
4130,4,0,0,37,0.0,0.0,1.0,37,1000,800,200,0.8,12,8,4,361.71201814058946,0.37875375375375375,0.10651222651222647,0.21827449370552812,132461.0726643599,2182.55238369858,134643.6250480585,2469,1,825.4054054054054,33,4,21,33.338293650793645,0.6515151515151515,42.64705882352941,1029.4117647058827,31.19429590017826,0
4131,4,0,0,37,0.0,0.0,1.0,37,600,400,200,0.6666666666666666,8,4,4,358.66216712887154,0.37875375375375375,0.1038275269489144,0.2169529892073245,132551.19756235828,2108.2199546485276,134659.4175170068,2470,2,826.4054054054054,34,3,22,33.32610789980731,0.6501225490196079,42.55952380952381,1029.7619047619048,30.287114845938376,0
4132,4,0,0,37,0.0,0.0,1.0,37,1000,700,300,0.7,13,7,6,358.338738622761,0.378440940940941,0.10727632046288682,0.21776722115757274,132725.77649444874,2112.157466349454,134837.9339607982,2471,3,827.4054054054054,35,2,19,33.15888370961098,0.649702380952381,42.3900462962963,1030.439814814815,29.44113756613757,0
4133,4,0,0,37,0.0,0.0,1.0,37,700,500,200,0.7142857142857143,9,5,4,358.02391719052355,0.3775025025025025,0.1042973822497848,0.21844363385843715,132874.89819101503,2114.4783093278393,134989.37650034289,2472,4,828.4054054054054,35,2,19,33.01713815297111,0.6511904761904762,42.24537037037037,1031.018518518518,29.457671957671945,0
4134,4,0,0,37,0.0,0.0,1.0,37,1000,800,200,0.8,12,8,4,358.2457031132479,0.3773460960960961,0.1008956437078985,0.21910277696926211,132964.41139671204,2126.785809970839,135091.19720668287,2473,5,829.4054054054054,35,2,19,32.921506190850266,0.6520833333333333,42.15856481481481,1031.36574074074,29.46759259259257,0
4135,4,0,0,37,0.0,0.0,1.0,37,750,600,150,0.8,9,6,3,358.0570886796071,0.37728353353353355,0.10295375025013853,0.21951312850687865,133053.9547432269,2128.182334533594,135182.1370777605,2474,6,830.4054054054054,35,2,19,32.83645576247103,0.6529761904761905,42.07175925925925,1031.712962962962,29.477513227513196,0
4136,4,0,0,37,0.0,0.0,1.0,37,800,500,300,0.625,11,5,6,360.6088132681904,0.3772522522522523,0.0920216022256839,0.22178685494660158,133173.39275763032,2204.699824245543,135378.09258187586,2475,7,831.4054054054054,35,2,19,32.65072512521491,0.6541666666666666,41.95601851851852,1032.175925925926,29.490740740740744,0
4137,4,0,0,37,0.0,0.0,1.0,37,700,400,300,0.5714285714285714,10,4,6,359.18625856726715,0.3765953453453454,0.09409005372678458,0.22108918151562815,133203.26063368033,2168.9561631944202,135372.21679687474,2476,8,832.4054054054054,35,2,19,32.657458795829136,0.6544642857142857,41.92708333333332,1032.291666666665,29.49404761904757,0
4138,4,1,1,37,0.02631578947368421,0.02631578947368421,0.9736842105263158,38,750,400,350,0.5333333333333333,11,4,7,350.35888602632724,0.3787932669511617,0.09444715330560749,0.217052179560537,133443.1322158307,1750.5974302004706,135193.72964603116,2477,0,811.4736842105264,36,2,19,32.64486830154405,0.6548032407407407,41.69481981981982,1033.2207207207207,28.700575575575574,0
4139,4,0,0,37,0.0,0.0,1.0,37,1200,900,300,0.75,15,9,6,360.3723778789323,0.37596971971971976,0.10877424590173912,0.22307100173005157,133412.42953746545,2215.6308942043624,135628.06043166982,2478,10,834.4054054054054,35,2,20,32.417002763462555,0.6565476190476192,41.724537037037024,1033.1018518518497,29.517195767195705,0
4140,4,0,0,37,0.0,0.0,1.0,37,750,600,150,0.8,9,6,3,361.80536027953553,0.3758133133133133,0.11214687298478054,0.2241385462328531,133442.32420535403,2256.0296371313357,135698.35384248538,2479,11,835.4054054054054,35,2,20,32.350010268473895,0.6568452380952381,41.69560185185185,1033.2175925925922,29.52050264550263,0
4141,4,0,0,37,0.0,0.0,1.0,37,850,400,450,0.47058823529411764,13,4,9,356.4755271906623,0.3752815315315315,0.11331259607121691,0.2217297638486766,133591.84777949253,2124.444873113865,135716.29265260638,2480,12,836.4054054054054,35,2,20,32.33784893267653,0.6583333333333332,41.55092592592593,1033.7962962962968,29.53703703703705,0
4142,4,1,0,38,0.02631578947368421,0.0,1.0,38,900,600,300,0.6666666666666666,12,6,6,385.1271121743662,0.37923779042200095,0.17864193803130912,0.21927086336359633,130233.84871357837,2431.317212482739,132665.1659260611,2481,0,815.3684210526316,36,2,19,34.99213923212709,0.6226851851851853,44.81981981981981,1020.7207207207201,28.353353353353338,6
4143,4,1,1,38,0.02564102564102564,0.02564102564102564,0.9743589743589743,39,1100,800,300,0.7272727272727273,14,8,6,375.58584819387306,0.3839968511021143,0.17355740966852085,0.2151082585110362,130463.84222059889,2000.0777382111746,132463.91995881006,2482,0,795.4358974358975,36,3,19,35.00192901234568,0.625,44.59459459459459,1021.6216216216209,28.378378378378358,0
4144,4,0,0,38,0.0,0.0,1.0,38,1000,600,400,0.6,14,6,8,383.3692031900681,0.37931187766714086,0.1774124297828188,0.2194303882850545,130439.87509645053,2401.3261959876436,132841.20129243817,2483,2,817.3684210526316,35,3,19,34.82749830047587,0.6267857142857144,44.61805555555555,1021.527777777777,29.186507936507915,0
4145,4,2,3,37,0.05,0.075,0.925,40,850,500,350,0.5882352941176471,12,5,7,372.45569402572835,0.385803952991453,0.17033861980282938,0.21561765115682946,130878.94833025517,1749.3219067405034,132628.27023699568,2484,0,777.45,37,3,16,34.66075510787255,0.6272522522522523,44.188596491228054,1023.2456140350854,27.655286865813117,0
4146,4,0,0,37,0.0,0.0,1.0,37,1100,700,400,0.6363636363636364,15,7,8,394.6184748147188,0.3768455955955956,0.19948295026938867,0.22625319768435076,130505.75573979595,2899.9964569161048,133405.75219671204,2485,4,841.0540540540541,34,3,16,34.473183424599014,0.629595588235294,44.55357142857143,1021.7857142857146,30.05252100840337,0
4147,4,0,0,37,0.0,0.0,1.0,37,900,700,200,0.7777777777777778,11,7,4,396.5184493463481,0.37678303303303307,0.19784778373342515,0.22805786500583336,130627.4252409297,2959.236819727894,133586.6620606576,2486,5,842.0540540540541,34,3,16,34.30088117697295,0.6308210784313726,44.43452380952381,1022.2619047619047,30.066526610644257,0
4148,4,1,0,38,0.02631578947368421,0.0,1.0,38,600,400,200,0.6666666666666666,8,4,4,384.80293949835396,0.3823346372688478,0.1959831445627529,0.22313523894976672,130942.84664619765,2477.438459147801,133420.28510534545,2487,0,820.8684210526316,35,3,17,34.280056730370546,0.6318452380952382,44.126157407407405,1023.4953703703699,29.242724867724853,0
4149,4,0,0,38,0.0,0.0,1.0,38,650,600,50,0.9230769230769231,7,6,1,384.0609460407351,0.3822605500237079,0.19542240948368206,0.2228763127811195,130972.4633487654,2460.2816358024693,133432.74498456786,2488,1,821.8684210526316,35,3,17,34.2689959294437,0.6321428571428571,44.09722222222222,1023.611111111111,29.246031746031743,0
4150,4,1,1,38,0.02564102564102564,0.02564102564102564,0.9743589743589743,39,1050,600,450,0.5714285714285714,15,6,9,371.6671130373644,0.3830690508322087,0.18571505026519874,0.21785484417122533,131356.98356718212,1964.2141719422236,133321.19773912436,2489,0,801.7692307692307,36,3,17,34.196830715148856,0.6339699074074073,43.72184684684685,1025.1126126126132,28.475350350350368,0
4151,4,0,0,38,0.0,0.0,1.0,38,1050,800,250,0.7619047619047619,13,8,5,378.3327124978993,0.3807195353247985,0.1897244239521816,0.22193848790108542,131387.44882758908,2341.6339806241363,133729.08280821322,2490,3,823.8684210526316,35,3,18,33.99516444645142,0.6363095238095239,43.692129629629626,1025.2314814814808,29.292328042328023,0
4152,4,0,0,38,0.0,0.0,1.0,38,900,500,400,0.5555555555555556,13,5,8,379.9583279210458,0.3797564011379801,0.19189648311049612,0.22341146275437196,131476.45968632106,2391.1151566786607,133867.57484299972,2491,4,824.8684210526316,35,3,19,33.863394838806755,0.637202380952381,43.60532407407407,1025.578703703703,29.302248677248656,0
4153,4,0,0,38,0.0,0.0,1.0,38,950,700,250,0.7368421052631579,12,7,5,378.85773306051203,0.3796230440967283,0.18786813604408148,0.22328423842076953,131565.50068587085,2368.921467764033,133934.4221536349,2492,5,825.8684210526316,35,3,17,33.80151925391095,0.6380952380952382,43.518518518518505,1025.925925925924,29.31216931216926,0
4154,4,0,0,38,0.0,0.0,1.0,38,800,700,100,0.875,9,7,2,379.6165267680227,0.3791488857278331,0.18910206940767216,0.22407990188583798,131624.8780971363,2393.395811899844,134018.27390903616,2493,6,826.8684210526316,35,3,17,33.72199037521618,0.6386904761904763,43.46064814814814,1026.157407407406,29.31878306878303,0
4155,4,2,0,40,0.05,0.0,1.0,40,1000,500,500,0.5,15,5,10,383.7271863620285,0.3857371794871795,0.18201396973224648,0.22122258596307554,130718.71456916102,2109.265590881414,132827.98016004244,2494,0,786.475,34,6,15,34.53506984866124,0.6317401960784315,44.345238095238095,1022.6190476190478,30.077030812324935,6
4156,4,2,1,41,0.047619047619047616,0.023809523809523808,0.9761904761904762,42,750,400,350,0.5333333333333333,11,4,7,370.465628843044,0.39384920634920634,0.17936342420179718,0.21636817177861134,131218.6392815402,1322.3991434728941,132541.0384250131,2495,0,749.9761904761905,38,4,16,34.367613833854705,0.6288377192982455,43.85683760683762,1024.572649572652,26.962438146648736,0
4157,4,1,0,42,0.023809523809523808,0.0,1.0,42,1150,900,250,0.782608695652174,14,9,5,370.95118956020144,0.3940064847077042,0.1905084381382347,0.21794612330924307,131446.78605109744,1352.205301194796,132798.99135229224,2496,0,750.952380952381,35,7,17,34.12434161023325,0.6369047619047619,43.63425925925926,1025.4629629629633,29.298941798941808,0
4158,4,0,0,42,0.0,0.0,1.0,42,850,600,250,0.7058823529411765,11,6,5,367.2449789771257,0.3942242547425474,0.1914513520628831,0.21627191021091452,131535.81700370798,1261.173670053153,132796.99067376115,2497,1,751.952380952381,35,7,17,34.12936270638235,0.6377976190476191,43.5474537037037,1025.810185185185,29.30886243386243,0
4159,4,0,0,42,0.0,0.0,1.0,42,1200,900,300,0.75,15,9,6,365.71929191682324,0.39451461478900507,0.18479574570945112,0.2157086841545336,131595.18771701396,1225.379774305561,132820.56749131953,2498,2,752.952380952381,35,7,14,34.10850253807106,0.6383928571428571,43.489583333333336,1026.0416666666672,29.315476190476204,0
4160,4,0,0,42,0.0,0.0,1.0,42,700,400,300,0.5714285714285714,10,4,6,364.77795652024105,0.3942363530778165,0.18098568098568046,0.21532099617233416,131624.8780971366,1202.770811899872,132827.64890903648,2499,3,753.952380952381,35,7,14,34.10265809459357,0.6386904761904761,43.46064814814815,1026.1574074074083,29.318783068783095,0
4161,4,0,1,41,0.0,0.023809523809523808,0.9761904761904762,42,1050,800,250,0.7619047619047619,13,8,5,365.1934982576752,0.39465979481223384,0.18129658356706746,0.2163397741140497,131761.33639974432,1223.676674985795,132985.01307473012,2500,4,754.952380952381,36,6,14,33.95419728711929,0.6380208333333334,43.3277027027027,1026.6891891891892,28.519144144144143,0
4162,4,0,2,39,0.0,0.04878048780487805,0.9512195121951219,41,1200,1000,200,0.8333333333333334,14,10,4,375.41845192172053,0.3903455284552846,0.17904143866692346,0.22229383635151265,131743.67310742452,1691.8011616940967,133435.47426911863,2501,6,774.2682926829268,35,6,14,33.70960165351372,0.6398809523809523,43.344907407407405,1026.62037037037,29.33201058201057,0
4163,4,1,1,39,0.025,0.025,0.975,40,750,400,350,0.5333333333333333,11,4,7,380.99615286722155,0.38418803418803416,0.1795331529093369,0.22524492557510156,131684.268904321,2034.239969135806,133718.50887345683,2502,0,794.1,35,5,15,33.62652232746956,0.6392857142857142,43.40277777777778,1026.3888888888891,29.325396825396833,0
4164,4,1,1,39,0.025,0.025,0.975,40,950,500,450,0.5263157894736842,14,5,9,381.01232734989406,0.3857772435897436,0.17640940354042223,0.22543017553477043,131713.96933138277,2036.9291998885383,133750.89853127132,2503,0,795.075,35,5,15,33.59606964332695,0.6395833333333334,43.37384259259259,1026.5046296296289,29.32870370370368,0
4165,4,0,0,39,0.0,0.0,1.0,39,750,500,250,0.6666666666666666,10,5,5,390.43796140077154,0.38031376518218624,0.18109624976577798,0.2307036096803325,131663.9048327664,2481.3173185940977,134145.22215136047,2504,10,816.4615384615385,34,5,15,33.40486409155937,0.6412377450980392,43.422619047619044,1026.3095238095234,30.185574229691866,0
4166,4,0,0,39,0.0,0.0,1.0,39,900,500,400,0.5555555555555556,13,5,8,389.6103896103899,0.38020130454340983,0.1782800532800537,0.2307692307692308,131755.55555555545,2466.6666666666583,134222.2222222221,2505,11,817.4615384615385,34,5,16,33.333333333333336,0.6421568627450981,43.33333333333333,1026.6666666666658,30.196078431372523,0
4167,4,0,1,38,0.0,0.02564102564102564,0.9743589743589743,39,1000,800,200,0.8,12,8,4,389.83908594563246,0.38025753486279806,0.18089145472512613,0.23155502333879124,131862.52170138885,2481.0329861111068,134343.55468749994,2506,12,818.4615384615385,35,4,16,33.219235970250175,0.6410714285714285,43.229166666666664,1027.083333333333,29.345238095238088,0
4168,4,0,0,38,0.0,0.0,1.0,38,900,600,300,0.6666666666666666,12,6,6,403.9701850399996,0.37516299193930774,0.19223163579960834,0.22012885898820697,128506.39349489789,2783.6353812358193,131290.0288761337,2507,13,840.6842105263158,34,4,13,36.27793432742359,0.609375,46.51785714285714,1013.9285714285709,29.821428571428555,8
4169,4,1,1,38,0.02564102564102564,0.02564102564102564,0.9743589743589743,39,650,500,150,0.7692307692307693,8,5,3,396.7646118599818,0.3789642375168691,0.19036589930750525,0.2174270072992701,128731.13854595338,2415.1920438957495,131146.33058984912,2508,0,820.1025641025641,35,4,13,36.23023114355231,0.6095238095238095,46.2962962962963,1014.814814814815,28.994708994709,0
4170,4,2,1,39,0.05,0.025,0.975,40,800,600,200,0.75,10,6,4,390.6650194519686,0.38331997863247863,0.20175346260387794,0.21617117109466685,129115.53603857239,2088.1846796120503,131203.72071818443,2509,0,800.55,36,4,15,35.99168975069252,0.611400462962963,45.917792792792795,1016.3288288288292,28.231356356356365,0
4171,4,1,1,39,0.025,0.025,0.975,40,900,800,100,0.8888888888888888,10,8,2,391.7766518629721,0.38457532051282056,0.1959577332865008,0.2174245863262927,129231.64859693879,2126.0455876105048,131357.6941845493,2510,0,801.525,34,6,15,35.844748858447495,0.6167279411764706,45.80357142857143,1016.7857142857144,29.905462184873954,0
4172,4,1,1,39,0.025,0.025,0.975,40,800,700,100,0.875,9,7,2,388.64566174806487,0.38607104700854705,0.1978203627852544,0.21635030486235923,129352.72285997737,2054.474914965989,131407.19777494334,2511,0,802.5,34,6,15,35.800663155841626,0.617953431372549,45.68452380952381,1017.261904761905,29.919467787114854,0
4173,4,0,0,39,0.0,0.0,1.0,39,700,200,500,0.2857142857142857,12,2,10,398.0784735286215,0.38076360773729195,0.2091214796132832,0.22075260804769,129201.38888888882,2486.458333333325,131687.84722222213,2512,3,824.0769230769231,33,6,15,35.71550546448088,0.6186868686868687,45.83333333333333,1016.6666666666661,30.80808080808079,0
4174,4,3,1,41,0.07142857142857142,0.023809523809523808,0.9761904761904762,42,1050,800,250,0.7619047619047619,13,8,5,376.8458011100877,0.39336527293844364,0.21918427415116182,0.21392374423918525,130118.92804967133,1406.9543360928565,131525.88238576418,2513,0,766.1428571428571,36,6,15,35.3203182487123,0.6215277777777778,44.932432432432435,1020.2702702702707,28.34084084084085,0
4175,4,0,0,41,0.0,0.0,1.0,41,950,600,350,0.631578947368421,13,6,7,390.64190687412787,0.38912601626016263,0.23291105613574858,0.22156484988343397,130085.41907793214,1963.363233024694,132048.78231095683,2514,1,785.829268292683,35,6,15,35.002552756977536,0.6232142857142857,44.96527777777778,1020.1388888888891,29.146825396825403,0
4176,4,3,3,41,0.06818181818181818,0.06818181818181818,0.9318181818181819,44,1450,1100,350,0.7586206896551724,18,11,7,369.9286710869726,0.4004911028893587,0.21831246831246887,0.21291450180339067,130654.6485457062,866.7006648412992,131521.3492105475,2515,0,733.1818181818181,37,7,11,34.95280995280994,0.625,44.407894736842096,1022.3684210526301,27.631578947368382,0
4177,4,0,0,41,0.0,0.0,1.0,41,1000,700,300,0.7,13,7,6,393.3658863205897,0.38983739837398373,0.23725306883370467,0.22378712164999742,130203.5175004286,2043.5244127228955,132247.0419131515,2516,3,787.829268292683,35,6,15,34.81278823618356,0.6244047619047619,44.84953703703703,1020.6018518518513,29.160052910052894,0
4178,4,1,0,42,0.023809523809523808,0.0,1.0,42,1100,900,200,0.8181818181818182,13,9,4,388.33908832061474,0.3942000580720093,0.22848892699419276,0.2231244299908489,130587.70743580669,1742.475646219128,132330.18308202582,2517,0,770.047619047619,35,7,13,34.550282150001884,0.6282738095238095,44.473379629629626,1022.106481481481,29.20304232804231,0
4179,4,0,1,41,0.0,0.023809523809523808,0.9761904761904762,42,750,400,350,0.5333333333333333,11,4,7,388.33908832061474,0.3942000580720093,0.22848892699419276,0.2231244299908489,130587.70743580669,1742.462250300061,132330.16968610676,2518,1,771.047619047619,35,7,13,34.550282150001884,0.6282738095238095,44.473379629629626,1022.106481481481,29.20304232804231,0
4180,4,2,1,42,0.046511627906976744,0.023255813953488372,0.9767441860465116,43,1050,700,350,0.6666666666666666,14,7,7,382.0101704249297,0.39846345514950166,0.2254552525797855,0.22157565022285824,130953.25213304527,1405.0948330086899,132358.34696605397,2519,0,752.7674418604652,36,7,14,34.3409616019364,0.6299189814814814,44.115990990990994,1023.5360360360366,28.431556556556572,0
4181,4,0,1,41,0.0,0.023809523809523808,0.9761904761904762,42,950,600,350,0.631578947368421,13,6,7,392.17159684688943,0.393062814556717,0.25431488534154445,0.2226009418033054,130114.93866008676,1805.4766535922706,131920.41531367903,2520,1,771.6904761904761,35,7,19,34.933470410285494,0.6235119047619047,44.9363425925926,1020.254629629631,29.150132275132314,2
4182,4,0,0,41,0.0,0.0,1.0,41,850,500,350,0.5882352941176471,12,5,7,401.5816566277926,0.3913871951219512,0.2623146819703488,0.22756293875574934,130050.0000000001,2245.1388888889032,132295.138888889,2521,4,791.4878048780488,34,7,19,34.759667755991295,0.625,45.00000000000001,1020.0000000000008,30.000000000000025,0
4183,4,1,0,42,0.023809523809523808,0.0,1.0,42,950,600,350,0.631578947368421,13,6,7,395.13910550439124,0.3961115950445219,0.2548706819764528,0.225308471212297,130292.12648158864,1896.702862439985,132188.82934402864,2522,0,773.6190476190476,35,7,20,34.67730888410234,0.6252976190476189,44.76273148148148,1020.9490740740739,29.16997354497354,0
4184,4,2,3,41,0.045454545454545456,0.06818181818181818,0.9318181818181819,44,700,400,300,0.5714285714285714,10,4,6,381.94150239498185,0.4031338090204369,0.24612561770811947,0.22030725991576977,130738.73842191831,1186.9100348184068,131925.64845673673,2523,0,739.4090909090909,37,7,14,34.56039365998356,0.6258445945945945,44.32565789473684,1022.6973684210529,27.640469416785216,0
4185,4,0,0,41,0.0,0.0,1.0,41,850,500,350,0.5882352941176471,12,5,7,409.4556781276462,0.39209857723577235,0.26701720018082775,0.2331222529239312,130233.84871357845,2464.99776803831,132698.84648161675,2524,7,794.4878048780488,36,5,19,34.37132244777876,0.6226851851851851,44.81981981981982,1020.7207207207208,28.353353353353356,0
4186,4,1,0,42,0.023809523809523808,0.0,1.0,42,950,500,450,0.5263157894736842,14,5,9,401.92589609446867,0.3935709446380178,0.2679339912635499,0.23075459444175267,130558.1342699759,2094.945362576656,132653.07963255254,2525,0,776.547619047619,35,7,15,34.23320120800301,0.6279761904761905,44.50231481481481,1021.99074074074,29.199735449735428,0
4187,4,0,0,42,0.0,0.0,1.0,42,1050,600,450,0.5714285714285714,15,6,9,406.6487476370511,0.39413956639566394,0.2721273291925468,0.2338230298913044,130617.28395061736,2223.0709876543337,132840.3549382717,2526,1,777.547619047619,35,7,15,34.05230978260871,0.6285714285714286,44.44444444444445,1022.2222222222229,29.206349206349223,0
4188,4,0,0,42,0.0,0.0,1.0,42,1150,700,450,0.6086956521739131,16,7,9,407.66546936591067,0.3937403213317847,0.27499959567207366,0.23458691145987562,130646.86381440761,2252.0430116169437,132898.90682602455,2527,2,778.547619047619,35,7,15,33.99621212121211,0.6288690476190476,44.41550925925926,1022.3379629629633,29.209656084656093,0
4189,4,0,0,42,0.0,0.0,1.0,42,1000,800,200,0.8,12,8,4,409.9733228138517,0.39361933797909404,0.28124444300748475,0.2366384228416728,130765.21675936654,2322.050084662224,133087.26684402875,2528,3,779.547619047619,35,7,15,33.81674116404512,0.6300595238095237,44.299768518518526,1022.8009259259269,29.222883597883627,0
4190,4,0,0,42,0.0,0.0,1.0,42,750,600,150,0.8,9,6,3,405.21692840031915,0.3933168795973674,0.2735617323852615,0.23443178318447805,130854.01663237323,2204.852537722921,133058.86917009615,2529,4,780.547619047619,35,7,15,33.84803921568628,0.6309523809523809,44.21296296296297,1023.1481481481491,29.23280423280426,0
4191,4,1,1,42,0.023255813953488372,0.023255813953488372,0.9767441860465116,43,800,700,100,0.875,9,7,2,398.6433592513931,0.39657161314138056,0.27193576843908573,0.23226530124224373,131126.20380092948,1854.5180738170807,132980.72187474655,2530,0,763.3720930232558,36,7,17,33.73969213853766,0.6316550925925926,43.94707207207208,1024.2117117117132,28.450325325325366,0
4192,4,0,0,42,0.0,0.0,1.0,42,1200,800,400,0.6666666666666666,16,8,8,402.0220545291705,0.39202235772357724,0.2668583157916784,0.23405816670219456,131097.3705969484,2140.8068541514594,133238.17745109985,2531,1,782.1428571428571,36,6,18,33.682464628692905,0.6313657407407407,43.97522522522523,1024.0990990991,28.44719719719722,0
4193,4,1,0,43,0.023255813953488372,0.0,1.0,43,1250,1100,150,0.88,14,11,3,396.2783460809252,0.3957641196013289,0.261539309649627,0.2326461145083446,131417.11576485346,1815.9572676209546,133233.0730324744,2532,0,764.9302325581396,35,8,19,33.50512190992212,0.6366071428571427,43.66319444444445,1025.3472222222229,29.29563492063494,0
4194,4,1,2,42,0.022727272727272728,0.045454545454545456,0.9545454545454546,44,1150,900,250,0.782608695652174,14,9,5,387.45811804970225,0.3991477272727273,0.26388320949483823,0.2291810996770304,131703.53366457685,1405.920658834519,133109.45432341137,2533,0,748.5227272727273,36,8,15,33.44121411592613,0.6374421296296295,43.38400900900901,1026.4639639639647,28.51288788788791,0
4195,4,1,2,41,0.023255813953488372,0.046511627906976744,0.9534883720930233,43,950,600,350,0.631578947368421,13,6,7,388.96400636609604,0.39917866371354743,0.25231461407795464,0.23059647659597293,131790.24252292837,1652.3321463355314,133442.5746692639,2534,0,730.0697674418604,36,7,16,33.314825985230684,0.6383101851851851,43.29954954954955,1026.8018018018022,28.522272272272282,0
4196,4,0,1,40,0.0,0.024390243902439025,0.975609756097561,41,1200,800,400,0.6666666666666666,16,8,8,395.0350288902016,0.39352134146341466,0.21836362407945353,0.21858927870840428,129115.53603857252,2002.4300482915537,131117.96608686406,2535,2,766.4634146341464,36,5,18,35.880655586334264,0.6114004629629628,45.9177927927928,1016.3288288288302,28.231356356356393,5
4197,4,1,0,41,0.024390243902439025,0.0,1.0,41,1200,900,300,0.75,15,9,6,399.2695286794029,0.3928861788617886,0.2409920675738635,0.22322544661673702,129522.50567544138,2142.9920932864375,131665.49776872783,2536,0,767.3170731707318,32,9,16,35.356973042255866,0.6243489583333333,45.517676767676775,1017.9292929292938,31.81029040404043,0
4198,4,1,1,41,0.023809523809523808,0.023809523809523808,0.9761904761904762,42,1150,800,350,0.6956521739130435,15,8,7,388.76211896235463,0.39792634533488197,0.2405985758789495,0.21893445646827348,129807.25623582772,1692.8287981859469,131500.08503401367,2537,0,750.0238095238095,34,8,17,35.33391744548286,0.6225490196078431,45.23809523809524,1019.0476190476195,29.97198879551822,0
4199,4,0,0,41,0.0,0.0,1.0,41,750,400,350,0.5333333333333333,11,4,7,396.4891206540477,0.39395325203252035,0.24826394827763099,0.2225958606506585,129685.9693877552,2083.815192743773,131769.784580499,2538,1,769.219512195122,34,7,17,35.26083060620227,0.6213235294117647,45.35714285714286,1018.5714285714294,29.957983193277332,0
4200,4,0,0,41,0.0,0.0,1.0,41,400,200,200,0.5,6,2,4,396.4891206540477,0.39395325203252035,0.24826394827763099,0.2225958606506585,129685.9693877552,2083.815192743773,131769.784580499,2539,2,770.219512195122,34,7,17,35.26083060620227,0.6213235294117647,45.35714285714286,1018.5714285714294,29.957983193277332,0
4201,4,1,1,41,0.023809523809523808,0.023809523809523808,0.9761904761904762,42,650,400,250,0.6153846153846154,9,4,5,390.43188204509113,0.39706736353077815,0.2453002540403224,0.2207769499882704,129967.37423911181,1748.6813057270256,131716.05554483883,2540,0,752.8571428571429,35,7,17,35.128168747635264,0.6220238095238095,45.08101851851852,1019.6759259259261,29.13359788359789,0
4202,4,0,0,41,0.0,0.0,1.0,41,750,400,350,0.5333333333333333,11,4,7,396.20807836061834,0.3932672764227642,0.24039858478472653,0.22347388451407219,129867.92091836738,2090.9438775510253,131958.8647959184,2541,4,772.219512195122,34,7,17,35.08234057463208,0.6231617647058822,45.17857142857143,1019.2857142857147,29.978991596638668,0
4203,4,0,0,41,0.0,0.0,1.0,41,1200,900,300,0.75,15,9,6,396.8689799482028,0.3932672764227642,0.24205842694140434,0.22424752048516486,129937.87140185623,2113.662095979093,132051.53349783533,2542,5,773.219512195122,35,6,17,34.994158436447584,0.6217261904761904,45.10995370370371,1019.5601851851859,29.130291005291024,0
4204,4,0,0,41,0.0,0.0,1.0,41,1100,800,300,0.7272727272727273,14,8,6,398.7799812303417,0.3934705284552846,0.2420592638923098,0.22600951605035394,130055.90284475748,2172.7380990655142,132228.640943823,2543,6,774.219512195122,35,6,17,34.82509266613716,0.6229166666666666,44.99421296296297,1020.023148148149,29.14351851851854,0
4205,4,0,0,41,0.0,0.0,1.0,41,1050,900,150,0.8571428571428571,12,9,3,397.4400244301819,0.3938262195121951,0.23794821548259582,0.2257808188941619,130147.65346004804,2145.1773141384792,132292.83077418653,2544,7,775.219512195122,36,5,17,34.76575433175147,0.6218171296296295,44.90427927927929,1020.382882882884,28.343968968969,0
4206,4,0,0,41,0.0,0.0,1.0,41,1000,600,400,0.6,14,6,8,391.2089361758998,0.3938262195121951,0.2213046315531506,0.2201418333155506,129776.92920918358,1954.0803360241007,131731.0095452077,2545,8,776.219512195122,34,7,17,35.30250808116214,0.6222426470588236,45.26785714285714,1018.9285714285706,29.96848739495796,1
4207,4,1,1,41,0.023809523809523808,0.023809523809523808,0.9761904761904762,42,1300,1000,300,0.7692307692307693,16,10,6,386.18554741751063,0.3975633952768099,0.224098601913171,0.21922563030091793,130118.92804967146,1650.0098916484253,131768.9379413199,2546,0,758.7142857142857,36,6,17,35.08209161147904,0.6215277777777777,44.93243243243244,1020.2702702702717,28.34084084084088,0
4208,4,1,0,42,0.023809523809523808,0.0,1.0,42,900,500,400,0.5555555555555556,13,5,8,388.5220212028788,0.39603900503290745,0.24935882490090977,0.22188694393330854,130353.74858276636,1729.2188941561462,132082.9674769225,2547,0,759.6904761904761,34,8,18,34.78350625631461,0.6280637254901962,44.70238095238095,1021.1904761904756,30.03501400560222,0
4209,4,1,1,42,0.023255813953488372,0.023255813953488372,0.9767441860465116,43,1400,1100,300,0.7857142857142857,17,11,6,381.7689582959699,0.40063215208564046,0.2604524801111987,0.21985312761320713,130676.44702717754,1377.642211076807,132054.08923825435,2548,0,743.0,35,8,19,34.6280469398536,0.6291666666666667,44.38657407407407,1022.4537037037029,29.21296296296294,0
4210,4,0,0,42,0.0,0.0,1.0,42,1000,800,200,0.8,12,8,4,382.1314634258126,0.401725222609369,0.25577288780222807,0.22012925146641868,130688.28124999987,1588.020833333319,132276.3020833332,2549,1,743.0952380952381,34,8,19,34.60676446617766,0.6314338235294118,44.37499999999999,1022.499999999999,30.073529411764675,0
4211,4,0,0,42,0.0,0.0,1.0,42,1200,800,400,0.6666666666666666,16,8,8,383.900217689835,0.40224545102593884,0.2583133812184093,0.22167141602090457,130779.59183673456,1641.262755102024,132420.85459183657,2550,2,744.0952380952381,34,8,19,34.46883729050279,0.6323529411764707,44.28571428571428,1022.8571428571418,30.084033613445346,0
4212,4,0,0,42,0.0,0.0,1.0,42,1450,1200,250,0.8275862068965517,17,12,5,386.68253857464805,0.4019429926442122,0.2571921430509645,0.22451608029732567,130992.7738803853,1730.5236678004317,132723.29754818574,2551,3,745.0952380952381,34,8,19,34.181300151180366,0.6344975490196079,44.07738095238094,1023.6904761904747,30.108543417366903,0
4213,4,0,0,42,0.0,0.0,1.0,42,1450,1300,150,0.896551724137931,16,13,3,383.3886814133872,0.4017494192799071,0.2560290556900733,0.22351711663428664,131150.23389274662,1656.3030478394685,132806.53694058608,2552,4,746.0952380952381,35,7,20,34.10593220338982,0.6339285714285715,43.92361111111109,1024.3055555555532,29.26587301587295,0
4214,4,0,0,42,0.0,0.0,1.0,42,1350,900,450,0.6666666666666666,18,9,9,381.8454008599169,0.40178571428571425,0.2566498131457464,0.22298006784489863,131212.72243527303,1620.5949192435578,132833.3173545166,2553,5,747.0952380952381,36,6,20,34.08212427639773,0.6325231481481483,43.86261261261261,1024.5495495495488,28.45970970970969,0
4215,4,0,0,42,0.0,0.0,1.0,42,1100,700,400,0.6363636363636364,15,7,8,378.8705974671596,0.40203977932636464,0.25478361875461064,0.2217428493600398,131299.26960321804,1549.0865443145733,132848.3561475326,2554,6,748.0952380952381,36,6,20,34.07066073325275,0.6333912037037038,43.77815315315315,1024.887387387387,28.469094094094082,0
4216,4,0,0,42,0.0,0.0,1.0,42,1400,1300,100,0.9285714285714286,15,13,2,378.30773670945797,0.4011203058459156,0.2534622019443149,0.22244093264648368,131476.45968632118,1547.7155493010264,133024.1752356222,2555,7,749.0952380952381,35,7,20,33.90571511868488,0.637202380952381,43.605324074074076,1025.578703703704,29.302248677248684,0
4217,4,0,0,42,0.0,0.0,1.0,42,750,300,450,0.4,12,3,9,375.6132607561169,0.4009388308168796,0.251747356094705,0.22116749788154286,131530.20154867697,1480.89757832156,133011.09912699854,2556,8,750.0952380952381,36,6,20,33.920435832692945,0.6357060185185186,43.552927927927925,1025.7882882882877,28.494119119119105,0
4218,4,0,0,42,0.0,0.0,1.0,42,1200,700,500,0.5833333333333334,17,7,10,374.6057040997141,0.4005274874177313,0.24647754878144323,0.22157890933607377,131703.53366457685,1467.3789921678515,133170.9126567447,2557,9,751.0952380952381,36,6,18,33.771027610166385,0.6374421296296295,43.38400900900901,1026.4639639639647,28.51288788788791,0
4219,4,0,0,42,0.0,0.0,1.0,42,1550,1000,550,0.6451612903225806,21,10,11,371.39481933120607,0.4009993224932249,0.24629612682143098,0.22043624067528986,131834.36850761765,1392.5202947060561,133226.8888023237,2558,10,752.0952380952381,37,5,18,33.72126129973664,0.6368243243243243,43.25657894736842,1026.9736842105258,27.7560455192034,0
4220,4,0,0,42,0.0,0.0,1.0,42,1150,1000,150,0.8695652173913043,13,10,3,371.3211763459023,0.40130178087495155,0.2464688511758637,0.2208830540434767,131918.83710612878,1396.85155528624,133315.688661415,2559,11,753.0952380952381,37,5,18,33.63786156473477,0.637668918918919,43.17434210526316,1027.3026315789473,27.7649359886202,0
4221,4,0,0,42,0.0,0.0,1.0,42,1450,1100,350,0.7586206896551724,18,11,7,370.51002714381207,0.4011082075106465,0.2464483872934582,0.22089185587734128,132003.3327562326,1381.7116805170733,133385.04443674965,2560,12,754.0952380952381,37,5,20,33.5734101579172,0.6385135135135136,43.09210526315789,1027.6315789473676,27.773826458036964,0
4222,4,0,0,42,0.0,0.0,1.0,42,900,700,200,0.7777777777777778,11,7,4,367.6631716735198,0.40032181571815717,0.24301153908662432,0.21984757000069655,132116.03570329328,1314.8401431209595,133430.87584641424,2561,13,755.0952380952381,37,5,20,33.53286760523322,0.6396396396396395,42.98245614035088,1028.0701754385964,27.78568041725936,0
4223,4,0,0,42,0.0,0.0,1.0,42,1000,800,200,0.8,12,8,4,369.9646709484329,0.3997894889663182,0.2473722694452063,0.22155355582084305,132172.40521121878,1379.8240804862924,133552.22929170507,2562,14,756.0952380952381,37,5,20,33.41686215966446,0.6402027027027027,42.92763157894736,1028.28947368421,27.79160739687054,0
4224,4,0,0,42,0.0,0.0,1.0,42,900,600,300,0.6666666666666666,12,6,6,368.2898331977031,0.39991047231900895,0.24671540257894198,0.2208797081454255,132228.78674207444,1339.7035626346506,133568.4903047091,2563,15,757.0952380952381,37,5,21,33.4030739161336,0.6407657657657657,42.872807017543856,1028.5087719298242,27.797534376481735,0
4225,4,0,0,42,0.0,0.0,1.0,42,1650,1400,250,0.8484848484848485,19,14,5,366.46172420415786,0.39841027874564455,0.24366141373900296,0.2209453636167848,132427.7842747985,1306.1592443181646,133733.94351911667,2564,16,758.0952380952381,35,7,21,33.249583005360016,0.6467261904761905,42.679398148148145,1029.2824074074072,29.408068783068774,0
4226,4,0,0,42,0.0,0.0,1.0,42,1250,500,750,0.4,20,5,15,369.0898381551963,0.3978900503290747,0.25071956862316513,0.2240745142191035,132687.90486009655,1394.7514659930184,134082.65632608958,2565,17,759.0952380952381,36,6,19,32.9200367981929,0.6472800925925927,42.4268018018018,1030.2927927927924,28.619244244244232,0
4227,4,0,0,42,0.0,0.0,1.0,42,1100,800,300,0.7272727272727273,14,8,6,368.94094194298424,0.39722464188927603,0.24432666739518472,0.22433080131031563,132745.92318247314,1395.0811876065436,134141.0043700797,2566,18,760.0952380952381,36,6,19,32.865488289075884,0.6478587962962963,42.370495495495504,1030.5180180180191,28.625500500500532,0
4228,4,1,1,42,0.023255813953488372,0.023255813953488372,0.9767441860465116,43,1100,900,200,0.8181818181818182,13,9,4,361.31007040097955,0.39793281653746765,0.2409208362696733,0.22080059857837636,132934.5703125,1006.1197916666666,133940.69010416666,2567,0,743.3953488372093,37,6,19,32.87247474747474,0.6478040540540541,42.1875,1031.25,27.87162162162162,0
4229,4,0,0,42,0.0,0.0,1.0,42,1350,800,550,0.5925925925925926,19,8,11,368.73455479545635,0.39739401858304296,0.24290575439022932,0.22516751644782254,132906.30290089245,1401.4292859341174,134307.73218682656,2568,20,762.0952380952381,37,5,19,32.709485325393445,0.6475225225225225,42.214912280701746,1031.1403508771918,27.868658131815994,0
4230,4,0,0,42,0.0,0.0,1.0,42,650,400,250,0.6153846153846154,9,4,5,371.833451795306,0.3971762485481998,0.24857993378086962,0.22740347513567274,132962.84072983984,1488.006405817162,134450.847135657,2569,21,763.0952380952381,37,5,19,32.572737259905026,0.6480855855855856,42.16008771929824,1031.359649122806,27.87458511142719,0
4231,4,0,0,42,0.0,0.0,1.0,42,1550,1300,250,0.8387096774193549,18,13,5,369.15628255082765,0.39572444831591175,0.24795918367346959,0.2268479446209283,133141.23109796178,1429.9843852728359,134571.2154832346,2570,22,764.0952380952381,38,4,20,32.46247412008282,0.6480263157894738,41.98717948717948,1032.0512820512813,27.159244264507404,0
4232,4,0,0,42,0.0,0.0,1.0,42,1000,700,300,0.7,13,7,6,343.0758885167238,0.395603464963221,0.1922655318051394,0.20188170810326725,131506.13667052463,661.6860195686256,132167.82269009325,2571,23,765.0952380952381,35,7,20,34.77911306702775,0.6375,43.576388888888886,1025.6944444444441,29.305555555555546,7
4233,4,2,2,42,0.045454545454545456,0.045454545454545456,0.9545454545454546,44,1350,1000,350,0.7407407407407407,17,10,7,327.09236677290926,0.40390459830866804,0.1862067172714983,0.19477692205913744,131958.55391418296,-167.47285685586724,131791.0810573271,2572,0,731.2727272727273,38,6,17,34.73384804686146,0.6362390350877192,43.13568376068376,1027.4572649572654,27.038349077822772,0
4234,4,0,0,42,0.0,0.0,1.0,42,1000,700,300,0.7,13,7,6,343.53724642327086,0.3950832365466512,0.19090462605933345,0.20304789000659487,131674.6370525932,647.028447366298,132321.6654999595,2573,25,767.0952380952381,36,6,17,34.59741423451103,0.6371527777777777,43.41216216216217,1026.351351351352,28.509759759759774,0
4235,4,0,0,42,0.0,0.0,1.0,42,1100,1000,100,0.9090909090909091,12,10,2,343.1868228992581,0.39504694154084397,0.18615193390363394,0.2034575715991832,131790.24252292843,645.7349241133111,132435.97744704175,2574,26,768.0952380952381,36,6,18,34.489928346859685,0.6383101851851851,43.29954954954955,1026.8018018018026,28.522272272272296,0
4236,4,0,0,42,0.0,0.0,1.0,42,1100,900,200,0.8181818181818182,13,9,4,347.29735595646343,0.39451461478900507,0.1980142199392365,0.20652193487841344,131905.89871966562,762.1139720801908,132668.01269174583,2575,27,769.0952380952381,36,6,18,34.267887159248716,0.6394675925925926,43.18693693693694,1027.2522522522524,28.53478478478479,0
4237,4,0,0,42,0.0,0.0,1.0,42,1400,1200,200,0.8571428571428571,16,12,4,347.6183663925324,0.3940064847077042,0.19265444755748273,0.2075024741703495,132050.54029959018,780.6386200389636,132831.17891962914,2576,28,770.0952380952381,36,6,18,34.11398414959279,0.6409143518518519,43.046171171171174,1027.8153153153157,28.550425425425438,0
4238,4,0,0,42,0.0,0.0,1.0,42,1000,600,400,0.6,14,6,8,346.30936295122837,0.39392179636082075,0.18961279050869506,0.2070788639687957,132116.03570329328,750.604032009848,132866.63973530312,2577,29,771.0952380952381,37,5,18,34.08169795221843,0.6396396396396395,42.98245614035088,1028.0701754385964,27.78568041725936,0
4239,4,0,0,42,0.0,0.0,1.0,42,1550,1300,250,0.8387096774193549,18,13,5,346.6259927896309,0.3939338946960898,0.1884150675195453,0.20788694452472745,132228.78674207442,766.7868959679831,132995.5736380424,2578,30,772.0952380952381,37,5,19,33.960110163468364,0.6407657657657657,42.872807017543856,1028.508771929824,27.797534376481728,0
4240,4,0,0,42,0.0,0.0,1.0,42,1200,800,400,0.6666666666666666,16,8,8,342.91564892228416,0.39410327138985674,0.1829372268997127,0.20612284009210702,132313.38158135195,674.4658212142185,132987.84740256617,2579,31,773.0952380952381,37,5,19,33.97045632171657,0.6416103603603605,42.790570175438596,1028.8377192982455,27.806424845898526,0
4241,4,0,0,42,0.0,0.0,1.0,42,950,700,250,0.7368421052631579,12,7,5,348.90301193391355,0.39401858304297327,0.17525053266864443,0.20346141931876524,131159.5935768697,752.4225001923544,131912.01607706206,2580,32,774.0952380952381,37,5,18,34.97957253978449,0.6300675675675675,43.91447368421052,1024.342105263157,27.68492176386911,3
4242,4,0,0,42,0.0,0.0,1.0,42,900,600,300,0.6666666666666666,12,6,6,351.80204977669234,0.3940064847077042,0.17792810007898296,0.20560288650176306,131243.84576263855,834.3707919744611,132078.216554613,2581,33,775.0952380952381,37,5,18,34.82020242553952,0.6309121621621621,43.83223684210527,1024.6710526315792,27.693812233285925,0
4243,4,0,0,42,0.0,0.0,1.0,42,900,700,200,0.7777777777777778,11,7,4,350.32057637649547,0.3940064847077042,0.17576461478900507,0.20518776616337597,131328.12500000012,801.3888888889037,132129.51388888902,2582,34,776.0952380952381,37,5,18,34.77303523035231,0.6317567567567567,43.75000000000001,1025.000000000001,27.702702702702727,0
4244,4,0,0,42,0.0,0.0,1.0,42,1000,800,200,0.8,12,8,4,348.9281890612515,0.39363143631436315,0.1761405599784036,0.20452223445351975,131356.2240905856,766.777878770393,132123.001969356,2583,35,777.0952380952381,37,5,18,34.78034638285734,0.6320382882882882,43.72258771929825,1025.1096491228072,27.705666192508303,0
4245,4,2,0,44,0.045454545454545456,0.0,1.0,44,1100,700,400,0.6363636363636364,15,7,8,320.57061289430794,0.4014380725863284,0.14866983372921627,0.18149573430406613,130015.40927716179,-464.17611246319404,129551.2331646986,2584,0,742.7272727272727,42,2,15,36.86045130641331,0.6103670634920635,45.03391472868217,1019.864341085271,24.28248431155407,7
4246,4,1,1,44,0.022222222222222223,0.022222222222222223,0.9777777777777777,45,400,100,300,0.25,7,1,6,317.84883339156625,0.40484006734006733,0.14948145399063906,0.18087511754457797,130214.25637769766,-722.3101038796826,129491.94627381797,2585,0,727.2,43,2,15,36.72875301540176,0.6109496124031006,44.83901515151516,1020.6439393939412,23.735905567300957,0
4247,4,1,1,44,0.022222222222222223,0.022222222222222223,0.9777777777777777,45,1400,1200,200,0.8571428571428571,16,12,4,318.5214156848385,0.4062920875420875,0.15437251386054918,0.18170888380496986,130310.92620092988,-698.6358614554534,129612.29033947444,2586,0,728.1777777777778,43,2,16,36.613878068385574,0.6119186046511627,44.74431818181819,1021.0227272727283,23.744714587737867,0
4248,4,1,1,44,0.022222222222222223,0.022222222222222223,0.9777777777777777,45,800,500,300,0.625,11,5,6,318.31144502461046,0.4057239057239057,0.15563798219584557,0.18181518131066743,130359.27456382014,-701.0301882460858,129658.24437557405,2587,0,729.1555555555556,43,2,16,36.57038204747775,0.6124031007751938,44.6969696969697,1021.2121212121222,23.749119097956328,0
4249,4,2,0,46,0.043478260869565216,0.0,1.0,46,1150,800,350,0.6956521739130435,15,8,7,317.07195613811643,0.4072564412238325,0.17632412856496105,0.18287518305720601,130735.62349965704,-909.4800240054913,129826.14347565155,2588,0,714.2608695652174,44,2,14,36.222083899200236,0.6148200757575758,44.3287037037037,1022.685185185185,23.242845117845114,0
4250,4,2,0,48,0.041666666666666664,0.0,1.0,48,1550,1100,450,0.7096774193548387,20,11,9,309.86543637995015,0.4099900265957446,0.1906829454681782,0.1811701860958947,131259.98224592555,-1465.4136644283699,129794.56858149718,2589,0,685.4583333333334,46,2,17,35.87824782997375,0.6175271739130436,43.81648936170212,1024.7340425531897,22.276827012025866,0
4251,4,1,2,47,0.02040816326530612,0.04081632653061224,0.9591836734693877,49,1150,700,450,0.6086956521739131,16,7,9,310.04264314165215,0.41197208049886624,0.2026229858426536,0.18284100737906583,131589.25004286692,-1640.2911715137243,129948.95887135318,2590,0,672.4489795918367,44,5,10,35.542633035526265,0.623342803030303,43.49537037037037,1026.0185185185182,23.31860269360269,0
4252,4,0,0,47,0.0,0.0,1.0,47,1450,900,550,0.6206896551724138,20,9,11,320.80112150825437,0.40888066604995377,0.20105709477865963,0.18850851021220738,131452.30647384468,-965.9905316687737,130486.3159421759,2591,1,693.9574468085107,42,5,19,35.404461557844336,0.6247519841269842,43.62887596899225,1025.4844961240308,24.416297526762637,0
4253,4,0,0,47,0.0,0.0,1.0,47,1200,800,400,0.6666666666666666,16,8,8,322.8874127641103,0.40870721554116557,0.1991188683568419,0.19010490275422004,131526.84352653107,-906.3275569376674,130620.5159695934,2592,2,694.9574468085107,42,5,19,35.27595409030794,0.6254960317460316,43.556201550387605,1025.7751937984513,24.423218899963125,0
4254,4,1,0,48,0.020833333333333332,0.0,1.0,48,950,600,350,0.631578947368421,13,6,7,323.806680241209,0.41027630023640665,0.2168141592920354,0.1925797624592455,131911.1570247935,-1057.2572314049487,130853.89979338855,2593,0,681.4583333333334,43,5,13,34.8658738938053,0.627906976744186,43.18181818181819,1027.2727272727282,23.890063424947165,0
4255,4,0,1,47,0.0,0.020833333333333332,0.9791666666666666,48,1000,700,300,0.7,13,7,6,324.26862364117585,0.4098607417257683,0.21447140048536184,0.19322563619606836,131984.12682399305,-1040.337770460258,130943.78905353279,2594,1,682.4583333333334,43,5,14,34.780684575922336,0.6286337209302324,43.11079545454547,1027.5568181818205,23.896670190274897,0
4256,4,0,0,47,0.0,0.0,1.0,47,1000,800,200,0.8,12,8,4,326.62744148732884,0.40814831945729263,0.20722862559812194,0.19470961309573515,131999.40212614957,-777.0746011357203,131222.32752501385,2595,2,697.8723404255319,42,5,14,34.70473833097596,0.6302083333333331,43.09593023255815,1027.6162790697697,24.467054263565945,0
4257,4,0,1,46,0.0,0.02127659574468085,0.9787234042553191,47,1500,1100,400,0.7333333333333333,19,11,8,326.3191297919738,0.4079748689485045,0.2058167790778802,0.19542317185961816,132173.71627306088,-773.8375848806807,131399.8786881802,2596,3,698.8723404255319,42,5,15,34.537551828119106,0.6319444444444442,42.926356589147304,1028.2945736434137,24.483204134366993,0
4258,4,0,0,46,0.0,0.0,1.0,46,1350,800,550,0.5925925925925926,19,8,11,331.8728272368802,0.4044182769726248,0.21469987287548853,0.1984534396223771,132117.37769471243,-430.7664674665913,131686.61122724583,2597,4,714.8913043478261,41,5,15,34.45139357972273,0.6328760162601625,42.981150793650805,1028.075396825399,25.075009678668266,0
4259,4,0,0,46,0.0,0.0,1.0,46,1650,1400,250,0.8484848484848485,19,14,5,333.0768905173583,0.40476046698872786,0.21302186122664657,0.19975417492595438,132227.50521012698,-391.614744748607,131835.89046537838,2598,5,715.8913043478261,43,3,15,34.309781941503246,0.6310562015503876,42.87405303030304,1028.5037878787891,23.918692741367188,0
4260,4,0,0,46,0.0,0.0,1.0,46,1150,800,350,0.6956521739130435,15,8,7,338.24251594877217,0.40530394524959745,0.21882964379593517,0.2036388598789647,132373.63985200037,-245.1214022325338,132128.51844976784,2599,6,716.8913043478261,43,3,16,34.03011027269101,0.6325096899224805,42.732007575757585,1029.0719696969716,23.931906272022594,0
4261,4,1,0,47,0.02127659574468085,0.0,1.0,47,1350,800,550,0.5925925925925926,19,8,11,331.10235098281476,0.4073581560283688,0.2259134957465696,0.2008608337470255,132659.60784131484,-615.2094251404063,132044.39841617443,2600,0,702.6170212765958,40,7,15,33.926868567294726,0.6398437499999999,42.45426829268293,1030.1829268292693,25.75457317073173,0
4262,4,0,0,47,0.0,0.0,1.0,47,950,500,450,0.5263157894736842,14,5,9,330.43719290874503,0.40722325007708915,0.22940534642662325,0.20087728633661128,132738.1395002975,-627.6763583184531,132110.46314197904,2601,1,703.6170212765958,40,7,15,33.86526134122289,0.640625,42.37804878048781,1030.4878048780492,25.76219512195123,0
4263,4,0,0,47,0.0,0.0,1.0,47,1100,900,200,0.8181818181818182,13,9,4,332.67708964570585,0.40724252235584335,0.23609007413871974,0.20252167125970885,132790.50684942823,-564.7281297508084,132225.77871967742,2602,2,704.6170212765958,40,7,15,33.75505324393613,0.6411458333333333,42.327235772357724,1030.691056910569,25.767276422764223,0
4264,4,0,0,47,0.0,0.0,1.0,47,1050,600,450,0.5714285714285714,15,6,9,330.17937052307076,0.40691489361702127,0.2357869392167462,0.2013629118823797,132857.85147392284,-626.6156462585081,132231.23582766432,2603,3,705.6170212765958,41,6,15,33.75192455735181,0.6402439024390244,42.26190476190476,1030.9523809523805,25.145180023228793,0
4265,4,0,0,47,0.0,0.0,1.0,47,850,600,250,0.7058823529411765,11,6,5,330.8072562548018,0.4068378045020043,0.23465256142045932,0.20202177564702764,132908.99490583275,-606.5480127236076,132302.44689310915,2604,4,706.6170212765958,41,6,15,33.68449746648707,0.6407520325203251,42.21230158730159,1031.150793650794,25.150019357336436,0
4266,4,0,0,47,0.0,0.0,1.0,47,1300,800,500,0.6153846153846154,18,8,10,326.9268402240549,0.406567992599445,0.2277405234702139,0.2001228415287558,132997.0322265038,-703.9400990024653,132293.09212750132,2605,5,707.6170212765958,42,5,15,33.69637545013308,0.6401289682539684,42.126937984496124,1031.4922480620153,24.55933923957179,0
4267,4,0,0,47,0.0,0.0,1.0,47,1350,1200,150,0.8888888888888888,15,12,3,326.25656159912825,0.40633672525439407,0.2224260554866122,0.19998005822371448,133047.01232084914,-718.5078458325765,132328.50447501655,2606,6,708.6170212765958,42,5,15,33.663629817475965,0.640625,42.07848837209303,1031.6860465116283,24.563953488372103,0
4268,4,1,0,48,0.020833333333333332,0.0,1.0,48,950,600,350,0.631578947368421,13,6,7,322.35285883723043,0.40864177009456265,0.22689748173955548,0.19920128222876343,133349.93332651808,-1002.8535532885602,132347.07977322952,2607,0,694.8333333333334,43,5,16,33.461404755355886,0.6421996124031008,41.78503787878788,1032.859848484849,24.019996476391835,0
4269,4,0,0,48,0.0,0.0,1.0,48,1050,1000,50,0.9523809523809523,11,10,1,325.0883412481135,0.40878028959810875,0.22704584617423862,0.18696761718780852,130625.94112507424,-940.6674395566711,129685.27368551758,2608,1,695.8333333333334,40,8,17,36.12788713258441,0.6195312500000001,44.43597560975609,1022.2560975609747,25.556402439024367,8
4270,4,0,0,48,0.0,0.0,1.0,48,1250,900,350,0.72,16,9,7,324.95151064980644,0.4078752955082742,0.23734764175940648,0.18751789009057626,130755.83316808769,-1102.1388971511765,129653.69427093651,2609,2,696.8333333333334,40,8,21,36.000223569157384,0.6208333333333333,44.30894308943089,1022.7642276422757,25.569105691056894,0
4271,4,2,1,49,0.04,0.02,0.98,50,1500,1000,500,0.6666666666666666,20,10,10,311.12003870033635,0.4110714285714286,0.23732816488607322,0.18210938845232214,131303.29574732608,-1829.78270912203,129473.51303820405,2610,0,669.92,42,8,22,35.80252749676972,0.6232638888888888,43.77422480620156,1024.9031007751953,24.402454780361793,0
4272,4,1,2,48,0.02,0.04,0.96,50,1300,1000,300,0.7692307692307693,16,10,6,311.65311653116515,0.41164115646258503,0.23447154471544684,0.18253968253968259,131328.12500000015,-1814.2361111110972,129513.88888888905,2611,0,670.9,42,8,22,35.76388888888891,0.6235119047619047,43.75000000000001,1025.0000000000011,24.404761904761934,0
4273,4,0,0,48,0.0,0.0,1.0,48,1100,700,400,0.6363636363636364,15,7,8,323.7796478403666,0.4069795360520094,0.24283776630938125,0.1883604925888881,131067.83743142348,-1112.5803506510304,129955.25708077246,2612,2,699.7708333333334,40,8,22,35.71543767368004,0.6239583333333332,44.004065040650424,1023.9837398374015,25.599593495935036,0
4274,4,1,1,48,0.02040816326530612,0.02040816326530612,0.9795918367346939,49,900,600,300,0.6666666666666666,12,6,6,319.59808413356296,0.41043083900226757,0.24623347887073455,0.18694497220270165,131277.28666698182,-1408.8061381959988,129868.48052878582,2613,0,686.469387755102,41,8,22,35.611487576637614,0.6244918699186991,43.799603174603185,1024.801587301589,24.995160665892417,0
4275,4,0,0,48,0.0,0.0,1.0,48,750,500,250,0.6666666666666666,10,5,5,324.9263743166511,0.40678560874704495,0.24989460370994943,0.1896689507519493,131197.94894118933,-1074.065226551631,130123.8837146377,2614,4,701.7708333333334,40,8,22,35.554921800085985,0.6252604166666667,43.877032520325216,1024.491869918701,25.612296747967527,0
4276,4,0,0,48,0.0,0.0,1.0,48,1050,700,350,0.6666666666666666,14,7,7,327.03301384327807,0.4065455082742317,0.2516435162778694,0.19142085359857838,131302.7046032535,-1011.9361575648613,130290.76844568865,2615,5,702.7708333333334,41,7,22,35.39539170135193,0.6247459349593495,43.774801587301596,1024.9007936507949,24.997580332946217,0
4277,4,1,0,49,0.02040816326530612,0.0,1.0,49,850,600,250,0.7058823529411765,11,6,5,320.4645502084248,0.4086238662131519,0.25230587578800057,0.18872632262566189,131536.54095611093,-1369.4353923556948,130167.10556375523,2616,0,689.4081632653061,40,9,23,35.32833036127072,0.6286458333333333,43.54674796747968,1025.8130081300826,25.645325203252064,0
4278,4,0,1,48,0.0,0.02040816326530612,0.9795918367346939,49,900,600,300,0.6666666666666666,12,6,6,318.3766510051652,0.4080392573696145,0.2520650882669835,0.18772242444101594,131582.4642935879,-1421.443137440149,130161.02115614775,2617,1,690.4081632653061,41,8,16,35.335686198672086,0.627540650406504,43.501984126984134,1025.9920634920643,25.024196670538153,0
4279,4,0,0,48,0.0,0.0,1.0,48,1200,800,400,0.6666666666666666,16,8,8,328.05380169423074,0.40544658687943264,0.2622845254606696,0.19319574529180666,131536.5409561109,-969.7875355277777,130566.75342058312,2618,8,705.7708333333334,40,8,22,35.133701538867975,0.6286458333333333,43.54674796747968,1025.8130081300824,25.64532520325206,0
4280,4,0,0,48,0.0,0.0,1.0,48,1300,900,400,0.6923076923076923,17,9,8,328.2065526705813,0.4054373522458629,0.26184608942146625,0.19429527500201232,131735.18597253718,-952.7297493071329,130782.45622323004,2619,9,706.7708333333334,41,7,19,34.92985762144051,0.6290650406504066,43.3531746031746,1026.5873015873017,25.038714672861015,0
4281,4,0,1,47,0.0,0.020833333333333332,0.9791666666666666,48,850,300,550,0.35294117647058826,14,3,11,328.5518046517256,0.40503102836879434,0.26521684864882245,0.19462980116432216,131760.64819735763,-941.9602505354048,130818.68794682223,2620,10,707.7708333333334,41,7,20,34.89538039102005,0.6293191056910569,43.32837301587301,1026.6865079365077,25.041134339914823,0
4282,4,0,0,47,0.0,0.0,1.0,47,1100,900,200,0.8181818181818182,13,9,4,335.10286701781604,0.4039855072463768,0.2723453606657493,0.19824524671431357,131709.72620819174,-572.7386267006659,131136.98758149106,2621,11,722.2765957446809,41,6,20,34.77849859862763,0.628810975609756,43.3779761904762,1026.4880952380963,25.036295005807226,0
4283,4,0,0,47,0.0,0.0,1.0,47,1050,800,250,0.7619047619047619,13,8,5,333.1691574157846,0.40404332408263954,0.2695679521148131,0.19762945263099033,131811.58002842325,-616.8893888574062,131194.69063956584,2622,12,723.2765957446809,41,6,21,34.72561024699708,0.6298272357723578,43.278769841269835,1026.8849206349194,25.045973674022424,0
4284,4,0,0,47,0.0,0.0,1.0,47,1050,500,550,0.47619047619047616,16,5,11,333.37182401523165,0.4039662349676226,0.26993910406548194,0.19841371318975506,131938.95266439897,-603.0541383220082,131335.89852607696,2623,13,724.2765957446809,41,6,22,34.59226535341831,0.6310975609756098,43.1547619047619,1027.3809523809514,25.058072009291497,0
4285,4,0,0,47,0.0,0.0,1.0,47,1350,1100,250,0.8148148148148148,16,11,5,333.85726946495714,0.40390841813135986,0.26678004325563354,0.19910348039075929,132015.4057716836,-585.1394203514814,131430.26635133213,2624,14,725.2765957446809,41,6,22,34.502908099237374,0.631859756097561,43.08035714285714,1027.6785714285709,25.065331010452947,0
4286,4,1,0,48,0.020833333333333332,0.0,1.0,48,1200,900,300,0.75,15,9,6,351.14651169123886,0.4066932624113475,0.22253292912398126,0.2016247017309954,130562.68376981483,-380.0962847609296,130182.5874850539,2625,0,711.1458333333334,38,10,15,35.52599484284619,0.6222587719298247,44.49786324786323,1022.0085470085442,26.894961763382742,5
4287,4,1,0,49,0.02040816326530612,0.0,1.0,49,1300,800,500,0.6153846153846154,18,8,10,347.33804941167296,0.4100233843537415,0.23116924668676364,0.20105490037541923,130874.74093967018,-708.4445529513846,130166.2963867188,2626,0,697.6122448979592,39,10,16,35.30754776205504,0.62366452991453,44.192708333333336,1023.2291666666671,26.23664529914531,0
4288,4,0,0,49,0.0,0.0,1.0,49,750,300,450,0.4,12,3,9,348.81767152550486,0.4103068310657596,0.17497991475686625,0.19331464299915857,129176.76150959988,-779.3590904406768,128397.4024191592,2627,1,698.6122448979592,42,7,19,36.99262065897753,0.6019345238095237,45.85755813953489,1016.5697674418612,24.204042081949076,6
4289,4,1,2,48,0.02,0.04,0.96,50,1350,1100,250,0.8148148148148148,16,11,5,345.6983001893802,0.41233843537414966,0.1807070807949669,0.19283994873516802,129433.96297053678,-1050.972760767218,128382.99020976956,2628,0,685.62,40,10,15,36.8102716468591,0.6075520833333332,45.60467479674797,1017.5813008130087,25.43953252032522,0
4290,4,2,2,48,0.04,0.04,0.96,50,1350,1000,350,0.7407407407407407,17,10,7,339.95341270737435,0.4169897959183673,0.18049079754601238,0.19107726300448952,129731.44531249984,-1179.4704861111247,128551.97482638872,2629,0,664.78,41,9,15,36.654311520109076,0.6089939024390245,45.31249999999999,1018.7499999999987,24.847560975609724,0
4291,4,0,0,48,0.0,0.0,1.0,48,1250,900,350,0.72,16,9,7,350.9253959943843,0.4098699763593381,0.18059038796192062,0.19578470550937382,129439.78000216991,-515.2587890625239,128924.52121310738,2630,4,693.4791666666666,39,9,15,36.67137970450746,0.6092414529914532,45.59895833333332,1017.6041666666648,26.092414529914482,0
4292,4,2,1,49,0.04,0.02,0.98,50,750,400,350,0.5333333333333333,11,4,7,342.1070914806337,0.41586734693877553,0.18565255474452602,0.19303406726872613,129883.08930342935,-1113.2148171769024,128769.87448625245,2631,0,666.7,41,9,16,36.4455596107056,0.6105182926829269,45.16369047619046,1019.3452380952352,24.862078977932565,0
4293,4,1,2,48,0.02,0.04,0.96,50,1500,1100,400,0.7333333333333333,19,11,8,344.48630507488554,0.4159778911564626,0.18206326588771704,0.19528310896733012,130064.826003921,-1038.8897339402754,129025.93626998072,2632,0,667.68,42,8,16,36.200563630030715,0.6108630952380952,44.985465116279066,1020.0581395348835,24.28709856035437,0
4294,4,0,0,48,0.0,0.0,1.0,48,1400,1200,200,0.8571428571428571,16,12,4,358.375503753652,0.40896498226950356,0.19016593581821817,0.2027023565199628,129977.44914568032,-283.85323716043695,129693.59590851988,2633,2,696.375,40,8,18,35.93511228489802,0.6130208333333333,45.071138211382106,1019.7154471544702,25.492886178861756,0
4295,4,1,0,49,0.02040816326530612,0.0,1.0,49,850,600,250,0.7058823529411765,11,6,5,352.5221590909578,0.4109268707482993,0.18913112051469794,0.200464093453216,130186.64301658137,-621.2647037982115,129565.37831278316,2634,0,683.1428571428571,41,8,20,35.87203509283562,0.6135670731707318,44.866071428571416,1020.5357142857122,24.891114982578344,0
4296,4,2,1,50,0.0392156862745098,0.0196078431372549,0.9803921568627451,51,1150,800,350,0.6956521739130435,15,8,7,339.32911618319986,0.4144607843137255,0.19847924006600381,0.19544764377538912,130683.32732407918,-1331.0462635736976,129352.28106050548,2635,0,657.3137254901961,42,9,16,35.705908832448856,0.6170634920634921,44.379844961240316,1022.4806201550394,24.344776670358083,0
4297,4,0,1,49,0.0,0.02,0.98,50,1250,900,350,0.72,16,9,7,347.1438857726574,0.4121853741496599,0.20123605316775062,0.20000067247952905,130693.35322381252,-926.1203034454638,129767.23292036705,2636,1,671.46,41,9,16,35.49600190808837,0.6186483739837398,44.37003968253968,1022.51984126984,24.939508323654632,0
4298,4,1,1,49,0.02,0.02,0.98,50,1300,900,400,0.6923076923076923,17,9,8,347.78826147848895,0.41136904761904763,0.19668735453840158,0.20103097266626546,130820.18455530347,-900.4550894431974,129919.72946586026,2637,0,672.4,41,9,17,35.351208947504524,0.6199186991869919,44.24603174603174,1023.015873015872,24.95160665892371,0
4299,4,0,0,49,0.0,0.0,1.0,49,1100,700,400,0.6363636363636364,15,7,8,358.85982308277846,0.409562783446712,0.20327041678243374,0.20694592548320948,130729.84959556168,-417.2618604996843,130312.587735062,2638,3,687.1224489795918,40,9,17,35.15953658617376,0.6205729166666667,44.33434959349594,1022.6626016260177,25.566565040650442,0
4300,4,0,0,49,0.0,0.0,1.0,49,1500,900,600,0.6,21,9,12,360.0897180198509,0.4095273526077097,0.20106165417800836,0.20849588100873384,130885.78976014617,-373.8745744926864,130511.91518565349,2639,4,688.1224489795918,40,9,17,34.970164200350915,0.6221354166666666,44.181910569105696,1023.272357723578,25.58180894308945,0
4301,4,0,0,49,0.0,0.0,1.0,49,850,600,250,0.7058823529411765,11,6,5,360.54321141462486,0.4098107993197279,0.20071370818211132,0.2090403386388421,130937.79047070198,-358.2537056315655,130579.53676507041,2640,5,689.1224489795918,40,9,17,34.90591798232549,0.62265625,44.13109756097561,1023.4756097560977,25.58689024390244,0
4302,4,0,0,49,0.0,0.0,1.0,49,1050,700,350,0.6666666666666666,14,7,7,358.76892884338406,0.40959821428571425,0.19854597915417171,0.20815211125060853,130963.79469892263,-402.8519317205294,130560.9427672021,2641,6,690.1224489795918,40,9,17,34.924998345247545,0.6229166666666666,44.10569105691057,1023.5772357723581,25.589430894308954,0
4303,4,0,1,48,0.0,0.02040816326530612,0.9795918367346939,49,850,700,150,0.8235294117647058,10,7,3,357.31840972003334,0.4095096371882086,0.19804002212420757,0.20745062484783272,130989.80150910513,-438.98648704473817,130550.8150220604,2642,7,691.1224489795918,40,9,17,34.93580197888745,0.6231770833333332,44.080284552845534,1023.6788617886187,25.59197154471547,0
4304,4,0,0,48,0.0,0.0,1.0,48,1700,1300,400,0.7647058823529411,21,13,8,358.8464188307986,0.409057328605201,0.21759188621028747,0.2088702867688326,131088.00048828125,-191.90809461805543,130896.09239366319,2643,8,705.5,39,9,17,34.79734598040211,0.625801282051282,43.984375,1024.0625,26.25801282051282,0
4305,4,0,0,48,0.0,0.0,1.0,48,800,600,200,0.75,10,6,4,358.5934570127488,0.4092881944444444,0.22147729198440924,0.20930365873711493,131194.69536675356,-190.88812934027305,131003.80723741329,2644,9,706.5,39,9,17,34.69592018301983,0.6268696581196581,43.880208333333336,1024.4791666666672,26.268696581196593,0
4306,4,0,0,48,0.0,0.0,1.0,48,1300,1000,300,0.7692307692307693,16,10,6,358.28051830728293,0.4094267139479906,0.22172878347854152,0.20957178675618515,131277.2866669815,-193.18113819602695,131084.10552878547,2645,10,707.5,41,7,17,34.62044207808972,0.6244918699186992,43.79960317460317,1024.8015873015866,24.995160665892357,0
4307,4,1,0,49,0.02040816326530612,0.0,1.0,49,1000,700,300,0.7,13,7,6,353.73815119045366,0.41170634920634924,0.23570248070813493,0.20922783564410122,131702.0887586804,-482.3597972175175,131219.72896146288,2646,0,694.0408163265306,39,10,18,34.307979838982476,0.6319444444444446,43.38541666666666,1026.458333333332,26.319444444444407,0
4308,4,0,2,47,0.0,0.04081632653061224,0.9591836734693877,49,1150,800,350,0.6956521739130435,15,8,7,356.63207942230565,0.4119189342403628,0.23265386914860953,0.21146775413632501,131797.2932778109,-399.3714472205623,131397.92183059035,2647,1,695.0408163265306,40,9,18,34.13767649775666,0.63125,43.29268292682927,1026.8292682926835,25.67073170731709,0
4309,4,1,0,48,0.020833333333333332,0.0,1.0,48,1000,600,400,0.6,14,6,8,356.3541155831813,0.412963578605201,0.2484477952356825,0.212412891252452,131996.29041883667,-192.51573350695276,131803.7746853297,2648,0,706.4791666666666,39,9,19,33.94418398378105,0.6348824786324787,43.09895833333333,1027.6041666666656,26.34882478632476,0
4310,4,1,1,48,0.02040816326530612,0.02040816326530612,0.9795918367346939,49,750,400,350,0.5333333333333333,11,4,7,350.2482495851528,0.4142750850340136,0.24809522497017333,0.20986551186125377,132193.88247197014,-539.8648116654205,131654.01766030473,2649,0,693.0408163265306,41,8,19,33.90209981349283,0.6336382113821138,42.906746031746025,1028.3730158730148,25.082268679829628,0
4311,4,0,0,48,0.0,0.0,1.0,48,1000,700,300,0.7,13,7,6,357.5134104119973,0.4126034278959811,0.2459651507661893,0.2136000086424897,132084.41904826812,-155.6097767532637,131928.80927151485,2650,2,708.4791666666666,40,8,19,33.82558905915308,0.6341145833333335,43.013211382113816,1027.9471544715439,25.698678861788597,0
4312,4,0,0,48,0.0,0.0,1.0,48,1000,400,600,0.4,16,4,12,357.92586511295764,0.4123079196217494,0.2515738060781474,0.21432129358150218,132168.3784190759,-138.70376275511234,132029.67465632077,2651,3,709.4791666666666,41,7,19,33.73040279787747,0.6333841463414633,42.93154761904761,1028.2738095238087,25.079849012775824,0
4313,4,0,0,48,0.0,0.0,1.0,48,1350,1000,350,0.7407407407407407,17,10,7,358.0299895566399,0.41254802009456265,0.25351809882020127,0.21496311301174276,132270.4093935027,-128.64534123835688,132141.76405226433,2652,4,710.4791666666666,41,7,19,33.62496785289485,0.6344004065040652,42.832341269841265,1028.6706349206343,25.08952768099108,0
4314,4,1,0,49,0.02040816326530612,0.0,1.0,49,900,600,300,0.6666666666666666,12,6,6,352.2837291698613,0.41330073696145125,0.26223674460175483,0.21329021618508376,132585.67843967007,-458.26001733158773,132127.4184223385,2653,0,696.9591836734694,39,10,20,33.45565304608746,0.6407585470085471,42.526041666666664,1029.8958333333328,26.407585470085458,0
4315,4,0,0,49,0.0,0.0,1.0,49,1000,700,300,0.7,13,7,6,351.9936978534623,0.41236181972789115,0.2712206862825992,0.21413125914408868,132764.32188388178,-453.5590794170303,132310.76280446476,2654,1,697.9591836734694,40,9,19,33.283617657693185,0.6408854166666667,42.352642276422756,1030.5894308943077,25.764735772357692,0
4316,4,0,0,49,0.0,0.0,1.0,49,1650,1200,450,0.7272727272727273,21,12,9,354.3408345303882,0.4121846655328798,0.27481605554759225,0.21624570130794568,132883.42195964,-382.79547351351687,132500.62648612648,2655,2,698.9591836734694,41,8,19,33.103511177395035,0.6404979674796749,42.237103174603156,1031.0515873015845,25.147599690282547,0
4317,4,1,2,48,0.02,0.04,0.96,50,800,300,500,0.375,13,3,10,348.7087407478165,0.41241496598639454,0.2774701849938963,0.21402878272181525,133097.00180465402,-717.5824206778558,132379.41938397617,2656,0,685.96,42,8,19,33.034400726202776,0.6411210317460319,42.030038759689916,1031.879844961239,24.56856773717236,0
4318,4,0,0,48,0.0,0.0,1.0,48,950,500,450,0.5263157894736842,14,5,9,355.1339881043751,0.4118831264775414,0.273165512598577,0.21747250932327974,133011.3112953514,-152.63251133787645,132858.67878401352,2657,4,701.0416666666666,41,7,19,32.95465474129641,0.6417682926829269,42.113095238095234,1031.5476190476184,25.159698025551666,0
4319,4,1,1,48,0.02040816326530612,0.02040816326530612,0.9795918367346939,49,800,600,200,0.75,10,6,4,349.2167953241377,0.4143813775510204,0.2704100791649744,0.21477236165084965,133172.00363559872,-498.81993269636024,132673.18370290237,2658,0,687.7142857142857,42,7,19,32.946082112905245,0.6418650793650793,41.95736434108527,1032.1705426356582,24.575489110372814,0
4320,4,0,0,48,0.0,0.0,1.0,48,1100,800,300,0.7272727272727273,14,8,6,354.42280720252666,0.4117076684397163,0.2711898010189373,0.21778266174411615,133139.2621429359,-162.48179248550696,132976.7803504504,2659,6,703.0416666666666,41,7,20,32.84459210484155,0.6430386178861789,41.989087301587304,1032.043650793651,25.171796360820757,0
4321,4,0,0,48,0.0,0.0,1.0,48,1150,800,350,0.6956521739130435,15,8,7,351.36643703598486,0.4117815455082742,0.2669537330642835,0.2164991421097394,133241.66710955222,-236.6700325963635,133004.99707695586,2660,7,704.0416666666666,41,7,20,32.820757663111365,0.6440548780487805,41.889880952380956,1032.4404761904768,25.18147502903602,0
4322,4,0,0,48,0.0,0.0,1.0,48,1450,1200,250,0.8275862068965517,17,12,5,352.55498232590725,0.4108026743498818,0.26547196082197067,0.21828225837942933,133420.97052941562,-192.35441861928302,133228.61611079634,2661,8,705.0416666666666,41,7,20,32.61034824915178,0.6458333333333333,41.71626984126985,1033.1349206349219,25.198412698412728,0
4323,4,0,1,47,0.0,0.020833333333333332,0.9791666666666666,48,1050,600,450,0.5714285714285714,15,6,9,355.42403746097796,0.41067338947990545,0.26646505376344054,0.2203629032258065,133472.2222222223,-112.1527777777676,133360.06944444453,2662,9,706.0416666666666,41,7,20,32.484879032258064,0.646341463414634,41.66666666666667,1033.3333333333342,25.203252032520346,0
4324,4,0,0,47,0.0,0.0,1.0,47,1250,900,350,0.72,16,9,7,346.8753606795917,0.41146315140302187,0.24966478339325637,0.20527478676879482,131721.78578985823,-257.4513311788387,131464.3344586794,2663,10,720.4042553191489,37,10,17,34.464234850103274,0.6356981981981983,43.36622807017543,1026.5350877192968,27.744191559980994,6
4325,4,0,0,47,0.0,0.0,1.0,47,950,700,250,0.7368421052631579,12,7,5,348.6575244665911,0.4115980573543016,0.2499153526442932,0.20648199883495832,131749.9269606993,-212.87932344568793,131537.0476372536,2664,11,721.4042553191489,37,10,17,34.39013047812313,0.6359797297297298,43.33881578947368,1026.644736842104,27.747155049786596,0
4326,4,0,0,47,0.0,0.0,1.0,47,1250,900,350,0.72,16,9,7,349.7648622294272,0.4115595127967931,0.24867291010314663,0.20775190009531014,131862.52170138873,-175.82465277779664,131686.69704861092,2665,12,722.4042553191489,37,10,17,34.248225152129805,0.6371058558558559,43.22916666666666,1027.083333333332,27.75900900900897,0
4327,4,1,0,48,0.020833333333333332,0.0,1.0,48,1450,1000,450,0.6896551724137931,19,10,9,344.5675402231045,0.4138593380614657,0.26152343090583763,0.20655223586051652,132210.4614257811,-488.9133029514033,131721.5481228297,2666,0,708.3333333333334,39,9,18,34.03147050879503,0.6370192307692308,42.89062499999999,1028.4374999999989,26.370192307692278,0
4328,4,0,0,48,0.0,0.0,1.0,48,1450,1100,350,0.7586206896551724,18,11,7,340.9468096751736,0.4137577570921986,0.25794986669366526,0.20496236391732728,132317.61203342007,-577.3464626736201,131740.26557074644,2667,1,709.3333333333334,39,9,18,34.016844689683104,0.6380876068376069,42.78645833333333,1028.854166666666,26.380876068376054,0
4329,4,0,0,48,0.0,0.0,1.0,48,1900,1500,400,0.7894736842105263,23,15,8,336.0956500296988,0.4137577570921986,0.2493643628061437,0.20292090749913383,132480.48159105846,-694.7528706186388,131785.72872043983,2668,2,710.3333333333334,38,10,18,33.9780510585305,0.6414473684210527,42.628205128205124,1029.487179487179,27.09176788124155,0
4330,4,0,0,48,0.0,0.0,1.0,48,1550,1100,450,0.7096774193548387,20,11,9,337.49118982445196,0.4139239804964539,0.24164979757085003,0.20331786313814562,132398.0034722223,-663.3680555555503,131734.63541666674,2669,3,711.3333333333334,39,9,16,34.024966261808366,0.638888888888889,42.708333333333336,1029.1666666666672,26.388888888888903,3
4331,4,0,0,48,0.0,0.0,1.0,48,1200,900,300,0.75,15,9,6,338.5595962061429,0.41242796985815605,0.2505795818580343,0.20468878339435626,132532.04345703125,-626.0009765624995,131906.04248046875,2670,4,712.3333333333334,39,9,16,33.86286039453718,0.640224358974359,42.578125,1029.6875,26.40224358974359,0
4332,4,0,0,48,0.0,0.0,1.0,48,650,400,250,0.6153846153846154,9,4,5,338.8621144839384,0.41187389184397166,0.25371068069181746,0.2051640983406431,132585.67843967024,-614.3473307291567,131971.33110894109,2671,5,713.3333333333334,39,9,16,33.80122467212837,0.6407585470085471,42.52604166666667,1029.8958333333342,26.40758547008549,0
4333,4,0,0,48,0.0,0.0,1.0,48,1450,800,650,0.5517241379310345,21,8,13,337.6307630062749,0.4111074172576832,0.2615425706771859,0.20525035592827517,132738.13950029752,-636.7041360962293,132101.4353642013,2672,6,714.3333333333334,40,8,13,33.67993918474688,0.640625,42.37804878048781,1030.4878048780495,25.762195121951237,0
4334,4,0,0,48,0.0,0.0,1.0,48,1200,1000,200,0.8333333333333334,14,10,4,339.82967939807503,0.4103224734042554,0.26856165171382584,0.20702056685493544,132816.69439693636,-572.9890648754003,132243.70533206096,2673,7,715.3333333333334,40,8,14,33.54448059417005,0.64140625,42.301829268292686,1030.7926829268295,25.769817073170735,0
4335,4,0,0,48,0.0,0.0,1.0,48,1500,1300,200,0.8666666666666667,17,13,4,386.1398319876812,0.4102947695035461,0.2525719901970791,0.218961631421851,130076.563856337,478.33683544178245,130554.90069177878,2674,8,716.3333333333334,39,9,15,35.12638704516833,0.6156517094017093,44.97395833333334,1020.1041666666682,26.156517094017133,8
4336,4,3,3,48,0.058823529411764705,0.058823529411764705,0.9411764705882353,51,900,500,400,0.5555555555555556,13,5,8,366.1117733627201,0.41736928104575166,0.25082998223136643,0.21127000499555143,130755.83316808783,-625.4841662483814,130130.34900183945,2675,0,675.1372549019608,40,11,14,34.947792461579226,0.6208333333333333,44.3089430894309,1022.7642276422769,25.569105691056922,0
4337,4,1,0,49,0.02040816326530612,0.0,1.0,49,1250,800,450,0.64,17,8,9,377.7272769781813,0.41390306122448983,0.2563814516632339,0.2166961746874833,130528.56445312528,60.83984375002966,130589.4042968753,2676,0,703.6734693877551,39,10,15,34.88149847094803,0.6201923076923076,44.531250000000014,1021.8750000000022,26.201923076923133,0
4338,4,0,1,48,0.0,0.02040816326530612,0.9795918367346939,49,1050,900,150,0.8571428571428571,12,9,3,375.68854535515334,0.4138499149659864,0.2490228365184699,0.21641776767642,130688.28125000042,19.618055555598858,130707.89930555603,2677,1,704.6734693877551,39,10,15,34.77146155935888,0.6217948717948716,44.37500000000002,1022.5000000000034,26.217948717948804,0
4339,4,0,0,48,0.0,0.0,1.0,48,1500,1100,400,0.7333333333333333,19,11,8,380.95227077024504,0.4117261377068558,0.2526857849282629,0.21966717685619203,130726.5185550443,360.11281868654453,131086.63137373084,2678,2,720.125,38,10,15,34.59808991502995,0.6239035087719298,44.33760683760684,1022.6495726495734,26.911830859199302,0
4340,4,1,1,48,0.02040816326530612,0.02040816326530612,0.9795918367346939,49,1550,1200,350,0.7741935483870968,19,12,7,371.969462552093,0.4141687925170068,0.24905017958353137,0.21635856904657277,131061.3335503475,-49.83723958330572,131011.4963107642,2679,0,706.4081632653061,39,10,15,34.48838589352323,0.6255341880341879,44.01041666666668,1023.9583333333355,26.255341880341938,0
4341,4,2,2,48,0.04,0.04,0.96,50,1650,1300,350,0.7878787878787878,20,13,7,364.5316940974285,0.41546768707482995,0.23999999999999977,0.21351142082849403,131328.12500000015,-425.3472222222082,130902.77777777794,2680,0,693.24,40,10,15,34.40887533875339,0.6265624999999999,43.75000000000001,1025.0000000000011,25.62500000000003,0
4342,4,0,0,48,0.0,0.0,1.0,48,1350,1000,350,0.7407407407407407,17,10,7,377.59422002904404,0.4115229757683215,0.24068085402322859,0.21990389995130105,131109.19922017667,301.21516363502644,131410.4143838117,2681,5,723.125,38,10,16,34.29589157799569,0.6277412280701755,43.96367521367521,1024.1452991452984,26.951192082771012,0
4343,4,0,0,48,0.0,0.0,1.0,48,1550,1200,350,0.7741935483870968,19,12,7,376.05540677620286,0.41069185874704495,0.2452675576786254,0.22010762327608951,131301.43364800359,275.3228081597323,131576.7564561633,2682,6,724.125,39,9,17,34.140601178981605,0.6279380341880341,43.77604166666667,1024.8958333333344,26.27938034188037,0
4344,4,0,0,48,0.0,0.0,1.0,48,950,600,350,0.631578947368421,13,6,7,377.75133848899486,0.4108119089834515,0.24288617886178865,0.2212543554006967,131328.12499999988,321.8831380208211,131650.0081380207,2683,7,725.125,36,12,17,34.0701219512195,0.6336805555555556,43.74999999999999,1024.999999999999,28.472222222222197,0
4345,4,2,1,49,0.04,0.02,0.98,50,1700,1200,500,0.7058823529411765,22,12,10,362.7283372684326,0.41622448979591836,0.25718028696194595,0.21615372663245253,131985.99810979606,-424.9876725838442,131561.01043721222,2684,0,697.08,38,12,16,33.7908088999792,0.636513157894737,43.10897435897435,1027.5641025641016,27.04116059379215,0
4346,4,0,0,49,0.0,0.0,1.0,49,1400,1000,400,0.7142857142857143,18,10,8,368.94283259629975,0.4131235827664399,0.26230698207520153,0.21938066390930225,131903.67408366184,-67.01697074295032,131836.65711291888,2685,1,712.3061224489796,38,11,16,33.71424856994281,0.6356907894736843,43.189102564102555,1027.243589743588,27.032726045883894,0
4347,4,0,0,49,0.0,0.0,1.0,49,1900,1600,300,0.8421052631578947,22,16,6,370.3237414812008,0.4135133219954648,0.2663835852362144,0.22132018885292631,132095.80342793482,-16.357568120393807,132079.44585981444,2686,2,713.3061224489796,38,11,16,33.48489572507447,0.637609649122807,43.00213675213675,1027.9914529914527,27.052406657669806,0
4348,4,0,0,49,0.0,0.0,1.0,49,700,500,200,0.7142857142857143,9,5,4,372.75110229414014,0.4133893140589569,0.2698865082192481,0.22309431644768674,132150.72320841538,51.86554898092078,132202.5887573963,2687,3,714.3061224489796,38,11,16,33.36710307564422,0.6381578947368423,42.94871794871794,1028.2051282051273,27.058029689608613,0
4349,4,0,0,49,0.0,0.0,1.0,49,1250,800,450,0.64,17,8,9,371.89246782843685,0.4132298752834467,0.27356732658784977,0.22306596808625284,132233.12428090058,35.30058349768666,132268.42486439826,2688,4,715.3061224489796,38,11,17,33.30606627194351,0.6389802631578948,42.86858974358974,1028.5256410256397,27.066464237516836,0
4350,4,0,0,49,0.0,0.0,1.0,49,900,300,600,0.3333333333333333,15,3,12,369.30889991042824,0.41310586734693877,0.26632133796503354,0.22183876464363766,132288.0725970669,-28.96748758127444,132259.10510948562,2689,5,716.3061224489796,38,11,17,33.31710631079725,0.6395285087719298,42.81517094017094,1028.7393162393157,27.072087269455675,0
4351,4,0,2,47,0.0,0.04081632653061224,0.9591836734693877,49,1350,900,450,0.6666666666666666,18,9,9,365.35593109213437,0.412733843537415,0.2655539948773038,0.22010467068233447,132398.0034722221,-125.52083333334338,132272.48263888876,2690,6,717.3061224489796,38,11,17,33.30802968960866,0.640625,42.70833333333333,1029.1666666666656,27.083333333333304,0
4352,4,0,0,47,0.0,0.0,1.0,47,1200,1000,200,0.8333333333333334,14,10,4,362.7425821914202,0.4129663891458526,0.26001441120101076,0.21003191834878726,130885.78976014616,99.91014772953599,130985.69990787569,2691,7,724.5531914893617,40,7,16,34.90229913596187,0.6221354166666666,44.181910569105696,1023.2723577235779,25.58180894308945,5
4353,4,1,0,48,0.020833333333333332,0.0,1.0,48,850,600,250,0.7058823529411765,11,6,5,356.2919358893512,0.4134530141843971,0.26568551510457006,0.20813252906477497,131226.45817586302,-249.01423532374804,130977.44394053928,2692,0,710.4375,41,7,17,34.72276013426285,0.6239837398373983,43.849206349206355,1024.6031746031754,24.990321331784767,0
4354,4,0,1,47,0.0,0.020833333333333332,0.9791666666666666,48,1450,1000,450,0.6896551724137931,19,10,9,355.9389252429105,0.4137485224586288,0.2650745257452569,0.20847851335656212,131328.12500000015,-251.00229906776173,131077.12270093238,2693,1,711.4375,40,8,18,34.629065040650396,0.6265624999999999,43.75000000000001,1025.0000000000011,25.62500000000003,0
4355,4,1,1,47,0.020833333333333332,0.020833333333333332,0.9791666666666666,48,1100,800,300,0.7272727272727273,14,8,6,346.0101858159625,0.4149028516548463,0.2590621087537641,0.20422686282043429,131621.90890842024,-491.49576822915816,131130.41314019109,2694,0,709.1458333333334,39,9,15,34.587118905018094,0.6311431623931624,43.46354166666667,1026.1458333333342,26.311431623931647,0
4356,4,0,0,47,0.0,0.0,1.0,47,1050,700,350,0.6666666666666666,14,7,7,350.95683435040826,0.41229185938945423,0.26224146565210305,0.20674156585476183,131547.23340821092,-166.51987910001242,131380.71352911092,2695,3,725.2340425531914,38,9,18,34.53555682843852,0.6321271929824561,43.53632478632478,1025.8547008547002,26.996176338281586,0
4357,4,0,0,47,0.0,0.0,1.0,47,1200,700,500,0.5833333333333334,17,7,10,352.6591352705694,0.412195497995683,0.2661734247455343,0.20819243972180787,131629.4461451711,-115.93466926000923,131513.51147591107,2696,4,726.2340425531914,38,9,15,34.408944993926774,0.6329495614035088,43.45619658119657,1026.175213675212,27.00461088618979,0
4358,4,0,0,47,0.0,0.0,1.0,47,1200,900,300,0.75,15,9,6,352.91311772642956,0.41182932469935246,0.26291793313069944,0.2090331543456543,131755.55555555545,-100.34722222223309,131655.20833333323,2697,5,727.2340425531914,39,8,15,34.27522997835497,0.6324786324786326,43.33333333333333,1026.6666666666658,26.324786324786302,0
4359,4,0,1,46,0.0,0.02127659574468085,0.9787234042553191,47,1150,800,350,0.6956521739130435,15,8,7,354.9838650148531,0.41144387912426766,0.2602601695482094,0.211000355208648,131889.2700195314,-36.28743489582001,131852.98258463558,2698,6,728.2340425531914,39,8,15,34.08725027887638,0.6338141025641024,43.20312500000001,1027.1875000000011,26.338141025641054,0
4360,4,0,0,46,0.0,0.0,1.0,46,850,600,250,0.7058823529411765,11,6,5,362.894184322825,0.4092089371980676,0.2640229833054333,0.21500697357227816,131766.52444480988,363.4610818905858,132129.98552670048,2699,7,743.6086956521739,38,8,15,34.00797780090183,0.6343201754385963,43.32264957264958,1026.7094017094032,27.018668466036928,0
4361,4,0,0,46,0.0,0.0,1.0,46,900,700,200,0.7777777777777778,11,7,4,364.0070969453441,0.4090780998389694,0.2651495625042388,0.21644577842482915,131903.67408366228,402.774695923761,132306.44877958603,2700,8,744.6086956521739,38,8,15,33.84100364014562,0.6356907894736841,43.189102564102576,1027.2435897435914,27.032726045883987,0
4362,4,0,0,46,0.0,0.0,1.0,46,1000,600,400,0.6,14,6,8,362.3592334705154,0.40817230273752014,0.2554669811960246,0.21640336345250366,132068.3478180476,371.2370562130462,132439.58487426065,2701,9,745.6086956521739,38,8,15,33.717259120673525,0.6373355263157894,43.02884615384617,1027.8846153846175,27.04959514170046,0
4363,4,0,0,46,0.0,0.0,1.0,46,1100,500,600,0.45454545454545453,17,5,12,366.60614568489166,0.40717592592592594,0.2599436309271088,0.2197354145929495,132205.65440317048,493.48107969903486,132699.13548286952,2702,10,746.6086956521739,38,8,16,33.46968280351825,0.6387061403508771,42.89529914529915,1028.4188034188037,27.063652721547466,0
4364,4,0,0,46,0.0,0.0,1.0,46,1450,1000,450,0.6896551724137931,19,10,9,364.6978355091928,0.40676328502415454,0.2580697603005724,0.21890964839666532,132260.59701219967,447.0306907005747,132707.62770290024,2703,11,747.6086956521739,38,8,16,33.463379379587316,0.6392543859649122,42.84188034188035,1028.6324786324794,27.069275753486302,0
4365,4,0,0,46,0.0,0.0,1.0,46,1050,800,250,0.7619047619047619,13,8,5,361.77359690425294,0.4057971014492754,0.2610704563614774,0.21762907631385772,132343.0323275076,375.6429660676584,132718.67529357524,2704,12,748.6086956521739,38,8,16,33.45555151766865,0.6400767543859648,42.76175213675214,1028.9529914529924,27.077710301394536,0
4366,4,0,0,46,0.0,0.0,1.0,46,1200,600,600,0.5,18,6,12,362.6811655841245,0.4051630434782609,0.263485669305922,0.2191490440691719,132510.87474030483,411.8511149513783,132922.7258552562,2705,13,749.6086956521739,37,9,17,33.26322328718495,0.643581081081081,42.59868421052632,1029.6052631578957,27.82716927453772,0
4367,4,0,1,45,0.0,0.021739130434782608,0.9782608695652174,46,1200,800,400,0.6666666666666666,16,8,8,365.56136473625725,0.40390499194847024,0.27241797230972753,0.2223890787803289,132765.0109288435,506.75171687442526,133271.7626457179,2706,14,750.6086956521739,37,9,16,32.93335727205022,0.6461148648648647,42.35197368421053,1030.592105263158,27.853840682788054,0
4368,4,0,1,44,0.0,0.022222222222222223,0.9777777777777777,45,950,700,250,0.7368421052631579,12,7,5,372.0337764170285,0.40315656565656566,0.2656270873562385,0.22586177972391458,132687.90486009658,872.8764659930191,133560.7813260896,2707,15,764.5333333333333,36,9,16,32.84420883885307,0.6472800925925927,42.4268018018018,1030.2927927927926,28.61924424424424,0
4369,4,1,1,44,0.022222222222222223,0.022222222222222223,0.9777777777777777,45,750,400,350,0.5333333333333333,11,4,7,370.323923235855,0.40477693602693604,0.25721153846153855,0.22534604690522242,132774.9370992614,833.9471227984723,133608.8842220599,2708,0,756.4222222222222,36,9,16,32.800662878787875,0.6481481481481481,42.34234234234234,1030.6306306306305,28.628628628628626,0
4370,4,0,0,44,0.0,0.0,1.0,44,950,600,350,0.631578947368421,13,6,7,375.36053937416904,0.4013169485553207,0.2571061014457241,0.22829304935707648,132755.59413580244,1166.2422839506103,133921.83641975306,2709,17,774.6136363636364,35,9,17,32.690363881401616,0.65,42.36111111111111,1030.5555555555552,29.444444444444436,0
4371,4,0,0,44,0.0,0.0,1.0,44,800,500,300,0.625,11,5,6,373.39586641393,0.4013499823819591,0.25368964144646267,0.22764113498623356,132845.06715374216,1120.7597897376424,133965.8269434798,2710,18,775.6136363636364,35,9,17,32.650934658134055,0.6508928571428572,42.27430555555555,1030.9027777777767,29.454365079365047,0
4372,4,1,0,45,0.022222222222222223,0.0,1.0,45,950,800,150,0.8421052631578947,11,8,3,367.48861127575003,0.4023148148148148,0.2559604334860719,0.22606715509755193,133181.4648263128,788.5343113383665,133969.99913765115,2711,0,759.3555555555556,36,9,18,32.465088370063285,0.6521990740740742,41.9481981981982,1032.2072072072071,28.67242242242242,0
4373,4,0,0,45,0.0,0.0,1.0,45,700,400,300,0.5714285714285714,10,4,6,365.2616093361217,0.402020202020202,0.250967620126499,0.22508529538670946,133245.71021852872,733.908510310859,133979.6187288396,2712,1,760.3555555555556,37,8,18,32.458050127442654,0.6509009009009009,41.8859649122807,1032.4561403508767,27.904220009483154,0
4374,4,0,0,45,0.0,0.0,1.0,45,1250,900,350,0.72,16,9,7,368.46843478830687,0.4019991582491582,0.25198084047096625,0.22740732102465733,133302.32018505674,823.5394544475048,134125.85963950426,2713,2,761.3555555555556,37,8,18,32.31843278827777,0.6514639639639641,41.831140350877185,1032.6754385964898,27.91014698909432,0
4375,4,0,0,45,0.0,0.0,1.0,45,950,300,650,0.3157894736842105,16,3,13,369.8885814468109,0.4018097643097643,0.25185499658010824,0.22898096020971404,133415.57618690346,869.7796437365112,134285.35583063998,2714,3,762.3555555555556,37,8,18,32.16806410528549,0.6525900900900903,41.721491228070164,1033.1140350877176,27.922000948316693,0
4376,4,0,0,45,0.0,0.0,1.0,45,1450,1300,150,0.896551724137931,16,13,3,368.08793517064976,0.4011363636363636,0.25206583809203975,0.22876780438476466,133561.93636670505,832.5315207830815,134394.46788748814,2715,4,763.3555555555556,35,10,18,32.067727578098754,0.6580357142857144,41.5798611111111,1033.6805555555538,29.53373015873011,0
4377,4,1,0,46,0.021739130434782608,0.0,1.0,46,1450,1100,350,0.7586206896551724,18,11,7,362.85619314618884,0.40503220611916263,0.24968653446701383,0.2272859958296064,133850.68081172367,513.709697873522,134364.3905095972,2716,0,747.7391304347826,36,10,16,31.91361047629411,0.6588541666666667,41.30067567567566,1034.7972972972957,28.744369369369323,0
4378,4,0,2,44,0.0,0.043478260869565216,0.9565217391304348,46,650,400,250,0.6153846153846154,9,4,5,333.5573439984266,0.4051630434782609,0.1720647773279349,0.200947960896613,132398.00347222216,-367.53472222223087,132030.46874999994,2717,1,748.7391304347826,38,8,19,34.12618083670715,0.640625,42.70833333333333,1029.166666666666,27.083333333333318,6
4379,4,0,1,43,0.0,0.022727272727272728,0.9772727272727273,44,1550,1300,250,0.8387096774193549,18,13,5,337.5586871783577,0.3997753699788584,0.194040296411101,0.20320643227510488,132369.79316953287,136.51472087564287,132506.30789040853,2718,7,780.8636363636364,37,7,19,34.05156721719055,0.6421734234234234,42.73574561403508,1029.057017543859,27.812351825509705,0
4380,4,0,1,42,0.0,0.023255813953488372,0.9767441860465116,43,1500,1200,300,0.8,18,12,6,343.1083897400412,0.39954780361757103,0.19532746658932498,0.20702005218572417,132455.95838659626,489.3501186998047,132945.30850529607,2719,8,797.0232558139535,36,7,19,33.82220216606499,0.6449652777777777,42.65202702702704,1029.3918918918935,28.594219219219262,0
4381,4,2,2,42,0.045454545454545456,0.045454545454545456,0.9545454545454546,44,650,300,350,0.46153846153846156,10,3,7,328.8006657896856,0.4045102184637068,0.19081488459726792,0.20056424935970082,132865.71905361972,-62.73262290890156,132802.98643071082,2720,0,775.2727272727273,38,6,17,33.7795768566494,0.6452850877192982,42.254273504273506,1030.9829059829062,27.131129104813322,0
4382,4,0,0,42,0.0,0.0,1.0,42,1200,800,400,0.6666666666666666,16,8,8,343.2233683775726,0.4000919473480449,0.20480980496287704,0.20788880312458832,132600.90115453317,702.3455888321035,133303.24674336528,2721,10,813.1904761904761,36,6,20,33.67364603834099,0.646412037037037,42.511261261261275,1029.954954954957,28.609859859859917,0
4383,4,0,0,42,0.0,0.0,1.0,42,1300,1000,300,0.7692307692307693,16,10,6,346.0848077831597,0.39940234223770804,0.20826826576717195,0.20994587676394902,132658.9004545089,782.2460129048295,133441.14646741372,2722,11,814.1904761904761,36,6,17,33.54171221396297,0.6469907407407407,42.45495495495497,1030.1801801801828,28.61611611611619,0
4384,4,0,0,42,0.0,0.0,1.0,42,900,400,500,0.4444444444444444,14,4,10,349.4735675103057,0.39871273712737126,0.20959300359497046,0.21282312464549777,132803.95418645014,882.2943298027978,133686.24851625293,2723,12,815.1904761904761,36,6,17,33.30875122910521,0.6484375,42.3141891891892,1030.7432432432447,28.631756756756797,0
4385,4,0,0,42,0.0,0.0,1.0,42,900,400,500,0.4444444444444444,14,4,10,352.9546400501619,0.3983134920634921,0.21899666177892874,0.21577827727499235,132949.08717839472,984.9994420095895,133934.0866204043,2724,13,816.1904761904761,36,6,18,33.0733147703283,0.6498842592592593,42.17342342342343,1031.306306306307,28.64739739739742,0
4386,4,0,0,42,0.0,0.0,1.0,42,1300,900,400,0.6923076923076923,17,9,8,353.2996271706608,0.3982530003871467,0.21763323820959424,0.21649350398063047,133036.20501836305,1000.3283266374601,134036.5333450005,2725,14,817.1904761904761,36,6,18,32.97697667649092,0.6507523148148149,42.08896396396397,1031.644144144145,28.656781781781806,0
4387,4,0,0,42,0.0,0.0,1.0,42,1400,1100,300,0.7857142857142857,17,11,6,354.5013540625894,0.3978900503290747,0.22184033460629204,0.21790777397609884,133152.40652392263,1040.5416818845938,134192.94820580722,2726,15,818.1904761904761,36,6,18,32.829378068739764,0.6519097222222222,41.976351351351354,1032.094594594595,28.669294294294307,0
4388,4,0,0,42,0.0,0.0,1.0,42,1000,500,500,0.5,15,5,10,355.2305306967085,0.3978658536585366,0.22527512477343437,0.21903891970128575,133268.65875588416,1068.219275018248,134336.87803090242,2727,16,819.1904761904761,36,6,18,32.69395063074854,0.6530671296296298,41.86373873873873,1032.5450450450442,28.681806806806783,0
4389,4,0,0,42,0.0,0.0,1.0,42,1050,600,450,0.5714285714285714,15,6,9,354.820196244689,0.3976117886178862,0.22123383704626942,0.21895701208370072,133297.72973987483,1059.3453250547664,134357.0750649296,2728,17,820.1904761904761,36,6,18,32.67539076699383,0.6533564814814816,41.83558558558558,1032.6576576576563,28.684934934934898,0
4390,4,0,0,42,0.0,0.0,1.0,42,1000,600,400,0.6,14,6,8,354.8376021281345,0.3971883468834689,0.22083184085800456,0.21948248983960744,133384.96171424803,1065.9999949273551,134450.96170917538,2729,18,821.1904761904761,36,6,18,32.58748501035648,0.6542245370370371,41.751126126126124,1032.9954954954953,28.694319319319316,0
4391,4,0,0,42,0.0,0.0,1.0,42,1100,900,200,0.8181818181818182,13,9,4,358.02549427679526,0.3969342818428185,0.22657450076804975,0.22197580645161286,133472.22222222204,1157.3202002678154,134629.54242248985,2730,19,822.1904761904761,35,7,18,32.4176747311828,0.6571428571428573,41.66666666666666,1033.333333333332,29.523809523809483,0
4392,4,0,0,42,0.0,0.0,1.0,42,1400,1300,100,0.9285714285714286,15,13,2,355.3185219368263,0.39723674022454514,0.22074868021116645,0.2206532963070832,133532.02830289767,1089.2805855624028,134621.30888846007,2731,20,823.1904761904761,35,7,18,32.427678238148566,0.6577380952380952,41.60879629629629,1033.5648148148139,29.530423280423253,0
4393,4,0,0,42,0.0,0.0,1.0,42,650,500,150,0.7692307692307693,8,5,3,355.5008544430537,0.39703106852497094,0.21991555242786776,0.22112351196973223,133591.84777949244,1098.403206447184,134690.25098593964,2732,21,824.1904761904761,35,7,19,32.36303925959098,0.6583333333333334,41.550925925925924,1033.796296296296,29.53703703703703,0
4394,4,0,0,42,0.0,0.0,1.0,42,1100,800,300,0.7272727272727273,14,8,6,358.3505184384893,0.3966197251258227,0.22170354265251335,0.22361873133843135,133711.5269204388,1183.1189986282388,134894.64591906703,2733,22,825.1904761904761,35,7,17,32.169501641301096,0.6595238095238096,41.435185185185176,1034.259259259258,29.550264550264515,0
4395,4,0,0,42,0.0,0.0,1.0,42,1150,1000,150,0.8695652173913043,13,10,3,344.92603786143883,0.39663182346109177,0.13932631750444235,0.20277141622363515,131468.650510253,672.0177448355242,132140.66825508853,2734,23,826.1904761904761,37,5,20,34.769481271606246,0.6331644144144144,43.61293859649122,1025.548245614034,27.717520151730646,7
4396,4,0,0,42,0.0,0.0,1.0,42,1250,1100,150,0.88,14,11,3,344.6889869598169,0.39729723190089045,0.13884350105622145,0.2029304891761538,131524.88175448202,667.0356503924137,132191.91740487443,2735,24,827.1904761904761,37,5,22,34.71884464635666,0.6337274774774775,43.55811403508771,1025.7675438596482,27.723447131341842,0
4397,4,1,0,43,0.023255813953488372,0.0,1.0,43,1100,900,200,0.8181818181818182,13,9,4,338.37255885792774,0.4005860095976375,0.14310079132182918,0.200912625589948,131848.80566741535,322.80355120899003,132171.60921862433,2736,0,808.9302325581396,38,5,17,34.55455286244322,0.6351425438596492,43.24252136752136,1027.0299145299139,27.0271030139451,0
4398,4,0,0,43,0.0,0.0,1.0,43,700,500,200,0.7142857142857143,9,5,4,338.85491951032355,0.4004937246216316,0.14464855032147894,0.20134432609222794,131876.23844875433,337.382432975367,132213.6208817297,2737,1,809.9302325581396,38,5,17,34.51455342902711,0.6354166666666667,43.21581196581196,1027.136752136751,27.029914529914503,0
4399,4,1,1,43,0.022727272727272728,0.022727272727272728,0.9772727272727273,44,1100,900,200,0.8181818181818182,13,9,4,331.8239348783757,0.4022198731501057,0.14530898772893086,0.19821056836439557,132076.58420138905,-34.76562499997996,132041.81857638908,2738,0,792.5,39,5,17,34.4936495068234,0.6356837606837606,43.02083333333334,1027.916666666668,26.356837606837644,0
4400,4,0,0,43,0.0,0.0,1.0,43,1400,1100,300,0.7857142857142857,17,11,6,342.22059897735585,0.40056293835363604,0.15091137649277186,0.20422842197035748,132040.8950617284,437.4228395061753,132478.31790123458,2739,3,811.9302325581396,38,5,18,34.26238738738739,0.6370614035087719,43.05555555555556,1027.7777777777778,27.046783625730995,0
4401,4,0,0,43,0.0,0.0,1.0,43,900,700,200,0.7777777777777778,11,7,4,355.5234433034023,0.4003322259136213,0.15950704404888794,0.21141361472057613,131905.89871966562,787.8084165246349,132693.70713619026,2740,4,812.9302325581396,36,7,18,34.056630490389544,0.6394675925925926,43.18693693693694,1027.2522522522524,28.53478478478479,2
4402,4,0,0,43,0.0,0.0,1.0,43,650,600,50,0.9230769230769231,7,6,1,355.5234433034023,0.4003322259136213,0.15950704404888794,0.21141361472057613,131905.89871966562,779.1278609690793,132685.0265806347,2741,5,813.9302325581396,36,7,18,34.056630490389544,0.6394675925925926,43.18693693693694,1027.2522522522524,28.53478478478479,0
4403,4,0,1,42,0.0,0.023255813953488372,0.9767441860465116,43,1400,1100,300,0.7857142857142857,17,11,6,361.0624262125336,0.4012320044296789,0.16184293663249294,0.2156922661301055,132079.4781267757,937.7873650678015,133017.26549184351,2742,6,814.9302325581396,36,7,19,33.73936422728601,0.6412037037037035,43.01801801801803,1027.92792792793,28.553553553553613,0
4404,4,0,1,41,0.0,0.023809523809523808,0.9761904761904762,42,950,600,350,0.631578947368421,13,6,7,367.9852261179959,0.3977932636469222,0.1675245709138291,0.2197765160157314,132070.63567654768,1320.008546596387,133390.64422314407,2743,32,835.1904761904761,35,7,19,33.57037964943887,0.6431547619047618,43.02662037037038,1027.89351851852,29.368386243386286,0
4405,4,1,1,41,0.023809523809523808,0.023809523809523808,0.9761904761904762,42,1250,800,450,0.64,17,8,9,361.2892219281139,0.39828929539295393,0.16362453203078564,0.21748290265151413,132368.22601862578,1164.6426772548164,133532.8686958806,2744,0,828.7619047619048,35,7,19,33.44264330971396,0.6461309523809522,42.737268518518526,1029.0509259259268,29.40145502645505,0
4406,4,0,0,41,0.0,0.0,1.0,41,1000,700,300,0.7,13,7,6,369.30148454975665,0.3957825203252032,0.1646433198506272,0.22176053703922485,132275.51197562352,1569.9085884353676,133845.42056405888,2745,34,849.9756097560976,34,7,20,33.329957952397486,0.6473651960784315,42.82738095238095,1028.6904761904757,30.255602240896344,0
4407,4,1,1,41,0.023809523809523808,0.023809523809523808,0.9761904761904762,42,1250,900,350,0.72,16,9,7,358.00629825338575,0.3968012001548587,0.1654779790108578,0.2170867903844812,132643.15653344675,1097.4737811791376,133740.6303146259,2746,0,830.7142857142857,34,8,18,33.25051042027814,0.6510416666666667,42.470238095238095,1030.1190476190477,30.29761904761905,0
4408,4,0,0,41,0.0,0.0,1.0,41,1050,800,250,0.7619047619047619,13,8,5,373.0378607007417,0.3953252032520325,0.12851671918196272,0.21769473657258112,131187.67463305994,1590.1768072475747,132777.8514403075,2747,36,851.9756097560976,37,4,18,34.33307913232723,0.6303490990990992,43.88706140350876,1024.451754385963,27.68788525367468,4
4409,4,1,1,41,0.023809523809523808,0.023809523809523808,0.9761904761904762,42,850,500,350,0.5882352941176471,12,5,7,367.6735540357891,0.3994628339140534,0.1256599934760858,0.21586723387254608,131419.65880102038,1264.2071775616973,132683.8659785821,2748,0,832.6666666666666,34,8,18,34.235796663957586,0.6387867647058822,43.660714285714285,1025.3571428571427,30.157563025210077,0
4410,4,1,0,42,0.023809523809523808,0.0,1.0,42,1100,700,400,0.6363636363636364,15,7,8,371.7165511035128,0.39727303523035234,0.13151322260164267,0.21911444852326073,131572.28599773237,1381.5192743764126,132953.8052721088,2749,0,833.6428571428571,34,8,17,33.97781774580336,0.6403186274509804,43.51190476190476,1025.9523809523805,30.17507002801119,0
4411,4,1,1,42,0.023255813953488372,0.023255813953488372,0.9767441860465116,43,850,600,250,0.7058823529411765,11,6,5,362.9008231958261,0.3997093023255814,0.12916925545217905,0.21504964613027217,131773.38023244595,964.1336323302461,132737.5138647762,2750,0,815.2325581395348,35,8,17,34.000887724044645,0.6401785714285715,43.31597222222222,1026.7361111111109,29.33531746031745,0
4412,4,0,0,42,0.0,0.0,1.0,42,900,500,400,0.5555555555555556,13,5,8,373.29625162609085,0.39676490514905144,0.129608762655973,0.22057484477508785,131663.9048327665,1429.9284297052227,133093.83326247174,2751,2,835.6428571428571,34,8,17,33.8446815914627,0.6412377450980392,43.42261904761905,1026.3095238095243,30.18557422969189,0
4413,4,0,0,42,0.0,0.0,1.0,42,950,600,350,0.631578947368421,13,6,7,376.07579911318203,0.3968374951606659,0.13205951978356434,0.2228569414784932,131773.38023244622,1511.3558545524966,133284.73608699872,2752,3,836.6428571428571,35,7,17,33.662707135610425,0.6401785714285713,43.315972222222236,1026.736111111113,29.335317460317512,0
4414,4,0,0,42,0.0,0.0,1.0,42,1000,800,200,0.8,12,8,4,375.5980195618932,0.3970915602013163,0.1321380287130629,0.22344557785733032,131921.9660922499,1509.9258401920756,133431.89193244197,2753,4,837.6428571428571,35,7,18,33.524861048520364,0.6416666666666665,43.17129629629631,1027.3148148148168,29.351851851851908,0
4415,4,0,0,42,0.0,0.0,1.0,42,900,600,300,0.6666666666666666,12,6,6,375.5824236614536,0.3969463801780875,0.13403880070546736,0.22402386917218506,132021.6056428052,1516.9989246003017,133538.6045674055,2754,5,838.6428571428571,36,6,18,33.42464752721163,0.6406249999999998,43.07432432432434,1027.7027027027045,28.547297297297348,0
4416,4,0,0,42,0.0,0.0,1.0,42,600,500,100,0.8333333333333334,7,5,2,374.8243275433019,0.3971762485481998,0.13337956541840024,0.2236300714235121,132031.50398439926,1497.7239390966672,133529.22792349593,2755,6,839.6428571428571,37,5,18,33.43413261495785,0.6387950450450448,43.06469298245615,1027.7412280701772,27.776789947842627,0
4417,4,0,0,42,0.0,0.0,1.0,42,1050,800,250,0.7619047619047619,13,8,5,374.2380325185808,0.39663182346109177,0.1361055673202416,0.22394575819570758,132144.21895439006,1490.6785020391187,133634.89745642917,2756,7,840.6428571428571,37,5,18,33.33544399417015,0.639921171171171,42.95504385964914,1028.1798245614057,27.78864390706502,0
4418,4,0,0,42,0.0,0.0,1.0,42,1200,800,400,0.6666666666666666,16,8,8,374.1981533089953,0.3965713317847464,0.14205503096761074,0.22442318913288872,132228.78674207468,1495.9535626346785,133724.74030470935,2757,8,841.6428571428571,37,5,19,33.25115493958777,0.6407657657657657,42.87280701754387,1028.5087719298263,27.797534376481792,0
4419,4,1,1,42,0.023255813953488372,0.023255813953488372,0.9767441860465116,43,1400,1200,200,0.8571428571428571,16,12,4,367.5576559219396,0.3997093023255814,0.13575914779234477,0.22178139699930358,132457.5684263548,1137.4832910957684,133595.05171745055,2758,0,823.046511627907,35,8,19,33.19138370437,0.6470238095238093,42.650462962962976,1029.3981481481499,29.41137566137571,0
4420,4,0,0,42,0.0,0.0,1.0,42,1300,1100,200,0.8461538461538461,15,11,4,379.8753331004699,0.39691008517228027,0.14297003640128425,0.22922414552126763,132459.27047902497,1663.6018990929733,134122.87237811793,2759,10,843.6428571428571,34,8,19,32.872672603214994,0.649203431372549,42.648809523809526,1029.4047619047622,30.276610644257712,0
4421,4,0,0,42,0.0,0.0,1.0,42,1050,700,350,0.6666666666666666,14,7,7,380.5870396631914,0.3974666085946574,0.14240842596721892,0.230027764224105,132520.55165816325,1687.1208900226773,134207.67254818592,2760,11,844.6428571428571,34,8,19,32.79256754152696,0.6498161764705883,42.589285714285715,1029.642857142857,30.28361344537815,0
4422,4,0,0,42,0.0,0.0,1.0,42,1200,900,300,0.75,15,9,6,381.45284686276995,0.3968737901664731,0.13717495987158945,0.23126228454214248,132636.34366426614,1718.9021776406094,134355.24584190676,2761,12,845.6428571428571,35,7,18,32.65355805243446,0.6488095238095237,42.476851851851855,1030.0925925925928,29.431216931216937,0
4423,4,0,0,42,0.0,0.0,1.0,42,1350,1000,350,0.7407407407407407,17,10,7,377.44193538344547,0.396680216802168,0.1398311920112818,0.22949974423215394,132745.92318247326,1620.7756320510014,134366.69881452425,2762,13,846.6428571428571,36,6,18,32.64647761628967,0.6478587962962962,42.37049549549551,1030.51801801802,28.625500500500557,0
4424,4,0,0,42,0.0,0.0,1.0,42,1450,1100,350,0.7586206896551724,18,11,7,384.8436494288345,0.3969342818428185,0.1566360591744851,0.22151724271413073,130657.85147392291,1672.7188958125278,132330.57036973545,2763,14,847.6428571428571,34,8,16,34.56834148424158,0.6311274509803921,44.404761904761905,1022.3809523809524,30.07002801120448,7
4425,4,0,0,42,0.0,0.0,1.0,42,1550,1200,350,0.7741935483870968,19,12,7,381.5770765928377,0.39716415021293067,0.15236210871685718,0.2203299893874773,130779.59183673467,1580.4988662131507,132360.0907029478,2764,15,848.6428571428571,34,8,16,34.52824332712602,0.6323529411764706,44.285714285714285,1022.8571428571427,30.08403361344537,0
4426,4,0,0,42,0.0,0.0,1.0,42,1600,1200,400,0.75,20,12,8,380.8253771749945,0.39722464188927603,0.15152959295218715,0.22082877444973611,130942.84664619766,1573.271792481134,132516.1184386788,2765,16,849.6428571428571,35,7,16,34.38183214595349,0.6318452380952382,44.126157407407405,1023.49537037037,29.242724867724856,0
4427,4,0,0,42,0.0,0.0,1.0,42,1500,1200,300,0.8,18,12,6,380.4555365941245,0.39626887340301975,0.15005086469989837,0.22129455175859436,131061.33355034729,1572.601996527788,132633.9355468751,2766,17,850.6428571428571,35,7,17,34.27115123770769,0.6330357142857143,44.01041666666667,1023.9583333333339,29.255952380952397,0
4428,4,0,0,42,0.0,0.0,1.0,42,1050,600,450,0.5714285714285714,15,6,9,382.98823775624663,0.3964745451025939,0.14793765607508869,0.22293946892547833,131090.963648834,1641.259430727023,132732.22307956102,2767,18,851.6428571428571,35,7,17,34.17627335744425,0.6333333333333333,43.98148148148148,1024.074074074074,29.259259259259256,0
4429,4,0,1,41,0.0,0.023809523809523808,0.9761904761904762,42,950,500,450,0.5263157894736842,14,5,9,381.18383730156256,0.3963777584204413,0.13940792848244987,0.22259374529971887,131212.72243527332,1603.233808132477,132815.9562434058,2768,19,852.6428571428571,36,6,17,34.09906939254047,0.6325231481481481,43.86261261261262,1024.549549549551,28.459709709709752,0
4430,4,2,1,42,0.046511627906976744,0.023255813953488372,0.9767441860465116,43,850,700,150,0.8235294117647058,10,7,3,368.6396475900822,0.40247785160575855,0.1567056691103883,0.2179980138217894,131694.45153061228,1109.711419569051,132804.16295018131,2769,0,830.9767441860465,34,9,16,33.93330047166164,0.6415441176470588,43.392857142857146,1026.4285714285718,30.189075630252113,0
4431,4,0,1,41,0.0,0.023809523809523808,0.9761904761904762,42,1150,800,350,0.6956521739130435,15,8,7,374.6480692933394,0.397587591947348,0.1598718373660375,0.22119632584305385,131633.36167800456,1463.2369614512552,133096.5986394558,2770,1,851.7619047619048,34,8,16,33.8408739365816,0.6409313725490196,43.452380952380956,1026.1904761904764,30.18207282913166,0
4432,4,1,1,41,0.023809523809523808,0.023809523809523808,0.9761904761904762,42,1200,600,600,0.5,18,6,12,366.8480751228354,0.4003581107239644,0.15693262325766,0.2187537984563906,132011.15779588904,1285.607826431756,133296.7656223208,2771,0,838.5,35,7,16,33.65959473664452,0.6425595238095239,43.08449074074074,1027.662037037037,29.361772486772484,0
4433,4,0,0,41,0.0,0.0,1.0,41,950,400,550,0.42105263157894735,15,4,11,373.1242674871886,0.39621443089430897,0.16138041769847455,0.22171599034982514,131877.80612244888,1641.3619614512363,133519.16808390012,2772,3,859.9512195121952,34,7,17,33.632987559882544,0.6433823529411765,43.21428571428571,1027.1428571428564,30.210084033613423,0
4434,4,0,0,41,0.0,0.0,1.0,41,750,600,150,0.8,9,6,3,365.8779391507694,0.39588414634146346,0.14316519805751549,0.2126679044300952,131034.66932508671,1388.538953993046,132423.20827907976,2773,4,860.9512195121952,39,2,17,34.67131702106012,0.6252670940170941,44.03645833333333,1023.8541666666658,26.25267094017092,3
4435,4,1,1,41,0.023809523809523808,0.023809523809523808,0.9761904761904762,42,400,300,100,0.75,5,3,2,361.447359582391,0.398833720480062,0.143263335883848,0.21113049126938943,131223.9789890275,1086.1121438958144,132310.09113292332,2774,0,841.4285714285714,40,2,17,34.593210672485625,0.6255208333333334,43.851626016260155,1024.593495934958,25.614837398373947,0
4436,4,1,0,42,0.023809523809523808,0.0,1.0,42,900,700,200,0.7777777777777778,11,7,4,357.8322989678034,0.3994628339140534,0.15160086340890633,0.20017716415640188,129545.80213758675,871.2170628816107,130417.01920046836,2775,0,842.4047619047619,39,3,15,36.38777328694703,0.6103098290598291,45.494791666666664,1018.0208333333329,26.10309829059828,4
4437,4,0,0,42,0.0,0.0,1.0,42,1050,700,350,0.6666666666666666,14,7,7,357.8952504405571,0.3992450638792102,0.14977571267844358,0.20075397955004748,129651.86767578128,880.3575303819455,130532.22520616323,2776,1,843.4047619047619,39,3,15,36.27827639698613,0.6113782051282051,45.390625,1018.4375000000002,26.113782051282058,0
4438,4,1,0,43,0.023255813953488372,0.0,1.0,43,750,500,250,0.6666666666666666,10,5,5,352.1639826487469,0.40178571428571425,0.16012275769031947,0.19905697115013427,129951.54303200828,552.8505891004284,130504.39362110871,2777,0,824.7674418604652,40,3,17,36.119763115053665,0.6127604166666666,45.096544715447166,1019.6138211382132,25.49034552845533,0
4439,4,0,0,43,0.0,0.0,1.0,43,1400,1200,200,0.8571428571428571,16,12,4,350.2005684670149,0.4019933554817276,0.15329243126437464,0.199001918957402,130158.8642363176,516.3416493158788,130675.20588563348,2778,1,825.7674418604652,40,3,17,35.95944129070812,0.6148437500000001,44.89329268292683,1020.4268292682921,25.5106707317073,0
4440,4,0,0,43,0.0,0.0,1.0,43,800,500,300,0.625,11,5,6,350.4606583208681,0.4019241417497232,0.1530581291145745,0.19941509300376656,130210.72035701305,526.7469553506542,130737.4673123637,2779,2,826.7674418604652,40,3,17,35.90021241992764,0.6153645833333334,44.84247967479675,1020.6300813008132,25.515752032520332,0
4441,4,0,0,43,0.0,0.0,1.0,43,900,400,500,0.4444444444444444,14,4,10,351.00116712697485,0.40187799926172024,0.15061163009701883,0.20026974055119415,130317.1242078495,548.3131944115967,130865.4374022611,2780,3,827.7674418604652,38,5,17,35.77853057096022,0.6197916666666665,44.73824786324787,1021.0470085470096,26.869658119658148,0
4442,4,0,0,43,0.0,0.0,1.0,43,1050,800,250,0.7619047619047619,13,8,5,357.7867247214217,0.40095514950166117,0.15362165159570562,0.20485968034648133,130453.5176510339,734.9073617503345,131188.42501278422,2781,4,828.7674418604652,38,5,18,35.46699609565641,0.6211622807017543,44.604700854700866,1021.5811965811984,26.88371569950522,0
4443,4,1,1,43,0.022727272727272728,0.022727272727272728,0.9772727272727273,44,1000,800,200,0.8,12,8,4,348.9373370656598,0.4047084214235377,0.14895183244134103,0.2012847694072067,130741.54188368093,324.1210937500398,131065.66297743097,2782,0,810.9090909090909,39,5,16,35.40138860596184,0.6223290598290596,44.322916666666686,1022.7083333333363,26.223290598290674,0
4444,4,0,0,43,0.0,0.0,1.0,43,950,600,350,0.631578947368421,13,6,7,354.13815869449263,0.400609080841639,0.14683559070350727,0.2037731834364164,130644.58832137137,653.2467903061075,131297.83511167747,2783,6,830.7674418604652,38,5,16,35.366591772041666,0.623081140350877,44.41773504273505,1022.3290598290614,26.90339631129109,0
4445,4,0,1,42,0.0,0.023255813953488372,0.9767441860465116,43,1450,1200,250,0.8275862068965517,17,12,5,360.035512409173,0.40042451088962716,0.14541929464814984,0.2076060195650971,130726.51855504456,813.2378186865742,131539.75637373113,2784,7,831.7674418604652,38,5,16,35.13285276500906,0.6239035087719296,44.337606837606856,1022.6495726495756,26.91183085919936,0
4446,4,0,0,42,0.0,0.0,1.0,42,1200,900,300,0.75,15,9,6,364.55514731735127,0.396861691831204,0.14539485105644223,0.21012616216820906,130710.7054574487,1130.252096799044,131840.95755424775,2785,8,852.3571428571429,37,5,17,35.03332975909644,0.6255630630630629,44.35307017543861,1022.5877192982476,27.637505926979667,0
4447,4,0,0,42,0.0,0.0,1.0,42,800,600,200,0.75,10,6,4,366.74014562093896,0.3968012001548587,0.14822838362651902,0.21215451325412177,130850.90033712305,1197.6556488535034,132048.55598597656,2786,9,853.3571428571429,37,5,17,34.83538295288108,0.6269707207207207,44.21600877192983,1023.1359649122815,27.652323376007608,0
4448,4,0,1,41,0.0,0.023809523809523808,0.9761904761904762,42,1150,800,350,0.6956521739130435,15,8,7,365.3407977590657,0.3961720867208672,0.1495625781110519,0.21196123971913478,130963.11034404818,1169.2334420206248,132132.3437860688,2787,10,854.3571428571429,37,5,17,34.75752097839673,0.6280968468468469,44.10635964912281,1023.5745614035088,27.66417733522997,0
4449,4,0,0,41,0.0,0.0,1.0,41,1150,900,250,0.782608695652174,14,9,5,372.0717218847595,0.3938262195121951,0.15526871676772225,0.21548857468239707,130895.6269402849,1540.5122605713855,132436.1392008563,2788,19,875.9512195121952,36,5,17,34.65367191225562,0.6293402777777778,44.1722972972973,1023.310810810811,28.425300300300304,0
4450,4,1,0,42,0.023809523809523808,0.0,1.0,42,950,500,450,0.5263157894736842,14,5,9,364.12513731056515,0.398119918699187,0.15518752994668228,0.2123381418698688,131159.5935768697,1151.7010041551127,132311.29458102482,2789,0,856.0714285714286,37,5,18,34.58975594091202,0.6300675675675675,43.91447368421052,1024.342105263157,27.68492176386911,0
4451,4,0,0,42,0.0,0.0,1.0,42,900,600,300,0.6666666666666666,12,6,6,364.51182529594496,0.3985554587688734,0.15536024628829637,0.21289088943898374,131218.63928153997,1166.1491434728646,132384.78842501284,2790,1,857.0714285714286,38,4,18,34.520116440736864,0.6288377192982456,43.85683760683761,1024.5726495726499,26.96243814664868,0
4452,4,1,0,43,0.023255813953488372,0.0,1.0,43,1300,1200,100,0.9230769230769231,14,12,2,357.16723647264905,0.4023394241417497,0.15543210349539582,0.20967167556953387,131414.71021274655,787.5427469989576,132202.2529597455,2791,0,838.1162790697674,36,7,19,34.510113490755984,0.6345486111111112,43.66554054054054,1025.337837837838,28.481606606606608,0
4453,4,0,1,42,0.0,0.023255813953488372,0.9767441860465116,43,900,300,600,0.3333333333333333,15,3,12,357.02443718387883,0.401578073089701,0.15159787381097978,0.2100381500262895,131496.7646295015,789.5116766697568,132286.27630617126,2792,1,839.1162790697674,37,6,19,34.4309030004989,0.6334459459459458,43.58552631578948,1025.657894736843,27.720483641536298,0
4454,4,1,1,42,0.023255813953488372,0.023255813953488372,0.9767441860465116,43,500,300,200,0.6,7,3,4,353.0270370526235,0.40393133997785163,0.16505530877101338,0.2094627086512229,131821.37573964475,707.3019395134581,132528.6776791582,2793,0,833.5116279069767,38,5,17,34.20594049105284,0.6348684210526316,43.26923076923076,1026.9230769230753,27.024291497975668,0
4455,4,0,0,42,0.0,0.0,1.0,42,700,300,400,0.42857142857142855,11,3,8,358.77529403170473,0.400104045683314,0.1648148148148154,0.21200358283691612,131665.51246537376,1047.6665897198952,132713.17905509364,2794,1,854.3095238095239,37,5,17,34.215633903133906,0.6351351351351353,43.42105263157894,1026.3157894736826,27.738264580369798,0
4456,4,0,0,42,0.0,0.0,1.0,42,1050,800,250,0.7619047619047619,13,8,5,360.3109037657014,0.399208768873403,0.17302333150261395,0.213541221700128,131778.07113727275,1096.2151815943114,132874.28631886706,2795,2,855.3095238095239,37,5,17,34.06263348996155,0.6362612612612613,43.31140350877192,1026.7543859649104,27.750118539592172,0
4457,4,0,1,41,0.0,0.023809523809523808,0.9761904761904762,42,800,500,300,0.625,11,5,6,399.23021926051103,0.399208768873403,0.18569780853517903,0.2287939755138849,130488.247372717,2208.8484574860945,132697.0958302031,2796,3,856.3095238095239,32,10,15,34.37319780853517,0.6341145833333335,44.570707070707066,1021.7171717171711,31.928661616161598,7
4458,4,1,1,41,0.023809523809523808,0.023809523809523808,0.9761904761904762,42,700,400,300,0.5714285714285714,10,4,6,396.7535576417282,0.3957002516453736,0.19331072556105555,0.22807177286627528,130606.84479827466,1963.746065215299,132570.59086348995,2797,0,857.1190476190476,33,9,15,34.315804459896896,0.6328914141414141,44.4546568627451,1022.1813725490192,30.975193107546037,0
4459,4,2,2,41,0.046511627906976744,0.046511627906976744,0.9534883720930233,43,1100,700,400,0.6363636363636364,15,7,8,390.50887118762097,0.3980712440014766,0.17716711466941626,0.22626995013374443,130913.23329260953,1624.555791323709,132537.78908393322,2798,0,838.1395348837209,35,8,15,34.1641219935158,0.6315476190476191,44.15509259259258,1023.379629629628,29.23941798941794,0
4460,4,0,0,41,0.0,0.0,1.0,41,1300,900,400,0.6923076923076923,17,9,8,402.32097045458585,0.39410569105691057,0.19001107356824454,0.23194208967818047,130718.71456916087,2318.176020408149,133036.89058956903,2799,6,880.0243902439024,34,7,15,34.05971090415211,0.6317401960784315,44.34523809523809,1022.6190476190466,30.0770308123249,0
4461,4,0,0,41,0.0,0.0,1.0,41,750,400,350,0.5333333333333333,11,4,7,400.95000096060414,0.39418191056910573,0.19303585274793789,0.2317852883251,130824.41332572441,2290.809729723931,133115.22305544835,2800,7,881.0243902439024,35,6,15,33.98727702982992,0.6306547619047619,44.241898148148145,1023.032407407407,29.229497354497344,0
4462,4,3,0,44,0.06818181818181818,0.0,1.0,44,1400,1000,400,0.7142857142857143,18,10,8,389.3377759266971,0.40223088442565186,0.17931354359925766,0.22183198860939737,130262.58680555563,1344.1970218192828,131606.78382737492,2801,0,821.8863636363636,38,6,20,34.85544217687075,0.6192434210526315,44.79166666666667,1020.833333333334,26.864035087719316,5
4463,4,2,2,44,0.043478260869565216,0.043478260869565216,0.9565217391304348,46,1000,700,300,0.7,13,7,6,351.74177378109687,0.4088264895330113,0.18115942028985477,0.1899405578417925,128144.53125000013,-180.9027777777635,127963.62847222236,2802,0,787.1086956521739,39,7,19,37.971536351165994,0.596153846153846,46.87500000000001,1012.500000000001,25.96153846153849,6
4464,4,6,6,44,0.12,0.12,0.88,50,1200,1100,100,0.9166666666666666,13,11,2,322.9153510911849,0.42623299319727886,0.17442144424306094,0.1780705747232451,128979.8269804247,-1670.0867773871855,127309.74020303751,2803,0,724.98,42,8,16,37.85096505453275,0.5999503968253969,46.05135658914728,1015.7945736434095,24.185585086747846,0
4465,4,2,2,44,0.043478260869565216,0.043478260869565216,0.9565217391304348,46,650,300,350,0.46153846153846156,10,3,7,348.93956951069043,0.4123892914653784,0.19044248030900723,0.18996486374566493,128469.2559377054,-234.39862754767515,128234.85731015772,2804,0,788.9782608695652,38,8,16,37.71077036568657,0.6011513157894738,46.554487179487175,1013.7820512820508,26.67847503373818,0
4466,4,0,0,44,0.0,0.0,1.0,44,1000,700,300,0.7,13,7,6,363.826515225871,0.40547921071176884,0.1978576916855388,0.1966062514970571,128173.0379027676,526.5499452154806,128699.58784798307,2805,3,825.8409090909091,36,8,20,37.63646389383156,0.6018518518518519,46.846846846846844,1012.6126126126123,28.12812812812812,0
4467,4,2,2,44,0.043478260869565216,0.043478260869565216,0.9565217391304348,46,1050,800,250,0.7619047619047619,13,8,5,346.74911229416693,0.41375805152979067,0.19456704882605025,0.1896733623470857,128658.86843450938,-277.53031631237695,128381.338118197,2806,0,790.8913043478261,38,8,17,37.57283768604325,0.6030701754385965,46.36752136752136,1014.5299145299139,26.69815564552405,0
4468,4,2,1,45,0.043478260869565216,0.021739130434782608,0.9782608695652174,46,950,600,350,0.631578947368421,13,6,7,350.63990922587686,0.4128119967793881,0.20214713676954532,0.19219437378745546,128740.17373666808,-171.71143345022344,128568.46230321785,2807,0,791.8478260869565,38,8,18,37.391216619293246,0.6038925438596492,46.28739316239316,1014.8504273504269,26.706590193432287,0
4469,4,1,1,45,0.021739130434782608,0.021739130434782608,0.9782608695652174,46,650,200,450,0.3076923076923077,11,2,9,348.9181186352115,0.41104066022544283,0.20469927650636355,0.1915119032439712,128794.39153928318,-212.26064266931294,128582.13089661387,2808,0,792.8260869565217,38,8,18,37.37961793495422,0.6044407894736843,46.23397435897435,1015.0641025641012,26.712213225371084,0
4470,4,3,1,47,0.0625,0.020833333333333332,0.9791666666666666,48,1050,700,350,0.6666666666666666,14,7,7,336.9123384647978,0.41769171099290775,0.21474089635854332,0.18734844989397628,129310.02995105548,-885.4869785959655,128424.54297245952,2809,0,760.7291666666666,38,10,20,37.159707633053216,0.6096491228070176,45.72649572649572,1017.0940170940162,26.7656320287899,0
4471,4,2,2,47,0.04081632653061224,0.04081632653061224,0.9591836734693877,49,900,700,200,0.7777777777777778,11,7,4,334.85139322769646,0.4183673469387755,0.22770335127916175,0.18820957619349835,129731.4453125,-1111.8489583333326,128619.59635416667,2810,0,746.1632653061224,39,10,17,36.78425357873209,0.6121794871794872,45.3125,1018.75,26.121794871794872,0
4472,4,0,1,46,0.0,0.02127659574468085,0.9787234042553191,47,1650,1200,450,0.7272727272727273,21,12,9,343.8008372330328,0.4154717853839038,0.23199756341643818,0.19323978092753202,129731.44531249987,-479.64409722223724,129251.80121527764,2811,1,775.5531914893617,37,10,18,36.55632242672118,0.6157094594594594,45.31249999999999,1018.749999999999,27.533783783783758,0
4473,4,0,0,46,0.0,0.0,1.0,46,950,500,450,0.5263157894736842,14,5,9,340.58751603413936,0.4160426731078905,0.21440731871585728,0.19211781244255793,129871.11418898104,-353.50396275779053,129517.61022622325,2812,2,778.8260869565217,37,9,18,36.49643215720023,0.6171171171171171,45.17543859649122,1019.2982456140336,27.54860123281172,0
4474,4,0,1,45,0.0,0.021739130434782608,0.9782608695652174,46,1050,700,350,0.6666666666666666,14,7,7,344.15270975071843,0.4152173913043478,0.21743230438427097,0.19458492072635392,129962.83512309138,-254.58762510045995,129708.24749799092,2813,3,779.8260869565217,38,8,18,36.312517462978484,0.6162280701754387,45.08547008547008,1019.6581196581185,26.83310841205575,0
4475,4,1,0,46,0.021739130434782608,0.0,1.0,46,950,900,50,0.9473684210526315,10,9,1,344.73858082875233,0.4149255233494364,0.22193404711700926,0.19532458345234985,130044.55133912252,-233.72518536782667,129810.8261537547,2814,0,780.6739130434783,38,8,19,36.21469222443351,0.6170504385964912,45.005341880341874,1019.9786324786314,26.841542959963984,0
4476,4,0,0,46,0.0,0.0,1.0,46,1550,1200,350,0.7741935483870968,19,12,7,347.47437988447757,0.4149859098228663,0.2244403562776629,0.19701219591074765,130071.7957849368,-160.67668383373785,129911.11910110306,2815,1,781.6739130434783,38,8,19,36.11729332495461,0.6173245614035088,44.97863247863248,1020.08547008547,26.84435447593342,0
4477,4,0,0,46,0.0,0.0,1.0,46,1650,1100,550,0.6666666666666666,22,11,11,346.28497695408794,0.41432165861513687,0.22787279274193883,0.19675001873221254,130153.54624379062,-185.95644769523133,129967.58979609539,2816,2,782.6739130434783,38,8,20,36.06472271664399,0.6181469298245614,44.89850427350427,1020.4059829059828,26.852789023841652,0
4478,4,3,2,47,0.061224489795918366,0.04081632653061224,0.9591836734693877,49,950,600,350,0.631578947368421,13,6,7,327.6070114699943,0.42052862811791386,0.23090993154018347,0.18905028460057466,130755.8331680877,-1232.648795609791,129523.18437247792,2817,0,735.6938775510204,40,9,15,35.932324788023294,0.6208333333333333,44.30894308943089,1022.7642276422758,25.569105691056897,0
4479,4,2,2,47,0.04081632653061224,0.04081632653061224,0.9591836734693877,49,1300,1000,300,0.7692307692307693,16,10,6,328.15683526278724,0.4228670634920635,0.23620431681514242,0.18962265808009277,130807.80805902569,-1214.9047359376032,129592.90332308809,2818,0,736.6530612244898,40,9,15,35.86578581363004,0.6213541666666667,44.25813008130081,1022.9674796747966,25.574186991869915,0
4480,4,0,0,47,0.0,0.0,1.0,47,950,800,150,0.8421052631578947,11,8,3,343.67428673082395,0.41747610237434474,0.2420646573587122,0.19705640757155893,130508.09500328742,-429.5447074293091,130078.55029585812,2819,2,769.0,38,9,16,35.77216645754916,0.6217105263157894,44.55128205128206,1021.7948717948726,26.889338731444017,0
4481,4,1,0,48,0.020833333333333332,0.0,1.0,48,1550,1100,450,0.7096774193548387,20,11,9,339.3787850097907,0.42020353132387706,0.2485811361091319,0.196447719808555,130874.7409396703,-716.7778862847024,130157.9630533856,2820,0,753.9583333333334,39,9,19,35.51115154908548,0.6236645299145298,44.19270833333334,1023.229166666668,26.236645299145334,0
4482,4,1,3,46,0.02040816326530612,0.061224489795918366,0.9387755102040817,49,900,600,300,0.6666666666666666,12,6,6,319.5509655576924,0.42334537981859416,0.18600900850803614,0.18042339132257393,129908.37191358027,-1436.2352912808558,128472.13662229941,2821,0,739.5510204081633,38,11,17,36.99477747502271,0.6156798245614035,45.13888888888889,1019.4444444444446,26.82748538011696,5
4483,4,1,1,46,0.02127659574468085,0.02127659574468085,0.9787234042553191,47,1250,1000,250,0.8,15,10,5,328.890556077272,0.4180157261794635,0.21341597392609968,0.18551981852514093,129871.1141889813,-857.3234072022061,129013.7907817791,2822,0,771.5744680851063,37,10,19,36.79449942627653,0.617117117117117,45.17543859649123,1019.2982456140357,27.548601232811777,0
4484,4,1,1,46,0.02127659574468085,0.02127659574468085,0.9787234042553191,47,1300,800,500,0.6153846153846154,18,8,10,328.45644894182243,0.4198465926611163,0.21790230243798026,0.1857102102310873,129962.83512309153,-862.5737362115578,129100.26138687997,2823,0,772.4468085106383,38,9,19,36.71263795753002,0.6162280701754386,45.085470085470085,1019.6581196581196,26.83310841205578,0
4485,4,2,0,48,0.041666666666666664,0.0,1.0,48,900,600,300,0.6666666666666666,12,6,6,321.2511702788893,0.41873522458628837,0.2240018916766231,0.18291648266900024,130236.6522903034,-1232.2646077070494,129004.38768259635,2824,0,757.3125,40,8,21,36.619291782822245,0.615625,44.81707317073171,1020.7317073170733,25.518292682926834,0
4486,4,3,4,47,0.058823529411764705,0.0784313725490196,0.9215686274509804,51,900,500,400,0.5555555555555556,13,5,8,300.8847377976324,0.42683006535947715,0.2086646916638919,0.1739808532687398,130833.79937743719,-2326.8135699649797,128506.9858074722,2825,0,713.7058823529412,40,11,15,36.53707658686801,0.6216145833333334,44.23272357723577,1023.0691056910554,25.576727642276385,0
4487,4,1,1,47,0.020833333333333332,0.020833333333333332,0.9791666666666666,48,1850,1400,450,0.7567567567567568,23,14,9,323.7585996285095,0.420988475177305,0.21136826861188585,0.18607137273347496,130598.60365689437,-1143.5157933210312,129455.08786357334,2826,0,759.2708333333334,37,11,16,36.189480082957864,0.6244369369369369,44.46271929824561,1022.1491228070171,27.625651967757218,0
4488,4,2,2,47,0.04081632653061224,0.04081632653061224,0.9591836734693877,49,700,400,300,0.5714285714285714,10,4,6,316.0865201390609,0.42136125283446707,0.2113962375501064,0.18271251996973015,130821.45317925338,-1529.8204210069498,129291.63275824643,2827,0,744.734693877551,39,10,16,36.16071428571429,0.623130341880342,44.244791666666664,1023.0208333333326,26.2313034188034,0
4489,4,0,0,47,0.0,0.0,1.0,47,1100,1000,100,0.9090909090909091,12,10,2,328.74365803217415,0.4165895775516497,0.22165821415366094,0.18893639828458234,130598.60365689435,-813.3074599876979,129785.29619690665,2828,4,777.4255319148937,37,10,17,36.06209325609668,0.6244369369369369,44.46271929824561,1022.149122807017,27.625651967757214,0
4490,4,0,0,47,0.0,0.0,1.0,47,1550,1000,550,0.6451612903225806,21,10,11,331.14840862525733,0.41591504779525135,0.21931751560899615,0.19100935109757408,130738.73842191815,-741.2149651816089,129997.52345673654,2829,5,778.4255319148937,37,10,17,35.8590427432901,0.6258445945945947,44.325657894736835,1022.6973684210516,27.640469416785177,0
4491,4,0,0,47,0.0,0.0,1.0,47,550,300,250,0.5454545454545454,8,3,5,331.00745113812206,0.41551032994141224,0.216819065607466,0.1912731650360602,130808.47447083422,-740.2840556286119,130068.19041520561,2830,6,779.4255319148937,38,9,17,35.792210617928625,0.6247258771929824,44.25747863247863,1022.9700854700852,26.920265407107507,0
4492,4,0,1,46,0.0,0.02127659574468085,0.9787234042553191,47,1250,1000,250,0.8,15,10,5,334.26084096382954,0.41498997841504776,0.22077067017811336,0.1936190154262185,130901.38888888912,-648.9583333333105,130252.43055555581,2831,7,780.4255319148937,39,8,18,35.61516015200868,0.6239316239316238,44.16666666666668,1023.3333333333352,26.239316239316288,0
4493,4,0,2,44,0.0,0.043478260869565216,0.9565217391304348,46,950,600,350,0.631578947368421,13,6,7,343.1219021609471,0.4126912238325282,0.22722318598377877,0.19813323831658078,130781.1529786691,-225.22440463144198,130555.92857403765,2832,8,798.195652173913,38,8,18,35.510018452754004,0.6244517543859648,44.28418803418804,1022.8632478632486,26.91745389113812,0
4494,4,0,1,43,0.0,0.022727272727272728,0.9772727272727273,44,1100,700,400,0.6363636363636364,15,7,8,349.2807459529758,0.4093001233262861,0.21943052658257445,0.20132214071430476,130710.70545744844,330.9465412434579,131041.65199869189,2833,9,817.6818181818181,37,7,18,35.42381514046752,0.6255630630630631,44.353070175438596,1022.5877192982456,27.63750592697961,0
4495,4,0,0,43,0.0,0.0,1.0,43,1150,800,350,0.6956521739130435,15,8,7,358.346194623464,0.4064922480620155,0.23334716693052981,0.20615125188794697,130636.47050766973,762.6164170927572,131399.0869247625,2834,10,837.1627906976744,36,7,18,35.26726701916723,0.6267361111111112,44.42567567567567,1022.2972972972965,28.397147147147123,0
4496,4,0,0,43,0.0,0.0,1.0,43,1400,1000,400,0.7142857142857143,18,10,8,358.0388700327591,0.40596160944998155,0.23116184321088395,0.20652000870720721,130738.73842191811,761.9100348183924,131500.6484567365,2835,11,838.1627906976744,37,6,18,35.17152264036312,0.6258445945945947,44.325657894736835,1022.6973684210512,27.64046941678517,0
4497,4,1,1,43,0.022727272727272728,0.022727272727272728,0.9772727272727273,44,1400,900,500,0.6428571428571429,19,9,10,345.72022343143465,0.40976259689922484,0.22337081145055082,0.2013697415152765,131114.67013888896,265.79861111111495,131380.4687500001,2836,0,820.0909090909091,39,5,18,35.106455112557626,0.6260683760683761,43.958333333333336,1024.1666666666672,26.260683760683776,0
4498,4,0,0,43,0.0,0.0,1.0,43,750,200,550,0.26666666666666666,13,2,11,355.60972516799,0.4057770394979698,0.22975792988313848,0.20680604405400582,131054.49631090656,720.8506830301691,131775.34699393672,2837,13,840.1627906976744,38,5,19,34.91409293266556,0.6271929824561404,44.01709401709402,1023.9316239316239,26.94556905083221,0
4499,4,0,0,43,0.0,0.0,1.0,43,750,500,250,0.6666666666666666,10,5,5,355.1381560917113,0.4055232558139535,0.22721175234874713,0.20697322203350985,131136.55495516473,714.318864599313,131850.87381976403,2838,14,841.1627906976744,38,5,19,34.843190431487095,0.628015350877193,43.93696581196581,1024.2521367521367,26.95400359874044,0
4500,4,0,0,43,0.0,0.0,1.0,43,950,600,350,0.631578947368421,13,6,7,353.2861244153962,0.40526947212993725,0.21770409759149234,0.20648185370311167,131246.00643080196,673.4785913872284,131919.48502218918,2839,15,842.1627906976744,38,5,19,34.78000208528829,0.6291118421052633,43.8301282051282,1024.679487179486,26.96524966261805,0
4501,4,0,0,43,0.0,0.0,1.0,43,800,400,400,0.5,12,4,8,350.6510674862853,0.405015688445921,0.2134619020608821,0.2053813395276807,131328.12499999956,610.095126561429,131938.220126561,2840,16,843.1627906976744,37,6,19,34.764566395663955,0.6317567567567569,43.74999999999998,1024.9999999999966,27.70270270270261,0
4502,4,0,1,42,0.0,0.023255813953488372,0.9767441860465116,43,1450,900,550,0.6206896551724138,20,9,11,350.2082434804154,0.4051079734219269,0.21165699850066821,0.2058766625563996,131468.6505102528,608.2810335872232,132076.93154384004,2841,17,844.1627906976744,37,6,19,34.63405235396842,0.6331644144144146,43.61293859649121,1025.5482456140323,27.717520151730604,0
4503,4,0,0,42,0.0,0.0,1.0,42,1000,800,200,0.8,12,8,4,350.16590442450223,0.40540311653116534,0.20637635131008447,0.2063068137150904,131553.00188519506,813.0751769774893,132366.07706217255,2842,18,838.452380952381,37,5,19,34.55002137665667,0.6340090090090091,43.530701754385944,1025.8771929824532,27.726410621147384,0
4504,4,1,0,43,0.023255813953488372,0.0,1.0,43,1000,600,400,0.6,14,6,8,340.78000372368905,0.4086148025101513,0.20511357040591327,0.20278097251280852,131931.11257213785,391.89700672068636,132323.00957885853,2843,0,819.9302325581396,38,5,18,34.40988110094288,0.6359649122807018,43.162393162393144,1027.3504273504243,27.03553756185327,0
4505,4,0,0,43,0.0,0.0,1.0,43,1300,900,400,0.6923076923076923,17,9,8,340.4763597223033,0.408453303802141,0.20731256210455573,0.20304042803278552,132013.44515897782,389.4914484257214,132402.93660740354,2844,1,820.9302325581396,38,5,18,34.33482343972,0.6367872807017545,43.08226495726495,1027.6709401709386,27.04397210976154,0
4506,4,0,0,43,0.0,0.0,1.0,43,1050,900,150,0.8571428571428571,12,9,3,340.82704513197564,0.40813030638612036,0.20257667555203307,0.20383956838439998,132123.26189139063,406.2361887281512,132529.4980801188,2845,2,821.9302325581396,38,5,19,34.21533478818109,0.6378837719298247,42.97542735042734,1028.0982905982887,27.055218173639176,0
4507,4,0,0,43,0.0,0.0,1.0,43,1150,700,450,0.6086956521739131,16,7,9,340.3002969710597,0.4078303802141012,0.2019273815414342,0.2035614503699609,132130.12695312485,392.7842881944292,132522.9112413193,2846,3,822.9302325581396,39,4,19,34.22196892941574,0.6362179487179489,42.96874999999999,1028.1249999999989,26.362179487179457,0
4508,4,0,0,43,0.0,0.0,1.0,43,950,600,350,0.631578947368421,13,6,7,339.8706030381757,0.40796880767811,0.20421393841166968,0.20359239036364485,132183.6805555554,385.0694444444252,132568.74999999983,2847,4,823.9302325581396,39,4,19,34.17915991356023,0.6367521367521368,42.91666666666666,1028.333333333332,26.36752136752133,0
4509,4,0,0,43,0.0,0.0,1.0,43,950,600,350,0.631578947368421,13,6,7,344.73067350862766,0.40732281284606864,0.2125963632354162,0.20724782295732433,132319.5725097493,522.9230699318975,132842.49557968118,2848,5,824.9302325581396,40,3,19,33.91754741209007,0.6364583333333333,42.784552845528445,1028.8617886178845,25.721544715447113,0
4510,4,0,0,43,0.0,0.0,1.0,43,550,400,150,0.7272727272727273,7,4,3,345.68670196200566,0.4066537467700258,0.20713680444402627,0.20825515947467166,132398.00347222216,553.715546301795,132951.71901852396,2849,6,825.9302325581396,37,6,21,33.81410256410256,0.642454954954955,42.70833333333333,1029.166666666666,27.8153153153153,0
4511,4,0,0,43,0.0,0.0,1.0,43,900,700,200,0.7777777777777778,11,7,4,341.83497408465126,0.4067229605020302,0.20422952763686708,0.20652181441642353,132505.23003472204,458.9843749999805,132964.21440972202,2850,7,826.9302325581396,39,4,21,33.80547686496695,0.6399572649572651,42.60416666666666,1029.583333333332,26.39957264957261,0
4512,4,1,0,44,0.022727272727272728,0.0,1.0,44,1850,1400,450,0.7567567567567568,23,14,9,338.86380659654577,0.40688865398167723,0.22030314974737597,0.2071560186350447,132947.6708639035,210.2307654173901,133157.9016293209,2851,0,809.1136363636364,40,4,16,33.438033766916305,0.6427083333333334,42.17479674796747,1031.3008130081282,25.782520325203205,0
4513,4,0,0,44,0.0,0.0,1.0,44,1100,600,500,0.5454545454545454,16,6,10,337.56862846728023,0.4063821353065539,0.21986409296828824,0.20723529948348027,133104.92782900398,186.40958589464225,133291.33741489862,2852,1,810.1136363636364,40,4,16,33.313841835729754,0.6442708333333333,42.02235772357724,1031.9105691056916,25.79776422764229,0
4514,4,0,0,44,0.0,0.0,1.0,44,1100,600,500,0.5454545454545454,16,6,10,338.58887717775417,0.4059526955602537,0.22749642090193234,0.20874168641541171,133262.27774472878,224.2249983475549,133486.50274307633,2853,2,811.1136363636364,40,4,16,33.12992125984251,0.6458333333333333,41.869918699187,1032.520325203253,25.81300813008132,0
4515,4,0,0,44,0.0,0.0,1.0,44,1550,1200,350,0.7741935483870968,19,12,7,336.1760090052456,0.40533606412966877,0.22170047583270658,0.20784020410762277,133367.22932778124,166.97257750017639,133534.20190528143,2854,3,812.1136363636364,40,4,16,33.087162206480365,0.646875,41.768292682926834,1032.926829268294,25.823170731707346,0
4516,4,0,0,44,0.0,0.0,1.0,44,1200,900,300,0.75,15,9,6,337.29015917743953,0.4050167371388302,0.22664917440706556,0.20926806764340367,133498.47690073718,205.544504759086,133704.02140549626,2855,4,813.1136363636364,40,4,17,32.927074114137724,0.6481770833333333,41.64126016260163,1033.434959349595,25.835873983739873,0
4517,4,0,0,44,0.0,0.0,1.0,44,1500,900,600,0.6,21,9,12,336.1704827188637,0.40475246652572233,0.22716101240481912,0.20901749084451587,133577.25642805203,180.94615473593382,133758.20258278796,2856,5,814.1136363636364,40,4,18,32.87722014680823,0.6489583333333333,41.5650406504065,1033.7398373983735,25.84349593495934,0
4518,4,0,1,43,0.0,0.022727272727272728,0.9772727272727273,44,1300,1000,300,0.7692307692307693,16,10,6,332.726173435584,0.4044221282593376,0.21734294596912496,0.20746455520101137,133682.33194527077,95.92215281910046,133778.25409808988,2857,6,815.1136363636364,40,4,18,32.861225759958074,0.65,41.463414634146346,1034.1463414634154,25.853658536585385,0
4519,4,0,0,43,0.0,0.0,1.0,43,750,600,150,0.8,9,6,3,334.365063512241,0.40409283868586193,0.21798955339149217,0.20878328935138585,133734.88519565074,343.2546764492058,134078.13987209994,2858,7,829.3255813953489,40,3,14,32.766342437938036,0.6505208333333332,41.41260162601626,1034.349593495935,25.858739837398378,0
4520,4,0,0,43,0.0,0.0,1.0,43,1300,1100,200,0.8461538461538461,15,11,4,333.325925434638,0.4042543373938723,0.21782625974702263,0.20872844851017763,133840.02267995258,322.4698839976387,134162.49256395022,2859,8,830.3255813953489,40,3,14,32.68819976428992,0.6515624999999999,41.310975609756106,1034.756097560977,25.868902439024424,0
4521,4,0,0,43,0.0,0.0,1.0,43,1000,500,500,0.5,15,5,10,331.44206480080925,0.40374677002583975,0.2096196474759211,0.20829119766353174,133971.5026294701,280.75829119573837,134252.26092066584,2860,9,831.3255813953489,40,3,14,32.60569025882661,0.6528645833333333,41.183943089430905,1035.264227642278,25.88160569105695,0
4522,4,0,0,43,0.0,0.0,1.0,43,1450,1000,450,0.6896551724137931,19,10,9,334.4842274999936,0.40321613141380586,0.2177173032836437,0.21141145067343037,134182.0048107111,376.3528447022202,134558.35765541333,2861,10,832.3255813953489,40,3,14,32.31690371096944,0.6549479166666667,40.980691056910565,1036.077235772357,25.901930894308926,0
4523,4,0,0,43,0.0,0.0,1.0,43,1050,900,150,0.8571428571428571,12,9,3,335.0042948405644,0.4031699889258029,0.21736136132483797,0.21219713035925944,134260.98573104636,395.60136988565307,134656.587100932,2862,11,833.3255813953489,40,3,15,32.22466006406485,0.6557291666666667,40.90447154471545,1036.3821138211383,25.90955284552846,0
4524,4,0,0,43,0.0,0.0,1.0,43,1400,1200,200,0.8571428571428571,16,12,4,333.6945405613227,0.4031469176818014,0.21550387596899223,0.21167191005755534,134313.65258774534,363.94651827615536,134677.5991060215,2863,12,834.3255813953489,40,3,15,32.206086601307184,0.65625,40.853658536585364,1036.5853658536582,25.914634146341456,0
4525,4,0,0,43,0.0,0.0,1.0,43,1250,800,450,0.64,17,8,9,337.646865324847,0.4031238464377999,0.22058615770932732,0.2151076097069533,134471.7151249258,480.79061735741254,134952.50574228322,2864,13,835.3255813953489,40,3,15,31.946077470768838,0.6578124999999999,40.70121951219513,1037.1951219512207,25.929878048780516,0
4526,4,0,0,43,0.0,0.0,1.0,43,1250,1000,250,0.8,15,10,5,337.6007236007394,0.4028008490217792,0.2173203644181143,0.21602543411908587,134631.84814453125,490.3851083158795,135122.23325284713,2865,14,836.3255813953489,39,4,15,31.78771872595269,0.6610576923076923,40.546875,1037.8125,26.610576923076923,0
4527,4,0,0,43,0.0,0.0,1.0,43,1000,700,300,0.7,13,7,6,335.9651404098993,0.40261627906976744,0.2166886428079675,0.21529856104081324,134685.9063042534,449.9538845486061,135135.860188802,2866,15,837.3255813953489,39,4,15,31.77632129118581,0.6615918803418804,40.494791666666664,1038.020833333333,26.615918803418797,0
4528,4,0,0,43,0.0,0.0,1.0,43,1000,600,400,0.6,14,6,8,337.1969276479342,0.40250092284976,0.21587051222522713,0.21640964442156868,134739.97531467018,486.78114149306055,135226.75645616325,2867,16,838.3255813953489,39,4,15,31.69051620347146,0.6621260683760684,40.442708333333336,1038.229166666667,26.621260683760692,0
4529,4,0,0,43,0.0,0.0,1.0,43,1100,800,300,0.7272727272727273,14,8,6,340.5503090435557,0.40222406792174237,0.240304620055245,0.21471729377425958,134091.8633355034,533.0050998263805,134624.8684353298,2868,17,839.3255813953489,39,4,16,32.24976113848938,0.6557158119658121,41.06770833333333,1035.729166666666,26.557158119658105,1
4530,4,0,0,43,0.0,0.0,1.0,43,1250,900,350,0.72,16,9,7,339.51239447830926,0.4016011443337025,0.23397962690632457,0.21469356566279346,134199.7734917534,512.4972873263841,134712.2707790798,2869,18,840.3255813953489,39,4,16,32.16893284407358,0.656784188034188,40.963541666666664,1036.145833333333,26.567841880341874,0
4531,4,0,0,43,0.0,0.0,1.0,43,700,400,300,0.5714285714285714,10,4,6,341.36898463599664,0.40187799926172024,0.2387665465969464,0.2161858706647697,134253.7448459202,566.012912326395,134819.75775824662,2870,19,841.3255813953489,39,4,16,32.06697909337622,0.6573183760683761,40.911458333333336,1036.3541666666672,26.573183760683776,0
4532,4,0,0,43,0.0,0.0,1.0,43,1550,1200,350,0.7741935483870968,19,12,7,340.74383751382203,0.40162421557770395,0.24047978252847946,0.21722965006162887,134496.75021701408,565.787760416685,135062.53797743077,2871,20,842.3255813953489,39,4,17,31.84081475530561,0.6597222222222221,40.67708333333334,1037.2916666666683,26.597222222222264,0
4533,4,0,0,43,0.0,0.0,1.0,43,1100,800,300,0.7272727272727273,14,8,6,340.8094271736643,0.40153193060169806,0.24091155724362423,0.21794301675262437,134609.2053835931,575.2497879002366,135184.45517149335,2872,21,843.3255813953489,36,7,17,31.727030204376927,0.6663773148148149,40.568693693693696,1037.7252252252256,28.82570070070071,0
4534,4,0,0,43,0.0,0.0,1.0,43,1050,900,150,0.8571428571428571,12,9,3,373.71065093870004,0.40153193060169806,0.24482286900325545,0.2219751215816613,131862.5217013887,1339.7013673301485,133202.22306871886,2873,22,844.3255813953489,35,8,15,33.63336713995943,0.6410714285714286,43.22916666666666,1027.0833333333317,29.34523809523805,7
4535,4,0,0,43,0.0,0.0,1.0,43,1350,1000,350,0.7407407407407407,17,10,7,374.15754326082595,0.40104743447766705,0.242051163838493,0.22293762879661802,131981.42387902932,1276.3690629286514,133257.79294195797,2874,23,845.3255813953489,35,8,16,33.50182098070135,0.6422619047619048,43.11342592592592,1027.546296296295,29.35846560846557,0
4536,4,1,0,44,0.022727272727272728,0.0,1.0,44,1200,800,400,0.6666666666666666,16,8,8,367.2527380413544,0.40202167019027485,0.24769667784333382,0.22090772004502024,132340.06123944905,920.4499685496459,133260.5112079987,2875,0,827.0909090909091,36,8,17,33.317600598299954,0.6438078703703705,42.76463963963965,1028.9414414414425,28.581706706706736,0
4537,4,0,0,44,0.0,0.0,1.0,44,950,500,450,0.5263157894736842,14,5,9,366.8005204696491,0.4017353770260747,0.24617978869456247,0.22080521449615637,132369.03077063552,910.6058761464255,133279.63664678196,2876,1,828.0909090909091,36,8,17,33.300047421025766,0.6440972222222222,42.73648648648649,1029.0540540540544,28.584834834834844,0
4538,4,1,1,44,0.022222222222222223,0.022222222222222223,0.9777777777777777,45,1050,800,250,0.7619047619047619,13,8,5,360.36681770122027,0.4040824915824916,0.24605031400702115,0.2184410391990103,132629.89921932085,559.0861131401894,133188.98533246104,2877,0,810.6666666666666,36,9,15,33.20305382456908,0.6467013888888888,42.48310810810812,1030.067567567569,28.61298798798803,0
4539,4,0,0,44,0.0,0.0,1.0,44,900,500,400,0.5555555555555556,13,5,8,367.98853402114025,0.4015702078928823,0.2524528591139046,0.2222171086298739,132487.35592689048,950.7655767746924,133438.12150366517,2878,3,830.0909090909091,35,9,18,33.15029510961214,0.6473214285714286,42.62152777777778,1029.5138888888891,29.41468253968255,0
4540,4,0,0,44,0.0,0.0,1.0,44,1250,1000,250,0.8,15,10,5,367.9800489444659,0.4008434637068358,0.2517979548263847,0.22291725361176332,132606.53941883147,959.3121731395779,133565.85159197103,2879,4,831.0909090909091,35,9,18,33.03051372813425,0.6485119047619048,42.50578703703704,1029.9768518518522,29.42791005291006,0
4541,4,0,0,44,0.0,0.0,1.0,44,1100,900,200,0.8181818181818182,13,9,4,359.207812395592,0.40136099365750527,0.2694499186016628,0.20380721334316723,130099.04308431942,560.667971730385,130659.7110560498,2880,5,832.0909090909091,38,6,18,35.79039690019899,0.6175986842105263,44.95192307692307,1020.1923076923068,26.847165991902813,8
4542,4,0,0,44,0.0,0.0,1.0,44,800,600,200,0.75,10,6,4,358.7679650703638,0.40136099365750527,0.25133859174391104,0.193342872643722,128063.41428336647,389.11283694940346,128452.52712031586,2881,6,833.0909090909091,38,6,19,37.87668883259447,0.5970394736842104,46.95512820512822,1012.1794871794893,26.636302294197087,4
4543,4,4,3,45,0.08333333333333333,0.0625,0.9375,48,1500,1400,100,0.9333333333333333,16,14,2,329.8507725802415,0.4146073433806146,0.23111047151867048,0.18113685361759413,128814.2301725992,-1102.0539674137513,127712.17620518545,2882,0,764.5833333333334,40,8,16,37.843294290386105,0.6013020833333332,46.214430894308954,1015.1422764227659,25.37855691056915,0
4544,4,0,1,44,0.0,0.022222222222222223,0.9777777777777777,45,1000,600,400,0.6,14,6,8,346.23089932255965,0.4043139730639731,0.24580536146504084,0.1884518519131519,128461.13281250025,-104.55729166663752,128356.5755208336,2883,1,816.5555555555555,39,6,16,37.78771064529389,0.5993589743589742,46.562500000000014,1013.7500000000019,25.993589743589794,0
4545,4,1,2,43,0.022222222222222223,0.044444444444444446,0.9555555555555556,45,950,500,450,0.5263157894736842,14,5,9,345.628068947635,0.40669191919191916,0.2434425387696415,0.18874820568385448,128593.16541883702,-110.91851128469943,128482.24690755231,2884,0,817.3555555555556,39,6,16,37.66827992879394,0.6006944444444444,46.43229166666668,1014.2708333333351,26.00694444444449,0
4546,4,1,0,44,0.022727272727272728,0.0,1.0,44,800,500,300,0.625,11,5,6,348.856376256546,0.40502774841437633,0.24705119352009075,0.19114504035384003,128725.2658420141,181.32595486113044,128906.59179687522,2885,0,818.0227272727273,39,5,18,37.451669746116465,0.6020299145299144,46.30208333333334,1014.7916666666683,26.020299145299187,0
4547,4,0,0,44,0.0,0.0,1.0,44,600,400,200,0.6666666666666666,8,4,4,354.4381277901786,0.40482954545454547,0.18896103896103922,0.18725033166273602,127262.39753266796,223.965902663666,127486.36343533163,2886,1,819.0227272727273,36,8,19,38.80696614583334,0.5925925925925926,47.74774774774776,1009.0090090090104,28.028028028028064,4
4548,4,2,0,46,0.043478260869565216,0.0,1.0,46,1200,800,400,0.6666666666666666,16,8,8,363.596335246998,0.4105475040257649,0.24682411880479482,0.1963420210333791,128144.53125000015,118.57638888890347,128263.10763888905,2887,0,784.3695652173913,38,8,17,37.67146776406037,0.597861842105263,46.87500000000001,1012.5000000000011,26.644736842105292,0
4549,4,2,0,48,0.041666666666666664,0.0,1.0,48,1550,1200,350,0.7741935483870968,19,12,7,347.94283175468723,0.4143210697399527,0.24960302838895343,0.19071603917125052,128740.17373666794,-641.1558778946826,128099.01785877327,2888,0,752.6458333333334,38,10,17,37.45964487489909,0.6038925438596492,46.28739316239315,1014.8504273504259,26.70659019343226,0
4550,4,2,1,49,0.04,0.02,0.98,50,1750,1400,350,0.8,21,14,7,333.9107774796587,0.42024659863945574,0.2487046958714152,0.18555147056794324,129282.86540516098,-1364.5622169260052,127918.30318823498,2889,0,723.5,38,12,18,37.26363063346992,0.609375,45.753205128205124,1016.9871794871788,26.762820512820493,0
4551,4,0,0,49,0.0,0.0,1.0,49,950,800,150,0.8421052631578947,11,8,3,343.32168771835546,0.4166135204081633,0.25326196052191396,0.19038748137108774,129201.38888888869,-928.4722222222467,128272.91666666644,2890,1,739.265306122449,37,12,19,37.10724043715846,0.6103603603603605,45.83333333333332,1016.666666666665,27.477477477477432,0
4552,4,3,2,50,0.057692307692307696,0.038461538461538464,0.9615384615384616,52,1000,600,400,0.6,14,6,8,323.14741272972384,0.4246087858220211,0.24997379239080786,0.18210056889591064,129832.53146455332,-2008.9906738158347,127823.54079073749,2891,0,697.5576923076923,41,11,14,36.97992715532626,0.610010162601626,45.213293650793645,1019.1468253968246,24.85723964382499,0
4553,4,0,0,50,0.0,0.0,1.0,50,1300,1000,300,0.7692307692307693,16,10,6,333.40305016012644,0.4193962585034014,0.25107248747571864,0.18752244011593985,129757.97661675338,-1347.6589626736195,128410.31765407976,2892,1,726.46,39,11,15,36.79423116245782,0.6124465811965812,45.28645833333333,1018.8541666666658,26.12446581196579,0
4554,4,1,2,49,0.0196078431372549,0.0392156862745098,0.9607843137254902,51,1300,800,500,0.6153846153846154,18,8,10,322.6631378641889,0.42364379084967324,0.2511178540326706,0.1834758341128076,130184.79100568431,-1798.8333663824612,128385.95763930185,2893,0,713.1960784313726,40,11,17,36.63571333731658,0.6151041666666668,44.86788617886178,1020.5284552845518,25.513211382113795,0
4555,4,1,0,50,0.02,0.0,1.0,50,1700,1200,500,0.7058823529411765,22,12,10,327.4174540866561,0.42090136054421773,0.2653749617385983,0.18667937565464315,130289.17236328125,-1468.2101779513894,128820.96218532986,2894,0,728.24,39,11,18,36.40880607421013,0.6177884615384617,44.765625,1020.9375,26.177884615384617,0
4556,4,0,0,50,0.0,0.0,1.0,50,1450,1100,350,0.7586206896551724,18,11,7,328.34351553530576,0.42081632653061224,0.27121543664213266,0.18820785092314507,130496.1136311058,-1430.489457333598,129065.62417377222,2895,1,729.24,40,10,14,36.17590013924807,0.6182291666666667,44.5630081300813,1021.7479674796747,25.543699186991866,0
4557,4,0,0,50,0.0,0.0,1.0,50,800,700,100,0.875,9,7,2,328.7413676023004,0.42028061224489793,0.2740797454509294,0.1888150733281744,130574.00238160153,-1414.9847767532578,129159.01760484827,2896,2,730.24,40,10,14,36.087012362864996,0.6190104166666668,44.48678861788618,1022.0528455284551,25.551321138211378,0
4558,4,0,2,48,0.0,0.04,0.96,50,1250,900,350,0.72,16,9,7,310.3234436589786,0.4204676870748299,0.16949054670764685,0.17219342710937757,129225.45882295987,-1977.4906920597175,127247.96813090016,2897,3,731.24,43,7,18,37.92153689733323,0.601017441860465,45.8096590909091,1016.7613636363649,23.645613107822438,7
4559,4,1,0,49,0.02040816326530612,0.0,1.0,49,2050,1600,450,0.7804878048780488,25,16,9,314.4137176748975,0.4164895124716553,0.1853470981687273,0.17512093484714847,129373.84627013098,-1664.6176048614893,127709.22866526949,2898,0,746.8571428571429,42,7,19,37.66707940438772,0.6039186507936507,45.66375968992248,1017.3449612403099,24.222499077150236,0
4560,4,2,2,49,0.0392156862745098,0.0392156862745098,0.9607843137254902,51,1200,800,400,0.6666666666666666,16,8,8,305.2616825072904,0.4195588235294118,0.19340584939109684,0.17183656347788895,129790.40745027429,-2275.9923696845062,127514.41508058978,2899,0,718.5294117647059,44,7,17,37.4782295926094,0.6053503787878789,45.254629629629626,1018.981481481481,23.15867003367002,0
4561,4,0,1,48,0.0,0.02040816326530612,0.9795918367346939,49,1450,1000,450,0.6896551724137931,19,10,9,314.43082479222875,0.4173929988662131,0.19806267098219754,0.1764539455094027,129669.75509472072,-1645.5663909921425,128024.18870372858,2900,1,748.7551020408164,42,7,17,37.36680620302541,0.6068948412698414,45.37306201550387,1018.5077519379834,24.250184569951983,0
4562,4,0,0,48,0.0,0.0,1.0,48,1250,1100,150,0.88,14,11,3,317.37038228354544,0.41654661643026003,0.1761990208194697,0.1790037024793894,129867.21543364269,-1356.7984383450614,128510.41699529762,2901,2,737.0625,42,6,18,37.09200811230471,0.6088789682539684,45.17926356589147,1019.2829457364331,24.26864156515317,0
4563,4,1,1,48,0.02040816326530612,0.02040816326530612,0.9795918367346939,49,1000,600,400,0.6,14,6,8,315.2441403013677,0.4186153628117914,0.17858894508903167,0.17928158839197028,130190.0945265868,-1591.6671150424747,128598.42741154433,2902,0,723.0,43,6,18,36.81963517985835,0.6107073643410853,44.86268939393939,1020.5492424242417,23.73370331219167,0
4564,4,1,0,49,0.02040816326530612,0.0,1.0,49,1450,900,550,0.6206896551724138,20,9,11,316.0704812688157,0.41879251700680276,0.18660138168914941,0.18067438115838177,130389.20899667733,-1557.52363820969,128831.68535846764,2903,0,723.9795918367347,41,8,19,36.5973571312935,0.6155995934959348,44.66765873015873,1021.3293650793648,24.9104723190089,0
4565,4,0,0,49,0.0,0.0,1.0,49,1300,900,400,0.6923076923076923,17,9,8,313.3274922800001,0.41870393990929705,0.18692508053365087,0.17952683559261373,130480.18470392827,-1623.394186897399,128856.79051703088,2904,1,724.9795918367347,43,6,19,36.57554376370997,0.6136143410852715,44.57859848484848,1021.6856060606043,23.760130373502424,0
4566,4,1,1,49,0.02,0.02,0.98,50,1150,1000,150,0.8695652173913043,13,10,3,310.82817601660247,0.42084183673469383,0.19483707458363453,0.17960406321294065,130806.65294924557,-1868.32133058985,128938.33161865572,2905,0,711.46,44,6,16,36.31011646150131,0.615530303030303,44.25925925925926,1022.9629629629633,23.249158249158256,0
4567,4,1,1,49,0.02,0.02,0.98,50,1450,1300,150,0.896551724137931,16,13,3,312.9940474413562,0.41964285714285715,0.20063874061340758,0.1814118094582753,130925.07823216739,-1804.2459705075453,129120.83226165985,2906,0,712.4,44,6,16,36.13536294821916,0.6167140151515151,44.14351851851852,1023.4259259259263,23.259680134680142,0
4568,4,0,0,49,0.0,0.0,1.0,49,1300,900,400,0.6923076923076923,17,9,8,320.32151655472063,0.41696782879818595,0.2042138221069867,0.18561472543736546,130915.92527727551,-1412.962454803729,129502.96282247179,2907,2,727.9387755102041,43,6,17,35.95711498719966,0.6179748062015504,44.15246212121212,1023.3901515151509,23.799770965468625,0
4569,4,0,0,49,0.0,0.0,1.0,49,900,300,600,0.3333333333333333,15,3,12,320.08016697459556,0.41647179705215415,0.20603749362834933,0.18582527416731337,130988.61932535573,-1414.6281709136902,129573.99115444203,2908,3,728.9387755102041,43,6,17,35.88999383287081,0.618701550387597,44.08143939393939,1023.6742424242416,23.806377730796317,0
4570,4,0,1,48,0.0,0.02040816326530612,0.9795918367346939,49,1650,1200,450,0.7272727272727273,21,12,9,324.7108250407335,0.41634778911564624,0.20857652353590472,0.18910864689367435,131109.82090973656,-1285.4443762913265,129824.37653344523,2909,4,729.9387755102041,43,6,18,35.649271844660184,0.6199127906976745,43.96306818181818,1024.1477272727273,23.817389006342495,0
4571,4,0,0,48,0.0,0.0,1.0,48,1300,900,400,0.6923076923076923,17,9,8,326.1005399924659,0.4163988622931442,0.1970031266364778,0.1906393270263901,131255.33679300136,-1039.5127589818344,130215.82403401953,2910,5,688.7708333333334,43,5,19,35.46701244493731,0.6213662790697674,43.82102272727274,1024.7159090909117,23.830602536997947,0
4572,4,0,1,47,0.0,0.020833333333333332,0.9791666666666666,48,1350,900,450,0.6666666666666666,18,9,9,324.87276092273106,0.41638962765957444,0.19224254742547453,0.1902826171118855,131328.12500000015,-1067.0138888888737,130261.11111111127,2911,6,689.7708333333334,44,4,19,35.42513550135503,0.6207386363636364,43.75000000000001,1025.0000000000011,23.29545454545457,0
4573,4,0,0,47,0.0,0.0,1.0,47,1100,800,300,0.7272727272727273,14,8,6,339.50816063231906,0.41466234967622567,0.16362750454028663,0.19899005324219685,131354.16795764773,-476.497331284271,130877.67062636346,2912,7,704.0,40,7,19,35.02383430818545,0.6268229166666666,43.72459349593497,1025.1016260162617,25.62754065040654,2
4574,4,0,0,47,0.0,0.0,1.0,47,1450,1000,450,0.6896551724137931,19,10,9,339.96017526416307,0.4147779833487512,0.17303699956793417,0.2003443064385132,131562.6045694529,-454.7907784717894,131107.8137909811,2913,8,705.0,40,7,16,34.802088492653134,0.62890625,43.52134146341464,1025.914634146343,25.647865853658573,0
4575,4,0,0,47,0.0,0.0,1.0,47,750,400,350,0.5333333333333333,11,4,7,343.2842270179542,0.41421908726487816,0.17402186439356737,0.20285707481886034,131666.88484243845,-360.16704260029985,131306.71779983814,2914,9,706.0,40,7,16,34.61171898207743,0.6299479166666666,43.41971544715447,1026.3211382113827,25.65802845528457,0
4576,4,0,0,47,0.0,0.0,1.0,47,1250,800,450,0.64,17,8,9,340.9103603352711,0.4140456367560901,0.17070139892248015,0.2018684912137696,131745.12215777647,-417.3445865556207,131327.77757122085,2915,10,707.0,40,7,17,34.59380980663895,0.6307291666666668,43.34349593495935,1026.6260162601627,25.665650406504067,0
4577,4,1,1,47,0.020833333333333332,0.020833333333333332,0.9791666666666666,48,1150,700,450,0.6086956521739131,16,7,9,331.1429064606469,0.41573396867612294,0.1659753645047768,0.19779076304811608,132074.0941049216,-852.9201219878561,131221.17398293375,2916,0,693.25,42,6,18,34.51365321769735,0.6309523809523809,43.02325581395349,1027.906976744186,24.473975636766333,0
4578,4,0,1,46,0.0,0.02127659574468085,0.9787234042553191,47,1000,600,400,0.6,14,6,8,337.73489840514185,0.41606922602528523,0.18431429940398303,0.20239302522720315,132198.62768350745,-470.3819820022952,131728.24570150516,2917,1,707.6170212765958,42,5,19,34.21903954269921,0.6321924603174605,42.90213178294573,1028.391472868216,24.485511258767048,0
4579,4,0,1,45,0.0,0.021739130434782608,0.9782608695652174,46,750,400,350,0.5333333333333333,11,4,7,347.0889941170435,0.4137882447665056,0.19521172843390167,0.20783231796783094,132168.3784190759,-25.162096088447896,132143.21632298743,2918,2,723.7391304347826,41,5,19,34.00898456343462,0.6333841463414633,42.93154761904761,1028.2738095238087,25.079849012775824,0
4580,4,1,0,46,0.021739130434782608,0.0,1.0,46,1200,900,300,0.75,15,9,6,352.95084756953196,0.41382850241545893,0.20768521236006876,0.21205679544009545,132295.92328829682,138.7916509196299,132434.71493921644,2919,0,724.304347826087,41,5,20,33.729909996785594,0.6346544715447153,42.807539682539684,1028.7698412698414,25.09194734804491,0
4581,4,0,0,46,0.0,0.0,1.0,46,950,800,150,0.8421052631578947,11,8,3,352.94079152555406,0.41354669887278583,0.20598098559667322,0.21233769661850616,132346.95845930962,142.12805492567122,132489.0865142353,2920,1,725.304347826087,41,5,20,33.67881475768093,0.6351626016260162,42.757936507936506,1028.9682539682537,25.09678668215253,0
4582,4,0,0,46,0.0,0.0,1.0,46,1250,1000,250,0.8,15,10,5,368.61412969284277,0.41354669887278583,0.19222093723417455,0.2152536169413017,131212.72243527306,478.1755440860884,131690.89797935914,2921,2,726.304347826087,36,10,16,34.42102659925258,0.6325231481481481,43.86261261261261,1024.549549549549,28.459709709709696,3
4583,4,1,1,46,0.02127659574468085,0.02127659574468085,0.9787234042553191,47,1000,700,300,0.7,13,7,6,361.13059132069526,0.41543324082639527,0.1904637302612675,0.2123186762529096,131472.44953991144,95.79541534776999,131568.2449552592,2922,0,711.8297872340426,36,11,17,34.35017934921854,0.6351273148148149,43.60923423423423,1025.5630630630624,28.487862862862844,0
4584,4,1,1,46,0.02127659574468085,0.02127659574468085,0.9787234042553191,47,1500,1100,400,0.7333333333333333,19,11,8,368.4373267985619,0.4170713845205057,0.1975808112474431,0.20812456042363459,129927.0027797013,209.6141324795852,130136.61691218089,2923,0,712.6808510638298,37,10,17,35.7299060729906,0.6176801801801801,45.12061403508771,1019.5175438596481,27.55452821242292,5
4585,4,1,1,46,0.02127659574468085,0.02127659574468085,0.9787234042553191,47,1050,700,350,0.6666666666666666,14,7,7,368.285870381565,0.4210800185013876,0.20148679825685734,0.20837514124434126,129990.07100819997,174.70128844327127,130164.77229664325,2924,0,707.3191489361702,38,9,17,35.66963506198707,0.6165021929824561,45.05876068376068,1019.7649572649569,26.83591992802518,0
4586,4,0,1,45,0.0,0.021739130434782608,0.9782608695652174,46,1250,1000,250,0.8,15,10,5,376.7829595348284,0.41754227053140097,0.20676784249384728,0.21244145590793523,129853.92011834323,585.3488658777142,130439.26898422095,2925,2,723.695652173913,38,8,17,35.591588050314456,0.6151315789473684,45.19230769230769,1019.2307692307695,26.821862348178144,0
4587,4,0,0,45,0.0,0.0,1.0,45,1100,700,400,0.6363636363636364,15,7,8,373.9620517737245,0.4155513468013468,0.21299342296723123,0.21158670919858913,129990.07100819997,722.2707328877159,130712.34174108769,2926,3,737.3111111111111,38,7,17,35.52492579011699,0.6165021929824561,45.05876068376068,1019.7649572649569,26.83591992802518,0
4588,4,1,2,44,0.021739130434782608,0.043478260869565216,0.9565217391304348,46,1500,1100,400,0.7333333333333333,19,11,8,357.4206230071245,0.4184681964573269,0.13149631585520316,0.1966216835820232,128883.8758680556,20.28781663197134,128904.16368468758,2927,0,722.2608695652174,39,7,16,37.072561893037886,0.6036324786324787,46.145833333333336,1015.4166666666671,26.036324786324798,6
4589,4,3,0,47,0.06382978723404255,0.0,1.0,47,1150,1000,150,0.8695652173913043,13,10,3,349.9100337710914,0.419345513413506,0.15589763702323767,0.1946935316110942,129333.8012695311,-348.5704210069586,128985.23084852415,2928,0,707.5744680851063,39,8,19,36.80502218808672,0.608173076923077,45.70312499999999,1017.1874999999989,26.08173076923074,0
4590,4,1,2,46,0.020833333333333332,0.041666666666666664,0.9583333333333334,48,1200,700,500,0.5833333333333334,17,7,10,340.46853741654905,0.4215887263593381,0.14941450659390654,0.19050644116513746,129554.63927469113,-778.1442901234802,128776.49498456765,2929,0,693.8125,41,7,15,36.82071396089131,0.6072154471544717,45.4861111111111,1018.0555555555536,24.830623306233015,0
4591,4,0,0,46,0.0,0.0,1.0,46,1200,800,400,0.6666666666666666,16,8,8,347.91925541790073,0.417975040257649,0.1467474770856616,0.19384639861190142,129386.78521050327,-196.7692057291876,129190.01600477408,2930,2,724.9565217391304,39,7,19,36.80175164670148,0.6087072649572651,45.65104166666666,1017.3958333333317,26.087072649572608,0
4592,4,0,1,45,0.0,0.021739130434782608,0.9782608695652174,46,1400,1000,400,0.7142857142857143,18,10,8,351.6852977152163,0.4177838164251208,0.16180362504169854,0.1970042283762888,129598.82948133687,-84.39941406249619,129514.43006727437,2931,3,725.9565217391304,39,7,16,36.49030264279624,0.610844017094017,45.442708333333336,1018.2291666666672,26.108440170940185,0
4593,4,0,1,44,0.0,0.022222222222222223,0.9777777777777777,45,1700,1300,400,0.7647058823529411,21,13,8,340.9195214853989,0.4183291245791246,0.11073189230185809,0.1899038399148704,129377.9538001543,-178.50597993827265,129199.44782021602,2932,4,740.4,41,4,15,36.988765642775874,0.6054369918699187,45.65972222222222,1017.361111111111,24.813685636856366,4
4594,4,1,0,45,0.022222222222222223,0.0,1.0,45,1300,800,500,0.6153846153846154,18,8,10,338.93938632577635,0.4181818181818182,0.11080385156334516,0.1906302024953848,129756.71315980109,-204.06785399343755,129552.64530580766,2933,0,738.2888888888889,41,4,14,36.6544952937358,0.6092479674796747,45.28769841269842,1018.8492063492074,24.849980642663596,0
4595,4,1,2,44,0.021739130434782608,0.043478260869565216,0.9565217391304348,46,950,700,250,0.7368421052631579,12,7,5,341.601773855936,0.4195450885668277,0.11895693483424585,0.1934028332347354,130015.40927716195,-317.30111246317904,129698.10816469877,2934,0,723.2173913043479,42,4,14,36.32422802850357,0.6103670634920635,45.03391472868218,1019.8643410852724,24.282484311554104,0
4596,4,1,0,45,0.022222222222222223,0.0,1.0,45,1300,900,400,0.6923076923076923,17,9,8,351.07678034959883,0.41717171717171714,0.13481582331139874,0.19912424337203094,130085.41907793198,133.9940200617161,130219.41309799369,2935,0,740.1333333333333,41,4,17,36.01160086226459,0.6125508130081301,44.96527777777777,1020.1388888888879,24.881436314363118,0
4597,4,1,0,46,0.021739130434782608,0.0,1.0,46,1150,700,450,0.6086956521739131,16,7,9,350.52068043769276,0.41969605475040256,0.1471015970701166,0.20053709407071282,130422.14084201399,-56.50679976850785,130365.63404224548,2936,0,725.0217391304348,39,7,18,35.684359915697875,0.6191239316239316,44.63541666666667,1021.4583333333342,26.191239316239336,0
4598,4,1,0,47,0.02127659574468085,0.0,1.0,47,1300,1000,300,0.7692307692307693,16,10,6,347.1605082643663,0.4213883749614555,0.16168891879229674,0.2002729535365054,130744.07837498422,-322.1638597568694,130421.91451522736,2937,0,710.5744680851063,41,6,16,35.4442517864649,0.6191565040650406,44.320436507936506,1022.7182539682537,24.944347657762286,0
4599,4,0,0,47,0.0,0.0,1.0,47,1050,700,350,0.6666666666666666,14,7,7,345.9187040863176,0.420790934320074,0.16315683430045103,0.20026872341839444,130881.55759870203,-345.12424133165007,130536.43335737038,2938,1,711.5744680851063,42,5,16,35.33696338383839,0.6190476190476191,44.18604651162791,1023.2558139534887,24.363233665559253,0
4600,4,1,2,46,0.020833333333333332,0.041666666666666664,0.9583333333333334,48,1100,600,500,0.5454545454545454,16,6,10,339.214099364187,0.4232140218676123,0.16586738467227535,0.19780479314406524,131158.31723664195,-701.8499088900398,130456.4673277519,2939,0,697.7291666666666,43,5,17,35.22897984653786,0.6203972868217055,43.915719696969695,1024.3371212121208,23.82179351656095,0
4601,4,1,3,44,0.02127659574468085,0.06382978723404255,0.9361702127659575,47,1150,1000,150,0.8695652173913043,13,10,3,345.47774269694276,0.41971168670983655,0.1640578298315145,0.2014365812492764,131154.36952594487,-337.8168942671783,130816.5526316777,2940,0,713.2978723404256,42,5,17,35.07256487875634,0.6217757936507937,43.91957364341085,1024.321705426356,24.388612033960857,0
4602,4,0,0,44,0.0,0.0,1.0,44,700,400,300,0.5714285714285714,10,4,6,369.4024698020668,0.41413407329105006,0.23978178196305722,0.20977380072470297,130132.94004891261,820.1543036895423,130953.09435260216,2941,4,762.5,40,4,18,35.49593293492695,0.6145833333333334,44.918699186991866,1020.3252032520319,25.5081300813008,3
4603,4,1,0,45,0.022222222222222223,0.0,1.0,45,1700,1300,400,0.7647058823529411,21,13,8,364.146590059318,0.4148148148148148,0.2445531992024652,0.20861856047323576,130475.34722222242,502.55965364533654,130977.90687586776,2942,0,746.5333333333333,39,6,19,35.282422512234916,0.6196581196581196,44.58333333333334,1021.6666666666682,26.196581196581235,0
4604,4,0,0,45,0.0,0.0,1.0,45,1100,800,300,0.7272727272727273,14,8,6,361.62686526936267,0.41466750841750843,0.239487264489751,0.20742487908062987,130522.07396597596,440.05769135435594,130962.13165733032,2943,1,747.5333333333333,40,5,13,35.29939499419858,0.6184895833333333,44.53760162601626,1021.8495934959351,25.546239837398378,0
4605,4,1,1,45,0.021739130434782608,0.021739130434782608,0.9782608695652174,46,900,600,300,0.6666666666666666,12,6,6,354.13915441289976,0.41662640901771336,0.24287856071963998,0.2045018005460924,130782.423682471,63.035386995972516,130845.45906946696,2944,0,732.2608695652174,42,4,13,35.22700359984842,0.6180555555555556,44.28294573643411,1022.8682170542635,24.354005167958654,0
4606,4,1,1,45,0.021739130434782608,0.021739130434782608,0.9782608695652174,46,1100,700,400,0.6363636363636364,15,7,8,350.8224319101171,0.416274154589372,0.237114832978625,0.20328890196528862,130915.9252772755,-14.351343692615615,130901.57393358288,2945,0,733.2391304347826,43,3,15,35.176756577526916,0.6179748062015504,44.15246212121212,1023.3901515151508,23.799770965468625,0
4607,4,0,0,45,0.0,0.0,1.0,45,1050,800,250,0.7619047619047619,13,8,5,354.87003190692565,0.4137205387205387,0.23932497974728872,0.2055832368057618,130906.3469461719,290.94790352140575,131197.2948496933,2946,4,750.5333333333333,42,3,15,35.08289145598587,0.619295634920635,44.16182170542635,1023.352713178293,24.365540789959358,0
4608,4,0,1,44,0.0,0.022222222222222223,0.9777777777777777,45,1400,1000,400,0.7142857142857143,18,10,8,358.3834863443108,0.413699494949495,0.24343912339369478,0.2082882242416935,131030.32889399672,391.82121717444574,131422.15011117116,2947,5,751.5333333333333,42,3,15,34.86753896144867,0.6205357142857143,44.0406976744186,1023.8372093023253,24.377076411960125,0
4609,4,1,0,45,0.022222222222222223,0.0,1.0,45,1250,1000,250,0.8,15,10,5,356.6920157450406,0.4176136363636364,0.2463601178560062,0.20878732755049065,131303.86002245452,367.00770130278454,131670.8677237573,2948,0,748.1111111111111,43,2,16,34.634285780282724,0.6218507751937985,43.773674242424235,1024.905303030302,23.835007047216326,0
4610,4,0,0,45,0.0,0.0,1.0,45,1100,700,400,0.6363636363636364,15,7,8,355.8949912098873,0.41759259259259257,0.24301914374469358,0.20914647664221694,131455.26389085694,356.8584811439982,131812.12237200094,2949,1,749.1111111111111,41,4,16,34.501769533391375,0.6262703252032522,43.62599206349205,1025.496031746029,25.012098335269002,0
4611,4,0,1,44,0.0,0.022222222222222223,0.9777777777777777,45,950,600,350,0.631578947368421,13,6,7,356.9027241558923,0.41738215488215485,0.2445153595719305,0.21029806669493353,131557.01929209186,390.61171343537524,131947.63100552725,2950,2,750.1111111111111,41,4,13,34.373186829126766,0.6272865853658536,43.526785714285715,1025.8928571428573,25.021777003484324,0
4612,4,0,0,44,0.0,0.0,1.0,44,1450,900,550,0.6206896551724138,20,9,11,357.0784502667406,0.41718419661733613,0.2351297194684665,0.21082303022597965,131633.36167800447,600.687358276635,132234.0490362811,2199,3,701.1136363636364,41,3,13,34.29161832946636,0.6280487804878049,43.45238095238095,1026.1904761904757,25.02903600464575,0
4613,4,0,1,43,0.0,0.022727272727272728,0.9772727272727273,44,1500,1200,300,0.8,18,12,6,365.1010126056092,0.4167217230443974,0.23839513161619008,0.21679023151859103,131850.081547458,827.7196570218017,132677.8012044798,2200,4,702.1136363636364,42,2,14,33.866992169072546,0.6287202380952381,43.24127906976744,1027.0348837209294,24.453211517164988,0
4614,4,0,0,43,0.0,0.0,1.0,43,850,500,350,0.5882352941176471,12,5,7,372.69145137576186,0.4129291251384275,0.23385237613751308,0.22092534488769364,131786.1128826529,1223.1115362811697,133009.22441893409,2201,11,719.3488372093024,41,2,15,33.73671497584542,0.6295731707317074,43.30357142857142,1026.785714285713,25.043554006968613,0
4615,4,1,0,44,0.022727272727272728,0.0,1.0,44,1300,1000,300,0.7692307692307693,16,10,6,343.0175521145811,0.41553250528541225,0.2102344256666535,0.19233195922095236,129636.22708013744,154.35272166614513,129790.57980180359,2202,0,703.9772727272727,38,6,13,36.67296125332215,0.612938596491228,45.40598290598291,1018.3760683760692,26.799370220422873,8
4616,4,0,0,44,0.0,0.0,1.0,44,1350,1000,350,0.7407407407407407,17,10,7,340.54699946163703,0.4151250880902044,0.20815265560521867,0.19187701286855027,129826.69850107757,42.41852491051887,129869.11702598809,2203,1,704.9772727272727,38,6,15,36.5425271691652,0.6148574561403508,45.2190170940171,1019.1239316239321,26.819050832208738,0
4617,4,0,0,44,0.0,0.0,1.0,44,950,600,350,0.631578947368421,13,6,7,338.3724548884991,0.4145194679351656,0.21054699779943475,0.1911834420959706,129935.60209155147,-6.674268573317079,129928.92782297815,2204,2,705.9772727272727,38,6,16,36.487477732369285,0.615953947368421,45.11217948717948,1019.5512820512809,26.830296896086338,0
4618,4,0,0,44,0.0,0.0,1.0,44,800,700,100,0.875,9,7,2,339.06477739274294,0.4142551973220578,0.21312501785425253,0.19210987713759722,130044.5513391225,18.705370187727226,130063.25670931023,2205,3,706.9772727272727,38,6,17,36.35937118117385,0.6170504385964912,45.005341880341874,1019.9786324786312,26.841542959963977,0
4619,4,0,0,44,0.0,0.0,1.0,44,1000,800,200,0.8,12,8,4,341.8283816583257,0.4144864341085271,0.2040058242852223,0.19096655901563764,129492.78564453126,52.86187065972291,129545.64751519098,2206,4,707.9772727272727,39,5,13,36.84894500733462,0.609775641025641,45.546875,1017.8125000000001,26.097756410256412,2
4620,4,2,0,46,0.043478260869565216,0.0,1.0,46,1350,1200,150,0.8888888888888888,15,12,3,328.5824837368331,0.4184581320450886,0.20971806258391035,0.18603177199194013,130015.40927716177,-655.8427791298606,129359.56649803191,2207,0,678.1521739130435,42,4,16,36.65617577197152,0.6103670634920635,45.03391472868217,1019.8643410852709,24.282484311554068,0
4621,4,0,2,44,0.0,0.043478260869565216,0.9565217391304348,46,1200,900,300,0.75,15,9,6,300.9799931407766,0.4184279388083736,0.08755654858243633,0.17034910814247256,130002.78206447208,-1374.3527091906553,128628.42935528142,2208,1,679.1521739130435,44,2,17,37.37269989710065,0.6074810606060606,45.046296296296305,1019.8148148148164,23.177609427609465,8
4622,4,1,0,45,0.022222222222222223,0.0,1.0,45,1150,800,350,0.6956521739130435,15,8,7,302.62746712565905,0.4166245791245791,0.11645632269240291,0.1719996616954696,130165.93491735544,-1121.6425619834638,129044.29235537197,2209,0,695.1777777777778,43,2,18,37.16592427616927,0.6104651162790697,44.88636363636364,1020.454545454546,23.731501057082465,0
4623,4,1,0,46,0.021739130434782608,0.0,1.0,46,900,700,200,0.7777777777777778,11,7,4,296.8902231825355,0.4192532206119162,0.12475660639777475,0.16968527064248246,130383.45210808364,-1458.049690800049,128925.40241728359,2210,0,681.0434782608696,43,3,19,37.092895224849336,0.6126453488372092,44.67329545454545,1021.3068181818178,23.75132135306553,0
4624,4,0,1,45,0.0,0.021739130434782608,0.9782608695652174,46,1250,800,450,0.64,17,8,9,296.04507466633146,0.4192330917874396,0.11823484625703484,0.17004866901935684,130576.95316983756,-1468.6672298266753,129108.28594001089,2211,1,682.0434782608696,43,3,14,36.91947326971186,0.6145833333333333,44.483901515151516,1022.0643939393938,23.76893939393939,0
4625,4,0,2,43,0.0,0.044444444444444446,0.9555555555555556,45,1400,1200,200,0.8571428571428571,16,12,4,302.8681315757339,0.41698232323232326,0.12624261383385527,0.17411203923664392,130609.02970261696,-1088.537441409778,129520.49226120718,2212,2,697.5777777777778,42,3,15,36.712800581413724,0.6163194444444444,44.45251937984496,1022.1899224806195,24.33785529715761,0
4626,4,0,0,43,0.0,0.0,1.0,43,800,400,400,0.5,12,4,8,309.0867953753117,0.4112910668143226,0.13624137013865667,0.17728851839696286,130522.07396597591,-531.4700864234228,129990.6038795525,2213,4,729.3255813953489,40,3,15,36.64159622078569,0.6184895833333333,44.53760162601626,1021.8495934959348,25.546239837398367,0
4627,4,0,0,43,0.0,0.0,1.0,43,850,300,550,0.35294117647058826,14,3,11,311.1087963265055,0.4108527131782946,0.1420775132158949,0.179168036625127,130677.89019639415,-468.99177490252384,130208.89842149163,2214,5,730.3255813953489,40,3,15,36.43276016300567,0.6200520833333334,44.38516260162601,1022.4593495934944,25.56148373983736,0
4628,4,1,1,43,0.022727272727272728,0.022727272727272728,0.9772727272727273,44,900,600,300,0.6666666666666666,12,6,6,306.73694559151926,0.41307699083861876,0.15113482175897364,0.17800403850468477,130972.4633487653,-765.1813271605105,130207.2820216048,2215,0,714.7045454545455,41,3,17,36.247738579828116,0.6214430894308944,44.097222222222214,1023.6111111111102,24.96612466124659,0
4629,4,0,0,43,0.0,0.0,1.0,43,1350,700,650,0.5185185185185185,20,7,13,314.2362943013603,0.41276762643041714,0.1528602110805759,0.18206901516770413,130911.7888244431,-372.55291988895556,130539.23590455414,2216,1,713.4186046511628,40,3,17,36.116972856669975,0.6223958333333334,44.15650406504065,1023.3739837398372,25.58434959349593,0
4630,4,0,0,43,0.0,0.0,1.0,43,1600,1400,200,0.875,18,14,4,313.2651452250971,0.41285991140642303,0.1532545298486785,0.18239346272750542,131099.43000637725,-386.2236040249751,130713.20640235228,2217,2,714.4186046511628,41,2,17,35.952787464884246,0.6227134146341464,43.97321428571427,1024.1071428571404,24.97822299651562,0
4631,4,1,0,44,0.022727272727272728,0.0,1.0,44,1050,900,150,0.8571428571428571,12,9,3,308.76757462068525,0.41396890415785764,0.1531054294212184,0.18110193500695979,131381.515842014,-686.1317052862721,130695.38413672772,2218,0,699.1590909090909,39,5,18,35.784139402560456,0.6287393162393162,43.69791666666667,1025.2083333333342,26.287393162393183,0
4632,4,0,0,44,0.0,0.0,1.0,44,1300,900,400,0.6923076923076923,17,9,8,310.81042735031497,0.41464059196617337,0.15325677571818974,0.183065854578104,131541.75347222207,-623.0902777777831,130918.66319444429,2219,1,700.1590909090909,39,5,19,35.570674248578406,0.6303418803418804,43.541666666666664,1025.8333333333323,26.30341880341878,0
4633,4,0,0,44,0.0,0.0,1.0,44,1250,700,550,0.56,18,7,11,311.670786923776,0.4145965468639887,0.15698704462407242,0.18408756551397132,131648.63281249997,-593.7934027777783,131054.83940972219,2220,2,701.1590909090909,39,5,14,35.44119637298688,0.6314102564102565,43.4375,1026.2499999999998,26.31410256410256,0
4634,4,0,1,43,0.0,0.022727272727272728,0.9772727272727273,44,1400,900,500,0.6428571428571429,19,9,10,312.6601757748929,0.4140790169133193,0.16407395414519188,0.1857763901561928,131875.56932257576,-553.5522630378858,131322.01705953787,2221,3,702.1590909090909,40,4,15,35.18786484614624,0.63203125,43.21646341463414,1027.1341463414626,25.678353658536565,0
4635,4,0,0,43,0.0,0.0,1.0,43,1200,1000,200,0.8333333333333334,14,10,4,317.8093010832952,0.41258305647840526,0.16629629105389565,0.18850566125626486,131809.03320312485,-221.97265625001597,131587.06054687483,2222,7,719.4186046511628,39,4,16,35.12248934875229,0.6330128205128207,43.28124999999999,1026.8749999999989,26.330128205128176,0
4636,4,1,0,44,0.022727272727272728,0.0,1.0,44,1400,1000,400,0.7142857142857143,18,10,8,309.49060982828473,0.4164574524312896,0.15477069640351493,0.1822884883725452,131541.7534722226,-646.0720486110719,130895.68142361153,2223,0,704.0454545454545,39,5,24,35.60452206877877,0.6303418803418801,43.541666666666686,1025.8333333333364,26.303418803418882,2
4637,4,0,1,43,0.0,0.022727272727272728,0.9772727272727273,44,800,500,300,0.625,11,5,6,311.7158276325571,0.41595093375616626,0.15933546202046833,0.18398517783153545,131621.90890842053,-594.2735460069043,131027.63536241362,2224,1,705.0454545454545,39,5,17,35.466894223936656,0.6311431623931621,43.463541666666686,1026.1458333333364,26.311431623931703,0
4638,4,0,0,43,0.0,0.0,1.0,43,850,500,350,0.5882352941176471,12,5,7,318.03063686785487,0.4117294204503507,0.1587867542867385,0.1872110450379078,131519.83486969478,-234.53263112716775,131285.30223856762,2225,10,722.4186046511628,38,5,23,35.40755303267022,0.6318530701754386,43.563034188034194,1025.7478632478642,26.993364822312216,0
4639,4,0,0,43,0.0,0.0,1.0,43,700,300,400,0.42857142857142855,11,3,8,317.9661040927975,0.4117294204503507,0.14813235847917072,0.18354551299748242,130768.1762695311,-269.64565134701377,130498.53061818409,2226,11,723.4186046511628,39,4,17,36.16638235393964,0.622596153846154,44.29687499999999,1022.8124999999989,26.225961538461508,5
4640,4,0,1,42,0.0,0.023255813953488372,0.9767441860465116,43,950,500,450,0.5263157894736842,14,5,9,319.05450564291544,0.41145256552233295,0.15386534357069626,0.1846115380926938,130859.79327781076,-249.71866944280072,130610.07460836797,2227,12,724.4186046511628,40,3,17,36.046136273341276,0.6218750000000001,44.20731707317073,1023.1707317073165,25.57926829268291,0
4641,4,0,0,42,0.0,0.0,1.0,42,800,500,300,0.625,11,5,6,323.26037773890056,0.41015776229190865,0.12652879370954606,0.1752525325467416,128302.78320312488,-94.29784710863086,128208.48535601626,2228,13,712.0952380952381,39,3,17,38.53117074508188,0.5977564102564104,46.71874999999999,1013.1249999999991,25.97756410256408,7
4642,4,2,2,42,0.045454545454545456,0.045454545454545456,0.9545454545454546,44,1400,1100,300,0.7857142857142857,17,11,6,308.0078194868836,0.4163913847780127,0.1178045485651309,0.16875265053729663,128722.74900990466,-870.4773518203842,127852.27165808427,2229,0,680.6818181818181,41,3,12,38.49054567080523,0.5988313008130082,46.30456349206348,1014.7817460317442,24.750774293457177,0
4643,4,0,0,42,0.0,0.0,1.0,42,1350,1100,250,0.8148148148148148,16,11,5,321.53589718387565,0.41046022067363536,0.12532963457652668,0.17512640667547058,128487.53390842004,-137.32910156251035,128350.20480685752,2230,15,714.0952380952381,39,3,12,38.386695606013895,0.5996260683760685,46.53645833333333,1013.8541666666658,25.996260683760664,0
4644,4,1,1,42,0.023255813953488372,0.023255813953488372,0.9767441860465116,43,1200,700,500,0.5833333333333334,17,7,10,315.5233274168605,0.4136904761904762,0.12981527148083205,0.1730440126805153,128762.65290377739,-474.47586175558314,128288.17704202181,2231,0,698.4651162790698,40,3,13,38.25932044991824,0.60078125,46.26524390243902,1014.9390243902428,25.37347560975607,0
4645,4,1,1,42,0.023255813953488372,0.023255813953488372,0.9767441860465116,43,1550,1200,350,0.7741935483870968,19,12,7,310.51599999999974,0.41828165374677,0.11938139534883718,0.1717455752212392,129098.08976138575,-582.5955119306956,128515.49424945506,2232,0,695.2325581395348,40,3,14,38.04583333333333,0.6041666666666665,45.93495934959351,1016.2601626016286,25.406504065040714,0
4646,4,1,0,43,0.023255813953488372,0.0,1.0,43,900,600,300,0.6666666666666666,12,6,6,336.3578262776655,0.41839700996677737,0.156291787060155,0.179897185796248,127758.96044021404,-0.22628313174561754,127758.73415708229,2233,0,696.2093023255813,40,3,16,38.75485859804316,0.5906250000000001,47.256097560975604,1010.9756097560966,25.274390243902413,6
4647,4,0,0,43,0.0,0.0,1.0,43,1300,1000,300,0.7692307692307693,16,10,6,336.0638569044595,0.4186046511627907,0.1609467787507628,0.18008462251245427,127836.028126859,-7.786267268162078,127828.24185959084,2234,1,697.2093023255813,40,3,18,38.68350752018223,0.59140625,47.17987804878049,1011.280487804878,25.28201219512195,0
4648,4,1,1,43,0.022727272727272728,0.022727272727272728,0.9772727272727273,44,900,600,300,0.6666666666666666,12,6,6,330.03252657930364,0.4209500528541226,0.16960372046612782,0.1779942865335734,128094.31295666388,-344.9420508944553,127749.37090576942,2235,0,682.3409090909091,41,3,18,38.572291911668636,0.592479674796748,46.92460317460316,1012.3015873015852,24.690282617111833,0
4649,4,5,3,45,0.10416666666666667,0.0625,0.9375,48,1050,600,450,0.5714285714285714,15,6,9,312.0875492741771,0.43039856678487,0.18771753993411666,0.17201701199973393,128960.81285152666,-1550.5675091528049,127410.24534237385,2236,0,626.375,43,5,15,38.14523898315619,0.5983527131782946,46.07007575757576,1015.7196969696971,23.621388301620865,0
4650,4,1,1,45,0.021739130434782608,0.021739130434782608,0.9782608695652174,46,1150,700,450,0.6086956521739131,16,7,9,324.3119376622981,0.4230877616747182,0.20023151589813315,0.17836285233603547,128873.80248685121,-840.9374803162003,128032.86500653501,2237,0,654.5869565217391,41,5,17,37.9232820387559,0.6003556910569106,46.15575396825397,1015.3769841269841,24.7652922957801,0
4651,4,2,0,47,0.0425531914893617,0.0,1.0,47,950,500,450,0.5263157894736842,14,5,9,320.9302894779499,0.4242599444958372,0.21657256478143938,0.17808694099982725,129227.22012566905,-1104.582526801089,128122.63759886795,2238,0,641.6170212765958,40,7,20,37.65013326669999,0.6054687500000002,45.80792682926828,1016.7682926829253,25.419207317073134,0
4652,4,0,0,47,0.0,0.0,1.0,47,900,600,300,0.6666666666666666,12,6,6,323.24160655488413,0.42420212765957444,0.2211890062418156,0.1797223332445154,129304.72932778085,-1040.666311388747,128264.0630163921,2239,1,642.6170212765958,40,7,21,37.51269817479349,0.6062500000000002,45.73170731707316,1017.0731707317054,25.426829268292636,0
4653,4,3,3,47,0.06,0.06,0.94,50,1300,900,400,0.6923076923076923,17,9,8,306.43599769500327,0.429328231292517,0.21890044576523038,0.17330371970482084,129972.7387511476,-2034.3348255280314,127938.40392561957,2240,0,605.0,43,7,17,37.26396111936602,0.6085271317829459,45.075757575757564,1019.6969696969677,23.713883016208552,0
4654,4,0,0,47,0.0,0.0,1.0,47,1050,800,250,0.7619047619047619,13,8,5,323.33416998338686,0.424722479185939,0.21107147407313076,0.1811973368698843,129614.99851278975,-1018.2084076938561,128596.79010509589,2241,1,644.5744680851063,40,7,17,37.19560878243512,0.6093750000000002,45.42682926829267,1018.2926829268272,25.457317073170678,0
4655,4,1,2,46,0.020833333333333332,0.041666666666666664,0.9583333333333334,48,1300,900,400,0.6923076923076923,17,9,8,320.0520006393527,0.42725879137115835,0.20970194647202,0.180589473177888,129883.08930342934,-1286.1314838435699,128596.95781958578,2242,0,632.125,41,7,18,37.00760340632605,0.6105182926829269,45.16369047619046,1019.3452380952351,24.862078977932565,0
4656,4,2,1,47,0.041666666666666664,0.020833333333333332,0.9791666666666666,48,1350,1000,350,0.7407407407407407,17,10,7,319.36693044564754,0.42920729905437355,0.23801020408163232,0.1819648789748458,130262.58680555565,-1279.1338931405803,128983.45291241507,2243,0,632.25,40,8,20,36.64115646258504,0.6158854166666666,44.79166666666667,1020.8333333333342,25.520833333333353,0
4657,4,0,0,47,0.0,0.0,1.0,47,1350,1100,250,0.8148148148148148,16,11,5,324.03165347771744,0.4287889300030836,0.24628745115067296,0.18462268628381598,130262.58680555577,-958.1597222221988,129304.42708333356,2244,1,646.5531914893617,39,8,20,36.52210884353742,0.6175213675213674,44.79166666666668,1020.8333333333351,26.17521367521372,0
4658,4,0,0,47,0.0,0.0,1.0,47,1550,900,650,0.5806451612903226,22,9,13,327.2304956330963,0.42782531606537155,0.250352162041271,0.18723224229491575,130426.23325526011,-864.1118096646503,129562.12144559546,2245,2,647.5531914893617,38,9,20,36.274971237318276,0.6208881578947366,44.63141025641028,1021.4743589743623,26.88090418353585,0
4659,4,1,0,48,0.020833333333333332,0.0,1.0,48,1350,900,450,0.6666666666666666,18,9,9,324.60765972511354,0.4296597960992908,0.2617460356870924,0.18795138158551916,130885.78976014645,-1102.6940189370978,129783.09574120936,2246,0,635.0416666666666,40,8,18,35.87785943655446,0.6221354166666664,44.18191056910571,1023.2723577235802,25.581808943089506,0
4660,4,1,2,47,0.02040816326530612,0.04081632653061224,0.9591836734693877,49,900,600,300,0.6666666666666666,12,6,6,319.32433208847993,0.4303606859410431,0.26213766862677224,0.18616734775909446,131150.23389274726,-1424.1078317900863,129726.12606095718,2247,0,623.0612244897959,41,8,18,35.74646892655369,0.623221544715447,43.92361111111113,1024.3055555555584,24.983062330623376,0
4661,4,0,1,46,0.0,0.02127659574468085,0.9787234042553191,47,1000,600,400,0.6,14,6,8,333.07770069163377,0.4260715386987357,0.2594735325906845,0.19280036852645413,130874.74093967046,-681.7084418402427,130193.03249783022,2248,2,650.4893617021277,39,8,19,35.67233788048458,0.6236645299145298,44.19270833333335,1023.2291666666692,26.236645299145366,0
4662,4,0,0,46,0.0,0.0,1.0,46,1300,800,500,0.6153846153846154,18,8,10,340.5606425532361,0.4232487922705314,0.25902846622291364,0.19726814578083723,130901.3888888893,-284.02777777773815,130617.36111111156,2249,3,664.7826086956521,39,7,19,35.453990228013026,0.6239316239316237,44.166666666666686,1023.3333333333366,26.23931623931632,0
4663,4,0,0,46,0.0,0.0,1.0,46,950,500,450,0.5263157894736842,14,5,9,339.95879370955475,0.4234601449275362,0.2579088656981807,0.19750547219319842,131015.81090124954,-292.0045938263969,130723.80630742315,2250,4,665.7826086956521,40,6,19,35.353798557342344,0.6234374999999999,44.0548780487805,1023.7804878048803,25.594512195122007,0
4664,4,1,1,46,0.02127659574468085,0.02127659574468085,0.9787234042553191,47,1150,600,550,0.5217391304347826,17,6,11,333.8011293102876,0.42531991982732037,0.2533991462992564,0.19499423436180185,131226.4581758632,-639.2920131015082,130587.16616276168,2251,0,652.5957446808511,41,6,19,35.29886392977021,0.6239837398373982,43.84920634920636,1024.6031746031767,24.9903213317848,0
4665,4,1,1,46,0.02127659574468085,0.02127659574468085,0.9787234042553191,47,1300,1000,300,0.7692307692307693,16,10,6,338.39152620386363,0.42584027135368485,0.26095092813495024,0.198484418426178,131382.8849806413,-508.11090407015973,130874.77407657115,2252,0,653.5744680851063,38,9,19,35.023490690565524,0.6304824561403508,43.69658119658119,1025.2136752136744,26.979307242465115,0
4666,4,0,0,46,0.0,0.0,1.0,46,1350,800,550,0.5925925925925926,19,8,11,342.5722211101261,0.4223631239935588,0.2664636131132294,0.20094418239521192,131384.3261869036,-198.27591181903006,131186.05027508456,2253,7,668.7826086956521,37,9,20,34.91488413547236,0.6323198198198199,43.695175438596486,1025.2192982456136,27.70862968231388,0
4667,4,1,1,46,0.02127659574468085,0.02127659574468085,0.9787234042553191,47,1400,1000,400,0.7142857142857143,18,10,8,337.49134541619395,0.42399013259327784,0.26276651123639105,0.19923812985387454,131629.44614517112,-515.240224815563,131114.20592035557,2254,0,655.531914893617,38,9,18,34.798065243796636,0.6329495614035088,43.45619658119657,1026.1752136752123,27.004610886189795,0
4668,4,0,0,46,0.0,0.0,1.0,46,1100,700,400,0.6363636363636364,15,7,8,348.04285140184595,0.42160829307568437,0.2719077473236309,0.20546721497939338,131629.4461451713,-37.462447037770175,131591.98369813352,2255,9,670.7826086956521,38,8,19,34.527372896061074,0.6329495614035088,43.45619658119658,1026.1752136752136,27.004610886189834,0
4669,4,0,0,46,0.0,0.0,1.0,46,1100,800,300,0.7272727272727273,14,8,6,348.24888993413924,0.42183977455716587,0.27382799600095975,0.20647872184805724,131793.94866544285,-20.58073544453191,131773.36792999832,2256,10,671.7826086956521,38,8,19,34.3562497832345,0.6345942982456141,43.29594017094016,1026.8162393162377,27.021479982006255,0
4670,4,0,0,46,0.0,0.0,1.0,46,1300,1200,100,0.9230769230769231,14,12,2,349.5745850827894,0.42216183574879224,0.2786216062274549,0.20831526389877703,131985.99810979582,27.790105193919317,132013.78821498973,2257,11,672.7826086956521,38,8,19,34.128716988978994,0.636513157894737,43.10897435897434,1027.5641025640998,27.0411605937921,0
4671,4,1,1,46,0.02127659574468085,0.02127659574468085,0.9787234042553191,47,1450,1100,350,0.7586206896551724,18,11,7,349.2042070990321,0.42497301880974403,0.29072126754920724,0.21007546636566607,132344.4064670138,-156.9552951388942,132187.45117187488,2258,0,659.4468085106383,39,8,20,33.777502193426486,0.6383547008547009,42.760416666666664,1028.9583333333326,26.38354700854699,0
4672,4,0,2,44,0.0,0.043478260869565216,0.9565217391304348,46,1300,700,600,0.5384615384615384,19,7,12,355.5819524938829,0.4248892914653784,0.2997564217145876,0.21469832488521315,132482.65241468523,221.69889413088242,132704.3513088161,2259,1,670.2608695652174,37,9,20,33.474344978165945,0.6432995495495495,42.62609649122807,1029.4956140350873,27.82420578473209,0
4673,4,1,1,44,0.022222222222222223,0.022222222222222223,0.9777777777777777,45,1450,1100,350,0.7586206896551724,18,11,7,353.99609373371754,0.4255260942760943,0.300856156283998,0.21486739642907024,132680.2718144044,393.6595875654011,133073.9314019698,2260,0,677.2222222222222,37,8,18,33.31648219100326,0.6452702702702702,42.43421052631579,1030.2631578947367,27.84495021337126,0
4674,4,0,0,44,0.0,0.0,1.0,44,700,300,400,0.42857142857142855,11,3,8,361.28060682047254,0.42339455602536996,0.3009226119462338,0.21848874793428608,132542.91453615797,777.0369186754543,133319.95145483344,2261,3,693.6136363636364,36,8,20,33.26703302712161,0.6458333333333333,42.56756756756758,1029.7297297297314,28.60360360360365,0
4675,4,0,0,44,0.0,0.0,1.0,44,1800,1400,400,0.7777777777777778,22,14,8,365.6953382492198,0.4237469168428471,0.3138203280699061,0.22083231729306282,132487.3559268907,893.2481776188085,133380.60410450952,2262,4,694.6136363636364,35,9,16,33.209317032040474,0.6473214285714284,42.62152777777779,1029.513888888891,29.414682539682598,3
4676,4,0,0,44,0.0,0.0,1.0,44,1100,700,400,0.6363636363636364,15,7,8,366.77222969825544,0.42325140944326994,0.31644457161543493,0.22165799968720692,132517.1467764063,920.7218792867269,133437.86865569302,2263,5,695.6136363636364,35,9,16,33.15160371702639,0.6476190476190474,42.59259259259261,1029.6296296296318,29.41798941798948,0
4677,4,0,0,44,0.0,0.0,1.0,44,1400,900,500,0.6428571428571429,19,9,10,369.1300988580997,0.4224145525017618,0.32101283530576996,0.22432527441185418,132725.77649444886,998.6157996828006,133724.39229413166,2264,6,696.6136363636364,35,9,16,32.88088752854843,0.6497023809523809,42.390046296296305,1030.439814814816,29.4411375661376,0
4678,4,0,0,44,0.0,0.0,1.0,44,900,500,400,0.5555555555555556,13,5,8,367.169946984885,0.4223044397463002,0.31537535208392864,0.22402396491379156,132874.89819101515,957.5338648834081,133832.43205589856,2265,7,697.6136363636364,35,9,16,32.78139500074839,0.6511904761904761,42.245370370370374,1031.018518518519,29.45767195767197,0
4679,4,0,2,42,0.0,0.045454545454545456,0.9545454545454546,44,1000,800,200,0.8,12,8,4,377.5613098470141,0.4223044397463002,0.3257785634716912,0.22728754925684558,132369.79316953273,1195.5424986534067,133565.33566818613,2266,8,698.6136363636364,37,7,17,33.02244272775705,0.6421734234234235,42.735745614035075,1029.057017543858,27.812351825509673,1
4680,4,0,0,42,0.0,0.0,1.0,42,1100,800,300,0.7272727272727273,14,8,6,384.7284521477557,0.41836043360433606,0.3247850547204536,0.2307107651651645,132224.2148187039,1774.0835007304663,133998.29831943437,2267,21,687.0714285714286,36,6,17,32.985008576955366,0.642650462962963,42.877252252252255,1028.4909909909916,28.56919419419421,0
4681,4,0,0,42,0.0,0.0,1.0,42,1000,700,300,0.7,13,7,6,384.9627948302764,0.4180579752226094,0.32354320736722,0.23156056987256318,132340.06123944887,1789.1999685496316,134129.2612079985,2268,22,688.0714285714286,36,6,18,32.8620353142899,0.6438078703703705,42.76463963963964,1028.9414414414412,28.581706706706697,0
4682,4,0,0,42,0.0,0.0,1.0,42,1150,900,250,0.782608695652174,14,9,5,377.66284303563356,0.4168118466898955,0.3070510659023642,0.22842055163072936,132546.94097490126,1611.6235944520101,134158.56456935327,2269,23,689.0714285714286,35,7,19,32.84124330298602,0.6479166666666667,42.5636574074074,1029.745370370369,29.42129629629626,0
4683,4,0,0,42,0.0,0.0,1.0,42,1050,700,350,0.6666666666666666,14,7,7,377.73571367837513,0.41710220673635306,0.3087531708570146,0.22864574015715522,132576.73852237655,1615.7937885802457,134192.5323109568,2270,24,690.0714285714286,35,7,19,32.809339177343226,0.6482142857142856,42.53472222222222,1029.861111111111,29.424603174603174,0
4684,4,0,1,41,0.0,0.023809523809523808,0.9761904761904762,42,1100,800,300,0.7272727272727273,14,8,6,383.49382761976295,0.41695702671312423,0.31632805897016203,0.23286917145096386,132695.96220207473,1777.6164909122085,134473.57869298695,2271,25,691.0714285714286,35,7,16,32.54090841009511,0.6494047619047618,42.41898148148148,1030.324074074074,29.437830687830683,0
4685,4,1,1,41,0.023809523809523808,0.023809523809523808,0.9761904761904762,42,1050,800,250,0.7619047619047619,13,8,5,380.2051551260099,0.41865079365079366,0.30099845528064195,0.23216228423698576,132904.73257726766,1706.212893304181,134610.94547057184,2272,0,683.7857142857143,35,7,16,32.41537116024993,0.6514880952380953,42.21643518518518,1031.1342592592591,29.460978835978832,0
4686,4,0,0,41,0.0,0.0,1.0,41,1150,800,350,0.6956521739130435,15,8,7,389.9153587153337,0.41493902439024394,0.310018839710392,0.2379885075287884,132888.53635204086,2163.056264172343,135051.5926162132,2273,27,701.4634146341464,34,7,16,32.18137820882884,0.6534926470588235,42.23214285714286,1031.0714285714291,30.325630252100858,0
4687,4,0,0,41,0.0,0.0,1.0,41,1300,1000,300,0.7692307692307693,16,10,6,388.3924607871041,0.41483739837398376,0.3111466483474714,0.2374484042200906,132949.9167375284,2127.349064625857,135077.26580215426,2274,28,702.4634146341464,34,7,16,32.158797952980116,0.6541053921568627,42.17261904761905,1031.3095238095243,30.332633053221304,0
4688,4,0,0,41,0.0,0.0,1.0,41,1200,1000,200,0.8333333333333334,14,10,4,386.3650006133192,0.4137957317073171,0.3015091217148036,0.2367920152273709,133042.01388888893,2080.5555555555593,135122.5694444445,2275,29,703.4634146341464,34,7,17,32.118336025848144,0.6550245098039216,42.083333333333336,1031.666666666667,30.34313725490197,0
4689,4,0,0,41,0.0,0.0,1.0,41,1200,900,300,0.75,15,9,6,387.1880984614544,0.41359247967479673,0.3031041361284532,0.23788331860824585,133134.14292800456,2109.5911281179165,135243.73405612248,2276,30,704.4634146341464,34,7,17,32.004364209635874,0.6559436274509804,41.99404761904762,1032.0238095238096,30.353641456582636,0
4690,4,0,0,41,0.0,0.0,1.0,41,1450,1100,350,0.7586206896551724,18,11,7,391.5022963399748,0.41318597560975606,0.30707809095382044,0.24172828617432596,133318.49666950098,2238.8995181405735,135557.39618764154,2277,31,705.4634146341464,34,7,17,31.70749279538905,0.6577818627450981,41.81547619047618,1032.738095238094,30.374649859943943,0
4691,4,0,0,41,0.0,0.0,1.0,41,1650,1300,350,0.7878787878787878,20,13,7,393.0962347567794,0.4130589430894309,0.3055932598731457,0.24351764607095533,133441.47002551,2291.0678854875105,135732.53791099752,2278,32,706.4634146341464,34,7,17,31.542612436148577,0.6590073529411765,41.69642857142856,1033.2142857142842,30.38865546218483,0
4692,4,0,0,41,0.0,0.0,1.0,41,850,600,250,0.7058823529411765,11,6,5,390.0974325440651,0.4124745934959349,0.303907932973817,0.24248134440008745,133567.2146079631,2220.8490412095985,135788.0636491727,2279,33,707.4634146341464,33,8,18,31.493652440229198,0.6625631313131315,41.57475490196077,1033.7009803921555,31.324272133095622,0
4693,4,0,0,41,0.0,0.0,1.0,41,1050,800,250,0.7619047619047619,13,8,5,388.1752713663976,0.41216971544715447,0.3005846837707631,0.24211464265048233,133693.9236862023,2179.3350213859935,135873.25870758828,2280,34,708.4634146341464,33,8,19,31.416019868072844,0.6638257575757576,41.452205882352935,1034.1911764705872,31.339126559714764,0
4694,4,0,0,41,0.0,0.0,1.0,41,600,400,200,0.6666666666666666,8,4,4,389.9147010670708,0.4116361788617886,0.30472057119576057,0.24361731988949967,133757.3007527151,2230.7875877066217,135988.0883404217,2281,35,709.4634146341464,33,8,16,31.307383603838414,0.6644570707070707,41.390931372549005,1034.4362745098022,31.346553773024308,0
4695,4,0,0,41,0.0,0.0,1.0,41,950,700,250,0.7368421052631579,12,7,5,389.38052476915925,0.41100101626016255,0.30886222183713885,0.24412164303456174,133884.09994052752,2226.3722186178193,136110.47215914534,2282,36,710.4634146341464,33,8,17,31.193877047562655,0.665719696969697,41.26838235294117,1034.926470588234,31.361408199643453,0
4696,4,0,0,41,0.0,0.0,1.0,41,800,600,200,0.75,10,6,4,391.42132245126186,0.41039126016260163,0.3095020442041623,0.24635185692337738,134026.36763038547,2292.155612244896,136318.52324263036,2283,37,711.4634146341464,34,7,17,30.998265884877753,0.664828431372549,41.13095238095238,1035.4761904761904,30.45518207282913,0
4697,4,0,0,41,0.0,0.0,1.0,41,1100,800,300,0.7272727272727273,14,8,6,390.41727786273844,0.41041666666666665,0.3075187355225508,0.2464199320783856,134130.82588520227,2273.3983839163157,136404.2242691186,2284,38,712.4634146341464,35,6,17,30.919459962756054,0.6636904761904763,41.03009259259259,1035.879629629629,29.59656084656083,0
4698,4,0,0,41,0.0,0.0,1.0,41,800,500,300,0.625,11,5,6,390.21339907567807,0.41041666666666665,0.30811482377558375,0.24669423365292847,134190.77932098752,2272.6080246913416,136463.38734567887,2285,39,713.4634146341464,35,6,17,30.864611260053604,0.6642857142857144,40.972222222222214,1036.1111111111102,29.603174603174576,0
4699,4,0,0,41,0.0,0.0,1.0,41,950,600,350,0.631578947368421,13,6,7,387.89929547233703,0.41021341463414634,0.3058708175021454,0.24583426687578008,134280.73459201373,2217.4804687499804,136498.2150607637,2286,40,714.4634146341464,35,6,17,30.83438023450586,0.6651785714285714,40.88541666666666,1036.458333333332,29.613095238095198,0
4700,4,0,0,41,0.0,0.0,1.0,41,700,300,400,0.42857142857142855,11,3,8,387.7564495251561,0.40983231707317075,0.3067571542173664,0.24594523809825047,134310.7263803154,2215.9700788751557,136526.69645919057,2287,41,715.4634146341464,35,6,18,30.808024415661745,0.6654761904761906,40.856481481481474,1036.5740740740732,29.616402116402092,0
4701,4,0,0,41,0.0,0.0,1.0,41,800,700,100,0.875,9,7,2,386.31211463739976,0.40980691056910573,0.30293788479918904,0.24523016377088502,134340.7215175968,2179.489642275365,136520.21115987215,2288,42,716.4634146341464,35,6,18,30.815400431692144,0.6657738095238095,40.82754629629629,1036.6898148148143,29.61970899470898,0
4702,4,0,0,41,0.0,0.0,1.0,41,1400,1100,300,0.7857142857142857,17,11,6,388.5187559213462,0.4092225609756098,0.30550270685164205,0.2474425424172837,134460.73555651997,2248.103539737643,136708.8390962576,2289,43,717.4634146341464,35,6,18,30.63797288249079,0.6669642857142857,40.71180555555555,1037.152777777777,29.632936507936485,0
4703,4,0,0,41,0.0,0.0,1.0,41,950,600,350,0.631578947368421,13,6,7,387.57439396138756,0.4087144308943089,0.30404545009305495,0.24745134383688613,134550.78125000012,2229.747781635817,136780.52903163593,2290,44,718.4634146341464,33,8,18,30.572289156626503,0.6723484848484848,40.62500000000001,1037.500000000001,31.439393939393966,0
4704,4,0,0,41,0.0,0.0,1.0,41,1250,1000,250,0.8,15,10,5,390.25827665947867,0.40790142276422764,0.312287269271748,0.250036883759893,134677.95589436765,2311.8373942714447,136989.7932886391,2291,45,719.4634146341464,33,8,18,30.37534435261708,0.673611111111111,40.50245098039216,1037.990196078432,31.454248366013093,0
4705,4,0,0,41,0.0,0.0,1.0,41,1400,1300,100,0.9285714285714286,15,13,2,388.02840254503127,0.40721544715447155,0.3115252247378535,0.24991859726228613,134868.83049788547,2266.5873702422173,137135.4178681277,2292,46,720.4634146341464,33,8,15,30.24225263489066,0.6755050505050504,40.318627450980394,1038.7254901960787,31.47653000594178,0
4706,4,0,0,41,0.0,0.0,1.0,41,1300,700,600,0.5384615384615384,19,7,12,385.53474610114773,0.40637703252032525,0.3112249887534959,0.24909939294721842,134983.42013888905,2208.1597222222426,137191.5798611113,2293,47,721.4634146341464,34,7,16,30.192461908580583,0.6743259803921567,40.20833333333334,1039.166666666668,30.56372549019612,0
4707,4,0,0,41,0.0,0.0,1.0,41,950,800,150,0.8421052631578947,11,8,3,385.202599355491,0.4057418699186992,0.3113359328737584,0.24952441376648002,135076.2188208618,2206.3421201814226,137282.56094104322,2294,48,722.4634146341464,34,7,16,30.108365781035282,0.6752450980392156,40.11904761904763,1039.5238095238105,30.57422969187678,0
4708,4,0,0,41,0.0,0.0,1.0,41,750,500,250,0.6666666666666666,10,5,5,384.43058938647664,0.4054369918699187,0.3111773955252428,0.24923773846415026,135107.1588010206,2187.86493764174,137295.02373866233,2295,49,723.4634146341464,34,7,16,30.09752280621397,0.6755514705882353,40.08928571428572,1039.6428571428585,30.577731092437013,0
4709,4,0,0,41,0.0,0.0,1.0,41,1050,700,350,0.6666666666666666,14,7,7,383.6651462853383,0.40444613821138214,0.3075750469043148,0.24938234508547025,135200.00000000023,2174.305555555583,137374.30555555582,2296,50,724.4634146341464,34,7,16,30.0247061965812,0.6764705882352939,40.000000000000014,1040.0000000000018,30.588235294117702,0
4710,4,0,0,41,0.0,0.0,1.0,41,1050,900,150,0.8571428571428571,12,9,3,381.71775688606124,0.40447154471544716,0.3064774547951472,0.2485432011676904,135261.91184807266,2126.3747165533005,137388.28656462597,2297,51,725.4634146341464,34,7,16,30.013542381933316,0.6770833333333333,39.9404761904762,1040.238095238096,30.59523809523812,0
4711,4,0,0,41,0.0,0.0,1.0,41,1200,800,400,0.6666666666666666,16,8,8,382.30026862998676,0.40459857723577236,0.30831054305966354,0.24935107073329013,135323.83786848097,2146.8679138322254,137470.7057823132,2298,52,726.4634146341464,34,7,16,29.93659420289854,0.6776960784313724,39.880952380952394,1040.4761904761924,30.6022408963586,0
4712,4,0,0,41,0.0,0.0,1.0,41,800,400,400,0.5,12,4,8,383.0581633700512,0.404395325203252,0.3069805597953015,0.2500605979102031,135354.80619331074,2169.7526927437752,137524.55888605452,2299,53,727.4634146341464,34,7,16,29.885977958280904,0.6780024509803921,39.85119047619048,1040.5952380952388,30.605742296918788,0
4713,4,0,0,41,0.0,0.0,1.0,41,1000,500,500,0.5,15,5,10,386.11894303698205,0.4032774390243902,0.308559901961847,0.2531724498222081,135513.14407578894,2264.838391632392,137777.98246742133,2300,54,728.4634146341464,35,6,17,29.64836223506744,0.6773809523809522,39.69907407407408,1041.203703703705,29.748677248677286,0
4714,4,0,0,41,0.0,0.0,1.0,41,1050,600,450,0.5714285714285714,15,6,9,387.1679573700264,0.4032774390243902,0.2894155700224117,0.2371703095559479,133024.10361207547,2100.6412626457295,135124.7448747212,2301,55,729.4634146341464,35,6,17,32.115659710535155,0.6526785714285714,42.100694444444436,1031.5972222222213,29.474206349206323,3
4715,4,0,0,41,0.0,0.0,1.0,41,1250,800,450,0.64,17,8,9,387.3335794101413,0.4027947154471545,0.28932441376443374,0.23822350766756106,133173.39275763018,2116.505379801084,135289.89813743127,2302,56,730.4634146341464,35,6,18,31.961108619271887,0.6541666666666668,41.95601851851851,1032.175925925925,29.490740740740712,0
4716,4,0,1,40,0.0,0.024390243902439025,0.975609756097561,41,1050,900,150,0.8571428571428571,12,9,3,387.9173265778724,0.40231199186991873,0.28726530232914094,0.23954230484805208,133322.76562767907,2143.642162851499,135466.40779053056,2303,57,731.4634146341464,35,6,20,31.79575721917143,0.6556547619047619,41.81134259259259,1032.7546296296289,29.50727513227511,0
4717,4,2,0,42,0.047619047619047616,0.0,1.0,42,900,600,300,0.6666666666666666,12,6,6,367.1983561218235,0.40730255516840885,0.2583130448441062,0.21394420556873678,131126.2038009291,1230.032745027599,132356.2365459567,2304,0,711.0,36,6,16,34.54485065054059,0.6316550925925928,43.94707207207206,1024.21171171171,28.450325325325277,7
4718,4,0,0,42,0.0,0.0,1.0,42,1100,800,300,0.7272727272727273,14,8,6,367.90215333218094,0.40755662020905925,0.2557148461181846,0.21532757840926042,131300.0289151467,1261.1126740919974,132561.1415892387,2305,1,712.0,37,5,18,34.350928105274406,0.6314752252252254,43.77741228070174,1024.8903508771907,27.699739212897047,0
4719,4,0,1,41,0.0,0.023809523809523808,0.9761904761904762,42,1200,900,300,0.75,15,9,6,368.8948605363415,0.4077622919086334,0.2614393440222562,0.21671978064799519,131443.57829112894,1297.7751021532727,132741.35339328222,2306,2,713.0,36,6,18,34.18030236474118,0.634837962962963,43.637387387387385,1025.4504504504503,28.48473473473473,0
4720,4,1,1,41,0.023809523809523808,0.023809523809523808,0.9761904761904762,42,900,800,100,0.8888888888888888,10,8,2,370.66351036418325,0.4101698606271777,0.25562630365572514,0.21825300038185802,131530.201548677,1350.689244988227,132880.89079366522,2307,0,712.3095238095239,36,6,18,34.04737073224284,0.6357060185185186,43.552927927927925,1025.788288288288,28.49411911911911,0
4721,4,0,1,40,0.0,0.024390243902439025,0.975609756097561,41,800,600,200,0.75,10,6,4,378.6378549517757,0.4070121951219512,0.26530067354617826,0.22263503866806125,131476.45968632106,1756.392934456438,133232.8526207775,2308,4,730.6829268292682,35,6,19,33.89725106270925,0.637202380952381,43.60532407407407,1025.578703703703,29.302248677248656,0
4722,4,0,0,40,0.0,0.0,1.0,40,1150,1000,150,0.8695652173913043,13,10,3,385.87002255333596,0.4069577991452991,0.2649930345948457,0.22673153985500938,131450.1771541951,2144.5365646258624,133594.71371882095,2309,5,745.575,34,6,19,33.73843936227847,0.6390931372549019,43.63095238095239,1025.4761904761913,30.16106442577033,0
4723,4,0,0,40,0.0,0.0,1.0,40,1100,800,300,0.7272727272727273,14,8,6,385.2222088616285,0.40731837606837606,0.26830024813895736,0.2273888218220508,131624.87809713668,2140.9652563443306,133765.843353481,2310,6,746.575,35,5,16,33.57818257011805,0.6386904761904761,43.46064814814816,1026.157407407409,29.318783068783112,0
4724,4,0,0,40,0.0,0.0,1.0,40,1050,700,350,0.6666666666666666,14,7,7,386.2864054491331,0.4079861111111111,0.26262259046330705,0.22890759537336428,131773.38023244613,2180.4530767747046,133953.83330922082,2311,7,747.575,35,5,16,33.400617179573885,0.6401785714285714,43.31597222222223,1026.7361111111122,29.33531746031749,0
4725,4,0,0,40,0.0,0.0,1.0,40,1500,1100,400,0.7333333333333333,19,11,8,391.25801375213575,0.4078926282051282,0.2699312908312683,0.23312675477123912,131981.42387902958,2327.757951817569,134309.18183084714,2312,8,748.575,35,5,16,33.06253285274462,0.6422619047619047,43.11342592592593,1027.546296296297,29.35846560846563,0
4726,4,0,0,40,0.0,0.0,1.0,40,1000,600,400,0.6,14,6,8,390.0036414622894,0.40818643162393164,0.264866006080396,0.23292685540192318,132070.63567654768,2301.6057688186092,134372.2414453663,2313,9,749.575,35,5,16,33.00456498892767,0.6431547619047618,43.02662037037038,1027.89351851852,29.368386243386286,0
4727,4,1,1,40,0.024390243902439025,0.024390243902439025,0.975609756097561,41,1200,800,400,0.6666666666666666,16,8,8,383.4633361423892,0.41059451219512194,0.2597086684772014,0.23084050094267633,132369.793169533,1951.7924986534351,134321.58566818642,2314,0,732.2682926829268,37,4,17,32.87060468833245,0.6421734234234234,42.73574561403509,1029.05701754386,27.81235182550973,0
4728,4,0,0,40,0.0,0.0,1.0,40,850,600,250,0.7058823529411765,11,6,5,388.6903315073868,0.40702457264957265,0.26174474605954434,0.23362334662180853,132311.0948786626,2285.60866609855,134596.70354476117,2315,11,751.575,36,4,17,32.79539732924694,0.6435185185185184,42.7927927927928,1028.8288288288302,28.578578578578615,0
4729,4,1,0,41,0.024390243902439025,0.0,1.0,41,900,700,200,0.7777777777777778,11,7,4,375.9052578145333,0.40980691056910573,0.25372708059633253,0.22782283818772453,132623.79410010795,1770.7963027085475,134394.59040281648,2316,0,734.219512195122,37,4,18,32.80906252217727,0.6447072072072071,42.48903508771931,1030.0438596491244,27.83902323376012,0
4730,4,0,1,40,0.0,0.024390243902439025,0.975609756097561,41,1100,800,300,0.7272727272727273,14,8,6,383.079699687522,0.40960365853658537,0.26021104646032645,0.2328708290855973,132736.76155163135,1969.7517505386422,134706.51330217,2317,1,735.219512195122,37,4,15,32.510463219124645,0.6458333333333333,42.37938596491229,1030.4824561403516,27.850877192982477,0
4731,4,1,0,41,0.024390243902439025,0.0,1.0,41,1000,900,100,0.9,11,9,2,381.8794000612179,0.40932418699186995,0.2646957378664694,0.2333707444818556,132934.57031250015,1952.9947916666804,134887.56510416683,2318,0,734.0975609756098,37,4,16,32.342171717171716,0.647804054054054,42.18750000000001,1031.2500000000011,27.871621621621653,0
4732,4,0,0,41,0.0,0.0,1.0,41,900,600,300,0.6666666666666666,12,6,6,383.42444010134903,0.4086636178861789,0.26446915122780745,0.23502544344713971,133047.67001625506,2002.7456765543338,135050.4156928094,2319,1,735.0975609756098,37,4,16,32.1884853154781,0.6489301801801801,42.077850877192986,1031.6885964912285,27.883475580844014,0
4733,4,0,0,41,0.0,0.0,1.0,41,1250,900,350,0.72,16,9,7,398.5809070894954,0.4085111788617886,0.28450987759624624,0.24031050893199177,132427.78427479835,2357.9898556601033,134785.77413045845,2320,2,736.0975609756098,35,6,17,32.42309025825555,0.6467261904761905,42.67939814814814,1029.282407407406,29.408068783068742,1
4734,4,0,0,41,0.0,0.0,1.0,41,800,500,300,0.625,11,5,6,397.80007905610455,0.4082571138211382,0.28731954098630386,0.24021939600842135,132487.35592689033,2340.696132330234,134828.05205922056,2321,3,737.0975609756098,35,6,17,32.38301011804385,0.6473214285714286,42.62152777777777,1029.513888888888,29.414682539682513,0
4735,4,1,1,41,0.023809523809523808,0.023809523809523808,0.9761904761904762,42,1800,1300,500,0.7222222222222222,23,13,10,388.7885112306683,0.41021825396825395,0.28236196717900763,0.2371324996879925,132861.9978720274,1931.0436703595465,134793.04154238693,2322,0,720.5238095238095,36,6,14,32.23716548334244,0.6490162037037037,42.25788288288288,1030.9684684684682,28.63801301301301,0
4736,4,0,0,41,0.0,0.0,1.0,41,850,600,250,0.7058823529411765,11,6,5,397.5922871818717,0.4073678861788618,0.29156531457497836,0.2418143254827448,132755.59413580244,2356.5200617283867,135112.11419753084,2323,5,739.0975609756098,35,6,14,32.117587601078164,0.65,42.36111111111111,1030.5555555555552,29.444444444444436,0
4737,4,0,0,41,0.0,0.0,1.0,41,900,700,200,0.7777777777777778,11,7,4,396.8602555407357,0.40640243902439027,0.28822593759667514,0.24233228352381175,132904.73257726766,2348.921226637513,135253.65380390518,2324,6,740.0975609756098,35,6,14,31.98603004452426,0.6514880952380953,42.21643518518518,1031.1342592592591,29.460978835978832,0
4738,4,0,0,41,0.0,0.0,1.0,41,1150,800,350,0.6956521739130435,15,8,7,401.1978917485879,0.4061991869918699,0.285951186674438,0.24576472915155784,133024.10361207573,2473.7979841821098,135497.90159625784,2325,7,741.0975609756098,35,6,15,31.75382867721307,0.6526785714285714,42.10069444444445,1031.597222222223,29.474206349206373,0
4739,4,0,0,41,0.0,0.0,1.0,41,750,300,450,0.4,12,3,9,401.1160618437118,0.4060213414634146,0.2860723334628452,0.24591118124311206,133053.95474322716,2474.0156678669537,135527.9704110941,2326,8,742.0975609756098,35,6,16,31.72584324283898,0.6529761904761904,42.07175925925927,1031.712962962964,29.477513227513256,0
4740,4,0,0,41,0.0,0.0,1.0,41,1000,600,400,0.6,14,6,8,400.25711011490165,0.4060213414634146,0.28477646269586376,0.2454588783716691,133065.250639153,2452.062535508517,135517.3131746615,2327,9,743.0975609756098,36,5,16,31.73661136578622,0.6510416666666665,42.06081081081083,1031.7567567567594,28.659909909909985,0
4741,4,0,1,40,0.0,0.024390243902439025,0.975609756097561,41,700,500,200,0.7142857142857143,9,5,4,398.8814046805277,0.40533536585365854,0.2810680180132219,0.24499659467106988,133123.35139193272,2420.085879798742,135543.43727173147,2328,10,744.0975609756098,36,5,16,31.713543940055285,0.6516203703703702,42.00450450450452,1031.9819819819838,28.666166166166217,0
4742,4,0,0,40,0.0,0.0,1.0,40,850,700,150,0.8235294117647058,10,7,3,409.02855279708757,0.40260416666666665,0.29063446650959235,0.25056161450724707,133024.10361207573,2882.1313175154437,135906.23492959118,2329,11,763.4,35,5,16,31.551876472568164,0.6526785714285714,42.10069444444445,1031.597222222223,29.474206349206373,0
4743,4,1,0,41,0.024390243902439025,0.0,1.0,41,900,600,300,0.6666666666666666,12,6,6,411.4238516177036,0.40538617886178857,0.2956155569043024,0.23739208515832178,130751.61944038632,2560.374015978252,133311.99345636458,2330,0,745.7560975609756,36,5,18,33.79349262277031,0.6278935185185186,44.31306306306306,1022.7477477477477,28.409659659659656,4
4744,4,0,0,41,0.0,0.0,1.0,41,950,500,450,0.5263157894736842,14,5,9,414.8459418049378,0.40459857723577236,0.29557636613011895,0.24026163627670286,130895.62694028477,2660.303927238038,133555.9308675228,2331,1,746.7560975609756,36,5,18,33.55938887054767,0.6293402777777779,44.17229729729729,1023.3108108108099,28.425300300300275,0
4745,4,0,0,41,0.0,0.0,1.0,41,650,400,250,0.6153846153846154,9,4,5,419.2378418036791,0.4044207317073171,0.2995703412059414,0.2440812377312841,131097.37059694825,2792.195743040335,133889.56633998858,2332,2,747.7560975609756,36,5,18,33.24169782274027,0.6313657407407407,43.97522522522522,1024.0990990990988,28.447197197197188,0
4746,4,0,0,41,0.0,0.0,1.0,41,950,700,250,0.7368421052631579,12,7,5,414.72432259814445,0.4035569105691057,0.29620715130409336,0.24202182048934817,131187.67463306023,2681.3438990843383,133869.01853214458,2333,3,748.7560975609756,37,4,18,33.265434906703774,0.6303490990990991,43.887061403508774,1024.4517543859654,27.68788525367474,0
4747,4,0,0,41,0.0,0.0,1.0,41,1250,1000,250,0.8,15,10,5,413.0186106360609,0.40342987804878044,0.29707746614607755,0.2422860167559089,131387.44882758908,2653.242600584123,134040.6914281732,2334,4,749.7560975609756,35,6,18,33.10613757808384,0.6363095238095238,43.692129629629626,1025.2314814814808,29.292328042328023,0
4748,4,0,0,41,0.0,0.0,1.0,41,1100,700,400,0.6363636363636364,15,7,8,413.1107077842158,0.40284552845528454,0.29844544186161714,0.24328240552103017,131535.81700370798,2667.7708922753745,134203.58789598336,2335,5,750.7560975609756,35,6,18,32.953124412350974,0.6377976190476191,43.5474537037037,1025.810185185185,29.30886243386243,0
4749,4,0,0,41,0.0,0.0,1.0,41,1250,900,350,0.72,16,9,7,409.9531592745973,0.40228658536585366,0.30077082634124297,0.24198699801122384,131624.87809713656,2592.006923010983,134216.88502014754,2336,6,751.7560975609756,35,6,16,32.94373637115572,0.6386904761904761,43.46064814814815,1026.157407407408,29.318783068783087,0
4750,4,0,0,41,0.0,0.0,1.0,41,850,700,150,0.8235294117647058,10,7,3,410.66939424894167,0.40177845528455286,0.302500625637669,0.24297710857864363,131713.96933138304,2618.179199888566,134332.1485312716,2337,7,752.7560975609756,35,6,16,32.83499173149923,0.6395833333333332,43.3738425925926,1026.504629629631,29.32870370370374,0
4751,4,0,0,41,0.0,0.0,1.0,41,900,800,100,0.8888888888888888,10,8,2,414.9522922230029,0.40175304878048784,0.305188770038771,0.24570272576889446,131743.67310742466,2733.467828360778,134477.14093578543,2338,8,753.7560975609756,35,6,16,32.69494550920706,0.6398809523809523,43.34490740740741,1026.6203703703711,29.332010582010604,0
4752,4,0,0,41,0.0,0.0,1.0,41,950,800,150,0.8421052631578947,11,8,3,412.7770112380973,0.4008638211382114,0.2972818327174722,0.24545970642202894,131905.8987196656,2689.5445276357477,134595.44324730133,2339,9,754.7560975609756,36,5,17,32.58628407512974,0.6394675925925926,43.18693693693694,1027.2522522522522,28.534784784784783,0
4753,4,0,1,40,0.0,0.024390243902439025,0.975609756097561,41,1000,700,300,0.7,13,7,6,412.75676487145836,0.4011686991869919,0.2975743401269635,0.24600950225029755,131992.6741564199,2696.173834307282,134688.8479907272,2340,10,755.7560975609756,36,5,17,32.498858447488594,0.6403356481481481,43.10247747747748,1027.59009009009,28.544169169169166,0
4754,4,0,0,40,0.0,0.0,1.0,40,850,600,250,0.7058823529411765,11,6,5,410.3968339152531,0.4005608974358974,0.2965240495233923,0.24497657966936015,132050.54029959018,2838.624731150075,134889.16503074026,2341,11,770.525,36,4,17,32.50086738979585,0.6409143518518519,43.046171171171174,1027.8153153153157,28.550425425425438,0
4755,4,0,0,40,0.0,0.0,1.0,40,500,200,300,0.4,8,2,6,409.97368795586635,0.40018696581196583,0.2961414174608388,0.24509821855593372,132108.41912436095,2832.195159686727,134940.61428404768,2342,12,771.525,36,4,18,32.45312557052617,0.6414930555555556,42.98986486486487,1028.0405405405415,28.55668168168171,0
4756,4,0,0,40,0.0,0.0,1.0,40,1050,500,550,0.47619047619047616,16,5,11,415.7060261018132,0.39935897435897433,0.29357690202517794,0.24966959555818974,132282.13168827622,2998.095857682016,135280.22754595825,2343,13,772.525,36,4,18,32.12985769020252,0.6432291666666665,42.82094594594595,1028.716216216217,28.57545045045047,0
4757,4,0,0,40,0.0,0.0,1.0,40,1050,600,450,0.5714285714285714,15,6,9,418.5476035648992,0.39909188034188037,0.2940623335109216,0.2519608248528916,132369.793169533,3080.6119430978797,135450.40511263086,2344,14,773.525,37,3,18,31.968011898419466,0.6421734234234234,42.73574561403509,1029.05701754386,27.81235182550973,0
4758,4,0,0,40,0.0,0.0,1.0,40,950,800,150,0.8421052631578947,11,8,3,419.7741316854884,0.39858440170940174,0.29767206477732744,0.25288831835686776,132398.00347222242,3115.454394621442,135513.45786684388,2345,15,774.525,36,4,18,31.907894736842096,0.6443865740740741,42.70833333333334,1029.1666666666683,28.587962962963008,0
4759,4,1,0,41,0.024390243902439025,0.0,1.0,41,1300,900,400,0.6923076923076923,17,9,8,415.4347209826883,0.4018038617886179,0.29741066859969245,0.25279644723627437,132774.93709926156,2831.863789465154,135606.80088872672,2346,0,756.609756097561,36,5,16,31.638348630536136,0.6481481481481481,42.34234234234235,1030.6306306306317,28.628628628628658,0
4760,4,0,0,41,0.0,0.0,1.0,41,900,500,400,0.5555555555555556,13,5,8,412.21434990954435,0.4013973577235772,0.2945353504167951,0.2511488725534432,132821.5187004656,2750.1871970221673,135571.70589748776,2347,1,757.609756097561,37,4,16,31.67426780838918,0.6466779279279279,42.29714912280702,1030.8114035087724,27.859767662399253,0
4761,4,0,0,41,0.0,0.0,1.0,41,550,300,250,0.5454545454545454,8,3,5,410.6111621263133,0.4013719512195122,0.2892338014289231,0.25092904352163614,132934.57031250015,2716.883680555571,135651.4539930557,2348,2,758.609756097561,37,4,16,31.60143097643098,0.647804054054054,42.18750000000001,1031.2500000000011,27.871621621621653,0
4762,4,0,0,41,0.0,0.0,1.0,41,1100,700,400,0.6363636363636364,15,7,8,411.479338683435,0.4010670731707317,0.2855128328092722,0.2522220910535793,133047.67001625506,2749.2734543321108,135796.94347058717,2349,3,759.609756097561,37,4,16,31.464887341906703,0.6489301801801801,42.077850877192986,1031.6885964912285,27.883475580844014,0
4763,4,0,0,41,0.0,0.0,1.0,41,850,500,350,0.5882352941176471,12,5,7,412.8403816578384,0.4004573170731707,0.2843671878035827,0.2542113926297286,133217.40974386354,2799.50525642506,136016.9150002886,2350,4,760.609756097561,37,4,16,31.258519206939283,0.6506193693693694,41.91337719298246,1032.3464912280706,27.901256519677585,0
4764,4,0,0,41,0.0,0.0,1.0,41,1500,1200,300,0.8,18,12,6,415.3279723291037,0.39997459349593495,0.2826290487426346,0.25616750814044587,133279.09412895388,2870.9071836876283,136150.0013126415,2351,5,761.609756097561,38,3,16,31.132091739955168,0.6493969298245614,41.85363247863248,1032.5854700854698,27.173301844354466,0
4765,4,0,0,41,0.0,0.0,1.0,41,1750,1400,350,0.8,21,14,7,419.2437057223958,0.39913617886178865,0.28550888053093937,0.25935172044976634,133389.4359179817,2984.536283694945,136373.97220167663,2352,6,762.609756097561,38,3,16,30.91969179853139,0.6504934210526315,41.746794871794876,1033.0128205128212,27.184547908232137,0
4766,4,0,0,41,0.0,0.0,1.0,41,650,400,250,0.6153846153846154,9,4,5,416.26902830344,0.3991869918699187,0.2830135860039189,0.2578947964588451,133444.62393390693,2909.7727874570955,136354.39672136403,2353,7,763.609756097561,38,3,16,30.94087133354014,0.6510416666666665,41.693376068376075,1033.226495726497,27.190170940170972,0
4767,4,1,1,41,0.023809523809523808,0.023809523809523808,0.9761904761904762,42,1150,800,350,0.6956521739130435,15,8,7,407.08821732628047,0.40224545102593884,0.2825869215441825,0.254444369682678,133771.38658479083,2491.3624730876813,136262.7490578785,2354,0,746.4047619047619,35,7,16,30.849090027597516,0.6601190476190476,41.37731481481482,1034.490740740741,29.556878306878318,0
4768,4,0,0,41,0.0,0.0,1.0,41,1250,1000,250,0.8,15,10,5,409.82428348347037,0.3980182926829268,0.28840719809637094,0.25569471599946975,133705.05640775926,2759.1157880853966,136464.17219584464,2355,9,765.609756097561,36,5,16,30.845083841463413,0.6574074074074073,41.44144144144145,1034.2342342342354,28.72872872872876,0
4769,4,0,0,41,0.0,0.0,1.0,41,550,300,250,0.5454545454545454,8,3,5,412.27245485550105,0.3976880081300813,0.29308651022499776,0.25762821566684585,133763.29665814465,2829.3845365635952,136592.68119470825,2356,10,766.609756097561,36,5,16,30.72315661513898,0.6579861111111112,41.38513513513514,1034.4594594594598,28.734984984984994,0
4770,4,0,0,41,0.0,0.0,1.0,41,1200,800,400,0.6666666666666666,16,8,8,409.35345446710755,0.3970782520325203,0.28967548573790847,0.25693461503786513,133925.8233302553,2764.5996845182976,136690.4230147736,2357,11,767.609756097561,37,4,16,30.635151836158194,0.6576576576576577,41.22807017543859,1035.0877192982443,27.975343764817413,0
4771,4,0,0,41,0.0,0.0,1.0,41,450,200,250,0.4444444444444444,7,2,5,409.35345446710755,0.3970782520325203,0.28967548573790847,0.25693461503786513,133925.8233302553,2764.5996845182976,136690.4230147736,2358,12,768.609756097561,37,4,16,30.635151836158194,0.6576576576576577,41.22807017543859,1035.0877192982443,27.975343764817413,0
4772,4,0,0,41,0.0,0.0,1.0,41,1250,900,350,0.72,16,9,7,406.12635466372024,0.39667174796747967,0.2828132061098274,0.2558948245362798,134067.7314774737,2689.6878125961643,136757.41929006984,2359,13,769.609756097561,37,4,16,30.57603229221809,0.6590653153153154,41.091008771929815,1035.6359649122794,27.99016121384539,0
4773,4,0,0,41,0.0,0.0,1.0,41,1150,900,250,0.782608695652174,14,9,5,407.53559161034656,0.3958079268292683,0.28902348699711733,0.25797849138040085,134238.12044330942,2741.3623663050103,136979.48280961445,2360,14,770.609756097561,37,4,18,30.368369308362425,0.6607545045045045,40.926535087719294,1036.2938596491224,28.007942152678982,0
4774,4,0,0,41,0.0,0.0,1.0,41,1600,1300,300,0.8125,19,13,6,405.4319480701307,0.39527439024390243,0.2862787284097079,0.25748112722987876,134356.87413251516,2694.513843231793,137051.38797574697,2361,15,771.609756097561,38,3,19,30.30365485023358,0.6600877192982456,40.81196581196581,1036.7521367521367,27.282950967161494,0
4775,4,0,0,41,0.0,0.0,1.0,41,1150,800,350,0.6956521739130435,15,8,7,409.45282349938776,0.39496951219512194,0.28649044550101976,0.2608395242215874,134469.7387695315,2811.8028428819744,137281.54161241348,2362,16,772.609756097561,39,2,19,30.086141240668212,0.6594551282051281,40.703125000000014,1037.187500000002,26.594551282051334,0
4776,4,0,0,41,0.0,0.0,1.0,41,1000,600,400,0.6,14,6,8,409.1762671374761,0.39502032520325203,0.2840230310125167,0.2610497401936022,134523.7643771704,2808.7863498264146,137332.5507269968,2363,17,773.609756097561,39,2,19,30.03909780098404,0.6599893162393162,40.65104166666668,1037.3958333333353,26.59989316239321,0
4777,4,0,0,41,0.0,0.0,1.0,41,900,700,200,0.7777777777777778,11,7,4,408.0724519610581,0.39504573170731705,0.2831183386560612,0.2609684453839405,134610.82845721874,2786.205016503767,137397.03347372252,2364,18,774.609756097561,35,6,19,29.980388876496406,0.668452380952381,40.567129629629626,1037.731481481481,29.649470899470888,0
4778,4,0,0,41,0.0,0.0,1.0,41,1300,900,400,0.6923076923076923,17,9,8,404.53893104074945,0.39410569105691057,0.27820163271566556,0.2603672408226679,134843.02873397042,2709.850940467489,137552.87967443792,2365,19,775.609756097561,36,5,17,29.839350898117026,0.6686921296296298,40.343468468468465,1038.6261261261259,28.85072572572572,0
4779,4,0,0,41,0.0,0.0,1.0,41,800,500,300,0.625,11,5,6,405.4242388884849,0.393140243902439,0.2834903316523414,0.2619926384077688,134989.27136596054,2745.584520331141,137734.85588629168,2366,20,776.609756097561,36,5,17,29.66989055049848,0.670138888888889,40.2027027027027,1039.1891891891892,28.866366366366364,0
4780,4,0,0,41,0.0,0.0,1.0,41,900,500,400,0.5555555555555556,13,5,8,402.88709505134807,0.3928099593495935,0.2787992495309568,0.260774746656658,135047.79061155755,2681.8024105186305,137729.59302207618,2367,21,777.609756097561,36,5,17,29.677230046948353,0.6707175925925927,40.1463963963964,1039.4144144144148,28.872622622622632,0
4781,4,0,0,41,0.0,0.0,1.0,41,500,300,200,0.6,7,3,4,403.8362576403148,0.3926321138211382,0.27489413635607174,0.2620253103860172,135135.5932579538,2714.530451059157,137850.12370901296,2368,22,778.609756097561,36,5,18,29.564695476370993,0.6715856481481483,40.06193693693693,1039.7522522522515,28.882007007006987,0
4782,4,0,0,41,0.0,0.0,1.0,41,1050,600,450,0.5714285714285714,15,6,9,402.72874450718666,0.392505081300813,0.27333866713139354,0.2621568296696888,135252.70783875088,2694.0306438194925,137946.73848257036,2369,23,779.609756097561,36,5,18,29.47633611201328,0.6727430555555556,39.94932432432432,1040.2027027027025,28.894519519519513,0
4783,4,0,0,41,0.0,0.0,1.0,41,950,800,150,0.8421052631578947,11,8,3,405.16947216455065,0.39214939024390244,0.2751010430333767,0.2641750708065124,135311.28415155012,2764.8003155182087,138076.08446706831,2370,24,780.609756097561,36,5,19,29.35427715842262,0.6733217592592593,39.89301801801801,1040.4279279279272,28.900775775775756,0
4784,4,0,0,41,0.0,0.0,1.0,41,1250,1000,250,0.8,15,10,5,406.3696640584871,0.39186991869918697,0.270923910250481,0.26565157377707654,135405.34106648163,2804.92459218217,138210.2656586638,2371,25,781.609756097561,37,4,19,29.22899985953082,0.6722972972972975,39.80263157894735,1040.7894736842077,28.129445234708317,0
4785,4,0,0,41,0.0,0.0,1.0,41,1550,1100,450,0.7096774193548387,20,11,9,404.4800000000004,0.3914380081300813,0.2677073170731712,0.26610526315789473,135633.68055555545,2772.799322868567,138406.47987842403,2372,26,782.609756097561,34,7,19,29.050000000000004,0.6807598039215688,39.58333333333333,1041.6666666666658,30.63725490196076,0
4786,4,0,0,41,0.0,0.0,1.0,41,1200,900,300,0.75,15,9,6,403.2174144265158,0.3914380081300813,0.26815611316894783,0.2655045593413424,135664.68431122453,2740.4726473922956,138405.15695861683,2373,27,783.609756097561,34,7,19,29.051917876052254,0.6810661764705882,39.55357142857143,1041.7857142857147,30.64075630252102,0
4787,4,0,0,41,0.0,0.0,1.0,41,1150,800,350,0.6956521739130435,15,8,7,405.75003074036863,0.3909806910569105,0.2683901881851487,0.26810124672693764,135788.7347647391,2819.2566609977202,138607.99142573684,2374,28,784.609756097561,34,7,19,28.86207881210737,0.6822916666666667,39.4345238095238,1042.261904761904,30.65476190476188,0
4788,4,0,0,41,0.0,0.0,1.0,41,1000,800,200,0.8,12,8,4,404.44158789712503,0.3908536585365854,0.26825368527783056,0.2674690742920866,135819.75623582766,2786.2315759637204,138605.9878117914,2375,29,785.609756097561,34,7,19,28.865206715395168,0.6825980392156863,39.404761904761905,1042.3809523809525,30.658263305322134,0
4789,4,0,0,41,0.0,0.0,1.0,41,650,300,350,0.46153846153846156,10,3,7,402.0601855203985,0.3901168699186992,0.2678443635675083,0.2665893387564853,135912.84190759636,2729.028486394558,138641.87039399092,2376,30,786.609756097561,34,7,17,28.8343893899608,0.6835171568627451,39.31547619047619,1042.7380952380952,30.668767507002798,0
4790,4,0,0,41,0.0,0.0,1.0,41,1250,1000,250,0.8,15,10,5,400.00184482804724,0.3898119918699187,0.266402376385366,0.2656873512159608,135974.91673752843,2678.0435090703095,138652.96024659873,2377,31,787.609756097561,34,7,17,28.826142373397253,0.6841299019607843,39.25595238095239,1042.9761904761913,30.675770308123273,0
4791,4,0,0,41,0.0,0.0,1.0,41,1150,800,350,0.6956521739130435,15,8,7,396.17874787486767,0.3893038617886179,0.264839942313968,0.2645377979325846,136162.06578199822,2588.903345913485,138750.9691279117,2378,32,788.609756097561,36,5,17,28.739345058265002,0.681712962962963,39.07657657657658,1043.6936936936938,28.991491491491495,0
4792,4,0,0,41,0.0,0.0,1.0,41,850,300,550,0.35294117647058826,14,3,11,393.59639905088756,0.38889735772357725,0.26463019970005575,0.2632495396249442,136220.83865960548,2523.2063144225253,138744.04497402802,2379,33,789.609756097561,36,5,17,28.74820208558073,0.6822916666666667,39.02027027027027,1043.9189189189183,28.99774774774773,0
4793,4,0,0,41,0.0,0.0,1.0,41,1050,900,150,0.8571428571428571,12,9,3,394.20409484466944,0.38884654471544716,0.2683216218420408,0.2638748132350129,136250.22985400932,2542.0797063955724,138792.3095604049,2380,34,790.609756097561,36,5,17,28.703079495200083,0.6825810185185186,38.99211711711711,1044.0315315315308,29.000875875875856,0
4794,4,0,0,41,0.0,0.0,1.0,41,750,500,250,0.6666666666666666,10,5,5,393.5287460330345,0.38838922764227646,0.26967633999032015,0.2636415125157725,136279.62421881323,2525.989925736531,138805.61414454976,2381,35,791.609756097561,36,5,17,28.691445570894444,0.6828703703703705,38.963963963963955,1044.1441441441427,29.004004004003964,0
4795,4,0,0,41,0.0,0.0,1.0,41,1050,700,350,0.6666666666666666,14,7,7,392.9693045116733,0.3879827235772358,0.26925504054523075,0.2641437151195855,136397.23338203062,2519.985187890585,138917.2185699212,2382,36,792.609756097561,36,5,17,28.589011067989073,0.6840277777777779,38.85135135135135,1044.5945945945941,29.016516516516504,0
4796,4,0,0,41,0.0,0.0,1.0,41,1150,800,350,0.6956521739130435,15,8,7,396.0214769430288,0.38701727642276423,0.27367099050716925,0.26775436055805796,136603.17147806587,2619.5579447690952,139222.72942283496,2383,37,793.609756097561,36,5,18,28.30442744802327,0.6860532407407407,38.65427927927928,1045.3828828828828,29.03841341341341,0
4797,4,0,0,41,0.0,0.0,1.0,41,1250,1200,50,0.96,13,12,1,391.58108601450783,0.3863058943089431,0.27130502380721033,0.265640142134166,136720.92013888885,2507.566730581929,139228.48686947077,2384,38,794.609756097561,34,7,18,28.303452855245688,0.6914828431372549,38.541666666666664,1045.833333333333,30.75980392156862,0
4798,4,0,0,41,0.0,0.0,1.0,41,1100,700,400,0.6363636363636364,15,7,8,389.98118763173807,0.3853404471544715,0.2686229183375002,0.26549532595626235,136845.45245181414,2473.4304138322077,139318.88286564636,2385,39,795.609756097561,34,7,20,28.221593279478135,0.6927083333333333,38.42261904761905,1046.3095238095243,30.77380952380954,0
4799,4,0,0,41,0.0,0.0,1.0,41,1350,1000,350,0.7407407407407407,17,10,7,390.1363078053014,0.38470528455284553,0.2690499371728623,0.2665476732348109,136970.04145408163,2487.3972505668985,139457.43870464852,2386,40,796.609756097561,34,7,17,28.093843587702345,0.6939338235294118,38.30357142857143,1046.7857142857142,30.78781512605042,0
4800,4,0,0,41,0.0,0.0,1.0,41,850,700,150,0.8235294117647058,10,7,3,390.1363078053014,0.38437499999999997,0.2690499371728623,0.2665476732348109,136970.04145408163,2487.3972505668985,139457.43870464852,2387,41,797.609756097561,34,7,17,28.093843587702345,0.6939338235294118,38.30357142857143,1046.7857142857142,30.78781512605042,0
4801,4,0,0,41,0.0,0.0,1.0,41,1400,1100,300,0.7857142857142857,17,11,6,381.393472107123,0.3840701219512195,0.23976312400720734,0.23513553314911104,133263.00643272005,1992.3673743867093,135255.37380710675,2388,42,798.609756097561,35,6,17,32.024273250383004,0.6550595238095239,41.86921296296295,1032.5231481481458,29.50066137566131,6
4802,4,0,0,41,0.0,0.0,1.0,41,950,600,350,0.631578947368421,13,6,7,382.61392634136143,0.38320630081300816,0.2362811526065547,0.23647809517540205,133355.88121905687,2004.7634627871125,135360.644681844,2389,43,799.609756097561,36,5,17,31.899394897514178,0.6539351851851851,41.77927927927928,1032.8828828828828,28.691191191191187,0
4803,4,0,0,41,0.0,0.0,1.0,41,1100,900,200,0.8181818181818182,13,9,4,369.1545425881715,0.3822916666666667,0.2315272548698637,0.2311093564942755,133831.25964506174,1680.9849404584738,135512.2445855202,2390,44,800.609756097561,35,6,18,31.77013422818791,0.6607142857142857,41.31944444444444,1034.7222222222224,29.563492063492067,2
4804,4,0,0,41,0.0,0.0,1.0,41,1250,1000,250,0.8,15,10,5,370.35707623852494,0.3826473577235772,0.23105972814898634,0.23280703070650766,133981.00090288484,1724.1623531807145,135705.16325606557,2391,45,801.609756097561,35,6,19,31.588992919694423,0.662202380952381,41.17476851851851,1035.3009259259252,29.580026455026434,0
4805,4,0,0,41,0.0,0.0,1.0,41,1400,1100,300,0.7857142857142857,17,11,6,371.0432707085978,0.38328252032520327,0.23020297369586062,0.23463705386871514,134200.50276205246,1758.8386951140205,135959.34145716648,2392,46,802.609756097561,36,5,19,31.35143824946563,0.662326388888889,40.96283783783783,1036.1486486486476,28.78190690690688,0
4806,4,0,0,41,0.0,0.0,1.0,41,700,500,200,0.7142857142857143,9,5,4,371.25417566417525,0.3830030487804878,0.23275019015538456,0.23514467850222995,134258.8508060424,1768.8317963233421,136027.68260236573,2393,47,803.609756097561,36,5,19,31.287578325908232,0.6629050925925927,40.90653153153153,1036.373873873873,28.788163163163137,0
4807,4,0,0,41,0.0,0.0,1.0,41,450,400,50,0.8888888888888888,5,4,1,374.2489301175985,0.3827743902439025,0.22951097640457174,0.2376093552181112,134346.39665002847,1855.7990422855348,136202.195692314,2394,48,804.609756097561,36,5,19,31.12236584835977,0.6637731481481481,40.822072072072075,1036.711711711712,28.797547547547556,0
4808,4,0,0,41,0.0,0.0,1.0,41,900,800,100,0.8888888888888888,10,8,2,371.6705016495299,0.38343495934959354,0.2282337797859466,0.23653860744233043,134433.97102761548,1793.0282901144446,136226.99931772993,2395,49,805.609756097561,36,5,19,31.101594454700127,0.6646412037037037,40.737612612612615,1037.0495495495497,28.80693193193194,0
4809,4,0,0,41,0.0,0.0,1.0,41,700,400,300,0.5714285714285714,10,4,6,372.38273483174777,0.383130081300813,0.22940757471845696,0.2373714443276976,134492.36979800757,1816.527295876969,136308.89709388453,2396,50,806.609756097561,36,5,19,31.024725871240914,0.6652199074074073,40.68130630630631,1037.2747747747756,28.81318818818821,0
4810,4,0,0,41,0.0,0.0,1.0,41,1150,900,250,0.782608695652174,14,9,5,376.67806034888577,0.3829014227642276,0.2305182996771462,0.24110714611759082,134643.431122449,1943.4706579856172,136586.90178043462,2397,51,807.609756097561,34,7,20,30.76226389844766,0.6709558823529411,40.535714285714285,1037.857142857143,30.525210084033613,0
4811,4,0,1,40,0.0,0.024390243902439025,0.975609756097561,41,850,400,450,0.47058823529411764,13,4,9,378.7792665861175,0.38135162601626016,0.235731584998899,0.24364059921700582,134821.09917534716,2013.4874131944348,136834.5865885416,2398,52,808.609756097561,35,6,16,30.530132062855227,0.6705357142857142,40.36458333333333,1038.541666666666,29.67261904761903,0
4812,4,0,0,40,0.0,0.0,1.0,40,1000,400,600,0.4,16,4,12,382.5402261296971,0.3803952991452992,0.23238831615120303,0.24737601289720418,135014.34948979595,2329.6839569161048,137344.03344671204,2399,53,818.375,34,6,18,30.23935662466591,0.6746323529411764,40.17857142857143,1039.2857142857147,30.567226890756313,0
4813,4,0,0,40,0.0,0.0,1.0,40,1200,1000,200,0.8333333333333334,14,10,4,382.5031070163519,0.3804086538461538,0.23045631512653197,0.24798809454890863,135107.1588010203,2335.7816043083785,137442.94040532867,2400,54,819.375,34,6,19,30.147620138173217,0.6755514705882353,40.08928571428571,1039.6428571428564,30.577731092436952,0
4814,4,0,0,40,0.0,0.0,1.0,40,1200,900,300,0.75,15,9,6,378.3772221439891,0.3811832264957265,0.21712283044058744,0.2464387299007371,135272.23186728387,2236.786265432089,137509.01813271595,2401,55,820.375,35,5,19,30.0901201602136,0.675,39.93055555555555,1040.2777777777771,29.722222222222204,0
4815,4,0,0,40,0.0,0.0,1.0,40,1250,1200,50,0.96,13,12,1,380.40140069148083,0.38038194444444445,0.2257562277580074,0.2485878920797814,135392.661179698,2300.7115912208264,137693.37277091885,2402,56,821.375,35,5,19,29.917333926453136,0.6761904761904762,39.8148148148148,1040.740740740739,29.735449735449688,0
4816,4,0,0,40,0.0,0.0,1.0,40,1150,900,250,0.782608695652174,14,9,5,380.2307300132418,0.3799813034188034,0.22609248242293156,0.24913062359832863,135487.08917955105,2303.2709652219655,137790.36014477303,2403,57,822.375,36,4,19,29.82760951865873,0.6750578703703705,39.72409909909909,1041.1036036036026,28.919544544544515,0
4817,4,1,0,41,0.024390243902439025,0.0,1.0,41,600,200,400,0.3333333333333333,10,2,8,371.2420855709443,0.38368902439024394,0.21990493086496676,0.24527035807530084,135784.42650730864,1881.9372569320556,137666.3637642407,2404,0,803.2926829268292,35,6,20,29.76552378308346,0.680059523809524,39.4386574074074,1042.245370370369,29.778439153439116,0
4818,4,0,0,41,0.0,0.0,1.0,41,1000,600,400,0.6,14,6,8,370.8966376653407,0.38353658536585367,0.21515999346642856,0.24561953301185435,135868.39161796926,1878.6259232205127,137747.01754118977,2405,1,804.2926829268292,36,5,15,29.690987974364514,0.6788194444444444,39.358108108108105,1042.5675675675673,28.960210210210203,0
4819,4,0,0,41,0.0,0.0,1.0,41,850,700,150,0.8235294117647058,10,7,3,371.61730451770524,0.38328252032520327,0.21788161288028296,0.24629954348814814,135897.74476757154,1900.3907201119932,137798.13548768352,2406,2,805.2926829268292,36,5,15,29.643005004140118,0.6791087962962964,39.32995495495495,1042.6801801801794,28.963338338338318,0
4820,4,0,2,39,0.0,0.04878048780487805,0.9512195121951219,41,800,500,300,0.625,11,5,6,371.8092016561844,0.38292682926829263,0.2200020013588171,0.24703707501718647,135985.82323877924,1912.1560749939017,137897.97931377313,2407,3,806.2926829268292,36,5,15,29.5504030806881,0.6799768518518519,39.24549549549549,1043.0180180180175,28.972722722722708,0
4821,4,0,0,39,0.0,0.0,1.0,39,800,400,400,0.5,12,4,8,383.635537613075,0.3778115159694107,0.23001086310438845,0.25393018918198773,135850.78125,2623.437500000001,138474.21875,2408,62,842.8461538461538,34,5,19,29.37649880095924,0.6829044117647058,39.375,1042.5,30.66176470588235,0
4822,4,0,0,39,0.0,0.0,1.0,39,900,400,500,0.4444444444444444,14,4,10,380.2829382206377,0.3775865946918579,0.2292178901767945,0.2523695862736959,135943.87755102038,2539.427437641722,138483.3049886621,2409,63,843.8461538461538,34,5,16,29.371194824961947,0.6838235294117647,39.285714285714285,1042.8571428571427,30.67226890756302,0
4823,4,0,0,39,0.0,0.0,1.0,39,950,600,350,0.631578947368421,13,6,7,381.72659521795276,0.3772773279352227,0.2323085116967789,0.2537699868967908,136005.95946712018,2583.418367346935,138589.3778344671,2410,64,844.8461538461538,34,5,17,29.2717606330366,0.6844362745098038,39.226190476190474,1043.095238095238,30.679271708683473,0
4824,4,0,0,39,0.0,0.0,1.0,39,1100,700,400,0.6363636363636364,15,7,8,387.3108850265131,0.3772773279352227,0.2380616325570455,0.24833462628170527,134705.21541950098,2646.478174603157,137351.69359410414,2411,65,845.8461538461538,34,5,19,30.42455084097859,0.6715686274509804,40.47619047619047,1038.095238095237,30.532212885154028,3
4825,4,0,0,39,0.0,0.0,1.0,39,950,800,150,0.8421052631578947,11,8,3,385.33580330251016,0.3767150247413405,0.2360785282133595,0.2474888716056328,134767.01388888888,2586.1111111111063,137353.12499999997,2412,66,846.8461538461538,34,5,20,30.41399143927233,0.6721813725490196,40.416666666666664,1038.3333333333333,30.539215686274506,0
4826,4,0,0,39,0.0,0.0,1.0,39,800,500,300,0.625,11,5,6,381.66189111747866,0.37657444894287,0.23557416795239172,0.24575645756457562,134859.7381660997,2494.1645408163204,137353.90270691604,2413,67,847.8461538461538,34,5,15,30.41666666666667,0.6731004901960784,40.32738095238095,1038.6904761904757,30.549719887955167,0
4827,4,0,0,39,0.0,0.0,1.0,39,950,500,450,0.5263157894736842,14,5,9,379.42545670153686,0.3756185335132704,0.2279110891781304,0.24515209559938672,134983.42013888882,2443.2291666666583,137426.64930555547,2414,68,848.8461538461538,34,5,17,30.351176156108,0.6743259803921569,40.20833333333333,1039.166666666666,30.56372549019606,0
4828,4,0,0,39,0.0,0.0,1.0,39,950,400,550,0.42105263157894735,15,4,11,377.28786303399545,0.3753654970760234,0.2251100558281871,0.24418831224238763,135045.28238378663,2390.189200680247,137435.47158446687,2415,69,849.8461538461538,34,5,17,30.344939487649377,0.6749387254901962,40.14880952380951,1039.40476190476,30.570728291316474,0
4829,4,0,0,39,0.0,0.0,1.0,39,950,500,450,0.5263157894736842,14,5,9,377.0792725958334,0.37485942420152946,0.2306841226378824,0.2453121075703496,135230.95415249432,2398.557964852608,137629.51211734692,2416,70,850.8461538461538,34,5,17,30.165054748006572,0.6767769607843137,39.970238095238095,1040.1190476190475,30.591736694677866,0
4830,4,0,0,39,0.0,0.0,1.0,39,1050,800,250,0.7619047619047619,13,8,5,377.1728351456184,0.3746345029239766,0.22886001108579168,0.2466433880088363,135416.7534722222,2415.1041666666633,137831.85763888885,2417,71,851.8461538461538,34,5,18,29.977315185481718,0.6786151960784315,39.791666666666664,1040.8333333333333,30.612745098039213,0
4831,4,0,0,39,0.0,0.0,1.0,39,1050,500,550,0.47619047619047616,16,5,11,375.4199491925632,0.3740721997300945,0.22236882614241127,0.24592115772951045,135478.71492346935,2372.282454648521,137850.99737811787,2418,72,852.8461538461538,34,5,18,29.96116828663999,0.6792279411764706,39.732142857142854,1041.0714285714282,30.619747899159652,0
4832,4,0,0,39,0.0,0.0,1.0,39,1000,900,100,0.9,11,9,2,373.4400000000001,0.37457827260458837,0.2207179487179487,0.24568421052631578,135633.68055555547,2330.2969104308304,137963.9774659863,2419,73,853.8461538461538,33,6,19,29.858333333333334,0.6830808080808082,39.58333333333333,1041.666666666666,31.565656565656546,0
4833,4,0,0,39,0.0,0.0,1.0,39,800,500,300,0.625,11,5,6,374.61842871902917,0.3745220422852002,0.22221015869569216,0.24689968069528556,135697.5156790656,2366.958020953468,138064.47370001907,2420,74,854.8461538461538,33,6,20,29.764075119579715,0.6837121212121213,39.522058823529406,1041.9117647058813,31.5730837789661,0
4834,4,0,0,39,0.0,0.0,1.0,39,1250,800,450,0.64,17,8,9,374.7132181125261,0.3733412055780477,0.2210645321756437,0.24762516861282285,135793.2965235725,2376.7086276912573,138170.00515126376,2421,75,855.8461538461538,33,6,20,29.666250244953957,0.684659090909091,39.43014705882352,1042.2794117647047,31.584224598930447,0
4835,4,0,0,39,0.0,0.0,1.0,39,1200,1000,200,0.8333333333333334,14,10,4,375.2361035575269,0.37275078722447147,0.21646461815694407,0.24886079541473072,135921.05688016623,2400.497555026908,138321.55443519313,2422,76,856.8461538461538,33,6,16,29.52547792533397,0.6859217171717171,39.307598039215684,1042.7696078431368,31.5990790255496,0
4836,4,0,0,39,0.0,0.0,1.0,39,1050,600,450,0.5714285714285714,15,6,9,377.51376121091306,0.3721884840305893,0.2173416604153302,0.2508212038771334,135984.9595858563,2467.2387122741175,138452.19829813042,2423,77,857.8461538461538,33,6,17,29.40251341401325,0.6865530303030303,39.24632352941176,1043.0147058823522,31.606506238859158,0
4837,4,0,0,39,0.0,0.0,1.0,39,650,500,150,0.7692307692307693,8,5,3,377.8076071169995,0.372104138551507,0.22040806772063193,0.2513840593140673,136037.00573979592,2479.163123582762,138516.16886337867,2424,78,858.8461538461538,34,5,17,29.343071246528957,0.6847426470588236,39.19642857142857,1043.2142857142856,30.682773109243694,0
4838,4,0,0,39,0.0,0.0,1.0,39,750,600,150,0.8,9,6,3,376.32496357804365,0.37187921727395407,0.21372884578817275,0.2508356126054412,136099.10891439902,2443.498441043078,138542.6073554421,2425,79,859.8461538461538,34,5,17,29.31997528047157,0.6853553921568627,39.13690476190476,1043.4523809523805,30.689775910364133,0
4839,4,0,0,39,0.0,0.0,1.0,39,1100,600,500,0.5454545454545454,16,6,10,376.75601783051684,0.3711482231219074,0.21818702831361114,0.2520040824070021,136223.35778061204,2464.5939625850096,138687.95174319705,2426,80,860.8461538461538,34,5,18,29.185197856083924,0.6865808823529412,39.01785714285713,1043.9285714285697,30.70378151260499,0
4840,4,0,0,39,0.0,0.0,1.0,39,1200,1100,100,0.9166666666666666,13,11,2,374.353667277365,0.37092330184435446,0.21707764799420093,0.25105736768784737,136316.58163265296,2406.122448979581,138722.70408163255,2427,81,861.8461538461538,34,5,18,29.155266757865938,0.6875,38.92857142857142,1044.2857142857135,30.714285714285694,0
4841,4,0,0,39,0.0,0.0,1.0,39,750,400,350,0.5333333333333333,11,4,7,377.59758443519144,0.3709514170040486,0.21944627072832223,0.25390182401676664,136409.83737244896,2501.605017006805,138911.44238945577,2428,82,862.8461538461538,34,5,18,28.97792022792022,0.6884191176470589,38.839285714285715,1044.642857142857,30.724789915966387,0
4842,4,0,0,39,0.0,0.0,1.0,39,500,200,300,0.4,8,2,6,380.7528826415756,0.37024853801169594,0.22304011777695965,0.2567011370067397,136503.12500000003,2594.791666666667,139097.9166666667,2429,83,863.8461538461538,34,5,18,28.802830940988827,0.6893382352941176,38.75,1045.0000000000002,30.735294117647065,0
4843,4,0,0,39,0.0,0.0,1.0,39,750,500,250,0.6666666666666666,10,5,5,379.62168252731936,0.36991115609536657,0.21541187192831557,0.2564220953555885,136569.65509527168,2568.9604498885365,139138.61554516022,2430,84,864.8461538461538,35,4,18,28.76630956335585,0.6877976190476192,38.68634259259259,1045.2546296296289,29.86441798941797,0
4844,4,0,1,38,0.0,0.02564102564102564,0.9743589743589743,39,1100,600,500,0.5454545454545454,16,6,10,379.11215959334186,0.3694331983805668,0.22001617640798599,0.25696011717373174,136690.660432206,2564.2182945387576,139254.87872674476,2431,85,865.8461538461538,35,4,18,28.659495480538652,0.6889880952380952,38.570601851851855,1045.717592592593,29.877645502645517,0
4845,4,0,0,38,0.0,0.0,1.0,38,850,600,250,0.7058823529411765,11,6,5,382.98800850030347,0.36855440967283076,0.21930423736937987,0.2595807613168725,136689.79591836745,2870.110544217698,139559.90646258515,2432,86,874.2894736842105,34,4,18,28.55902777777778,0.6911764705882353,38.57142857142858,1045.7142857142865,30.756302521008426,0
4846,4,0,0,38,0.0,0.0,1.0,38,700,500,200,0.7142857142857143,9,5,4,383.9047253306536,0.3683469653864391,0.22272685228008493,0.2606703922591195,136752.96347859016,2900.0253195641253,139652.98879815429,2433,87,875.2894736842105,33,5,18,28.472344268697533,0.6941287878787878,38.51102941176472,1045.9558823529426,31.695632798574017,0
4847,4,0,0,38,0.0,0.0,1.0,38,1000,600,400,0.6,14,6,8,384.0783243015687,0.3684358700806069,0.22531950703747783,0.26126507207669286,136817.06142168894,2909.693537341429,139726.75495903037,2434,88,876.2894736842105,33,5,18,28.404176916168847,0.694760101010101,38.449754901960794,1046.200980392158,31.703060011883576,0
4848,4,0,0,38,0.0,0.0,1.0,38,1600,1300,300,0.8125,19,13,6,383.0420182648677,0.36793207681365575,0.22484424971807826,0.2615157376498989,136945.30236267298,2891.1610017781636,139836.46336445113,2435,89,877.2894736842105,33,5,21,28.30403836396988,0.6960227272727273,38.32720588235294,1046.691176470588,31.717914438502667,0
4849,4,0,0,38,0.0,0.0,1.0,38,800,600,200,0.75,10,6,4,384.2242712980875,0.36733937885253676,0.23016615960683362,0.2635297449850288,137105.6880166283,2935.8666138023946,140041.55463043068,2436,90,878.2894736842105,33,5,15,28.114029955534754,0.69760101010101,38.17401960784314,1047.303921568628,31.736482471776608,0
4850,4,0,0,38,0.0,0.0,1.0,38,600,300,300,0.5,9,3,6,382.0802332577014,0.36733937885253676,0.19710956283673475,0.2507349276892444,135543.27317226084,2757.6810860339583,138300.9542582948,2437,91,879.2894736842105,35,3,17,29.72344948316106,0.6776785714285714,39.67013888888889,1041.3194444444448,29.751984126984137,4
4851,4,0,0,38,0.0,0.0,1.0,38,1050,700,350,0.6666666666666666,14,7,7,383.3120181644179,0.3673690137505927,0.19949046242237745,0.25240398655427687,135665.59624002778,2800.5109796846173,138466.1072197124,2438,92,880.2894736842105,33,5,17,29.569437909265574,0.6833964646464648,39.55269607843137,1041.7892156862738,31.569370172311327,0
4852,4,0,0,38,0.0,0.0,1.0,38,300,200,100,0.6666666666666666,4,2,2,383.57421373614017,0.36762091038406824,0.20129628941796973,0.2528021678437722,135697.51567906563,2810.0135765090217,138507.52925557466,2439,93,881.2894736842105,33,5,17,29.530796675292084,0.6837121212121213,39.522058823529406,1041.9117647058815,31.573083778966108,0
4853,4,0,0,38,0.0,0.0,1.0,38,650,200,450,0.3076923076923077,11,2,9,383.74946569330706,0.36770981507823614,0.2000668416101401,0.2533699888397421,135761.3658208379,2819.670319108006,138581.0361399459,2440,94,882.2894736842105,33,5,18,29.46260583254938,0.6843434343434345,39.460784313725476,1042.156862745096,31.580510992275638,0
4854,4,0,0,38,0.0,0.0,1.0,38,750,500,250,0.6666666666666666,10,5,5,362.0973074446655,0.36770981507823614,0.13160752663587738,0.23026187893304406,134404.77639801957,2133.5215282850377,136538.2979263046,2441,95,883.2894736842105,36,2,19,31.378963944396173,0.6643518518518519,40.765765765765764,1036.9369369369365,28.803803803803792,4
4855,4,0,0,38,0.0,0.0,1.0,38,600,300,300,0.5,9,3,6,363.4773607972265,0.36733937885253676,0.13286473512772168,0.23150943934595108,134463.16882761125,2174.8635459783964,136638.03237358964,2442,96,884.2894736842105,36,2,19,31.28483532392327,0.6649305555555556,40.70945945945945,1037.1621621621612,28.81006006006003,0
4856,4,0,0,38,0.0,0.0,1.0,38,450,200,250,0.4444444444444444,7,2,5,365.6057084866681,0.367206021811285,0.1349730585284188,0.23305150040627673,134492.3697980074,2234.2356292102872,136726.60542721767,2443,97,885.2894736842105,36,2,19,31.200466833134307,0.6652199074074074,40.681306306306304,1037.2747747747742,28.81318818818817,0
4857,4,0,0,38,0.0,0.0,1.0,38,800,600,200,0.75,10,6,4,366.28441476750345,0.3675023707918445,0.1358063834284502,0.23385851096694474,134550.78125000015,2256.770833333348,136807.5520833335,2444,98,886.2894736842105,36,2,19,31.124497991967875,0.665798611111111,40.62500000000001,1037.5000000000011,28.819444444444475,0
4858,4,0,0,38,0.0,0.0,1.0,38,1050,700,350,0.6666666666666666,14,7,7,366.60426202413,0.3670282124229493,0.13029956878087723,0.23443846457684664,134609.20538359325,2269.6616802613617,136878.86706385462,2445,99,887.2894736842105,36,2,20,31.057831434255743,0.6663773148148147,40.5686936936937,1037.7252252252267,28.825700700700743,0
4859,4,0,0,38,0.0,0.0,1.0,38,550,100,450,0.18181818181818182,10,1,9,365.5988306675936,0.36690967283072545,0.13134482620786536,0.23417125936505978,134667.6421987867,2246.8665033276607,136914.50870211434,2446,100,888.2894736842105,36,2,20,31.025550612997726,0.6669560185185185,40.51238738738739,1037.950450450451,28.831956956956972,0
4860,4,0,0,38,0.0,0.0,1.0,38,800,300,500,0.375,13,3,10,364.4385617939486,0.3670133949739213,0.12859279898596543,0.2336157623516425,134696.86536198366,2217.746378134895,136914.61174011856,2447,101,889.2894736842105,36,2,20,31.026478990381126,0.6672453703703705,40.484234234234236,1038.0630630630635,28.835085085085097,0
4861,4,0,0,38,0.0,0.0,1.0,38,800,400,400,0.5,12,4,8,365.8470910464354,0.3668504030346136,0.13091099046020482,0.23470733001789065,134726.0916955807,2257.829746976706,136983.9214425574,2448,102,890.2894736842105,36,2,20,30.96074230755324,0.6675347222222222,40.45608108108108,1038.1756756756756,28.838213213213212,0
4862,4,0,0,38,0.0,0.0,1.0,38,1050,700,350,0.6666666666666666,14,7,7,362.3731332069866,0.3667614983404457,0.12455417520272527,0.2332287095302188,134843.0287339704,2172.698162689711,137015.7268966601,2449,103,891.2894736842105,36,2,17,30.934213379594496,0.6686921296296295,40.343468468468465,1038.6261261261257,28.850725725725713,0
4863,4,0,0,38,0.0,0.0,1.0,38,1200,1000,200,0.8333333333333334,14,10,4,361.87172538392053,0.3663614272166904,0.12391099700470676,0.2332820871185651,134901.51627556607,2163.408890309227,137064.9251658753,2450,104,892.2894736842105,36,2,17,30.88888888888888,0.6692708333333334,40.28716216216216,1038.8513513513512,28.856981981981978,0
4864,4,0,0,38,0.0,0.0,1.0,38,950,600,350,0.631578947368421,13,6,7,361.6964839487967,0.3664651493598862,0.13064928250404906,0.23373495475346623,134989.27136596065,2165.0289647755985,137154.30033073624,2451,105,893.2894736842105,36,2,17,30.80592580551943,0.6701388888888888,40.20270270270271,1039.18918918919,28.866366366366393,0
4865,4,0,0,38,0.0,0.0,1.0,38,850,600,250,0.7058823529411765,11,6,5,364.3365496096765,0.36584281650071127,0.12450971449420756,0.2362047068817792,135106.32253875516,2244.834276844434,137351.1568155996,2452,106,894.2894736842105,36,2,17,30.620622111496267,0.6712962962962962,40.0900900900901,1039.639639639641,28.87887887887892,0
4866,4,0,0,38,0.0,0.0,1.0,38,1100,900,200,0.8181818181818182,13,9,4,367.18306130985724,0.36476114272166904,0.1274470692160823,0.23863023020383775,135194.14420755222,2328.1999482590763,137522.3441558113,2453,107,895.2894736842105,36,2,17,30.45907778379353,0.6721643518518519,40.005630630630634,1039.9774774774783,28.888263263263283,0
4867,4,0,0,38,0.0,0.0,1.0,38,850,400,450,0.47058823529411764,13,4,9,365.86644498967553,0.3643610715979137,0.12343575482665137,0.23796778069891864,135223.42443795156,2294.7427156886774,137518.16715364024,2454,108,896.2894736842105,36,2,17,30.464125884221172,0.6724537037037036,39.977477477477485,1040.0900900900908,28.891391391391412,0
4868,4,0,0,38,0.0,0.0,1.0,38,1100,700,400,0.6363636363636364,15,7,8,359.7203866705337,0.3644351588430536,0.11218929282371404,0.22947856410875397,134520.7626698602,2078.5935509888914,136599.3562208491,2455,109,897.2894736842105,35,3,19,31.324728513518554,0.6675595238095238,40.65393518518518,1037.384259259259,29.639550264550255,2
4869,4,0,0,38,0.0,0.0,1.0,38,1100,900,200,0.8181818181818182,13,9,4,361.22327719885914,0.3633534850640114,0.11903280891491752,0.23158052703334997,134700.92438539522,2131.421869641636,136832.34625503686,2456,110,898.2894736842105,35,3,20,31.10586929051921,0.669345238095238,40.480324074074076,1038.0787037037037,29.659391534391535,0
4870,4,0,0,38,0.0,0.0,1.0,38,800,500,300,0.625,11,5,6,365.4742293221729,0.3633534850640114,0.10858042780292565,0.21910699979973963,132214.2874858275,2067.401334408487,134281.68882023598,2457,111,899.2894736842105,34,4,20,33.49008372882663,0.6467524509803922,42.88690476190475,1028.4523809523796,30.24859943977587,4
4871,4,1,0,39,0.02564102564102564,0.0,1.0,39,650,300,350,0.46153846153846156,10,3,7,357.6015087210809,0.3678025191183086,0.11116491422246821,0.21611569440100079,132517.14677640583,1677.6663237311157,134194.81310013696,2458,0,877.2051282051282,35,4,21,33.38766486810552,0.6476190476190478,42.59259259259258,1029.6296296296282,29.41798941798938,0
4872,4,1,2,38,0.025,0.05,0.95,40,550,200,350,0.36363636363636365,9,2,7,352.14902871645614,0.37275641025641026,0.11526108804894064,0.21461865571707303,132832.97444403844,1355.400586397184,134188.37503043562,2459,0,856.25,36,4,15,33.210663826378266,0.648726851851852,42.28603603603602,1030.8558558558543,28.63488488488484,0
4873,4,0,0,38,0.0,0.0,1.0,38,900,700,200,0.7777777777777778,11,7,4,366.52947071039904,0.3623162636320531,0.11616275148926647,0.22168679136032757,132546.94097490126,2116.4720239626017,134663.41299886385,2460,114,902.2894736842105,35,3,20,33.12785676819902,0.6479166666666668,42.5636574074074,1029.745370370369,29.42129629629626,0
4874,4,0,0,38,0.0,0.0,1.0,38,1150,800,350,0.6956521739130435,15,8,7,365.5041862006631,0.36196064485538165,0.1116189147323483,0.2219453114296248,132695.96220207453,2100.185935356625,134796.14813743116,2461,115,903.2894736842105,35,3,16,33.004287426046574,0.649404761904762,42.41898148148147,1030.3240740740723,29.437830687830637,0
4875,4,1,0,39,0.02564102564102564,0.0,1.0,39,750,400,350,0.5333333333333333,11,4,7,355.9096100860209,0.36771817363922626,0.10644902163295367,0.21809283866207582,133036.2050183627,1669.7727710818626,134705.97778944456,2462,0,881.1025641025641,36,3,18,32.90966233671723,0.6507523148148149,42.08896396396395,1031.644144144142,28.656781781781724,0
4876,4,0,0,39,0.0,0.0,1.0,39,1300,1200,100,0.9230769230769231,14,12,2,356.3504004914016,0.36715587044534415,0.11354552142159835,0.21938644199494137,133210.52629910308,1693.9248792711458,134904.45117837423,2463,1,882.1025641025641,36,3,19,32.723355514344924,0.652488425925926,41.920045045045036,1032.319819819819,28.67555055055053,0
4877,4,0,0,39,0.0,0.0,1.0,39,1150,700,450,0.6086956521739131,16,7,9,363.04610429691604,0.36715587044534415,0.10763474245681093,0.21439690249523086,131642.34459102261,1772.1220086166668,133414.46659963927,2464,2,883.1025641025641,33,6,16,34.129448292333414,0.6433080808080809,43.44362745098039,1026.2254901960778,31.09774212715387,3
4878,4,0,0,39,0.0,0.0,1.0,39,1100,800,300,0.7272727272727273,14,8,6,366.3277388166799,0.36642487629329734,0.11589731346207399,0.21687119915670144,131736.68368235766,1851.7602905132508,133588.4439728709,2465,3,884.1025641025641,33,6,16,33.94997711989177,0.6442550505050506,43.3517156862745,1026.5931372549012,31.108882947118218,0
4879,4,0,0,39,0.0,0.0,1.0,39,800,500,300,0.625,11,5,6,368.04759754195914,0.3657782276203329,0.12140992943218776,0.2183479075926368,131816.67375283438,1902.9620181405799,133719.63577097497,2466,4,885.1025641025641,34,5,16,33.825063760723395,0.6427696078431373,43.27380952380952,1026.9047619047612,30.203081232492977,0
4880,4,1,1,39,0.025,0.025,0.975,40,800,400,400,0.5,12,4,8,361.96815197844535,0.3702991452991453,0.12475230803872983,0.21635270026060233,132100.37964034636,1563.22605881344,133663.60569915982,2467,0,863.95,35,5,16,33.69501989041506,0.6434523809523809,42.99768518518518,1028.0092592592591,29.371693121693117,0
4881,4,0,0,39,0.0,0.0,1.0,39,650,600,50,0.9230769230769231,7,6,1,368.94661297664123,0.36639676113360325,0.1262144576165436,0.21958684620609736,131938.95266439897,1935.6859410430711,133874.63860544204,2468,6,887.1025641025641,34,5,16,33.6785438393202,0.6439950980392157,43.1547619047619,1027.3809523809514,30.217086834733863,0
4882,4,0,0,39,0.0,0.0,1.0,39,1200,700,500,0.5833333333333334,17,7,10,369.0319566094238,0.36591880341880345,0.12020455800858887,0.22034729691326163,132061.2882653061,1946.9671201814037,134008.2553854875,2469,7,888.1025641025641,34,5,16,33.55291097212571,0.6452205882352942,43.035714285714285,1027.8571428571427,30.231092436974784,0
4883,4,0,0,39,0.0,0.0,1.0,39,1000,800,200,0.8,12,8,4,371.71168452291124,0.3656376518218623,0.11482607227288089,0.22235117128734164,132130.12695312512,2022.8624131944591,134152.98936631958,2470,8,889.1025641025641,35,4,16,33.41459810874705,0.6437499999999999,42.96875000000001,1028.125000000001,29.375000000000025,0
4884,4,0,0,39,0.0,0.0,1.0,39,900,700,200,0.7777777777777778,11,7,4,370.3311949104593,0.3658906882591093,0.11496043906577325,0.22204878528841707,132219.3889853395,1992.9928626543183,134212.38184799382,2471,9,890.1025641025641,35,4,16,33.360060769750156,0.6446428571428571,42.88194444444444,1028.4722222222222,29.384920634920633,0
4885,4,0,0,39,0.0,0.0,1.0,39,800,200,600,0.25,14,2,12,366.8634238677728,0.36631241565452094,0.11400753859419921,0.22083836842304455,132368.2260186257,1912.2121216992473,134280.43814032493,2472,10,891.1025641025641,35,4,16,33.29923986803133,0.6461309523809524,42.73726851851852,1029.050925925926,29.401455026455032,0
4886,4,0,0,39,0.0,0.0,1.0,39,800,500,300,0.625,11,5,6,351.4975908310728,0.3663686459739091,0.04788442063506326,0.19764233786677513,129746.60572562342,1325.711968493652,131072.31769411708,2473,11,892.1025641025641,34,5,15,36.34489171924904,0.621936274509804,45.29761904761904,1018.8095238095225,29.964985994397722,6
4887,4,0,0,39,0.0,0.0,1.0,39,750,600,150,0.8,9,6,3,349.53524334956427,0.3672402159244264,0.043231230475711424,0.19699613023802615,129837.58680555546,1276.5624999999918,131114.14930555545,2474,12,893.1025641025641,34,5,16,36.30246661215589,0.6228553921568627,45.20833333333333,1019.1666666666658,29.975490196078407,0
4888,4,1,0,40,0.025,0.0,1.0,40,1000,800,200,0.8,12,8,4,342.48493097728186,0.3716880341880342,0.050088642956914065,0.19471638684212386,130178.65022170302,916.8452071791514,131095.49542888216,2475,0,871.75,37,3,19,36.13621915404177,0.6202139639639639,44.87390350877194,1020.5043859649138,27.581199620673345,0
4889,4,0,1,39,0.0,0.025,0.975,40,1400,1000,400,0.7142857142857143,18,10,8,339.3314177749431,0.3717013888888889,0.04764069729904241,0.19099981013825243,129787.30384589505,808.1819646429864,130595.48581053803,2476,1,872.75,37,3,15,36.61346802252591,0.6162725225225224,45.2576754385965,1018.9692982456153,27.539710763395007,2
4890,4,1,0,40,0.025,0.0,1.0,40,800,400,400,0.5,12,4,8,336.47156084423705,0.37334401709401704,0.0607554484492876,0.19024197729250011,129962.83512309169,745.7595971217909,130708.59472021348,2477,0,873.7,38,2,16,36.50832110924839,0.6162280701754386,45.08547008547009,1019.6581196581209,26.83310841205581,0
4891,4,0,0,40,0.0,0.0,1.0,40,1050,900,150,0.8571428571428571,12,9,3,337.4638827934232,0.3725560897435898,0.05951508169250097,0.19133641050543967,130071.7957849368,778.9066494995955,130850.70243443639,2478,1,874.7,38,2,16,36.37258239072754,0.6173245614035088,44.97863247863248,1020.08547008547,26.84435447593342,0
4892,4,0,0,40,0.0,0.0,1.0,40,1200,1000,200,0.8333333333333334,14,10,4,336.3137136688469,0.37172809829059833,0.06154208542713624,0.1912183686288586,130180.80210387893,756.3178007889486,130937.11990466788,2479,2,875.7,38,2,17,36.29148345896149,0.618421052631579,44.87179487179487,1020.5128205128198,26.855600539811046,0
4893,4,0,0,40,0.0,0.0,1.0,40,1350,1100,250,0.8148148148148148,16,11,5,334.90802964694166,0.3715144230769231,0.06016435031987566,0.19096076709302975,130291.32806793279,727.1737568969804,131018.50182482977,2480,3,876.7,36,4,18,36.21543863519374,0.623263888888889,44.76351351351351,1020.9459459459458,28.359609609609606,0
4894,4,0,0,40,0.0,0.0,1.0,40,1150,900,250,0.782608695652174,14,9,5,335.33840070309475,0.37146100427350426,0.061025358324145795,0.19177296938064725,130406.32482144295,746.0496814381802,131152.37450288114,2481,4,877.7,36,4,19,36.08806504961411,0.6244212962962964,44.65090090090089,1021.3963963963954,28.372122122122093,0
4895,4,0,0,40,0.0,0.0,1.0,40,1000,800,200,0.8,12,8,4,320.174988612145,0.3723958333333333,0.027646690332010948,0.18540725761349014,130890.45606874142,381.57005624955514,131272.02612499098,2482,5,878.7,38,2,17,35.986549035985256,0.625548245614035,44.17735042735043,1023.2905982905991,26.928699955015766,5
4896,4,1,2,39,0.024390243902439025,0.04878048780487805,0.9512195121951219,41,1000,800,200,0.8,12,8,4,312.4929092322439,0.3760162601626016,0.02332095338042195,0.18188974485862586,131088.00048828125,-7.185872395833229,131080.8146158854,2483,0,858.2439024390244,39,2,17,35.984068253483876,0.625801282051282,43.984375,1024.0625,26.25801282051282,0
4897,4,0,0,39,0.0,0.0,1.0,39,850,300,550,0.35294117647058826,14,3,11,331.1467222481135,0.3652440395861449,0.03061319795838724,0.19198282642632894,130935.05333371826,871.7427477685599,131806.79608148683,2484,22,903.1025641025641,37,2,19,35.66084565388186,0.6278153153153152,44.13377192982457,1023.4649122807033,27.661213845424413,0
4898,4,3,2,40,0.07142857142857142,0.047619047619047616,0.9523809523809523,42,1250,900,350,0.72,16,9,7,310.4539323669351,0.3790287456445993,0.036224773006621636,0.183672498902803,131711.68456424904,-220.73967051811155,131490.94489373092,2485,0,839.5238095238095,38,4,14,35.40907750485706,0.6337719298245612,43.376068376068396,1026.4957264957295,27.013045434098146,0
4899,4,0,0,40,0.0,0.0,1.0,40,850,500,350,0.5882352941176471,12,5,7,326.12154071677634,0.3678151709401709,0.032512355848434815,0.19144659111710194,131414.71021274666,571.4335534859326,131986.1437662326,2486,1,882.5,36,4,22,35.30592165476843,0.634548611111111,43.66554054054055,1025.3378378378388,28.481606606606633,0
4900,4,1,1,40,0.024390243902439025,0.024390243902439025,0.975609756097561,41,750,300,450,0.4,12,3,9,318.54368700994974,0.3699186991869919,0.03266280579027181,0.18795282616892264,131609.25116381983,184.65922206834932,131793.9103858882,2487,0,861.9512195121952,37,4,15,35.3044632043884,0.634572072072072,43.475877192982466,1026.0964912280717,27.732337600758694,0
4901,4,0,0,40,0.0,0.0,1.0,40,550,400,150,0.7272727272727273,7,4,3,326.62603966378975,0.36821581196581193,0.041238471673255006,0.19217764659288095,131501.3239590943,590.3513310608046,132091.6752901551,2488,3,884.5,36,4,23,35.20577148294541,0.6354166666666665,43.58108108108109,1025.6756756756763,28.49099099099101,0
4902,4,1,1,40,0.024390243902439025,0.024390243902439025,0.975609756097561,41,700,300,400,0.42857142857142855,11,3,8,320.98514985934804,0.3725609756097561,0.03956413803163983,0.1900938619945022,131749.92696069958,257.9540098876738,132007.88097058726,2489,0,863.9024390243902,37,4,16,35.10037292178433,0.6359797297297296,43.33881578947369,1026.6447368421063,27.74715504978666,0
4903,4,0,1,39,0.0,0.025,0.975,40,1100,800,300,0.7272727272727273,14,8,6,327.4590912411426,0.3674011752136752,0.041517094017094136,0.19349855391522067,131665.51246537405,623.0138119421462,132288.52627731618,2490,5,886.5,37,3,17,35.01914173789174,0.6351351351351351,43.42105263157895,1026.3157894736848,27.73826458036986,0
4904,4,0,0,39,0.0,0.0,1.0,39,900,700,200,0.7777777777777778,11,7,4,334.373374626211,0.36726833108412055,0.03102788783489796,0.19729294071576825,131609.2511638197,1001.3258887350016,132610.5770525547,2491,6,852.0,37,2,17,34.89839353138135,0.634572072072072,43.47587719298246,1026.0964912280706,27.732337600758665,0
4905,4,0,0,39,0.0,0.0,1.0,39,1200,800,400,0.6666666666666666,16,8,8,332.84473897673763,0.3667622582096266,0.03382106874577229,0.19711734921184051,131749.9269606995,970.4540098876596,132720.38097058714,2492,7,853.0,37,2,19,34.79598330307236,0.6359797297297298,43.338815789473685,1026.6447368421057,27.747155049786638,0
4906,4,0,0,39,0.0,0.0,1.0,39,850,500,350,0.5882352941176471,12,5,7,331.77673911079086,0.3670996401259559,0.03631086834503816,0.19677575438711573,131806.21831957917,946.0474617189972,132752.26578129816,2493,8,854.0,37,2,20,34.76675120128137,0.6365427927927928,43.28399122807018,1026.86403508772,27.753082029397834,0
4907,4,1,1,39,0.025,0.025,0.975,40,1100,700,400,0.6363636363636364,15,7,8,328.5094414123148,0.37236912393162397,0.03377767383847896,0.19618804070936538,132068.34781804716,677.1398339907801,132745.48765203793,2494,0,833.625,38,2,20,34.587101132938365,0.6373355263157896,43.028846153846146,1027.8846153846139,27.049595141700365,0
4908,4,0,0,39,0.0,0.0,1.0,39,950,700,250,0.7368421052631579,12,7,5,335.7041176569253,0.36735267656320286,0.034739100921850286,0.19954798059708595,131890.67790089245,1055.2487303785613,132945.92663127102,2495,10,856.0,37,2,20,34.580931539994296,0.6373873873873874,43.201754385964904,1027.1929824561394,27.76197249881458,0
4909,4,1,0,40,0.025,0.0,1.0,40,850,400,450,0.47058823529411764,13,4,9,329.39475214644096,0.37394497863247866,0.039656337735260117,0.19614794621624332,131958.55391418323,702.7170092568123,132661.27092344005,2496,0,835.575,38,2,16,34.6747079823923,0.6362390350877192,43.135683760683776,1027.4572649572674,27.038349077822826,2
4910,4,0,0,40,0.0,0.0,1.0,40,1000,800,200,0.8,12,8,4,328.08619430241,0.3733974358974359,0.03689189189189168,0.19579337401918057,132040.89506172863,664.1589506173032,132705.05401234594,2497,1,836.575,38,2,17,34.62556306306307,0.6370614035087718,43.055555555555564,1027.7777777777796,27.04678362573104,0
4911,4,0,0,40,0.0,0.0,1.0,40,1300,1100,200,0.8461538461538461,15,11,4,328.5236427469425,0.37377136752136747,0.03724288385622265,0.196909625472109,132205.6544031705,686.5366352545914,132892.1910384251,2498,2,837.575,38,2,18,34.44880185608422,0.6387061403508771,42.89529914529915,1028.418803418804,27.06365272154747,0
4912,4,1,1,40,0.024390243902439025,0.024390243902439025,0.975609756097561,41,1050,800,250,0.7619047619047619,13,8,5,322.0419197975723,0.37883638211382115,0.044472008809345986,0.19429391967749624,132452.98603121142,331.2226057418633,132784.2086369533,2499,0,818.1219512195122,38,3,18,34.367323992388876,0.6411732456140349,42.65491452991454,1029.3803418803436,27.0889563652722,0
4913,4,1,2,39,0.024390243902439025,0.04878048780487805,0.9512195121951219,41,950,700,250,0.7368421052631579,12,7,5,319.16827361787824,0.37644817073170733,0.037359578989980546,0.19326521090931864,132590.4923661337,263.735709328692,132854.2280754624,2500,0,819.0975609756098,38,3,19,34.303466459197786,0.6425438596491226,42.52136752136754,1029.9145299145323,27.103013945119272,0
4914,4,0,0,39,0.0,0.0,1.0,39,1100,1000,100,0.9090909090909091,12,10,2,335.524266911439,0.36951754385964913,0.03924011211460576,0.20213291201737932,132398.00347222234,1084.5486111111177,133482.55208333346,2501,5,861.7179487179487,36,3,21,34.07557354925775,0.6443865740740742,42.708333333333336,1029.1666666666674,28.587962962962983,0
4915,4,0,0,39,0.0,0.0,1.0,39,1350,1000,350,0.7407407407407407,17,10,7,327.5120623819567,0.36828047683310844,0.036120596365512236,0.19837253791691226,132600.9011545329,885.6789221654095,133486.58007669833,2502,6,862.7179487179487,36,3,22,34.07819447481595,0.6464120370370371,42.51126126126126,1029.954954954955,28.60985985985986,0
4916,4,0,0,39,0.0,0.0,1.0,39,750,500,250,0.6666666666666666,10,5,5,327.6420866765777,0.3679430949167792,0.038134963684324674,0.19860451735126936,132629.8992193206,891.0273871844774,133520.92660650506,2503,7,863.7179487179487,36,3,14,34.045770926715505,0.646701388888889,42.483108108108105,1030.067567567567,28.612987987987974,0
4917,4,0,0,39,0.0,0.0,1.0,39,1100,900,200,0.8181818181818182,13,9,4,327.9662226914937,0.367380791722897,0.04508390145160024,0.19951809236746576,132765.0109288434,908.4878279855234,133673.49875682892,2504,8,864.7179487179487,37,2,14,33.90198868673972,0.6461148648648649,42.35197368421052,1030.5921052631572,27.853840682788032,0
4918,4,0,0,39,0.0,0.0,1.0,39,900,700,200,0.7777777777777778,11,7,4,344.5311834799533,0.36777440395861444,0.011162652246173632,0.1953183180934799,130066.7768568213,1164.2906952139076,131231.0675520352,2505,9,865.7179487179487,37,2,18,36.197440789709404,0.6190878378378378,44.983552631578945,1020.065789473684,27.56934566145092,8
4919,4,0,0,39,0.0,0.0,1.0,39,850,700,150,0.8235294117647058,10,7,3,343.5769852800087,0.3668747188484031,0.01512149281782782,0.19507492327134845,130126.29323727071,1141.6799072247677,131267.97314449548,2506,10,866.7179487179487,38,1,18,36.16143106457241,0.6178728070175439,44.92521367521367,1020.2991452991447,26.84997750787223,0
4920,4,0,0,39,0.0,0.0,1.0,39,1100,600,500,0.5454545454545454,16,6,10,377.9996231317375,0.3668747188484031,0.03280223362814172,0.19967580551425088,127257.91229032014,1820.7599164685141,129078.67220678864,2507,11,867.7179487179487,37,2,16,38.21723538361226,0.5906531531531531,47.752192982456144,1008.9912280701757,27.27003319108583,5
4921,4,4,2,41,0.09302325581395349,0.046511627906976744,0.9534883720930233,43,1350,1200,150,0.8888888888888888,15,12,3,349.9917583415645,0.38621262458471756,0.0520883147075919,0.18976397051761296,128306.84222961844,390.5010741811979,128697.34330379964,2508,0,787.9069767441861,38,5,16,37.84996836444164,0.5995065789473686,46.71474358974358,1013.1410256410238,26.661605937921678,0
4922,4,2,1,42,0.046511627906976744,0.023255813953488372,0.9767441860465116,43,950,600,350,0.631578947368421,13,6,7,347.83261399887425,0.3851744186046511,0.07046830200700871,0.1894909016561029,128496.33487654298,339.0432098765167,128835.3780864195,2509,0,788.8604651162791,38,5,17,37.711187214611876,0.6014254385964914,46.527777777777764,1013.8888888888871,26.681286549707554,0
4923,4,0,0,42,0.0,0.0,1.0,42,1000,800,200,0.8,12,8,4,354.5938989658298,0.3810491676345335,0.07976459537996439,0.19325963116088413,128513.93771701398,714.0516493055673,129227.98936631954,2510,1,808.6428571428571,39,3,17,37.52183069652763,0.5998931623931624,46.51041666666667,1013.9583333333342,25.998931623931647,0
4924,4,0,0,42,0.0,0.0,1.0,42,1150,900,250,0.782608695652174,14,9,5,355.04085113546694,0.382416279519938,0.07209340978974477,0.19440432439070174,128698.84033203128,738.6691623263902,129437.50949435767,2511,2,809.6428571428571,39,3,17,37.32173715908702,0.6017628205128205,46.328125,1014.6875000000002,26.01762820512821,0
4925,4,0,0,42,0.0,0.0,1.0,42,1050,800,250,0.7619047619047619,13,8,5,355.53878914895273,0.38270663956639567,0.0761196217840654,0.19519580283135446,128804.55864800338,759.0033637152696,129563.56201171865,2512,3,810.6428571428571,39,3,17,37.20123567641526,0.6028311965811967,46.22395833333333,1015.1041666666658,26.028311965811945,0
4926,4,3,2,43,0.06666666666666667,0.044444444444444446,0.9555555555555556,45,1200,1000,200,0.8333333333333334,14,10,4,340.0787255002871,0.39391835016835014,0.10485007958938408,0.1901660927715774,129529.39111118979,-189.3515996531759,129340.03951153661,2513,0,757.5333333333333,41,4,15,36.856280252087174,0.6069613821138211,45.510912698412696,1017.9563492063488,24.82820363917924,0
4927,4,1,1,43,0.022727272727272728,0.022727272727272728,0.9772727272727273,44,1000,700,300,0.7,13,7,6,343.01567953670656,0.39069106765327694,0.10438929391790719,0.19134350970479327,129433.96297053662,79.5757526934976,129513.53872323011,2514,0,775.7272727272727,40,4,15,36.8785162621925,0.6075520833333334,45.604674796747965,1017.5813008130074,25.439532520325184,0
4928,4,3,3,43,0.06521739130434782,0.06521739130434782,0.9347826086956522,46,1100,700,400,0.6363636363636364,15,7,8,329.733640365012,0.3989935587761675,0.1132468563208413,0.1858595085401497,129842.52467550019,-637.3103329126917,129205.2143425875,2515,0,742.9347826086956,42,4,15,36.80199023895545,0.6086309523809523,45.20348837209302,1019.1860465116273,24.26633444075303,0
4929,4,0,0,43,0.0,0.0,1.0,43,550,300,250,0.5454545454545454,8,3,5,349.2488334346729,0.3870662606127722,0.11007291693944077,0.19484933488425574,129439.78000217007,441.33843315971376,129881.11843532979,2516,3,795.7674418604652,39,4,16,36.71403163066844,0.6092414529914532,45.59895833333333,1017.6041666666661,26.092414529914514,0
4930,4,2,0,45,0.044444444444444446,0.0,1.0,45,1650,1200,450,0.7272727272727273,21,12,9,338.72200941725106,0.3928030303030303,0.13610894941634277,0.19174351634412642,130009.52695893154,-192.58235701689944,129816.94460191464,2517,0,761.3555555555556,41,4,19,36.403615434500644,0.6117886178861789,45.03968253968253,1019.8412698412684,24.874177313201667,0
4931,4,0,2,43,0.0,0.044444444444444446,0.9555555555555556,45,900,700,200,0.7777777777777778,11,7,4,339.0018067368157,0.39278198653198654,0.13437034156458671,0.19265041901076713,130161.33334120679,-175.01456601159708,129986.31877519519,2518,1,762.3555555555556,41,4,19,36.24262751960593,0.6133130081300813,44.89087301587301,1020.4365079365074,24.888695315524572,0
4932,4,0,0,43,0.0,0.0,1.0,43,1200,700,500,0.5833333333333334,17,7,10,344.90301054297447,0.38893503137689184,0.1322423941975135,0.1957309962035569,130107.0184434695,374.8604707845883,130481.87891425409,2519,2,781.8139534883721,40,3,19,36.1471511106684,0.6143229166666667,44.94410569105691,1020.2235772357724,25.50558943089431,0
4933,4,2,0,45,0.044444444444444446,0.0,1.0,45,1450,900,550,0.6206896551724138,20,9,11,332.6315404445582,0.3984217171717172,0.14759018185431794,0.19182069865292795,130729.84959556164,-302.8398481393201,130427.00974742231,2520,0,748.0222222222222,40,5,18,35.83010368014842,0.6205729166666667,44.33434959349594,1022.6626016260174,25.566565040650435,0
4934,4,0,0,45,0.0,0.0,1.0,45,850,400,450,0.47058823529411764,13,4,9,332.2541379053232,0.39806397306397306,0.14500088323617755,0.1917319749930719,130755.83316808782,-311.1666749289394,130444.66649315887,2521,1,749.0222222222222,40,5,18,35.813501921038686,0.6208333333333333,44.3089430894309,1022.7642276422768,25.56910569105692,0
4935,4,0,1,44,0.0,0.022222222222222223,0.9777777777777777,45,1300,900,400,0.6923076923076923,17,9,8,333.6481571716774,0.3980850168350168,0.14949013375711795,0.19305572680485358,130859.79327781101,-267.77422499832755,130592.01905281268,2522,2,750.0222222222222,40,5,19,35.672841345517156,0.621875,44.20731707317074,1023.1707317073185,25.57926829268296,0
4936,4,1,1,44,0.022222222222222223,0.022222222222222223,0.9777777777777777,45,1150,900,250,0.782608695652174,14,9,5,333.7552555994733,0.40185185185185185,0.15603331396474918,0.19470942199548943,131175.63952664402,-243.88818027210613,130931.75134637192,2523,0,701.0888888888888,41,4,20,35.35129769513848,0.6234756097560975,43.898809523809526,1024.4047619047622,24.985481997677127,0
4937,4,0,0,44,0.0,0.0,1.0,44,1050,800,250,0.7619047619047619,13,8,5,352.653392031535,0.39934593023255816,0.09540577448302767,0.2023848284318908,130542.57079101262,493.08728627646923,131035.65807728909,2524,1,717.8863636363636,37,7,18,35.50786838340486,0.6238738738738738,44.51754385964912,1021.9298245614035,27.61972498814604,6
4938,4,0,0,44,0.0,0.0,1.0,44,1000,700,300,0.7,13,7,6,350.1757379620126,0.39935694150810425,0.09333466597759199,0.20139965484391378,130626.6245984341,348.4549332486839,130975.07953168277,2525,2,718.8863636363636,37,7,18,35.486051521327184,0.6247184684684685,44.435307017543856,1022.2587719298242,27.628615457562816,0
4939,4,0,1,43,0.0,0.022727272727272728,0.9772727272727273,44,1150,600,550,0.5217391304347826,17,6,11,340.84205984284165,0.39933491895701195,0.03641345759334125,0.19364323619642765,130150.67737188368,72.16499307479371,130222.84236495847,2526,3,719.8863636363636,37,7,18,36.206479690522244,0.6199324324324325,44.901315789473685,1020.3947368421055,27.57823613086772,5
4940,4,0,1,42,0.0,0.023255813953488372,0.9767441860465116,43,900,400,500,0.4444444444444444,14,4,10,348.5595849977408,0.39594868955334067,0.03523670408715973,0.1977208065431772,130090.20580969503,468.83762985961454,130559.04343955465,2527,4,737.4883720930233,36,7,18,36.07094234095007,0.6212384259259258,44.9605855855856,1020.1576576576593,28.337712712712758,0
4941,4,0,0,42,0.0,0.0,1.0,42,1450,1400,50,0.9655172413793104,15,14,1,361.28085725367634,0.39121176926054974,0.03275632921650651,0.20491180668171824,130085.41907793208,999.4743441358047,131084.8934220679,2528,8,755.952380952381,35,7,18,35.751361470388034,0.6232142857142856,44.96527777777778,1020.1388888888887,29.146825396825392,0
4942,4,0,0,42,0.0,0.0,1.0,42,1100,800,300,0.7272727272727273,14,8,6,363.19481586063625,0.39080042586140146,0.04062386945933838,0.2067795404180085,130233.05047850228,1059.993757501721,131293.044236004,2529,9,756.952380952381,35,7,19,35.55261839966739,0.624702380952381,44.820601851851855,1020.717592592593,29.1633597883598,0
4943,4,1,1,42,0.023255813953488372,0.023255813953488372,0.9767441860465116,43,800,700,100,0.875,9,7,2,356.76736383504783,0.3930647840531561,0.048623695657188826,0.20448201466047947,130492.60567577722,711.1005853826936,131203.7062611599,2530,0,740.3255813953489,36,7,15,35.45340570924724,0.6252893518518519,44.56644144144145,1021.7342342342349,28.381506506506526,0
4944,4,1,0,43,0.023255813953488372,0.0,1.0,43,1250,900,350,0.72,16,9,7,359.69103314753386,0.39320321151716503,0.07191046908484844,0.20769699008766995,130780.4145995657,808.1084885561168,131588.52308812182,2531,0,741.3023255813954,36,7,17,35.087067415317996,0.6281828703703705,44.284909909909906,1022.8603603603598,28.41278778778777,0
4945,4,1,1,43,0.022727272727272728,0.022727272727272728,0.9772727272727273,44,1200,800,400,0.6666666666666666,16,8,8,352.5514812759929,0.3967032241014799,0.07903445590811775,0.20528870543128258,131103.44048168664,444.14242843951826,131547.58291012616,2532,0,725.4318181818181,37,7,18,34.942897930049966,0.6295045045045045,43.969298245614034,1024.1228070175437,27.678994784257938,0
4946,4,0,0,43,0.0,0.0,1.0,43,750,500,250,0.6666666666666666,10,5,5,361.7555398530275,0.3920035068290882,0.07797131331012275,0.210141828294177,131010.89000740592,878.783048250936,131889.67305565687,2533,2,743.3023255813954,36,7,18,34.80090199098007,0.6304976851851853,44.059684684684676,1023.7612612612602,28.437812812812783,0
4947,4,0,0,43,0.0,0.0,1.0,43,950,700,250,0.7368421052631579,12,7,5,369.93725680955015,0.39174972314507195,0.07212932052533905,0.21602626203166145,131212.72243527306,1108.094919243559,132320.81735451662,2534,3,744.3023255813954,36,7,18,34.3871363669671,0.6325231481481481,43.86261261261261,1024.549549549549,28.459709709709696,0
4948,4,0,0,43,0.0,0.0,1.0,43,1250,900,350,0.72,16,9,7,368.4975874148985,0.3926264304171281,0.07487237663074309,0.21583430120015493,131328.12500000012,1078.8701708465373,132406.99517084664,2535,4,745.3023255813954,35,8,18,34.30724932249323,0.6357142857142857,43.75000000000001,1025.000000000001,29.285714285714313,0
4949,4,0,1,42,0.0,0.023255813953488372,0.9767441860465116,43,1350,1100,250,0.8148148148148148,16,11,5,363.68694872330536,0.3930878552971577,0.07490156963620098,0.21367814096077514,131446.78605109756,961.0961076817714,132407.88215877934,2536,5,746.3023255813954,35,8,18,34.31057185854026,0.6369047619047619,43.63425925925927,1025.4629629629642,29.298941798941833,0
4950,4,1,1,42,0.023255813953488372,0.023255813953488372,0.9767441860465116,43,1400,900,500,0.6428571428571429,19,9,10,350.09401396426216,0.39590254706533773,0.07651304306806894,0.2079474082944354,131862.521701389,632.8559027777876,132495.37760416677,2537,0,739.8139534883721,37,6,15,34.23977349560514,0.6371058558558558,43.22916666666667,1027.0833333333342,27.75900900900903,0
4951,4,0,0,42,0.0,0.0,1.0,42,1300,1000,300,0.7692307692307693,16,10,6,355.0427840849139,0.39151422764227645,0.07428007395105429,0.2104863527494309,131790.2425229284,958.2349241133101,132748.47744704172,2538,7,758.4285714285714,36,6,16,34.185585289171605,0.6383101851851851,43.29954954954955,1026.8018018018024,28.52227227227229,0
4952,4,0,1,41,0.0,0.023809523809523808,0.9761904761904762,42,1050,900,150,0.8571428571428571,12,9,3,354.80772930132355,0.3917078010065815,0.08154239766081894,0.21066708927266084,131848.0642804967,956.1424600275928,132804.2067405243,2539,8,759.4285714285714,36,6,16,34.13331505847954,0.6388888888888888,43.24324324324324,1027.0270270270269,28.528528528528525,0
4953,4,0,0,41,0.0,0.0,1.0,41,800,400,400,0.5,12,4,8,358.26627440176026,0.3883638211382114,0.09333329668245405,0.21263522760982081,131832.80452942822,1246.249544538758,133079.05407396698,2540,9,778.3170731707318,35,6,16,34.05990551861452,0.6407738095238094,43.258101851851855,1026.967592592593,29.34193121693123,0
4954,4,0,0,41,0.0,0.0,1.0,41,1000,600,400,0.6,14,6,8,380.0678907786489,0.3883638211382114,0.021578855706952282,0.21704459549126343,130351.2158805942,1736.1952374828602,132087.41111807706,2541,10,779.3170731707318,35,6,19,35.0019126147569,0.625892857142857,44.704861111111114,1021.1805555555561,29.17658730158732,5
4955,4,0,0,41,0.0,0.0,1.0,41,1300,900,400,0.6923076923076923,17,9,8,379.79230152027037,0.38729674796747965,0.012793341935911418,0.21754877647757503,130469.4348663625,1710.2573891889801,132179.6922555515,2542,11,780.3170731707318,35,6,20,34.88881178958498,0.6270833333333332,44.58912037037038,1021.6435185185201,29.18981481481486,0
4956,4,0,0,41,0.0,0.0,1.0,41,950,600,350,0.631578947368421,13,6,7,378.3226388983298,0.38724593495934956,0.017644946551390595,0.21720343962758484,130558.13426997613,1678.6195773319805,132236.7538473081,2543,12,781.3170731707318,35,6,16,34.83625896564742,0.6279761904761904,44.502314814814824,1021.9907407407419,29.19973544973548,0
4957,4,0,0,41,0.0,0.0,1.0,41,1150,700,450,0.6086956521739131,16,7,9,399.76534644164144,0.38755081300813005,0.04906269383291639,0.22186308223587284,129232.53864198868,2147.675504895439,131380.21414688413,2544,13,782.3170731707318,33,8,18,35.64076875175767,0.6190025252525253,45.802696078431374,1016.7892156862747,30.811794414735598,7
4958,4,0,0,41,0.0,0.0,1.0,41,1150,700,450,0.6086956521739131,16,7,9,399.0214232160429,0.3880335365853658,0.050990036463429256,0.22215136379050113,129357.17520004325,2123.2568303056514,131480.4320303489,2545,14,783.3170731707318,33,8,18,35.532240091555245,0.6202651515151515,45.68014705882353,1017.2794117647059,30.82664884135472,0
4959,4,3,2,42,0.06818181818181818,0.045454545454545456,0.9545454545454546,44,1200,800,400,0.6666666666666666,16,8,8,377.51292584633217,0.3964389534883721,0.05479630744531416,0.2143024503864518,130118.92804967133,1024.3154472039662,131143.2434968753,2546,0,730.8409090909091,36,8,15,35.30330206033849,0.6215277777777778,44.932432432432435,1020.2702702702707,28.34084084084085,0
4960,4,1,1,42,0.023255813953488372,0.023255813953488372,0.9767441860465116,43,600,300,300,0.5,9,3,6,386.16729013126394,0.3924418604651163,0.062256460314738415,0.21919283081178942,130114.93866008651,1449.2266535922406,131564.16531367876,2547,0,748.8139534883721,35,8,17,35.086618453393825,0.6235119047619049,44.93634259259259,1020.254629629629,29.150132275132258,0
4961,4,0,0,42,0.0,0.0,1.0,42,1150,1100,50,0.9565217391304348,12,11,1,394.4247697503523,0.3887921022067364,0.06648712946133273,0.22333357583947566,130019.64462868468,1856.5936791383078,131876.238307823,2548,2,767.6428571428571,34,8,17,34.97310415937124,0.6246936274509804,45.0297619047619,1019.8809523809514,29.996498599439747,0
4962,4,0,1,41,0.0,0.023809523809523808,0.9761904761904762,42,950,400,550,0.42105263157894735,15,4,11,396.8674144487883,0.3890219705768487,0.0749445065538974,0.22560799440328586,130173.98787133474,1932.3627989968977,132106.35067033165,2549,3,768.6428571428571,35,7,18,34.753530112283094,0.624107142857143,44.878472222222214,1020.4861111111101,29.156746031746003,0
4963,4,0,0,41,0.0,0.0,1.0,41,1250,900,350,0.72,16,9,7,400.0327995670214,0.3903963414634146,0.06147071677112792,0.2275799501020639,130203.51750042845,2217.135523833993,132420.65302426246,2550,4,726.7317073170732,35,6,18,34.64268163604747,0.6244047619047619,44.849537037037024,1020.60185185185,29.16005291005286,0
4964,4,1,1,41,0.023809523809523808,0.023809523809523808,0.9761904761904762,42,1000,400,600,0.4,16,4,12,388.94362625363976,0.39502274487030586,0.06645133961664751,0.22327019226219583,130552.75769054181,1755.5861823906862,132308.34387293248,2551,0,710.4047619047619,32,10,15,34.570360761057565,0.634765625,44.50757575757576,1021.9696969696971,31.936553030303035,0
4965,4,0,0,41,0.0,0.0,1.0,41,950,600,350,0.631578947368421,13,6,7,393.8445883073764,0.38920223577235774,0.06131025957972791,0.22533258270202786,130423.75299714309,2073.337860932552,132497.09085807565,2552,6,728.7317073170732,32,9,18,34.57638030490317,0.6334635416666667,44.63383838383838,1021.4646464646461,31.92077020202019,0
4966,4,1,1,41,0.023809523809523808,0.023809523809523808,0.9761904761904762,42,1100,700,400,0.6363636363636364,15,7,8,381.6332867957299,0.39196186604723193,0.06686353390966926,0.22009189898482134,130732.14215986634,1578.3474204632769,132310.48958032962,2553,0,712.3571428571429,33,9,16,34.57497004194128,0.6341540404040404,44.33210784313725,1022.6715686274505,30.990047534165168,0
4967,4,3,1,43,0.06818181818181818,0.022727272727272728,0.9772727272727273,44,900,500,400,0.5555555555555556,13,5,8,368.2325020885895,0.397055584918957,0.08239725087361816,0.21585092413103102,131358.63272392293,875.4589979374099,132234.09172186034,2554,0,680.9090909090909,34,10,18,34.28318429915225,0.6381740196078431,43.720238095238095,1025.1190476190477,30.150560224089638,0
4968,4,0,1,42,0.0,0.023255813953488372,0.9767441860465116,43,1150,800,350,0.6956521739130435,15,8,7,378.08182959878366,0.3950258397932817,0.08754017772735856,0.22144792876500202,131328.12500000012,1330.5555555555698,132658.68055555568,2555,1,697.7441860465116,36,7,18,34.06165311653117,0.6336805555555556,43.75000000000001,1025.000000000001,28.472222222222246,0
4969,4,0,0,42,0.0,0.0,1.0,42,1150,600,550,0.5217391304347826,17,6,11,377.30961633749655,0.39600271002710025,0.09074703590083755,0.22187865834454157,131480.6990504536,1521.7864229025056,133002.48547335612,2556,2,703.3095238095239,34,8,19,33.92701683110853,0.6393995098039215,43.60119047619048,1025.5952380952388,30.164565826330552,0
4970,4,1,3,40,0.023255813953488372,0.06976744186046512,0.9302325581395349,43,900,600,300,0.6666666666666666,12,6,6,370.80580874623973,0.3989479512735327,0.08893363009335364,0.21973402333920478,131773.3802324461,1172.466965663593,132945.8471981097,2557,0,687.9302325581396,35,8,15,33.79797937098411,0.6401785714285714,43.31597222222223,1026.736111111112,29.335317460317487,0
4971,4,0,0,40,0.0,0.0,1.0,40,950,700,250,0.7368421052631579,12,7,5,389.82563161155474,0.3914262820512821,0.08989425259887684,0.22926568594217187,131485.18786344212,2251.259281286067,133736.44714472818,2558,4,729.925,33,7,19,33.601560321822596,0.6417297979797979,43.59681372549021,1025.6127450980407,31.07917409388002,0
4972,4,0,0,40,0.0,0.0,1.0,40,700,400,300,0.5714285714285714,10,4,6,389.10485619546404,0.39123931623931624,0.08832138590203154,0.2290300735834061,131516.61169982702,2234.750456555179,133751.36215638218,2559,5,730.925,33,7,19,33.588211867781766,0.6420454545454545,43.56617647058824,1025.7352941176473,31.082887700534766,0
4973,4,0,0,40,0.0,0.0,1.0,40,1100,600,500,0.5454545454545454,16,6,10,384.8339408975104,0.39095886752136755,0.08546862312956738,0.22739228269207956,131663.90483276662,2133.747874149682,133797.6527069163,2560,6,731.925,34,6,16,33.54865058191238,0.6412377450980391,43.42261904761906,1026.3095238095252,30.18557422969192,0
4974,4,0,0,40,0.0,0.0,1.0,40,1250,700,550,0.56,18,7,11,384.3135659895088,0.39066506410256413,0.08602593010146542,0.22756083647042358,131743.67310742466,2126.17616169411,133869.84926911877,2561,7,732.925,35,5,16,33.48130402104472,0.6398809523809523,43.34490740740741,1026.6203703703711,29.332010582010604,0
4975,4,1,1,40,0.024390243902439025,0.024390243902439025,0.975609756097561,41,950,700,250,0.7368421052631579,12,7,5,377.8215904525835,0.3929878048780488,0.09580278318120561,0.22570389251643874,132079.47812677556,1780.4956984011194,133859.97382517668,2562,0,716.0243902439024,36,5,18,33.30868390300907,0.6412037037037037,43.018018018018026,1027.927927927929,28.553553553553584,0
4976,4,0,1,39,0.0,0.025,0.975,40,1300,1000,300,0.7692307692307693,16,10,6,384.68090971701645,0.3895432692307692,0.09074678981752626,0.22920786016561567,131981.42387902958,2154.146840706457,134135.57071973605,2563,1,734.725,35,5,18,33.23148982503568,0.6422619047619047,43.11342592592593,1027.546296296297,29.35846560846563,0
4977,4,1,0,40,0.025,0.0,1.0,40,950,800,150,0.8421052631578947,11,8,3,378.0730748557507,0.3930154914529915,0.10494306984891644,0.22689352600081666,132253.17166829002,2000.2726544111838,134253.4443227012,2564,0,729.225,36,4,20,33.126915918546096,0.6429398148148149,42.84909909909911,1028.6036036036046,28.57232232232235,0
4978,4,2,2,40,0.047619047619047616,0.047619047619047616,0.9523809523809523,42,1200,1000,200,0.8333333333333334,14,10,4,359.62776482886994,0.3976359852884243,0.10433850214450668,0.21932228474774748,132857.85147392287,1156.191473119557,134014.0429470424,2565,0,695.452380952381,34,8,15,32.99292725173209,0.6531862745098039,42.26190476190476,1030.9523809523807,30.32212885154061,0
4979,4,0,0,40,0.0,0.0,1.0,40,1650,1100,550,0.6666666666666666,22,11,11,375.6099488132472,0.39300213675213674,0.10891368317802863,0.2272607375757302,132560.48489950004,1958.2073895520896,134518.69228905212,2566,2,731.225,32,8,21,32.88044588850743,0.6549479166666666,42.55050505050505,1029.79797979798,32.18118686868687,0
4980,4,0,0,40,0.0,0.0,1.0,40,600,400,200,0.6666666666666666,8,4,4,381.20375825785896,0.393349358974359,0.11000858053444484,0.23104459582968914,132625.5053693502,2111.468217528838,134736.97358687903,2567,3,732.225,32,8,16,32.67089564435727,0.6555989583333333,42.487373737373744,1030.050505050506,32.18907828282831,0
4981,4,0,0,40,0.0,0.0,1.0,40,1150,600,550,0.5217391304347826,17,6,11,378.2536219692032,0.3931490384615384,0.10717598097502967,0.23018183507677265,132776.64389898113,2044.6492935409362,134821.29319252208,2568,4,733.225,33,7,19,32.59462940943321,0.6546717171717171,42.3406862745098,1030.6372549019604,31.231431966726074,0
4982,4,1,2,39,0.024390243902439025,0.04878048780487805,0.9512195121951219,41,1100,600,500,0.5454545454545454,16,6,10,368.21640325507485,0.3964176829268293,0.11474382995484089,0.22628433272401804,133143.5282305598,1605.1262163494478,134748.65444690926,2569,0,716.3170731707318,35,6,20,32.48441647041232,0.6538690476190476,41.9849537037037,1032.060185185185,29.487433862433857,0
4983,4,0,0,39,0.0,0.0,1.0,39,1300,1000,300,0.7692307692307693,16,10,6,371.8657287770776,0.39304993252361675,0.11703949528381452,0.22846945448394662,133134.14292800453,2101.6050170068047,135235.74794501133,2570,1,742.6666666666666,34,5,20,32.39969046795095,0.6559436274509804,41.99404761904762,1032.0238095238094,30.35364145658263,0
4984,4,1,1,39,0.025,0.025,0.975,40,950,500,450,0.5263157894736842,14,5,9,362.9750006137552,0.3969684829059829,0.1168104414071256,0.22468202881264746,133412.42953746562,1685.0753386488202,135097.50487611443,2571,0,725.075,35,5,21,32.3497834042871,0.656547619047619,41.72453703703703,1033.101851851851,29.517195767195744,0
4985,4,0,0,39,0.0,0.0,1.0,39,1150,900,250,0.782608695652174,14,9,5,371.4731890687686,0.3930218173639226,0.12101460521097396,0.22920358180301206,133292.8843557099,2102.9465663580263,135395.83092206792,2572,3,744.6666666666666,35,4,21,32.25033624747815,0.6553571428571429,41.84027777777778,1032.638888888889,29.503968253968253,0
4986,4,0,0,39,0.0,0.0,1.0,39,1100,600,500,0.5454545454545454,16,6,10,372.5962855730529,0.39279689608636975,0.12585218702865775,0.23045196456961148,133382.53821855693,2139.567660108009,135522.10587866494,2573,4,745.6666666666666,35,4,21,32.131302521008394,0.65625,41.753472222222214,1032.98611111111,29.513888888888857,0
4987,4,0,0,39,0.0,0.0,1.0,39,1100,1000,100,0.9090909090909091,12,10,2,368.8014615651449,0.3923470535312641,0.12377753951305381,0.22884671106840754,133502.97796201808,2047.2488199562179,135550.22678197428,2574,5,746.6666666666666,34,5,21,32.108436048074346,0.6596200980392157,41.63690476190476,1033.4523809523805,30.395658263305307,0
4988,4,0,0,39,0.0,0.0,1.0,39,750,500,250,0.6666666666666666,10,5,5,367.5367078213282,0.3920940170940171,0.12327893253947164,0.22825133743238676,133533.73724489778,2015.7100340135844,135549.44727891136,2575,6,747.6666666666666,34,5,21,32.11025685325963,0.6599264705882353,41.60714285714285,1033.571428571427,30.399159663865504,0
4989,4,1,0,40,0.025,0.0,1.0,40,900,500,400,0.5555555555555556,13,5,8,368.9815054954364,0.3946314102564103,0.14652718387293828,0.2289699486338246,133504.84206012142,1863.738777956853,135368.58083807828,2576,0,729.95,32,8,19,32.1019140704541,0.6643880208333334,41.63510101010101,1033.459595959596,32.29561237373738,1
4990,4,0,1,39,0.0,0.025,0.975,40,900,500,400,0.5555555555555556,13,5,8,369.4007109287607,0.39455128205128204,0.14905643092707965,0.22963429160013388,133570.0936926079,1868.1775137741029,135438.271206382,2577,1,730.95,32,8,20,32.02561988518383,0.6650390625,41.571969696969695,1033.712121212121,32.30350378787878,0
4991,4,0,0,39,0.0,0.0,1.0,39,1050,900,150,0.8571428571428571,12,9,3,369.2515891377102,0.39403396311291045,0.14023575161015933,0.23050912813034585,133725.61034217622,2075.678825451766,135801.28916762798,2578,2,732.8974358974359,33,6,18,31.87351895734598,0.6641414141414141,41.42156862745099,1034.3137254901972,31.342840166369612,0
4992,4,0,0,39,0.0,0.0,1.0,39,550,300,250,0.5454545454545454,8,3,5,370.4453588179989,0.3936965811965812,0.1429773480478378,0.23145294402536828,133757.30075271518,2109.9542543733032,135867.25500708848,2579,3,733.8974358974359,33,6,18,31.810878450420578,0.6644570707070707,41.39093137254901,1034.4362745098028,31.34655377302433,0
4993,4,0,0,39,0.0,0.0,1.0,39,1050,600,450,0.5714285714285714,15,6,9,369.2438341399176,0.3929655870445344,0.13650830169868455,0.2314229740575563,133872.3232001135,2086.30598072564,135958.62918083914,2580,4,734.8974358974359,34,5,18,31.726676636374098,0.6632965686274509,41.27976190476191,1034.8809523809534,30.437675070028043,0
4994,4,0,0,39,0.0,0.0,1.0,39,1450,1200,250,0.8275862068965517,17,12,5,365.6009462896727,0.3921502474134053,0.13837078419932936,0.23087514039279636,134149.66695011346,2009.0490362811893,136158.71598639464,2581,5,735.8974358974359,34,5,19,31.543275492224012,0.6660539215686274,41.011904761904766,1035.9523809523816,30.46918767507005,0
4995,4,0,0,39,0.0,0.0,1.0,39,1200,900,300,0.75,15,9,6,364.07394060477816,0.3918690958164643,0.13953242180100056,0.2307807540858389,134288.02958363784,1978.1544213132213,136266.18400495106,2582,6,736.8974358974359,36,3,20,31.444435390409968,0.6631944444444444,40.878378378378386,1036.4864864864876,28.791291291291323,0
4996,4,0,0,39,0.0,0.0,1.0,39,1200,1000,200,0.8333333333333334,14,10,4,364.9602774061838,0.3915317139001349,0.12983918336214484,0.23264007717566534,134492.36979800765,2016.874518099205,136509.24431610687,2583,7,737.8974358974359,36,3,20,31.217204067600353,0.6652199074074073,40.68130630630632,1037.2747747747765,28.813188188188235,0
4997,4,0,0,39,0.0,0.0,1.0,39,1150,700,450,0.6086956521739131,16,7,9,363.80100429172404,0.3908569500674764,0.1319587982538144,0.23323310989939064,134700.92438539537,2000.8789956866149,136701.803381082,2584,8,738.8974358974359,35,4,22,31.038972200542617,0.669345238095238,40.48032407407408,1038.0787037037048,29.659391534391567,0
4998,4,0,0,39,0.0,0.0,1.0,39,1000,700,300,0.7,13,7,6,363.80100429172404,0.3908569500674764,0.1319587982538144,0.23323310989939064,134700.92438539537,2000.8663140860954,136701.79069948147,2585,9,739.8974358974359,35,4,22,31.038972200542617,0.669345238095238,40.48032407407408,1038.0787037037048,29.659391534391567,0
4999,4,0,0,39,0.0,0.0,1.0,39,1050,600,450,0.5714285714285714,15,6,9,361.68798992019344,0.3908569500674764,0.13114304331424242,0.23245448750458297,134791.0504543897,1950.4608196159274,136741.51127400564,2586,10,740.8974358974359,35,4,15,31.003863872789417,0.6702380952380952,40.393518518518526,1038.425925925927,29.6693121693122,0
5000,4,0,0,39,0.0,0.0,1.0,39,1350,1200,150,0.8888888888888888,15,12,3,364.6360051070074,0.38995726495726496,0.1356115200383885,0.23532260372721817,134941.32754897542,2040.893320258907,136982.22086923433,2587,11,741.8974358974359,35,4,16,30.777380156696733,0.6717261904761905,40.24884259259259,1039.004629629629,29.685846560846546,0
